Source,YOB,Age,NPA,Date,freq
SIM,1930,26,45-49,1956,2
SIM,1896,0,na,1896,3490
STAT,1868,71,na,1939,1203.959498230867
SIM,1875,18,na,1893,2453
SIM,1921,20,35-39,1941,14
STAT,1839,17,35-39,1856,0.47860319201279433
STAT,1876,90,na,1966,205.37411218105626
STAT,1906,62,na,1968,2775.1516104530456
STAT,1890,48,20-24,1938,0.007720139220535659
SIM,1867,4,na,1871,2493
STAT,1810,57,na,1867,1113.6130879714876
SIM,1905,65,na,1970,2571
SIM,1859,55,na,1914,1725
SIM,1907,17,30-34,1924,2
SIM,1931,19,15-19,1950,55
STAT,1838,30,15-19,1868,0.12322364254705863
SIM,1863,60,na,1923,1645
STAT,1871,18,50-100,1889,0.04590735629147387
SIM,1867,74,na,1941,924
SIM,1901,51,na,1952,2893
SIM,1910,27,30-34,1937,39
STAT,1784,99,na,1883,0.29164830571783174
SIM,1941,16,na,1957,3478
STAT,1917,14,na,1931,4001.65747804467
STAT,1898,31,25-29,1929,13.152047118424068
STAT,1927,35,35-39,1962,2.846148251427967
SIM,1902,49,50-100,1951,2
STAT,1934,25,25-29,1959,83.71824453686598
STAT,1925,27,25-29,1952,73.45085997359196
SIM,1907,9,na,1916,3657
STAT,1925,33,na,1958,4240.677391547511
SIM,1884,2,na,1886,2903
SIM,1909,25,40-44,1934,10
SIM,1933,27,25-29,1960,84
STAT,1907,36,20-24,1943,0.2319591832031087
SIM,1886,35,50-100,1921,1
SIM,1888,68,na,1956,1663
STAT,1902,27,30-34,1929,33.5712031054825
STAT,1855,21,na,1876,1781.872889250413
STAT,1859,35,na,1894,1793.0980777903037
STAT,1829,32,15-19,1861,0.13896776498787342
SIM,1860,40,50-100,1900,3
SIM,1872,47,50-100,1919,1
STAT,1942,24,20-24,1966,110.05830193200921
SIM,1797,62,na,1859,925
STAT,1913,20,35-39,1933,8.668911775504178
STAT,1922,26,45-49,1948,1.853249446384067
SIM,1833,62,na,1895,1149
SIM,1878,16,25-29,1894,6
SIM,1858,41,50-100,1899,1
SIM,1924,7,na,1931,4492
STAT,1931,24,45-49,1955,1.3700143690811861
STAT,1916,34,20-24,1950,2.3585370145318203
SIM,1876,35,na,1911,2365
SIM,1869,23,20-24,1892,60
SIM,1914,26,na,1940,3847
SIM,1940,17,15-19,1957,37
STAT,1932,17,15-19,1949,56.77187706640909
SIM,1912,22,35-39,1934,7
SIM,1821,40,50-100,1861,3
STAT,1893,70,na,1963,1886.4010088820519
STAT,1815,88,na,1903,58.757548525390455
STAT,1918,42,30-34,1960,0.12840714772100661
STAT,1900,19,20-24,1919,23.110223967156863
STAT,1844,69,na,1913,1030.2289296975935
STAT,1923,19,15-19,1942,50.07793795647697
STAT,1909,44,30-34,1953,0.11154869926425799
SIM,1875,93,na,1968,109
STAT,1896,23,15-19,1919,4.106210241830243
SIM,1904,25,50-100,1929,5
STAT,1909,31,25-29,1940,8.364044130733948
STAT,1852,88,na,1940,104.30427563758018
SIM,1924,34,20-24,1958,2
SIM,1970,1,na,1971,4522
SIM,1875,20,40-44,1895,3
STAT,1907,23,15-19,1930,4.563143294941621
STAT,1940,30,50-100,1970,0.8092043674542135
STAT,1941,15,15-19,1956,44.180138394815145
SIM,1832,36,50-100,1868,3
SIM,1858,38,na,1896,1898
STAT,1787,105,na,1892,0.01093034570512146
STAT,1912,41,25-29,1953,0.06542270453787166
SIM,1854,24,na,1878,1895
STAT,1849,24,40-44,1873,1.7899679443923746
STAT,1826,40,na,1866,1517.4289730297387
STAT,1904,22,35-39,1926,7.906043266130801
SIM,1860,6,na,1866,2430
STAT,1924,48,15-19,1972,4.1318381863079235E-4
STAT,1801,96,na,1897,3.267391539482735
STAT,1958,3,na,1961,4879.898165061064
STAT,1855,101,na,1956,0.48272480007002977
SIM,1850,10,na,1860,2143
SIM,1825,43,na,1868,1400
SIM,1829,57,na,1886,1128
SIM,1865,30,25-29,1895,14
SIM,1917,39,35-39,1956,9
STAT,1867,15,45-49,1882,0.05993716045664973
STAT,1829,101,na,1930,0.34976295724363443
STAT,1901,18,25-29,1919,7.473409329090896
STAT,1929,7,na,1936,4819.557262852111
SIM,1941,5,na,1946,3751
STAT,1943,23,25-29,1966,92.80495260151677
SIM,1915,23,15-19,1938,4
STAT,1867,20,40-44,1887,1.882895129059765
STAT,1920,18,35-39,1938,4.43602614804112
SIM,1836,34,50-100,1870,4
SIM,1884,54,na,1938,2042
SIM,1953,3,na,1956,4372
STAT,1841,48,25-29,1889,0.03908413669745274
STAT,1942,13,na,1955,3877.175059840162
SIM,1934,36,30-34,1970,4
SIM,1880,40,na,1920,2400
SIM,1939,28,30-34,1967,41
STAT,1838,41,na,1879,1698.564275139032
STAT,1903,26,35-39,1929,13.012983174068243
STAT,1905,34,45-49,1939,1.355230750906962
SIM,1884,22,na,1906,2303
STAT,1899,18,45-49,1917,0.08434582828770833
STAT,1855,22,15-19,1877,2.7296003196811025
STAT,1848,15,35-39,1863,0.4958606186969443
SIM,1926,17,40-44,1943,1
STAT,1809,60,na,1869,1051.4908733197879
SIM,1863,22,15-19,1885,6
STAT,1929,43,45-49,1972,0.2033020882896685
SIM,1935,35,35-39,1970,5
STAT,1827,89,na,1916,58.29938094789832
STAT,1920,23,30-34,1943,30.09333523035085
STAT,1922,31,40-44,1953,4.194409644557065
SIM,1940,20,45-49,1960,1
STAT,1857,30,25-29,1887,7.836344916278622
SIM,1917,31,25-29,1948,9
SIM,1888,36,na,1924,2590
STAT,1904,35,40-44,1939,1.292255804270311
SIM,1892,73,na,1965,1648
SIM,1850,42,na,1892,1702
SIM,1857,24,40-44,1881,1
SIM,1839,20,30-34,1859,21
STAT,1910,33,15-19,1943,0.1165246597144501
SIM,1911,26,35-39,1937,19
SIM,1856,15,35-39,1871,3
SIM,1847,22,30-34,1869,16
STAT,1878,15,20-24,1893,17.516175308922637
STAT,1765,96,na,1861,1.363120787874303
SIM,1882,42,50-100,1924,1
STAT,1912,21,30-34,1933,26.093530705548023
STAT,1926,36,30-34,1962,2.1063919422957085
SIM,1822,78,na,1900,410
SIM,1863,92,na,1955,26
STAT,1934,30,20-24,1964,3.1495855347586375
STAT,1917,46,na,1963,3633.9290764581433
STAT,1938,18,20-24,1956,126.28549078737717
SIM,1902,20,25-29,1922,81
SIM,1950,19,25-29,1969,64
STAT,1944,27,35-39,1971,15.328920114736581
STAT,1913,32,na,1945,3553.9400325765228
SIM,1884,30,35-39,1914,18
STAT,1942,19,25-29,1961,42.75147916004771
SIM,1830,97,na,1927,4
SIM,1856,90,na,1946,45
SIM,1909,29,50-100,1938,6
SIM,1929,18,20-24,1947,152
SIM,1930,32,na,1962,4546
SIM,1925,38,30-34,1963,5
STAT,1932,20,45-49,1952,1.403025578792545
SIM,1797,94,na,1891,2
STAT,1831,94,na,1925,12.18881024793258
SIM,1863,17,na,1880,2243
STAT,1914,32,45-49,1946,1.496095566217079
STAT,1950,15,50-100,1965,0.4187493356147961
STAT,1915,25,15-19,1940,0.6847837824030196
SIM,1867,21,45-49,1888,1
STAT,1822,58,na,1880,1106.6916724055047
STAT,1910,16,25-29,1926,8.129345212389746
SIM,1913,34,45-49,1947,1
STAT,1919,41,35-39,1960,0.2064456726229976
STAT,1839,90,na,1929,52.56869081732537
SIM,1896,30,50-100,1926,1
STAT,1954,14,na,1968,4585.681877047286
STAT,1858,17,45-49,1875,0.05659031840220238
STAT,1894,2,na,1896,3239.3639712621543
STAT,1944,18,50-100,1962,0.38075736512692776
STAT,1917,30,20-24,1947,2.4322150310182
SIM,1937,33,50-100,1970,1
STAT,1944,15,40-44,1959,1.4227034659105848
STAT,1877,4,na,1881,2835.1740078416124
SIM,1905,32,45-49,1937,2
SIM,1936,31,35-39,1967,8
STAT,1897,52,na,1949,2705.937510787395
STAT,1903,39,40-44,1942,1.2571226011682877
STAT,1922,9,na,1931,4352.6261328232085
STAT,1908,35,25-29,1943,0.8789386862229929
STAT,1934,38,30-34,1972,2.3735405283847086
SIM,1887,19,na,1906,2624
SIM,1911,23,30-34,1934,32
SIM,1920,21,30-34,1941,34
STAT,1899,23,40-44,1922,2.6893910165905863
SIM,1793,80,na,1873,190
STAT,1917,38,30-34,1955,1.7794018010103252
SIM,1880,72,na,1952,1299
SIM,1884,86,na,1970,390
STAT,1905,13,na,1918,3520.06176513057
STAT,1772,98,na,1870,0.47553305972516435
STAT,1848,20,30-34,1868,15.851557216036321
STAT,1927,40,30-34,1967,0.15190694173814773
STAT,1839,22,30-34,1861,15.260194009652526
STAT,1871,46,45-49,1917,0.2216517836273865
STAT,1750,113,na,1863,0.014905623304791858
STAT,1909,27,na,1936,3381.28082122358
STAT,1813,97,na,1910,2.2720686187134955
STAT,1940,22,45-49,1962,1.0827044879876455
SIM,1894,32,na,1926,3042
SIM,1804,81,na,1885,165
STAT,1882,49,25-29,1931,0.05184327297480307
STAT,1889,33,na,1922,2771.343143967299
STAT,1933,26,20-24,1959,22.907506345118975
STAT,1927,24,na,1951,4224.236148023262
STAT,1919,49,45-49,1968,0.22139078720857366
SIM,1898,25,40-44,1923,8
SIM,1935,15,40-44,1950,5
STAT,1885,83,na,1968,678.1338100166993
STAT,1923,22,45-49,1945,1.2368884218705818
STAT,1864,20,15-19,1884,2.8712765685955293
STAT,1865,49,25-29,1914,0.04841401845985351
STAT,1924,23,15-19,1947,5.9161169124417095
SIM,1868,48,na,1916,2004
SIM,1952,15,40-44,1967,3
STAT,1913,28,45-49,1941,1.6201068771635747
SIM,1833,47,50-100,1880,4
STAT,1845,43,na,1888,1636.7126312598707
SIM,1904,33,40-44,1937,4
SIM,1941,26,20-24,1967,16
SIM,1872,53,na,1925,2007
SIM,1925,25,25-29,1950,81
STAT,1908,40,20-24,1948,0.015606898918722174
SIM,1843,40,na,1883,1718
SIM,1921,33,40-44,1954,5
STAT,1869,25,20-24,1894,10.800450745786897
STAT,1912,29,40-44,1941,4.307215409392612
SIM,1921,28,45-49,1949,4
SIM,1942,25,25-29,1967,68
SIM,1902,33,30-34,1935,8
STAT,1889,65,na,1954,1970.9559704144983
SIM,1899,24,45-49,1923,4
STAT,1826,72,na,1898,689.3096839902269
STAT,1837,24,na,1861,1741.5782586288162
SIM,1876,67,na,1943,1585
STAT,1806,105,na,1911,0.009756409758170713
SIM,1922,32,45-49,1954,1
STAT,1885,51,na,1936,2036.2689073948125
STAT,1918,37,35-39,1955,2.408359261215595
SIM,1861,51,50-100,1912,1
SIM,1893,20,35-39,1913,7
STAT,1913,33,40-44,1946,3.661778665270284
SIM,1922,45,na,1967,4022
SIM,1901,16,25-29,1917,11
STAT,1859,21,45-49,1880,0.6037419763344297
STAT,1927,15,40-44,1942,1.6507653803807465
STAT,1920,43,25-29,1963,0.07439126174731499
STAT,1930,40,50-100,1970,0.14643774785128086
SIM,1920,29,40-44,1949,5
SIM,1872,20,15-19,1892,3
STAT,1810,54,30-34,1864,0.019408759999049056
SIM,1922,13,na,1935,4352
STAT,1903,43,25-29,1946,0.05950111494629156
STAT,1940,19,15-19,1959,43.497392013114435
SIM,1839,35,na,1874,1807
SIM,1901,29,30-34,1930,44
SIM,1925,30,20-24,1955,2
SIM,1926,37,35-39,1963,3
STAT,1930,20,35-39,1950,11.463882734874181
SIM,1931,22,45-49,1953,1
STAT,1818,53,na,1871,1227.305855994297
STAT,1846,60,na,1906,1344.6998571659658
SIM,1835,21,na,1856,1752
STAT,1861,33,50-100,1894,0.715740028005137
SIM,1887,23,15-19,1910,3
SIM,1901,21,20-24,1922,88
SIM,1902,28,35-39,1930,10
STAT,1800,79,na,1879,286.65774355625393
STAT,1875,17,45-49,1892,0.06339797477379129
STAT,1780,85,na,1865,70.96948771719926
STAT,1876,15,na,1891,2474.55498528644
STAT,1822,106,na,1928,0.006271582808882642
SIM,1789,75,na,1864,381
SIM,1900,17,20-24,1917,23
STAT,1939,25,na,1964,3560.4240988631204
SIM,1926,27,na,1953,4079
STAT,1930,28,45-49,1958,2.0743538336803002
STAT,1810,49,35-39,1859,0.4812433273377305
STAT,1858,22,40-44,1880,1.7731450099837234
STAT,1860,45,30-34,1905,0.07506006637521175
STAT,1917,25,25-29,1942,65.64879821939165
SIM,1848,71,na,1919,951
SIM,1946,18,20-24,1964,131
STAT,1877,32,na,1909,2339.341238409231
SIM,1866,22,40-44,1888,1
STAT,1876,30,35-39,1906,9.955864310577503
STAT,1935,11,na,1946,5124.463976483801
STAT,1808,54,50-100,1862,0.052771063851591055
STAT,1908,48,30-34,1956,0.07593252430403026
STAT,1924,36,20-24,1960,0.2939467444190434
SIM,1938,28,na,1966,3433
STAT,1926,44,30-34,1970,0.1484124538955961
STAT,1907,3,na,1910,3667.96557526569
SIM,1916,27,25-29,1943,68
SIM,1934,14,na,1948,4995
STAT,1910,21,20-24,1931,98.91564847025806
SIM,1904,48,na,1952,2958
STAT,1835,103,na,1938,0.08954329404381522
STAT,1851,39,na,1890,1710.2884842054464
STAT,1835,76,na,1911,591.1133457581451
STAT,1875,22,40-44,1897,2.0224157091195303
SIM,1904,20,35-39,1924,10
STAT,1891,39,25-29,1930,3.3327806407042213
STAT,1855,30,15-19,1885,0.10484961695730746
STAT,1902,31,15-19,1933,0.19062637660532297
SIM,1868,16,na,1884,2318
SIM,1889,31,25-29,1920,15
SIM,1857,27,45-49,1884,4
STAT,1858,18,na,1876,1976.8791921700677
SIM,1885,71,na,1956,1225
STAT,1914,24,45-49,1938,1.0789693987463087
SIM,1881,9,na,1890,2164
STAT,1916,46,15-19,1962,3.578094050154517E-4
STAT,1931,21,40-44,1952,4.132248200047191
SIM,1834,36,na,1870,1605
SIM,1918,35,35-39,1953,4
STAT,1904,38,45-49,1942,0.5800572458748996
STAT,1864,20,50-100,1884,0.3549167984111089
STAT,1942,27,25-29,1969,65.25803389007612
SIM,1848,21,35-39,1869,4
SIM,1930,23,40-44,1953,5
STAT,1809,103,na,1912,0.06028814556633675
STAT,1848,40,25-29,1888,0.47404791095828863
STAT,1922,43,35-39,1965,0.21801598629051375
SIM,1802,58,na,1860,1034
SIM,1872,16,30-34,1888,3
STAT,1846,32,15-19,1878,0.11865689478375943
SIM,1892,32,50-100,1924,2
STAT,1920,35,25-29,1955,1.020225655696029
SIM,1948,18,30-34,1966,10
SIM,1932,23,15-19,1955,6
STAT,1930,42,30-34,1972,0.15891760748550465
STAT,1885,20,35-39,1905,5.52500318812851
SIM,1826,60,na,1886,1087
SIM,1888,23,30-34,1911,21
SIM,1851,91,na,1942,31
STAT,1861,49,40-44,1910,0.13149827232788547
STAT,1886,9,na,1895,2589.7659573111146
SIM,1931,30,45-49,1961,2
STAT,1849,27,45-49,1876,0.9486761872988458
SIM,1891,56,na,1947,2425
STAT,1901,43,15-19,1944,0.0012588904618534738
STAT,1922,23,40-44,1945,3.631605367978642
SIM,1855,20,15-19,1875,6
SIM,1928,42,40-44,1970,1
STAT,1879,87,na,1966,380.1947361435785
STAT,1875,73,na,1948,1152.7591162505857
STAT,1864,16,30-34,1880,1.5388646497950258
STAT,1913,45,35-39,1958,0.11941357443138585
STAT,1928,31,35-39,1959,10.80192334398906
SIM,1821,61,na,1882,1035
STAT,1935,37,35-39,1972,3.194959537088588
STAT,1921,22,35-39,1943,10.047800507390994
SIM,1898,46,na,1944,2862
STAT,1860,0,na,1860,2979.5882697849383
STAT,1896,35,na,1931,2969.449289254665
STAT,1812,49,45-49,1861,0.7516763778467769
SIM,1858,20,40-44,1878,1
STAT,1907,19,30-34,1926,2.1995818179927404
STAT,1905,31,40-44,1936,3.4133241175817197
STAT,1829,45,50-100,1874,0.20342253834066884
STAT,1933,22,50-100,1955,0.8245344121072864
SIM,1898,28,45-49,1926,3
STAT,1910,29,30-34,1939,35.478093344041476
STAT,1892,21,na,1913,2806.3155623519588
STAT,1902,22,25-29,1924,76.31688135314228
SIM,1846,26,30-34,1872,27
STAT,1802,108,na,1910,6.248697320538992E-4
STAT,1904,30,35-39,1934,13.830669474957013
STAT,1948,24,15-19,1972,5.77049771270999
SIM,1875,23,45-49,1898,1
STAT,1900,5,na,1905,3434.5813934755956
SIM,1902,3,na,1905,3531
SIM,1922,24,45-49,1946,1
STAT,1829,37,na,1866,1678.349778800886
STAT,1884,34,na,1918,2208.6433334830695
SIM,1846,22,15-19,1868,4
STAT,1867,23,45-49,1890,0.6166133299944707
SIM,1915,19,30-34,1934,4
STAT,1903,23,30-34,1926,23.866321792802374
STAT,1850,27,50-100,1877,0.5299659631338368
STAT,1888,48,na,1936,2479.7572632890788
STAT,1881,69,na,1950,1338.6108613611216
SIM,1837,45,50-100,1882,1
SIM,1904,28,45-49,1932,1
SIM,1910,22,25-29,1932,85
STAT,1918,45,35-39,1963,0.1302202113533578
STAT,1923,30,45-49,1953,1.7180286156266775
SIM,1879,25,30-34,1904,29
SIM,1901,37,30-34,1938,2
STAT,1922,34,45-49,1956,1.6715260546174053
SIM,1869,26,25-29,1895,40
STAT,1773,83,na,1856,87.11054317
STAT,1777,97,na,1874,0.8621439052614135
STAT,1854,25,50-100,1879,0.5383620632025041
SIM,1826,92,na,1918,45
STAT,1841,45,20-24,1886,0.008461580398636677
STAT,1824,48,25-29,1872,0.06673854056941948
STAT,1888,21,15-19,1909,3.692859826445863
SIM,1854,38,50-100,1892,3
SIM,1924,37,25-29,1961,4
SIM,1951,20,20-24,1971,121
SIM,1917,34,na,1951,3660
STAT,1925,24,20-24,1949,124.96630484983959
SIM,1913,20,na,1933,3397
STAT,1928,39,45-49,1967,0.812248583923922
STAT,1830,45,45-49,1875,0.17749626372223054
SIM,1912,30,35-39,1942,10
STAT,1838,26,30-34,1864,22.00544886624634
STAT,1918,17,40-44,1935,0.2885419929687197
SIM,1869,37,50-100,1906,1
STAT,1880,20,na,1900,2364.8811222562904
STAT,1937,15,50-100,1952,0.3458722019629215
STAT,1852,56,na,1908,1549.6575236709473
STAT,1829,40,15-19,1869,0.011981582600534883
STAT,1943,28,30-34,1971,39.4013490708273
STAT,1933,34,20-24,1967,3.1013119489622207
SIM,1900,34,na,1934,3055
STAT,1916,37,25-29,1953,0.9524979449715367
SIM,1896,21,15-19,1917,4
STAT,1814,51,50-100,1865,0.03998256785544585
STAT,1943,20,20-24,1963,111.83300025637853
STAT,1908,27,25-29,1935,59.26559739362396
STAT,1911,42,20-24,1953,0.01592000696372394
STAT,1896,31,15-19,1927,0.17852717329757128
SIM,1903,4,na,1907,3493
SIM,1933,24,20-24,1957,132
STAT,1933,38,15-19,1971,0.0246849497148176
SIM,1930,34,45-49,1964,1
STAT,1921,51,na,1972,3862.9573768343935
STAT,1934,7,na,1941,5107.639762971749
STAT,1904,27,40-44,1931,4.058459205506901
STAT,1903,40,20-24,1943,0.014971966826271095
SIM,1870,94,na,1964,44
STAT,1865,6,na,1871,2425.15889242039
STAT,1840,49,20-24,1889,0.008214173241211674
SIM,1871,36,50-100,1907,1
SIM,1887,27,30-34,1914,40
STAT,1839,15,na,1854,2025.9601073172382
STAT,1935,21,25-29,1956,118.86056269992254
SIM,1943,21,25-29,1964,93
SIM,1897,72,na,1969,1930
STAT,1820,48,40-44,1868,0.27817200691095206
STAT,1872,39,15-19,1911,0.052709988790621914
STAT,1900,42,45-49,1942,0.1360415647955897
STAT,1952,17,40-44,1969,1.5835332404270865
STAT,1909,39,35-39,1948,2.1404821339803846
SIM,1923,20,45-49,1943,1
SIM,1919,25,na,1944,3850
STAT,1798,59,na,1857,977.1818114969517
STAT,1879,27,30-34,1906,24.865415672747496
STAT,1851,104,na,1955,0.048912236396735136
STAT,1856,70,na,1926,1038.1261709703595
SIM,1915,11,na,1926,3861
STAT,1907,44,20-24,1951,0.015094866328370335
STAT,1944,24,30-34,1968,29.29529501698029
SIM,1842,23,na,1865,1841
SIM,1854,56,na,1910,1612
SIM,1903,24,35-39,1927,12
STAT,1934,17,25-29,1951,55.37215549826328
SIM,1917,23,25-29,1940,96
STAT,1864,57,na,1921,1696.7530840099912
STAT,1913,41,40-44,1954,0.23170230438882133
STAT,1860,43,na,1903,1761.6582610283642
SIM,1840,75,na,1915,639
SIM,1877,84,na,1961,419
SIM,1909,47,na,1956,3178
STAT,1860,22,50-100,1882,0.3227459386677447
SIM,1905,33,na,1938,3263
SIM,1846,37,na,1883,1750
STAT,1764,109,na,1873,0.002203796594190048
SIM,1888,7,na,1895,2830
STAT,1797,74,na,1871,454.44693935802206
STAT,1872,22,15-19,1894,3.128142189868514
SIM,1869,18,25-29,1887,6
SIM,1781,79,na,1860,232
STAT,1850,38,25-29,1888,2.0377894597877413
STAT,1858,30,40-44,1888,3.2837288217321126
STAT,1848,23,35-39,1871,5.0820681524050695
STAT,1925,32,20-24,1957,2.736639731637304
SIM,1847,54,na,1901,1495
SIM,1838,24,30-34,1862,20
SIM,1932,28,20-24,1960,20
SIM,1934,19,40-44,1953,1
SIM,1838,93,na,1931,22
SIM,1916,49,na,1965,3460
STAT,1821,52,40-44,1873,0.015454119420398186
STAT,1871,16,na,1887,2394.721027303602
SIM,1912,27,40-44,1939,4
SIM,1853,39,na,1892,1871
SIM,1877,17,20-24,1894,17
SIM,1900,25,20-24,1925,21
SIM,1779,97,na,1876,1
SIM,1912,35,na,1947,3358
SIM,1933,32,20-24,1965,3
STAT,1869,17,20-24,1886,16.43611216063085
STAT,1897,15,30-34,1912,2.023075181196155
STAT,1929,35,45-49,1964,0.8282890789753712
SIM,1775,83,na,1858,118
SIM,1898,20,35-39,1918,9
SIM,1925,33,25-29,1958,9
STAT,1889,16,35-39,1905,0.6415158263031575
STAT,1808,75,na,1883,444.7610729788966
STAT,1785,84,na,1869,105.39790406906627
SIM,1829,25,na,1854,1708
STAT,1789,98,na,1887,0.5360940727572165
SIM,1844,89,na,1933,54
SIM,1848,30,25-29,1878,12
STAT,1917,33,25-29,1950,9.104231961611367
STAT,1804,61,na,1865,965.7777629716437
SIM,1866,30,40-44,1896,6
SIM,1913,31,40-44,1944,4
STAT,1924,28,20-24,1952,20.009457262423766
STAT,1926,19,40-44,1945,1.6115473297428935
SIM,1856,23,35-39,1879,6
SIM,1787,84,na,1871,87
SIM,1907,34,20-24,1941,1
SIM,1921,41,40-44,1962,1
STAT,1912,37,40-44,1949,1.3799548269253297
STAT,1934,26,na,1960,4762.811171035296
STAT,1889,41,25-29,1930,0.7523185009462326
SIM,1918,18,45-49,1936,1
SIM,1867,30,35-39,1897,7
STAT,1916,29,25-29,1945,63.83034064412421
STAT,1898,7,na,1905,3331.7996570362516
STAT,1868,16,15-19,1884,5.482035138147887
STAT,1893,30,50-100,1923,1.107054295253057
STAT,1914,41,35-39,1955,0.1887343295225403
STAT,1930,12,na,1942,4839.539644182634
SIM,1878,21,20-24,1899,59
SIM,1818,73,na,1891,459
SIM,1942,17,25-29,1959,52
STAT,1919,46,40-44,1965,0.16195067300327667
SIM,1908,29,40-44,1937,3
SIM,1926,34,30-34,1960,21
STAT,1868,50,50-100,1918,0.013818091848162344
SIM,1924,29,25-29,1953,77
STAT,1934,33,50-100,1967,1.0657358258661054
SIM,1873,70,na,1943,1315
STAT,1950,18,20-24,1968,151.402691280496
STAT,1882,46,20-24,1928,0.011062320325791348
STAT,1930,25,40-44,1955,5.60410540896502
STAT,1862,53,40-44,1915,0.008347365299924652
STAT,1860,48,35-39,1908,0.10613578468193266
STAT,1849,68,na,1917,1101.5107762674843
STAT,1911,25,30-34,1936,36.334869217237745
STAT,1830,77,na,1907,516.3459240186305
SIM,1869,33,na,1902,2165
STAT,1908,44,15-19,1952,0.0013254290654129643
STAT,1816,62,na,1878,1018.1818395359734
SIM,1839,67,na,1906,1131
STAT,1839,40,50-100,1879,0.8370210369018292
STAT,1936,33,35-39,1969,8.378620781360782
SIM,1849,25,45-49,1874,5
SIM,1886,15,20-24,1901,16
STAT,1915,17,15-19,1932,8.972316520108796
SIM,1836,19,25-29,1855,6
SIM,1899,21,40-44,1920,3
STAT,1875,16,50-100,1891,0.04766526096971926
STAT,1918,34,30-34,1952,15.680294638418784
STAT,1899,31,40-44,1930,5.637315474466117
STAT,1901,35,15-19,1936,0.01617894566696516
SIM,1876,16,15-19,1892,5
SIM,1832,88,na,1920,66
STAT,1923,27,15-19,1950,0.7657522784275806
SIM,1862,43,na,1905,1988
SIM,1923,17,15-19,1940,42
STAT,1831,38,15-19,1869,0.0438281371705037
SIM,1819,90,na,1909,25
STAT,1935,29,35-39,1964,19.313460131598553
STAT,1914,21,40-44,1935,3.122920979526578
STAT,1917,22,20-24,1939,111.63842002157287
SIM,1882,30,25-29,1912,10
STAT,1919,30,30-34,1949,16.186951235292685
STAT,1830,42,40-44,1872,1.7107545238148538
STAT,1918,28,45-49,1946,1.730721866403415
STAT,1856,48,20-24,1904,0.008767166682006793
STAT,1921,38,45-49,1959,0.7184301229849412
STAT,1887,16,25-29,1903,6.001582780419695
STAT,1940,31,35-39,1971,8.939043514782753
STAT,1836,18,na,1854,1910.8595114802474
SIM,1889,21,na,1910,2792
STAT,1840,23,na,1863,1880.0044115640517
STAT,1874,39,25-29,1913,2.7519766427177785
STAT,1844,37,na,1881,1747.7362092244048
SIM,1918,32,30-34,1950,22
STAT,1914,40,45-49,1954,0.15685345571603213
STAT,1957,11,na,1968,4892.626655209929
STAT,1944,19,35-39,1963,4.262990710380984
SIM,1943,25,40-44,1968,10
STAT,1937,21,35-39,1958,8.66380096009076
SIM,1829,89,na,1918,47
SIM,1899,52,na,1951,2761
SIM,1927,12,na,1939,4577
STAT,1881,20,15-19,1901,3.0271394103968774
SIM,1786,78,na,1864,266
STAT,1861,92,na,1953,32.6729930505569
STAT,1873,17,35-39,1890,0.5261617666452104
STAT,1855,26,30-34,1881,18.724189966401724
SIM,1952,19,35-39,1971,5
STAT,1859,30,35-39,1889,7.746264162960067
STAT,1828,74,na,1902,630.0008943804769
STAT,1906,48,20-24,1954,0.00919449790037018
STAT,1926,28,30-34,1954,44.2219280857838
STAT,1905,18,50-100,1923,0.0667062991901952
STAT,1921,19,40-44,1940,1.4982232961143416
SIM,1860,95,na,1955,4
STAT,1910,24,25-29,1934,81.409058657192
SIM,1927,30,30-34,1957,24
STAT,1874,30,25-29,1904,9.969051110337686
STAT,1913,42,30-34,1955,0.11775097223806641
SIM,1827,77,na,1904,443
STAT,1807,48,25-29,1855,0.2098467041560567
STAT,1906,35,15-19,1941,0.016831372473206013
STAT,1857,87,na,1944,131.21077544215086
STAT,1876,47,na,1923,2183.9400301699047
STAT,1853,73,na,1926,880.8466746415344
STAT,1866,27,45-49,1893,0.9670618446259323
STAT,1881,29,15-19,1910,0.41088423279951114
SIM,1831,82,na,1913,237
STAT,1809,92,na,1901,17.49618898599415
STAT,1919,38,40-44,1957,1.5177474130306698
SIM,1934,28,30-34,1962,60
STAT,1932,38,20-24,1970,0.33426654188959265
SIM,1890,38,20-24,1928,1
STAT,1898,29,50-100,1927,0.8122090575596718
SIM,1925,22,20-24,1947,122
STAT,1920,32,20-24,1952,2.5240855429687947
STAT,1824,36,50-100,1860,1.9363270992559556
SIM,1875,40,35-39,1915,2
SIM,1877,25,20-24,1902,13
SIM,1927,38,40-44,1965,2
SIM,1833,23,40-44,1856,1
STAT,1901,27,15-19,1928,0.599924949344789
STAT,1842,49,30-34,1891,0.06749324035168297
STAT,1867,49,35-39,1916,0.1215872825439847
SIM,1784,104,na,1888,1
STAT,1886,22,50-100,1908,0.40702545608264484
SIM,1882,39,25-29,1921,3
STAT,1921,30,35-39,1951,9.685205148438984
STAT,1937,34,40-44,1971,3.6523110526769105
SIM,1825,75,na,1900,498
STAT,1910,37,30-34,1947,1.6462091792261018
STAT,1804,93,na,1897,9.903875716824475
STAT,1831,62,na,1893,1114.669338661215
STAT,1832,23,50-100,1855,0.38480236508722543
SIM,1902,36,35-39,1938,4
STAT,1952,18,30-34,1970,13.794944749667803
SIM,1929,33,45-49,1962,2
STAT,1940,30,45-49,1970,1.5400986443391973
SIM,1896,25,30-34,1921,50
SIM,1810,45,na,1855,1362
STAT,1907,27,30-34,1934,34.939055960037436
STAT,1864,5,na,1869,2413.4728588982643
STAT,1866,20,25-29,1886,50.99710392548743
STAT,1869,24,50-100,1893,0.37056414427422324
SIM,1814,59,na,1873,1050
SIM,1871,36,na,1907,2287
SIM,1879,21,15-19,1900,5
STAT,1917,42,15-19,1959,0.001513918972462761
STAT,1930,36,45-49,1966,0.8408412065614161
SIM,1883,69,na,1952,1314
SIM,1848,37,45-49,1885,1
SIM,1841,38,25-29,1879,2
STAT,1926,20,20-24,1946,128.3933257376251
STAT,1836,53,50-100,1889,0.009460643958259561
SIM,1838,20,15-19,1858,1
SIM,1850,74,na,1924,788
SIM,1925,17,25-29,1942,61
SIM,1902,17,30-34,1919,2
SIM,1944,22,30-34,1966,29
STAT,1937,29,45-49,1966,1.5891279164702328
STAT,1846,40,15-19,1886,0.010110583586143234
STAT,1924,43,45-49,1967,0.18673637355830658
STAT,1930,17,40-44,1947,1.708397897191888
STAT,1909,35,40-44,1944,1.3509442126164113
STAT,1933,37,25-29,1970,1.2669441526874208
STAT,1829,69,na,1898,899.5287292251934
STAT,1888,25,30-34,1913,28.293917556495725
SIM,1934,27,40-44,1961,4
STAT,1917,49,35-39,1966,0.12646889707665462
SIM,1895,16,25-29,1911,9
STAT,1833,38,25-29,1871,2.168506170720228
SIM,1903,16,35-39,1919,3
STAT,1828,34,50-100,1862,0.919638021423688
STAT,1905,43,35-39,1948,0.17042362504384262
SIM,1899,31,na,1930,3066
STAT,1863,72,na,1935,1048.7250836857436
STAT,1878,35,50-100,1913,1.218893798485921
STAT,1915,20,45-49,1935,1.0605554630753804
STAT,1937,0,na,1937,4139.79077508328
STAT,1924,38,50-100,1962,0.46727499416228835
SIM,1854,88,na,1942,82
SIM,1863,26,30-34,1889,32
STAT,1912,47,na,1959,3334.636081595097
SIM,1922,21,40-44,1943,4
STAT,1932,25,15-19,1957,0.8742913472428091
STAT,1928,30,na,1958,4472.999142660374
STAT,1900,14,na,1914,3373.652142822432
STAT,1950,4,na,1954,4409.053920096876
SIM,1846,69,na,1915,989
SIM,1909,21,25-29,1930,78
STAT,1900,47,15-19,1947,2.94333779856401E-4
SIM,1940,4,na,1944,3679
SIM,1945,21,35-39,1966,12
STAT,1921,8,na,1929,4295.191692084422
STAT,1904,28,na,1932,3221.935566754044
STAT,1867,86,na,1953,196.80428189681763
STAT,1910,35,na,1945,3430.421241908526
STAT,1913,4,na,1917,3884.8454508717778
STAT,1914,49,na,1963,3421.22751931618
STAT,1825,55,na,1880,1271.1616690461665
STAT,1856,1,na,1857,2777.304370508752
SIM,1857,21,na,1878,1998
STAT,1926,27,40-44,1953,5.279091447907306
STAT,1850,22,na,1872,1806.6763331960262
SIM,1829,34,30-34,1863,24
SIM,1881,57,na,1938,1697
STAT,1821,41,na,1862,1501.6326685020574
STAT,1901,6,na,1907,3454.2859753229654
SIM,1812,57,na,1869,1084
STAT,1874,42,50-100,1916,1.018781775381184
SIM,1933,35,25-29,1968,4
STAT,1823,49,20-24,1872,0.013907897535561658
STAT,1893,39,35-39,1932,8.39239249790884
SIM,1932,0,na,1932,5093
STAT,1824,92,na,1916,21.988295076888058
STAT,1856,25,35-39,1881,7.505217336010497
STAT,1947,12,na,1959,4180.427714634499
STAT,1907,47,25-29,1954,0.04487029701440981
STAT,1854,36,na,1890,1704.6910273118215
SIM,1856,58,na,1914,1544
STAT,1916,38,15-19,1954,0.018484947494089604
STAT,1779,77,na,1856,313.55336467710003
STAT,1806,49,20-24,1855,0.03432745338454884
STAT,1902,19,30-34,1921,2.1134688940485504
SIM,1892,20,40-44,1912,3
STAT,1836,102,na,1938,0.18513678935114725
SIM,1937,32,40-44,1969,2
STAT,1838,73,na,1911,810.0761967084604
STAT,1836,26,20-24,1862,9.655356594327571
SIM,1910,19,30-34,1929,2
STAT,1846,49,15-19,1895,2.761402002025352E-4
STAT,1938,30,40-44,1968,3.7210085469027385
STAT,1806,63,na,1869,864.320760284939
STAT,1783,82,na,1865,131.45137632801644
STAT,1909,16,50-100,1925,0.06956021907458451
SIM,1821,93,na,1914,10
STAT,1795,62,na,1857,861.7119898372947
STAT,1901,30,45-49,1931,2.3243679507406796
SIM,1819,36,50-100,1855,2
SIM,1903,21,30-34,1924,28
STAT,1846,17,na,1863,2033.104012244027
STAT,1787,96,na,1883,1.547832953847357
SIM,1944,13,na,1957,3955
STAT,1799,76,na,1875,383.61331655969815
SIM,1918,27,35-39,1945,20
STAT,1901,25,50-100,1926,0.8515954708819649
STAT,1905,18,45-49,1923,0.08894173225359361
SIM,1874,20,25-29,1894,53
STAT,1921,31,25-29,1952,9.757303182486641
STAT,1893,30,35-39,1923,12.236034202854173
STAT,1884,20,40-44,1904,1.9569251953825457
STAT,1938,26,50-100,1964,0.9318706026174377
SIM,1919,31,35-39,1950,14
STAT,1838,22,15-19,1860,2.9192254866573295
SIM,1841,81,na,1922,326
STAT,1903,47,50-100,1950,0.1853327203381154
STAT,1911,17,30-34,1928,2.3036809760069805
STAT,1903,17,45-49,1920,0.08779560587051344
STAT,1904,44,50-100,1948,0.09805116967896409
STAT,1920,26,35-39,1946,15.612820378366264
STAT,1865,31,50-100,1896,0.789760587558446
STAT,1815,56,na,1871,1112.27670715919
SIM,1878,90,na,1968,279
SIM,1919,44,40-44,1963,3
SIM,1903,29,40-44,1932,4
STAT,1815,47,20-24,1862,0.029201936940041147
STAT,1929,33,50-100,1962,0.9915709513940212
STAT,1841,37,20-24,1878,0.6213906837638757
SIM,1900,66,na,1966,2335
SIM,1934,20,20-24,1954,137
STAT,1867,40,35-39,1907,1.6223997594922588
SIM,1868,5,na,1873,2532
SIM,1813,74,na,1887,436
SIM,1879,32,na,1911,2346
SIM,1824,37,na,1861,1526
STAT,1851,43,50-100,1894,0.7691171760342287
STAT,1882,54,na,1936,1924.9228725173214
STAT,1814,82,na,1896,192.51002148885786
STAT,1821,39,45-49,1860,3.6670343723881094
STAT,1846,92,na,1938,29.36585452254949
STAT,1909,40,15-19,1949,0.0013719636651317074
STAT,1888,28,35-39,1916,10.73039770612354
SIM,1933,16,20-24,1949,168
SIM,1844,26,20-24,1870,13
STAT,1925,16,20-24,1941,155.1160790088362
STAT,1882,38,20-24,1920,0.7050882236443018
SIM,1877,20,na,1897,2333
STAT,1882,86,na,1968,446.6388019739176
STAT,1880,53,50-100,1933,0.014771073674189762
STAT,1830,52,50-100,1882,0.009735757569957202
STAT,1811,63,na,1874,922.589238682275
STAT,1815,77,na,1892,369.96092088604746
STAT,1874,35,na,1909,2296.37401251975
STAT,1893,38,na,1931,2809.9053630923995
SIM,1854,15,25-29,1869,8
SIM,1907,26,20-24,1933,16
STAT,1906,22,45-49,1928,0.9592418729831671
STAT,1884,40,35-39,1924,1.7075240067885942
STAT,1886,68,na,1954,1525.3308801499693
SIM,1847,22,na,1869,1848
STAT,1862,55,na,1917,1666.2418173909623
STAT,1878,49,na,1927,2166.41394803311
STAT,1915,46,20-24,1961,0.010545077503131373
STAT,1866,69,na,1935,1278.2141971524518
SIM,1871,15,25-29,1886,6
SIM,1947,18,15-19,1965,48
STAT,1862,16,20-24,1878,16.45907730986692
STAT,1853,51,50-100,1904,0.011253906587637292
STAT,1858,18,50-100,1876,0.04219275107011007
SIM,1911,29,na,1940,3456
STAT,1830,45,na,1875,1479.9307002663734
STAT,1925,40,20-24,1965,0.02025732135309398
STAT,1834,59,na,1893,1202.919543238805
SIM,1947,23,50-100,1970,4
STAT,1920,13,na,1933,4193.27705316533
STAT,1935,30,15-19,1965,0.1681338416160512
STAT,1877,38,50-100,1915,1.1976073334084558
STAT,1844,40,50-100,1884,0.7792760825503594
STAT,1882,15,35-39,1897,0.5067444387367362
SIM,1914,22,45-49,1936,1
STAT,1924,27,na,1951,4120.933707431879
STAT,1901,26,25-29,1927,56.1265698100539
SIM,1958,9,na,1967,4846
STAT,1912,33,25-29,1945,8.55344503897208
SIM,1917,20,20-24,1937,110
SIM,1782,85,na,1867,68
SIM,1892,40,35-39,1932,5
STAT,1863,15,25-29,1878,5.4334966772610755
SIM,1832,56,na,1888,1275
STAT,1939,18,15-19,1957,42.89658896245823
SIM,1859,24,15-19,1883,1
SIM,1861,58,na,1919,1697
STAT,1847,20,15-19,1867,3.018933098210577
STAT,1945,20,30-34,1965,29.778322346209844
SIM,1870,16,20-24,1886,23
STAT,1861,17,na,1878,2069.7204378033653
STAT,1922,42,45-49,1964,0.18047567592434455
STAT,1911,16,40-44,1927,0.2650061088173993
STAT,1784,107,na,1891,0.004200127027287667
SIM,1920,33,25-29,1953,16
SIM,1938,31,45-49,1969,2
SIM,1929,24,na,1953,4405
STAT,1820,43,50-100,1863,1.8482601147304645
STAT,1846,15,25-29,1861,5.078748806688512
STAT,1867,31,45-49,1898,1.5530922099201867
SIM,1908,30,20-24,1938,2
STAT,1931,33,35-39,1964,11.305253293326407
STAT,1826,48,35-39,1874,0.1291570424726188
SIM,1925,10,na,1935,4439
STAT,1925,35,25-29,1960,1.1184610937173858
STAT,1929,32,40-44,1961,4.696153608122754
SIM,1861,69,na,1930,1205
SIM,1906,50,na,1956,3066
STAT,1847,27,35-39,1874,8.53332380195633
STAT,1879,23,15-19,1902,3.24749629563009
SIM,1889,35,40-44,1924,5
STAT,1922,18,45-49,1940,0.5447594481493315
STAT,1935,25,40-44,1960,6.0071374145097405
STAT,1881,16,30-34,1897,1.4574090671610016
SIM,1910,38,35-39,1948,10
SIM,1841,92,na,1933,16
SIM,1832,45,na,1877,1499
STAT,1894,41,50-100,1935,1.2896307294969565
STAT,1908,42,50-100,1950,0.10265614710602611
STAT,1911,21,15-19,1932,4.782602288533555
STAT,1912,31,50-100,1943,0.7715255960247471
SIM,1855,27,35-39,1882,14
STAT,1845,53,40-44,1898,0.00729641644628762
STAT,1902,38,35-39,1940,2.0251265476652858
SIM,1841,60,na,1901,1326
SIM,1952,16,30-34,1968,21
STAT,1845,27,50-100,1872,0.5484452448551167
SIM,1811,94,na,1905,5
SIM,1914,19,15-19,1933,7
STAT,1853,51,25-29,1904,0.002639352666428893
STAT,1858,25,45-49,1883,0.8551816801843721
SIM,1853,18,na,1871,2189
STAT,1909,47,35-39,1956,0.11189113788768658
STAT,1848,49,25-29,1897,0.04062998208977051
SIM,1849,88,na,1937,70
SIM,1885,27,20-24,1912,7
STAT,1905,40,30-34,1945,0.11008734524030725
STAT,1908,10,na,1918,3629.1267507946995
STAT,1921,35,40-44,1956,1.5819331905012668
SIM,1919,46,na,1965,3778
STAT,1917,37,40-44,1954,1.468815054475793
SIM,1915,32,na,1947,3608
STAT,1911,49,40-44,1960,0.140146611554854
STAT,1918,25,40-44,1943,4.717720069853138
STAT,1869,16,30-34,1885,1.4864306017441706
SIM,1845,74,na,1919,790
SIM,1881,25,na,1906,2008
SIM,1935,32,30-34,1967,19
STAT,1870,44,50-100,1914,0.964725126441833
STAT,1899,26,50-100,1925,0.8309963913247352
STAT,1919,33,35-39,1952,9.274658409398116
SIM,1864,30,30-34,1894,24
STAT,1852,54,50-100,1906,0.011159106092203306
SIM,1896,20,25-29,1916,78
STAT,1841,40,na,1881,1685.849105848582
STAT,1911,41,30-34,1952,0.11591117602766714
STAT,1843,95,na,1938,9.592137763230749
STAT,1935,28,45-49,1963,2.2235357146028347
STAT,1837,88,na,1925,86.6613243439493
SIM,1851,59,na,1910,1438
SIM,1818,41,na,1859,1388
SIM,1874,24,40-44,1898,2
STAT,1863,40,na,1903,1938.651169648073
STAT,1812,54,40-44,1866,0.03182993407793646
STAT,1918,31,na,1949,3812.105366053298
SIM,1901,24,25-29,1925,72
STAT,1895,3,na,1898,3259.0807865652873
STAT,1891,68,na,1959,1888.0554805246445
STAT,1794,77,na,1871,323.1749505184812
STAT,1833,74,na,1907,673.741592017068
STAT,1856,30,30-34,1886,13.350908583009495
SIM,1842,55,na,1897,1405
STAT,1888,20,25-29,1908,64.26786826129316
STAT,1845,54,na,1899,1474.9442518312767
STAT,1844,15,15-19,1859,5.358779674855788
SIM,1815,43,50-100,1858,1
SIM,1931,31,35-39,1962,9
STAT,1867,54,na,1921,1857.3408681329965
SIM,1849,22,40-44,1871,1
SIM,1848,34,40-44,1882,4
SIM,1925,37,40-44,1962,2
STAT,1916,41,45-49,1957,0.1613476045042116
STAT,1930,21,25-29,1951,112.13030258070344
STAT,1950,17,30-34,1967,13.616095085380596
SIM,1862,38,45-49,1900,1
SIM,1898,41,40-44,1939,2
SIM,1926,25,40-44,1951,8
STAT,1881,50,50-100,1931,0.013973847219866978
SIM,1925,8,na,1933,4452
STAT,1906,15,50-100,1921,0.06770679303019621
SIM,1870,37,40-44,1907,5
STAT,1865,15,35-39,1880,0.5397400308949599
STAT,1890,38,50-100,1928,1.4110424008056335
STAT,1827,37,50-100,1864,1.227013830314296
STAT,1945,23,35-39,1968,9.745725421366075
SIM,1852,15,15-19,1867,4
SIM,1890,3,na,1893,3156
STAT,1855,39,15-19,1894,0.039370452005062444
STAT,1849,9,na,1858,2161.592865956987
STAT,1903,18,35-39,1921,0.7355510198984077
SIM,1840,96,na,1936,5
STAT,1901,23,20-24,1924,90.84052438153456
SIM,1876,20,35-39,1896,5
STAT,1923,31,35-39,1954,9.9381615881725
STAT,1888,16,na,1904,2825.5246249426154
STAT,1849,20,25-29,1869,50.61130184201999
STAT,1926,23,25-29,1949,105.6961297727055
SIM,1874,27,45-49,1901,5
STAT,1896,67,na,1963,2168.172882356449
STAT,1952,6,na,1958,4450.61597002145
STAT,1862,87,na,1949,141.97314081477057
STAT,1897,31,30-34,1928,22.149021773231652
STAT,1892,53,na,1945,2506.3824594349367
STAT,1922,16,50-100,1938,0.41064894028368915
SIM,1896,28,35-39,1924,11
STAT,1884,15,45-49,1899,0.06126448027646521
STAT,1831,30,na,1861,1746.2162601453265
STAT,1865,38,20-24,1903,0.6584490584136431
STAT,1868,20,35-39,1888,5.3398743130561375
SIM,1944,17,35-39,1961,5
STAT,1866,24,40-44,1890,1.8036125916777195
STAT,1942,28,15-19,1970,0.6995869973333921
STAT,1882,24,50-100,1906,0.37251466487003554
STAT,1887,41,15-19,1928,0.014656053423247193
STAT,1852,20,45-49,1872,0.6385205582541049
SIM,1966,2,na,1968,4549
SIM,1777,85,na,1862,63
STAT,1913,17,40-44,1930,0.2701005148392481
SIM,1829,37,35-39,1866,11
STAT,1835,44,na,1879,1531.9611785819664
STAT,1788,81,na,1869,198.87271379502707
STAT,1943,27,40-44,1970,4.689318175851417
SIM,1868,91,na,1959,68
STAT,1852,38,35-39,1890,5.34715604807329
SIM,1817,56,na,1873,1204
SIM,1882,37,50-100,1919,1
SIM,1839,23,35-39,1862,6
SIM,1813,42,na,1855,1397
SIM,1860,38,35-39,1898,11
STAT,1908,32,20-24,1940,2.174535034151735
STAT,1874,37,50-100,1911,1.1854243506774926
STAT,1923,48,20-24,1971,0.012180015107211152
SIM,1902,36,na,1938,3213
SIM,1791,78,na,1869,277
SIM,1857,20,25-29,1877,56
SIM,1934,23,25-29,1957,137
SIM,1940,31,na,1971,3515
STAT,1906,19,15-19,1925,8.119841980940151
SIM,1915,28,20-24,1943,21
STAT,1930,41,40-44,1971,0.3113637433989095
STAT,1931,17,20-24,1948,167.64420711789936
SIM,1823,63,na,1886,928
STAT,1927,32,30-34,1959,18.310852411155302
STAT,1762,100,na,1862,0.039451461086022696
STAT,1867,28,15-19,1895,0.40101780240481494
STAT,1823,39,50-100,1862,1.7385118347423492
STAT,1897,49,20-24,1946,0.008373497670274396
SIM,1922,29,50-100,1951,4
STAT,1917,46,30-34,1963,0.08817845967570102
SIM,1949,12,na,1961,4295
STAT,1904,31,25-29,1935,13.933626930521916
STAT,1877,27,20-24,1904,11.500540878743724
SIM,1849,41,45-49,1890,5
STAT,1914,29,50-100,1943,0.9409770882300948
STAT,1936,17,35-39,1953,3.7945096225259896
STAT,1841,18,na,1859,2013.630754449913
STAT,1891,30,25-29,1921,12.073016911187365
STAT,1897,20,na,1917,3005.8670922054785
STAT,1870,21,na,1891,2195.862888519558
SIM,1792,63,na,1855,801
SIM,1796,77,na,1873,317
SIM,1906,20,45-49,1926,4
STAT,1859,26,15-19,1885,0.3504781641906025
STAT,1781,109,na,1890,0.0029209067011516984
STAT,1914,17,na,1931,3773.631989988655
STAT,1840,55,na,1895,1439.9902738088595
SIM,1859,87,na,1946,141
STAT,1870,39,40-44,1909,4.011338009894926
SIM,1855,73,na,1928,884
STAT,1907,28,20-24,1935,16.219706983053907
SIM,1910,35,30-34,1945,1
SIM,1899,20,na,1919,3048
STAT,1871,17,25-29,1888,5.341412871223582
STAT,1903,65,na,1968,2552.227872776852
STAT,1928,44,40-44,1972,0.30025531349447127
SIM,1837,36,30-34,1873,5
STAT,1921,42,50-100,1963,0.125012662243508
STAT,1829,49,15-19,1878,3.1443009768533615E-4
SIM,1912,31,25-29,1943,12
STAT,1925,19,25-29,1944,49.194418556738874
SIM,1933,19,25-29,1952,62
SIM,1894,49,50-100,1943,1
SIM,1865,40,na,1905,1997
STAT,1820,52,25-29,1872,0.005613879415680293
STAT,1858,48,30-34,1906,0.07088770613332702
SIM,1869,54,na,1923,1920
STAT,1848,33,50-100,1881,0.6932603278501241
STAT,1820,56,na,1876,1174.7068143547476
STAT,1911,45,25-29,1956,0.04765337123209667
SIM,1916,32,20-24,1948,2
STAT,1839,25,35-39,1864,8.222589542644144
STAT,1902,35,30-34,1937,1.548141601358104
STAT,1951,5,na,1956,4423.317276983016
STAT,1770,86,na,1856,47.81255377000001
SIM,1939,16,15-19,1955,31
STAT,1872,76,na,1948,898.3303296231389
SIM,1889,38,45-49,1927,3
STAT,1899,26,45-49,1925,1.4423462029937673
STAT,1871,91,na,1962,115.71206939306026
STAT,1880,53,35-39,1933,0.00841999316231981
SIM,1929,30,40-44,1959,5
STAT,1848,8,na,1856,2193.0692754131996
STAT,1872,30,15-19,1902,0.13611668534283047
SIM,1828,47,50-100,1875,2
SIM,1926,29,35-39,1955,22
STAT,1812,50,25-29,1862,0.01160233142017105
STAT,1840,44,na,1884,1636.5567614547745
SIM,1905,41,35-39,1946,1
SIM,1838,18,na,1856,1917
SIM,1917,38,45-49,1955,4
STAT,1940,27,15-19,1967,0.6799967939392919
STAT,1783,108,na,1891,0.0026363044708920544
STAT,1880,28,45-49,1908,1.0997547413390016
STAT,1840,37,50-100,1877,1.0112801488091565
SIM,1847,25,35-39,1872,8
STAT,1917,17,25-29,1934,8.809245363977434
STAT,1918,27,50-100,1945,1.000664093438981
SIM,1869,17,35-39,1886,1
STAT,1938,33,45-49,1971,1.4936250818414247
STAT,1906,2,na,1908,3666.905962051439
STAT,1952,12,na,1964,4447.190092614484
STAT,1821,107,na,1928,0.0025466088165855627
STAT,1886,49,50-100,1935,0.24002096993005897
STAT,1896,27,30-34,1923,31.44041292370179
STAT,1918,21,25-29,1939,94.39497302770869
STAT,1851,16,45-49,1867,0.05858521131516046
STAT,1857,44,50-100,1901,0.7761731300167869
SIM,1926,21,25-29,1947,120
STAT,1909,38,45-49,1947,0.6064008199548345
SIM,1926,27,50-100,1953,1
STAT,1883,17,na,1900,2338.375652703663
SIM,1869,65,na,1934,1510
STAT,1905,15,40-44,1920,0.2508512028285079
SIM,1838,40,30-34,1878,1
STAT,1829,36,30-34,1865,4.841891333481784
SIM,1889,53,na,1942,2463
STAT,1883,21,50-100,1904,0.378699613876537
STAT,1849,30,50-100,1879,0.7807944358677574
STAT,1924,27,30-34,1951,43.10260029680078
STAT,1920,45,50-100,1965,0.2373173348585679
SIM,1890,39,na,1929,2798
STAT,1840,28,15-19,1868,0.3911348544576997
SIM,1803,75,na,1878,372
STAT,1847,24,30-34,1871,15.836881567502433
STAT,1918,29,35-39,1947,14.985839925309909
STAT,1909,19,40-44,1928,0.25766604291793366
SIM,1927,33,35-39,1960,11
STAT,1804,52,40-44,1856,0.03130646674770357
STAT,1931,30,30-34,1961,19.52513763398335
SIM,1941,18,20-24,1959,121
STAT,1805,78,na,1883,319.5700019619436
STAT,1905,27,20-24,1932,16.01525432803638
SIM,1772,86,na,1858,42
STAT,1933,18,20-24,1951,171.00218482272243
SIM,1889,30,35-39,1919,17
STAT,1937,23,na,1960,3357.8855505815463
STAT,1895,15,20-24,1910,21.957274650067447
STAT,1913,36,45-49,1949,0.6384654981845401
SIM,1921,28,na,1949,3819
SIM,1906,17,15-19,1923,9
STAT,1935,34,30-34,1969,20.56400216960566
SIM,1921,36,45-49,1957,1
SIM,1932,27,30-34,1959,53
STAT,1914,37,15-19,1951,0.018109786925113825
SIM,1834,30,45-49,1864,2
STAT,1860,41,15-19,1901,0.010650604658709876
STAT,1801,64,na,1865,866.165061610427
SIM,1879,41,30-34,1920,3
STAT,1849,40,40-44,1889,1.6495925154969702
SIM,1833,26,45-49,1859,1
SIM,1855,24,30-34,1879,25
SIM,1877,16,30-34,1893,4
SIM,1898,21,25-29,1919,69
SIM,1807,89,na,1896,36
SIM,1878,37,30-34,1915,6
STAT,1925,44,15-19,1969,0.0017507855791245256
SIM,1858,16,20-24,1874,20
SIM,1866,36,na,1902,2086
STAT,1871,43,40-44,1914,2.0913273524225753
SIM,1807,78,na,1885,277
SIM,1866,25,45-49,1891,1
SIM,1870,73,na,1943,1025
SIM,1874,87,na,1961,235
SIM,1816,93,na,1909,5
SIM,1942,22,20-24,1964,102
SIM,1917,19,40-44,1936,1
SIM,1803,64,na,1867,796
STAT,1915,49,25-29,1964,0.05019489354659303
SIM,1872,21,na,1893,2200
SIM,1821,37,45-49,1858,2
SIM,1836,24,20-24,1860,53
SIM,1920,24,35-39,1944,11
STAT,1839,50,25-29,1889,0.0024204809292841505
SIM,1943,28,45-49,1971,2
STAT,1887,53,na,1940,2238.350940594123
SIM,1857,40,40-44,1897,10
SIM,1920,30,20-24,1950,1
STAT,1892,17,45-49,1909,0.07727696668396146
STAT,1852,17,15-19,1869,5.453352823097662
SIM,1913,27,20-24,1940,19
STAT,1840,15,30-34,1855,1.4542245892935532
SIM,1811,45,50-100,1856,4
STAT,1861,53,25-29,1914,0.002734012611717257
SIM,1908,33,25-29,1941,10
STAT,1826,30,45-49,1856,2.631751767735859
SIM,1870,30,50-100,1900,1
STAT,1912,24,35-39,1936,8.825976254077167
SIM,1935,31,na,1966,4932
STAT,1903,47,40-44,1950,0.1291895836525138
STAT,1934,22,20-24,1956,141.16479049805017
STAT,1912,30,20-24,1942,2.2850711271963067
SIM,1888,26,35-39,1914,11
STAT,1870,10,na,1880,2482.191477234487
STAT,1925,39,40-44,1964,1.6939426797368071
SIM,1907,29,25-29,1936,59
STAT,1816,41,na,1857,1473.981865438105
STAT,1860,49,25-29,1909,0.043299615214454086
STAT,1893,21,45-49,1914,0.8383442210000158
STAT,1833,33,40-44,1866,3.3654284389199316
SIM,1887,6,na,1893,2726
STAT,1821,95,na,1916,7.179573184228163
STAT,1859,34,15-19,1893,0.10644542755945553
SIM,1838,42,50-100,1880,3
SIM,1882,42,na,1924,2093
STAT,1831,25,30-34,1856,23.612653065056325
SIM,1914,15,na,1929,4091
STAT,1909,32,15-19,1941,0.11581588405180619
SIM,1799,74,na,1873,417
SIM,1924,47,na,1971,4100
SIM,1851,37,30-34,1888,6
SIM,1922,34,na,1956,4027
STAT,1808,49,30-34,1857,0.3564558264009938
STAT,1895,39,45-49,1934,2.4328356377817135
STAT,1879,38,35-39,1917,6.949388780422633
STAT,1901,22,45-49,1923,0.9220592182353644
STAT,1920,31,50-100,1951,0.859076126880791
STAT,1817,52,50-100,1869,0.03236550237330112
STAT,1856,33,35-39,1889,7.50634411402384
STAT,1898,43,40-44,1941,0.19830259754829074
SIM,1916,3,na,1919,3949
STAT,1904,23,25-29,1927,77.318024460546
STAT,1836,34,20-24,1870,2.1132583393878073
SIM,1823,31,na,1854,1581
STAT,1819,37,25-29,1856,7.485244983590441
STAT,1894,27,20-24,1921,14.2562973227157
SIM,1862,25,25-29,1887,41
SIM,1881,19,15-19,1900,4
STAT,1854,25,25-29,1879,35.60067404229078
STAT,1871,22,20-24,1893,64.53954493718868
SIM,1856,36,na,1892,1871
STAT,1946,26,50-100,1972,1.0479317647532405
STAT,1906,31,35-39,1937,8.031803361119488
STAT,1895,72,na,1967,1869.7635003404398
SIM,1829,25,40-44,1854,3
SIM,1853,27,25-29,1880,5
STAT,1915,12,na,1927,3904.4386274562194
STAT,1813,41,15-19,1854,0.05103733164570239
STAT,1850,27,20-24,1877,9.719155635028715
STAT,1841,29,20-24,1870,9.826728461582228
STAT,1857,33,na,1890,1769.7071943189935
SIM,1857,53,na,1910,1668
STAT,1835,38,35-39,1873,5.399457503238475
SIM,1903,25,25-29,1928,56
STAT,1944,20,15-19,1964,5.433239513115139
SIM,1844,21,15-19,1865,3
SIM,1838,23,40-44,1861,1
STAT,1910,20,45-49,1930,1.00386309154251
STAT,1843,37,30-34,1880,4.488758415970761
STAT,1908,64,na,1972,2778.961649593519
STAT,1929,24,40-44,1953,3.991903374096139
SIM,1920,22,20-24,1942,126
SIM,1841,33,40-44,1874,7
STAT,1858,50,na,1908,1619.8003741181808
SIM,1865,72,na,1937,1060
STAT,1840,23,30-34,1863,15.661912820665394
STAT,1921,20,20-24,1941,119.36470504803394
STAT,1828,48,45-49,1876,0.19617484675126579
SIM,1943,22,15-19,1965,5
STAT,1849,43,45-49,1892,1.0709717604607776
STAT,1842,31,40-44,1873,3.7695987739836396
SIM,1864,33,35-39,1897,9
STAT,1868,37,20-24,1905,0.6952879926347244
SIM,1881,22,30-34,1903,17
SIM,1916,28,na,1944,3534
STAT,1883,27,45-49,1910,1.0279931446569952
STAT,1938,22,40-44,1960,3.143315750430654
SIM,1937,24,40-44,1961,6
SIM,1844,25,na,1869,1948
SIM,1842,39,30-34,1881,5
SIM,1855,35,35-39,1890,18
STAT,1923,31,na,1954,4113.058155027022
SIM,1899,17,20-24,1916,32
SIM,1804,60,na,1864,948
SIM,1908,0,na,1908,3723
SIM,1919,20,30-34,1939,37
SIM,1946,22,40-44,1968,2
STAT,1857,23,na,1880,1825.1032821507763
STAT,1885,40,na,1925,2197.240631930518
STAT,1849,14,na,1863,2098.855324983797
STAT,1914,30,30-34,1944,15.099804025534882
SIM,1833,41,na,1874,1556
SIM,1847,21,40-44,1868,6
SIM,1890,71,na,1961,1726
STAT,1912,22,20-24,1934,100.64727637512347
STAT,1895,50,na,1945,2692.643662417085
SIM,1885,22,15-19,1907,3
STAT,1864,32,30-34,1896,14.741427331945259
SIM,1882,52,na,1934,1937
STAT,1884,38,30-34,1922,4.950694701542612
SIM,1891,27,45-49,1918,2
SIM,1874,29,25-29,1903,49
SIM,1921,21,25-29,1942,109
STAT,1828,35,25-29,1863,2.858644234727044
STAT,1874,48,15-19,1922,3.813595167132717E-4
STAT,1878,31,20-24,1909,2.6691935641275153
STAT,1834,39,30-34,1873,4.0191345774929745
STAT,1862,24,20-24,1886,56.03438763124986
STAT,1890,17,35-39,1907,0.6337738831267354
STAT,1932,21,35-39,1953,11.706706418057934
SIM,1871,23,25-29,1894,50
STAT,1847,35,35-39,1882,5.5128714792132225
STAT,1845,32,20-24,1877,2.263845471867451
STAT,1950,11,na,1961,4388.786519002119
SIM,1891,26,20-24,1917,14
STAT,1841,49,15-19,1890,2.679622464944145E-4
STAT,1880,50,30-34,1930,0.00600185206992354
STAT,1861,28,35-39,1889,7.56960932487289
STAT,1880,32,15-19,1912,0.14155300325691605
SIM,1824,36,45-49,1860,1
SIM,1827,55,na,1882,1164
SIM,1935,36,25-29,1971,1
STAT,1820,78,na,1898,416.2428265774809
SIM,1940,21,35-39,1961,10
STAT,1833,104,na,1937,0.040492930701883575
SIM,1961,7,na,1968,4706
STAT,1839,21,40-44,1860,1.7981578930197797
STAT,1845,27,25-29,1872,36.26745219747596
STAT,1857,39,25-29,1896,2.1227030647941656
STAT,1889,15,45-49,1904,0.07653776989140461
STAT,1913,21,25-29,1934,84.7921880320398
STAT,1827,36,20-24,1863,0.7898676738531234
STAT,1839,48,20-24,1887,0.008048476638934106
STAT,1893,18,15-19,1911,7.094610893630271
SIM,1870,24,20-24,1894,56
SIM,1874,33,na,1907,2274
STAT,1947,15,45-49,1962,0.5319052522000207
SIM,1829,36,na,1865,1572
SIM,1882,20,na,1902,2176
STAT,1869,49,45-49,1918,0.2113011960481787
STAT,1890,24,50-100,1914,0.46806034052227474
STAT,1896,22,25-29,1918,71.47298996859898
STAT,1863,23,25-29,1886,48.13678360608722
SIM,1835,23,15-19,1858,2
STAT,1863,36,30-34,1899,4.44705517955211
STAT,1878,92,na,1970,155.80116618800864
STAT,1931,27,50-100,1958,1.2139963852550253
STAT,1838,39,15-19,1877,0.04526446805401536
STAT,1945,15,50-100,1960,0.38683412719187743
SIM,1870,100,na,1970,9
SIM,1922,30,30-34,1952,20
STAT,1857,2,na,1859,2621.494097713613
STAT,1844,58,na,1902,1388.291587154901
SIM,1905,33,35-39,1938,7
STAT,1897,34,35-39,1931,12.685147778893347
SIM,1878,48,50-100,1926,2
SIM,1892,38,30-34,1930,5
SIM,1904,5,na,1909,3497
SIM,1836,35,25-29,1871,2
STAT,1861,15,15-19,1876,5.414573737776654
SIM,1841,20,35-39,1861,8
STAT,1933,33,45-49,1966,2.0020883730093355
SIM,1865,94,na,1959,26
STAT,1895,26,25-29,1921,52.32814489486619
SIM,1867,85,na,1952,199
SIM,1869,34,25-29,1903,13
STAT,1810,46,na,1856,1343.005573494211
SIM,1854,35,na,1889,1848
SIM,1819,36,na,1855,1519
SIM,1933,1,na,1934,5182
SIM,1940,29,30-34,1969,34
STAT,1855,17,40-44,1872,0.15407333297897582
STAT,1874,34,40-44,1908,4.151387075327079
SIM,1904,29,20-24,1933,18
STAT,1888,16,40-44,1904,0.20462299684855947
SIM,1869,22,30-34,1891,18
STAT,1817,47,30-34,1864,0.21658011692213355
STAT,1932,29,30-34,1961,48.43568919455006
SIM,1829,68,na,1897,813
SIM,1853,32,20-24,1885,2
STAT,1846,39,35-39,1885,5.100711192762701
STAT,1927,36,25-29,1963,1.1576407935062811
STAT,1896,35,30-34,1931,6.717344789649433
SIM,1892,52,na,1944,2589
STAT,1848,47,45-49,1895,0.16922731212269965
STAT,1831,50,35-39,1881,0.005793211775961575
STAT,1851,24,45-49,1875,0.6019228356560774
STAT,1925,44,na,1969,4234.131793686771
STAT,1878,17,35-39,1895,0.5396293922088521
STAT,1932,38,50-100,1970,0.5323914124383141
STAT,1815,39,20-24,1854,2.575811480807138
STAT,1940,11,na,1951,3790.2429739141453
STAT,1922,39,15-19,1961,0.020599968023928737
STAT,1863,36,50-100,1899,1.024441341886868
STAT,1829,44,30-34,1873,0.9380809440471557
SIM,1932,38,50-100,1970,2
SIM,1887,38,35-39,1925,21
SIM,1890,61,na,1951,2192
SIM,1813,48,50-100,1861,4
SIM,1863,36,50-100,1899,1
SIM,1886,31,20-24,1917,2
SIM,1879,24,40-44,1903,3
SIM,1888,43,50-100,1931,1
STAT,1819,42,20-24,1861,0.31177921421874377
STAT,1873,25,35-39,1898,9.315209409573516
STAT,1885,16,15-19,1901,5.599194726372224
STAT,1847,15,40-44,1862,0.16996286983759573
STAT,1858,72,na,1930,936.6002621421255
STAT,1864,15,40-44,1879,0.17763731621859982
STAT,1923,23,35-39,1946,10.318818313157958
STAT,1912,40,35-39,1952,0.18550713584740922
SIM,1875,72,na,1947,1143
STAT,1856,47,50-100,1903,0.18087078502051374
SIM,1887,43,30-34,1930,1
STAT,1935,32,na,1967,4942.802856996927
SIM,1880,26,30-34,1906,28
STAT,1872,22,na,1894,2242.5445410496022
STAT,1884,23,45-49,1907,0.6489658653554796
SIM,1865,37,45-49,1902,2
SIM,1840,21,30-34,1861,13
STAT,1876,39,35-39,1915,6.82848049989917
STAT,1857,42,40-44,1899,1.6730875439645434
SIM,1845,30,20-24,1875,2
STAT,1939,21,45-49,1960,1.0677283866074223
SIM,1810,98,na,1908,1
SIM,1868,38,25-29,1906,1
SIM,1882,28,20-24,1910,12
STAT,1869,24,30-34,1893,16.18624006645541
STAT,1870,26,20-24,1896,10.896713315509501
STAT,1907,40,40-44,1947,0.21890121079815
STAT,1918,43,20-24,1961,0.017709898688134378
STAT,1835,25,15-19,1860,0.3742930410831197
SIM,1822,33,30-34,1855,19
STAT,1844,49,40-44,1893,0.11767462195365384
STAT,1834,32,45-49,1866,1.3826460794100248
STAT,1932,14,na,1946,4940.525412224266
STAT,1879,43,30-34,1922,1.1270187252734793
STAT,1940,23,35-39,1963,9.05753634212822
SIM,1842,32,45-49,1874,1
STAT,1872,51,35-39,1923,0.008202187244879543
STAT,1862,37,40-44,1899,3.527557376147188
STAT,1927,41,20-24,1968,0.020956233546465912
SIM,1907,45,na,1952,3179
SIM,1857,75,na,1932,783
STAT,1838,37,35-39,1875,5.82090355183246
SIM,1844,35,na,1879,1834
STAT,1807,80,na,1887,268.656267635177
STAT,1874,28,20-24,1902,11.287214789333186
STAT,1927,13,na,1940,4647.437680123247
SIM,1884,39,35-39,1923,13
SIM,1838,43,35-39,1881,3
SIM,1931,17,na,1948,4566
SIM,1941,30,40-44,1971,2
SIM,1834,44,50-100,1878,3
STAT,1839,54,50-100,1893,0.009793171180705156
SIM,1936,32,25-29,1968,8
STAT,1829,31,25-29,1860,10.264259284001312
SIM,1902,14,na,1916,3450
STAT,1905,35,35-39,1940,2.1038772391109246
STAT,1841,22,35-39,1863,5.057811900990902
STAT,1866,35,45-49,1901,1.7527949612122096
STAT,1908,36,15-19,1944,0.017062882445575734
STAT,1761,101,na,1862,0.08077051559599416
SIM,1921,29,20-24,1950,21
SIM,1947,21,45-49,1968,1
STAT,1864,27,35-39,1891,8.146694142952335
SIM,1872,42,na,1914,2153
SIM,1894,33,20-24,1927,3
SIM,1898,67,na,1965,2280
STAT,1848,44,40-44,1892,1.598558468723802
SIM,1872,27,35-39,1899,11
STAT,1880,15,25-29,1895,5.658889575130804
SIM,1867,53,na,1920,1843
STAT,1885,8,na,1893,2446.6392635185193
STAT,1892,25,45-49,1917,1.3224073181156784
STAT,1816,41,50-100,1857,3.2932507949209193
SIM,1849,56,na,1905,1539
STAT,1955,17,45-49,1972,0.626423052393802
STAT,1771,110,na,1881,0.0013503478288836965
SIM,1914,47,na,1961,3730
STAT,1930,21,50-100,1951,0.7987627460727126
STAT,1937,30,25-29,1967,8.647059233265542
SIM,1837,31,25-29,1868,11
SIM,1867,39,35-39,1906,8
STAT,1928,32,25-29,1960,10.918824423689605
SIM,1809,91,na,1900,29
SIM,1907,35,na,1942,3367
SIM,1913,35,35-39,1948,4
STAT,1889,32,35-39,1921,11.810913580025149
STAT,1920,42,35-39,1962,0.21010732799883522
STAT,1827,49,40-44,1876,0.14605608665349964
STAT,1913,29,20-24,1942,17.055722851650994
SIM,1901,28,40-44,1929,5
SIM,1959,11,na,1970,4855
STAT,1833,47,15-19,1880,2.851045069912871E-4
SIM,1897,32,35-39,1929,21
SIM,1936,15,35-39,1951,4
SIM,1888,34,35-39,1922,12
STAT,1886,33,20-24,1919,2.6866027060719095
STAT,1947,20,40-44,1967,3.592603374519003
STAT,1853,39,40-44,1892,3.2137168980096256
SIM,1856,31,35-39,1887,7
STAT,1889,45,40-44,1934,0.20165634909346733
SIM,1901,20,45-49,1921,5
STAT,1909,15,25-29,1924,8.063378461876896
SIM,1894,28,25-29,1922,69
SIM,1839,56,na,1895,1436
STAT,1839,16,45-49,1855,0.057314140207131534
STAT,1922,19,20-24,1941,147.44116265854956
SIM,1826,38,35-39,1864,11
STAT,1825,34,45-49,1859,2.5590276737863116
SIM,1831,23,30-34,1854,20
SIM,1846,37,35-39,1883,7
STAT,1902,22,50-100,1924,0.543645030097616
SIM,1871,20,20-24,1891,63
SIM,1802,79,na,1881,279
SIM,1837,27,40-44,1864,2
STAT,1936,31,20-24,1967,2.239059774617382
SIM,1831,60,na,1891,1162
SIM,1895,49,na,1944,2743
SIM,1902,21,15-19,1923,4
STAT,1870,48,30-34,1918,0.08847891938194212
SIM,1879,44,35-39,1923,2
SIM,1893,29,35-39,1922,12
SIM,1843,38,35-39,1881,12
STAT,1871,38,na,1909,2195.5308750600852
STAT,1928,15,35-39,1943,5.018544899143309
SIM,1896,33,30-34,1929,33
STAT,1885,29,35-39,1914,9.016466027338032
SIM,1887,83,na,1970,661
STAT,1801,109,na,1910,2.7072438897255595E-4
STAT,1839,54,40-44,1893,0.006826510209125225
STAT,1866,18,50-100,1884,0.04354074068234638
SIM,1936,20,30-34,1956,26
SIM,1833,34,45-49,1867,2
STAT,1896,18,40-44,1914,0.2277620553722864
STAT,1861,50,20-24,1911,5.871992919214849E-4
SIM,1894,21,na,1915,3017
STAT,1803,76,na,1879,373.9879927702514
STAT,1837,30,20-24,1867,2.184327730605281
STAT,1852,40,50-100,1892,0.8107620889927459
SIM,1846,42,30-34,1888,5
STAT,1934,26,15-19,1960,0.8975402353604915
STAT,1899,49,30-34,1948,0.06921416214702605
SIM,1931,23,35-39,1954,9
STAT,1855,37,35-39,1892,5.0093032105395165
STAT,1829,27,40-44,1856,4.316602460751779
SIM,1917,15,25-29,1932,10
SIM,1888,22,40-44,1910,2
STAT,1809,48,35-39,1857,0.5014090765043366
STAT,1864,29,15-19,1893,0.3803280939608443
STAT,1885,72,na,1957,1247.652873036252
SIM,1902,22,50-100,1924,1
STAT,1886,28,25-29,1914,42.073448141901025
STAT,1818,38,35-39,1856,21.642324378512207
STAT,1884,32,50-100,1916,0.8553516166619819
STAT,1918,30,15-19,1948,0.1300354100091763
SIM,1878,32,25-29,1910,14
SIM,1893,16,15-19,1909,11
SIM,1920,31,50-100,1951,4
SIM,1861,26,20-24,1887,11
STAT,1891,28,20-24,1919,13.669378712535034
SIM,1827,37,25-29,1864,1
SIM,1830,76,na,1906,596
STAT,1869,33,20-24,1902,2.4613454745441867
SIM,1832,22,35-39,1854,6
SIM,1930,19,20-24,1949,161
SIM,1929,22,40-44,1951,5
STAT,1939,23,50-100,1962,0.6239905513476872
SIM,1836,38,na,1874,1613
STAT,1838,42,30-34,1880,0.917007230420949
STAT,1944,16,30-34,1960,12.394744533413778
STAT,1854,38,45-49,1892,1.4283781962175661
STAT,1881,24,30-34,1905,16.145655444942054
STAT,1875,25,45-49,1900,1.0849021305073434
STAT,1928,20,30-34,1948,34.10587282921791
STAT,1849,36,na,1885,1755.811194309679
STAT,1798,80,na,1878,255.74193380868985
STAT,1853,26,20-24,1879,10.151607767523286
STAT,1919,42,25-29,1961,0.07310505398871124
SIM,1883,25,45-49,1908,2
SIM,1789,96,na,1885,2
STAT,1800,58,na,1858,1016.188703824936
STAT,1830,29,45-49,1859,0.9741459682879765
SIM,1816,61,na,1877,943
STAT,1895,43,15-19,1938,0.0011736937197048046
STAT,1860,22,45-49,1882,0.5518955340930436
STAT,1824,37,20-24,1861,1.158462858631037
SIM,1877,33,20-24,1910,2
SIM,1834,37,30-34,1871,8
SIM,1907,13,na,1920,3639
STAT,1878,39,45-49,1917,1.9407679781902358
STAT,1898,46,45-49,1944,0.1707254631090272
STAT,1847,23,40-44,1870,1.8661108484866757
STAT,1926,32,15-19,1958,0.14680765790650252
SIM,1832,29,20-24,1861,13
SIM,1916,39,40-44,1955,1
STAT,1888,70,na,1958,1650.302838114875
STAT,1850,50,45-49,1900,0.010363592437999824
STAT,1907,47,na,1954,3107.604639138191
STAT,1893,28,30-34,1921,30.07718265914777
SIM,1887,35,30-34,1922,10
STAT,1937,13,na,1950,3635.3041717614997
SIM,1820,43,50-100,1863,4
SIM,1917,45,na,1962,3587
STAT,1830,56,na,1886,1233.178825201364
STAT,1929,27,45-49,1956,2.042692670688638
SIM,1879,54,na,1933,2050
STAT,1826,31,50-100,1857,1.2896635706235533
STAT,1899,39,15-19,1938,0.015533396032979544
STAT,1931,40,45-49,1971,0.2106285020901146
SIM,1853,15,30-34,1868,1
SIM,1886,34,25-29,1920,13
SIM,1937,27,45-49,1964,1
STAT,1881,49,45-49,1930,0.21077138930913814
STAT,1944,3,na,1947,4082.450902916135
SIM,1865,39,25-29,1904,1
STAT,1834,24,45-49,1858,0.5690149326986776
STAT,1945,24,25-29,1969,95.57135675299206
SIM,1845,25,25-29,1870,42
SIM,1854,44,30-34,1898,3
SIM,1900,16,30-34,1916,2
STAT,1915,29,30-34,1944,37.48169051389828
STAT,1865,42,na,1907,1981.6291164215897
SIM,1861,37,na,1898,2041
STAT,1851,21,40-44,1872,1.838036124416632
STAT,1879,35,30-34,1914,5.312575595528528
SIM,1838,35,35-39,1873,8
STAT,1830,26,40-44,1856,3.160704889515796
SIM,1928,21,35-39,1949,15
STAT,1816,94,na,1910,9.313444189295776
STAT,1825,49,30-34,1874,0.09874335865499907
STAT,1845,15,30-34,1860,1.4358490511434414
SIM,1849,26,20-24,1875,10
SIM,1874,42,50-100,1916,1
STAT,1838,45,35-39,1883,0.10078463757627612
SIM,1867,17,25-29,1884,3
STAT,1848,31,35-39,1879,8.596979885486714
SIM,1787,95,na,1882,3
STAT,1826,37,30-34,1863,5.775996077390992
STAT,1846,44,30-34,1890,0.7996578351336425
SIM,1827,34,20-24,1861,5
STAT,1843,22,45-49,1865,0.6314764000079738
STAT,1866,7,na,1873,2431.606798705569
STAT,1908,39,40-44,1947,1.3104347339621414
SIM,1872,74,na,1946,990
SIM,1932,12,na,1944,4815
STAT,1927,33,20-24,1960,2.8330712059780283
STAT,1888,33,30-34,1921,19.402994288684017
STAT,1857,37,45-49,1894,1.4846507715995065
STAT,1877,22,15-19,1899,3.2340892658851077
SIM,1905,21,40-44,1926,2
SIM,1813,96,na,1909,5
SIM,1892,20,na,1912,2872
STAT,1892,49,20-24,1941,0.007840576296344787
STAT,1909,20,20-24,1929,98.18678407176704
SIM,1861,34,20-24,1895,1
SIM,1886,49,50-100,1935,1
SIM,1920,25,25-29,1945,73
STAT,1929,41,30-34,1970,0.1566424740170237
STAT,1897,26,35-39,1923,12.232439406658264
STAT,1789,104,na,1893,0.014716839781717953
SIM,1869,31,20-24,1900,2
STAT,1866,42,50-100,1908,0.9190251444639032
SIM,1781,90,na,1871,18
STAT,1918,26,30-34,1944,39.52696383613097
SIM,1906,20,50-100,1926,1
SIM,1893,24,15-19,1917,3
STAT,1872,26,30-34,1898,23.959476803503737
SIM,1834,25,na,1859,1737
STAT,1929,28,50-100,1957,1.1763163716810299
STAT,1914,33,35-39,1947,8.651754264901157
SIM,1861,7,na,1868,2439
SIM,1876,26,50-100,1902,1
STAT,1837,25,25-29,1862,34.771853750672584
SIM,1935,33,20-24,1968,2
STAT,1836,37,25-29,1873,2.2317102599293803
SIM,1918,27,50-100,1945,1
STAT,1863,20,20-24,1883,59.2135751925249
STAT,1853,34,20-24,1887,2.0219038082444873
STAT,1878,5,na,1883,2675.222808223851
STAT,1941,19,30-34,1960,11.851429414261476
SIM,1878,28,40-44,1906,6
SIM,1889,43,40-44,1932,6
SIM,1922,33,35-39,1955,11
STAT,1885,24,15-19,1909,3.0855356507444918
SIM,1829,42,30-34,1871,3
STAT,1878,49,50-100,1927,0.2364928535435268
STAT,1837,35,na,1872,1680.6521555975914
SIM,1853,24,20-24,1877,54
STAT,1842,34,45-49,1876,1.4692899649591638
STAT,1859,17,25-29,1876,4.959228491643957
STAT,1880,2,na,1882,3190.138915791907
STAT,1807,90,na,1897,28.281279727357163
STAT,1820,46,na,1866,1390.88566264657
STAT,1851,39,30-34,1890,3.8689320204079123
STAT,1864,68,na,1932,1290.2736377481954
STAT,1887,45,30-34,1932,0.10328844023404386
STAT,1867,33,na,1900,2107.7267509542235
STAT,1845,35,25-29,1880,2.390738071297451
SIM,1891,29,25-29,1920,64
STAT,1786,106,na,1892,0.005975002184068139
STAT,1845,24,20-24,1869,59.39788737389608
SIM,1882,84,na,1966,505
STAT,1933,30,40-44,1963,4.987722848385636
STAT,1832,39,20-24,1871,0.5783084244359903
STAT,1928,17,50-100,1945,0.44601204596355115
STAT,1867,38,30-34,1905,4.703890464303597
SIM,1926,26,30-34,1952,49
STAT,1850,4,na,1854,2293.0
STAT,1855,21,25-29,1876,47.70734677994778
STAT,1878,34,25-29,1912,9.986873096335135
STAT,1854,42,15-19,1896,0.009932135408532978
STAT,1860,49,50-100,1909,0.18462474950852983
STAT,1868,28,30-34,1896,22.63354372215749
SIM,1824,38,25-29,1862,2
STAT,1854,68,na,1922,1100.4462303618554
STAT,1872,17,40-44,1889,0.17399957482831485
SIM,1846,34,30-34,1880,19
SIM,1923,29,30-34,1952,55
SIM,1898,36,45-49,1934,4
STAT,1878,26,25-29,1904,41.744204332133066
STAT,1868,24,15-19,1892,2.9570158584728596
STAT,1862,27,25-29,1889,34.21374994954449
SIM,1926,22,15-19,1948,5
STAT,1882,22,na,1904,2174.071097822873
STAT,1942,20,50-100,1962,0.6521641678029961
STAT,1907,25,na,1932,3333.686760859139
STAT,1858,38,15-19,1896,0.04143932242741152
STAT,1918,22,15-19,1940,5.423541253212836
STAT,1872,15,50-100,1887,0.04716093736845131
STAT,1856,16,45-49,1872,0.05748771603774461
SIM,1900,32,45-49,1932,2
STAT,1782,109,na,1891,0.0018009195659810092
SIM,1886,39,45-49,1925,5
SIM,1917,5,na,1922,4020
STAT,1874,21,35-39,1895,5.651350572632451
STAT,1846,36,30-34,1882,3.9650939856425182
STAT,1852,24,na,1876,1902.2058314145825
SIM,1938,20,40-44,1958,3
STAT,1844,23,15-19,1867,2.8708467115444547
SIM,1870,27,25-29,1897,36
STAT,1938,34,35-39,1972,8.668260685235595
STAT,1816,38,25-29,1854,10.63726098364983
SIM,1945,26,40-44,1971,6
SIM,1912,46,na,1958,3191
SIM,1848,42,40-44,1890,7
STAT,1896,39,50-100,1935,1.5174486662951654
SIM,1883,1,na,1884,3019
STAT,1837,27,50-100,1864,0.5183046522051582
STAT,1883,29,25-29,1912,38.88557123221545
SIM,1903,22,20-24,1925,90
STAT,1903,32,20-24,1935,3.6330003012418914
SIM,1923,6,na,1929,4338
SIM,1852,23,15-19,1875,3
SIM,1911,32,20-24,1943,1
STAT,1839,24,45-49,1863,0.5888634524347818
SIM,1857,85,na,1942,173
STAT,1864,35,35-39,1899,6.028458101482323
SIM,1952,2,na,1954,4419
SIM,1902,46,na,1948,3023
SIM,1928,30,25-29,1958,14
STAT,1937,26,40-44,1963,4.293598384339087
SIM,1824,90,na,1914,24
STAT,1859,15,50-100,1874,0.04338473266928142
SIM,1864,25,35-39,1889,10
STAT,1794,98,na,1892,0.5836876923068405
SIM,1877,73,na,1950,1109
SIM,1839,22,45-49,1861,1
STAT,1898,38,45-49,1936,0.5475200582856579
STAT,1925,31,45-49,1956,1.7665108451851423
SIM,1825,32,45-49,1857,1
SIM,1854,36,30-34,1890,5
STAT,1862,49,35-39,1911,0.11046175756560404
SIM,1896,24,40-44,1920,2
SIM,1868,26,30-34,1894,26
STAT,1925,12,na,1937,4522.251600176354
SIM,1927,34,25-29,1961,9
STAT,1867,53,50-100,1920,0.013181056589799555
STAT,1875,19,na,1894,2438.0515136099966
SIM,1907,33,45-49,1940,1
SIM,1918,24,30-34,1942,38
STAT,1820,36,25-29,1856,7.026061309699231
STAT,1879,46,35-39,1925,0.13863298200853436
STAT,1797,63,na,1860,861.9700538075635
SIM,1867,36,30-34,1903,4
STAT,1887,21,na,1908,2506.2093197103645
STAT,1911,19,45-49,1930,0.0939068172679115
STAT,1926,24,15-19,1950,6.071823058822181
SIM,1857,35,45-49,1892,1
STAT,1850,19,20-24,1869,15.072360541459556
SIM,1886,26,25-29,1912,38
STAT,1819,45,25-29,1864,0.10552748431968016
SIM,1874,55,na,1929,1947
STAT,1821,73,na,1894,641.3848700867505
STAT,1936,22,30-34,1958,25.95369633038742
STAT,1890,51,na,1941,2498.9345239407435
SIM,1882,34,40-44,1916,2
SIM,1946,1,na,1947,4210
SIM,1829,33,40-44,1862,11
STAT,1865,20,na,1885,2084.773200885387
SIM,1853,37,40-44,1890,12
SIM,1930,15,40-44,1945,2
STAT,1857,55,na,1912,1539.9312833351169
STAT,1932,25,50-100,1957,1.2326964721592746
SIM,1863,21,25-29,1884,41
STAT,1905,39,15-19,1944,0.016379792326440813
SIM,1849,24,na,1873,1858
SIM,1885,27,35-39,1912,8
STAT,1828,48,50-100,1876,0.20415484018212854
SIM,1819,58,na,1877,1094
SIM,1922,22,30-34,1944,52
STAT,1915,34,na,1949,3607.3486786002472
SIM,1933,31,45-49,1964,4
STAT,1810,47,20-24,1857,0.04266589809522523
STAT,1870,29,25-29,1899,38.87727138212865
SIM,1830,27,45-49,1857,1
SIM,1934,24,15-19,1958,6
STAT,1888,24,40-44,1912,2.3109934663621985
SIM,1850,28,25-29,1878,37
SIM,1815,43,40-44,1858,7
SIM,1861,39,40-44,1900,5
STAT,1813,54,50-100,1867,0.041886907883328155
SIM,1818,36,35-39,1854,9
STAT,1873,26,50-100,1899,0.6155114073691625
SIM,1878,24,25-29,1902,73
STAT,1914,16,45-49,1930,0.09784126954636822
SIM,1915,27,30-34,1942,50
STAT,1907,43,45-49,1950,0.1431574605279552
STAT,1931,25,35-39,1956,18.3274994210848
STAT,1948,16,15-19,1964,49.0819934541759
SIM,1874,32,40-44,1906,5
STAT,1922,32,30-34,1954,16.81805760317741
STAT,1785,106,na,1891,0.008761537839187615
STAT,1934,29,40-44,1963,5.917465978178062
STAT,1891,36,na,1927,2768.1192391452273
SIM,1819,35,25-29,1854,1
STAT,1842,28,25-29,1870,36.984586757818406
STAT,1857,48,15-19,1905,2.941569351824985E-4
STAT,1838,34,30-34,1872,14.493039722576347
SIM,1812,79,na,1891,267
SIM,1871,68,na,1939,1384
STAT,1835,54,na,1889,1315.877044638527
STAT,1923,0,na,1923,4997.9722156849975
SIM,1930,32,30-34,1962,21
STAT,1927,44,25-29,1971,0.084332522904955
SIM,1836,23,30-34,1859,18
STAT,1867,16,20-24,1883,16.171136291250907
SIM,1875,16,20-24,1891,20
SIM,1885,49,na,1934,2087
STAT,1843,27,15-19,1870,0.4028332675498902
STAT,1914,17,20-24,1931,26.48906828549365
SIM,1902,68,na,1970,2371
SIM,1831,26,35-39,1857,12
SIM,1875,38,30-34,1913,8
SIM,1922,17,20-24,1939,131
STAT,1919,34,25-29,1953,9.339572868018902
STAT,1874,19,50-100,1893,0.04704952628816321
SIM,1919,14,na,1933,4108
STAT,1840,48,45-49,1888,0.16362839035569735
SIM,1837,23,25-29,1860,39
STAT,1910,13,na,1923,3689.997089930157
SIM,1879,36,35-39,1915,11
STAT,1842,26,45-49,1868,0.9848415020291158
SIM,1800,78,na,1878,300
SIM,1820,38,40-44,1858,10
SIM,1929,25,45-49,1954,3
STAT,1951,21,45-49,1972,1.2704324462886913
STAT,1887,37,30-34,1924,5.630680398212428
STAT,1892,22,40-44,1914,2.4651599981291334
STAT,1926,46,50-100,1972,0.26432998066779523
STAT,1864,24,30-34,1888,15.062297005304627
SIM,1799,96,na,1895,3
STAT,1835,20,45-49,1855,0.7752623298697933
SIM,1878,37,45-49,1915,3
STAT,1835,42,50-100,1877,0.7898038935506174
SIM,1893,26,30-34,1919,41
STAT,1876,48,25-29,1924,0.055468873265044044
STAT,1885,43,50-100,1928,0.9871280325257449
STAT,1805,57,na,1862,1051.0271751449254
SIM,1894,25,20-24,1919,14
SIM,1888,25,45-49,1913,1
SIM,1924,25,na,1949,4086
STAT,1819,47,40-44,1866,0.30442179868917013
STAT,1890,19,15-19,1909,6.817806825436783
STAT,1928,23,35-39,1951,11.072828481613385
SIM,1932,39,25-29,1971,1
STAT,1877,21,na,1898,2325.4970484339433
SIM,1862,54,na,1916,1815
STAT,1900,18,30-34,1918,2.0834356605421154
SIM,1942,29,40-44,1971,8
STAT,1886,38,40-44,1924,4.347619597258218
STAT,1947,23,45-49,1970,1.2009956737197651
STAT,1813,44,na,1857,1329.1765968466962
STAT,1876,69,na,1945,1431.2296092828935
SIM,1803,96,na,1899,3
STAT,1917,21,50-100,1938,0.6626160011973932
SIM,1888,31,30-34,1919,21
STAT,1836,21,15-19,1857,2.769312459374956
STAT,1903,15,30-34,1918,2.1521662538096
SIM,1865,30,50-100,1895,3
SIM,1826,35,30-34,1861,9
STAT,1898,15,na,1913,3244.819326425911
STAT,1912,25,25-29,1937,61.6771837329977
SIM,1874,26,20-24,1900,13
STAT,1827,44,20-24,1871,0.14107210471240605
STAT,1824,60,na,1884,1082.2421708672223
SIM,1919,36,40-44,1955,2
STAT,1821,48,35-39,1869,0.2106738743211889
SIM,1806,61,na,1867,944
STAT,1883,71,na,1954,1235.8479891541908
SIM,1877,20,15-19,1897,3
SIM,1926,28,45-49,1954,2
STAT,1840,15,45-49,1855,0.05959935629650798
SIM,1872,24,30-34,1896,25
SIM,1895,37,30-34,1932,6
SIM,1826,38,na,1864,1581
STAT,1885,26,30-34,1911,23.782018783636758
STAT,1922,14,na,1936,4318.262306019769
SIM,1863,39,na,1902,2002
STAT,1841,93,na,1934,19.99576823007036
STAT,1803,98,na,1901,1.0732447988039646
SIM,1894,38,40-44,1932,5
SIM,1911,15,30-34,1926,2
SIM,1914,31,35-39,1945,11
SIM,1932,34,na,1966,4593
STAT,1825,31,40-44,1856,8.453537160221783
STAT,1922,15,40-44,1937,1.5364391872964975
STAT,1886,25,20-24,1911,11.788885591447087
STAT,1864,18,45-49,1882,0.056717983712714894
STAT,1894,35,20-24,1929,0.9456476269506321
SIM,1936,23,35-39,1959,8
STAT,1849,35,45-49,1884,1.5011693000343351
STAT,1848,72,na,1920,909.8192098323343
STAT,1800,109,na,1909,2.835932007925959E-4
SIM,1845,33,25-29,1878,11
SIM,1833,31,40-44,1864,11
SIM,1856,44,40-44,1900,8
STAT,1940,20,30-34,1960,27.67554237338626
SIM,1855,23,40-44,1878,1
STAT,1836,39,na,1875,1625.9954724633378
STAT,1837,33,25-29,1870,8.02313183214588
SIM,1859,15,25-29,1874,5
SIM,1901,19,na,1920,3382
STAT,1945,21,20-24,1966,115.16545558095868
SIM,1847,30,30-34,1877,23
STAT,1872,8,na,1880,2567.1537173526654
STAT,1869,20,15-19,1889,3.0477395537380962
SIM,1868,22,15-19,1890,2
SIM,1929,20,25-29,1949,118
SIM,1941,17,30-34,1958,13
STAT,1928,36,40-44,1964,1.7890520759667685
SIM,1916,24,20-24,1940,107
STAT,1863,19,na,1882,2152.245394673613
SIM,1817,37,30-34,1854,6
SIM,1870,29,40-44,1899,3
STAT,1834,91,na,1925,35.86717117143887
STAT,1933,17,30-34,1950,15.414199938737758
SIM,1845,22,20-24,1867,55
STAT,1795,94,na,1889,4.195546135760957
STAT,1847,26,45-49,1873,0.9890316362175501
SIM,1863,37,35-39,1900,12
STAT,1851,61,na,1912,1370.3011791459846
STAT,1862,15,30-34,1877,1.4885074980481459
STAT,1887,28,40-44,1915,3.153662740031726
SIM,1842,21,40-44,1863,1
STAT,1862,29,40-44,1891,2.3966858475500374
STAT,1864,47,50-100,1911,0.20639598757732452
STAT,1895,29,na,1924,2921.0775641277255
STAT,1955,10,na,1965,4927.216497195096
STAT,1846,20,20-24,1866,60.82151317127062
SIM,1844,57,na,1901,1419
STAT,1855,74,na,1929,785.9930991560852
SIM,1897,51,na,1948,2759
STAT,1844,39,25-29,1883,2.091977578865455
SIM,1833,94,na,1927,9
SIM,1852,39,25-29,1891,2
STAT,1902,16,na,1918,3375.2765729289886
SIM,1801,84,na,1885,86
SIM,1918,20,15-19,1938,5
STAT,1924,39,25-29,1963,1.094585985008657
STAT,1842,24,na,1866,1892.9532715294426
SIM,1954,13,na,1967,4435
SIM,1828,37,40-44,1865,2
STAT,1819,36,50-100,1855,3.575069014709193
SIM,1869,39,45-49,1908,1
SIM,1939,24,15-19,1963,3
STAT,1830,24,25-29,1854,127.57645646562707
SIM,1880,22,15-19,1902,3
STAT,1851,15,20-24,1866,15.994235595498024
SIM,1895,28,40-44,1923,4
STAT,1829,35,40-44,1864,4.046603912418802
STAT,1853,37,25-29,1890,2.1352351785687254
STAT,1852,103,na,1955,0.10903874410813647
STAT,1859,89,na,1948,79.20242864805827
STAT,1942,20,40-44,1962,3.332558655017024
STAT,1834,21,40-44,1855,1.7375483030024959
SIM,1842,18,25-29,1860,5
STAT,1884,66,na,1950,1530.0810711778843
SIM,1852,25,30-34,1877,30
SIM,1892,19,na,1911,3032
STAT,1896,27,45-49,1923,1.3862492103285986
STAT,1812,47,30-34,1859,0.31852251154559813
SIM,1827,87,na,1914,79
SIM,1934,15,25-29,1949,61
STAT,1838,28,45-49,1866,0.9563664598158919
STAT,1965,5,na,1970,4635.891747911603
SIM,1906,29,30-34,1935,48
STAT,1837,42,15-19,1879,0.010287034914506842
STAT,1875,53,50-100,1928,0.014422446054515382
SIM,1861,17,30-34,1878,1
SIM,1863,25,40-44,1888,2
STAT,1857,21,35-39,1878,5.053465972386506
STAT,1894,19,35-39,1913,0.6632265441739401
STAT,1934,34,15-19,1968,0.16553125329375382
STAT,1846,49,na,1895,1553.1800119713316
SIM,1937,28,20-24,1965,15
SIM,1844,26,35-39,1870,16
STAT,1846,47,35-39,1893,0.09824995229216696
STAT,1849,48,15-19,1897,2.84693387223152E-4
SIM,1929,14,na,1943,4854
STAT,1871,27,40-44,1898,2.8054757566040593
STAT,1889,41,50-100,1930,1.2376852679702937
STAT,1903,35,25-29,1938,0.8431810137932504
STAT,1853,17,30-34,1870,1.4219004223574534
SIM,1938,32,35-39,1970,11
STAT,1829,36,45-49,1865,1.811071420116491
SIM,1794,97,na,1891,2
SIM,1865,21,35-39,1886,7
SIM,1895,29,45-49,1924,3
SIM,1908,25,25-29,1933,65
STAT,1899,27,20-24,1926,15.187694879666077
SIM,1835,28,35-39,1863,7
STAT,1827,28,35-39,1855,17.399960705275088
STAT,1872,48,40-44,1920,0.1602925244059346
SIM,1820,44,na,1864,1397
STAT,1819,38,na,1857,1448.6236889401303
STAT,1810,48,50-100,1858,0.8586113881175236
STAT,1855,25,40-44,1880,2.465365024730761
STAT,1859,99,na,1958,2.2975491475886654
STAT,1898,49,15-19,1947,2.825210989231935E-4
SIM,1870,15,30-34,1885,5
SIM,1952,18,45-49,1970,4
STAT,1864,49,45-49,1913,0.19509699900443334
SIM,1871,36,30-34,1907,8
STAT,1847,49,50-100,1896,0.17693662385014974
SIM,1909,34,30-34,1943,21
STAT,1836,26,35-39,1862,7.941374220449018
STAT,1885,19,na,1904,2364.300737909474
SIM,1930,35,35-39,1965,8
STAT,1907,15,15-19,1922,8.272249947316292
STAT,1941,28,na,1969,3658.898915341443
STAT,1924,19,30-34,1943,13.63983843922775
STAT,1844,25,30-34,1869,21.954904843311716
SIM,1900,28,25-29,1928,50
STAT,1854,16,35-39,1870,0.4754609873652821
SIM,1859,36,30-34,1895,4
STAT,1887,15,35-39,1902,0.5824027159736406
STAT,1916,30,40-44,1946,3.8473303138204202
STAT,1827,57,na,1884,1175.1835184009283
STAT,1837,49,35-39,1886,0.0894210500103348
SIM,1858,31,45-49,1889,1
STAT,1909,23,25-29,1932,80.82945909837808
STAT,1931,29,15-19,1960,0.8601760825296457
STAT,1880,41,na,1921,2307.763726890436
STAT,1892,16,20-24,1908,21.024482958161325
STAT,1902,18,40-44,1920,0.24319802157753959
STAT,1944,18,45-49,1962,0.5076764868359035
STAT,1863,23,50-100,1886,0.34290346655073606
STAT,1842,17,20-24,1859,16.211787126267556
STAT,1937,22,25-29,1959,84.96317540413925
SIM,1828,38,45-49,1866,1
SIM,1894,36,25-29,1930,4
SIM,1927,25,35-39,1952,20
STAT,1873,16,45-49,1889,0.06300941942804564
SIM,1898,33,40-44,1931,4
SIM,1837,35,40-44,1872,4
SIM,1890,37,50-100,1927,1
STAT,1938,31,30-34,1969,14.972623967751842
SIM,1822,57,na,1879,1169
STAT,1818,49,25-29,1867,0.11934890842749127
STAT,1896,26,40-44,1922,3.7528929091893617
SIM,1840,36,50-100,1876,4
STAT,1890,73,na,1963,1604.0210009453308
SIM,1861,37,25-29,1898,2
STAT,1919,31,20-24,1950,2.4961895030151346
SIM,1879,33,30-34,1912,25
SIM,1945,22,25-29,1967,86
STAT,1848,111,na,1959,1.1657889039105377E-4
STAT,1859,67,na,1926,1195.134633040528
STAT,1804,107,na,1911,0.0015981382648356701
STAT,1817,57,na,1874,1078.4802333618622
SIM,1835,27,30-34,1862,22
SIM,1887,29,45-49,1916,4
STAT,1803,107,na,1910,0.00155804484435125
STAT,1816,47,15-19,1863,0.0010531986928570282
STAT,1953,17,35-39,1970,4.79538048552335
SIM,1899,32,45-49,1931,5
STAT,1908,24,20-24,1932,95.94412218086923
STAT,1879,29,45-49,1908,1.088513111798048
SIM,1850,17,20-24,1867,13
STAT,1886,36,25-29,1922,2.8876279789215977
STAT,1910,45,na,1955,3252.360289252262
STAT,1939,30,35-39,1969,8.817338022330345
SIM,1911,35,25-29,1946,1
STAT,1890,39,45-49,1929,2.2793570467888826
SIM,1852,86,na,1938,135
SIM,1820,76,na,1896,435
STAT,1835,47,25-29,1882,0.03788174539984939
STAT,1852,34,na,1886,1838.6174066523392
SIM,1812,47,na,1859,1304
STAT,1866,29,25-29,1895,36.58074223608441
STAT,1922,35,35-39,1957,2.6046989619694987
STAT,1957,2,na,1959,4900.707059492553
STAT,1833,39,15-19,1872,0.04185266546843447
SIM,1932,19,30-34,1951,17
STAT,1837,22,20-24,1859,56.94843524210326
STAT,1839,30,30-34,1869,14.627030332144686
STAT,1884,28,15-19,1912,0.42205844814111826
STAT,1928,6,na,1934,4771.43703546447
SIM,1863,26,45-49,1889,1
SIM,1869,38,40-44,1907,3
SIM,1927,31,20-24,1958,1
STAT,1827,27,30-34,1854,67.71536888148712
SIM,1897,24,35-39,1921,11
SIM,1792,84,na,1876,73
STAT,1825,104,na,1929,0.037711811264963375
STAT,1845,37,40-44,1882,3.2397330706539837
STAT,1802,81,na,1883,205.9592933444717
STAT,1877,27,35-39,1904,9.459008371511734
SIM,1950,20,40-44,1970,3
STAT,1867,36,15-19,1903,0.050048857369923136
STAT,1942,16,20-24,1958,133.8764385939811
STAT,1823,48,45-49,1871,0.2774929580849989
STAT,1835,46,20-24,1881,0.007993791627190721
STAT,1843,15,20-24,1858,16.539441033437708
SIM,1833,25,20-24,1858,9
SIM,1910,23,15-19,1933,4
STAT,1873,22,30-34,1895,17.080346622385367
STAT,1876,28,30-34,1904,24.47233674200434
STAT,1894,18,30-34,1912,1.931827760828511
STAT,1919,38,50-100,1957,0.42567726011520823
STAT,1855,36,50-100,1891,0.8737177039292406
SIM,1865,34,40-44,1899,3
SIM,1884,28,30-34,1912,28
STAT,1863,93,na,1956,27.71672019996601
STAT,1838,21,25-29,1859,51.021573237906736
SIM,1883,19,25-29,1902,8
STAT,1889,24,35-39,1913,6.763151817940597
SIM,1850,64,na,1914,1284
SIM,1846,21,25-29,1867,55
SIM,1870,19,na,1889,2331
SIM,1904,25,40-44,1929,6
STAT,1827,67,na,1894,879.7155648504801
STAT,1843,29,30-34,1872,22.038581791763026
SIM,1882,37,45-49,1919,2
STAT,1863,32,15-19,1895,0.11825726676780346
SIM,1858,27,25-29,1885,7
SIM,1920,2,na,1922,4217
STAT,1870,51,25-29,1921,0.0032944207621153163
SIM,1794,75,na,1869,393
SIM,1852,76,na,1928,684
STAT,1841,48,50-100,1889,0.1666504173717361
STAT,1887,48,35-39,1935,0.1460510252950362
STAT,1857,34,40-44,1891,3.2021209523206644
STAT,1909,36,30-34,1945,1.6371330286497479
SIM,1838,61,na,1899,1186
SIM,1879,27,45-49,1906,1
SIM,1937,20,25-29,1957,83
STAT,1836,72,na,1908,797.5042780744196
STAT,1885,29,na,1914,2230.092786113001
STAT,1828,26,35-39,1854,22.95876130170145
SIM,1937,11,na,1948,3511
STAT,1858,33,45-49,1891,1.2878125807762637
STAT,1893,48,na,1941,2663.306203654646
STAT,1905,66,na,1971,2577.393335282987
SIM,1839,44,40-44,1883,9
STAT,1851,93,na,1944,21.431461559031526
STAT,1870,31,50-100,1901,0.8516065942214114
STAT,1870,15,30-34,1885,1.5071529275724198
SIM,1851,29,30-34,1880,23
SIM,1871,37,35-39,1908,10
SIM,1896,27,45-49,1923,3
STAT,1894,38,25-29,1932,3.4815044110287205
STAT,1855,26,45-49,1881,0.8255741938872395
STAT,1888,30,50-100,1918,1.0307586584456885
SIM,1859,37,35-39,1896,11
STAT,1873,93,na,1966,90.68217062124958
STAT,1817,37,15-19,1854,0.19472925185642095
SIM,1895,21,20-24,1916,71
STAT,1898,35,40-44,1933,5.6512340339802485
STAT,1842,56,na,1898,1452.4490521361042
SIM,1911,8,na,1919,3788
SIM,1874,7,na,1881,2603
SIM,1948,20,35-39,1968,14
STAT,1879,7,na,1886,2635.8600698222804
SIM,1828,30,20-24,1858,4
SIM,1879,22,na,1901,2306
STAT,1877,38,25-29,1915,2.8085261475828456
STAT,1856,22,30-34,1878,15.306409495760658
SIM,1876,28,30-34,1904,31
STAT,1846,38,50-100,1884,0.8946411606730332
STAT,1851,48,20-24,1899,0.008689227813222454
SIM,1837,87,na,1924,87
SIM,1866,33,45-49,1899,1
SIM,1885,38,25-29,1923,3
STAT,1873,19,15-19,1892,5.6601721519664565
STAT,1861,38,na,1899,1839.04198327244
SIM,1864,22,30-34,1886,20
STAT,1881,15,40-44,1896,0.16760905785796298
STAT,1830,24,na,1854,1480.4026202895056
STAT,1888,27,45-49,1915,1.2391095597862436
STAT,1831,47,40-44,1878,0.12587272542615974
STAT,1865,20,30-34,1885,15.701398449483202
STAT,1883,38,15-19,1921,0.051733783264772834
SIM,1950,16,20-24,1966,132
STAT,1919,25,35-39,1944,15.428804463145964
STAT,1891,49,50-100,1940,0.15861209293383208
STAT,1902,48,na,1950,2962.234525738781
SIM,1915,15,15-19,1930,8
SIM,1887,51,na,1938,2241
STAT,1929,20,25-29,1949,111.01334724328188
STAT,1936,25,35-39,1961,13.582992219247856
SIM,1836,26,35-39,1862,8
STAT,1863,28,45-49,1891,0.918765316406869
SIM,1849,33,45-49,1882,1
SIM,1853,35,25-29,1888,2
SIM,1805,77,na,1882,332
SIM,1924,30,40-44,1954,9
STAT,1898,18,15-19,1916,7.569379500626641
SIM,1857,32,40-44,1889,5
SIM,1929,2,na,1931,4965
STAT,1886,16,30-34,1902,1.5947868153419764
STAT,1916,29,na,1945,3632.8950730458196
SIM,1960,5,na,1965,4670
STAT,1835,27,30-34,1862,20.477176202872688
SIM,1887,41,na,1928,2422
STAT,1924,48,na,1972,4120.718768309094
STAT,1925,36,15-19,1961,0.021796072732160027
STAT,1878,43,15-19,1921,0.013483203425062035
STAT,1927,27,35-39,1954,17.24461678476269
SIM,1829,36,45-49,1865,1
SIM,1859,34,na,1893,1953
STAT,1852,25,15-19,1877,0.4073268975309813
STAT,1861,37,25-29,1898,2.2586629850752673
SIM,1889,22,35-39,1911,9
SIM,1900,56,na,1956,2637
STAT,1833,42,na,1875,1546.3829917205292
SIM,1843,27,30-34,1870,26
SIM,1855,41,na,1896,1860
STAT,1826,44,50-100,1870,1.0027851462951922
SIM,1777,95,na,1872,1
SIM,1918,51,na,1969,3629
STAT,1866,28,20-24,1894,10.181998199252055
SIM,1871,28,45-49,1899,3
SIM,1894,16,30-34,1910,2
STAT,1853,19,na,1872,2023.7259649196856
SIM,1869,22,na,1891,2143
STAT,1852,39,25-29,1891,2.165517836926683
SIM,1886,23,20-24,1909,75
SIM,1830,38,35-39,1868,11
STAT,1887,29,45-49,1916,1.1646475133785241
STAT,1887,21,20-24,1908,73.02561732381349
SIM,1860,39,25-29,1899,1
STAT,1846,27,40-44,1873,2.5551062935203803
SIM,1913,19,20-24,1932,15
SIM,1944,25,35-39,1969,16
SIM,1935,27,35-39,1962,29
STAT,1878,23,20-24,1901,67.56275012448069
STAT,1822,38,35-39,1860,12.167880805158248
SIM,1818,95,na,1913,4
SIM,1854,27,40-44,1881,2
STAT,1826,35,15-19,1861,0.06442555101984412
SIM,1845,38,45-49,1883,6
SIM,1852,54,na,1906,1610
STAT,1857,17,15-19,1874,5.194742819222523
STAT,1861,17,30-34,1878,1.437136609084656
STAT,1898,22,35-39,1920,7.462569083766675
SIM,1874,23,na,1897,2252
STAT,1836,39,40-44,1875,3.32333137120851
STAT,1907,48,15-19,1955,3.0912492900381266E-4
SIM,1887,22,25-29,1909,73
SIM,1876,29,35-39,1905,9
STAT,1847,32,30-34,1879,15.08361895416505
STAT,1836,25,30-34,1861,20.87538766634092
STAT,1893,26,15-19,1919,0.5456813606933197
SIM,1891,18,20-24,1909,22
STAT,1843,49,25-29,1892,0.04068817590714259
STAT,1926,15,25-29,1941,50.43162025460533
STAT,1842,23,40-44,1865,1.8582048780613458
STAT,1849,32,40-44,1881,3.2938821812618424
STAT,1874,88,na,1962,247.42665032988847
STAT,1881,16,45-49,1897,0.059729867657983875
SIM,1873,20,30-34,1893,19
SIM,1937,33,na,1970,3374
STAT,1905,19,20-24,1924,24.072409311826178
STAT,1831,106,na,1937,0.0074047922738836
STAT,1862,16,35-39,1878,0.5094187443635646
SIM,1889,8,na,1897,3067
SIM,1825,39,30-34,1864,8
STAT,1826,49,25-29,1875,0.052431010973791096
STAT,1879,22,25-29,1901,56.52615343367691
STAT,1817,39,30-34,1856,15.54359172335021
SIM,1909,37,35-39,1946,7
STAT,1874,56,na,1930,1969.330954764473
SIM,1855,32,30-34,1887,19
SIM,1943,26,30-34,1969,41
STAT,1873,71,na,1944,1279.9514242547507
SIM,1844,37,25-29,1881,2
STAT,1884,16,20-24,1900,16.590936030569775
SIM,1837,20,20-24,1857,55
STAT,1876,17,25-29,1893,5.526507508427734
STAT,1935,26,30-34,1961,50.47717333054825
STAT,1860,38,20-24,1898,0.5888912297431427
SIM,1855,26,45-49,1881,4
SIM,1801,62,na,1863,913
SIM,1898,14,na,1912,3252
STAT,1837,38,45-49,1875,1.5163413631394993
STAT,1929,28,20-24,1957,21.572709735536353
STAT,1807,49,15-19,1856,0.0014336523486626173
SIM,1839,31,35-39,1870,8
STAT,1927,20,15-19,1947,6.233383187926643
SIM,1850,23,40-44,1873,2
SIM,1805,55,na,1860,1099
STAT,1834,31,50-100,1865,0.73405787200638
SIM,1903,33,25-29,1936,7
STAT,1876,21,45-49,1897,0.6821198087110667
STAT,1899,34,45-49,1933,2.2382472394601853
STAT,1859,36,30-34,1895,4.037438838339061
SIM,1865,17,15-19,1882,6
STAT,1863,37,35-39,1900,5.873450062697717
STAT,1827,47,25-29,1874,0.050465050716807
SIM,1844,25,30-34,1869,27
SIM,1838,26,45-49,1864,4
SIM,1844,39,40-44,1883,8
SIM,1838,32,30-34,1870,16
STAT,1846,28,45-49,1874,0.9402480940333802
STAT,1901,39,30-34,1940,1.5057739129107184
STAT,1799,97,na,1896,1.796103003361113
STAT,1901,53,na,1954,2801.468989049997
STAT,1920,39,40-44,1959,1.5451621794031365
STAT,1946,20,25-29,1966,97.17385706448047
SIM,1953,15,35-39,1968,7
STAT,1861,36,20-24,1897,0.6076234769241146
STAT,1897,17,45-49,1914,0.08252945651401745
SIM,1907,30,40-44,1937,6
STAT,1916,26,20-24,1942,17.890682604594158
SIM,1899,39,30-34,1938,2
SIM,1939,30,35-39,1969,15
STAT,1827,102,na,1929,0.1626972621157543
STAT,1883,18,20-24,1901,16.371258791945408
STAT,1837,37,40-44,1874,3.364493288197813
STAT,1897,23,30-34,1920,22.434773893509355
SIM,1860,27,30-34,1887,28
SIM,1887,73,na,1960,1281
STAT,1852,27,30-34,1879,22.284423532894632
STAT,1866,37,na,1903,2052.030280198522
STAT,1870,53,na,1923,1961.119937252765
SIM,1854,20,20-24,1874,55
SIM,1913,23,40-44,1936,3
STAT,1905,23,40-44,1928,2.835932737620388
STAT,1945,15,35-39,1960,4.332543027266108
STAT,1842,37,15-19,1879,0.046909375281218677
SIM,1899,25,20-24,1924,12
STAT,1853,48,30-34,1901,0.07088562410696149
STAT,1900,27,20-24,1927,15.375117198180503
SIM,1924,26,20-24,1950,21
STAT,1812,43,50-100,1855,3.8023187417283286
STAT,1887,33,15-19,1920,0.1498182997659406
SIM,1877,27,35-39,1904,11
SIM,1919,32,25-29,1951,13
STAT,1866,32,40-44,1898,3.7772325176457384
STAT,1822,36,35-39,1858,13.47312222858391
STAT,1849,44,50-100,1893,0.7512022700365089
SIM,1870,1,na,1871,3098
SIM,1909,26,na,1935,3370
STAT,1867,47,20-24,1914,0.010594383281285221
SIM,1887,27,45-49,1914,1
SIM,1862,22,20-24,1884,59
STAT,1838,38,50-100,1876,0.9999754914707757
SIM,1846,38,50-100,1884,4
STAT,1889,21,30-34,1910,20.83668558324456
SIM,1880,19,na,1899,2578
STAT,1851,18,25-29,1869,5.022575303584402
SIM,1910,6,na,1916,3669
STAT,1846,25,50-100,1871,0.5535546867408991
STAT,1921,23,25-29,1944,98.26357626111812
STAT,1824,104,na,1928,0.03521346516765233
STAT,1825,37,15-19,1862,0.07190989571509948
SIM,1869,36,40-44,1905,5
SIM,1847,75,na,1922,685
SIM,1842,15,20-24,1857,14
SIM,1935,20,15-19,1955,10
STAT,1796,79,na,1875,302.40161097602993
STAT,1941,17,50-100,1958,0.3645298603085026
SIM,1860,42,na,1902,1933
STAT,1871,25,25-29,1896,39.88589427198313
STAT,1896,38,35-39,1934,8.786969648904556
SIM,1863,28,45-49,1891,1
SIM,1897,21,30-34,1918,28
STAT,1883,24,40-44,1907,1.9172521283568094
SIM,1876,15,25-29,1891,5
STAT,1862,18,35-39,1880,0.503435464360983
STAT,1833,36,45-49,1869,1.533209527442494
SIM,1924,17,30-34,1941,20
STAT,1916,17,30-34,1933,2.4429299175464694
SIM,1770,84,na,1854,91
STAT,1839,33,35-39,1872,8.223824045883246
SIM,1913,26,45-49,1939,5
SIM,1892,16,20-24,1908,19
STAT,1919,1,na,1920,4359.67873190979
SIM,1852,28,35-39,1880,8
SIM,1919,23,35-39,1942,8
STAT,1878,47,30-34,1925,0.09475438557054214
STAT,1956,0,na,1956,4950.811741937489
SIM,1881,25,35-39,1906,11
STAT,1855,28,45-49,1883,0.8137615087940919
STAT,1909,59,na,1968,2998.0870922876506
STAT,1886,17,35-39,1903,0.5476798481646219
SIM,1941,29,25-29,1970,55
STAT,1892,28,15-19,1920,0.534843883066085
STAT,1901,31,na,1932,3168.2828824215017
SIM,1849,34,na,1883,1778
SIM,1858,24,20-24,1882,57
STAT,1844,36,20-24,1880,0.6349539894198661
STAT,1900,67,na,1967,2350.7707795267725
STAT,1818,75,na,1893,496.3278801117729
STAT,1905,26,45-49,1931,1.5209379338367799
STAT,1846,23,25-29,1869,49.44393255433487
STAT,1930,33,na,1963,4608.320456725096
SIM,1934,21,45-49,1955,1
STAT,1894,16,30-34,1910,1.941659511037067
STAT,1829,47,35-39,1876,0.11296530222350767
STAT,1898,47,na,1945,2864.27597217281
STAT,1850,39,15-19,1889,0.03933356873177239
SIM,1841,27,20-24,1868,11
SIM,1843,72,na,1915,873
SIM,1917,27,40-44,1944,6
STAT,1847,29,15-19,1876,0.3955044596337962
SIM,1908,31,45-49,1939,1
SIM,1951,15,25-29,1966,59
SIM,1913,30,na,1943,3447
SIM,1920,16,35-39,1936,3
STAT,1833,27,20-24,1860,9.444758197069007
STAT,1885,38,25-29,1923,2.696400145254088
STAT,1875,38,15-19,1913,0.054229816659433785
SIM,1809,58,na,1867,1089
STAT,1876,26,15-19,1902,0.4439943117032768
SIM,1893,38,25-29,1931,2
STAT,1780,100,na,1880,0.18214226911088746
STAT,1868,15,25-29,1883,5.265649214139982
STAT,1915,6,na,1921,3949.5654246925646
STAT,1942,23,45-49,1965,1.1140635661259612
STAT,1905,34,na,1939,3257.26793651391
STAT,1824,49,15-19,1873,4.569559064787296E-4
STAT,1920,15,30-34,1935,2.6040615141248358
STAT,1808,47,15-19,1855,0.0015227366337477262
STAT,1926,29,na,1955,4212.560149459167
SIM,1779,76,na,1855,306
STAT,1854,22,20-24,1876,58.305855500539934
SIM,1876,26,30-34,1902,28
SIM,1923,21,35-39,1944,7
STAT,1865,52,na,1917,1838.5358300466062
STAT,1818,47,25-29,1865,0.12310905467040058
SIM,1909,28,45-49,1937,2
STAT,1911,28,35-39,1939,13.77990858008407
STAT,1912,16,35-39,1928,0.8033625523052069
STAT,1879,26,40-44,1905,2.9680666850259976
STAT,1878,48,35-39,1926,0.135953357549996
SIM,1904,21,25-29,1925,88
STAT,1895,23,20-24,1918,84.69279591198305
STAT,1896,29,45-49,1925,1.3763414277165271
SIM,1871,27,40-44,1898,4
SIM,1921,25,40-44,1946,10
STAT,1909,27,40-44,1936,4.207064611063351
STAT,1933,29,25-29,1962,82.48129942827654
STAT,1923,27,50-100,1950,1.0796631296219998
SIM,1946,25,45-49,1971,5
SIM,1883,37,na,1920,2222
SIM,1837,38,45-49,1875,2
STAT,1926,21,45-49,1947,1.2953980282334434
STAT,1845,49,35-39,1894,0.09655441634916641
STAT,1835,49,25-29,1884,0.03692341500866832
SIM,1954,4,na,1958,4438
STAT,1840,26,35-39,1866,8.43904608916173
STAT,1863,39,35-39,1902,5.814336400327251
STAT,1924,15,15-19,1939,51.29709287798669
SIM,1895,26,40-44,1921,3
STAT,1838,25,40-44,1863,2.6366337819554575
STAT,1914,29,15-19,1943,0.6673890489458681
STAT,1885,37,20-24,1922,0.7255070623520316
SIM,1931,27,50-100,1958,1
SIM,1946,25,na,1971,3887
STAT,1916,33,45-49,1949,1.528224213648535
SIM,1862,27,40-44,1889,6
SIM,1852,27,30-34,1879,31
STAT,1943,19,40-44,1962,1.4002055484641347
STAT,1894,66,na,1960,2111.5843839191507
STAT,1863,27,40-44,1890,2.48755695313421
SIM,1856,20,30-34,1876,22
STAT,1943,15,25-29,1958,43.433463370747624
STAT,1901,39,50-100,1940,0.3468760754337794
STAT,1886,15,na,1901,2532.5807994194383
STAT,1822,35,30-34,1857,10.618430215543317
SIM,1794,65,na,1859,793
STAT,1887,26,40-44,1913,3.1756636156152234
SIM,1836,32,20-24,1868,1
STAT,1860,75,na,1935,790.3794680503374
SIM,1824,80,na,1904,325
SIM,1859,39,35-39,1898,7
STAT,1855,48,40-44,1903,0.11972662646471595
SIM,1871,39,35-39,1910,11
STAT,1828,32,20-24,1860,2.910785745483374
STAT,1854,27,40-44,1881,2.2613317319476125
STAT,1844,27,30-34,1871,21.64076423779821
SIM,1819,68,na,1887,767
SIM,1908,22,20-24,1930,92
SIM,1927,22,30-34,1949,34
STAT,1915,44,na,1959,3520.2053346819384
STAT,1931,3,na,1934,5015.479870005113
SIM,1913,52,na,1965,3202
STAT,1818,46,20-24,1864,0.026048947884396267
SIM,1869,25,35-39,1894,8
STAT,1889,11,na,1900,3016.402534248675
SIM,1870,18,35-39,1888,1
STAT,1938,25,45-49,1963,1.6181114505553962
STAT,1866,38,15-19,1904,0.048667413915685784
SIM,1830,36,35-39,1866,11
SIM,1833,28,25-29,1861,33
SIM,1895,70,na,1965,1993
SIM,1830,35,30-34,1865,8
SIM,1852,37,25-29,1889,5
SIM,1855,49,50-100,1904,1
SIM,1847,33,35-39,1880,9
STAT,1895,17,35-39,1912,0.6764485148731659
SIM,1905,30,30-34,1935,16
SIM,1917,36,30-34,1953,1
SIM,1933,29,na,1962,4696
STAT,1938,20,25-29,1958,86.41160024637774
SIM,1884,17,25-29,1901,6
STAT,1776,80,na,1856,200.2108555458
STAT,1844,28,35-39,1872,8.23253728149754
SIM,1842,76,na,1918,623
STAT,1898,69,na,1967,2160.3893447992264
STAT,1948,20,35-39,1968,10.221143133192854
SIM,1894,17,35-39,1911,2
SIM,1891,24,40-44,1915,3
SIM,1828,35,40-44,1863,3
SIM,1928,34,40-44,1962,5
STAT,1902,23,15-19,1925,4.384497695905738
STAT,1866,26,20-24,1892,10.253030802938435
STAT,1915,38,20-24,1953,0.2503000300292462
SIM,1891,20,25-29,1911,77
STAT,1883,20,25-29,1903,53.31806818254656
STAT,1931,16,45-49,1947,0.6192185349717326
SIM,1851,15,20-24,1866,16
STAT,1834,48,20-24,1882,0.007777190746164
STAT,1919,22,30-34,1941,29.731489587656693
STAT,1874,37,45-49,1911,1.9247742719168077
SIM,1824,33,40-44,1857,4
SIM,1861,15,30-34,1876,1
STAT,1889,39,20-24,1928,0.8899712462017138
STAT,1901,15,20-24,1916,23.551121694865305
STAT,1943,24,15-19,1967,5.346411748959989
STAT,1851,6,na,1857,2224.275065364673
STAT,1931,22,30-34,1953,35.215910016392236
STAT,1829,38,45-49,1867,1.7471536665571632
SIM,1932,15,15-19,1947,59
SIM,1846,25,40-44,1871,3
STAT,1869,37,50-100,1906,1.1226931561474185
SIM,1946,20,25-29,1966,99
STAT,1890,41,na,1931,2681.6234155040943
STAT,1859,47,20-24,1906,0.00900491686484904
STAT,1895,40,na,1935,2878.0463095031228
STAT,1896,26,50-100,1922,0.801417398854081
SIM,1858,40,35-39,1898,4
SIM,1927,20,15-19,1947,5
STAT,1838,26,45-49,1864,0.9702492199383198
STAT,1865,74,na,1939,952.6922683576807
SIM,1836,37,40-44,1873,3
STAT,1861,52,50-100,1913,0.011784682806909096
SIM,1849,30,40-44,1879,9
SIM,1831,39,na,1870,1576
STAT,1859,38,30-34,1897,3.9981697327521526
SIM,1814,69,na,1883,706
STAT,1843,20,na,1863,1964.339929710671
STAT,1921,27,40-44,1948,4.907865654082008
STAT,1935,17,40-44,1952,1.8062831871169076
SIM,1840,24,35-39,1864,4
SIM,1882,74,na,1956,1000
STAT,1870,18,35-39,1888,0.5097416270662914
SIM,1899,28,25-29,1927,58
STAT,1895,28,40-44,1923,3.6799314233923632
SIM,1877,37,50-100,1914,1
STAT,1827,35,na,1862,1591.3246689721936
SIM,1905,17,20-24,1922,22
STAT,1849,89,na,1938,75.72161505591328
STAT,1941,28,20-24,1969,17.82877505791911
SIM,1840,18,15-19,1858,4
SIM,1938,23,45-49,1961,3
SIM,1860,36,20-24,1896,3
STAT,1841,61,na,1902,1278.5047211140102
SIM,1896,55,na,1951,2611
STAT,1905,32,30-34,1937,13.686188639752231
STAT,1878,70,na,1948,1379.85686937759
STAT,1834,37,15-19,1871,0.043235847324899594
SIM,1951,19,40-44,1970,1
STAT,1923,20,30-34,1943,31.783415206038775
STAT,1855,34,30-34,1889,12.331965133061592
SIM,1895,24,25-29,1919,84
STAT,1881,27,35-39,1908,8.801211969168541
SIM,1943,17,40-44,1960,3
SIM,1935,24,30-34,1959,42
STAT,1887,24,25-29,1911,60.10117565957739
STAT,1786,79,na,1865,262.6071298063231
STAT,1785,94,na,1879,4.159161316205549
SIM,1924,33,45-49,1957,1
STAT,1906,27,15-19,1933,0.6241173242215037
SIM,1938,7,na,1945,3649
STAT,1892,19,25-29,1911,6.667827224564472
STAT,1919,20,15-19,1939,5.539443101928314
STAT,1826,46,20-24,1872,0.011371593396024712
SIM,1846,26,45-49,1872,5
STAT,1869,36,25-29,1905,2.645515856148928
STAT,1939,26,15-19,1965,0.6706715019632591
STAT,1913,25,40-44,1938,4.416198164517862
SIM,1863,49,na,1912,1908
STAT,1828,37,40-44,1865,4.157183582316125
STAT,1939,32,35-39,1971,8.807377243095942
STAT,1927,24,30-34,1951,33.24658813627723
STAT,1869,27,35-39,1896,8.823335187259357
STAT,1875,52,na,1927,2078.6064025910455
STAT,1860,29,30-34,1889,19.26120250330408
SIM,1893,37,na,1930,2948
STAT,1826,94,na,1920,10.908743764181903
SIM,1883,15,na,1898,2413
STAT,1869,99,na,1968,9.849429566328785
STAT,1847,23,na,1870,1914.7550245171399
STAT,1945,10,na,1955,4054.779340378849
SIM,1916,31,45-49,1947,1
STAT,1879,31,15-19,1910,0.14119255951559787
SIM,1866,89,na,1955,55
STAT,1811,95,na,1906,5.75895109878779
STAT,1926,39,35-39,1965,2.786918615754747
SIM,1833,27,20-24,1860,9
STAT,1837,46,30-34,1883,0.06425090739751019
SIM,1828,33,25-29,1861,11
STAT,1772,110,na,1882,0.0016646695491504696
STAT,1915,21,35-39,1936,9.221720034149374
SIM,1895,9,na,1904,3259
STAT,1848,38,20-24,1886,0.5663746820776325
SIM,1931,20,30-34,1951,43
SIM,1859,47,50-100,1906,3
STAT,1832,24,35-39,1856,5.051028685506721
SIM,1879,20,25-29,1899,56
STAT,1842,39,15-19,1881,0.041810162449626646
STAT,1910,25,15-19,1935,0.6536804475534496
STAT,1825,76,na,1901,535.656459579331
STAT,1877,24,50-100,1901,0.3972612700845053
STAT,1908,31,45-49,1939,1.408589058563166
STAT,1918,46,25-29,1964,0.05345791133147573
STAT,1877,29,35-39,1906,9.391403067954169
STAT,1881,18,45-49,1899,0.059427420634978405
STAT,1877,35,20-24,1912,0.7628530006388123
SIM,1923,30,na,1953,4029
STAT,1907,15,na,1922,3520.4762704192544
STAT,1813,76,na,1889,401.92085097465974
STAT,1946,22,25-29,1968,97.10681864736023
SIM,1799,64,na,1863,797
STAT,1843,42,na,1885,1716.8348491153665
STAT,1869,38,40-44,1907,3.9830950056612897
STAT,1860,27,15-19,1887,0.35206680786719524
SIM,1854,23,25-29,1877,50
STAT,1851,17,20-24,1868,15.806378373803758
SIM,1896,33,na,1929,2990
STAT,1893,37,20-24,1930,0.9239518217694885
SIM,1887,26,40-44,1913,4
STAT,1934,21,45-49,1955,1.4289099575744368
SIM,1873,23,35-39,1896,5
SIM,1896,36,35-39,1932,11
STAT,1871,39,35-39,1910,6.557429686707783
SIM,1843,16,25-29,1859,7
SIM,1851,42,50-100,1893,3
STAT,1903,33,50-100,1936,0.7041228573503734
SIM,1848,39,25-29,1887,1
STAT,1846,25,40-44,1871,2.592196602780158
STAT,1788,104,na,1892,0.0195627284466192
STAT,1935,22,15-19,1957,6.847589542290798
STAT,1927,18,45-49,1945,0.5852949111657215
STAT,1830,106,na,1936,0.007252856358469742
SIM,1833,101,na,1934,1
STAT,1875,49,20-24,1924,0.011403287582101818
STAT,1889,48,45-49,1937,0.15330756367075007
SIM,1811,62,na,1873,942
STAT,1816,49,15-19,1865,0.00102007659941314
STAT,1830,38,35-39,1868,5.537812366825934
SIM,1864,23,na,1887,2125
STAT,1828,102,na,1930,0.16642855197783119
STAT,1859,48,25-29,1907,0.0428804035594705
STAT,1892,18,20-24,1910,20.91802378571956
STAT,1948,21,50-100,1969,0.7140087154123523
SIM,1841,36,45-49,1877,2
SIM,1878,48,na,1926,2254
STAT,1858,26,20-24,1884,8.9709634416936
STAT,1852,36,20-24,1888,0.5949938282972133
STAT,1911,20,50-100,1931,0.5929118719729761
SIM,1863,34,30-34,1897,16
STAT,1843,42,50-100,1885,0.78475346752459
SIM,1883,22,40-44,1905,2
STAT,1907,31,50-100,1938,0.7329408959277073
STAT,1926,33,50-100,1959,0.9439692588141583
STAT,1917,34,15-19,1951,0.12602846504678028
STAT,1821,54,50-100,1875,0.021304201536815733
SIM,1913,32,30-34,1945,29
SIM,1902,25,30-34,1927,42
STAT,1884,26,15-19,1910,0.42500285157673245
SIM,1834,57,na,1891,1228
STAT,1876,37,na,1913,2297.6794520886656
SIM,1822,36,35-39,1858,10
STAT,1860,53,na,1913,1626.5727846585778
STAT,1879,27,45-49,1906,1.096348922785716
SIM,1854,25,40-44,1879,2
SIM,1877,38,40-44,1915,6
SIM,1844,34,20-24,1878,5
SIM,1835,25,30-34,1860,20
STAT,1837,47,35-39,1884,0.0917419325672734
SIM,1843,94,na,1937,15
SIM,1903,37,40-44,1940,4
STAT,1936,34,25-29,1970,8.468533603782411
SIM,1780,84,na,1864,94
STAT,1843,19,50-100,1862,0.044638534775228965
SIM,1814,80,na,1894,269
STAT,1904,20,20-24,1924,93.92130365889788
STAT,1929,25,na,1954,4446.171469920068
STAT,1836,28,35-39,1864,7.827745483543731
STAT,1951,17,25-29,1968,48.752522950631636
STAT,1844,54,50-100,1898,0.01031071340145777
STAT,1894,49,30-34,1943,0.06496954819863707
STAT,1870,17,30-34,1887,1.4894509523856956
SIM,1924,15,na,1939,4144
SIM,1925,29,40-44,1954,9
SIM,1808,95,na,1903,4
STAT,1917,29,40-44,1946,4.584572416969643
STAT,1946,24,40-44,1970,3.532401264776153
STAT,1859,39,35-39,1898,5.278780373535658
SIM,1866,26,20-24,1892,8
STAT,1845,86,na,1931,156.2854451220246
SIM,1942,21,45-49,1963,1
SIM,1893,15,na,1908,3162
STAT,1856,60,na,1916,1411.1107768273591
SIM,1844,28,35-39,1872,7
STAT,1907,39,25-29,1946,0.8535625153200247
STAT,1865,23,35-39,1888,5.033926693814994
SIM,1876,24,15-19,1900,3
SIM,1912,20,20-24,1932,97
STAT,1884,88,na,1972,367.0723397390511
STAT,1906,30,na,1936,3337.164718653794
STAT,1888,36,35-39,1924,7.931443802920712
STAT,1828,34,35-39,1862,10.164562237494565
SIM,1892,19,25-29,1911,11
STAT,1826,30,na,1856,1621.2525975619974
SIM,1819,49,50-100,1868,2
SIM,1873,17,na,1890,2427
SIM,1853,33,25-29,1886,11
SIM,1894,27,35-39,1921,12
STAT,1917,31,45-49,1948,1.5629421531937122
SIM,1859,29,35-39,1888,10
SIM,1850,32,45-49,1882,2
SIM,1871,29,35-39,1900,9
STAT,1919,27,na,1946,3823.8195590723535
SIM,1939,8,na,1947,3700
STAT,1908,63,na,1971,2819.2201128043657
SIM,1854,34,na,1888,1870
STAT,1864,50,25-29,1914,0.003033535205293113
STAT,1915,26,50-100,1941,0.9622874579196118
SIM,1876,36,30-34,1912,5
SIM,1887,24,40-44,1911,1
STAT,1908,20,40-44,1928,2.9368998379937916
SIM,1853,31,30-34,1884,17
STAT,1827,42,20-24,1869,0.14609822800255015
STAT,1854,39,35-39,1893,5.041909425186049
STAT,1868,36,30-34,1904,4.830293865974871
STAT,1892,38,15-19,1930,0.06610172880476366
SIM,1832,41,40-44,1873,3
SIM,1893,35,20-24,1928,1
STAT,1834,45,15-19,1879,2.9604085510633184E-4
STAT,1854,31,25-29,1885,7.631938829443246
STAT,1807,105,na,1912,0.010517759195629087
STAT,1836,48,30-34,1884,0.06315741058165766
STAT,1894,33,20-24,1927,3.2709498513780084
SIM,1916,4,na,1920,3942
STAT,1845,33,25-29,1878,8.489695169559074
SIM,1936,31,20-24,1967,1
SIM,1827,36,35-39,1863,8
SIM,1852,3,na,1855,2519
STAT,1893,60,na,1953,2285.976100296679
SIM,1846,15,na,1861,2070
SIM,1823,43,40-44,1866,7
STAT,1871,41,50-100,1912,0.9938899576023906
SIM,1890,72,na,1962,1684
SIM,1821,35,30-34,1856,4
STAT,1897,36,50-100,1933,1.5586148385778482
STAT,1823,97,na,1920,2.8270785561741087
SIM,1882,53,na,1935,1911
STAT,1900,44,25-29,1944,0.05765386087285658
STAT,1886,27,35-39,1913,9.630828518723217
STAT,1882,34,40-44,1916,3.9523958952794813
STAT,1875,28,15-19,1903,0.4387855846518069
STAT,1895,25,35-39,1920,11.975897851748453
STAT,1816,42,45-49,1858,4.475361718206982
STAT,1861,27,30-34,1888,19.898134095302236
SIM,1844,33,30-34,1877,22
SIM,1882,35,45-49,1917,1
STAT,1884,19,25-29,1903,5.261746277698491
STAT,1845,31,30-34,1876,14.775360953458426
STAT,1874,35,45-49,1909,1.9430540864087398
SIM,1928,32,25-29,1960,19
STAT,1832,36,50-100,1868,0.9514121639667522
SIM,1885,29,35-39,1914,10
SIM,1916,20,40-44,1936,3
SIM,1945,0,na,1945,4132
STAT,1885,40,15-19,1925,0.013128676321372325
SIM,1818,43,30-34,1861,1
STAT,1813,53,30-34,1866,0.016843804129713223
STAT,1824,41,40-44,1865,2.918662463218924
STAT,1848,47,50-100,1895,0.17611113469947437
STAT,1887,52,na,1939,2262.7661877600535
SIM,1880,27,35-39,1907,12
STAT,1859,45,20-24,1904,0.009137290539951258
STAT,1871,46,30-34,1917,0.09091479947169155
SIM,1890,34,40-44,1924,6
STAT,1940,12,na,1952,3784.5955118830134
STAT,1880,44,30-34,1924,1.1273431826066385
STAT,1854,49,35-39,1903,0.09870828932827883
STAT,1815,43,40-44,1858,6.042813123119608
STAT,1926,32,50-100,1958,0.94455488284152
STAT,1891,32,40-44,1923,5.0709517678754406
SIM,1848,93,na,1941,15
STAT,1913,10,na,1923,3825.2415991229777
STAT,1819,41,30-34,1860,2.3359819285059698
STAT,1876,42,15-19,1918,0.013451529418742562
STAT,1883,33,45-49,1916,1.6077342252936198
SIM,1841,16,15-19,1857,4
STAT,1843,43,15-19,1886,0.01012762892153869
SIM,1819,37,na,1856,1494
STAT,1927,22,15-19,1949,6.196411865866706
SIM,1818,38,35-39,1856,10
SIM,1835,35,30-34,1870,2
SIM,1855,51,na,1906,1716
SIM,1867,28,30-34,1895,24
STAT,1863,47,35-39,1910,0.11571590153789128
SIM,1823,42,na,1865,1399
STAT,1854,89,na,1943,75.64843453238855
STAT,1928,31,20-24,1959,2.8831878173373595
STAT,1828,49,35-39,1877,0.11484705758179023
STAT,1811,46,50-100,1857,0.8319437479076793
STAT,1833,34,45-49,1867,1.3390907040855122
STAT,1890,40,25-29,1930,0.749192829803351
SIM,1778,81,na,1859,152
SIM,1852,23,na,1875,1962
SIM,1827,56,na,1883,1139
SIM,1935,22,15-19,1957,10
STAT,1842,88,na,1930,97.76137241257632
STAT,1856,101,na,1957,0.5982046231414273
STAT,1906,48,50-100,1954,0.18818071624367605
STAT,1831,26,35-39,1857,8.717529671800554
STAT,1856,44,40-44,1900,1.6417617525016566
STAT,1929,30,25-29,1959,11.104079167078801
STAT,1895,71,na,1966,1926.1019833535306
STAT,1857,3,na,1860,2473.1175317830225
SIM,1909,57,na,1966,3008
STAT,1896,25,50-100,1921,0.8040950353217025
SIM,1864,44,40-44,1908,5
STAT,1859,28,30-34,1887,19.174289488851457
STAT,1836,40,na,1876,1620.4002761635056
SIM,1824,42,45-49,1866,2
STAT,1880,39,35-39,1919,6.959714205371836
STAT,1886,32,30-34,1918,17.426965621141402
STAT,1879,33,50-100,1912,0.900912291717006
SIM,1888,78,na,1966,1196
SIM,1900,38,40-44,1938,1
STAT,1825,47,15-19,1872,4.194201661976565E-4
STAT,1862,30,20-24,1892,2.1957358963253735
STAT,1815,44,50-100,1859,2.7033675593315825
SIM,1925,31,45-49,1956,4
STAT,1889,28,15-19,1917,0.5272779959737557
SIM,1853,26,35-39,1879,17
SIM,1919,21,20-24,1940,100
STAT,1856,29,15-19,1885,0.3428762998281979
SIM,1836,34,35-39,1870,11
STAT,1830,45,30-34,1875,0.07280355230711186
STAT,1870,102,na,1972,2.895250148166866
STAT,1854,38,50-100,1892,0.8797053870046124
STAT,1859,13,na,1872,2079.7021218817363
STAT,1835,37,30-34,1872,4.11105881974795
STAT,1877,36,25-29,1913,2.8361108468840204
SIM,1831,61,na,1892,1136
STAT,1813,48,35-39,1861,0.41635795179302576
STAT,1850,31,40-44,1881,3.2271415245242894
STAT,1788,105,na,1893,0.008599579797849335
STAT,1835,19,30-34,1854,2.508761365227621
STAT,1877,19,35-39,1896,0.5350241939039023
STAT,1906,1,na,1907,3744.2241916081475
STAT,1952,13,na,1965,4446.434070298739
STAT,1853,15,30-34,1868,1.438799566269677
SIM,1869,87,na,1956,145
SIM,1894,54,na,1948,2682
STAT,1895,32,25-29,1927,12.627080434834125
STAT,1875,46,15-19,1921,3.893170964396549E-4
STAT,1825,29,15-19,1854,1.494749050897067
STAT,1857,22,na,1879,1838.30229261173
STAT,1919,16,30-34,1935,2.5592089241402234
SIM,1914,48,na,1962,3720
SIM,1919,16,25-29,1935,54
SIM,1844,24,na,1868,1904
SIM,1870,23,30-34,1893,15
STAT,1881,40,30-34,1921,1.0592443427255764
STAT,1831,44,35-39,1875,1.34310179992543
STAT,1843,25,15-19,1868,0.4086808561654566
STAT,1851,30,45-49,1881,1.358903942432436
SIM,1885,36,25-29,1921,2
STAT,1833,29,20-24,1862,9.292215260429344
SIM,1868,27,35-39,1895,8
SIM,1841,34,45-49,1875,1
STAT,1852,51,45-49,1903,0.011078886725632408
STAT,1864,43,35-39,1907,1.517845208832598
SIM,1843,19,30-34,1862,3
STAT,1828,41,25-29,1869,0.5760407285008328
SIM,1799,63,na,1862,826
STAT,1897,48,45-49,1945,0.1660771508761676
SIM,1858,16,na,1874,2152
STAT,1839,19,15-19,1858,5.115524026311691
STAT,1881,42,25-29,1923,0.5850185294548361
STAT,1836,18,35-39,1854,0.8999332357835642
SIM,1833,40,45-49,1873,2
SIM,1826,37,30-34,1863,2
SIM,1927,16,30-34,1943,20
STAT,1844,34,20-24,1878,2.222540078879727
STAT,1844,59,na,1903,1364.3296743606072
STAT,1848,50,40-44,1898,0.007693356984091913
STAT,1852,78,na,1930,593.6349833141248
STAT,1869,47,30-34,1916,0.0881048086637201
SIM,1859,44,30-34,1903,1
SIM,1872,43,na,1915,2150
STAT,1862,23,30-34,1885,14.588335262571047
STAT,1885,28,30-34,1913,23.617257870733237
STAT,1855,23,40-44,1878,1.7117564561800407
STAT,1887,47,50-100,1934,0.25826585736133384
SIM,1816,40,45-49,1856,1
STAT,1889,46,45-49,1935,0.27602165120648536
SIM,1857,43,50-100,1900,1
STAT,1850,5,na,1855,2163.2162
STAT,1853,27,50-100,1880,0.5495722407531664
SIM,1880,62,na,1942,1930
STAT,1831,51,25-29,1882,0.002336746164195337
STAT,1844,35,30-34,1879,4.435835228355649
STAT,1913,20,20-24,1933,102.37312488778176
STAT,1881,43,35-39,1924,1.6397912067042903
STAT,1892,31,45-49,1923,2.071384021687078
SIM,1873,42,40-44,1915,5
STAT,1848,27,15-19,1875,0.39020666494331346
SIM,1949,22,45-49,1971,1
STAT,1867,32,na,1899,2116.6590521543144
SIM,1903,32,na,1935,3246
STAT,1843,18,25-29,1861,5.193782945964424
SIM,1843,37,30-34,1880,5
SIM,1907,46,na,1953,3156
STAT,1919,24,50-100,1943,0.6764049564968391
SIM,1861,91,na,1952,35
STAT,1853,40,na,1893,1731.3287268767135
SIM,1851,18,25-29,1869,5
STAT,1814,52,35-39,1866,0.022339547082247054
STAT,1860,17,15-19,1877,5.254884402957647
STAT,1933,39,40-44,1972,1.9221485831584781
STAT,1826,50,50-100,1876,0.014178977066172476
SIM,1863,23,40-44,1886,1
SIM,1847,19,15-19,1866,8
STAT,1868,18,na,1886,2305.623940495458
STAT,1825,40,45-49,1865,1.747793084021955
STAT,1872,45,35-39,1917,0.13407176678195185
STAT,1846,54,25-29,1900,0.002428699542293044
STAT,1818,37,30-34,1855,18.06257695354687
SIM,1839,57,na,1896,1420
SIM,1877,32,30-34,1909,23
STAT,1844,53,50-100,1897,0.010432038003437753
STAT,1872,23,na,1895,2235.6150784177576
SIM,1835,43,na,1878,1560
STAT,1801,108,na,1909,6.970067428041403E-4
STAT,1814,51,25-29,1865,0.0093770191051586
SIM,1865,43,45-49,1908,2
SIM,1937,30,25-29,1967,12
STAT,1885,18,30-34,1903,1.4961867169844307
STAT,1943,2,na,1945,4061.666025614462
SIM,1877,34,25-29,1911,12
SIM,1894,32,30-34,1926,28
STAT,1857,43,45-49,1900,1.106572139932472
STAT,1858,42,50-100,1900,0.782531394544955
STAT,1928,16,25-29,1944,51.71543988957765
SIM,1831,42,35-39,1873,4
STAT,1845,21,na,1866,1883.1943196353195
SIM,1921,20,20-24,1941,108
STAT,1870,25,30-34,1895,23.468259818463544
STAT,1905,21,25-29,1926,78.38509617664909
SIM,1827,41,30-34,1868,6
SIM,1846,23,40-44,1869,1
SIM,1857,86,na,1943,135
STAT,1868,19,40-44,1887,0.1659885991765034
SIM,1882,17,15-19,1899,4
SIM,1893,28,30-34,1921,39
STAT,1878,22,50-100,1900,0.40104250725213497
STAT,1899,37,15-19,1936,0.01569132221153856
STAT,1827,35,30-34,1862,5.598025103540794
STAT,1838,23,40-44,1861,1.8306720723181917
SIM,1789,97,na,1886,2
SIM,1895,16,na,1911,3176
STAT,1873,40,na,1913,2238.629987943466
STAT,1874,17,15-19,1891,5.72999589766965
STAT,1894,26,30-34,1920,30.70657129437185
SIM,1816,60,na,1876,978
SIM,1911,51,na,1962,3282
STAT,1830,48,35-39,1878,0.10129269710109565
STAT,1841,36,45-49,1877,1.623747240664895
STAT,1885,19,50-100,1904,0.04586286578358065
STAT,1860,35,15-19,1895,0.04352265937700036
STAT,1829,33,40-44,1862,4.122833102244073
STAT,1834,27,15-19,1861,0.3682568499207395
STAT,1855,52,25-29,1907,0.0024952293648277967
STAT,1869,38,50-100,1907,1.117124598092928
STAT,1889,17,50-100,1906,0.0571378566037773
STAT,1947,23,50-100,1970,0.7023366780591452
STAT,1871,24,35-39,1895,5.43096766806862
SIM,1868,37,35-39,1905,14
SIM,1853,16,35-39,1869,2
SIM,1868,42,30-34,1910,1
STAT,1866,41,45-49,1907,1.3094554715735571
STAT,1835,86,na,1921,138.43515664421463
STAT,1851,27,15-19,1878,0.3895542886770735
STAT,1858,36,15-19,1894,0.04184632994250566
SIM,1862,31,25-29,1893,12
STAT,1805,49,50-100,1854,0.7269115955409106
SIM,1941,26,na,1967,3543
STAT,1780,95,na,1875,2.118434582553956
STAT,1831,72,na,1903,770.1954617181655
STAT,1845,16,35-39,1861,0.49139720269346515
SIM,1863,70,na,1933,1145
SIM,1871,26,na,1897,2298
STAT,1819,36,35-39,1855,20.595668032505582
STAT,1866,48,15-19,1914,3.4401772137017725E-4
STAT,1809,47,30-34,1856,0.35310706257671964
STAT,1853,32,20-24,1885,2.064332637878026
STAT,1869,32,30-34,1901,15.965807995983385
STAT,1907,21,35-39,1928,8.120980424084536
SIM,1852,35,30-34,1887,5
STAT,1865,42,40-44,1907,1.928501997343421
STAT,1822,52,50-100,1874,0.02027504054984887
STAT,1823,42,35-39,1865,2.3460126774414003
STAT,1879,24,40-44,1903,2.0447386410674606
STAT,1913,54,na,1967,3298.314522028751
SIM,1926,24,15-19,1950,5
STAT,1892,32,50-100,1924,1.0839247077205434
STAT,1805,54,35-39,1859,0.024123463982166173
STAT,1818,44,20-24,1862,0.3527049171670723
STAT,1855,50,30-34,1905,0.0042763975844451905
STAT,1868,26,30-34,1894,22.791441956843126
STAT,1910,22,50-100,1932,0.5835725357729242
STAT,1890,33,35-39,1923,11.647673326500033
STAT,1853,25,30-34,1878,21.948308745861
STAT,1876,38,30-34,1914,5.1719189137431405
STAT,1815,46,45-49,1861,0.5838748312572195
STAT,1833,47,50-100,1880,0.17505431434540206
SIM,1848,61,na,1909,1354
STAT,1869,34,25-29,1903,9.286024472676305
STAT,1880,26,30-34,1906,25.11666763640914
STAT,1943,21,45-49,1964,1.1312243270013225
SIM,1861,32,20-24,1893,2
SIM,1915,21,35-39,1936,8
STAT,1917,48,50-100,1965,0.22255025906990206
STAT,1901,21,na,1922,3136.714427529888
SIM,1867,38,30-34,1905,8
SIM,1837,33,40-44,1870,3
SIM,1894,34,25-29,1928,19
STAT,1885,35,20-24,1920,0.7323972908353823
SIM,1867,52,na,1919,1854
SIM,1875,71,na,1946,1221
SIM,1882,32,40-44,1914,7
STAT,1896,13,na,1909,3219.3480872532446
STAT,1896,24,40-44,1920,2.5854153432338896
SIM,1884,38,30-34,1922,10
STAT,1905,35,na,1940,3272.4401558166223
SIM,1861,25,30-34,1886,24
STAT,1882,37,45-49,1919,1.8325127947902013
STAT,1865,27,15-19,1892,0.389478601642959
STAT,1854,24,35-39,1878,4.866669227031876
STAT,1904,31,50-100,1935,1.2464235953908145
STAT,1918,24,15-19,1942,5.389588942356252
STAT,1830,55,na,1885,1257.845168964763
SIM,1862,24,35-39,1886,7
STAT,1875,31,45-49,1906,1.699362146172425
SIM,1883,31,45-49,1914,2
STAT,1886,34,25-29,1920,10.135862167647232
STAT,1840,42,35-39,1882,1.3154913070292835
STAT,1844,17,30-34,1861,1.4223277442918985
STAT,1907,49,40-44,1956,0.13189675660749725
STAT,1872,52,25-29,1924,0.003340665528381329
SIM,1815,41,40-44,1856,5
SIM,1852,17,30-34,1869,2
STAT,1885,41,na,1926,2185.13383604858
SIM,1856,80,na,1936,419
STAT,1855,45,35-39,1900,0.10014166537371566
STAT,1819,43,25-29,1862,1.2187581334154962
SIM,1866,29,25-29,1895,35
STAT,1895,22,30-34,1917,21.958978851502703
STAT,1909,29,50-100,1938,0.8919831437854934
STAT,1854,46,30-34,1900,0.06990302698546468
STAT,1881,50,25-29,1931,0.0032772540479891338
STAT,1864,46,40-44,1910,0.14495639557769766
STAT,1874,32,40-44,1906,4.187236522891253
STAT,1928,21,20-24,1949,131.5628264160022
SIM,1840,37,50-100,1877,3
STAT,1899,40,45-49,1939,0.13590651970733145
STAT,1964,5,na,1969,4676.885058231502
STAT,1860,22,na,1882,1871.818992431269
STAT,1862,38,30-34,1900,4.273473320658295
STAT,1879,54,35-39,1933,0.008267093155220152
STAT,1827,45,25-29,1872,0.05182560934109645
SIM,1833,32,45-49,1865,1
STAT,1831,43,25-29,1874,0.48265195776757774
STAT,1868,39,35-39,1907,6.315404760065
STAT,1885,36,30-34,1921,5.040231314395127
SIM,1891,49,50-100,1940,1
SIM,1870,38,30-34,1908,3
STAT,1877,33,20-24,1910,2.6386719936146537
STAT,1883,49,50-100,1932,0.2226451706548644
STAT,1800,89,na,1889,38.831634322214924
SIM,1840,42,na,1882,1634
STAT,1892,23,45-49,1915,0.8223871004899612
STAT,1862,31,30-34,1893,14.127198515051226
STAT,1832,37,50-100,1869,0.9411977363372589
STAT,1868,40,15-19,1908,0.012581836179299371
STAT,1830,53,30-34,1883,0.0037619499777112437
STAT,1935,24,15-19,1959,6.842933972298631
SIM,1890,37,45-49,1927,5
STAT,1893,16,15-19,1909,7.13071786110814
STAT,1841,41,40-44,1882,1.6197662981315508
SIM,1859,26,30-34,1885,31
SIM,1876,89,na,1965,222
SIM,1858,38,30-34,1896,4
SIM,1880,37,35-39,1917,16
SIM,1828,93,na,1921,13
STAT,1825,32,45-49,1857,3.063223845244798
STAT,1854,36,30-34,1890,3.8562697237201924
STAT,1828,101,na,1929,0.32392960406756044
STAT,1923,47,30-34,1970,0.09852602056576078
SIM,1866,90,na,1956,46
STAT,1858,29,25-29,1887,31.655840719591048
STAT,1775,84,na,1859,92.08444868286757
STAT,1762,98,na,1860,0.1052700472533596
STAT,1842,19,20-24,1861,16.021374694860288
STAT,1894,36,25-29,1930,3.5156989483936623
SIM,1947,20,40-44,1967,3
STAT,1856,92,na,1948,30.816150954941005
STAT,1865,44,50-100,1909,0.8946641417069744
STAT,1822,36,na,1858,1491.276562080243
SIM,1849,87,na,1936,94
STAT,1891,21,50-100,1912,0.4782716653461413
SIM,1879,53,na,1932,2074
STAT,1919,41,20-24,1960,0.018105817142528447
STAT,1899,33,na,1932,3076.3133745968767
STAT,1855,53,35-39,1908,0.005999354532716458
STAT,1822,50,20-24,1872,0.0010308591872718652
SIM,1850,19,20-24,1869,13
STAT,1805,53,25-29,1858,0.010127218255964857
SIM,1936,21,20-24,1957,82
SIM,1927,23,20-24,1950,122
STAT,1846,37,35-39,1883,5.20774754401005
SIM,1853,50,50-100,1903,1
SIM,1919,24,25-29,1943,91
STAT,1835,44,20-24,1879,0.11572509997034577
STAT,1844,42,20-24,1886,0.114182524667258
SIM,1947,11,na,1958,4003
SIM,1862,36,30-34,1898,7
SIM,1939,21,45-49,1960,1
STAT,1868,29,35-39,1897,8.64090908292933
STAT,1816,40,na,1856,1492.3064012962716
SIM,1900,12,na,1912,3359
SIM,1883,18,20-24,1901,15
SIM,1860,10,na,1870,2357
STAT,1939,20,40-44,1959,3.1918460625388145
SIM,1893,18,30-34,1911,3
STAT,1803,77,na,1880,340.1682585840377
STAT,1828,39,40-44,1867,3.9775951033814994
SIM,1871,44,30-34,1915,6
STAT,1897,45,40-44,1942,0.12322573870513691
STAT,1947,22,na,1969,3899.171862334802
SIM,1844,32,20-24,1876,2
STAT,1839,37,na,1876,1706.5928117593648
SIM,1823,62,na,1885,956
STAT,1856,47,45-49,1903,0.17380091748756157
STAT,1898,48,na,1946,2841.533620953759
STAT,1895,37,30-34,1932,6.570302356507819
SIM,1885,26,30-34,1911,30
STAT,1883,30,40-44,1913,4.0474981133634165
STAT,1919,23,20-24,1942,114.67031307944184
SIM,1919,47,na,1966,3767
SIM,1811,61,na,1872,975
SIM,1862,39,35-39,1901,15
SIM,1815,75,na,1890,404
STAT,1831,105,na,1936,0.01788165243632843
SIM,1770,85,na,1855,69
SIM,1864,24,na,1888,2123
STAT,1818,52,20-24,1870,0.0015120639076207773
SIM,1923,29,na,1952,3925
STAT,1877,26,30-34,1903,24.770960539262344
SIM,1841,31,40-44,1872,6
STAT,1872,27,35-39,1899,9.149136195270524
SIM,1889,63,na,1952,2026
SIM,1893,69,na,1962,1956
STAT,1850,12,na,1862,2053.691626884027
SIM,1860,15,15-19,1875,8
STAT,1827,36,na,1863,1575.2382576078041
SIM,1836,39,40-44,1875,2
STAT,1869,67,na,1936,1449.5815115372247
STAT,1828,46,30-34,1874,0.08262027420050429
STAT,1863,44,30-34,1907,0.9418134579766619
SIM,1885,33,20-24,1918,2
STAT,1818,45,30-34,1863,0.21341722562595983
SIM,1901,25,50-100,1926,4
STAT,1833,31,40-44,1864,3.4369954589337612
STAT,1823,45,40-44,1868,0.21020108397908477
STAT,1828,31,30-34,1859,19.497534145516234
STAT,1900,35,na,1935,3117.043444384342
STAT,1904,49,na,1953,2985.0484165075045
SIM,1882,73,na,1955,1052
SIM,1933,20,40-44,1953,5
STAT,1885,43,20-24,1928,0.14839179856790657
SIM,1850,32,50-100,1882,1
STAT,1813,45,30-34,1858,0.30292553130900834
SIM,1844,41,30-34,1885,4
STAT,1871,37,na,1908,2206.4749910155233
SIM,1905,11,na,1916,3531
STAT,1820,108,na,1928,9.758222127626538E-4
STAT,1862,88,na,1950,110.62831078568554
STAT,1792,64,na,1856,742.5116479999998
SIM,1893,36,30-34,1929,6
STAT,1880,36,30-34,1916,5.323089510861335
STAT,1881,26,50-100,1907,0.585493949089606
STAT,1821,37,30-34,1858,11.148915700332177
STAT,1852,33,15-19,1885,0.11086827790947201
STAT,1890,36,40-44,1926,5.080469450302462
STAT,1940,32,na,1972,3697.4123184885952
STAT,1894,34,na,1928,2875.0658120167723
STAT,1807,52,45-49,1859,0.05138759353237786
STAT,1925,20,40-44,1945,3.8252840520683526
STAT,1893,42,15-19,1935,0.016532303867737793
SIM,1836,31,30-34,1867,19
STAT,1873,40,25-29,1913,0.6219830658569883
SIM,1891,30,40-44,1921,6
STAT,1836,41,30-34,1877,0.8748058014666509
SIM,1876,39,35-39,1915,13
SIM,1874,33,45-49,1907,1
STAT,1786,80,na,1866,238.85956705793726
STAT,1966,6,na,1972,4637.38333860372
STAT,1877,41,20-24,1918,0.15639155875313307
SIM,1840,40,35-39,1880,2
STAT,1770,85,na,1855,59.078900000000004
SIM,1906,29,na,1935,3295
STAT,1841,33,40-44,1874,3.562844104754835
SIM,1877,35,35-39,1912,11
STAT,1855,49,50-100,1904,0.17031115958989124
SIM,1844,15,30-34,1859,1
STAT,1805,88,na,1893,45.9664544731058
STAT,1839,17,50-100,1856,0.042732419940983625
STAT,1854,29,40-44,1883,2.228975585354823
STAT,1767,97,na,1864,0.6490321003954358
STAT,1845,26,35-39,1871,8.332410556724975
STAT,1861,46,50-100,1907,0.19321448609761982
SIM,1898,68,na,1966,2230
STAT,1945,11,na,1956,4054.2927668580037
SIM,1835,75,na,1910,631
SIM,1850,95,na,1945,3
STAT,1922,47,na,1969,3987.3561111150398
SIM,1869,32,25-29,1901,11
STAT,1887,38,35-39,1925,7.435453257196445
SIM,1863,42,30-34,1905,7
STAT,1863,51,20-24,1914,6.1571019283463E-4
SIM,1895,38,35-39,1933,22
STAT,1889,43,40-44,1932,2.6043175452148426
SIM,1865,41,na,1906,1993
STAT,1853,18,35-39,1871,0.48662349952363304
SIM,1865,40,40-44,1905,4
STAT,1837,50,50-100,1887,0.009955221114690877
SIM,1897,43,40-44,1940,2
SIM,1794,64,na,1858,820
STAT,1927,43,50-100,1970,0.13898382301664466
SIM,1848,43,45-49,1891,2
STAT,1774,99,na,1873,0.3216621133214299
STAT,1861,34,20-24,1895,2.1023317362010823
SIM,1853,60,na,1913,1518
SIM,1798,78,na,1876,302
STAT,1842,32,50-100,1874,0.7881999095169508
STAT,1841,62,na,1903,1250.518252768825
STAT,1863,52,30-34,1915,0.004916763414277725
STAT,1871,23,25-29,1894,53.44733855603435
STAT,1903,64,na,1967,2592.8842985785636
SIM,1947,1,na,1948,4125
STAT,1853,28,35-39,1881,7.489358094477194
STAT,1880,54,25-29,1934,0.003423936778092523
SIM,1935,18,30-34,1953,16
STAT,1832,40,35-39,1872,1.3786089597879265
STAT,1869,35,35-39,1904,6.529164536972718
STAT,1952,19,50-100,1971,0.42387644616803594
STAT,1851,22,45-49,1873,0.610660438542354
STAT,1887,30,25-29,1917,10.90825881437329
SIM,1818,39,50-100,1857,3
SIM,1918,22,15-19,1940,5
STAT,1811,50,45-49,1861,0.04797034905152804
STAT,1867,44,15-19,1911,0.012083982614000342
STAT,1868,18,30-34,1886,1.4550422195479877
STAT,1834,69,na,1903,908.3453485126477
STAT,1880,42,na,1922,2294.540240735355
STAT,1914,16,50-100,1930,0.07338095215977618
STAT,1852,41,15-19,1893,0.01053980194511375
STAT,1914,15,50-100,1929,0.07354127213302615
SIM,1909,28,30-34,1937,44
SIM,1928,28,na,1956,4353
STAT,1851,37,15-19,1888,0.04162004305143578
SIM,1841,42,45-49,1883,3
SIM,1924,14,na,1938,4432
STAT,1915,45,na,1960,3513.3277248322047
SIM,1829,67,na,1896,843
SIM,1940,3,na,1943,3695
SIM,1877,31,20-24,1908,2
STAT,1908,18,50-100,1926,0.06845930096877907
STAT,1877,49,30-34,1926,0.09291335496190632
SIM,1861,28,35-39,1889,10
STAT,1893,34,15-19,1927,0.16923072082431267
STAT,1840,50,35-39,1890,0.006081650405501036
SIM,1845,41,na,1886,1670
SIM,1876,18,30-34,1894,1
STAT,1817,49,30-34,1866,0.2098385961353156
STAT,1837,35,40-44,1872,3.4350958123861752
STAT,1872,44,25-29,1916,0.60067584348925
STAT,1864,99,na,1963,5.12343221091475
STAT,1831,36,35-39,1867,5.651341847283868
STAT,1810,79,na,1889,307.9799997604875
SIM,1830,44,na,1874,1595
SIM,1866,35,na,1901,2104
STAT,1843,39,30-34,1882,4.000814708014385
SIM,1834,58,na,1892,1211
SIM,1919,17,35-39,1936,5
STAT,1840,45,na,1885,1621.0283766459656
SIM,1835,38,35-39,1873,17
SIM,1899,30,na,1929,3087
STAT,1836,33,30-34,1869,13.792529189991104
SIM,1862,21,30-34,1883,17
STAT,1853,35,25-29,1888,2.1800422209461208
STAT,1869,42,25-29,1911,0.5864890647128934
SIM,1870,72,na,1942,1124
SIM,1895,30,25-29,1925,15
STAT,1859,46,30-34,1905,0.07318709952588805
STAT,1894,29,35-39,1923,11.641768489487283
STAT,1873,41,35-39,1914,1.744261231676513
STAT,1927,18,30-34,1945,14.281198735957625
STAT,1879,65,na,1944,1668.7232032745678
SIM,1854,37,35-39,1891,10
STAT,1822,51,30-34,1873,0.008151754296750016
STAT,1871,16,35-39,1887,0.5202732553022354
STAT,1875,51,na,1926,2099.7296832040774
STAT,1851,17,na,1868,2046.5671246924771
STAT,1833,49,15-19,1882,2.528800429901035E-4
STAT,1826,43,15-19,1869,0.01335374384040137
SIM,1888,14,na,1902,2798
SIM,1889,44,45-49,1933,1
SIM,1901,41,na,1942,3141
STAT,1917,21,45-49,1938,1.1330733188742053
SIM,1877,42,na,1919,2268
STAT,1833,42,45-49,1875,1.1036033853247584
SIM,1961,6,na,1967,4706
STAT,1865,50,40-44,1915,0.009167277657743429
STAT,1862,33,na,1895,1914.8647498904234
STAT,1948,22,35-39,1970,10.214091758702754
SIM,1831,29,na,1860,1673
SIM,1885,34,30-34,1919,20
STAT,1863,25,40-44,1888,2.523666705956248
STAT,1906,20,na,1926,3272.793820887498
SIM,1910,20,45-49,1930,1
STAT,1805,105,na,1910,0.009817395413353283
STAT,1880,47,35-39,1927,0.13851100938627195
STAT,1854,21,30-34,1875,15.179703103216127
STAT,1877,34,30-34,1911,16.969516545606496
STAT,1903,20,50-100,1923,0.5513539691204831
STAT,1868,93,na,1961,54.76996037612119
STAT,1827,38,35-39,1865,6.895603342761096
SIM,1925,21,45-49,1946,2
STAT,1851,19,15-19,1870,5.228972379000467
STAT,1797,96,na,1893,2.0907231886698217
SIM,1851,39,30-34,1890,8
STAT,1933,30,na,1963,4820.407105196742
SIM,1856,42,40-44,1898,7
STAT,1863,18,na,1881,2164.9972283485863
SIM,1881,41,35-39,1922,1
STAT,1843,46,20-24,1889,0.00872821358568372
STAT,1859,53,20-24,1912,5.474029737076046E-4
STAT,1911,33,50-100,1944,0.757195603609306
STAT,1880,29,35-39,1909,9.522470843368527
SIM,1853,17,na,1870,2199
STAT,1947,22,40-44,1969,3.5901249049918653
STAT,1880,21,25-29,1901,57.073839943190265
STAT,1836,40,20-24,1876,0.12240222703563726
SIM,1847,76,na,1923,629
SIM,1831,92,na,1923,21
STAT,1902,20,45-49,1922,0.9351796857483891
STAT,1821,41,50-100,1862,1.8178967262224313
STAT,1900,36,25-29,1936,0.8183851608975273
STAT,1872,37,35-39,1909,6.706560443919021
SIM,1821,38,35-39,1859,15
SIM,1843,62,na,1905,1295
SIM,1871,25,40-44,1896,2
STAT,1806,50,35-39,1856,0.025304186678023262
SIM,1876,27,50-100,1903,1
SIM,1858,48,na,1906,1787
STAT,1808,53,na,1861,1191.2719563567755
SIM,1885,16,30-34,1901,1
STAT,1811,96,na,1907,3.7193033881301205
STAT,1937,32,25-29,1969,8.63729081474385
STAT,1848,42,40-44,1890,1.6184362320001258
STAT,1895,47,30-34,1942,0.06700106365653472
SIM,1912,13,na,1925,3623
STAT,1835,19,50-100,1854,0.07711355087614949
STAT,1920,48,45-49,1968,0.22634184031029633
SIM,1842,17,20-24,1859,19
SIM,1939,24,na,1963,3400
STAT,1870,30,50-100,1900,0.8549580296978269
STAT,1852,6,na,1858,2292.4751004454824
SIM,1934,32,50-100,1966,5
STAT,1869,39,30-34,1908,4.824511785599472
STAT,1915,47,25-29,1962,0.050490841057175814
STAT,1884,47,20-24,1931,0.011150250537250866
STAT,1933,36,50-100,1969,0.5407404206188005
SIM,1840,32,35-39,1872,12
SIM,1849,29,25-29,1878,39
STAT,1885,39,35-39,1924,6.589889087076357
STAT,1836,92,na,1928,26.301147921682876
STAT,1881,46,40-44,1927,0.15660241336906508
SIM,1845,36,30-34,1881,3
SIM,1948,16,15-19,1964,47
SIM,1859,34,50-100,1893,5
SIM,1923,26,50-100,1949,4
SIM,1929,13,na,1942,4859
STAT,1837,101,na,1938,0.360210539913727
STAT,1829,37,35-39,1866,6.31179773056996
STAT,1904,18,na,1922,3412.7845728616526
SIM,1877,24,30-34,1901,14
SIM,1886,36,40-44,1922,8
STAT,1878,36,40-44,1914,4.325786711305881
SIM,1846,59,na,1905,1356
STAT,1891,14,na,1905,3009.9692226167385
STAT,1867,48,30-34,1915,0.08478279214503255
STAT,1769,105,na,1874,0.017115227888920524
STAT,1844,45,25-29,1889,0.041073397336429215
SIM,1890,17,na,1907,3028
STAT,1828,73,na,1901,674.2592730644258
STAT,1835,33,15-19,1868,0.11195270149090401
SIM,1884,16,15-19,1900,5
SIM,1863,27,35-39,1890,8
SIM,1886,22,30-34,1908,23
SIM,1929,32,40-44,1961,4
STAT,1823,41,25-29,1864,0.856091907365045
STAT,1895,15,50-100,1910,0.060677791733440165
STAT,1878,22,30-34,1900,17.51753481694799
STAT,1925,23,45-49,1948,1.268560893864813
SIM,1813,43,30-34,1856,1
SIM,1877,39,30-34,1916,3
STAT,1884,21,45-49,1905,0.652942743133434
SIM,1893,39,35-39,1932,14
STAT,1789,77,na,1866,299.64299002792075
SIM,1806,94,na,1900,9
STAT,1880,19,40-44,1899,0.18083036670389663
SIM,1826,101,na,1927,1
SIM,1901,30,45-49,1931,1
STAT,1870,21,15-19,1891,3.0630256028402516
SIM,1854,33,40-44,1887,3
SIM,1872,35,35-39,1907,14
SIM,1822,56,na,1878,1205
STAT,1818,48,35-39,1866,0.2946170714104961
SIM,1899,53,na,1952,2729
STAT,1863,94,na,1957,21.750973344125327
STAT,1876,52,45-49,1928,0.014077964799460815
STAT,1895,40,25-29,1935,0.799639099317001
SIM,1820,42,50-100,1862,3
SIM,1914,48,50-100,1962,1
STAT,1900,15,na,1915,3325.411838782183
STAT,1858,28,15-19,1886,0.3419791197009239
STAT,1904,29,na,1933,3210.207721291058
SIM,1828,43,40-44,1871,6
SIM,1918,26,30-34,1944,38
STAT,1814,41,30-34,1855,3.7456300512317484
STAT,1878,37,30-34,1915,5.241386726875277
SIM,1880,34,30-34,1914,23
STAT,1957,12,na,1969,4891.892761211648
STAT,1872,34,30-34,1906,16.4136040423905
STAT,1930,3,na,1933,4954.0999283858155
SIM,1857,22,na,1879,1974
STAT,1869,31,20-24,1900,2.4818776127128266
STAT,1881,32,30-34,1913,15.92577607553665
STAT,1945,3,na,1948,4138.237147457056
STAT,1900,29,35-39,1929,12.555402771710368
SIM,1909,20,20-24,1929,92
STAT,1893,38,30-34,1931,6.356432224142942
STAT,1867,26,15-19,1893,0.4038154201289563
STAT,1821,42,na,1863,1482.7726358296386
SIM,1898,29,20-24,1927,13
STAT,1892,20,40-44,1912,2.4798685465912134
STAT,1904,30,20-24,1934,3.6916034733764134
STAT,1880,73,na,1953,1180.624269306961
STAT,1876,36,na,1912,2308.7383085867964
STAT,1873,33,35-39,1906,9.669947812526104
STAT,1853,41,30-34,1894,0.8564607930033811
SIM,1857,44,50-100,1901,1
STAT,1843,20,45-49,1863,0.6406430069025453
STAT,1872,41,20-24,1913,0.1512682529315058
STAT,1897,38,15-19,1935,0.07059464141760052
SIM,1845,35,40-44,1880,2
SIM,1939,18,15-19,1957,41
STAT,1809,93,na,1902,12.277075811472097
STAT,1850,46,50-100,1896,0.17339387246820634
SIM,1867,21,na,1888,2079
STAT,1869,50,25-29,1919,0.0032854919368499676
STAT,1823,34,35-39,1857,20.130831353314797
STAT,1869,98,na,1967,14.333948782386104
STAT,1873,47,45-49,1920,0.22524733199764158
STAT,1860,39,30-34,1899,4.050652400928625
SIM,1845,21,30-34,1866,19
SIM,1857,28,20-24,1885,15
STAT,1922,21,25-29,1943,100.37746391809715
STAT,1806,74,na,1880,455.68627633875985
STAT,1852,44,20-24,1896,0.11903304290106727
SIM,1930,21,25-29,1951,131
STAT,1803,108,na,1911,6.051601979944686E-4
STAT,1826,104,na,1930,0.03640602555145865
STAT,1855,27,35-39,1882,7.123019791279228
STAT,1847,39,15-19,1886,0.0419880491357007
STAT,1890,25,35-39,1915,11.220382806006867
STAT,1890,32,25-29,1922,11.830484691416554
STAT,1890,72,na,1962,1658.2627763600692
SIM,1874,30,40-44,1904,5
STAT,1825,45,na,1870,1495.2934368434187
SIM,1814,42,35-39,1856,4
SIM,1819,39,40-44,1858,5
STAT,1837,36,30-34,1873,4.139001957767075
STAT,1944,18,30-34,1962,12.38730879726284
STAT,1859,49,35-39,1908,0.10334564476873165
STAT,1879,53,25-29,1932,0.003441341089264483
SIM,1875,19,25-29,1894,8
STAT,1849,28,20-24,1877,9.951732586727532
STAT,1872,53,35-39,1925,0.008032061966923552
SIM,1956,15,na,1971,4479
STAT,1880,15,50-100,1895,0.048924107489974666
SIM,1856,69,na,1925,1127
SIM,1912,30,20-24,1942,1
SIM,1851,20,45-49,1871,1
SIM,1886,12,na,1898,2527
STAT,1840,45,40-44,1885,0.12335097709268887
STAT,1914,28,na,1942,3554.44852555902
STAT,1899,29,15-19,1928,0.5831713807453378
STAT,1779,78,na,1857,285.19873390934987
STAT,1840,22,na,1862,1893.6004628875853
STAT,1886,67,na,1953,1582.244204174112
STAT,1948,8,na,1956,4249.221414012224
STAT,1840,31,30-34,1871,14.964451309903447
STAT,1867,19,25-29,1886,5.078126383870191
STAT,1942,29,40-44,1971,4.616656477023317
STAT,1805,50,20-24,1855,0.002241389435667027
STAT,1847,50,25-29,1897,0.0026436248633091284
STAT,1931,28,na,1959,4566.866816961482
SIM,1843,15,15-19,1858,7
STAT,1882,53,na,1935,1947.5197751939982
SIM,1790,82,na,1872,132
SIM,1828,34,50-100,1862,3
STAT,1857,40,40-44,1897,1.6920527953862128
SIM,1944,23,20-24,1967,112
STAT,1885,46,25-29,1931,0.0543658483991308
STAT,1932,39,25-29,1971,1.2471204020636066
STAT,1936,23,20-24,1959,100.37701011218037
SIM,1820,45,na,1865,1385
STAT,1819,37,na,1856,1459.374968389897
STAT,1837,54,30-34,1891,0.0036543831493628144
STAT,1841,44,45-49,1885,1.0371339745771595
SIM,1870,31,30-34,1901,21
STAT,1925,41,45-49,1966,0.19064933053494926
STAT,1823,74,na,1897,584.0130271797617
SIM,1831,34,35-39,1865,5
SIM,1873,69,na,1942,1387
SIM,1864,47,50-100,1911,2
SIM,1878,35,30-34,1913,7
SIM,1890,30,25-29,1920,17
STAT,1831,33,30-34,1864,14.148226061783676
SIM,1925,31,na,1956,4130
STAT,1848,18,na,1866,2037.9199891896894
STAT,1936,19,35-39,1955,3.7741604452948567
SIM,1851,17,15-19,1868,7
STAT,1860,43,15-19,1903,0.01052603923385137
SIM,1924,39,40-44,1963,1
STAT,1831,52,35-39,1883,0.005568199481105668
STAT,1827,51,30-34,1878,0.005135415027026494
STAT,1863,73,na,1936,986.3259412064417
SIM,1895,71,na,1966,1942
STAT,1868,32,15-19,1900,0.12844845121373222
SIM,1851,37,na,1888,1771
STAT,1864,42,25-29,1906,0.5415125830537799
SIM,1897,2,na,1899,3387
STAT,1847,54,40-44,1901,0.007533112202461717
STAT,1899,47,15-19,1946,2.9074585797413203E-4
STAT,1815,55,na,1870,1134.5247372567956
STAT,1881,17,35-39,1898,0.5005017403817209
SIM,1834,29,30-34,1863,18
SIM,1842,77,na,1919,568
SIM,1850,96,na,1946,3
STAT,1898,41,40-44,1939,0.20064931569795402
STAT,1859,68,na,1927,1152.1456402900603
SIM,1896,26,35-39,1922,13
STAT,1843,17,15-19,1860,5.471479821796813
STAT,1911,47,40-44,1958,0.14097291156020755
SIM,1942,12,na,1954,3729
STAT,1866,47,na,1913,1950.4509508375838
STAT,1871,20,20-24,1891,64.92462461767575
STAT,1920,35,na,1955,3898.297566586482
STAT,1855,54,na,1909,1483.0173883512407
STAT,1843,74,na,1917,800.6629450198568
STAT,1835,51,45-49,1886,0.00941241522528923
SIM,1864,88,na,1952,111
STAT,1906,21,40-44,1927,2.875160549684156
STAT,1826,29,30-34,1855,47.45871383784852
STAT,1868,46,25-29,1914,0.05210138338112285
SIM,1881,33,35-39,1914,15
STAT,1925,22,50-100,1947,0.7441479212876644
SIM,1891,4,na,1895,3226
STAT,1894,42,30-34,1936,0.09689805493648626
STAT,1861,23,15-19,1884,2.639670782876075
STAT,1893,49,na,1942,2640.881165419875
STAT,1896,43,30-34,1939,0.0989569251403314
SIM,1944,19,35-39,1963,5
SIM,1841,47,50-100,1888,3
STAT,1882,30,25-29,1912,9.491197995606246
SIM,1843,18,na,1861,2094
STAT,1851,92,na,1943,30.54219974209994
SIM,1907,45,50-100,1952,1
STAT,1916,39,40-44,1955,1.4335932508972322
SIM,1918,5,na,1923,4092
STAT,1852,15,15-19,1867,5.518165374463857
STAT,1877,44,25-29,1921,0.6210201390451248
STAT,1877,42,30-34,1919,1.125651717869868
SIM,1928,22,25-29,1950,105
SIM,1829,35,35-39,1864,10
STAT,1871,28,30-34,1899,23.50092783562879
STAT,1831,26,50-100,1857,0.5779436972406307
SIM,1907,30,50-100,1937,3
SIM,1886,37,30-34,1923,10
STAT,1832,28,15-19,1860,0.36798498351907644
STAT,1859,57,na,1916,1515.1101372593778
SIM,1848,40,40-44,1888,4
SIM,1903,15,30-34,1918,2
STAT,1877,16,30-34,1893,1.5663347974444215
STAT,1914,48,20-24,1962,0.010323286261692705
STAT,1829,52,30-34,1881,0.004222444383140275
STAT,1819,92,na,1911,20.79917538483938
STAT,1867,87,na,1954,156.27244004016802
STAT,1826,47,30-34,1873,0.09050867154844011
STAT,1807,59,na,1866,1026.5270711299834
STAT,1872,26,45-49,1898,1.0564048849913397
STAT,1888,44,35-39,1932,1.993608393526473
STAT,1868,27,50-100,1895,0.5769878429940141
SIM,1828,41,na,1869,1463
STAT,1857,36,20-24,1893,0.5768534351672917
SIM,1892,21,45-49,1913,4
STAT,1828,96,na,1924,4.874443701671981
STAT,1846,33,40-44,1879,3.5761112767016843
SIM,1918,33,20-24,1951,2
STAT,1883,48,15-19,1931,3.656931158791152E-4
STAT,1913,5,na,1918,3870.0053412494476
STAT,1921,30,20-24,1951,2.5851197609110375
STAT,1784,108,na,1892,0.001631371338668803
SIM,1877,38,50-100,1915,4
SIM,1845,24,35-39,1869,3
STAT,1843,35,15-19,1878,0.04828782659781666
STAT,1795,84,na,1879,106.3199370054011
SIM,1820,34,25-29,1854,7
STAT,1836,43,25-29,1879,0.47626892677621224
STAT,1776,81,na,1857,162.03064539321593
STAT,1799,98,na,1897,1.086085525102431
STAT,1814,60,na,1874,1002.2517678129425
STAT,1899,9,na,1908,3359.0469571619906
SIM,1830,24,40-44,1854,1
STAT,1876,45,20-24,1921,0.011819739761626001
STAT,1906,49,25-29,1955,0.04376198305326055
SIM,1924,23,50-100,1947,3
SIM,1938,30,40-44,1968,4
STAT,1846,39,na,1885,1699.0375431029877
STAT,1884,18,15-19,1902,5.525623702428084
SIM,1869,37,30-34,1906,8
STAT,1837,24,35-39,1861,4.75336816415969
STAT,1843,73,na,1916,856.9105537692717
STAT,1847,87,na,1934,129.63182996258402
SIM,1842,44,50-100,1886,3
SIM,1889,41,40-44,1930,7
STAT,1833,50,45-49,1883,0.009468393563536343
STAT,1822,43,30-34,1865,1.6881764548676346
SIM,1841,82,na,1923,275
SIM,1813,49,50-100,1862,3
SIM,1895,34,40-44,1929,4
STAT,1893,45,20-24,1938,0.008194318766345242
STAT,1856,37,15-19,1893,0.04154842273242278
SIM,1782,86,na,1868,59
SIM,1898,13,na,1911,3257
SIM,1885,42,30-34,1927,1
STAT,1887,34,40-44,1921,4.5424989956519575
SIM,1825,30,45-49,1855,1
SIM,1876,8,na,1884,2656
STAT,1826,54,20-24,1880,6.399214940503755E-4
SIM,1868,16,30-34,1884,3
SIM,1937,12,na,1949,3507
SIM,1864,55,na,1919,1845
SIM,1914,21,40-44,1935,4
STAT,1863,29,35-39,1892,7.955333683517897
STAT,1831,40,20-24,1871,0.12421172442694708
STAT,1815,78,na,1893,334.4113759981073
SIM,1878,16,na,1894,2571
STAT,1875,18,20-24,1893,17.16113353294772
SIM,1864,19,15-19,1883,5
SIM,1860,41,na,1901,1936
STAT,1896,25,30-34,1921,31.653715008510485
STAT,1907,20,45-49,1927,0.9732834200308165
SIM,1894,9,na,1903,3314
STAT,1832,46,45-49,1878,0.17135294276971574
STAT,1868,52,30-34,1920,0.00534048065552164
STAT,1877,37,35-39,1914,6.933705000027459
SIM,1830,25,30-34,1855,27
STAT,1863,21,25-29,1884,48.83554443464786
SIM,1904,31,25-29,1935,5
SIM,1885,37,35-39,1922,11
STAT,1856,19,15-19,1875,5.131016386987074
STAT,1832,32,35-39,1864,8.016545751394315
STAT,1930,20,20-24,1950,135.37956427615208
SIM,1871,21,25-29,1892,58
SIM,1872,42,25-29,1914,2
STAT,1814,44,35-39,1858,5.147684470598573
STAT,1782,108,na,1890,0.004636645724829455
STAT,1856,91,na,1947,42.875241331971246
STAT,1824,44,45-49,1868,1.7998597867642079
SIM,1887,72,na,1959,1320
STAT,1777,96,na,1873,1.40831766026563
SIM,1932,13,na,1945,4805
STAT,1859,108,na,1967,0.013438933801428826
SIM,1944,26,25-29,1970,73
SIM,1851,43,50-100,1894,1
STAT,1868,50,45-49,1918,0.013277971015969378
SIM,1904,39,50-100,1943,1
STAT,1884,24,na,1908,2194.0451826838025
STAT,1843,43,50-100,1886,0.7747635558830023
SIM,1853,30,20-24,1883,2
STAT,1908,23,45-49,1931,0.9739502303527896
STAT,1855,42,30-34,1897,0.8132348815319547
STAT,1838,49,15-19,1887,2.735707678910959E-4
SIM,1845,39,35-39,1884,12
SIM,1851,92,na,1943,23
SIM,1835,39,25-29,1874,2
SIM,1891,57,na,1948,2384
STAT,1934,31,45-49,1965,2.0307721354661523
STAT,1806,53,40-44,1859,0.029133948596283255
STAT,1895,36,40-44,1931,5.422558590708538
STAT,1898,37,20-24,1935,0.9857823190201693
STAT,1817,45,15-19,1862,9.237362581663819E-4
STAT,1900,41,20-24,1941,0.014518977088095925
SIM,1802,57,na,1859,1054
SIM,1823,32,35-39,1855,10
STAT,1871,49,35-39,1920,0.12837847969502386
STAT,1938,32,40-44,1970,3.7168049942464645
STAT,1834,30,45-49,1864,1.4116603454238474
STAT,1814,93,na,1907,12.058279094737717
SIM,1928,15,35-39,1943,10
SIM,1890,23,35-39,1913,7
STAT,1882,23,35-39,1905,5.3476898842009835
STAT,1877,86,na,1963,390.60213639863434
STAT,1901,28,40-44,1929,3.9470523624755143
STAT,1937,12,na,1949,3640.947640604437
STAT,1888,19,45-49,1907,0.07250962802185973
STAT,1825,33,50-100,1858,1.4660850078270555
STAT,1809,54,20-24,1863,0.0024574425466492495
SIM,1840,43,40-44,1883,8
STAT,1891,35,45-49,1926,2.3531351765503996
STAT,1881,35,35-39,1916,6.512793615100582
STAT,1850,105,na,1955,0.020641820342540744
SIM,1885,19,35-39,1904,1
SIM,1918,21,25-29,1939,85
SIM,1861,36,na,1897,2055
STAT,1894,18,50-100,1912,0.05937993959225822
SIM,1862,38,50-100,1900,4
STAT,1936,26,25-29,1962,59.52355749833384
STAT,1852,19,30-34,1871,1.4474293571162902
STAT,1859,53,50-100,1912,0.011203513751639211
STAT,1884,36,15-19,1920,0.052674826269838194
STAT,1907,46,na,1953,3131.0247039235387
STAT,1835,102,na,1937,0.1829206039463458
SIM,1855,25,35-39,1880,13
STAT,1923,49,25-29,1972,0.05828341581178389
STAT,1816,39,15-19,1855,0.19428428892802022
SIM,1851,81,na,1932,325
SIM,1921,31,25-29,1952,14
STAT,1882,50,40-44,1932,0.009816612897776878
SIM,1892,18,15-19,1910,6
STAT,1860,21,na,1881,1885.3558474157146
STAT,1875,20,na,1895,2309.0650797227186
SIM,1822,44,35-39,1866,5
SIM,1832,44,45-49,1876,2
STAT,1872,50,30-34,1922,0.005725330984550653
SIM,1842,30,45-49,1872,2
STAT,1827,31,15-19,1858,0.17324366060199917
STAT,1837,31,25-29,1868,8.191493992722203
STAT,1848,73,na,1921,855.6849668473104
SIM,1832,23,na,1855,1754
SIM,1834,89,na,1923,55
SIM,1860,19,30-34,1879,1
STAT,1880,21,na,1901,2357.952020568078
STAT,1949,21,40-44,1970,3.707989300957483
SIM,1844,36,35-39,1880,12
STAT,1874,51,45-49,1925,0.014079236373100672
SIM,1854,36,45-49,1890,2
STAT,1839,37,15-19,1876,0.044744010853869566
STAT,1864,51,35-39,1915,0.007303499408151805
SIM,1830,75,na,1905,636
STAT,1759,107,na,1866,0.003263382779516776
STAT,1864,35,na,1899,2008.0683368183677
STAT,1847,25,35-39,1872,8.65719482040711
STAT,1894,22,15-19,1916,4.009040846755194
SIM,1909,24,15-19,1933,4
STAT,1845,30,20-24,1875,2.3113513489773605
STAT,1837,39,35-39,1876,5.324427034843213
SIM,1853,38,30-34,1891,5
STAT,1827,39,25-29,1866,2.7392940585415486
STAT,1913,31,25-29,1944,8.72065769805322
STAT,1869,17,35-39,1886,0.508707958620979
SIM,1863,24,30-34,1887,21
SIM,1902,47,na,1949,2997
SIM,1934,24,na,1958,4566
STAT,1850,34,45-49,1884,1.257854467221115
SIM,1878,34,40-44,1912,6
STAT,1840,34,35-39,1874,8.413533828899126
SIM,1831,31,30-34,1862,18
SIM,1853,4,na,1857,2425
SIM,1868,34,30-34,1902,19
SIM,1911,17,30-34,1928,2
SIM,1881,44,40-44,1925,5
STAT,1858,28,na,1886,1798.8462593567851
STAT,1855,24,30-34,1879,14.526942111137153
STAT,1860,20,45-49,1880,0.6152823467291021
STAT,1842,25,20-24,1867,10.481079262734568
STAT,1890,22,30-34,1912,20.57366819531591
SIM,1874,54,na,1928,1976
SIM,1845,31,25-29,1876,11
SIM,1878,68,na,1946,1515
STAT,1908,41,45-49,1949,0.1462676558181219
STAT,1903,17,30-34,1920,2.142213218774423
STAT,1932,13,na,1945,4948.8890346928965
STAT,1936,27,na,1963,3386.250602883299
STAT,1854,69,na,1923,1056.7695194787934
STAT,1847,43,35-39,1890,1.3227515295431604
STAT,1846,36,45-49,1882,1.4831122594213768
STAT,1948,18,15-19,1966,49.05254865584998
STAT,1888,26,35-39,1914,10.805256105500614
STAT,1836,36,35-39,1872,5.5395544128475125
SIM,1878,30,25-29,1908,14
SIM,1850,25,20-24,1875,12
STAT,1798,58,na,1856,996.7276405276998
STAT,1865,21,na,1886,2069.80452930303
STAT,1837,25,na,1862,1778.1508980208482
SIM,1918,29,35-39,1947,13
SIM,1855,43,35-39,1898,5
SIM,1938,27,na,1965,3425
STAT,1852,47,25-29,1899,0.04355886199444649
SIM,1916,23,45-49,1939,1
STAT,1873,44,40-44,1917,2.127735916890291
STAT,1840,41,25-29,1881,0.47251923827587117
STAT,1828,45,40-44,1873,0.14806605501350004
SIM,1858,17,na,1875,2143
STAT,1902,7,na,1909,3473.3257787760012
STAT,1823,31,30-34,1854,54.616850089314106
STAT,1831,41,na,1872,1583.0129672025662
STAT,1835,55,na,1890,1290.1080527439842
STAT,1849,38,15-19,1887,0.04098949707344472
STAT,1863,54,25-29,1917,0.0028604508251095554
STAT,1870,28,35-39,1898,8.900279037709247
SIM,1773,82,na,1855,131
STAT,1842,47,15-19,1889,2.848923897953166E-4
STAT,1924,25,50-100,1949,1.1023578790845139
STAT,1847,36,50-100,1883,0.9470585309914669
STAT,1878,25,35-39,1903,9.553641314603293
STAT,1871,8,na,1879,2543.597571817509
STAT,1886,46,na,1932,2251.9961484308737
STAT,1862,33,25-29,1895,8.21904670090548
STAT,1858,4,na,1862,2309.1052762818535
SIM,1855,40,na,1895,1862
SIM,1777,96,na,1873,1
STAT,1873,29,15-19,1902,0.43194969442377656
STAT,1883,39,na,1922,2159.36774283381
STAT,1854,58,na,1912,1424.0565287608258
STAT,1929,20,50-100,1949,0.7908060894685149
SIM,1886,25,35-39,1911,12
SIM,1881,36,na,1917,1960
STAT,1936,17,50-100,1953,0.338795439240508
STAT,1775,85,na,1860,74.52394431904473
SIM,1937,7,na,1944,3539
SIM,1844,88,na,1932,73
SIM,1829,28,45-49,1857,4
SIM,1855,36,50-100,1891,4
STAT,1850,16,15-19,1866,5.135621822320388
STAT,1902,47,na,1949,2985.9429124637422
STAT,1921,36,45-49,1957,0.7198114994852035
STAT,1879,50,20-24,1929,7.391162141008428E-4
STAT,1899,19,20-24,1918,22.82851087830803
STAT,1921,15,25-29,1936,46.88526792340385
STAT,1896,46,35-39,1942,0.09887860005859551
SIM,1914,39,30-34,1953,3
SIM,1929,3,na,1932,4940
STAT,1878,32,25-29,1910,10.073115086518362
STAT,1872,23,40-44,1895,1.9697668990157131
STAT,1900,36,na,1936,3127.062001867415
STAT,1891,17,15-19,1908,6.93931013171991
STAT,1901,24,25-29,1925,75.22126077828612
SIM,1886,32,25-29,1918,15
SIM,1847,55,na,1902,1478
SIM,1878,38,35-39,1916,12
SIM,1860,37,30-34,1897,6
STAT,1861,41,45-49,1902,1.1793917187763938
SIM,1853,23,30-34,1876,19
STAT,1847,18,45-49,1865,0.05963472846424444
STAT,1936,16,30-34,1952,11.049217781103689
STAT,1845,23,30-34,1868,15.46400936155825
STAT,1842,29,15-19,1871,0.3938288643370396
STAT,1834,49,30-34,1883,0.061937373711990734
STAT,1914,6,na,1920,3903.2511661062185
STAT,1932,36,20-24,1968,0.3349092598534105
STAT,1829,31,50-100,1860,0.9181826831292409
STAT,1852,37,30-34,1889,4.071237345384361
SIM,1795,81,na,1876,181
SIM,1939,22,35-39,1961,14
STAT,1840,16,35-39,1856,0.497685947347899
STAT,1849,41,45-49,1890,1.083645668413184
SIM,1886,35,na,1921,2325
STAT,1883,26,20-24,1909,10.899039638415982
SIM,1856,33,50-100,1889,1
SIM,1944,16,30-34,1960,18
STAT,1858,46,15-19,1904,2.974938452619687E-4
SIM,1891,33,45-49,1924,2
STAT,1837,21,30-34,1858,14.826304009206282
STAT,1963,4,na,1967,4718.519524832392
SIM,1787,85,na,1872,77
SIM,1830,28,35-39,1858,4
STAT,1820,45,na,1865,1408.8168945159953
STAT,1868,43,20-24,1911,0.1422109323309018
STAT,1906,39,30-34,1945,1.5664952531725287
STAT,1839,52,40-44,1891,0.00698217438176012
SIM,1807,56,na,1863,1044
STAT,1805,89,na,1894,35.174909956454755
SIM,1870,26,35-39,1896,9
SIM,1870,95,na,1965,44
SIM,1952,18,30-34,1970,15
STAT,1928,42,25-29,1970,0.08600756179325564
SIM,1845,29,40-44,1874,2
STAT,1845,38,30-34,1883,3.9036062614989744
STAT,1850,49,15-19,1899,2.7572108230006107E-4
STAT,1837,29,40-44,1866,2.3923986383483813
STAT,1872,87,na,1959,241.3361207257468
SIM,1817,89,na,1906,45
STAT,1831,25,45-49,1856,1.0411129696239212
STAT,1898,44,45-49,1942,0.1311141709783628
SIM,1951,16,na,1967,4084
STAT,1836,47,40-44,1883,0.11314015717129472
SIM,1908,21,45-49,1929,5
STAT,1862,26,35-39,1888,7.860574536983149
STAT,1873,0,na,1873,3545.819623239157
STAT,1830,27,30-34,1857,24.5034103637826
STAT,1930,42,45-49,1972,0.20687922790152458
SIM,1939,23,na,1962,3414
SIM,1938,33,45-49,1971,1
SIM,1903,5,na,1908,3481
SIM,1882,21,35-39,1903,7
SIM,1861,29,25-29,1890,37
SIM,1877,83,na,1960,463
STAT,1832,26,na,1858,1740.1970850942848
STAT,1906,46,20-24,1952,0.009337934255468555
STAT,1893,48,25-29,1941,0.03845513000374623
SIM,1796,99,na,1895,2
STAT,1894,40,45-49,1934,1.8370992891057645
STAT,1886,8,na,1894,2594.669883390723
STAT,1928,23,50-100,1951,0.773782653921314
SIM,1936,17,35-39,1953,4
STAT,1886,31,20-24,1917,2.7090139029298097
SIM,1846,37,50-100,1883,1
SIM,1884,21,na,1905,2299
SIM,1916,50,na,1966,3440
STAT,1903,48,45-49,1951,0.1766744226644128
STAT,1823,50,35-39,1873,0.010280757001204862
SIM,1893,68,na,1961,1998
SIM,1936,24,25-29,1960,69
SIM,1931,9,na,1940,4910
STAT,1936,9,na,1945,3599.842841518248
SIM,1837,22,na,1859,1746
SIM,1855,95,na,1950,9
STAT,1863,19,40-44,1882,0.1558644715830674
STAT,1832,43,40-44,1875,1.647135287542409
SIM,1926,20,20-24,1946,117
STAT,1873,15,35-39,1888,0.5324151464711375
STAT,1896,28,35-39,1924,12.004592514960189
SIM,1915,10,na,1925,3863
SIM,1919,24,na,1943,3744
STAT,1872,54,na,1926,1985.4948555388619
STAT,1884,35,na,1919,2220.286217551884
STAT,1837,66,na,1903,1034.6377849440662
STAT,1928,17,35-39,1945,4.995335840308582
SIM,1894,31,20-24,1925,3
STAT,1822,53,25-29,1875,0.004661369197713038
SIM,1862,35,40-44,1897,4
STAT,1890,41,35-39,1931,2.1010025510509194
SIM,1827,33,30-34,1860,22
STAT,1794,99,na,1893,0.3402840877379649
STAT,1853,29,25-29,1882,32.5980020826039
STAT,1921,19,50-100,1940,0.40130971387068926
SIM,1920,32,na,1952,3838
STAT,1819,40,20-24,1859,0.33340145321840203
STAT,1790,85,na,1875,83.27023532326199
SIM,1872,32,30-34,1904,17
STAT,1849,58,na,1907,1425.4341276886507
SIM,1926,28,30-34,1954,50
STAT,1886,24,30-34,1910,17.66757117739509
SIM,1871,26,30-34,1897,28
SIM,1894,39,30-34,1933,8
SIM,1879,45,50-100,1924,1
STAT,1945,16,50-100,1961,0.3867374186600792
SIM,1894,24,30-34,1918,28
STAT,1854,35,40-44,1889,3.2004468986840453
STAT,1822,46,35-39,1868,0.19811301520403254
STAT,1921,33,25-29,1954,9.676582724688908
SIM,1837,37,35-39,1874,14
SIM,1895,37,45-49,1932,7
STAT,1819,48,30-34,1867,0.16957657794951086
STAT,1928,24,25-29,1952,108.27817457039355
STAT,1853,21,15-19,1874,2.9116453233644357
STAT,1876,34,15-19,1910,0.1376947845826612
STAT,1918,20,20-24,1938,113.96696543427954
STAT,1896,20,25-29,1916,71.89943853075344
STAT,1887,37,45-49,1924,2.106111773821996
STAT,1844,38,35-39,1882,5.192709751197225
SIM,1835,74,na,1909,705
SIM,1839,88,na,1927,85
STAT,1880,52,30-34,1932,0.005885326514110064
SIM,1852,38,35-39,1890,15
SIM,1875,7,na,1882,2627
STAT,1842,32,45-49,1874,1.5001224176956993
STAT,1865,45,45-49,1910,0.20461274599610096
STAT,1918,28,30-34,1946,39.253122548509666
STAT,1886,39,30-34,1925,5.266041095294715
SIM,1861,21,15-19,1882,2
STAT,1820,40,45-49,1860,2.8699469276924794
STAT,1835,53,30-34,1888,0.0037107541172796965
STAT,1948,21,45-49,1969,1.2209548568332467
STAT,1838,37,50-100,1875,1.0104130583636728
STAT,1863,26,30-34,1889,21.062621223104227
SIM,1878,27,30-34,1905,28
STAT,1905,47,15-19,1952,3.065882543185017E-4
STAT,1851,24,50-100,1875,0.3520016716906788
STAT,1859,34,na,1893,1783.6953112106214
SIM,1818,39,25-29,1857,1
STAT,1909,30,20-24,1939,2.215986872510192
SIM,1903,43,40-44,1946,2
STAT,1930,31,25-29,1961,11.275399564832506
STAT,1802,53,20-24,1855,0.0020615082754079526
SIM,1886,56,na,1942,1959
STAT,1840,18,50-100,1858,0.04391431977968429
SIM,1880,41,na,1921,2398
STAT,1820,44,25-29,1864,1.0899670195736404
STAT,1927,21,25-29,1948,107.84653488171931
STAT,1944,15,na,1959,3743.8848187478607
STAT,1862,30,50-100,1892,0.7442802547811327
STAT,1902,46,35-39,1948,0.10557983361759395
SIM,1890,20,30-34,1910,23
SIM,1852,22,na,1874,1973
STAT,1877,48,40-44,1925,0.16572147335944787
STAT,1907,42,20-24,1949,0.015282568051787838
SIM,1896,18,35-39,1914,2
STAT,1912,40,20-24,1952,0.016269453544909114
SIM,1932,20,45-49,1952,2
STAT,1860,46,20-24,1906,0.00923927418160117
SIM,1880,26,45-49,1906,2
SIM,1825,44,na,1869,1390
STAT,1836,61,na,1897,1180.0228639162526
STAT,1897,16,35-39,1913,0.6949501911282806
STAT,1880,29,50-100,1909,0.6313086634950121
SIM,1905,31,40-44,1936,5
SIM,1795,60,na,1855,911
SIM,1923,22,45-49,1945,1
SIM,1917,30,20-24,1947,2
STAT,1899,27,50-100,1926,0.8281543836664047
SIM,1896,1,na,1897,3413
SIM,1846,91,na,1937,45
STAT,1876,91,na,1967,170.80759535986266
SIM,1930,32,45-49,1962,2
STAT,1837,46,45-49,1883,0.15664477408620966
STAT,1865,31,35-39,1896,8.72905475627318
SIM,1859,54,na,1913,1747
SIM,1871,18,30-34,1889,1
STAT,1834,32,50-100,1866,0.7264750541885543
SIM,1818,72,na,1890,491
STAT,1854,43,40-44,1897,1.6079902634263123
STAT,1913,34,45-49,1947,1.4660054814340877
STAT,1845,45,40-44,1890,0.12179231785799578
STAT,1863,18,30-34,1881,1.3662949612566158
STAT,1904,50,na,1954,2959.1632834159154
SIM,1903,63,na,1966,2608
SIM,1887,25,30-34,1912,32
SIM,1943,28,na,1971,3677
SIM,1928,26,40-44,1954,6
STAT,1879,25,30-34,1904,25.03411081728974
STAT,1924,20,45-49,1944,1.2618623018537254
STAT,1876,16,na,1892,2469.160455418516
SIM,1838,72,na,1910,831
STAT,1864,39,15-19,1903,0.046934721244790235
STAT,1811,51,20-24,1862,0.002390671761768104
STAT,1911,44,35-39,1955,0.17929320907693425
STAT,1922,32,45-49,1954,1.6797352105134817
SIM,1878,37,na,1915,2366
STAT,1828,42,na,1870,1502.2482551549442
STAT,1882,20,30-34,1902,16.471638788906688
STAT,1873,37,15-19,1910,0.053847076899684126
SIM,1867,16,15-19,1883,4
SIM,1921,34,45-49,1955,1
STAT,1840,76,na,1916,659.7877339032924
STAT,1870,11,na,1881,2462.6566303086515
STAT,1915,22,45-49,1937,1.0986497123888135
STAT,1875,50,35-39,1925,0.00847549016916933
SIM,1895,33,50-100,1928,1
SIM,1837,55,na,1892,1318
STAT,1833,21,50-100,1854,0.42978183950417065
SIM,1886,66,na,1952,1546
SIM,1932,34,20-24,1966,1
STAT,1899,64,na,1963,2428.939073090064
STAT,1929,42,40-44,1971,0.30602287161974007
STAT,1874,43,50-100,1917,1.0126690847288977
SIM,1907,18,20-24,1925,20
SIM,1949,18,25-29,1967,50
STAT,1901,40,45-49,1941,0.13881163911912278
STAT,1944,25,na,1969,3828.1684650077027
STAT,1822,32,40-44,1854,13.188311726993108
SIM,1850,11,na,1861,2137
STAT,1855,102,na,1957,0.2985121891153057
STAT,1821,36,40-44,1857,9.74370331384539
STAT,1845,50,50-100,1895,0.010790968930905894
STAT,1889,64,na,1953,2027.398751660733
STAT,1929,34,50-100,1963,0.9909065988565872
SIM,1878,47,na,1925,2272
SIM,1838,62,na,1900,1167
SIM,1888,47,na,1935,2435
STAT,1807,104,na,1911,0.02392629312684339
STAT,1894,3,na,1897,3212.606824859529
STAT,1886,46,40-44,1932,0.17136401146331628
SIM,1830,32,40-44,1862,4
STAT,1811,46,25-29,1857,0.19511384178105004
STAT,1954,18,40-44,1972,1.6329283204610703
STAT,1925,36,50-100,1961,0.4765413481406691
STAT,1827,54,35-39,1881,0.006368337619246606
STAT,1870,36,35-39,1906,6.578699592618005
STAT,1891,35,50-100,1926,1.4492420121247285
STAT,1765,95,na,1860,2.2266666468592624
SIM,1906,37,30-34,1943,2
STAT,1823,38,15-19,1861,0.0844245966912009
STAT,1923,43,15-19,1966,0.0016931004520742917
SIM,1837,26,30-34,1863,21
STAT,1882,53,45-49,1935,0.013126340988602837
SIM,1867,5,na,1872,2466
STAT,1810,56,na,1866,1135.8878486841845
SIM,1859,0,na,1859,3061
STAT,1865,7,na,1872,2406.0728919370417
SIM,1941,27,na,1968,3528
SIM,1860,7,na,1867,2411
STAT,1765,108,na,1873,0.004553675991965159
SIM,1912,36,na,1948,3344
STAT,1862,41,25-29,1903,0.5198158810785452
SIM,1935,21,25-29,1956,126
SIM,1838,25,35-39,1863,14
SIM,1899,19,15-19,1918,5
SIM,1848,17,na,1865,2107
STAT,1842,46,50-100,1888,0.17717957020639655
STAT,1847,40,30-34,1887,0.8727084715723514
STAT,1863,36,45-49,1899,1.66338605818654
SIM,1896,66,na,1962,2246
SIM,1891,35,50-100,1926,1
STAT,1904,41,40-44,1945,0.21257319743656825
STAT,1780,109,na,1889,0.002714944051246915
STAT,1894,45,35-39,1939,0.09692471982978157
STAT,1870,45,50-100,1915,0.22961095319071415
SIM,1829,26,na,1855,1697
SIM,1846,36,na,1882,1755
STAT,1864,17,35-39,1881,0.4792539572664546
STAT,1822,57,na,1879,1128.8279892751905
STAT,1868,17,na,1885,2319.2845263556933
STAT,1873,49,na,1922,2112.346374455372
SIM,1895,39,na,1934,2905
STAT,1885,47,35-39,1932,0.13115081485530028
SIM,1828,72,na,1900,632
STAT,1844,53,25-29,1897,0.0024466017294747762
SIM,1916,16,20-24,1932,26
STAT,1899,39,50-100,1938,0.33961647943287143
SIM,1929,40,40-44,1969,1
STAT,1792,97,na,1889,0.8936218176296249
STAT,1870,40,20-24,1910,0.14849174609461638
SIM,1835,20,na,1855,1783
SIM,1840,21,na,1861,1837
SIM,1906,19,15-19,1925,9
SIM,1896,56,na,1952,2579
STAT,1881,68,na,1949,1393.9361886902377
STAT,1946,16,40-44,1962,1.4660192469228754
STAT,1878,44,40-44,1922,2.182197400874004
SIM,1849,18,20-24,1867,19
STAT,1852,52,20-24,1904,5.57666112274054E-4
STAT,1866,91,na,1957,64.36007176972028
SIM,1863,19,35-39,1882,1
STAT,1810,48,30-34,1858,0.33841035254266905
STAT,1839,41,35-39,1880,1.4164341243068654
STAT,1929,6,na,1935,4832.508385324782
SIM,1911,47,50-100,1958,1
STAT,1898,16,50-100,1914,0.06280600874668393
STAT,1934,8,na,1942,5096.249726300322
SIM,1762,97,na,1859,1
SIM,1847,41,35-39,1888,2
STAT,1840,86,na,1926,154.51828139269378
SIM,1954,16,40-44,1970,2
STAT,1830,34,40-44,1864,3.5125963241988223
SIM,1886,44,40-44,1930,5
STAT,1808,104,na,1912,0.025925324957655444
STAT,1895,44,40-44,1939,0.18995718627231076
SIM,1848,72,na,1920,894
STAT,1828,53,40-44,1881,0.007638989321355867
STAT,1839,48,50-100,1887,0.16472548202160514
SIM,1945,18,40-44,1963,4
SIM,1868,37,na,1905,2113
STAT,1840,38,15-19,1878,0.04577617989627473
STAT,1913,33,na,1946,3538.9424056390512
STAT,1845,44,na,1889,1615.8772794639335
SIM,1906,30,45-49,1936,1
STAT,1858,18,20-24,1876,15.268153257096273
STAT,1826,61,na,1887,1061.125048629801
SIM,1879,26,35-39,1905,7
STAT,1838,42,na,1880,1676.941551916512
STAT,1890,29,15-19,1919,0.5202932871687702
STAT,1829,29,35-39,1858,10.56219721532478
SIM,1919,28,40-44,1947,5
STAT,1853,44,35-39,1897,1.324786869468903
STAT,1838,17,40-44,1855,0.16477679798154998
STAT,1820,37,35-39,1857,16.144722005115533
STAT,1943,22,20-24,1965,111.75584877196208
STAT,1880,40,50-100,1920,1.060707514400268
STAT,1861,45,25-29,1906,0.04563633880895828
STAT,1859,16,15-19,1875,5.224384404587635
SIM,1858,19,25-29,1877,8
SIM,1926,26,na,1952,4111
STAT,1923,21,40-44,1944,3.7073577531219737
SIM,1888,37,na,1925,2570
STAT,1855,22,50-100,1877,0.3374042810780262
STAT,1869,35,15-19,1904,0.05183747266411504
SIM,1931,21,40-44,1952,6
SIM,1866,18,20-24,1884,18
STAT,1889,47,20-24,1936,0.007857690203716596
SIM,1836,91,na,1927,29
SIM,1850,41,na,1891,1701
SIM,1862,22,na,1884,2078
SIM,1837,29,35-39,1866,6
SIM,1855,5,na,1860,2404
SIM,1877,28,25-29,1905,44
STAT,1895,25,15-19,1920,0.5631190348655227
STAT,1937,18,40-44,1955,1.2819174670351394
STAT,1869,46,40-44,1915,0.1569960579439996
SIM,1924,6,na,1930,4502
STAT,1792,87,na,1879,52.32041535270197
STAT,1904,41,25-29,1945,0.06068858761974008
STAT,1818,42,na,1860,1422.570839193223
SIM,1879,64,na,1943,1676
STAT,1922,8,na,1930,4360.868173671447
SIM,1910,11,na,1921,3636
STAT,1854,80,na,1934,445.4476173515783
STAT,1933,32,20-24,1965,3.1053165173210835
SIM,1856,91,na,1947,30
STAT,1903,42,35-39,1945,0.1687995429196718
STAT,1863,37,50-100,1900,1.0195342678592307
STAT,1914,31,40-44,1945,3.7358493367545034
STAT,1855,19,35-39,1874,0.45679105628421673
STAT,1900,6,na,1906,3423.7281162722124
SIM,1903,53,na,1956,2854
STAT,1914,45,15-19,1959,3.4669261810528896E-4
STAT,1838,24,30-34,1862,15.536127889588473
STAT,1890,47,45-49,1937,0.1530445728167309
STAT,1938,17,45-49,1955,0.46546016831521175
STAT,1911,47,50-100,1958,0.20223684026811586
STAT,1869,34,na,1903,2163.448095189518
STAT,1908,32,na,1940,3371.734440486252
SIM,1875,19,na,1894,2451
STAT,1811,47,35-39,1858,0.4661359601425787
STAT,1772,97,na,1869,0.7767863369028135
SIM,1821,34,40-44,1855,4
STAT,1908,16,20-24,1924,24.899223258669636
STAT,1930,34,45-49,1964,1.916069951396063
SIM,1903,28,50-100,1931,1
STAT,1892,20,na,1912,2814.562229684935
SIM,1846,24,30-34,1870,17
STAT,1750,112,na,1862,0.023785442585079634
STAT,1828,34,15-19,1862,0.14293494904269527
STAT,1835,75,na,1910,642.312038333726
STAT,1884,48,30-34,1932,0.08923118491802347
STAT,1848,46,20-24,1894,0.008669627724442764
STAT,1918,28,50-100,1946,0.9971417558300766
SIM,1894,20,15-19,1914,4
STAT,1905,14,na,1919,3514.1128607475
STAT,1916,51,na,1967,3514.2683636026754
SIM,1885,38,50-100,1923,1
STAT,1784,78,na,1862,242.2030261696055
SIM,1922,31,40-44,1953,8
STAT,1886,20,15-19,1906,3.312482492857791
STAT,1928,28,40-44,1956,5.422702403069412
SIM,1936,28,40-44,1964,4
SIM,1845,43,40-44,1888,6
SIM,1894,31,na,1925,3060
STAT,1877,53,na,1930,2076.8958979861404
STAT,1880,25,40-44,1905,2.997786713074211
STAT,1889,34,na,1923,2759.2600878596018
SIM,1848,92,na,1940,22
STAT,1910,48,35-39,1958,0.11328936137136529
SIM,1915,20,45-49,1935,1
STAT,1837,43,40-44,1880,1.6541715712427925
STAT,1838,19,35-39,1857,0.4885243029784655
STAT,1927,23,na,1950,4237.712072413534
STAT,1860,47,30-34,1907,0.07397265684214938
SIM,1882,36,20-24,1918,4
STAT,1862,77,na,1939,696.5598933497728
STAT,1869,23,50-100,1892,0.3717462975002741
SIM,1828,62,na,1890,959
STAT,1832,22,50-100,1854,0.6129760496072514
STAT,1858,50,35-39,1908,0.006476484551962188
STAT,1904,19,40-44,1923,0.24647238310395483
STAT,1794,78,na,1872,293.9502397430949
SIM,1862,24,15-19,1886,1
STAT,1824,38,na,1862,1497.183512524288
STAT,1870,35,25-29,1905,2.690496572655147
STAT,1907,45,50-100,1952,0.19413442476059597
SIM,1895,27,30-34,1922,41
STAT,1854,90,na,1944,56.77263714786698
SIM,1875,40,na,1915,2232
SIM,1917,29,50-100,1946,5
SIM,1828,36,30-34,1864,6
SIM,1856,47,50-100,1903,3
STAT,1824,30,35-39,1854,33.285329979519226
STAT,1883,49,na,1932,2039.5610097373803
STAT,1826,71,na,1897,728.5570524031865
SIM,1925,32,20-24,1957,3
STAT,1877,52,25-29,1929,0.003453810559265079
STAT,1887,0,na,1887,3326.4655622400983
STAT,1835,48,35-39,1883,0.09090158962088982
SIM,1873,44,50-100,1917,2
STAT,1801,65,na,1866,834.4634203554854
STAT,1823,46,15-19,1869,4.8408883524649743E-4
STAT,1845,48,45-49,1893,0.16414526186660472
SIM,1832,77,na,1909,504
STAT,1860,76,na,1936,727.378320652045
STAT,1909,33,25-29,1942,8.294849860693725
STAT,1903,33,na,1936,3220.9130422272315
STAT,1956,1,na,1957,4921.552444542639
SIM,1915,45,50-100,1960,3
STAT,1775,95,na,1870,2.2245348804388985
SIM,1921,31,40-44,1952,4
STAT,1921,41,40-44,1962,0.2665464076598211
STAT,1874,36,20-24,1910,0.7478611616391275
STAT,1880,18,30-34,1898,1.58015283876424
STAT,1852,45,30-34,1897,0.07427918497893565
STAT,1910,30,45-49,1940,1.4444423627197385
STAT,1856,33,50-100,1889,0.679135932060343
STAT,1905,32,45-49,1937,1.366933893220708
STAT,1912,43,25-29,1955,0.06465754544622446
SIM,1836,27,25-29,1863,46
STAT,1885,82,na,1967,739.3199271910286
SIM,1846,27,35-39,1873,14
SIM,1936,26,na,1962,2793
STAT,1843,54,20-24,1897,5.177359296485858E-4
STAT,1923,35,15-19,1958,0.021058314128145697
STAT,1895,18,25-29,1913,6.967638456345878
STAT,1933,35,25-29,1968,1.269138815807383
SIM,1940,22,45-49,1962,1
STAT,1856,16,na,1872,2020.1266821560862
STAT,1824,105,na,1929,0.015479487153048291
STAT,1913,49,15-19,1962,3.375926473779707E-4
SIM,1889,16,35-39,1905,1
STAT,1911,43,25-29,1954,0.06398596804075192
SIM,1821,42,40-44,1863,3
SIM,1853,93,na,1946,15
SIM,1949,13,na,1962,4295
STAT,1860,11,na,1871,2123.4747807447584
SIM,1832,30,35-39,1862,7
STAT,1916,18,20-24,1934,27.101397083827365
STAT,1817,51,50-100,1868,0.03301920400328063
STAT,1932,33,15-19,1965,0.16128385296034858
STAT,1880,33,40-44,1913,4.292498252562581
STAT,1845,85,na,1930,193.09517911712155
STAT,1870,33,30-34,1903,16.09372439549151
STAT,1939,24,na,1963,3461.861363073602
STAT,1880,52,50-100,1932,0.014932192026151944
STAT,1838,27,35-39,1865,8.371269895868183
STAT,1813,42,40-44,1855,8.002832674804369
STAT,1828,27,25-29,1855,74.88624234874204
SIM,1880,23,40-44,1903,2
SIM,1931,27,na,1958,4548
SIM,1933,28,na,1961,4713
STAT,1869,54,40-44,1923,0.009362137474223016
STAT,1859,54,30-34,1913,0.00436436236727302
STAT,1931,22,45-49,1953,1.3786449259259712
STAT,1822,35,45-49,1857,3.971740414100363
STAT,1811,43,20-24,1854,0.5879902761592406
STAT,1852,48,35-39,1900,0.10503160953608358
STAT,1903,45,40-44,1948,0.13108869057706127
STAT,1913,31,40-44,1944,3.6923246192112806
SIM,1949,15,20-24,1964,144
SIM,1882,0,na,1882,3102
STAT,1788,82,na,1870,160.94768727431546
STAT,1850,20,35-39,1870,5.0024442245060285
STAT,1900,46,na,1946,2957.5392129278166
STAT,1873,30,30-34,1903,16.876845138638714
STAT,1876,16,15-19,1892,5.801917376599389
STAT,1846,61,na,1907,1317.5234730526417
STAT,1893,46,30-34,1939,0.06563416370281693
SIM,1921,27,na,1948,3842
SIM,1891,67,na,1958,1890
STAT,1886,36,na,1922,2362.875889191126
SIM,1876,66,na,1942,1585
SIM,1813,63,na,1876,896
STAT,1863,33,40-44,1896,3.586070936497929
STAT,1778,82,na,1860,137.17817420671196
STAT,1891,21,35-39,1912,6.844066730050985
SIM,1923,37,30-34,1960,2
STAT,1843,47,30-34,1890,0.06951129840311715
STAT,1909,58,na,1967,3024.4908978256694
SIM,1928,29,45-49,1957,2
STAT,1813,53,50-100,1866,0.04273593268151941
STAT,1830,41,15-19,1871,0.010649890067633736
SIM,1883,38,na,1921,2208
STAT,1854,24,15-19,1878,2.7513175487273545
SIM,1823,73,na,1896,655
SIM,1830,35,45-49,1865,2
STAT,1875,10,na,1885,2559.5073466510935
STAT,1917,32,20-24,1949,2.4128204374518556
SIM,1959,0,na,1959,4858
STAT,1906,43,15-19,1949,0.0013096560618091721
STAT,1894,65,na,1959,2148.8016281181567
STAT,1940,21,40-44,1961,3.236518192469275
SIM,1888,42,35-39,1930,2
STAT,1836,51,25-29,1887,0.0023084319197634673
STAT,1846,18,30-34,1864,1.4033965491599294
SIM,1854,18,30-34,1872,1
STAT,1833,43,na,1876,1526.6977473911004
STAT,1876,49,35-39,1925,0.13368499352438987
STAT,1906,32,45-49,1938,1.3774011506358441
SIM,1887,17,30-34,1904,1
STAT,1886,49,45-49,1935,0.23063904314545547
STAT,1915,44,20-24,1959,0.016739188594948523
SIM,1937,16,40-44,1953,1
STAT,1888,44,50-100,1932,1.1630965995506093
SIM,1869,44,40-44,1913,2
STAT,1863,40,15-19,1903,0.011583585036836454
STAT,1887,27,30-34,1914,26.604589525387
SIM,1910,55,na,1965,3063
SIM,1914,32,45-49,1946,1
SIM,1881,30,30-34,1911,14
STAT,1833,35,20-24,1868,0.5991048820731566
STAT,1911,36,35-39,1947,2.21711424381043
STAT,1854,28,30-34,1882,18.873163249879855
SIM,1908,17,25-29,1925,5
SIM,1807,79,na,1886,257
SIM,1931,39,30-34,1970,6
STAT,1853,94,na,1947,14.821831785404303
SIM,1837,45,na,1882,1547
STAT,1878,47,45-49,1925,0.2310127579918094
STAT,1854,17,25-29,1871,4.881345354187534
STAT,1871,42,15-19,1913,0.012917582226878731
STAT,1902,21,20-24,1923,92.1479291661923
STAT,1946,19,45-49,1965,0.5230809327325153
SIM,1838,17,na,1855,1925
SIM,1843,93,na,1936,23
STAT,1841,52,45-49,1893,0.009876412857843407
STAT,1904,15,25-29,1919,7.7130850571601535
SIM,1828,29,40-44,1857,2
SIM,1895,19,30-34,1914,5
SIM,1873,31,35-39,1904,12
STAT,1785,95,na,1880,2.546155374554713
STAT,1841,26,15-19,1867,0.3883442438414102
STAT,1864,47,15-19,1911,3.36149534521647E-4
STAT,1915,37,30-34,1952,1.7391775363614401
STAT,1846,26,30-34,1872,21.63457442748487
SIM,1908,62,na,1970,2755
SIM,1916,19,25-29,1935,55
SIM,1862,28,30-34,1890,34
STAT,1872,77,na,1949,819.6186261415596
STAT,1901,21,20-24,1922,91.39719720831374
SIM,1845,19,na,1864,2017
STAT,1900,48,40-44,1948,0.12497472248290387
SIM,1862,17,25-29,1879,6
STAT,1888,41,30-34,1929,1.2888468817194594
STAT,1860,54,20-24,1914,5.509651400358332E-4
SIM,1862,43,40-44,1905,5
STAT,1828,52,na,1880,1309.7639954920912
STAT,1901,47,30-34,1948,0.07186457468006477
STAT,1885,44,30-34,1929,1.0674384489402329
SIM,1828,28,30-34,1856,28
SIM,1870,41,na,1911,2154
SIM,1909,31,25-29,1940,10
SIM,1939,13,na,1952,3665
SIM,1912,15,25-29,1927,13
STAT,1818,53,30-34,1871,0.011956071687570709
STAT,1836,71,na,1907,842.9119445260372
STAT,1919,48,na,1967,3753.884322750472
STAT,1923,39,30-34,1962,1.9909216321307783
STAT,1921,33,40-44,1954,4.097063072683099
SIM,1845,10,na,1855,2157
STAT,1888,17,na,1905,2818.602089611506
STAT,1882,45,45-49,1927,0.21910584541946745
SIM,1855,74,na,1929,816
SIM,1815,44,na,1859,1315
SIM,1870,34,35-39,1904,13
SIM,1870,19,25-29,1889,4
SIM,1846,16,30-34,1862,1
SIM,1939,29,20-24,1968,16
STAT,1850,76,na,1926,666.9743682080864
SIM,1776,79,na,1855,236
SIM,1910,21,20-24,1931,96
SIM,1822,46,na,1868,1424
STAT,1862,19,25-29,1881,4.703377562268116
STAT,1854,35,na,1889,1722.4842900278097
STAT,1803,52,25-29,1855,0.010152434061008301
STAT,1877,45,35-39,1922,0.13861264465922102
STAT,1910,36,50-100,1946,0.3810525443634978
SIM,1924,18,20-24,1942,139
SIM,1808,96,na,1904,3
SIM,1822,77,na,1899,460
STAT,1898,30,35-39,1928,13.054864861892101
SIM,1870,33,25-29,1903,13
STAT,1823,105,na,1928,0.015429654123400563
STAT,1830,37,45-49,1867,1.5820994267868853
SIM,1893,14,na,1907,3210
STAT,1887,19,30-34,1906,1.6748870221947088
STAT,1922,33,40-44,1955,4.159710029267095
SIM,1858,18,15-19,1876,7
STAT,1861,38,35-39,1899,5.521021042834986
STAT,1939,31,45-49,1970,1.5174595461909153
STAT,1866,16,na,1882,2271.268390938763
STAT,1870,43,25-29,1913,0.5901311801898945
SIM,1854,26,30-34,1880,31
STAT,1770,96,na,1866,1.0795802345430456
STAT,1879,18,40-44,1897,0.1801311641502584
STAT,1906,31,na,1937,3324.083032956671
STAT,1844,80,na,1924,434.2602749242795
STAT,1908,19,25-29,1927,7.896684976513006
STAT,1895,29,30-34,1924,30.82236164128752
SIM,1887,28,35-39,1915,14
STAT,1917,17,50-100,1934,0.07616060737195612
SIM,1836,38,30-34,1874,4
STAT,1838,16,30-34,1854,1.4444196713181474
STAT,1923,46,20-24,1969,0.012244335896678275
SIM,1864,15,35-39,1879,1
SIM,1913,53,na,1966,3186
STAT,1859,16,50-100,1875,0.04312919659385936
STAT,1953,16,50-100,1969,0.4282788106610484
SIM,1872,22,na,1894,2193
SIM,1819,35,50-100,1854,3
STAT,1867,53,na,1920,1879.1959166435608
STAT,1872,16,30-34,1888,1.5252657641226475
SIM,1842,56,na,1898,1394
STAT,1941,27,30-34,1968,38.288360089554324
STAT,1811,44,30-34,1855,4.054775544434416
SIM,1852,43,30-34,1895,1
STAT,1815,54,45-49,1869,0.032427849260140855
STAT,1913,42,45-49,1955,0.15328842792632033
STAT,1882,3,na,1885,2749.3734117483696
SIM,1844,29,25-29,1873,46
STAT,1853,63,na,1916,1323.2540057179608
STAT,1932,22,45-49,1954,1.3947039805580037
SIM,1884,1,na,1885,3089
STAT,1828,38,30-34,1866,4.950093173806973
STAT,1821,40,25-29,1861,1.138208721536765
STAT,1951,4,na,1955,4424.246368720448
STAT,1935,20,20-24,1955,143.1363450125812
SIM,1880,16,30-34,1896,2
STAT,1873,32,50-100,1905,0.8785954906453753
SIM,1839,98,na,1937,2
STAT,1879,34,na,1913,2336.1462161493196
STAT,1906,51,na,1957,3009.877125805009
STAT,1879,28,35-39,1907,9.494124125876558
SIM,1913,32,45-49,1945,1
STAT,1924,37,50-100,1961,0.4677474190555342
STAT,1917,40,50-100,1957,0.11613626796849785
STAT,1833,33,50-100,1866,0.711035374712584
STAT,1836,29,25-29,1865,34.070858991616184
STAT,1856,15,35-39,1871,0.48575801891778053
SIM,1858,92,na,1950,20
STAT,1907,45,25-29,1952,0.04552989734252737
SIM,1943,20,20-24,1963,104
STAT,1894,48,40-44,1942,0.11588053467007095
STAT,1890,37,15-19,1927,0.06486003580102094
STAT,1949,17,20-24,1966,148.9702599842822
STAT,1931,37,15-19,1968,0.024026290238764066
STAT,1913,19,50-100,1932,0.07196034530874593
STAT,1821,33,35-39,1854,31.823672575199776
STAT,1882,27,15-19,1909,0.417066091705737
STAT,1782,97,na,1879,0.8496797454396587
STAT,1918,32,na,1950,3796.5900972134623
STAT,1871,38,45-49,1909,1.8577266661980054
STAT,1878,17,na,1895,2483.813725391101
SIM,1869,64,na,1933,1559
SIM,1841,33,50-100,1874,4
SIM,1885,40,na,1925,2209
STAT,1846,19,40-44,1865,0.16009695399530155
STAT,1864,90,na,1954,66.56593937647405
STAT,1844,50,20-24,1894,5.254704374824016E-4
STAT,1855,75,na,1930,729.1029186391677
STAT,1902,36,50-100,1938,0.35498127353593395
SIM,1828,39,35-39,1867,10
STAT,1911,40,20-24,1951,0.01610046789405058
STAT,1913,42,50-100,1955,0.10820359587321365
STAT,1804,83,na,1887,141.84919581750697
SIM,1911,20,25-29,1931,91
STAT,1810,44,15-19,1854,0.05107383028166308
STAT,1830,30,25-29,1860,8.850707780855364
SIM,1927,26,25-29,1953,86
STAT,1847,56,na,1903,1500.7396625335755
STAT,1912,46,45-49,1958,0.19776504827947303
STAT,1829,68,na,1897,936.7066147652253
STAT,1870,32,20-24,1902,2.5021390136586055
SIM,1886,18,25-29,1904,10
STAT,1818,50,50-100,1868,0.032208370671498614
SIM,1801,85,na,1886,74
SIM,1844,58,na,1902,1390
SIM,1850,75,na,1925,730
STAT,1922,40,30-34,1962,0.1390201136791797
STAT,1844,31,15-19,1875,0.12079704011955329
SIM,1824,68,na,1892,843
STAT,1813,45,45-49,1858,0.7385374516700358
STAT,1853,47,40-44,1900,0.12637135159598256
STAT,1915,33,15-19,1948,0.1231052974098975
STAT,1859,88,na,1947,103.50146837951759
STAT,1852,102,na,1954,0.22274624960805783
SIM,1904,43,40-44,1947,4
STAT,1857,51,45-49,1908,0.01085984442427086
STAT,1837,24,15-19,1861,2.68726404765146
STAT,1827,46,35-39,1873,0.12430052447899526
STAT,1847,22,50-100,1869,0.3678290722797356
STAT,1903,20,25-29,1923,77.3990621001292
STAT,1869,28,25-29,1897,38.5458151100983
SIM,1920,32,35-39,1952,12
STAT,1827,56,na,1883,1198.6898258865638
STAT,1836,19,na,1855,1913.641362121009
STAT,1878,48,na,1926,2184.8100486426815
STAT,1884,46,50-100,1930,0.2299283157622663
STAT,1923,32,45-49,1955,1.7043289771035657
SIM,1900,34,25-29,1934,21
STAT,1880,52,na,1932,2128.8516660946216
STAT,1891,36,20-24,1927,0.9056970770594807
STAT,1834,90,na,1924,48.7988723420937
STAT,1844,43,30-34,1887,0.8160597844019954
STAT,1903,34,35-39,1937,7.748587467822383
STAT,1835,45,30-34,1880,0.0717743611028259
STAT,1950,5,na,1955,4392.211334122106
SIM,1801,95,na,1896,4
STAT,1897,42,35-39,1939,0.15867462156957282
STAT,1824,45,20-24,1869,0.01450653070228445
STAT,1908,42,20-24,1950,0.015431970120570473
SIM,1824,58,na,1882,1112
STAT,1823,53,40-44,1876,0.011843067407636292
STAT,1912,32,35-39,1944,8.49280034265262
STAT,1921,44,45-49,1965,0.17651201446833617
SIM,1930,33,40-44,1963,6
STAT,1834,28,na,1862,1743.1241078447983
SIM,1845,24,15-19,1869,2
STAT,1885,50,45-49,1935,0.013855067033858996
STAT,1900,40,45-49,1940,0.13758366131615307
STAT,1931,31,40-44,1962,4.847066728249535
SIM,1911,34,35-39,1945,19
STAT,1890,44,40-44,1934,2.562906580829309
SIM,1863,38,na,1901,2018
STAT,1886,42,25-29,1928,0.6401633271863381
STAT,1855,85,na,1940,194.15208939723811
STAT,1823,43,na,1866,1433.2545925744516
STAT,1853,43,25-29,1896,0.47278851623583457
STAT,1935,31,25-29,1966,12.086295607698293
STAT,1835,52,20-24,1887,4.6921210743662843E-4
SIM,1950,21,na,1971,3993
STAT,1890,30,30-34,1920,20.328546003335866
SIM,1855,20,na,1875,2062
STAT,1891,37,na,1928,2754.859947989722
SIM,1871,57,na,1928,1910
STAT,1883,35,50-100,1918,1.14752227692202
STAT,1880,40,15-19,1920,0.013865458717776604
STAT,1836,44,35-39,1880,1.3259304219408043
SIM,1931,32,45-49,1963,2
STAT,1887,33,50-100,1920,0.963925237967207
SIM,1873,38,na,1911,2248
STAT,1783,83,na,1866,106.38359886226371
SIM,1868,16,15-19,1884,10
SIM,1816,39,na,1855,1406
STAT,1800,80,na,1880,260.73528380646206
STAT,1813,43,na,1856,1345.1598990269943
STAT,1846,16,na,1862,2045.1499454225655
STAT,1862,45,40-44,1907,0.13933483311557576
STAT,1876,46,30-34,1922,0.09467275518075327
SIM,1894,17,20-24,1911,21
STAT,1884,55,na,1939,1930.2927426666297
STAT,1903,41,25-29,1944,0.06020525270392059
SIM,1881,67,na,1948,1332
STAT,1934,32,20-24,1966,3.1460275078221445
STAT,1880,36,45-49,1916,1.9910598185421053
STAT,1831,48,15-19,1879,2.9033749425182257E-4
STAT,1812,46,40-44,1858,0.5725896549515308
SIM,1844,44,35-39,1888,7
SIM,1823,44,50-100,1867,4
SIM,1859,23,na,1882,2035
SIM,1859,33,na,1892,1967
STAT,1821,62,na,1883,1028.8146870357623
SIM,1861,36,35-39,1897,9
SIM,1873,48,na,1921,2140
SIM,1871,67,na,1938,1441
STAT,1874,43,45-49,1917,1.4346145408103437
SIM,1882,43,45-49,1925,3
STAT,1893,1,na,1894,3262.4727565363933
STAT,1853,36,35-39,1889,5.300083827316328
STAT,1841,21,50-100,1862,0.3560021114406471
STAT,1868,51,20-24,1919,6.687709163903052E-4
STAT,1885,32,15-19,1917,0.1340311633322014
STAT,1929,16,40-44,1945,1.6905663024237911
STAT,1841,30,35-39,1871,8.583179824564125
STAT,1891,40,40-44,1931,2.656631958111134
STAT,1906,47,30-34,1953,0.07476256172480199
STAT,1808,76,na,1884,404.54132914941493
SIM,1902,67,na,1969,2432
STAT,1883,18,na,1901,2332.2491084935805
STAT,1919,26,25-29,1945,67.41546441832644
SIM,1771,91,na,1862,11
SIM,1869,23,na,1892,2138
STAT,1818,41,15-19,1859,0.034457642727342426
STAT,1864,40,30-34,1904,0.9804717478759998
SIM,1887,52,na,1939,2218
SIM,1917,12,na,1929,3978
STAT,1868,47,35-39,1915,0.1256880760023586
SIM,1850,40,45-49,1890,5
STAT,1852,23,na,1875,1915.9624417463194
STAT,1871,92,na,1963,94.54023205621203
STAT,1837,17,25-29,1854,6.226853489382244
STAT,1827,53,25-29,1880,0.0029369279061321665
STAT,1901,52,na,1953,2832.0265555847554
STAT,1871,54,30-34,1925,0.005421517344078804
STAT,1919,19,35-39,1938,4.357129221964593
SIM,1909,1,na,1910,3761
STAT,1864,54,40-44,1918,0.008644176936279103
SIM,1833,73,na,1906,719
STAT,1900,33,20-24,1933,3.5276507059217215
SIM,1966,3,na,1969,4547
STAT,1795,61,na,1856,894.448816522
STAT,1850,35,20-24,1885,0.5628412730247416
STAT,1856,41,35-39,1897,1.3458725558025086
SIM,1805,54,na,1859,1123
STAT,1873,18,na,1891,2415.479568952703
SIM,1889,7,na,1896,3078
STAT,1821,72,na,1893,681.961584355928
STAT,1834,38,na,1872,1631.9157847185916
STAT,1868,18,15-19,1886,5.417646947531723
SIM,1845,17,25-29,1862,8
SIM,1836,60,na,1896,1203
STAT,1838,53,35-39,1891,0.00577743626884219
SIM,1927,19,35-39,1946,5
STAT,1926,40,15-19,1966,0.0017936486477744624
SIM,1861,27,50-100,1888,1
SIM,1796,76,na,1872,346
SIM,1923,7,na,1930,4331
STAT,1873,52,40-44,1925,0.010041309633330964
SIM,1932,1,na,1933,4978
STAT,1842,40,45-49,1882,1.1312802847755645
STAT,1911,33,30-34,1944,14.428906324225318
STAT,1877,30,15-19,1907,0.140726822585265
STAT,1845,41,25-29,1886,0.4665484993999608
STAT,1945,16,25-29,1961,44.73263711999202
STAT,1856,52,40-44,1908,0.0077478779063535575
STAT,1886,17,20-24,1903,17.695275373621342
SIM,1953,16,25-29,1969,53
SIM,1829,45,50-100,1874,5
SIM,1859,18,15-19,1877,8
STAT,1822,54,35-39,1876,0.011106487128166318
STAT,1872,19,35-39,1891,0.5174970806172691
SIM,1889,40,50-100,1929,2
STAT,1874,89,na,1963,212.63598902700284
SIM,1911,7,na,1918,3793
SIM,1878,34,50-100,1912,5
STAT,1921,41,25-29,1962,0.07609766993704381
STAT,1870,52,na,1922,1982.5112334618186
STAT,1837,56,na,1893,1287.5346907879145
STAT,1892,46,15-19,1938,2.6768336553202273E-4
STAT,1928,7,na,1935,4758.649584209425
STAT,1815,51,40-44,1866,0.02498147123706379
STAT,1915,30,45-49,1945,1.5260160989941722
SIM,1913,41,40-44,1954,2
STAT,1845,16,20-24,1861,15.876809871000434
STAT,1883,41,45-49,1924,1.3919598374102917
STAT,1920,45,40-44,1965,0.16542641595056368
SIM,1944,23,40-44,1967,3
STAT,1941,23,15-19,1964,5.194713431054159
STAT,1847,51,35-39,1898,0.0063647564039686225
STAT,1859,42,15-19,1901,0.010398751155655235
STAT,1910,41,15-19,1951,0.0013785716644034482
SIM,1925,41,na,1966,4165
SIM,1815,98,na,1913,1
STAT,1894,37,35-39,1931,8.595157486122499
SIM,1871,36,45-49,1907,1
STAT,1832,51,40-44,1883,0.00677198731972711
STAT,1878,25,15-19,1903,0.4492220410635302
SIM,1870,30,20-24,1900,3
STAT,1920,31,30-34,1951,16.370312903371037
STAT,1821,44,40-44,1865,3.5346795755588363
SIM,1821,92,na,1913,20
SIM,1837,86,na,1923,115
SIM,1854,29,35-39,1883,7
STAT,1825,47,50-100,1872,0.25752419837617296
STAT,1811,54,25-29,1865,0.01080425422742824
STAT,1861,37,na,1898,1848.2091004104755
STAT,1900,26,30-34,1926,33.11639212609507
SIM,1786,79,na,1865,243
SIM,1926,28,50-100,1954,2
STAT,1920,12,na,1932,4199.786722585337
STAT,1870,42,na,1912,2136.8101288301978
STAT,1848,53,45-49,1901,0.010287217003647901
SIM,1868,92,na,1960,51
STAT,1816,95,na,1911,6.195675612487123
SIM,1891,41,45-49,1932,3
SIM,1918,52,na,1970,3613
STAT,1905,41,40-44,1946,0.21419434779777402
STAT,1936,23,40-44,1959,3.035247876902812
SIM,1811,95,na,1906,3
SIM,1847,48,50-100,1895,1
SIM,1945,9,na,1954,3930
SIM,1810,47,50-100,1857,3
STAT,1861,35,30-34,1896,4.220636171226102
STAT,1846,29,35-39,1875,8.112421429959454
STAT,1882,42,40-44,1924,2.0651013624005303
SIM,1869,15,20-24,1884,13
STAT,1842,57,na,1899,1431.083526579182
STAT,1926,33,25-29,1959,10.552524466671123
STAT,1816,50,45-49,1866,0.038073738504140565
SIM,1896,15,30-34,1911,4
SIM,1903,32,35-39,1935,8
SIM,1794,98,na,1892,1
SIM,1879,33,na,1912,2322
SIM,1934,33,25-29,1967,12
SIM,1837,76,na,1913,550
SIM,1853,16,20-24,1869,17
STAT,1839,68,na,1907,1018.9594944182902
STAT,1851,45,15-19,1896,2.962506654366209E-4
STAT,1846,52,30-34,1898,0.004174636022055071
STAT,1854,46,45-49,1900,0.17042473505214115
STAT,1894,44,25-29,1938,0.05345849217352282
STAT,1888,15,30-34,1903,1.7870389320390123
SIM,1784,105,na,1889,1
SIM,1928,18,40-44,1946,1
STAT,1832,47,20-24,1879,0.008601815373220167
STAT,1862,34,35-39,1896,8.090903638993556
STAT,1924,42,20-24,1966,0.019846520877409717
SIM,1890,42,40-44,1932,4
STAT,1862,26,50-100,1888,0.5211303753900822
STAT,1894,30,15-19,1924,0.174447745128641
STAT,1870,47,40-44,1917,0.15773580004284568
STAT,1916,44,20-24,1960,0.01703954583075214
SIM,1855,19,na,1874,2192
STAT,1922,47,15-19,1969,3.9981156610388623E-4
STAT,1858,17,50-100,1875,0.04244273880165178
STAT,1944,21,25-29,1965,94.24519066050838
SIM,1878,22,50-100,1900,1
STAT,1845,34,35-39,1879,8.307220668615338
STAT,1926,30,20-24,1956,2.7897269198037025
STAT,1913,43,40-44,1956,0.23001065823738168
SIM,1826,91,na,1917,60
STAT,1936,30,30-34,1966,14.470593421873458
STAT,1889,40,35-39,1929,2.1332112657428244
STAT,1927,5,na,1932,4723.375891716918
SIM,1781,91,na,1872,14
STAT,1846,71,na,1917,941.13114803877
STAT,1881,39,15-19,1920,0.05070552829660265
SIM,1918,33,40-44,1951,6
SIM,1798,57,na,1855,1023
STAT,1878,40,25-29,1918,0.6379033313891973
SIM,1886,40,25-29,1926,2
STAT,1912,43,40-44,1955,0.2264752190316835
STAT,1902,43,30-34,1945,0.10566346697296973
SIM,1920,43,40-44,1963,4
SIM,1862,12,na,1874,2387
STAT,1831,41,30-34,1872,0.8873333051566513
STAT,1931,34,45-49,1965,1.9453949393806529
SIM,1911,31,30-34,1942,19
STAT,1868,54,25-29,1922,0.003106958991194935
STAT,1941,20,45-49,1961,1.0991381258985053
STAT,1840,53,40-44,1893,0.007213913801924894
STAT,1873,48,20-24,1921,0.011362315762469872
STAT,1832,57,na,1889,1219.6892786238386
STAT,1882,23,na,1905,2167.3532181306
STAT,1877,63,na,1940,1749.1837475566297
STAT,1893,69,na,1962,1934.3139658152973
STAT,1809,104,na,1913,0.02801951853341066
SIM,1845,20,na,1865,1876
STAT,1871,35,40-44,1906,4.138657148435748
STAT,1905,45,na,1950,3102.579438847899
SIM,1861,33,30-34,1894,14
SIM,1847,86,na,1933,129
SIM,1853,34,35-39,1887,12
SIM,1900,31,20-24,1931,5
STAT,1844,46,35-39,1890,0.09856032423011535
STAT,1847,47,15-19,1894,2.9294311986247427E-4
STAT,1899,10,na,1909,3353.4709392131017
SIM,1962,8,na,1970,4680
STAT,1851,49,30-34,1900,0.06950291784902433
STAT,1860,1,na,1861,2810.9435737151107
STAT,1853,40,20-24,1893,0.11896540068726934
STAT,1865,53,45-49,1918,0.012258078598575663
STAT,1852,57,na,1909,1526.8620614977474
STAT,1862,23,na,1885,1936.9848169123072
STAT,1911,52,na,1963,3229.619682678864
SIM,1907,12,na,1919,3645
SIM,1900,35,na,1935,3109
SIM,1874,41,45-49,1915,3
SIM,1812,44,40-44,1856,3
SIM,1826,39,50-100,1865,3
SIM,1832,46,na,1878,1482
STAT,1918,31,25-29,1949,9.316072402497486
SIM,1819,57,na,1876,1123
STAT,1952,20,20-24,1972,126.3904732829465
STAT,1862,48,45-49,1910,0.1877881386210464
STAT,1867,22,na,1889,2106.4413018126716
STAT,1911,22,25-29,1933,82.73929016783863
SIM,1842,87,na,1929,94
STAT,1903,31,30-34,1934,23.562336021076074
SIM,1826,39,na,1865,1569
SIM,1868,27,20-24,1895,7
STAT,1818,39,50-100,1857,3.407176605022586
STAT,1809,51,50-100,1860,0.05342924360096075
STAT,1764,108,na,1872,0.0035166779871224846
SIM,1936,16,25-29,1952,32
STAT,1854,102,na,1956,0.25409815412655146
STAT,1934,25,na,1959,4764.812392240035
STAT,1832,105,na,1937,0.01772899363072287
SIM,1876,18,15-19,1894,6
STAT,1877,22,na,1899,2318.497302318156
STAT,1840,41,50-100,1881,0.777370354857707
STAT,1864,89,na,1953,88.69781923099086
STAT,1861,42,20-24,1903,0.12443173210649507
STAT,1853,33,30-34,1886,13.196288771132902
STAT,1904,44,45-49,1948,0.13890582410991822
SIM,1815,54,na,1869,1113
STAT,1811,62,na,1873,957.6388194750624
STAT,1906,34,50-100,1940,0.717523048911799
STAT,1886,35,35-39,1921,7.1267001300043376
STAT,1812,42,25-29,1854,2.4121698411965165
SIM,1901,31,20-24,1932,2
SIM,1820,35,35-39,1855,11
SIM,1948,19,20-24,1967,141
STAT,1814,48,15-19,1862,0.0010676366146476807
STAT,1786,105,na,1891,0.014428887186834435
STAT,1899,15,40-44,1914,0.23788891832251835
STAT,1896,36,na,1932,2955.671044552525
STAT,1894,55,na,1949,2512.7274229800205
STAT,1904,59,na,1963,2791.9056496393296
STAT,1879,88,na,1967,331.08118012855107
STAT,1880,51,20-24,1931,7.370001803167466E-4
SIM,1957,9,na,1966,4695
SIM,1866,3,na,1869,2676
STAT,1819,44,35-39,1863,3.3247966213047757
SIM,1813,73,na,1886,483
SIM,1864,78,na,1942,630
SIM,1775,84,na,1859,93
SIM,1894,35,35-39,1929,20
STAT,1814,83,na,1897,163.7952266835797
SIM,1921,43,40-44,1964,2
STAT,1881,37,na,1918,2148.990385989299
SIM,1800,55,na,1855,1086
SIM,1884,85,na,1969,441
STAT,1878,6,na,1884,2654.168804723129
SIM,1873,6,na,1879,2627
STAT,1922,37,na,1959,4044.4288483317046
STAT,1838,50,30-34,1888,0.0042014213815133135
STAT,1867,18,15-19,1885,5.349639430632857
STAT,1824,52,45-49,1876,0.016420541327962685
STAT,1899,54,na,1953,2710.939233745131
STAT,1874,40,40-44,1914,2.1936604550951224
STAT,1888,48,15-19,1936,2.4864486826982823E-4
SIM,1845,28,30-34,1873,23
STAT,1829,26,30-34,1855,46.15206510856927
STAT,1892,46,50-100,1938,0.16435772450384262
SIM,1932,33,na,1965,4613
STAT,1847,17,35-39,1864,0.5038997816241587
SIM,1823,40,35-39,1863,1
STAT,1881,54,40-44,1935,0.009338663288470956
STAT,1875,41,na,1916,2253.295771979176
STAT,1869,88,na,1957,155.5987045529295
STAT,1872,52,50-100,1924,0.014244226728446677
STAT,1929,19,45-49,1948,0.5990643066661884
SIM,1859,18,30-34,1877,2
STAT,1868,44,30-34,1912,1.0229771354929382
STAT,1845,75,na,1920,725.1338839902738
STAT,1853,102,na,1955,0.21742086824969914
SIM,1890,31,35-39,1921,17
STAT,1854,54,30-34,1908,0.004168523446210864
SIM,1853,19,25-29,1872,6
STAT,1927,43,35-39,1970,0.23822554054189216
SIM,1827,44,35-39,1871,1
SIM,1944,14,na,1958,3955
STAT,1882,31,35-39,1913,9.347349857288485
STAT,1891,43,45-49,1934,1.737389589093187
STAT,1827,50,20-24,1877,6.49375869857957E-4
STAT,1878,18,25-29,1896,5.558357247681948
STAT,1894,41,20-24,1935,0.19386606107096216
STAT,1932,37,30-34,1969,2.3134244574705085
STAT,1844,90,na,1934,55.34680185874774
STAT,1820,34,30-34,1854,53.80633842410916
STAT,1857,56,na,1913,1519.019016507426
SIM,1876,44,30-34,1920,3
SIM,1882,40,40-44,1922,3
SIM,1926,31,25-29,1957,18
STAT,1895,51,na,1946,2667.198179807244
STAT,1835,41,15-19,1876,0.010457356809232187
STAT,1901,33,20-24,1934,3.5591361070373964
STAT,1839,15,35-39,1854,0.48429134294903525
SIM,1814,58,na,1872,1074
SIM,1840,65,na,1905,1135
SIM,1842,19,15-19,1861,2
SIM,1863,93,na,1956,19
STAT,1876,53,20-24,1929,7.0810495361556E-4
STAT,1837,28,30-34,1865,20.25689754387851
STAT,1864,33,50-100,1897,0.7703314076184775
STAT,1893,49,35-39,1942,0.09268033588794958
STAT,1832,54,45-49,1886,0.008796701116396664
SIM,1810,99,na,1909,1
STAT,1896,17,30-34,1913,1.9899973392931072
STAT,1806,95,na,1901,4.424070648118267
SIM,1827,29,25-29,1856,42
STAT,1931,41,35-39,1972,0.25450454002308415
SIM,1883,2,na,1885,2843
STAT,1819,51,25-29,1870,0.006171262710894174
STAT,1844,16,50-100,1860,0.043978112696016064
SIM,1864,34,na,1898,2107
STAT,1871,31,25-29,1902,9.631845628041072
SIM,1832,87,na,1919,98
STAT,1830,76,na,1906,565.9329709316628
STAT,1805,51,30-34,1856,0.01771965492113027
STAT,1883,70,na,1953,1299.0602614776956
STAT,1920,41,25-29,1961,0.07461643360950597
STAT,1832,36,15-19,1868,0.043515738571251475
STAT,1853,15,50-100,1868,0.04422538751271466
STAT,1855,49,15-19,1904,2.773795057354766E-4
STAT,1910,45,30-34,1955,0.07891957013542038
SIM,1905,34,na,1939,3258
STAT,1876,27,50-100,1903,0.623863455194115
SIM,1908,52,na,1960,3009
STAT,1860,42,na,1902,1772.292013107005
SIM,1819,38,30-34,1857,8
STAT,1865,46,20-24,1911,0.010330585816253813
STAT,1930,31,40-44,1961,4.774001783600468
STAT,1914,49,30-34,1963,0.08301718787188204
STAT,1845,19,25-29,1864,4.9857007971195175
STAT,1872,29,50-100,1901,0.6022226155882752
SIM,1862,53,na,1915,1844
SIM,1903,22,40-44,1925,3
SIM,1934,30,20-24,1964,3
STAT,1888,18,35-39,1906,0.610760579826351
STAT,1924,45,25-29,1969,0.05994520088305854
STAT,1867,16,50-100,1883,0.044688097936170054
STAT,1881,51,50-100,1932,0.013841794363639233
STAT,1815,40,35-39,1855,5.610134945718085
STAT,1894,34,30-34,1928,21.035747435501175
STAT,1821,47,45-49,1868,0.36037458529433625
SIM,1875,18,15-19,1893,6
SIM,1784,98,na,1882,1
STAT,1876,50,50-100,1926,0.014940700448473081
STAT,1920,34,35-39,1954,9.375576063451927
SIM,1800,99,na,1899,1
STAT,1844,38,na,1882,1729.6820941831177
SIM,1862,8,na,1870,2442
STAT,1925,11,na,1936,4528.999809893095
STAT,1879,51,30-34,1930,0.005905861079507049
STAT,1872,42,30-34,1914,1.0887759552311003
STAT,1820,41,20-24,1861,0.2955099373216534
SIM,1829,27,35-39,1856,10
SIM,1871,33,40-44,1904,5
SIM,1877,52,na,1929,2102
SIM,1853,38,na,1891,1871
SIM,1865,19,na,1884,2204
STAT,1905,44,45-49,1949,0.1399651638086429
STAT,1900,22,15-19,1922,4.3236663402732765
STAT,1884,44,15-19,1928,0.012718006330005274
STAT,1871,21,30-34,1892,16.73234148198839
STAT,1895,29,50-100,1924,0.7829762783289692
STAT,1860,35,50-100,1895,0.9515634779278644
SIM,1886,29,30-34,1915,30
STAT,1916,37,50-100,1953,0.40616268605373446
SIM,1835,43,30-34,1878,3
STAT,1878,29,30-34,1907,24.588201338645934
STAT,1850,42,45-49,1892,1.0523409523210088
STAT,1873,9,na,1882,2567.26279352737
STAT,1895,47,45-49,1942,0.16334970049653091
SIM,1863,16,30-34,1879,1
SIM,1880,42,30-34,1922,1
STAT,1827,43,30-34,1870,1.0392333323842509
SIM,1918,18,30-34,1936,11
STAT,1909,40,50-100,1949,0.10495521271312776
STAT,1861,31,15-19,1892,0.1121720365355555
STAT,1855,16,30-34,1871,1.3505939896058803
SIM,1812,80,na,1892,267
STAT,1927,22,30-34,1949,33.45602869053778
SIM,1907,19,25-29,1926,8
STAT,1929,30,40-44,1959,4.701464763538292
STAT,1839,15,40-44,1854,0.16143045699630934
STAT,1948,22,50-100,1970,0.7137730925362664
STAT,1908,28,35-39,1936,13.357477666725067
STAT,1907,41,15-19,1948,0.0013365776225784717
STAT,1800,108,na,1908,7.301387729270513E-4
STAT,1776,108,na,1884,0.004243123111044959
STAT,1903,19,45-49,1922,0.08732477603432907
STAT,1893,20,40-44,1913,2.5125892671771672
SIM,1933,25,30-34,1958,60
SIM,1852,21,na,1873,1993
SIM,1912,37,35-39,1949,5
STAT,1850,85,na,1935,192.9912740938956
STAT,1865,25,35-39,1890,8.339267863938947
STAT,1923,28,50-100,1951,1.0758627154057305
STAT,1916,47,25-29,1963,0.051396816240340294
STAT,1887,54,na,1941,2212.318919155013
SIM,1823,32,na,1855,1561
SIM,1816,70,na,1886,630
SIM,1869,43,50-100,1912,2
STAT,1900,15,50-100,1915,0.0645065639881541
SIM,1841,69,na,1910,1022
STAT,1914,39,15-19,1953,0.01792751997494578
STAT,1882,25,50-100,1907,0.5920267112460489
SIM,1924,16,20-24,1940,132
STAT,1906,45,45-49,1951,0.18495179304704146
SIM,1897,20,20-24,1917,97
STAT,1836,62,na,1898,1154.192163425126
STAT,1937,16,50-100,1953,0.3451182005626425
STAT,1869,30,45-49,1899,1.607432917616995
STAT,1936,28,40-44,1964,4.211225764559009
SIM,1836,82,na,1918,281
STAT,1900,24,15-19,1924,4.296599437529956
SIM,1884,23,45-49,1907,1
STAT,1921,34,30-34,1955,16.422949733275548
SIM,1944,15,35-39,1959,6
SIM,1959,9,na,1968,4856
SIM,1873,25,35-39,1898,8
STAT,1923,42,40-44,1965,0.27620011311813514
STAT,1851,54,20-24,1905,5.262477402219151E-4
SIM,1895,18,na,1913,3154
STAT,1902,21,15-19,1923,4.41136599882455
SIM,1894,76,na,1970,1577
SIM,1937,30,40-44,1967,4
SIM,1835,41,na,1876,1596
SIM,1944,26,45-49,1970,2
STAT,1859,28,15-19,1887,0.3454633657433369
SIM,1881,25,50-100,1906,1
STAT,1867,22,35-39,1889,5.197396874277274
SIM,1799,97,na,1896,2
SIM,1916,2,na,1918,3968
SIM,1892,31,50-100,1923,1
STAT,1847,21,25-29,1868,52.00926630488647
SIM,1935,22,30-34,1957,35
SIM,1918,25,35-39,1943,18
STAT,1904,37,35-39,1941,2.0683108447433853
SIM,1827,46,na,1873,1387
STAT,1878,18,na,1896,2477.306133430577
SIM,1855,21,25-29,1876,59
STAT,1920,36,35-39,1956,2.504190716719187
STAT,1921,45,40-44,1966,0.16871035227647702
SIM,1848,16,na,1864,2118
STAT,1870,37,40-44,1907,4.052120803397789
STAT,1911,27,25-29,1938,60.62526072362489
STAT,1849,37,na,1886,1737.6736646724603
SIM,1919,34,40-44,1953,3
STAT,1911,30,25-29,1941,8.568803151886051
SIM,1900,30,45-49,1930,2
STAT,1850,33,50-100,1883,0.6678050061054224
STAT,1920,16,40-44,1936,1.4862009672739893
STAT,1782,96,na,1878,1.3879573743664588
STAT,1904,48,45-49,1952,0.17809278590301436
SIM,1942,18,35-39,1960,4
STAT,1925,45,25-29,1970,0.06101663052930701
SIM,1848,31,35-39,1879,10
STAT,1914,19,20-24,1933,26.34701284253756
STAT,1917,15,25-29,1932,8.85017440268036
SIM,1870,101,na,1971,3
STAT,1897,19,50-100,1916,0.06156515096795351
STAT,1900,37,20-24,1937,0.21805714382437233
STAT,1940,29,15-19,1969,0.679323763576507
SIM,1857,44,na,1901,1811
SIM,1846,92,na,1938,37
STAT,1904,51,na,1955,2931.1991903876356
STAT,1950,19,30-34,1969,13.60697382667604
SIM,1900,18,30-34,1918,6
STAT,1886,13,na,1899,2573.6693494035035
SIM,1888,33,30-34,1921,32
STAT,1934,18,35-39,1952,5.347636519983695
SIM,1869,33,20-24,1902,2
SIM,1902,26,40-44,1928,3
STAT,1782,88,na,1870,40.260783815597804
STAT,1921,15,45-49,1936,0.5404640744741517
STAT,1942,26,15-19,1968,0.7002380674847302
SIM,1889,32,35-39,1921,10
STAT,1841,49,na,1890,1507.1822389959966
STAT,1951,15,30-34,1966,13.719795738944947
STAT,1786,78,na,1864,288.7156896185264
SIM,1920,10,na,1930,4138
STAT,1904,17,40-44,1921,0.24780129062631928
SIM,1873,15,na,1888,2450
SIM,1903,30,na,1933,3296
SIM,1887,7,na,1894,2721
SIM,1922,19,20-24,1941,162
STAT,1879,20,50-100,1899,0.4050678629198656
SIM,1799,73,na,1872,455
STAT,1835,22,45-49,1857,0.5783418003693196
STAT,1952,16,30-34,1968,13.8032254481677
SIM,1833,42,na,1875,1531
SIM,1837,56,na,1893,1299
STAT,1930,27,35-39,1957,18.03552855057008
STAT,1932,35,45-49,1967,0.8668171932376445
STAT,1790,83,na,1873,127.13663461356927
STAT,1857,32,na,1889,1788.1790842593923
STAT,1916,16,20-24,1932,27.239325615466658
STAT,1831,39,na,1870,1608.6485483548186
STAT,1871,47,na,1918,2097.2503601697426
SIM,1806,84,na,1890,91
SIM,1907,35,30-34,1942,5
STAT,1811,52,25-29,1863,0.011247060034506309
STAT,1902,34,20-24,1936,2.051459031083325
STAT,1932,15,20-24,1947,170.38497201898562
SIM,1831,51,na,1882,1384
STAT,1863,22,20-24,1885,58.36632085467401
SIM,1802,70,na,1872,656
STAT,1905,16,45-49,1921,0.08939438797806595
STAT,1893,31,50-100,1924,1.1027146424156653
STAT,1915,18,25-29,1933,8.544955253159822
SIM,1923,18,25-29,1941,54
SIM,1912,15,na,1927,3545
SIM,1808,75,na,1883,394
STAT,1911,21,50-100,1932,0.5911746401880953
SIM,1940,15,20-24,1955,109
STAT,1866,48,30-34,1914,0.08325235872201545
SIM,1875,9,na,1884,2580
STAT,1840,75,na,1915,716.9345900784454
STAT,1934,34,50-100,1968,1.0650217828627753
SIM,1920,23,25-29,1943,106
STAT,1908,22,20-24,1930,96.54853277618311
STAT,1810,77,na,1887,372.2633307712342
STAT,1844,17,15-19,1861,5.295839157606346
STAT,1934,32,15-19,1966,0.16574499548746155
SIM,1897,26,35-39,1923,14
SIM,1926,19,35-39,1945,6
STAT,1913,40,30-34,1953,0.11908573610125867
STAT,1917,32,15-19,1949,0.12711678824269237
SIM,1877,18,30-34,1895,2
SIM,1852,13,na,1865,2257
STAT,1912,23,25-29,1935,83.34934899834302
SIM,1923,39,50-100,1962,2
STAT,1896,16,25-29,1912,7.0924695392167925
SIM,1847,35,35-39,1882,8
STAT,1803,75,na,1878,411.17010540173
SIM,1827,54,na,1881,1194
STAT,1894,24,na,1918,2856.062904826931
SIM,1941,19,30-34,1960,22
STAT,1898,38,na,1936,3021.599113709813
SIM,1943,19,35-39,1962,5
STAT,1932,15,na,1947,4625.807790497727
SIM,1852,17,15-19,1869,5
STAT,1854,67,na,1921,1141.5062086883763
SIM,1878,46,na,1924,2299
STAT,1935,19,35-39,1954,5.389789069954983
STAT,1830,52,35-39,1882,0.0055496989573806
SIM,1945,24,40-44,1969,3
STAT,1870,54,30-34,1924,0.005358569528027635
STAT,1890,18,na,1908,2909.5003914655554
STAT,1829,25,25-29,1854,121.36941342002137
STAT,1889,26,35-39,1915,11.29189339587814
SIM,1902,15,30-34,1917,4
SIM,1882,51,na,1933,1958
STAT,1860,47,25-29,1907,0.04401678711820854
STAT,1937,24,40-44,1961,3.0906586420760935
STAT,1868,16,na,1884,2333.0260497889485
SIM,1837,25,25-29,1862,42
STAT,1872,21,na,1893,2249.314979136803
STAT,1924,29,30-34,1953,42.79453794367278
STAT,1792,98,na,1890,0.5470574043165037
SIM,1849,40,40-44,1889,4
STAT,1819,49,50-100,1868,0.4238774470866561
STAT,1899,31,na,1930,3101.9754736035
SIM,1805,49,50-100,1854,1
STAT,1836,52,50-100,1888,0.0096498780671565
STAT,1885,48,40-44,1933,0.159105303407169
STAT,1903,30,20-24,1933,3.6622028739552626
SIM,1816,62,na,1878,903
STAT,1908,41,na,1949,3264.003624677116
SIM,1837,46,50-100,1883,3
STAT,1825,78,na,1903,441.76092049260177
STAT,1852,53,25-29,1905,0.0026479145721107007
STAT,1918,19,35-39,1937,4.291418120112165
SIM,1903,25,45-49,1928,1
SIM,1861,89,na,1950,71
STAT,1869,18,30-34,1887,1.468972016654704
STAT,1877,52,na,1929,2099.5500429495664
STAT,1931,2,na,1933,5057.252777950988
STAT,1933,31,15-19,1964,0.16369512494800068
SIM,1850,44,50-100,1894,4
STAT,1858,40,40-44,1898,1.6849616046983436
SIM,1906,27,na,1933,3316
STAT,1907,41,45-49,1948,0.1448515896772158
STAT,1761,102,na,1863,0.05061645900854166
SIM,1898,66,na,1964,2322
SIM,1933,0,na,1933,5272
STAT,1924,41,45-49,1965,0.1873015982363842
STAT,1909,29,35-39,1938,13.45440664864354
STAT,1913,43,50-100,1956,0.108032634191734
STAT,1866,60,na,1926,1661.1325825155373
SIM,1886,33,na,1919,2322
STAT,1943,22,15-19,1965,5.350049164461143
SIM,1911,30,20-24,1941,1
STAT,1854,103,na,1957,0.15098512318199692
STAT,1938,23,45-49,1961,1.0515257037863324
STAT,1853,42,na,1895,1711.9232540165835
STAT,1903,36,35-39,1939,2.0617140524623445
SIM,1911,36,35-39,1947,5
SIM,1840,44,na,1884,1605
SIM,1936,34,40-44,1970,8
STAT,1866,92,na,1958,52.58410943801455
SIM,1853,62,na,1915,1450
SIM,1857,76,na,1933,705
STAT,1823,39,20-24,1862,1.0915396557054504
STAT,1915,11,na,1926,3910.264922190283
STAT,1919,25,na,1944,3849.7616065213388
SIM,1932,29,30-34,1961,57
STAT,1890,39,50-100,1929,1.4038037532895
SIM,1762,96,na,1858,2
SIM,1911,41,na,1952,3423
SIM,1915,55,na,1970,3336
STAT,1952,5,na,1957,4451.328182530656
STAT,1849,8,na,1857,2178.739546185467
SIM,1828,35,25-29,1863,2
STAT,1840,39,20-24,1879,0.6218908404517657
STAT,1910,34,25-29,1944,8.344439747738097
SIM,1916,28,35-39,1944,17
SIM,1856,25,35-39,1881,7
STAT,1786,107,na,1893,0.002320750598313906
STAT,1918,44,25-29,1962,0.07148427265122764
SIM,1930,30,30-34,1960,26
SIM,1844,26,na,1870,1931
STAT,1857,43,50-100,1900,0.7811097435963158
SIM,1946,23,45-49,1969,1
STAT,1889,20,20-24,1909,80.85024987237634
SIM,1915,29,30-34,1944,41
STAT,1878,20,15-19,1898,3.263791648193017
STAT,1839,35,35-39,1874,5.753973986653649
STAT,1928,34,40-44,1962,4.6170661588477255
SIM,1853,94,na,1947,9
SIM,1939,27,20-24,1966,20
STAT,1905,24,50-100,1929,0.5532122655936415
SIM,1878,26,25-29,1904,39
STAT,1907,29,30-34,1936,34.39735987603946
SIM,1910,32,na,1942,3379
SIM,1916,22,20-24,1938,104
STAT,1871,53,35-39,1924,0.007933301784411791
STAT,1871,39,na,1910,2184.267801671027
SIM,1836,90,na,1926,39
STAT,1857,24,na,1881,1823.9199290332792
STAT,1923,30,na,1953,4129.244794621939
STAT,1917,45,20-24,1962,0.010955425905192204
SIM,1917,29,35-39,1946,22
STAT,1922,30,30-34,1952,16.953243540235157
STAT,1800,100,na,1900,0.4231796792902143
STAT,1933,31,45-49,1964,2.004493043846252
STAT,1919,28,40-44,1947,4.740934088797183
STAT,1863,5,na,1868,2382.7374334763563
SIM,1819,67,na,1886,790
STAT,1893,23,45-49,1916,0.8332381186076806
STAT,1891,67,na,1958,1928.5945377072508
SIM,1870,74,na,1944,948
SIM,1829,80,na,1909,283
SIM,1914,42,40-44,1956,2
STAT,1856,15,40-44,1871,0.16191934901419736
SIM,1924,19,25-29,1943,44
STAT,1835,21,na,1856,1786.045575806258
SIM,1871,99,na,1970,12
SIM,1878,78,na,1956,747
STAT,1918,41,20-24,1959,0.017763504054855626
STAT,1898,40,50-100,1938,0.09476419274359725
SIM,1815,77,na,1892,333
STAT,1857,101,na,1958,0.7097008992307597
SIM,1935,34,25-29,1969,16
STAT,1805,107,na,1912,0.0015790355821904778
SIM,1881,26,na,1907,2006
SIM,1908,36,30-34,1944,1
STAT,1847,110,na,1957,2.502870824618801E-4
STAT,1867,30,40-44,1897,3.8775897011513893
SIM,1941,16,20-24,1957,113
SIM,1919,45,na,1964,3788
STAT,1905,29,20-24,1934,15.900790307298294
STAT,1924,28,na,1952,4106.428020781722
SIM,1858,18,20-24,1876,13
STAT,1911,24,20-24,1935,98.97835994457935
SIM,1895,26,25-29,1921,54
STAT,1841,21,30-34,1862,15.550170541268315
STAT,1839,59,na,1898,1295.8476807279008
STAT,1847,23,50-100,1870,0.3651880595407672
STAT,1916,19,25-29,1935,8.638838694821771
STAT,1883,48,30-34,1931,0.08849780861312025
STAT,1921,37,35-39,1958,2.551578211512191
SIM,1918,20,na,1938,3706
SIM,1927,28,40-44,1955,5
SIM,1834,21,35-39,1855,5
SIM,1910,37,30-34,1947,4
STAT,1856,90,na,1946,58.333661676151344
STAT,1878,34,50-100,1912,0.8933692809141098
STAT,1907,26,20-24,1933,16.33286041281203
STAT,1940,32,45-49,1972,1.5383588241625625
STAT,1878,33,20-24,1911,2.647111793948039
SIM,1866,13,na,1879,2385
STAT,1910,47,30-34,1957,0.07854986989386525
SIM,1878,23,20-24,1901,73
STAT,1889,40,50-100,1929,1.2445426982375831
STAT,1887,26,25-29,1913,44.84467285474339
SIM,1911,33,25-29,1944,10
STAT,1941,25,15-19,1966,0.6904423215019411
STAT,1920,8,na,1928,4227.493203461884
STAT,1895,20,45-49,1915,0.8647870949212006
SIM,1830,77,na,1907,547
SIM,1887,74,na,1961,1221
SIM,1888,16,na,1904,2748
STAT,1923,45,45-49,1968,0.24133862185033417
STAT,1924,41,15-19,1965,0.0017282732307860324
STAT,1907,25,50-100,1932,0.8935735514820147
STAT,1826,32,45-49,1858,2.307472656219932
STAT,1875,29,na,1904,2299.6571483038283
STAT,1854,59,na,1913,1399.4773130744143
STAT,1894,56,na,1950,2478.6045845759522
STAT,1807,57,na,1864,1068.0034640137076
STAT,1931,19,20-24,1950,166.74516560218845
SIM,1789,95,na,1884,3
SIM,1879,43,30-34,1922,4
STAT,1869,30,15-19,1899,0.1312695661891384
STAT,1922,16,45-49,1938,0.5475319203782524
SIM,1940,30,na,1970,3520
SIM,1834,32,45-49,1866,1
SIM,1907,16,20-24,1923,28
STAT,1844,41,50-100,1885,0.7693558980194931
STAT,1865,11,na,1876,2331.219183408161
SIM,1866,4,na,1870,2517
STAT,1900,24,45-49,1924,0.9081811624299563
SIM,1864,54,na,1918,1878
STAT,1915,43,na,1958,3526.3764935456397
STAT,1859,90,na,1949,59.439838651794766
STAT,1901,25,15-19,1926,0.6039950371879268
STAT,1903,33,25-29,1936,7.871308954558888
STAT,1949,23,na,1972,4024.5248193860857
STAT,1945,18,40-44,1963,1.442953884769706
SIM,1860,22,45-49,1882,1
SIM,1858,18,na,1876,2146
STAT,1875,38,30-34,1913,5.146901995722299
SIM,1846,60,na,1906,1331
STAT,1875,21,na,1896,2302.299519039132
STAT,1878,20,45-49,1898,0.6898744311825209
SIM,1928,30,na,1958,4467
SIM,1888,30,20-24,1918,2
STAT,1841,60,na,1901,1304.876270541657
SIM,1902,27,25-29,1929,66
SIM,1913,29,20-24,1942,13
STAT,1933,16,20-24,1949,171.87247502166505
STAT,1913,23,40-44,1936,3.196889918667779
STAT,1850,106,na,1956,0.010719503722084835
STAT,1852,22,45-49,1874,0.6293843203048032
SIM,1883,38,30-34,1921,6
SIM,1921,27,35-39,1948,13
STAT,1838,19,40-44,1857,0.16284144375448056
SIM,1887,82,na,1969,735
STAT,1897,33,30-34,1930,21.965786801040124
SIM,1856,22,25-29,1878,69
STAT,1913,27,35-39,1940,14.129038339265664
STAT,1914,42,45-49,1956,0.1557645687368647
STAT,1914,18,na,1932,3763.7450741748844
STAT,1903,16,40-44,1919,0.2464315134244897
SIM,1877,21,na,1898,2323
SIM,1879,87,na,1966,377
SIM,1856,59,na,1915,1523
STAT,1907,56,na,1963,2976.3241207801184
SIM,1953,18,40-44,1971,2
STAT,1902,37,25-29,1939,0.8284841404908151
STAT,1899,41,40-44,1940,0.20312624031244658
SIM,1851,28,na,1879,1874
STAT,1817,67,na,1884,782.8080838946619
STAT,1921,48,45-49,1969,0.23083502954611448
STAT,1925,42,20-24,1967,0.020201247369767774
SIM,1891,36,na,1927,2919
STAT,1904,43,50-100,1947,0.09867479437944215
STAT,1930,24,30-34,1954,34.5671744723687
STAT,1870,97,na,1967,22.526910655012294
STAT,1863,40,50-100,1903,0.8861441905643048
SIM,1902,30,25-29,1932,17
STAT,1899,30,30-34,1929,22.785276177251596
SIM,1838,42,30-34,1880,3
SIM,1874,64,na,1938,1636
STAT,1860,44,20-24,1904,0.12028441216110888
STAT,1873,62,na,1935,1752.6266094975579
STAT,1911,26,40-44,1937,4.307894760694983
SIM,1879,31,na,1910,2351
SIM,1928,40,40-44,1968,1
SIM,1901,19,30-34,1920,3
STAT,1879,67,na,1946,1565.294943154642
STAT,1932,23,na,1955,4512.586988965691
STAT,1813,53,na,1866,1183.597332017737
STAT,1911,15,30-34,1926,2.3143842137907455
SIM,1854,25,25-29,1879,39
SIM,1871,40,50-100,1911,1
STAT,1901,20,45-49,1921,0.9275607486458096
SIM,1871,22,20-24,1893,58
STAT,1860,23,50-100,1883,0.3204286228281103
STAT,1901,36,25-29,1937,0.8256895079562425
STAT,1930,35,40-44,1965,1.847920759187564
SIM,1837,22,20-24,1859,67
STAT,1846,25,25-29,1871,36.60532811323372
SIM,1938,6,na,1944,3658
STAT,1902,40,25-29,1942,0.06004853664953384
SIM,1823,64,na,1887,897
SIM,1914,25,20-24,1939,22
SIM,1834,56,na,1890,1242
SIM,1877,30,45-49,1907,4
SIM,1830,66,na,1896,1065
SIM,1926,16,30-34,1942,18
STAT,1879,45,50-100,1924,0.24493107249978432
SIM,1874,21,35-39,1895,4
STAT,1909,38,25-29,1947,0.8758260208502371
STAT,1911,43,30-34,1954,0.11455552295909445
STAT,1937,27,45-49,1964,1.5907023223654475
SIM,1833,100,na,1933,1
SIM,1909,32,30-34,1941,19
SIM,1917,38,25-29,1955,1
SIM,1903,23,25-29,1926,77
SIM,1921,23,40-44,1944,3
SIM,1930,33,35-39,1963,10
STAT,1834,30,50-100,1864,0.74171983793222
SIM,1887,45,50-100,1932,3
STAT,1909,41,25-29,1950,0.06344478852083531
STAT,1926,37,40-44,1963,1.7285320067702385
SIM,1844,34,na,1878,1821
SIM,1848,48,na,1896,1653
STAT,1849,19,50-100,1868,0.04295683252113749
STAT,1848,22,25-29,1870,50.21524399927768
SIM,1897,23,30-34,1920,30
SIM,1925,15,25-29,1940,53
STAT,1901,20,15-19,1921,4.388284139524664
STAT,1808,47,30-34,1855,0.3685025758760513
SIM,1853,5,na,1858,2408
STAT,1924,38,20-24,1962,0.2933826368362117
STAT,1926,20,50-100,1946,0.7597688581883024
STAT,1906,25,20-24,1931,16.247375431924954
STAT,1915,35,45-49,1950,0.6567038175580057
SIM,1929,4,na,1933,4940
STAT,1855,37,50-100,1892,0.8695325961274196
STAT,1903,66,na,1969,2508.0232860203564
STAT,1889,23,30-34,1912,20.70977560111571
STAT,1943,0,na,1943,4474.095898918058
STAT,1927,38,40-44,1965,1.75668786454857
STAT,1869,89,na,1958,133.71997070574207
STAT,1836,30,na,1866,1766.1883038377173
SIM,1849,43,45-49,1892,2
STAT,1813,77,na,1890,365.5751484210211
STAT,1871,45,35-39,1916,0.1324232545802797
STAT,1816,42,na,1858,1455.9670707257758
STAT,1936,26,45-49,1962,1.5623397601913536
STAT,1775,86,na,1861,60.312228137402904
STAT,1872,49,15-19,1921,3.713615133548687E-4
SIM,1833,46,50-100,1879,1
STAT,1781,108,na,1889,0.004660996539090268
SIM,1839,87,na,1926,119
SIM,1849,32,35-39,1881,6
STAT,1882,31,na,1913,2202.5811072416273
STAT,1825,46,50-100,1871,0.2610947815128233
STAT,1940,10,na,1950,3796.0509318398604
SIM,1904,43,35-39,1947,3
STAT,1856,32,30-34,1888,13.076503472453412
STAT,1837,87,na,1924,111.21547745687904
SIM,1915,26,20-24,1941,16
STAT,1884,30,40-44,1914,4.081039499946867
SIM,1936,17,na,1953,2768
SIM,1904,4,na,1908,3507
STAT,1833,73,na,1906,721.0728113543688
STAT,1917,48,25-29,1965,0.0521941971986731
STAT,1823,50,50-100,1873,0.018035385084493427
SIM,1854,87,na,1941,105
SIM,1897,0,na,1897,3497
SIM,1910,21,15-19,1931,3
STAT,1888,22,25-29,1910,63.88668392143163
SIM,1934,37,40-44,1971,2
STAT,1767,99,na,1866,0.2432340947915072
STAT,1837,32,20-24,1869,2.1394326069003493
SIM,1872,48,50-100,1920,3
STAT,1822,81,na,1903,279.32268165227987
STAT,1936,15,35-39,1951,3.8121394676241933
SIM,1896,22,25-29,1918,81
STAT,1964,3,na,1967,4679.177580110114
STAT,1910,31,20-24,1941,2.23022007549949
SIM,1911,33,30-34,1944,18
STAT,1826,95,na,1921,7.256932701684373
SIM,1915,25,50-100,1940,4
STAT,1872,15,25-29,1887,5.454949523247074
STAT,1923,45,15-19,1968,4.0904816732153745E-4
SIM,1886,33,20-24,1919,2
SIM,1839,21,40-44,1860,2
SIM,1857,52,na,1909,1694
SIM,1845,32,20-24,1877,1
SIM,1875,22,35-39,1897,12
SIM,1946,20,40-44,1966,5
STAT,1828,103,na,1931,0.08147010476418796
SIM,1906,15,20-24,1921,26
STAT,1922,33,35-39,1955,9.713721903615353
SIM,1880,15,25-29,1895,8
STAT,1918,27,40-44,1945,4.685929187608417
STAT,1820,55,na,1875,1198.203586689734
SIM,1791,77,na,1868,305
SIM,1862,7,na,1869,2459
SIM,1905,22,45-49,1927,4
SIM,1828,95,na,1923,8
SIM,1902,37,na,1939,3188
SIM,1829,31,25-29,1860,17
STAT,1904,45,40-44,1949,0.1321410861468722
STAT,1922,45,na,1967,4006.122870620021
SIM,1936,30,25-29,1966,13
STAT,1824,69,na,1893,774.7714563323699
STAT,1903,33,30-34,1936,13.41756700781978
SIM,1799,65,na,1864,767
STAT,1895,41,na,1936,2872.0729840651297
SIM,1854,37,50-100,1891,1
STAT,1866,21,35-39,1887,5.161196821593444
STAT,1916,36,15-19,1952,0.018666502406320454
SIM,1892,30,40-44,1922,8
STAT,1828,28,50-100,1856,0.9304943419638062
STAT,1918,16,30-34,1934,2.520612768343862
SIM,1926,27,40-44,1953,7
STAT,1915,35,15-19,1950,0.018498701286088732
SIM,1868,24,15-19,1892,6
STAT,1904,34,30-34,1938,13.46631458673802
STAT,1920,20,25-29,1940,97.59341814440683
STAT,1827,34,na,1861,1582.150934515201
SIM,1938,29,25-29,1967,62
STAT,1928,30,25-29,1958,10.931173162318785
STAT,1846,37,50-100,1883,0.9039792664959362
SIM,1864,32,30-34,1896,28
STAT,1926,26,30-34,1952,44.53043321714353
STAT,1921,32,35-39,1953,9.607974880939974
SIM,1925,7,na,1932,4458
SIM,1897,23,25-29,1920,79
STAT,1889,23,25-29,1912,66.55765362858041
SIM,1842,37,30-34,1879,3
STAT,1912,44,30-34,1956,0.11555528688733488
SIM,1820,39,45-49,1859,4
STAT,1898,46,na,1944,2885.8622215903065
STAT,1911,53,na,1964,3215.021801713155
STAT,1938,28,15-19,1966,0.6603157414875804
SIM,1884,20,40-44,1904,4
STAT,1938,20,40-44,1958,3.145485761922673
SIM,1878,38,na,1916,2368
STAT,1925,25,30-34,1950,44.021705790274616
SIM,1938,18,15-19,1956,37
STAT,1842,47,30-34,1889,0.06894401642434707
SIM,1912,34,30-34,1946,14
STAT,1920,17,25-29,1937,45.93287684115896
SIM,1806,92,na,1898,12
SIM,1856,22,30-34,1878,21
SIM,1908,1,na,1909,3646
STAT,1834,37,30-34,1871,4.103474483064827
SIM,1934,26,30-34,1960,54
SIM,1875,18,20-24,1893,15
STAT,1872,32,na,1904,2262.7056406757647
STAT,1875,20,50-100,1895,0.39813752270567576
STAT,1928,38,35-39,1966,2.885101772761266
STAT,1849,69,na,1918,1057.7918135574278
SIM,1952,12,na,1964,4396
STAT,1880,75,na,1955,1023.2836809511743
STAT,1919,44,40-44,1963,0.2552122214111177
SIM,1861,37,40-44,1898,3
STAT,1831,49,20-24,1880,0.008598850884948463
STAT,1830,44,35-39,1874,1.3397379312631124
SIM,1920,26,35-39,1946,17
STAT,1914,23,35-39,1937,9.0580741947786
SIM,1931,28,50-100,1959,1
SIM,1941,19,25-29,1960,40
STAT,1849,50,50-100,1899,0.01104235862694816
STAT,1802,82,na,1884,166.68285610368085
STAT,1843,32,45-49,1875,1.512465655842284
SIM,1855,10,na,1865,2321
STAT,1829,29,40-44,1858,3.279093308325494
SIM,1923,39,30-34,1962,2
STAT,1888,43,30-34,1931,1.2737730183526832
STAT,1903,21,30-34,1924,24.012575162734738
SIM,1868,20,20-24,1888,60
SIM,1918,34,25-29,1952,14
STAT,1830,105,na,1935,0.017514746096280467
STAT,1902,17,na,1919,3367.0071453253117
SIM,1851,32,45-49,1883,1
SIM,1833,93,na,1926,11
STAT,1849,20,45-49,1869,0.6165075644154453
STAT,1924,25,15-19,1949,0.7818485547868076
STAT,1870,46,30-34,1916,0.08985921157806925
SIM,1847,32,25-29,1879,10
STAT,1813,45,na,1858,1336.3311157951614
STAT,1843,21,35-39,1864,5.322676802349925
STAT,1926,45,40-44,1971,0.18466418571433557
SIM,1922,23,35-39,1945,15
SIM,1837,29,40-44,1866,5
STAT,1893,19,50-100,1912,0.05840753397345645
SIM,1907,32,20-24,1939,2
SIM,1765,93,na,1858,6
SIM,1908,39,35-39,1947,5
STAT,1912,26,35-39,1938,14.021680001495216
STAT,1839,32,25-29,1871,8.404466675769202
STAT,1882,87,na,1969,393.34139373436994
SIM,1897,22,40-44,1919,3
SIM,1927,44,40-44,1971,2
STAT,1823,52,na,1875,1268.8508690839483
SIM,1934,29,35-39,1963,22
STAT,1855,31,25-29,1886,7.463357712512401
SIM,1810,46,na,1856,1346
SIM,1851,21,35-39,1872,7
SIM,1893,39,50-100,1932,3
STAT,1917,48,30-34,1965,0.08771524891537923
SIM,1867,23,45-49,1890,1
STAT,1853,37,40-44,1890,3.2463903731206463
STAT,1866,43,50-100,1909,0.9135109935971197
SIM,1809,89,na,1898,45
SIM,1862,32,20-24,1894,2
STAT,1856,18,45-49,1874,0.05681250511241353
SIM,1908,53,na,1961,2993
STAT,1921,9,na,1930,4287.073779786383
STAT,1869,97,na,1966,20.231117108278077
STAT,1890,82,na,1972,982.6344663468724
STAT,1832,31,30-34,1863,13.97390893094495
STAT,1889,22,40-44,1911,2.4302879115242524
SIM,1902,22,25-29,1924,78
SIM,1922,22,45-49,1944,1
STAT,1910,19,30-34,1929,2.2686906593363876
STAT,1855,20,15-19,1875,2.7692236106061445
STAT,1831,38,50-100,1869,0.9582423324780391
STAT,1901,44,25-29,1945,0.05816843986232455
STAT,1933,19,25-29,1952,54.508639778838074
STAT,1884,31,50-100,1915,0.858847124458528
STAT,1914,34,45-49,1948,1.4832865932204786
SIM,1820,67,na,1887,790
STAT,1919,45,30-34,1964,0.09177305897297854
STAT,1938,31,na,1969,3594.20748828681
STAT,1854,50,30-34,1904,0.00434799384385111
SIM,1896,31,50-100,1927,2
STAT,1854,32,20-24,1886,1.993289478096
SIM,1780,85,na,1865,79
STAT,1844,14,na,1858,2111.0094052608424
STAT,1812,44,50-100,1856,3.6399346350216697
STAT,1894,38,40-44,1932,5.293244752325967
SIM,1913,29,na,1942,3400
STAT,1797,73,na,1870,499.6283291643546
STAT,1901,62,na,1963,2587.9677558465523
STAT,1785,85,na,1870,85.29852376309533
STAT,1884,48,25-29,1932,0.05309624175353625
STAT,1838,29,na,1867,1849.9264020543253
STAT,1844,15,50-100,1859,0.04423867851245442
STAT,1881,4,na,1885,2589.2211646498345
STAT,1956,16,20-24,1972,169.5035883579305
STAT,1899,44,45-49,1943,0.13273271583247997
STAT,1914,22,45-49,1936,1.0857664856527098
SIM,1861,23,15-19,1884,3
STAT,1847,54,na,1901,1540.7099008532005
STAT,1907,29,25-29,1936,57.78186760151051
STAT,1865,48,15-19,1913,3.390630927104013E-4
STAT,1825,105,na,1930,0.016577735113965254
SIM,1915,29,25-29,1944,73
STAT,1911,29,45-49,1940,1.5798836174806254
STAT,1819,47,na,1866,1346.1839010070066
SIM,1850,46,50-100,1896,2
STAT,1835,27,15-19,1862,0.36893748871773724
STAT,1857,15,35-39,1872,0.48601482119477296
STAT,1899,33,35-39,1932,13.055309195412171
STAT,1911,18,35-39,1929,0.7909926409621898
STAT,1848,28,na,1876,1847.1612540630065
STAT,1881,39,50-100,1920,1.1086070921847786
STAT,1884,8,na,1892,2426.779665421876
STAT,1853,23,15-19,1876,2.8699841988252905
SIM,1860,96,na,1956,4
SIM,1814,90,na,1904,22
SIM,1902,24,20-24,1926,86
STAT,1880,72,na,1952,1255.3155441860295
STAT,1852,34,50-100,1886,0.7059536607956657
STAT,1884,86,na,1970,478.64118253783266
STAT,1867,18,20-24,1885,15.981201316417298
STAT,1940,24,45-49,1964,1.081968373988182
STAT,1944,17,50-100,1961,0.38087924648580307
SIM,1843,92,na,1935,36
SIM,1930,29,20-24,1959,24
STAT,1847,65,na,1912,1243.4553231105097
STAT,1838,18,na,1856,2055.732144340776
STAT,1845,17,30-34,1862,1.418984561939839
STAT,1901,51,na,1952,2860.806266627024
STAT,1922,29,20-24,1951,19.374972626090127
STAT,1768,92,na,1860,6.26990618538267
STAT,1910,17,35-39,1927,0.7852356971998894
STAT,1834,54,20-24,1888,4.5015803063426664E-4
STAT,1827,47,40-44,1874,0.14999334635375114
STAT,1865,22,25-29,1887,49.73956460713145
STAT,1851,70,na,1921,1028.8973764971229
STAT,1910,23,20-24,1933,98.31318301914438
STAT,1884,65,na,1949,1577.6471322141406
SIM,1784,75,na,1859,309
SIM,1873,22,25-29,1895,62
SIM,1859,19,20-24,1878,17
STAT,1841,50,45-49,1891,0.01007195927229372
STAT,1930,23,40-44,1953,4.056817067000385
STAT,1950,15,15-19,1965,50.7245131185415
STAT,1888,79,na,1967,1141.6597901101072
SIM,1784,103,na,1887,1
STAT,1920,33,25-29,1953,9.524065660852232
SIM,1846,15,25-29,1861,6
SIM,1901,26,25-29,1927,67
STAT,1859,98,na,1957,3.3436405209835915
SIM,1881,58,na,1939,1664
STAT,1894,24,15-19,1918,3.983943554283207
STAT,1925,22,20-24,1947,125.75354389056038
SIM,1892,22,35-39,1914,6
SIM,1876,39,50-100,1915,1
SIM,1901,15,15-19,1916,10
SIM,1937,34,35-39,1971,9
STAT,1861,17,15-19,1878,5.350977902079214
STAT,1860,48,50-100,1908,0.1861924902766593
STAT,1906,28,25-29,1934,57.98538821795295
SIM,1928,24,40-44,1952,8
STAT,1802,90,na,1892,26.895479196198515
STAT,1936,24,25-29,1960,83.35400246992835
STAT,1918,44,30-34,1962,0.12797990696485903
STAT,1853,101,na,1954,0.4231789253176439
STAT,1768,105,na,1873,0.011953323191591597
STAT,1783,81,na,1864,162.42601795133626
STAT,1871,54,50-100,1925,0.013755420002748894
STAT,1913,38,45-49,1951,0.6322556284959328
SIM,1892,33,45-49,1925,4
STAT,1851,37,50-100,1888,0.9099653717038385
STAT,1826,92,na,1918,22.73296389863836
STAT,1829,46,50-100,1875,0.20078075917724272
SIM,1958,8,na,1966,4846
STAT,1951,16,15-19,1967,51.0709766734893
STAT,1813,42,na,1855,1361.2948166568265
STAT,1942,22,20-24,1964,110.13317977387315
STAT,1873,32,30-34,1905,16.74226840591908
SIM,1868,79,na,1947,555
SIM,1926,32,30-34,1958,26
STAT,1868,48,40-44,1916,0.15247819458142248
STAT,1924,23,50-100,1947,0.731287712425661
SIM,1820,75,na,1895,481
SIM,1949,16,25-29,1965,63
STAT,1900,29,15-19,1929,0.5903679522551387
SIM,1809,60,na,1869,1044
SIM,1944,24,25-29,1968,105
SIM,1872,84,na,1956,257
STAT,1858,43,45-49,1901,1.1019346285761233
STAT,1860,21,50-100,1881,0.32508001316224966
STAT,1941,29,30-34,1970,38.25046398605621
STAT,1823,44,na,1867,1415.1698292794622
SIM,1841,29,na,1870,1836
SIM,1907,38,35-39,1945,8
STAT,1879,20,30-34,1899,17.693362333445478
STAT,1941,25,45-49,1966,1.6896538986198788
SIM,1887,16,25-29,1903,9
SIM,1933,22,20-24,1955,140
STAT,1935,32,30-34,1967,20.590555432797238
STAT,1843,18,50-100,1861,0.04490301352489057
SIM,1859,17,25-29,1876,4
SIM,1881,32,30-34,1913,16
SIM,1858,40,50-100,1898,1
STAT,1913,17,50-100,1930,0.07234833459577447
SIM,1946,16,na,1962,3809
STAT,1879,17,30-34,1896,1.5738378229721621
SIM,1933,20,na,1953,4628
STAT,1891,48,50-100,1939,0.15995894726984417
STAT,1926,35,20-24,1961,0.3049101609770264
SIM,1814,41,30-34,1855,1
SIM,1844,66,na,1910,1139
SIM,1866,43,45-49,1909,8
SIM,1914,17,15-19,1931,7
STAT,1847,102,na,1949,0.2157148443196266
STAT,1855,19,40-44,1874,0.15226369424395855
STAT,1906,17,15-19,1923,8.163621811170982
SIM,1914,28,25-29,1942,59
SIM,1870,18,na,1888,2345
SIM,1876,90,na,1966,190
STAT,1929,34,35-39,1963,10.952278571550586
SIM,1902,48,50-100,1950,2
SIM,1850,20,35-39,1870,5
SIM,1868,68,na,1936,1325
SIM,1917,22,15-19,1939,5
STAT,1882,22,30-34,1904,16.373942522824553
SIM,1858,37,50-100,1895,3
SIM,1869,21,20-24,1890,63
SIM,1927,23,40-44,1950,2
STAT,1892,45,50-100,1937,0.16552634046754353
STAT,1926,29,35-39,1955,16.882803009191008
STAT,1842,44,50-100,1886,0.7586584572601234
STAT,1902,37,30-34,1939,1.5335770344332722
STAT,1925,42,15-19,1967,0.001756630300943886
SIM,1917,33,25-29,1950,10
SIM,1849,28,20-24,1877,11
SIM,1895,61,na,1956,2345
STAT,1892,34,15-19,1926,0.1670268782771092
STAT,1916,28,na,1944,3646.1671213675972
SIM,1855,29,na,1884,1967
STAT,1911,34,40-44,1945,3.5682853124179363
SIM,1929,23,na,1952,4419
STAT,1912,46,na,1958,3342.926539412841
STAT,1872,19,40-44,1891,0.17249903685991153
SIM,1891,21,35-39,1912,9
STAT,1879,5,na,1884,2677.843468696426
STAT,1884,33,45-49,1917,1.6210574273467533
SIM,1840,31,30-34,1871,16
STAT,1871,19,50-100,1890,0.045636961962917076
SIM,1899,19,20-24,1918,19
STAT,1909,22,15-19,1931,4.672582725216228
STAT,1925,34,20-24,1959,2.733110603183636
STAT,1795,63,na,1858,830.1733310092499
SIM,1824,30,35-39,1854,8
SIM,1902,4,na,1906,3516
SIM,1933,34,20-24,1967,1
SIM,1944,12,na,1956,3955
STAT,1817,42,45-49,1859,3.784061704608114
STAT,1956,2,na,1958,4918.648728600359
STAT,1874,36,na,1910,2285.71883710166
STAT,1824,93,na,1917,15.429186655452352
STAT,1828,49,50-100,1877,0.20147455183172094
STAT,1885,28,na,1913,2238.239979638886
SIM,1890,22,30-34,1912,27
SIM,1874,5,na,1879,2631
STAT,1919,23,40-44,1942,3.467455584990789
STAT,1847,45,35-39,1892,0.10403738792351208
STAT,1884,22,35-39,1906,5.447652427369301
SIM,1907,19,30-34,1926,4
SIM,1938,26,20-24,1964,21
STAT,1922,0,na,1922,4925.850598469304
SIM,1851,36,na,1887,1791
STAT,1905,49,15-19,1954,3.0159296737427595E-4
STAT,1862,54,na,1916,1687.3897697168825
SIM,1825,42,45-49,1867,3
STAT,1909,35,20-24,1944,0.2378922156798063
SIM,1839,25,35-39,1864,13
STAT,1824,106,na,1930,0.006410055630077299
SIM,1933,28,35-39,1961,17
STAT,1867,33,45-49,1900,1.5402437504798905
STAT,1851,62,na,1913,1340.3052863344794
SIM,1868,28,30-34,1896,22
SIM,1883,36,na,1919,2237
SIM,1898,1,na,1899,3394
STAT,1837,55,na,1892,1305.2601232618101
STAT,1912,40,15-19,1952,0.0014147351672727333
SIM,1918,31,na,1949,3755
STAT,1863,95,na,1958,16.6860416912123
STAT,1897,49,50-100,1946,0.17137757886632918
STAT,1940,26,50-100,1966,0.9591848584264223
STAT,1792,66,na,1858,689.1544342695947
STAT,1827,33,15-19,1860,0.15867773369860963
STAT,1898,16,35-39,1914,0.7034274282912166
STAT,1965,4,na,1969,4636.865489664432
STAT,1846,91,na,1937,40.857409525766606
STAT,1916,32,20-24,1948,2.3789042430018275
STAT,1944,22,30-34,1966,29.315225984741318
SIM,1823,31,30-34,1854,15
STAT,1870,49,35-39,1919,0.12688791083544126
SIM,1924,32,20-24,1956,1
STAT,1915,39,30-34,1954,1.7216734880441305
STAT,1887,34,50-100,1921,0.9597225239296702
STAT,1883,21,35-39,1904,5.419190840293152
SIM,1825,31,35-39,1856,10
STAT,1915,39,50-100,1954,0.3966115613974936
SIM,1893,46,na,1939,2801
STAT,1813,74,na,1887,485.81204885574965
SIM,1906,39,30-34,1945,5
STAT,1848,25,35-39,1873,8.419019660930879
SIM,1905,34,45-49,1939,4
STAT,1888,46,35-39,1934,0.15668502037833842
SIM,1872,21,25-29,1893,56
SIM,1892,21,na,1913,2849
SIM,1866,69,na,1935,1239
STAT,1803,67,na,1870,738.6198358617822
STAT,1814,49,20-24,1863,0.031513207876127415
SIM,1788,70,na,1858,589
STAT,1813,44,35-39,1857,5.79009404464994
SIM,1903,27,40-44,1930,3
STAT,1876,28,50-100,1904,0.6216674558318316
SIM,1821,44,35-39,1865,3
STAT,1858,17,na,1875,1988.5919990444388
STAT,1833,35,50-100,1868,0.9542034705674144
STAT,1867,40,50-100,1907,0.9465287413037343
STAT,1816,93,na,1909,13.61893397668496
STAT,1928,35,30-34,1963,2.17994542422509
SIM,1830,29,50-100,1859,1
STAT,1901,41,20-24,1942,0.01464856356235785
STAT,1920,19,45-49,1939,0.5266459829171624
STAT,1929,33,45-49,1962,1.887183435270407
SIM,1886,20,15-19,1906,3
STAT,1907,4,na,1911,3649.992543946888
SIM,1920,23,30-34,1943,31
STAT,1915,15,20-24,1930,26.927908292268757
STAT,1925,28,35-39,1953,16.695122189721708
SIM,1929,39,25-29,1968,1
STAT,1838,31,25-29,1869,8.771249239202549
STAT,1950,15,45-49,1965,0.558332447486395
SIM,1855,18,na,1873,2204
SIM,1821,38,na,1859,1513
SIM,1938,9,na,1947,3641
SIM,1800,79,na,1879,263
SIM,1933,37,25-29,1970,1
STAT,1880,3,na,1883,3009.577053158085
STAT,1900,69,na,1969,2248.587448483516
SIM,1868,47,na,1915,2024
STAT,1869,57,na,1926,1837.6805275287716
STAT,1885,18,15-19,1903,5.57084275034047
SIM,1898,23,40-44,1921,4
SIM,1820,36,40-44,1856,1
SIM,1943,23,25-29,1966,88
SIM,1887,47,50-100,1934,3
STAT,1874,87,na,1961,284.13064735523807
STAT,1912,23,30-34,1935,25.934602861563917
STAT,1908,25,30-34,1933,35.51997475434589
STAT,1931,39,15-19,1970,0.023975141419095018
STAT,1792,63,na,1855,770.7199999999998
STAT,1841,19,20-24,1860,15.46039759634808
SIM,1839,22,30-34,1861,23
SIM,1841,35,50-100,1876,1
STAT,1796,77,na,1873,365.52058906445467
STAT,1890,23,50-100,1913,0.4695535207181585
STAT,1855,15,25-29,1870,4.830254643484242
STAT,1944,19,50-100,1963,0.3806241000491332
STAT,1882,48,15-19,1930,3.630795589844016E-4
STAT,1925,26,15-19,1951,0.7904983595009378
SIM,1936,35,30-34,1971,6
SIM,1857,84,na,1941,213
SIM,1893,18,15-19,1911,8
STAT,1879,47,50-100,1926,0.24138270922165891
SIM,1900,33,na,1933,3075
STAT,1935,12,na,1947,5116.82852515884
STAT,1935,23,25-29,1958,118.7821276724559
SIM,1893,35,na,1928,2976
SIM,1916,25,30-34,1941,42
SIM,1821,60,na,1881,1035
STAT,1925,37,25-29,1962,1.1165269906209228
STAT,1917,19,40-44,1936,1.4096063461859614
STAT,1832,34,35-39,1866,7.841779747348534
STAT,1838,30,50-100,1868,0.7928162257276021
STAT,1922,13,na,1935,4325.572523584628
SIM,1940,18,25-29,1958,49
STAT,1901,54,na,1955,2768.887904707344
STAT,1902,37,50-100,1939,0.35328091323569694
SIM,1846,30,50-100,1876,3
SIM,1863,15,25-29,1878,5
SIM,1839,36,na,1875,1779
STAT,1880,22,20-24,1902,68.4989102693832
SIM,1917,35,na,1952,3688
STAT,1883,16,na,1899,2344.1187436255477
STAT,1842,20,35-39,1862,5.317417473559841
SIM,1865,28,na,1893,2013
SIM,1868,17,na,1885,2308
STAT,1868,34,15-19,1902,0.12734872685106202
STAT,1903,10,na,1913,3481.4837722854936
SIM,1923,15,20-24,1938,136
STAT,1932,18,25-29,1950,54.06777035597418
SIM,1867,43,na,1910,1993
STAT,1911,61,na,1972,3026.0253525307817
STAT,1822,59,na,1881,1084.9894487096326
STAT,1806,54,45-49,1860,0.039362686112498824
STAT,1827,104,na,1931,0.03701514268887015
STAT,1844,47,40-44,1891,0.119623667741523
STAT,1908,42,15-19,1950,0.0013419105177447468
STAT,1910,44,20-24,1954,0.015569133170211606
STAT,1918,32,30-34,1950,15.815702368469235
SIM,1854,6,na,1860,2335
SIM,1876,19,20-24,1895,11
STAT,1920,30,20-24,1950,2.544374501265362
SIM,1931,24,45-49,1955,1
SIM,1932,25,50-100,1957,1
STAT,1846,40,na,1886,1692.1268012251164
SIM,1780,82,na,1862,143
SIM,1834,59,na,1893,1211
SIM,1925,19,40-44,1944,2
STAT,1864,21,25-29,1885,49.4654842730964
SIM,1892,10,na,1902,3130
STAT,1873,45,45-49,1918,0.22855850272703382
STAT,1835,77,na,1912,539.3199944028161
STAT,1925,13,na,1938,4515.242110196081
SIM,1788,81,na,1869,173
SIM,1902,29,45-49,1931,1
STAT,1796,88,na,1884,50.61701745683664
STAT,1923,24,45-49,1947,1.2291452853784637
STAT,1898,32,35-39,1930,12.950764774181538
STAT,1924,25,45-49,1949,1.913343689378887
STAT,1820,45,35-39,1865,0.23771761016682189
SIM,1867,54,na,1921,1818
STAT,1875,54,50-100,1929,0.014254713006901367
SIM,1884,28,50-100,1912,3
STAT,1839,18,45-49,1857,0.056640967983375
STAT,1870,23,15-19,1893,3.044369635557756
STAT,1874,15,35-39,1889,0.534243863705583
SIM,1932,25,45-49,1957,2
SIM,1923,39,na,1962,4015
STAT,1821,54,40-44,1875,0.014850485772664915
SIM,1834,67,na,1901,975
STAT,1848,95,na,1943,9.578418713389956
STAT,1904,15,45-49,1919,0.08891162536532284
STAT,1951,18,35-39,1969,4.719194688499916
STAT,1946,17,45-49,1963,0.5234315732622645
STAT,1872,28,50-100,1900,0.604422714268211
STAT,1861,69,na,1930,1151.2535337551071
SIM,1953,16,45-49,1969,1
SIM,1845,11,na,1856,2150
STAT,1832,44,45-49,1876,1.0818754175577399
SIM,1857,22,40-44,1879,3
SIM,1819,59,na,1878,1075
SIM,1866,32,35-39,1898,11
STAT,1860,44,na,1904,1750.5245808186646
STAT,1868,39,50-100,1907,1.0962503297985307
SIM,1856,45,50-100,1901,2
SIM,1911,9,na,1920,3781
STAT,1884,57,na,1941,1876.0703597293925
STAT,1883,72,na,1955,1169.2728579784546
STAT,1926,38,25-29,1964,1.1357520796311094
SIM,1888,8,na,1896,2825
STAT,1913,35,40-44,1948,1.4085437454955128
STAT,1871,36,na,1907,2217.0948754690185
STAT,1847,42,30-34,1889,0.8506307388247921
STAT,1850,77,na,1927,608.5340740656939
STAT,1952,19,35-39,1971,4.747417076665369
STAT,1895,49,na,1944,2716.1974284294265
SIM,1908,21,na,1929,3246
STAT,1894,64,na,1958,2183.0315630264104
STAT,1910,15,15-19,1925,8.532156446127857
STAT,1945,16,45-49,1961,0.5156498915467724
STAT,1926,41,25-29,1967,0.08329372835789985
SIM,1845,51,na,1896,1529
STAT,1919,39,50-100,1958,0.42520050158387906
SIM,1928,27,45-49,1955,5
STAT,1869,43,20-24,1912,0.14417541041700035
STAT,1926,38,na,1964,4339.72576905147
STAT,1882,51,45-49,1933,0.013404367032030703
SIM,1946,2,na,1948,4171
STAT,1930,38,45-49,1968,0.8392275642619713
SIM,1970,0,na,1970,4529
SIM,1846,81,na,1927,326
STAT,1884,45,20-24,1929,0.011314160950204042
STAT,1921,17,40-44,1938,1.5063012810930818
STAT,1934,15,30-34,1949,15.646777102611185
STAT,1947,18,15-19,1965,48.28253845653873
SIM,1840,34,35-39,1874,13
STAT,1915,48,20-24,1963,0.01048968309744724
STAT,1879,21,15-19,1900,3.2673970277664495
SIM,1854,25,na,1879,1960
STAT,1839,34,50-100,1873,0.7363638409455153
SIM,1901,23,20-24,1924,87
STAT,1825,47,30-34,1872,0.10149976574596783
STAT,1868,19,20-24,1887,16.089037114065025
STAT,1965,7,na,1972,4634.501084231203
SIM,1908,15,25-29,1923,9
STAT,1904,33,40-44,1937,3.3594659372713056
SIM,1818,74,na,1892,433
SIM,1840,44,45-49,1884,3
SIM,1888,33,25-29,1921,15
STAT,1873,94,na,1967,71.16374021673182
STAT,1910,26,25-29,1936,60.23233491017592
SIM,1960,7,na,1967,4667
STAT,1849,80,na,1929,445.878532942127
STAT,1859,28,50-100,1887,0.487081879004131
STAT,1851,37,30-34,1888,3.950119986367653
STAT,1902,25,na,1927,3203.173991503007
STAT,1918,47,35-39,1965,0.12961019227304493
STAT,1935,27,40-44,1962,6.001912340308089
SIM,1806,49,na,1855,1223
SIM,1887,21,15-19,1908,3
STAT,1913,24,30-34,1937,27.23993952955217
SIM,1877,36,50-100,1913,1
SIM,1908,61,na,1969,2794
STAT,1849,22,40-44,1871,1.8159513896959862
STAT,1861,46,35-39,1907,0.11013855104153984
SIM,1848,19,15-19,1867,3
SIM,1921,24,30-34,1945,36
SIM,1875,30,40-44,1905,5
STAT,1924,45,30-34,1969,0.1007412413438474
SIM,1943,16,30-34,1959,14
STAT,1926,27,na,1953,4242.884841690776
STAT,1879,32,25-29,1911,10.113876109260074
STAT,1919,40,25-29,1959,0.0733079766846909
SIM,1921,35,40-44,1956,1
SIM,1943,27,40-44,1970,6
SIM,1800,90,na,1890,11
STAT,1935,16,30-34,1951,15.779126004668917
SIM,1887,32,25-29,1919,9
STAT,1817,54,20-24,1871,0.0015193813677915663
SIM,1824,89,na,1913,37
STAT,1856,39,na,1895,1725.6290820835468
STAT,1892,38,30-34,1930,6.273654252650846
SIM,1880,17,na,1897,2600
STAT,1949,15,na,1964,4046.560876410613
SIM,1847,77,na,1924,576
SIM,1942,15,30-34,1957,14
STAT,1919,15,35-39,1934,0.8829639834138989
SIM,1917,26,30-34,1943,43
STAT,1895,48,50-100,1943,0.1686446779925161
STAT,1852,50,20-24,1902,5.687075308827376E-4
STAT,1857,54,20-24,1911,5.34453332003844E-4
SIM,1932,35,na,1967,4647
STAT,1919,48,35-39,1967,0.13174059646175232
SIM,1806,60,na,1866,982
SIM,1846,31,25-29,1877,11
SIM,1858,69,na,1927,1171
STAT,1841,47,15-19,1888,2.749170843512177E-4
STAT,1919,26,45-49,1945,1.769481948646384
SIM,1917,37,40-44,1954,2
STAT,1802,109,na,1911,2.427056526270549E-4
STAT,1838,20,15-19,1858,2.961601405175367
STAT,1848,21,40-44,1869,1.8411142349108922
SIM,1904,22,35-39,1926,10
SIM,1912,33,40-44,1945,6
STAT,1902,33,15-19,1935,0.1890493580275335
SIM,1865,31,35-39,1896,8
STAT,1871,50,30-34,1921,0.005654933777046159
SIM,1856,21,40-44,1877,2
SIM,1869,24,25-29,1893,52
STAT,1911,21,na,1932,3428.6160932515227
STAT,1915,35,na,1950,3624.1515595175742
STAT,1912,42,35-39,1954,0.18342789252742944
STAT,1853,104,na,1957,0.0735810073850023
STAT,1914,50,na,1964,3410.381295060465
STAT,1864,80,na,1944,522.2875064758906
SIM,1814,44,35-39,1858,2
SIM,1823,37,50-100,1860,3
SIM,1882,43,na,1925,2088
STAT,1841,49,50-100,1890,0.16452895755859392
SIM,1927,15,35-39,1942,4
STAT,1824,37,na,1861,1511.4241986249413
STAT,1873,35,35-39,1908,6.84669546144524
STAT,1909,26,30-34,1935,35.78885824943149
STAT,1895,33,20-24,1928,3.3182678104130505
STAT,1857,31,35-39,1888,7.667913294263719
STAT,1913,43,35-39,1956,0.18517358436318287
SIM,1866,80,na,1946,480
SIM,1888,13,na,1901,2798
SIM,1867,3,na,1870,2650
STAT,1935,35,35-39,1970,3.2004940035060296
SIM,1892,50,na,1942,2627
SIM,1927,26,45-49,1953,4
SIM,1943,27,na,1970,3653
SIM,1911,21,30-34,1932,28
SIM,1886,20,45-49,1906,3
SIM,1846,20,15-19,1866,6
SIM,1905,23,35-39,1928,11
SIM,1955,4,na,1959,4547
SIM,1868,23,25-29,1891,49
STAT,1868,44,25-29,1912,0.5713926365771488
STAT,1909,37,40-44,1946,1.3382348342371309
SIM,1779,96,na,1875,2
SIM,1947,12,na,1959,4003
STAT,1875,72,na,1947,1225.687523924068
STAT,1813,41,50-100,1854,3.9043555855911887
STAT,1828,42,20-24,1870,0.1400939558985961
STAT,1858,32,35-39,1890,7.510532065232515
STAT,1880,35,35-39,1915,7.097242038779888
SIM,1881,35,35-39,1916,15
STAT,1860,84,na,1944,255.40538389963248
SIM,1813,97,na,1910,5
SIM,1918,38,40-44,1956,1
STAT,1836,70,na,1906,886.025968135511
STAT,1804,60,na,1864,1002.4680952580899
STAT,1897,22,50-100,1919,0.5152086689312937
STAT,1879,36,40-44,1915,4.343291077035934
SIM,1837,53,na,1890,1358
SIM,1905,20,30-34,1925,25
SIM,1890,22,25-29,1912,84
STAT,1820,42,30-34,1862,2.0739312987658534
STAT,1863,29,40-44,1892,2.469777917919497
SIM,1884,55,na,1939,2015
STAT,1892,39,20-24,1931,0.9027414016331897
STAT,1902,44,40-44,1946,0.2054194642901958
SIM,1901,35,30-34,1936,1
STAT,1822,50,40-44,1872,0.014706923833533652
STAT,1903,34,50-100,1937,0.701052881692326
SIM,1818,37,30-34,1855,4
SIM,1919,20,15-19,1939,5
STAT,1936,27,35-39,1963,13.571177583202639
STAT,1879,20,25-29,1899,56.863420656812586
STAT,1942,14,na,1956,3876.3996248281937
SIM,1833,63,na,1896,1126
SIM,1797,61,na,1858,971
SIM,1827,37,40-44,1864,2
SIM,1924,8,na,1932,4481
STAT,1805,53,45-49,1858,0.04149346404849996
SIM,1928,20,25-29,1948,125
STAT,1837,26,35-39,1863,7.874491020110514
STAT,1855,20,na,1875,1794.7592607425443
STAT,1877,28,30-34,1905,24.599348275851224
SIM,1793,71,na,1864,500
SIM,1829,58,na,1887,1117
STAT,1856,20,30-34,1876,15.528599650156293
STAT,1931,18,45-49,1949,0.616083071763202
STAT,1869,2,na,1871,3051.108333190309
SIM,1936,6,na,1942,3023
STAT,1851,30,na,1881,1859.574622880052
STAT,1868,72,na,1940,1139.1022000611702
SIM,1789,66,na,1855,736
SIM,1883,15,15-19,1898,3
SIM,1888,45,na,1933,2474
STAT,1888,43,50-100,1931,1.1704941224042034
STAT,1900,25,20-24,1925,15.479427041709238
STAT,1930,20,15-19,1950,6.480979140685962
STAT,1875,15,15-19,1890,5.7864676132352
STAT,1854,45,35-39,1899,0.10181825612793287
STAT,1894,47,30-34,1941,0.06604563939106245
SIM,1823,31,25-29,1854,11
SIM,1808,64,na,1872,854
STAT,1871,24,15-19,1895,3.0703374227143043
SIM,1885,28,30-34,1913,30
SIM,1918,17,40-44,1935,2
STAT,1843,37,15-19,1880,0.04729535284116539
STAT,1916,28,20-24,1944,17.76673664251175
SIM,1905,64,na,1969,2612
STAT,1872,44,45-49,1916,1.39996224334396
STAT,1916,35,25-29,1951,0.9615439333723925
SIM,1871,35,35-39,1906,15
SIM,1896,29,45-49,1925,1
STAT,1848,48,15-19,1896,2.8454831518580554E-4
STAT,1914,27,15-19,1941,0.672193340585627
STAT,1848,20,50-100,1868,0.36290199027430614
SIM,1861,60,na,1921,1625
STAT,1814,48,45-49,1862,0.6299061328234462
SIM,1887,36,40-44,1923,5
SIM,1924,15,15-19,1939,46
STAT,1856,45,45-49,1901,0.17635581794130975
SIM,1863,37,50-100,1900,1
STAT,1887,31,15-19,1918,0.15106805932338538
STAT,1787,106,na,1893,0.004526256156490797
SIM,1851,17,20-24,1868,19
SIM,1916,29,40-44,1945,5
STAT,1847,42,25-29,1889,0.47512708128755765
STAT,1867,21,45-49,1888,0.6255641823175986
SIM,1859,56,na,1915,1698
STAT,1909,38,30-34,1947,1.621209877281761
SIM,1924,28,20-24,1952,20
STAT,1831,45,40-44,1876,0.12915180828077286
STAT,1825,48,20-24,1873,0.012410573134132014
STAT,1917,13,na,1930,4008.431727664423
STAT,1843,17,20-24,1860,16.34518020600609
STAT,1917,15,na,1932,3944.4372415669677
SIM,1885,40,45-49,1925,1
SIM,1949,16,30-34,1965,13
STAT,1848,32,50-100,1880,0.7697763344264783
SIM,1831,62,na,1893,1113
SIM,1917,38,30-34,1955,2
SIM,1950,18,20-24,1968,130
STAT,1908,29,40-44,1937,4.131809057384575
SIM,1836,93,na,1929,20
SIM,1892,72,na,1964,1710
STAT,1845,34,15-19,1879,0.1168168520406084
STAT,1885,42,na,1927,2172.6130191680195
STAT,1840,78,na,1918,544.1331499815128
STAT,1786,89,na,1875,35.573656265261164
STAT,1927,34,30-34,1961,18.287239017873006
SIM,1871,100,na,1971,9
SIM,1910,28,35-39,1938,15
STAT,1942,18,20-24,1960,133.79612472615358
STAT,1920,37,40-44,1957,1.5484586446999287
STAT,1946,26,na,1972,3944.0505188660413
SIM,1889,42,50-100,1931,1
SIM,1951,17,25-29,1968,58
SIM,1880,44,45-49,1924,2
STAT,1934,19,40-44,1953,1.7776436094413572
STAT,1844,16,25-29,1860,5.086802728499644
SIM,1822,48,45-49,1870,3
SIM,1919,33,35-39,1952,15
STAT,1848,9,na,1857,2175.8098202156975
STAT,1905,28,45-49,1933,1.510400934235176
STAT,1941,29,25-29,1970,64.25444434409103
STAT,1872,24,na,1896,2228.505822468389
SIM,1905,42,na,1947,3145
STAT,1792,95,na,1887,2.384489911878889
STAT,1880,25,25-29,1905,42.332809991295406
STAT,1910,47,25-29,1957,0.04674041799876472
STAT,1852,17,30-34,1869,1.4646319098577334
STAT,1874,25,na,1899,2319.896318070769
SIM,1892,18,20-24,1910,17
STAT,1919,41,15-19,1960,0.0015744189669947273
STAT,1863,16,35-39,1879,0.523026439842999
STAT,1889,49,15-19,1938,2.5765523056737446E-4
STAT,1894,34,25-29,1928,12.340453903334334
SIM,1930,31,na,1961,4557
STAT,1929,31,30-34,1960,18.91779153818057
STAT,1899,49,15-19,1948,2.86008693493861E-4
SIM,1889,33,40-44,1922,6
STAT,1875,34,15-19,1909,0.13702874569163204
STAT,1902,28,35-39,1930,12.818171774533845
STAT,1826,47,25-29,1873,0.05385639908001157
STAT,1943,17,25-29,1960,43.41044667550358
STAT,1866,49,20-24,1915,0.010233641766539264
STAT,1821,38,35-39,1859,13.876287530987804
STAT,1843,44,20-24,1887,0.11498509215128155
STAT,1831,43,45-49,1874,1.124890446110881
STAT,1851,31,35-39,1882,7.810172116779496
STAT,1920,17,30-34,1937,12.919448951991376
SIM,1896,9,na,1905,3314
STAT,1837,39,40-44,1876,3.295341878241486
SIM,1865,19,15-19,1884,5
STAT,1885,50,na,1935,2055.6388911812733
STAT,1876,54,30-34,1930,0.005645615314633109
SIM,1888,67,na,1955,1701
STAT,1827,43,25-29,1870,0.5804726745175555
STAT,1924,22,40-44,1946,3.748462688329875
STAT,1869,17,40-44,1886,0.1695693293581883
STAT,1890,15,40-44,1905,0.21223950862755994
STAT,1820,39,30-34,1859,10.627137346213875
SIM,1806,63,na,1869,874
STAT,1868,70,na,1938,1265.5407091374977
STAT,1882,22,25-29,1904,52.623032521401605
SIM,1942,19,40-44,1961,1
SIM,1913,28,45-49,1941,2
SIM,1831,24,40-44,1855,1
STAT,1844,68,na,1912,1072.8087072899307
SIM,1937,31,30-34,1968,21
STAT,1842,87,na,1929,125.46055339002638
SIM,1890,35,45-49,1925,2
STAT,1877,37,50-100,1914,1.2035770757039468
STAT,1817,80,na,1897,274.3246989916413
SIM,1910,44,40-44,1954,1
STAT,1857,19,15-19,1876,5.133728965349439
SIM,1894,28,40-44,1922,4
STAT,1872,46,40-44,1918,0.16279312592865383
STAT,1884,18,20-24,1902,16.50692648211317
STAT,1886,28,40-44,1914,2.9794200724908735
SIM,1781,78,na,1859,248
STAT,1922,25,40-44,1947,5.016716048516265
SIM,1804,82,na,1886,134
SIM,1823,44,45-49,1867,2
SIM,1930,25,40-44,1955,8
SIM,1889,20,35-39,1909,7
STAT,1895,46,35-39,1941,0.09763265711161757
STAT,1942,25,25-29,1967,65.31484546112145
STAT,1878,15,na,1893,2495.3538861990965
SIM,1844,80,na,1924,380
STAT,1909,15,50-100,1924,0.06971219165238672
SIM,1895,15,na,1910,3224
STAT,1819,37,40-44,1856,11.380492181412185
SIM,1875,94,na,1969,86
SIM,1871,16,35-39,1887,2
STAT,1877,55,na,1932,2027.014714337997
SIM,1821,34,25-29,1855,11
SIM,1861,33,25-29,1894,12
SIM,1842,22,na,1864,1864
SIM,1884,38,25-29,1922,2
SIM,1849,38,30-34,1887,3
SIM,1942,24,20-24,1966,96
SIM,1891,25,na,1916,2961
STAT,1849,38,20-24,1887,0.5626739344876661
SIM,1884,23,na,1907,2297
SIM,1826,83,na,1909,194
STAT,1888,40,20-24,1928,0.17902534121919553
STAT,1869,46,25-29,1915,0.05282110319611907
SIM,1839,34,na,1873,1779
STAT,1846,54,45-49,1900,0.009950921822326568
SIM,1870,17,30-34,1887,1
STAT,1908,30,na,1938,3398.8369210819246
STAT,1835,43,50-100,1878,0.7797496899857181
SIM,1797,93,na,1890,5
SIM,1923,19,15-19,1942,49
STAT,1864,28,45-49,1892,0.9341410852050435
SIM,1833,21,40-44,1854,1
SIM,1945,23,35-39,1968,18
STAT,1915,19,15-19,1934,8.924199825936345
SIM,1842,31,35-39,1873,8
STAT,1886,35,15-19,1921,0.05658153062041429
STAT,1899,29,20-24,1928,15.079145581224623
STAT,1819,61,na,1880,1025.079894989963
STAT,1897,53,na,1950,2676.740445045999
STAT,1951,6,na,1957,4422.609546218699
STAT,1819,44,15-19,1863,0.025355934059908693
STAT,1917,47,na,1964,3624.9169323485257
SIM,1886,24,30-34,1910,21
SIM,1795,80,na,1875,218
SIM,1925,24,20-24,1949,130
STAT,1938,17,na,1955,3429.6416825695314
STAT,1894,1,na,1895,3307.6673010283907
STAT,1850,6,na,1856,2146.1916885059995
STAT,1915,39,25-29,1954,0.9300994654469239
SIM,1904,17,na,1921,3383
SIM,1932,22,40-44,1954,5
STAT,1859,20,40-44,1879,1.8172121399876917
STAT,1878,21,20-24,1899,67.97677621418939
SIM,1888,24,35-39,1912,7
STAT,1838,35,40-44,1873,3.678215665878462
SIM,1906,39,25-29,1945,1
SIM,1855,72,na,1927,931
STAT,1917,24,20-24,1941,110.93954410948041
STAT,1928,40,50-100,1968,0.14188907142977145
STAT,1934,24,20-24,1958,141.06881474504485
SIM,1857,38,20-24,1895,1
STAT,1904,16,35-39,1920,0.7452296414583334
STAT,1859,27,25-29,1886,32.442568280236465
STAT,1878,24,30-34,1902,17.407872004446343
STAT,1860,23,15-19,1883,2.592267260249495
STAT,1871,29,35-39,1900,8.972054190230635
SIM,1912,16,35-39,1928,3
STAT,1904,40,na,1944,3173.840497160692
STAT,1908,49,35-39,1957,0.10948042352637335
SIM,1923,39,25-29,1962,1
STAT,1904,36,45-49,1940,0.5857544350282563
STAT,1770,112,na,1882,5.562094051232195E-4
SIM,1852,16,25-29,1868,7
STAT,1827,88,na,1915,76.18543568325643
SIM,1902,27,30-34,1929,43
STAT,1855,46,40-44,1901,0.12159439032680039
STAT,1925,21,45-49,1946,1.2763346642556934
SIM,1935,34,30-34,1969,25
STAT,1858,38,30-34,1896,3.9329679582444523
STAT,1826,63,na,1889,984.8721357402428
STAT,1834,31,35-39,1865,8.113384562309356
STAT,1841,38,na,1879,1708.7004597704754
SIM,1883,33,50-100,1916,3
STAT,1917,44,15-19,1961,0.0015088818082704186
SIM,1867,27,25-29,1894,47
STAT,1767,96,na,1863,1.06019814498258
STAT,1867,48,25-29,1915,0.05044926426123466
SIM,1862,20,na,1882,2123
STAT,1853,33,25-29,1886,7.741497837173197
SIM,1847,23,35-39,1870,4
SIM,1867,20,40-44,1887,1
SIM,1867,51,na,1918,1872
STAT,1868,27,na,1895,2152.5891519233624
SIM,1897,25,45-49,1922,1
SIM,1916,21,45-49,1937,1
SIM,1846,35,40-44,1881,2
STAT,1877,25,50-100,1902,0.6313557704248016
STAT,1813,49,40-44,1862,0.5005947661107113
STAT,1943,3,na,1946,4028.116664242886
STAT,1826,49,na,1875,1359.1150772553503
STAT,1830,49,40-44,1879,0.12227707635846496
SIM,1816,41,35-39,1857,5
STAT,1858,94,na,1952,14.822267126772173
STAT,1892,32,35-39,1924,11.980387821859773
STAT,1881,39,45-49,1920,1.8000460404598981
STAT,1918,23,25-29,1941,93.82004165044428
SIM,1905,10,na,1915,3536
SIM,1876,26,na,1902,2402
SIM,1884,77,na,1961,918
SIM,1921,20,15-19,1941,3
STAT,1895,36,25-29,1931,3.5665574776828075
STAT,1897,75,na,1972,1746.4093291112488
STAT,1935,31,50-100,1966,1.081171765357381
SIM,1797,95,na,1892,2
SIM,1883,32,35-39,1915,13
STAT,1875,32,35-39,1907,9.828702619976674
STAT,1909,18,na,1927,3567.7777978466042
SIM,1916,34,20-24,1950,2
STAT,1837,26,50-100,1863,0.5220529926926921
STAT,1840,38,45-49,1878,1.6250541930590674
STAT,1831,93,na,1924,17.823546117527822
STAT,1937,23,35-39,1960,8.658083794945025
STAT,1908,21,45-49,1929,0.9799186198085303
SIM,1813,43,na,1856,1373
SIM,1868,38,40-44,1906,5
STAT,1829,102,na,1931,0.1797012121726346
STAT,1889,24,na,1913,2741.0226050364004
STAT,1809,102,na,1911,0.12315767602209667
STAT,1839,99,na,1938,1.2627777030069756
STAT,1850,103,na,1953,0.10103490709644776
STAT,1899,16,15-19,1915,7.701818834068485
SIM,1821,52,na,1873,1268
STAT,1825,41,35-39,1866,2.068379433732313
SIM,1926,23,25-29,1949,107
STAT,1867,28,30-34,1895,22.257733224326
STAT,1889,25,45-49,1914,1.3037005799894477
SIM,1906,32,40-44,1938,6
STAT,1839,23,35-39,1862,4.963494816253978
STAT,1853,46,30-34,1899,0.07199145671043258
SIM,1854,33,na,1887,1892
STAT,1776,79,na,1855,220.11594
STAT,1834,33,15-19,1867,0.1117461641928695
STAT,1896,34,na,1930,2953.877894202216
SIM,1925,39,35-39,1964,4
STAT,1914,20,30-34,1934,26.773001355037273
SIM,1880,20,15-19,1900,3
STAT,1834,50,na,1884,1421.697349782403
STAT,1861,43,30-34,1904,0.8953728586077936
SIM,1793,89,na,1882,30
STAT,1826,41,na,1867,1498.1630649515057
STAT,1839,81,na,1920,360.56668724320224
STAT,1862,39,35-39,1901,5.642263485495119
STAT,1858,2,na,1860,2594.489932469319
STAT,1893,71,na,1964,1835.9775099146345
STAT,1908,34,20-24,1942,2.1559175332637137
SIM,1848,19,na,1867,2092
SIM,1895,34,50-100,1929,6
STAT,1848,50,na,1898,1573.483967531381
SIM,1804,80,na,1884,197
STAT,1917,39,35-39,1956,2.3588122501494913
SIM,1870,39,35-39,1909,10
SIM,1914,25,na,1939,3854
SIM,1845,23,30-34,1868,22
STAT,1891,23,50-100,1914,0.4753586565444619
STAT,1904,30,15-19,1934,0.19448806455600187
STAT,1849,25,15-19,1874,0.39328430427417765
STAT,1860,17,20-24,1877,15.698135664487735
STAT,1864,66,na,1930,1383.83390731724
SIM,1944,24,30-34,1968,34
STAT,1837,23,30-34,1860,14.614162615188887
SIM,1858,37,25-29,1895,2
STAT,1805,50,40-44,1855,0.031977154706143616
SIM,1895,47,na,1942,2790
STAT,1934,36,30-34,1970,2.378104302930672
STAT,1911,23,15-19,1934,4.7534728970791225
STAT,1829,34,30-34,1863,16.178913540837293
STAT,1894,28,30-34,1922,30.49383734757679
STAT,1846,29,40-44,1875,2.518546689007115
SIM,1892,24,15-19,1916,6
STAT,1903,24,35-39,1927,7.793979071982357
SIM,1907,35,25-29,1942,3
SIM,1842,54,na,1896,1426
STAT,1786,104,na,1890,0.032823510968935675
STAT,1877,87,na,1964,343.99158346218536
STAT,1852,34,20-24,1886,2.082666823678101
STAT,1835,37,25-29,1872,2.2209168214655217
STAT,1839,20,30-34,1859,15.481713293064564
STAT,1919,47,45-49,1966,0.22269610031337236
SIM,1901,38,35-39,1939,8
STAT,1809,69,na,1878,751.7358901498509
STAT,1837,45,35-39,1882,0.09412305257213376
STAT,1853,29,50-100,1882,0.4929549265450064
SIM,1925,19,na,1944,4070
STAT,1866,42,35-39,1908,1.575257156261159
STAT,1919,27,35-39,1946,15.324835745502236
SIM,1864,32,25-29,1896,10
STAT,1898,39,15-19,1937,0.015343981553975924
SIM,1927,27,35-39,1954,22
STAT,1897,46,45-49,1943,0.16866799394828796
STAT,1872,41,40-44,1913,2.142418809758515
SIM,1853,49,na,1902,1764
SIM,1868,90,na,1958,89
STAT,1853,52,50-100,1905,0.01114069228736566
STAT,1840,24,50-100,1864,0.3559858510301085
STAT,1828,45,25-29,1873,0.049816616252237905
STAT,1864,35,50-100,1899,1.0464411123284205
SIM,1874,42,35-39,1916,1
SIM,1817,55,na,1872,1230
SIM,1909,23,25-29,1932,96
STAT,1856,23,35-39,1879,4.978526756580773
STAT,1856,32,25-29,1888,7.671226744539873
STAT,1858,31,45-49,1889,1.3067691058027726
SIM,1837,34,30-34,1871,24
STAT,1871,9,na,1880,2523.579458927305
SIM,1911,24,35-39,1935,11
SIM,1936,28,na,1964,2783
SIM,1859,44,25-29,1903,3
SIM,1918,31,20-24,1949,2
STAT,1884,24,15-19,1908,3.0604900713448844
SIM,1813,94,na,1907,11
STAT,1898,20,35-39,1918,7.507095020867507
STAT,1843,19,na,1862,2091.47278449506
SIM,1900,18,25-29,1918,8
SIM,1941,15,15-19,1956,36
STAT,1891,36,50-100,1927,1.44251752918847
STAT,1932,39,50-100,1971,0.5317951340563832
STAT,1900,28,25-29,1928,55.244651061691236
SIM,1843,41,na,1884,1686
SIM,1846,38,45-49,1884,2
STAT,1770,110,na,1880,0.00141631716626355
SIM,1953,17,35-39,1970,7
SIM,1929,35,45-49,1964,1
STAT,1924,17,na,1941,4141.148819435958
SIM,1853,91,na,1944,35
STAT,1839,67,na,1906,1056.9790301321432
SIM,1860,34,20-24,1894,2
SIM,1885,34,25-29,1919,11
STAT,1873,20,30-34,1893,17.18225769762394
SIM,1843,37,25-29,1880,6
SIM,1877,53,na,1930,2084
STAT,1897,21,na,1918,2997.059901625317
STAT,1877,34,25-29,1911,9.955031896775434
SIM,1857,42,35-39,1899,4
SIM,1933,21,45-49,1954,2
STAT,1841,71,na,1912,913.2593388770239
SIM,1819,99,na,1918,1
SIM,1863,48,50-100,1911,2
STAT,1858,48,15-19,1906,2.929241586844919E-4
STAT,1901,29,30-34,1930,33.05971262398363
STAT,1943,29,35-39,1972,15.089683837174766
SIM,1861,27,30-34,1888,27
SIM,1877,75,na,1952,945
SIM,1847,85,na,1932,167
STAT,1848,24,45-49,1872,0.6029308599122691
STAT,1849,44,15-19,1893,0.009819638234372681
STAT,1794,76,na,1870,355.30519973007154
STAT,1826,44,20-24,1870,0.15074548238203728
STAT,1924,29,25-29,1953,71.88773599021442
STAT,1908,46,30-34,1954,0.07671805625526026
STAT,1762,101,na,1863,0.024723047118777843
SIM,1934,17,25-29,1951,65
STAT,1817,53,50-100,1870,0.031724743382893765
STAT,1838,38,45-49,1876,1.6236608413099454
STAT,1842,27,15-19,1869,0.39954574367420503
STAT,1862,34,15-19,1896,0.11377498335176288
STAT,1920,32,50-100,1952,0.8555796870443863
STAT,1867,23,na,1890,2091.317053265658
SIM,1866,28,20-24,1894,13
STAT,1864,39,45-49,1903,1.666182406040217
STAT,1939,16,na,1955,3481.164791836778
STAT,1858,28,20-24,1886,8.842602881366613
SIM,1851,39,na,1890,1729
SIM,1842,27,20-24,1869,7
STAT,1853,27,30-34,1880,21.634262520262233
STAT,1833,53,20-24,1886,4.5367192007600703E-4
STAT,1834,36,na,1870,1666.1608741851487
SIM,1893,17,25-29,1910,13
STAT,1905,44,na,1949,3123.3617537974915
STAT,1933,15,15-19,1948,57.65928004519057
STAT,1941,26,20-24,1967,17.845367394997098
SIM,1811,93,na,1904,8
STAT,1834,27,20-24,1861,9.522069900173872
STAT,1826,43,50-100,1869,1.0215613291416128
SIM,1854,29,40-44,1883,2
STAT,1876,38,25-29,1914,2.794025144960604
SIM,1822,79,na,1901,361
STAT,1885,17,25-29,1902,5.333407852591983
SIM,1872,52,na,1924,2036
SIM,1931,17,15-19,1948,44
STAT,1864,25,40-44,1889,2.5562200073569405
STAT,1928,20,15-19,1948,6.316769902653674
SIM,1834,43,50-100,1877,5
SIM,1862,35,25-29,1897,1
STAT,1805,79,na,1884,290.6712866845251
STAT,1931,27,15-19,1958,0.8610282897567798
SIM,1772,87,na,1859,32
SIM,1921,40,na,1961,3866
STAT,1923,17,15-19,1940,50.34794365698092
STAT,1886,16,50-100,1902,0.04902007657086508
SIM,1918,34,30-34,1952,15
STAT,1822,53,45-49,1875,0.019098665628951992
STAT,1860,21,35-39,1881,4.651894443878619
STAT,1809,47,25-29,1856,0.2101132914090395
STAT,1844,60,na,1904,1338.8576393402948
STAT,1854,39,40-44,1893,3.1204888650719
SIM,1864,57,na,1921,1788
STAT,1878,41,15-19,1919,0.01364276400865696
STAT,1941,22,40-44,1963,3.2822928918063417
SIM,1871,88,na,1959,200
STAT,1819,93,na,1912,14.594781367541787
STAT,1831,40,40-44,1871,1.7592160261501044
STAT,1854,35,25-29,1889,2.1050169633919698
STAT,1922,16,na,1938,4034.3694788399507
SIM,1936,20,15-19,1956,3
SIM,1932,29,25-29,1961,77
STAT,1893,35,20-24,1928,0.9327267041792628
SIM,1789,98,na,1887,1
SIM,1872,25,40-44,1897,7
SIM,1800,76,na,1876,357
SIM,1951,17,na,1968,4090
STAT,1926,17,25-29,1943,50.19839120811028
STAT,1829,30,15-19,1859,0.1466246219655084
SIM,1947,20,35-39,1967,13
SIM,1838,28,45-49,1866,4
STAT,1880,0,na,1880,3584.411410435153
SIM,1819,81,na,1900,231
SIM,1926,35,35-39,1961,3
SIM,1875,28,30-34,1903,28
SIM,1908,27,25-29,1935,63
STAT,1850,37,15-19,1887,0.040158967684875146
STAT,1806,94,na,1900,6.650337694844369
SIM,1940,19,15-19,1959,37
STAT,1875,28,20-24,1903,11.345741455026387
SIM,1886,27,35-39,1913,20
STAT,1934,27,25-29,1961,83.64542548686714
SIM,1888,21,30-34,1909,22
STAT,1801,107,na,1908,0.0017945128673415717
STAT,1815,44,45-49,1859,3.829770720027776
STAT,1884,38,15-19,1922,0.052162498183299696
STAT,1936,21,20-24,1957,100.4432917464586
STAT,1775,109,na,1884,0.002850920104012713
SIM,1855,30,30-34,1885,28
STAT,1932,19,15-19,1951,56.46742112793677
SIM,1859,22,15-19,1881,1
STAT,1854,20,20-24,1874,59.15223211416851
SIM,1942,27,25-29,1969,63
STAT,1859,24,20-24,1883,53.13359247229385
SIM,1849,19,30-34,1868,2
STAT,1863,30,15-19,1893,0.1192078354838288
STAT,1838,52,25-29,1890,0.002402929940682921
SIM,1904,35,40-44,1939,1
STAT,1935,28,30-34,1963,50.430240462420294
SIM,1862,76,na,1938,783
STAT,1882,35,45-49,1917,1.8499163908542198
SIM,1890,25,35-39,1915,15
SIM,1904,15,na,1919,3393
STAT,1925,25,25-29,1950,73.94917472541725
SIM,1944,21,20-24,1965,114
STAT,1831,95,na,1926,8.10848412933467
STAT,1896,21,15-19,1917,4.131373192817499
STAT,1947,20,25-29,1967,98.69464691296722
STAT,1866,22,40-44,1888,1.8297941047442408
STAT,1878,27,35-39,1905,9.489263038329197
STAT,1878,46,35-39,1924,0.1380742622782
STAT,1914,58,na,1972,3264.6028502906915
SIM,1874,22,40-44,1896,2
STAT,1862,51,25-29,1913,0.0028679446698103494
SIM,1853,17,30-34,1870,1
SIM,1837,21,na,1858,1761
SIM,1859,88,na,1947,119
STAT,1897,19,45-49,1916,0.08208686795727134
SIM,1886,36,na,1922,2304
STAT,1810,49,50-100,1859,0.8442382916804377
SIM,1833,31,na,1864,1686
STAT,1880,51,40-44,1931,0.010514535497233168
SIM,1791,90,na,1881,24
STAT,1774,90,na,1864,26.637145171902958
STAT,1901,17,20-24,1918,23.442205787959054
SIM,1828,39,40-44,1867,5
SIM,1914,28,50-100,1942,4
STAT,1930,26,45-49,1956,2.0762843296294418
STAT,1939,20,35-39,1959,8.938417834049412
STAT,1918,35,35-39,1953,2.431231740948556
SIM,1810,54,na,1864,1169
STAT,1890,18,45-49,1908,0.07525158076635474
SIM,1863,20,15-19,1883,3
SIM,1876,38,30-34,1914,5
SIM,1933,25,25-29,1958,83
STAT,1913,31,na,1944,3568.463679753118
STAT,1845,27,40-44,1872,2.5682700094088555
SIM,1871,37,na,1908,2277
SIM,1887,20,25-29,1907,56
STAT,1828,49,40-44,1877,0.14044154437614345
SIM,1831,27,45-49,1858,1
STAT,1823,107,na,1930,0.002481714533836793
SIM,1819,36,35-39,1855,8
STAT,1818,97,na,1915,2.5900843597427134
STAT,1945,17,35-39,1962,4.330247082739668
STAT,1803,51,50-100,1854,0.04416507355277224
STAT,1877,40,45-49,1917,1.4819861703506643
STAT,1882,25,35-39,1907,8.929953638091334
STAT,1774,110,na,1884,0.0018393657444835839
STAT,1915,36,20-24,1951,0.2527584194835777
SIM,1930,28,50-100,1958,2
SIM,1883,28,20-24,1911,10
STAT,1862,43,50-100,1905,0.84517908872722
STAT,1899,32,45-49,1931,2.2575757013912767
STAT,1849,42,35-39,1891,1.3036110284590035
SIM,1937,8,na,1945,3528
STAT,1868,38,30-34,1906,4.783313260835401
SIM,1897,28,na,1925,3062
STAT,1928,16,45-49,1944,0.5961432789849144
STAT,1841,21,25-29,1862,49.975571183655596
STAT,1903,46,50-100,1949,0.1867294566740372
SIM,1875,6,na,1881,2647
SIM,1783,79,na,1862,260
STAT,1859,23,45-49,1882,0.5415440606330005
STAT,1906,24,45-49,1930,0.9532368521420552
STAT,1854,24,50-100,1878,0.3400887349156536
STAT,1843,47,25-29,1890,0.041362094518915406
STAT,1881,38,na,1919,2138.331393674792
STAT,1790,86,na,1876,67.39060144711591
STAT,1859,36,na,1895,1784.7781027093572
STAT,1871,90,na,1961,139.1288453547118
STAT,1824,49,50-100,1873,0.2805711622691402
SIM,1925,15,30-34,1940,23
SIM,1866,31,45-49,1897,1
STAT,1927,37,35-39,1964,2.841226538748821
STAT,1855,48,50-100,1903,0.17175735653188978
STAT,1871,17,40-44,1888,0.1724029585914274
SIM,1870,43,50-100,1913,1
SIM,1827,27,30-34,1854,26
SIM,1828,35,50-100,1863,4
SIM,1830,34,35-39,1864,7
SIM,1851,82,na,1933,283
STAT,1861,27,25-29,1888,33.425569693584286
STAT,1925,10,na,1935,4535.939797783703
SIM,1888,42,50-100,1930,1
SIM,1878,36,50-100,1914,3
SIM,1894,18,30-34,1912,3
SIM,1912,44,na,1956,3200
SIM,1943,28,30-34,1971,42
STAT,1836,49,35-39,1885,0.09018056144885774
SIM,1880,41,40-44,1921,5
STAT,1841,34,45-49,1875,1.4178438164785143
SIM,1862,74,na,1936,925
SIM,1944,15,na,1959,3728
STAT,1801,63,na,1864,899.0710624978481
STAT,1828,30,20-24,1858,3.1312443032153303
STAT,1933,37,50-100,1970,0.5402483468360372
SIM,1775,92,na,1867,8
STAT,1837,40,15-19,1877,0.010554030212514847
STAT,1822,34,35-39,1856,22.377070649625598
STAT,1864,88,na,1952,115.91001297778563
SIM,1847,20,30-34,1867,14
SIM,1916,5,na,1921,3930
SIM,1823,34,35-39,1857,8
STAT,1908,37,25-29,1945,0.8706698293515749
SIM,1845,26,35-39,1871,8
STAT,1847,30,30-34,1877,15.400142567332944
STAT,1886,18,30-34,1904,1.5867114831247604
SIM,1867,24,20-24,1891,50
STAT,1867,45,20-24,1912,0.010750122359328203
SIM,1907,15,15-19,1922,9
STAT,1817,47,15-19,1864,8.94958406721226E-4
STAT,1917,15,30-34,1932,2.4892709596015083
SIM,1912,8,na,1920,3649
STAT,1906,28,50-100,1934,0.8768691626324786
STAT,1851,48,na,1899,1629.1148575482187
STAT,1919,28,na,1947,3810.3597142244166
SIM,1939,20,40-44,1959,2
SIM,1921,29,na,1950,3776
STAT,1876,28,15-19,1904,0.44091833616117815
STAT,1891,38,15-19,1929,0.06533622367189908
SIM,1949,19,35-39,1968,7
STAT,1810,48,na,1858,1309.0576961672864
STAT,1950,19,25-29,1969,48.37725318503204
SIM,1916,37,25-29,1953,1
SIM,1901,52,na,1953,2857
STAT,1893,18,30-34,1911,1.9054320965304428
STAT,1827,37,30-34,1864,5.326413515712893
STAT,1851,38,20-24,1889,0.565427775134256
SIM,1887,39,45-49,1926,1
SIM,1929,30,25-29,1959,15
STAT,1824,47,15-19,1871,4.7006180026575896E-4
STAT,1874,54,20-24,1928,6.928915827611948E-4
STAT,1862,22,na,1884,1950.9929462665016
SIM,1903,23,30-34,1926,33
STAT,1924,46,15-19,1970,4.1536577893013844E-4
STAT,1883,28,15-19,1911,0.4185896197776346
STAT,1907,25,15-19,1932,0.6337680376559145
SIM,1836,30,20-24,1866,3
SIM,1879,29,45-49,1908,4
STAT,1864,48,50-100,1912,0.20475720343596057
SIM,1834,27,30-34,1861,27
STAT,1812,45,30-34,1857,0.3290722540352202
SIM,1927,43,na,1970,4324
STAT,1879,39,45-49,1918,1.9486213271310495
STAT,1897,33,25-29,1930,12.886054099092066
SIM,1835,37,30-34,1872,11
SIM,1865,50,na,1915,1858
STAT,1848,22,30-34,1870,15.624746040232267
SIM,1843,39,na,1882,1721
SIM,1882,19,15-19,1901,4
SIM,1881,66,na,1947,1371
STAT,1922,15,50-100,1937,0.4115461108052446
STAT,1908,19,na,1927,3519.476214711297
SIM,1847,19,20-24,1866,15
STAT,1902,21,50-100,1923,0.5452863419869969
SIM,1871,59,na,1930,1817
STAT,1853,74,na,1927,823.0278989180641
STAT,1928,16,50-100,1944,0.4471074592386857
STAT,1939,22,50-100,1961,0.6241965362046347
STAT,1921,7,na,1928,4304.791376854809
STAT,1878,24,25-29,1902,55.945903886094406
STAT,1933,21,50-100,1954,0.8270237536056387
STAT,1853,49,35-39,1902,0.10165730791050383
SIM,1920,27,40-44,1947,5
STAT,1835,34,20-24,1869,2.103037781525094
STAT,1881,2,na,1883,2909.225626748992
STAT,1846,34,30-34,1880,14.248777585242582
SIM,1826,69,na,1895,770
SIM,1900,27,20-24,1927,14
STAT,1860,27,30-34,1887,19.540801030916967
STAT,1881,51,35-39,1932,0.007890273684013172
SIM,1858,30,40-44,1888,2
SIM,1927,11,na,1938,4584
SIM,1938,24,40-44,1962,3
STAT,1865,29,15-19,1894,0.3866949251666226
STAT,1916,31,45-49,1947,1.5409724080941376
STAT,1808,84,na,1892,129.3012902436197
STAT,1895,21,20-24,1916,85.21179531702988
SIM,1885,37,50-100,1922,3
STAT,1917,36,30-34,1953,1.7968786771501752
SIM,1902,23,15-19,1925,3
STAT,1850,24,45-49,1874,0.5807922802008474
STAT,1912,27,40-44,1939,4.338221490500281
SIM,1906,41,na,1947,3257
SIM,1850,51,na,1901,1592
SIM,1843,34,20-24,1877,2
SIM,1873,30,50-100,1903,3
STAT,1804,94,na,1898,6.7728644477075886
STAT,1831,61,na,1892,1139.6155224475938
STAT,1835,30,50-100,1865,0.7430907378850877
SIM,1831,35,40-44,1866,3
STAT,1789,75,na,1864,362.18617311771436
SIM,1900,15,20-24,1915,23
STAT,1877,45,15-19,1922,3.960357937087684E-4
STAT,1957,10,na,1967,4893.213840870833
SIM,1925,36,30-34,1961,2
SIM,1875,49,na,1924,2104
STAT,1847,57,na,1904,1478.6637820977066
STAT,1919,24,30-34,1943,29.545365295505064
STAT,1944,25,35-39,1969,15.34226498558596
STAT,1950,16,20-24,1966,151.49357385098236
SIM,1899,51,na,1950,2794
STAT,1931,20,30-34,1951,35.426028191076796
SIM,1929,20,40-44,1949,6
STAT,1893,47,15-19,1940,2.691866333350471E-4
STAT,1886,66,na,1952,1635.9356109246592
STAT,1912,38,na,1950,3450.8742173017963
STAT,1824,34,45-49,1858,3.132567486489589
STAT,1858,34,15-19,1892,0.10470952557704276
STAT,1883,19,na,1902,2325.835423445224
STAT,1873,15,40-44,1888,0.17747172576578044
SIM,1891,22,40-44,1913,2
SIM,1897,41,na,1938,2991
STAT,1930,1,na,1931,5100.690882042609
STAT,1908,3,na,1911,3703.8235307684004
SIM,1927,24,30-34,1951,36
SIM,1845,35,25-29,1880,5
STAT,1857,64,na,1921,1294.6437774685323
STAT,1950,16,50-100,1966,0.4186446482808926
STAT,1783,109,na,1892,0.001023967019539183
STAT,1875,41,50-100,1916,1.0299660863304922
STAT,1895,27,50-100,1922,0.7886126404989012
STAT,1903,63,na,1966,2630.447082922701
STAT,1872,24,30-34,1896,16.78391579991012
SIM,1872,36,40-44,1908,5
STAT,1951,15,25-29,1966,48.77837207334445
STAT,1857,86,na,1943,165.24246009967993
SIM,1835,97,na,1932,2
SIM,1925,33,na,1958,4157
SIM,1932,26,20-24,1958,27
STAT,1946,26,40-44,1972,4.9072751538462605
SIM,1806,95,na,1901,3
STAT,1883,22,40-44,1905,1.9293300699120244
STAT,1939,19,25-29,1958,40.94635820416233
STAT,1900,21,40-44,1921,2.7392632212206833
STAT,1942,21,45-49,1963,1.1147992122043817
SIM,1826,102,na,1928,1
STAT,1837,35,25-29,1872,2.2593516420856177
STAT,1840,21,na,1861,1907.294839837618
STAT,1853,96,na,1949,6.367932480677767
STAT,1795,60,na,1855,928.42933
STAT,1853,24,20-24,1877,59.519943633935085
SIM,1950,21,45-49,1971,2
STAT,1857,35,45-49,1892,1.498750679877642
SIM,1861,24,20-24,1885,56
STAT,1834,39,na,1873,1615.058094662449
STAT,1855,52,na,1907,1516.8344731704028
STAT,1875,33,50-100,1908,0.8854985073705063
STAT,1787,97,na,1884,0.9475523776862751
SIM,1873,37,na,1910,2259
STAT,1899,35,15-19,1934,0.07338887814380146
SIM,1934,20,50-100,1954,3
STAT,1783,84,na,1867,86.09624655923002
STAT,1847,25,40-44,1872,2.687674640583219
STAT,1849,48,30-34,1897,0.06889585776130361
SIM,1862,20,20-24,1882,60
STAT,1906,29,na,1935,3259.459324564519
STAT,1873,23,35-39,1896,5.578399748493815
SIM,1845,23,25-29,1868,57
SIM,1899,25,50-100,1924,4
STAT,1837,23,25-29,1860,46.96740284144312
STAT,1839,19,20-24,1858,15.281818590488726
STAT,1836,33,25-29,1869,8.091277536077879
STAT,1821,33,15-19,1854,0.4475072228008512
STAT,1912,20,20-24,1932,101.24779534478998
STAT,1930,34,50-100,1964,1.006748612315505
STAT,1913,26,45-49,1939,1.631409217576833
SIM,1879,34,35-39,1913,9
SIM,1860,19,na,1879,2217
STAT,1924,26,20-24,1950,20.149049100871107
STAT,1854,46,25-29,1900,0.041595189210297145
STAT,1887,36,35-39,1923,7.508482572748384
STAT,1864,37,na,1901,1989.1768829257974
STAT,1841,24,35-39,1865,4.985442464434916
STAT,1842,34,na,1876,1826.0591515010728
SIM,1876,17,25-29,1893,8
SIM,1866,38,30-34,1904,4
SIM,1899,31,40-44,1930,8
STAT,1868,17,25-29,1885,5.203802542826516
STAT,1789,78,na,1867,272.5462744396959
STAT,1804,62,na,1866,930.4302968468813
STAT,1864,36,40-44,1900,3.7137616611860347
STAT,1832,27,na,1859,1728.2084278705686
SIM,1895,36,35-39,1931,18
SIM,1952,17,40-44,1969,1
SIM,1921,26,45-49,1947,6
STAT,1871,43,20-24,1914,0.1476608744601587
STAT,1944,17,40-44,1961,1.4219495326628946
STAT,1827,34,20-24,1861,2.888673669980119
STAT,1856,37,na,1893,1743.1733464520842
STAT,1877,24,15-19,1901,3.2138433049959514
STAT,1853,44,15-19,1897,0.010103237079356724
SIM,1920,20,20-24,1940,116
STAT,1778,80,na,1858,209.4430422031392
STAT,1922,48,na,1970,3976.2712611261395
STAT,1926,45,50-100,1971,0.26491544379859006
SIM,1828,42,na,1870,1439
STAT,1900,44,30-34,1944,0.1032190085597296
STAT,1836,44,15-19,1880,0.010111958166501053
STAT,1911,27,30-34,1938,36.09002265331296
SIM,1904,26,45-49,1930,1
SIM,1855,25,40-44,1880,3
SIM,1844,33,25-29,1877,11
SIM,1850,24,45-49,1874,1
SIM,1830,24,25-29,1854,49
SIM,1895,35,30-34,1930,10
SIM,1903,20,20-24,1923,89
SIM,1908,24,20-24,1932,99
SIM,1838,25,40-44,1863,6
SIM,1840,29,20-24,1869,10
STAT,1865,35,45-49,1900,1.7275507728752146
STAT,1915,32,40-44,1947,3.7647919574645843
STAT,1894,25,20-24,1919,14.353016724842114
STAT,1905,2,na,1907,3639.0401158495756
SIM,1885,24,15-19,1909,3
SIM,1928,23,35-39,1951,14
STAT,1843,23,15-19,1866,2.966060597049353
SIM,1864,35,35-39,1899,14
SIM,1919,24,30-34,1943,34
STAT,1888,47,na,1935,2499.1394630111436
STAT,1872,49,45-49,1921,0.21910347729505544
STAT,1920,44,50-100,1964,0.12217144855469214
STAT,1863,54,45-49,1917,0.011719902788140052
STAT,1897,24,35-39,1921,7.326481211838906
SIM,1824,35,na,1859,1558
STAT,1812,48,35-39,1860,0.45323053639394956
STAT,1928,39,na,1967,4482.556509402059
STAT,1836,46,30-34,1882,0.06479663235934245
STAT,1921,30,15-19,1951,0.13619418839835856
STAT,1871,93,na,1964,75.76265116520719
STAT,1876,20,40-44,1896,2.0443713541103254
STAT,1932,32,40-44,1964,4.914596597894829
STAT,1902,25,30-34,1927,33.79896117053442
SIM,1925,30,na,1955,4156
SIM,1890,44,35-39,1934,4
SIM,1924,19,30-34,1943,16
STAT,1882,85,na,1967,501.6835175157451
STAT,1847,46,40-44,1893,0.12632466924274496
STAT,1947,25,45-49,1972,1.848119208799034
STAT,1893,2,na,1895,3195.1026941139166
STAT,1900,13,na,1913,3379.363266743228
STAT,1879,11,na,1890,2553.8576076148493
SIM,1913,30,30-34,1943,23
STAT,1897,36,35-39,1933,8.979047306167278
STAT,1843,64,na,1907,1254.148041660271
SIM,1911,19,na,1930,3661
SIM,1838,33,35-39,1871,10
STAT,1872,25,35-39,1897,9.211206939359858
SIM,1817,87,na,1904,88
STAT,1880,54,45-49,1934,0.014028629976690792
SIM,1841,91,na,1932,24
STAT,1897,16,40-44,1913,0.23165007712168997
STAT,1853,71,na,1924,989.8985905458966
SIM,1827,49,50-100,1876,2
STAT,1842,24,45-49,1866,0.6173612099700339
STAT,1819,90,na,1909,39.37195342196421
SIM,1869,20,15-19,1889,3
SIM,1835,34,20-24,1869,2
SIM,1885,38,40-44,1923,5
SIM,1903,3,na,1906,3505
SIM,1910,25,30-34,1935,39
STAT,1916,19,30-34,1935,2.429828985199301
STAT,1909,34,15-19,1943,0.11482431468625558
STAT,1887,35,30-34,1922,5.684155652243218
STAT,1882,44,35-39,1926,1.6421218458685631
SIM,1802,59,na,1861,1011
STAT,1846,35,35-39,1881,5.317030009584472
SIM,1869,36,25-29,1905,5
STAT,1815,57,na,1872,1090.4649609317976
SIM,1824,31,40-44,1855,5
SIM,1864,23,35-39,1887,4
STAT,1798,57,na,1855,1016.66443
STAT,1863,35,35-39,1898,5.929230929649358
SIM,1844,23,15-19,1867,5
STAT,1837,39,50-100,1876,0.9242329058375366
SIM,1915,3,na,1918,3908
STAT,1867,77,na,1944,766.7162502934738
SIM,1934,22,15-19,1956,6
SIM,1880,22,30-34,1902,26
SIM,1854,79,na,1933,463
SIM,1899,22,na,1921,3051
SIM,1869,27,35-39,1896,11
STAT,1811,49,30-34,1860,0.3114011719956546
SIM,1879,26,40-44,1905,4
STAT,1906,29,15-19,1935,0.6196566408705296
SIM,1829,35,40-44,1864,3
SIM,1881,32,25-29,1913,13
STAT,1811,52,30-34,1863,0.01890130940682453
SIM,1886,36,25-29,1922,6
SIM,1784,106,na,1890,1
STAT,1912,47,35-39,1959,0.11702729988502643
STAT,1917,18,35-39,1935,0.8507641033295208
SIM,1919,48,na,1967,3760
SIM,1925,18,35-39,1943,5
STAT,1939,16,20-24,1955,128.22369465264077
STAT,1877,84,na,1961,487.54392058777574
STAT,1862,36,30-34,1898,4.315446394907008
SIM,1851,23,15-19,1874,6
SIM,1864,86,na,1950,167
STAT,1897,30,20-24,1927,3.442536899595668
STAT,1924,26,na,1950,4135.075666210314
STAT,1898,15,45-49,1913,0.08392429996951212
STAT,1905,30,30-34,1935,24.026818803279507
STAT,1910,18,40-44,1928,0.2610594750061074
STAT,1920,33,na,1953,3897.21550496382
STAT,1894,45,15-19,1939,2.7692753747075974E-4
STAT,1828,75,na,1903,584.4014296452182
STAT,1927,34,25-29,1961,10.728063303253963
SIM,1870,23,25-29,1893,57
STAT,1856,35,35-39,1891,5.282912531765597
SIM,1947,16,20-24,1963,138
STAT,1896,76,na,1972,1638.490969132363
SIM,1854,35,35-39,1889,17
SIM,1928,36,40-44,1964,2
STAT,1852,46,15-19,1898,3.0477153630348894E-4
SIM,1923,32,40-44,1955,6
STAT,1852,53,30-34,1905,0.0044499675876852945
STAT,1858,49,na,1907,1633.7105264527468
STAT,1831,48,45-49,1879,0.1712992657882637
SIM,1854,34,30-34,1888,20
SIM,1865,43,50-100,1908,1
SIM,1879,31,50-100,1910,1
STAT,1888,25,na,1913,2681.453444010229
SIM,1825,84,na,1909,132
STAT,1841,28,50-100,1869,0.5397067872332361
STAT,1868,35,20-24,1903,0.7018912269512202
STAT,1832,29,20-24,1861,9.410337230351404
STAT,1854,27,na,1881,1801.5708928206413
SIM,1875,27,na,1902,2294
STAT,1926,34,15-19,1960,0.1466183370117042
STAT,1862,23,25-29,1885,46.884398176265144
STAT,1916,30,na,1946,3718.2696281493277
STAT,1886,69,na,1955,1464.790497516817
SIM,1943,24,15-19,1967,5
SIM,1835,21,15-19,1856,3
SIM,1924,31,45-49,1955,2
SIM,1834,23,15-19,1857,2
STAT,1838,82,na,1920,318.220563875439
STAT,1936,24,30-34,1960,25.93605081453468
SIM,1883,78,na,1961,922
SIM,1899,54,na,1953,2692
SIM,1869,43,30-34,1912,1
SIM,1896,26,40-44,1922,2
STAT,1888,26,40-44,1914,3.3545523027048274
STAT,1873,46,50-100,1919,0.23617653543319972
SIM,1824,57,na,1881,1129
STAT,1861,24,20-24,1885,54.74352655782459
STAT,1806,72,na,1878,550.7996985146157
STAT,1878,36,25-29,1914,2.8451821559853325
SIM,1886,24,25-29,1910,58
SIM,1922,20,30-34,1942,41
SIM,1937,5,na,1942,3562
STAT,1864,34,na,1898,1997.5382949422312
STAT,1926,22,15-19,1948,6.110073178852516
SIM,1855,33,35-39,1888,9
SIM,1849,15,15-19,1864,5
STAT,1906,42,40-44,1948,0.2145978030397613
STAT,1919,18,50-100,1937,0.3901021035250758
SIM,1882,11,na,1893,2370
STAT,1906,49,50-100,1955,0.18659623461290434
SIM,1907,39,40-44,1946,1
SIM,1952,10,na,1962,4396
STAT,1847,33,35-39,1880,8.658494573361088
STAT,1898,36,45-49,1934,2.5615945293863236
STAT,1820,87,na,1907,93.85756788508141
STAT,1900,40,15-19,1940,0.0012695148417588298
SIM,1830,28,40-44,1858,3
STAT,1928,37,50-100,1965,0.5013125114715081
STAT,1877,47,30-34,1924,0.09445227966902471
STAT,1908,43,50-100,1951,0.10204021022338997
SIM,1844,37,40-44,1881,4
SIM,1853,2,na,1855,2752
STAT,1891,15,35-39,1906,0.6445903015984855
STAT,1931,23,35-39,1954,11.50143073331776
SIM,1823,72,na,1895,655
SIM,1886,21,20-24,1907,62
STAT,1811,73,na,1884,534.7653526844537
STAT,1927,17,40-44,1944,1.6431311534074795
STAT,1866,19,50-100,1885,0.04328428571972736
SIM,1896,11,na,1907,3305
SIM,1832,24,35-39,1856,4
SIM,1826,61,na,1887,1049
STAT,1865,22,30-34,1887,15.476735812522053
SIM,1945,20,25-29,1965,90
STAT,1841,43,35-39,1884,1.2710285670144648
STAT,1916,30,50-100,1946,0.8128498350148605
SIM,1836,33,25-29,1869,9
SIM,1907,31,45-49,1938,2
STAT,1925,29,40-44,1954,5.164227768051872
SIM,1873,22,30-34,1895,30
SIM,1934,1,na,1935,5169
SIM,1866,15,15-19,1881,5
STAT,1887,33,30-34,1920,18.368288056466064
STAT,1842,48,20-24,1890,0.008437978712523712
SIM,1881,46,50-100,1927,2
SIM,1813,65,na,1878,822
STAT,1814,45,40-44,1859,0.47979346429423836
SIM,1903,26,35-39,1929,19
SIM,1838,21,25-29,1859,52
SIM,1837,24,na,1861,1756
STAT,1848,41,na,1889,1684.4647760221308
STAT,1888,47,40-44,1935,0.19017020250512792
SIM,1924,30,50-100,1954,6
SIM,1891,25,45-49,1916,1
SIM,1929,23,45-49,1952,2
STAT,1848,45,45-49,1893,0.17171497986795087
STAT,1947,24,40-44,1971,3.5876840347158985
SIM,1880,24,30-34,1904,27
STAT,1873,18,45-49,1891,0.06247418161747169
STAT,1931,15,40-44,1946,1.7376002881688533
STAT,1933,36,15-19,1969,0.02473241321663254
STAT,1775,94,na,1869,3.6337921533517896
STAT,1833,76,na,1909,575.1593246308433
STAT,1874,38,15-19,1912,0.053950073782971134
STAT,1836,37,40-44,1873,3.393070129298701
STAT,1848,29,15-19,1877,0.3846234133248013
STAT,1898,33,40-44,1931,5.522506124007811
SIM,1935,17,40-44,1952,1
STAT,1836,23,15-19,1859,2.7296878971619614
STAT,1892,44,na,1936,2706.6208698032556
SIM,1910,16,25-29,1926,11
SIM,1828,42,30-34,1870,4
SIM,1904,49,na,1953,2931
SIM,1851,27,30-34,1878,30
STAT,1828,33,25-29,1861,10.643180026281309
STAT,1859,107,na,1966,0.028674007428157445
SIM,1859,38,30-34,1897,6
STAT,1866,78,na,1944,680.5322186010401
SIM,1875,41,na,1916,2225
STAT,1843,27,30-34,1870,22.358497177035385
SIM,1879,31,30-34,1910,28
STAT,1881,36,40-44,1917,4.012130934281595
STAT,1820,109,na,1929,3.790191056591424E-4
SIM,1853,23,25-29,1876,55
STAT,1858,15,15-19,1873,5.202334487553511
SIM,1869,24,30-34,1893,24
STAT,1845,23,25-29,1868,49.69866398457114
STAT,1826,37,15-19,1863,0.06085820335472783
STAT,1863,34,30-34,1897,14.374653669048167
SIM,1854,32,30-34,1886,22
STAT,1902,16,25-29,1918,7.573142757326759
STAT,1895,24,25-29,1919,70.13058247638688
STAT,1951,19,40-44,1970,1.5725144144996885
SIM,1839,42,40-44,1881,6
SIM,1913,21,25-29,1934,104
STAT,1850,53,20-24,1903,5.111558767871548E-4
SIM,1840,98,na,1938,4
STAT,1893,28,15-19,1921,0.5419009011806006
SIM,1959,1,na,1960,4858
STAT,1842,106,na,1948,0.008646250164361824
STAT,1873,32,25-29,1905,9.821718583282312
STAT,1846,16,35-39,1862,0.4888785371555933
STAT,1923,29,15-19,1952,0.7602793035448325
STAT,1840,53,na,1893,1475.4258425747523
STAT,1872,20,15-19,1892,3.1468064676561123
STAT,1918,40,na,1958,3740.5910454864334
STAT,1934,15,25-29,1949,55.62942260819306
STAT,1908,33,na,1941,3357.505721147402
SIM,1862,23,na,1885,2092
STAT,1903,37,40-44,1940,1.2699036162123367
SIM,1936,25,na,1961,2821
SIM,1815,43,na,1858,1332
SIM,1919,30,25-29,1949,15
SIM,1862,23,25-29,1885,52
STAT,1829,38,na,1867,1661.1722046597793
SIM,1868,40,45-49,1908,5
STAT,1876,23,45-49,1899,0.677965222206058
STAT,1763,109,na,1872,0.0010799748084828226
SIM,1888,36,35-39,1924,12
SIM,1913,25,40-44,1938,8
STAT,1883,25,45-49,1908,1.03496738769434
STAT,1877,38,40-44,1915,4.270055279944476
SIM,1906,18,25-29,1924,8
STAT,1832,31,25-29,1863,8.197682518315972
STAT,1905,25,40-44,1930,4.11715419981023
SIM,1933,29,40-44,1962,9
STAT,1830,46,na,1876,1461.0912564269001
STAT,1862,17,30-34,1879,1.471024519172112
STAT,1933,19,30-34,1952,15.331536744377292
SIM,1926,18,na,1944,4153
SIM,1911,37,40-44,1948,2
SIM,1930,28,45-49,1958,5
STAT,1852,27,15-19,1879,0.4014986819615887
STAT,1953,15,35-39,1968,4.797923048884648
SIM,1885,70,na,1955,1273
STAT,1832,35,40-44,1867,3.428987762807711
STAT,1922,28,45-49,1950,1.8404102053842966
SIM,1918,22,30-34,1940,37
SIM,1941,28,20-24,1969,21
SIM,1870,71,na,1941,1193
STAT,1824,91,na,1915,30.59283618121722
STAT,1842,21,40-44,1863,1.885178861010746
SIM,1848,52,50-100,1900,1
SIM,1942,15,25-29,1957,59
STAT,1874,19,15-19,1893,5.699267104319605
SIM,1873,35,45-49,1908,2
STAT,1854,23,25-29,1877,48.086915674975636
SIM,1847,31,na,1878,1799
SIM,1871,29,40-44,1900,2
SIM,1895,33,30-34,1928,25
SIM,1840,35,40-44,1875,8
SIM,1849,97,na,1946,3
SIM,1898,22,35-39,1920,9
STAT,1862,56,na,1918,1643.6142535107929
STAT,1930,11,na,1941,4846.761318547269
STAT,1883,49,20-24,1932,0.010878428964330746
SIM,1840,31,25-29,1871,15
SIM,1938,30,35-39,1968,9
STAT,1875,74,na,1949,1077.0920078598976
STAT,1933,28,20-24,1961,22.88620731223938
SIM,1860,64,na,1924,1416
STAT,1921,16,35-39,1937,4.5300020867526465
STAT,1899,39,30-34,1938,1.474260323330439
SIM,1804,69,na,1873,658
STAT,1845,45,na,1890,1600.5451108582909
STAT,1847,28,45-49,1875,0.9748801288759883
STAT,1831,23,30-34,1854,35.933944625989064
STAT,1855,49,45-49,1904,0.16365404612876785
SIM,1899,34,45-49,1933,7
SIM,1827,33,25-29,1860,14
STAT,1863,25,25-29,1888,35.637593121175314
SIM,1840,76,na,1916,573
STAT,1846,30,15-19,1876,0.12114686149389484
STAT,1833,37,15-19,1870,0.042739029884649955
STAT,1832,24,na,1856,1709.606674858123
STAT,1837,20,20-24,1857,58.180793155311946
SIM,1854,22,20-24,1876,63
SIM,1850,21,40-44,1871,4
SIM,1851,68,na,1919,1096
SIM,1894,24,25-29,1918,82
SIM,1838,30,30-34,1868,18
SIM,1855,28,45-49,1883,5
SIM,1894,30,45-49,1924,2
SIM,1909,35,35-39,1944,6
SIM,1854,4,na,1858,2373
SIM,1892,28,30-34,1920,39
SIM,1919,16,45-49,1935,3
STAT,1886,24,25-29,1910,56.78053232117121
STAT,1908,25,25-29,1933,59.66767466634208
STAT,1839,45,45-49,1884,0.16448890409043956
STAT,1887,62,na,1949,1930.9915940050862
STAT,1928,24,30-34,1952,33.691342401655355
STAT,1867,38,15-19,1905,0.0495620700913393
STAT,1907,46,15-19,1953,3.1394735145328257E-4
STAT,1815,54,na,1869,1157.0859229484265
STAT,1850,39,50-100,1889,0.8599747349423034
SIM,1857,21,35-39,1878,7
SIM,1864,89,na,1953,87
STAT,1846,22,20-24,1868,59.95125173710676
SIM,1811,84,na,1895,135
STAT,1871,46,25-29,1917,0.05409806197416267
SIM,1841,18,15-19,1859,6
STAT,1824,37,50-100,1861,1.8451014393406386
STAT,1872,22,30-34,1894,16.889647931381383
STAT,1900,27,50-100,1927,0.8383741448549477
SIM,1910,34,20-24,1944,1
SIM,1938,20,25-29,1958,91
STAT,1884,28,30-34,1912,23.425554395500427
SIM,1832,37,50-100,1869,3
STAT,1893,38,25-29,1931,3.4339346309742385
STAT,1940,17,15-19,1957,43.52654992659165
STAT,1937,28,50-100,1965,0.9160306937600645
STAT,1865,30,50-100,1895,0.7928686325982313
STAT,1899,65,na,1964,2390.853308424012
STAT,1917,34,50-100,1951,0.8108623469272412
SIM,1845,20,20-24,1865,63
SIM,1871,25,25-29,1896,47
SIM,1900,39,30-34,1939,5
STAT,1876,35,20-24,1911,0.7589142324802286
SIM,1847,32,30-34,1879,26
SIM,1845,39,40-44,1884,7
STAT,1873,36,40-44,1909,4.217827292235732
STAT,1831,24,35-39,1855,6.0560885395207995
STAT,1820,42,50-100,1862,1.9057747027919942
SIM,1918,37,35-39,1955,10
SIM,1904,23,40-44,1927,4
SIM,1918,39,50-100,1957,3
STAT,1888,43,25-29,1931,0.7114768239728627
STAT,1907,38,20-24,1945,0.22970309214593673
SIM,1879,22,25-29,1901,74
STAT,1917,27,25-29,1944,65.20641647931413
STAT,1781,100,na,1881,0.1959600508764156
SIM,1866,19,30-34,1885,1
STAT,1858,19,30-34,1877,1.3645860810315222
SIM,1825,37,30-34,1862,4
STAT,1846,32,30-34,1878,14.547782391596513
SIM,1832,34,45-49,1866,1
SIM,1925,34,50-100,1959,1
SIM,1906,32,50-100,1938,4
SIM,1947,19,25-29,1966,51
SIM,1912,12,na,1924,3631
STAT,1897,21,30-34,1918,22.572254704925616
SIM,1873,60,na,1933,1825
SIM,1925,27,25-29,1952,90
STAT,1836,27,30-34,1863,20.576693275787406
STAT,1783,106,na,1889,0.010830942714366264
STAT,1896,47,40-44,1943,0.1200099623509784
STAT,1943,26,30-34,1969,39.43801790887069
SIM,1861,27,na,1888,2062
SIM,1878,49,50-100,1927,5
SIM,1844,27,30-34,1871,33
STAT,1879,33,na,1912,2346.376417328872
STAT,1927,31,20-24,1958,2.8364739547276665
STAT,1891,25,45-49,1916,1.307092898840122
STAT,1942,1,na,1943,4092.738925417645
STAT,1830,45,25-29,1875,0.04332112161646117
SIM,1938,22,40-44,1960,4
STAT,1821,35,30-34,1856,12.672895145624642
STAT,1823,98,na,1921,1.7095061321329217
SIM,1846,38,na,1884,1735
SIM,1934,33,50-100,1967,1
STAT,1929,38,15-19,1967,0.023268217742189304
STAT,1870,24,20-24,1894,63.3908555106605
SIM,1870,36,30-34,1906,3
STAT,1857,32,40-44,1889,3.249712871230986
SIM,1866,67,na,1933,1347
STAT,1826,39,30-34,1865,5.459686506309537
SIM,1908,15,30-34,1923,2
STAT,1866,54,50-100,1920,0.01279259383288909
STAT,1916,15,15-19,1931,9.138170051407858
SIM,1935,25,35-39,1960,24
STAT,1807,47,15-19,1854,0.0014812109562116354
STAT,1839,32,30-34,1871,14.326396719799586
SIM,1888,6,na,1894,2838
STAT,1809,83,na,1892,166.76728078297182
STAT,1888,29,45-49,1917,1.2302534118011421
SIM,1855,75,na,1930,761
SIM,1949,21,na,1970,3993
STAT,1811,45,15-19,1856,0.0013785219132050688
SIM,1851,50,na,1901,1637
SIM,1968,3,na,1971,4481
SIM,1901,20,na,1921,3205
SIM,1805,99,na,1904,1
SIM,1795,83,na,1878,112
SIM,1865,32,40-44,1897,3
STAT,1817,37,30-34,1854,18.48157409971573
SIM,1834,39,30-34,1873,10
SIM,1829,38,45-49,1867,1
STAT,1778,83,na,1861,111.018296385492
STAT,1828,72,na,1900,716.9157608340516
STAT,1872,100,na,1972,8.845956812129373
SIM,1814,47,50-100,1861,1
SIM,1916,25,25-29,1941,68
SIM,1940,22,na,1962,3327
SIM,1849,31,45-49,1880,1
SIM,1897,73,na,1970,1866
STAT,1928,37,45-49,1965,0.8139814436230296
SIM,1939,14,na,1953,3656
STAT,1937,20,25-29,1957,85.02183036649869
SIM,1796,68,na,1864,699
SIM,1913,33,35-39,1946,10
STAT,1863,51,40-44,1914,0.008784131743069114
SIM,1935,31,20-24,1966,2
STAT,1849,21,35-39,1870,5.122151457569131
SIM,1828,26,35-39,1854,11
STAT,1926,38,30-34,1964,2.102349605751335
SIM,1895,23,20-24,1918,79
SIM,1868,34,25-29,1902,13
SIM,1776,91,na,1867,16
SIM,1944,27,35-39,1971,19
SIM,1828,32,20-24,1860,2
SIM,1880,25,35-39,1905,12
STAT,1840,24,na,1864,1866.505979889022
SIM,1858,71,na,1929,1066
STAT,1887,17,35-39,1904,0.5797093020115884
STAT,1851,16,na,1867,2058.6928254342847
SIM,1860,37,25-29,1897,3
STAT,1957,13,na,1970,4891.061139442241
STAT,1778,107,na,1885,0.007083127249852229
SIM,1909,27,40-44,1936,5
SIM,1864,20,30-34,1884,19
STAT,1887,23,20-24,1910,72.58084026210237
STAT,1788,90,na,1878,29.618363828684103
STAT,1862,27,40-44,1889,2.422837629353632
SIM,1870,27,40-44,1897,3
STAT,1840,35,40-44,1875,3.681372142958714
STAT,1927,25,35-39,1952,17.361609927341433
STAT,1856,3,na,1859,2471.8107769563485
STAT,1949,23,20-24,1972,122.54395200478298
STAT,1852,37,25-29,1889,2.1994040710653544
STAT,1866,15,na,1881,2284.725423684262
STAT,1868,22,15-19,1890,2.975643906494425
STAT,1893,43,50-100,1936,0.08729788251918362
STAT,1886,30,45-49,1916,1.754541843460081
SIM,1865,35,45-49,1900,1
SIM,1895,17,35-39,1912,1
SIM,1858,33,45-49,1891,2
STAT,1858,54,45-49,1912,0.010466865143602762
STAT,1905,33,35-39,1938,7.904826675219378
SIM,1876,22,15-19,1898,3
STAT,1918,48,40-44,1966,0.15805413364033497
STAT,1834,61,na,1895,1156.603917841779
STAT,1923,39,25-29,1962,1.075555358580331
STAT,1891,34,35-39,1925,11.740262942765435
STAT,1845,20,20-24,1865,61.134861043069165
SIM,1939,20,35-39,1959,12
STAT,1812,58,na,1870,1083.5540335984867
STAT,1854,42,35-39,1896,1.3023511644497037
STAT,1902,47,40-44,1949,0.1281433176638968
SIM,1914,23,40-44,1937,3
STAT,1875,18,15-19,1893,5.744616740914323
STAT,1896,43,25-29,1939,0.055273237691920864
SIM,1838,71,na,1909,869
STAT,1894,46,25-29,1940,0.03959606276706573
SIM,1860,29,30-34,1889,24
STAT,1898,9,na,1907,3318.0866849852764
SIM,1876,38,25-29,1914,2
STAT,1854,26,30-34,1880,21.04080121489529
STAT,1857,38,20-24,1895,0.571242819289065
STAT,1833,52,45-49,1885,0.009100680348044362
SIM,1814,81,na,1895,234
SIM,1933,2,na,1935,5148
STAT,1852,29,30-34,1881,19.988666732331847
STAT,1801,94,na,1895,7.605094419925727
SIM,1896,35,45-49,1931,3
STAT,1938,16,40-44,1954,1.3064896879452972
STAT,1822,33,30-34,1855,45.206314586493235
STAT,1873,54,40-44,1927,0.00981744353220256
STAT,1837,29,35-39,1866,7.70608941555675
STAT,1901,29,na,1930,3133.1143909839197
STAT,1858,19,25-29,1877,4.851550916149514
STAT,1824,43,35-39,1867,2.233282655829723
STAT,1838,51,na,1889,1489.9122581226145
SIM,1903,52,na,1955,2870
STAT,1827,53,30-34,1880,0.0049356705564858406
STAT,1894,44,30-34,1938,0.09570794527391198
STAT,1819,49,40-44,1868,0.2954715757094162
SIM,1878,33,50-100,1911,4
SIM,1825,45,na,1870,1391
STAT,1877,47,35-39,1924,0.13660453677330528
STAT,1829,52,25-29,1881,0.002512528864925931
SIM,1829,35,na,1864,1598
SIM,1897,19,na,1916,3222
STAT,1875,16,20-24,1891,17.248472570936933
STAT,1868,38,25-29,1906,2.5840887589099886
SIM,1832,43,35-39,1875,2
STAT,1852,86,na,1938,168.57538894550993
SIM,1883,16,20-24,1899,21
STAT,1888,35,45-49,1923,2.2458801418468917
SIM,1931,39,25-29,1970,1
SIM,1871,32,35-39,1903,16
STAT,1848,45,15-19,1893,2.9104209379383537E-4
STAT,1859,33,na,1892,1791.5062785852542
STAT,1877,6,na,1883,2653.6532451364646
SIM,1886,67,na,1953,1493
STAT,1863,35,40-44,1898,3.6696611410721642
STAT,1879,42,40-44,1921,2.2182727006406
SIM,1862,26,30-34,1888,23
SIM,1878,33,30-34,1911,22
SIM,1901,31,50-100,1932,1
STAT,1865,45,50-100,1910,0.21293597599199296
SIM,1884,32,na,1916,2327
SIM,1848,39,30-34,1887,2
STAT,1863,17,40-44,1880,0.1733152814055227
SIM,1834,81,na,1915,309
SIM,1853,39,40-44,1892,7
SIM,1914,16,na,1930,4096
STAT,1885,37,15-19,1922,0.05285151450301266
SIM,1834,26,25-29,1860,36
SIM,1830,33,30-34,1863,15
SIM,1876,37,na,1913,2335
SIM,1946,16,40-44,1962,1
STAT,1811,45,20-24,1856,0.0413556937739974
SIM,1851,23,20-24,1874,52
STAT,1893,17,25-29,1910,6.792231471416021
SIM,1864,39,45-49,1903,1
STAT,1843,23,20-24,1866,61.95730344577293
SIM,1846,43,35-39,1889,2
SIM,1896,65,na,1961,2292
STAT,1813,99,na,1912,0.8009683129163399
SIM,1869,63,na,1932,1599
STAT,1944,26,na,1970,3826.5606342524015
SIM,1870,32,na,1902,2212
SIM,1887,42,40-44,1929,7
SIM,1881,36,40-44,1917,3
STAT,1882,29,15-19,1911,0.4140852422735438
SIM,1926,22,20-24,1948,112
STAT,1834,20,45-49,1854,1.040738562337761
STAT,1845,39,40-44,1884,3.1731458937665376
STAT,1876,51,50-100,1927,0.014799510829235009
SIM,1850,20,na,1870,1901
STAT,1845,51,25-29,1896,0.002506865089040254
STAT,1918,22,20-24,1940,113.29100676845819
SIM,1837,32,30-34,1869,20
STAT,1917,24,na,1941,3643.4188829046007
STAT,1879,25,na,1904,2372.517080207016
STAT,1906,52,na,1958,2997.416234504177
STAT,1906,60,na,1966,2839.0076679122917
SIM,1858,24,15-19,1882,2
STAT,1864,16,45-49,1880,0.06306821052983917
STAT,1828,41,na,1869,1521.5881396635086
STAT,1847,49,45-49,1896,0.17002053459777827
STAT,1914,46,20-24,1960,0.010377801951238452
SIM,1859,65,na,1924,1404
STAT,1865,44,35-39,1909,1.5335011236240594
STAT,1882,47,45-49,1929,0.2159316171438379
SIM,1845,27,40-44,1872,3
STAT,1883,30,na,1913,2227.1664472172906
STAT,1896,23,30-34,1919,22.17049005680278
STAT,1889,46,15-19,1935,4.678329133622717E-4
SIM,1880,25,40-44,1905,3
SIM,1872,30,30-34,1902,21
STAT,1831,25,50-100,1856,0.599829027818085
SIM,1887,44,35-39,1931,5
STAT,1849,26,20-24,1875,10.096193441545347
STAT,1875,43,na,1918,2226.9420808824984
STAT,1865,32,40-44,1897,3.72283187685309
STAT,1878,45,30-34,1923,0.0961472897403727
STAT,1880,16,30-34,1896,1.5881947917359727
STAT,1780,87,na,1867,46.48263626723211
STAT,1779,90,na,1869,28.43906099047297
SIM,1825,33,20-24,1858,2
STAT,1846,38,45-49,1884,1.4526294214195101
STAT,1868,26,50-100,1894,0.5789679132573539
STAT,1844,52,20-24,1896,5.152684641452E-4
STAT,1829,32,30-34,1861,17.03797160859813
SIM,1866,19,25-29,1885,6
SIM,1855,100,na,1955,2
STAT,1843,38,20-24,1881,0.5847018627219187
SIM,1856,37,na,1893,1847
STAT,1861,21,15-19,1882,2.6779886430485282
STAT,1879,26,35-39,1905,9.560357918417607
STAT,1834,50,40-44,1884,0.006951715791428444
STAT,1902,70,na,1972,2261.9722570793233
SIM,1804,51,na,1855,1146
SIM,1854,38,45-49,1892,1
STAT,1907,22,45-49,1929,0.9675107001942995
STAT,1821,35,35-39,1856,16.8182913915894
STAT,1808,103,na,1911,0.055782177807159494
STAT,1882,37,50-100,1919,1.1286026219111178
STAT,1841,28,15-19,1869,0.38278764057764375
SIM,1880,49,50-100,1929,5
STAT,1858,37,25-29,1895,2.1352978939076146
STAT,1895,43,35-39,1938,0.1539005782433882
STAT,1859,47,15-19,1906,3.0016363146081045E-4
SIM,1855,34,45-49,1889,1
STAT,1894,28,25-29,1922,51.22459626638521
SIM,1873,44,35-39,1917,3
STAT,1879,44,35-39,1923,1.763920225969655
STAT,1881,15,35-39,1896,0.5028271444607955
STAT,1906,23,40-44,1929,2.8576488119118384
SIM,1818,71,na,1889,545
SIM,1853,20,20-24,1873,73
STAT,1821,94,na,1915,10.792455631393425
STAT,1837,27,40-44,1864,2.4271270586861324
SIM,1892,24,20-24,1916,78
STAT,1855,42,25-29,1897,0.4542393050565465
SIM,1802,88,na,1890,32
SIM,1870,35,25-29,1905,3
SIM,1938,21,30-34,1959,35
STAT,1817,89,na,1906,46.5873723955903
STAT,1820,36,30-34,1856,13.00568802764469
SIM,1922,11,na,1933,4364
SIM,1887,26,35-39,1913,11
STAT,1887,20,na,1907,2513.574091799337
STAT,1880,31,25-29,1911,10.222739098111711
STAT,1771,111,na,1882,8.462224739265462E-4
SIM,1874,28,20-24,1902,10
STAT,1896,41,30-34,1937,0.10012798399247344
SIM,1919,27,35-39,1946,19
STAT,1903,46,45-49,1949,0.17943058569807577
SIM,1910,34,na,1944,3339
SIM,1865,73,na,1938,997
STAT,1884,24,20-24,1908,63.929817290895734
STAT,1912,49,20-24,1961,0.009972116500766529
STAT,1920,43,40-44,1963,0.2605693918937695
STAT,1877,30,na,1907,2358.1451957314166
SIM,1890,40,na,1930,2792
STAT,1829,50,30-34,1879,0.004827681310174187
STAT,1923,32,na,1955,4096.318008336064
STAT,1863,19,35-39,1882,0.46759338767610126
STAT,1828,52,35-39,1880,0.007002137042875873
STAT,1832,53,40-44,1885,0.0065089825548486765
STAT,1870,12,na,1882,2451.47616920705
STAT,1943,24,50-100,1967,0.6608667941230698
STAT,1912,60,na,1972,3105.2611694576512
SIM,1894,21,20-24,1915,85
SIM,1821,63,na,1884,996
SIM,1886,27,30-34,1913,30
STAT,1919,21,25-29,1940,95.84036881841733
STAT,1928,27,35-39,1955,17.47530562532573
STAT,1885,73,na,1958,1206.842147559236
SIM,1842,18,30-34,1860,1
STAT,1876,50,45-49,1926,0.014356699151590093
SIM,1863,25,35-39,1888,11
STAT,1845,53,20-24,1898,5.114310791946155E-4
STAT,1838,43,na,1881,1656.2020047759477
STAT,1840,17,45-49,1857,0.058899343506163694
STAT,1861,36,15-19,1897,0.04426396746423882
STAT,1960,0,na,1960,4872.356228437484
STAT,1835,31,15-19,1866,0.11430198342964086
STAT,1864,33,35-39,1897,8.514308188468643
SIM,1911,43,40-44,1954,1
STAT,1787,103,na,1890,0.05350043961835356
STAT,1897,40,35-39,1937,0.16047327466645403
STAT,1839,42,40-44,1881,1.5806753485131073
STAT,1859,50,45-49,1909,0.011098495735806655
STAT,1890,21,40-44,1911,2.414122007038563
STAT,1874,9,na,1883,2576.08072019041
STAT,1878,71,na,1949,1312.7130341136765
STAT,1814,41,25-29,1855,2.0921537308696596
STAT,1853,45,25-29,1898,0.043142477071550195
STAT,1844,37,25-29,1881,2.1358768780946926
STAT,1855,25,35-39,1880,7.941119434709774
SIM,1886,47,50-100,1933,2
SIM,1838,63,na,1901,1122
SIM,1927,21,25-29,1948,109
STAT,1858,41,50-100,1899,0.7870411402787522
STAT,1864,34,45-49,1898,1.459722363791288
SIM,1875,27,25-29,1902,52
STAT,1887,39,45-49,1926,2.084914695616995
SIM,1941,3,na,1944,3786
STAT,1849,46,15-19,1895,2.8913467180730025E-4
SIM,1819,36,30-34,1855,5
SIM,1845,44,30-34,1889,4
STAT,1890,20,30-34,1910,20.696422416511766
SIM,1846,25,35-39,1871,8
STAT,1927,14,na,1941,4639.583510443839
STAT,1947,21,30-34,1968,30.698320318865797
STAT,1844,36,15-19,1880,0.04625493220117906
STAT,1869,35,na,1904,2174.8527321353413
STAT,1873,48,na,1921,2130.2833603495164
STAT,1903,43,40-44,1946,0.20841385096033893
SIM,1852,21,15-19,1873,2
SIM,1931,28,na,1959,4540
STAT,1878,27,30-34,1905,24.765202879672945
SIM,1845,65,na,1910,1192
SIM,1878,39,45-49,1917,5
STAT,1849,31,45-49,1880,1.4706774584774616
STAT,1886,21,20-24,1907,68.99088710367879
STAT,1821,40,50-100,1861,1.8725369172092672
STAT,1895,27,30-34,1922,31.04424064062794
STAT,1849,44,20-24,1893,0.11292583359606344
SIM,1895,39,45-49,1934,4
SIM,1797,64,na,1861,848
SIM,1906,31,35-39,1937,9
STAT,1899,17,20-24,1916,22.951595580328235
SIM,1847,42,40-44,1889,7
STAT,1948,23,45-49,1971,1.220149159589721
SIM,1936,27,35-39,1963,13
STAT,1766,107,na,1873,0.007350938253581241
STAT,1828,54,30-34,1882,0.004234441709042148
STAT,1830,28,40-44,1858,2.747462578847888
STAT,1849,35,na,1884,1774.1380402656234
STAT,1909,29,na,1938,3357.114174218524
SIM,1836,36,30-34,1872,8
SIM,1888,40,35-39,1928,1
STAT,1845,104,na,1949,0.04698226470222364
STAT,1916,50,na,1966,3527.531883484577
SIM,1857,31,45-49,1888,2
STAT,1858,71,na,1929,989.9276654816205
STAT,1862,25,na,1887,1958.2600095546736
SIM,1846,36,50-100,1882,1
STAT,1784,77,na,1861,266.28299764680617
STAT,1851,5,na,1856,2241.91896764
STAT,1853,27,25-29,1880,36.34197790490563
SIM,1827,30,20-24,1857,1
STAT,1829,35,35-39,1864,6.53827374113991
SIM,1857,26,20-24,1883,14
STAT,1850,33,35-39,1883,7.381105814394899
STAT,1869,52,25-29,1921,0.0032217043310239866
SIM,1766,92,na,1858,9
SIM,1916,15,15-19,1931,7
SIM,1861,27,25-29,1888,44
STAT,1939,15,45-49,1954,0.473484919569811
STAT,1844,21,15-19,1865,2.912520356448634
STAT,1825,34,50-100,1859,1.3445738541978782
STAT,1889,35,na,1924,2773.8055533187026
SIM,1870,36,35-39,1906,9
STAT,1838,41,40-44,1879,1.8172179027778113
STAT,1855,43,35-39,1898,1.2732205574160298
STAT,1838,43,35-39,1881,1.297631534436753
STAT,1836,40,50-100,1876,0.8142408860632941
STAT,1873,24,45-49,1897,0.6644814883574759
STAT,1870,27,25-29,1897,39.1571347544342
SIM,1822,88,na,1910,62
STAT,1818,46,15-19,1864,8.682974990291439E-4
SIM,1921,29,15-19,1950,4
STAT,1954,17,35-39,1971,4.900352790642408
STAT,1861,39,25-29,1900,2.235930546783781
STAT,1913,34,na,1947,3523.5126167504654
STAT,1938,34,40-44,1972,3.7120118597646816
STAT,1924,21,35-39,1945,10.528854021698935
SIM,1867,6,na,1873,2442
STAT,1853,6,na,1859,2225.5908065556246
STAT,1871,29,40-44,1900,2.78542449618655
SIM,1898,27,20-24,1925,12
STAT,1789,103,na,1892,0.03166546127402951
STAT,1840,31,25-29,1871,8.778776325622626
STAT,1880,10,na,1890,2574.7799631008756
STAT,1908,15,15-19,1923,8.353119291488552
STAT,1835,46,15-19,1881,2.6645948651951394E-4
SIM,1945,17,35-39,1962,9
STAT,1868,53,20-24,1921,6.548996361277373E-4
STAT,1828,36,30-34,1864,5.17562869780463
STAT,1881,30,30-34,1911,16.05378972687154
STAT,1937,17,35-39,1954,3.855854517276204
STAT,1939,33,45-49,1972,1.51563914041394
STAT,1828,51,25-29,1879,0.0029385792296642227
SIM,1893,40,45-49,1933,7
STAT,1820,38,25-29,1858,6.140948991174431
SIM,1804,91,na,1895,28
STAT,1834,103,na,1937,0.08882953833113001
STAT,1885,40,45-49,1925,1.4228201964355058
SIM,1896,57,na,1953,2540
SIM,1883,19,30-34,1902,3
STAT,1831,27,45-49,1858,0.9739650623258256
STAT,1913,29,15-19,1942,0.6596135962366207
SIM,1893,22,15-19,1915,7
STAT,1934,9,na,1943,5086.617814317615
STAT,1899,19,15-19,1918,7.641747295415827
STAT,1895,42,25-29,1937,0.05490619147004136
STAT,1837,44,30-34,1881,0.7596048642928042
STAT,1871,40,15-19,1911,0.013064009229803117
STAT,1942,11,na,1953,3888.9886035758527
STAT,1891,20,50-100,1911,0.4796771193057069
SIM,1845,26,30-34,1871,22
SIM,1846,41,40-44,1887,1
SIM,1891,34,na,1925,2919
STAT,1853,43,30-34,1896,0.846443953023515
SIM,1879,85,na,1964,499
STAT,1847,35,50-100,1882,0.9569437600326041
SIM,1929,34,40-44,1963,7
STAT,1850,21,40-44,1871,1.7735117004290133
STAT,1869,50,30-34,1919,0.0055214517804211515
SIM,1887,29,na,1916,2494
STAT,1818,43,na,1861,1404.9839990919033
STAT,1874,50,40-44,1924,0.010310849668676304
STAT,1854,44,30-34,1898,0.8166947736756913
SIM,1797,84,na,1881,97
STAT,1848,53,50-100,1901,0.010705680050620765
SIM,1880,42,na,1922,2374
STAT,1822,56,na,1878,1151.407082156275
STAT,1838,25,35-39,1863,8.492788515317482
STAT,1885,22,15-19,1907,3.104973323393298
STAT,1896,24,50-100,1920,0.5059521587735157
STAT,1875,51,40-44,1926,0.010266370904513862
SIM,1909,22,20-24,1931,85
STAT,1880,17,40-44,1897,0.18180535153407676
STAT,1885,7,na,1892,2452.107463161369
STAT,1889,55,na,1944,2411.5164463089623
SIM,1932,21,35-39,1953,13
SIM,1867,18,30-34,1885,1
STAT,1842,31,50-100,1873,0.7964270004314074
SIM,1900,36,na,1936,3098
STAT,1859,18,30-34,1877,1.3866565405473357
STAT,1899,35,20-24,1934,1.0074290186780852
SIM,1876,57,na,1933,1966
SIM,1850,40,na,1890,1711
SIM,1892,75,na,1967,1509
STAT,1881,35,na,1916,2169.3996080856145
STAT,1909,49,na,1958,3169.595802638324
STAT,1849,28,15-19,1877,0.38487363903671157
SIM,1808,73,na,1881,476
STAT,1913,47,15-19,1960,3.395830829885138E-4
STAT,1938,19,45-49,1957,0.4651483621339794
SIM,1872,75,na,1947,904
STAT,1856,54,40-44,1910,0.007575142747071461
SIM,1815,43,35-39,1858,1
STAT,1837,89,na,1926,66.31584522772033
SIM,1866,27,na,1893,2131
STAT,1880,32,35-39,1912,10.06628764445434
STAT,1877,44,30-34,1921,1.111826373418853
STAT,1930,34,na,1964,4605.232882019089
SIM,1848,41,45-49,1889,4
STAT,1852,58,na,1910,1502.5238802374733
STAT,1874,34,35-39,1908,9.69428620751609
STAT,1862,20,20-24,1882,57.67300240673924
STAT,1869,39,50-100,1908,1.111393748904711
STAT,1889,18,50-100,1907,0.0569881554194754
STAT,1802,106,na,1908,0.004141986537816785
SIM,1825,73,na,1898,607
SIM,1843,30,na,1873,1861
STAT,1830,25,35-39,1855,11.409259898544079
SIM,1858,40,na,1898,1893
STAT,1858,18,15-19,1876,5.110949613856608
STAT,1896,40,20-24,1936,0.013908127298976159
SIM,1929,31,30-34,1960,30
SIM,1888,43,40-44,1931,7
STAT,1832,22,35-39,1854,8.771686243212475
STAT,1934,24,na,1958,4632.908739230571
SIM,1896,34,35-39,1930,18
SIM,1821,41,35-39,1862,2
STAT,1814,92,na,1906,17.184379499412458
SIM,1843,29,30-34,1872,28
STAT,1846,52,25-29,1898,0.002484080914802299
SIM,1798,58,na,1856,1005
STAT,1829,53,35-39,1882,0.005986996053612042
STAT,1861,37,30-34,1898,4.180929378302724
SIM,1845,73,na,1918,848
STAT,1857,31,50-100,1888,0.6937538917685095
STAT,1883,28,20-24,1911,10.82353151032416
STAT,1835,29,30-34,1864,20.184179600177917
SIM,1791,79,na,1870,261
STAT,1839,21,50-100,1860,0.3518900242353402
STAT,1820,39,35-39,1859,14.103351325271081
SIM,1898,12,na,1910,3263
SIM,1891,28,20-24,1919,13
STAT,1858,51,40-44,1909,0.007844973121397019
STAT,1860,25,15-19,1885,0.357177462878696
SIM,1866,18,15-19,1884,7
STAT,1824,31,40-44,1855,11.742535157592748
STAT,1923,36,20-24,1959,0.2888361448320981
SIM,1842,17,15-19,1859,5
STAT,1894,43,20-24,1937,0.01330500522117672
STAT,1864,15,35-39,1879,0.5329119178008332
SIM,1897,59,na,1956,2481
SIM,1840,73,na,1913,747
SIM,1872,31,40-44,1903,4
STAT,1844,53,30-34,1897,0.004111650168328156
STAT,1856,48,na,1904,1643.7273607356558
SIM,1874,22,na,1896,2253
SIM,1837,35,35-39,1872,14
STAT,1794,67,na,1861,701.7216418139999
STAT,1854,29,35-39,1883,7.179691916935438
SIM,1830,34,40-44,1864,3
STAT,1927,4,na,1931,4741.488377318274
STAT,1867,27,25-29,1894,37.52138068672868
SIM,1854,19,35-39,1873,2
STAT,1875,54,45-49,1929,0.013697525550300162
SIM,1847,21,35-39,1868,5
STAT,1764,107,na,1871,0.005611690342800013
STAT,1830,42,20-24,1872,0.12079003733229554
STAT,1871,42,50-100,1913,0.988194968145329
STAT,1896,26,35-39,1922,12.088340070778276
STAT,1834,35,15-19,1869,0.04414313400823721
STAT,1881,91,na,1972,199.21807023161637
STAT,1894,47,35-39,1941,0.09552055288160108
SIM,1880,70,na,1950,1466
SIM,1952,15,25-29,1967,62
STAT,1875,19,25-29,1894,5.470281253504124
STAT,1921,29,na,1950,3916.3328533512954
STAT,1932,24,50-100,1956,0.8128115556705862
STAT,1944,15,25-29,1959,44.07840020169506
SIM,1865,31,50-100,1896,1
STAT,1822,34,40-44,1856,9.58253964139345
SIM,1870,20,20-24,1890,60
SIM,1894,37,35-39,1931,21
STAT,1876,32,15-19,1908,0.1388838526869327
SIM,1862,29,35-39,1891,9
SIM,1962,6,na,1968,4681
SIM,1882,34,35-39,1916,9
SIM,1909,49,na,1958,3156
SIM,1877,39,50-100,1916,1
STAT,1856,109,na,1965,0.003635396447808382
STAT,1890,20,na,1910,2747.9938775496403
STAT,1865,47,45-49,1912,0.2016484820228984
SIM,1904,26,na,1930,3170
STAT,1834,53,45-49,1887,0.009030189618243053
STAT,1819,37,50-100,1856,3.1918464752133247
SIM,1872,15,35-39,1887,1
SIM,1888,22,35-39,1910,9
SIM,1926,25,25-29,1951,80
STAT,1880,19,35-39,1899,0.5424910687021023
SIM,1867,29,na,1896,2054
STAT,1855,41,40-44,1896,1.600227942741428
SIM,1864,46,50-100,1910,1
STAT,1847,16,45-49,1863,0.06034348123106109
SIM,1937,13,na,1950,3500
STAT,1839,21,35-39,1860,5.035545657430735
STAT,1835,23,na,1858,1760.4900362736196
SIM,1832,31,40-44,1863,3
SIM,1890,44,40-44,1934,7
SIM,1967,4,na,1971,4512
STAT,1873,39,45-49,1912,1.8923318907317959
STAT,1890,26,50-100,1916,0.741397569124775
STAT,1810,46,15-19,1856,0.0014464039366192934
STAT,1888,34,35-39,1922,11.20514608169308
SIM,1940,24,50-100,1964,3
STAT,1891,22,40-44,1913,2.436611688334181
STAT,1874,52,35-39,1926,0.008268067366298561
SIM,1885,73,na,1958,1186
SIM,1923,27,50-100,1950,1
STAT,1868,37,15-19,1905,0.05065012504133865
STAT,1870,42,20-24,1912,0.14682738709446813
STAT,1832,58,na,1890,1195.771171870025
STAT,1881,32,25-29,1913,9.342729852484673
STAT,1876,47,15-19,1923,3.882831561784086E-4
STAT,1832,38,15-19,1870,0.04258599698855223
STAT,1896,44,35-39,1940,0.15487952226564755
STAT,1846,19,35-39,1865,0.4802908341776365
STAT,1886,33,15-19,1919,0.14154070563189253
SIM,1878,36,35-39,1914,14
STAT,1836,48,na,1884,1467.887934402415
STAT,1897,30,na,1927,3039.1362625450197
SIM,1840,22,35-39,1862,3
STAT,1882,44,40-44,1926,2.039737622259418
STAT,1803,51,20-24,1854,0.0021579027020219746
SIM,1839,65,na,1904,1213
STAT,1819,42,15-19,1861,0.027111237483322625
STAT,1806,103,na,1909,0.04775441008369529
SIM,1841,48,50-100,1889,1
SIM,1870,32,20-24,1902,2
STAT,1918,25,25-29,1943,66.62059927018893
STAT,1956,15,45-49,1971,0.6247086984607167
STAT,1865,53,na,1918,1818.6980284404024
STAT,1806,48,45-49,1854,0.6868315171254835
STAT,1849,29,25-29,1878,35.62644007379906
SIM,1829,43,35-39,1872,1
SIM,1862,42,35-39,1904,1
STAT,1891,19,15-19,1910,6.902096034042072
SIM,1928,20,30-34,1948,38
SIM,1849,19,25-29,1868,6
SIM,1954,5,na,1959,4437
STAT,1895,40,30-34,1935,1.4316119300165528
STAT,1854,81,na,1935,389.4013981364026
STAT,1873,51,35-39,1924,0.00829479701255042
STAT,1836,30,20-24,1866,2.2028806540688928
STAT,1861,16,50-100,1877,0.04443600007631193
STAT,1836,49,40-44,1885,0.1102779434602896
STAT,1839,54,35-39,1893,0.005582426585756496
STAT,1854,50,50-100,1904,0.011031686831521326
STAT,1907,14,na,1921,3571.546289377778
STAT,1818,51,na,1869,1276.894588529071
STAT,1850,50,50-100,1900,0.010785162282171723
SIM,1885,44,30-34,1929,3
STAT,1870,26,15-19,1896,0.4214198553599817
STAT,1804,52,20-24,1856,0.0021943785956316615
STAT,1924,22,45-49,1946,1.2543779685229126
SIM,1938,24,35-39,1962,7
SIM,1837,78,na,1915,448
STAT,1915,27,50-100,1942,0.9589964348135268
STAT,1861,19,30-34,1880,1.420256997116595
SIM,1862,45,na,1907,1984
STAT,1807,99,na,1906,0.6793581673226624
SIM,1932,22,45-49,1954,2
SIM,1832,47,na,1879,1469
STAT,1866,31,45-49,1897,1.5250569899545197
SIM,1848,30,na,1878,1908
STAT,1833,48,50-100,1881,0.15727105676403036
SIM,1832,86,na,1918,125
SIM,1784,97,na,1881,1
STAT,1847,49,15-19,1896,2.88170155075214E-4
STAT,1812,44,25-29,1856,2.2125093018619473
STAT,1896,37,na,1933,2941.5133802491196
SIM,1836,39,35-39,1875,11
STAT,1853,42,20-24,1895,0.11763198559486455
SIM,1831,30,40-44,1861,5
STAT,1884,39,20-24,1923,0.7123754185274372
SIM,1843,19,na,1862,2067
STAT,1902,49,50-100,1951,0.180836570964738
SIM,1849,37,25-29,1886,2
STAT,1801,74,na,1875,474.0072938876462
STAT,1833,34,15-19,1867,0.10935564021782512
SIM,1890,26,40-44,1916,2
SIM,1881,23,35-39,1904,6
STAT,1761,100,na,1861,0.12888843505512335
SIM,1863,22,30-34,1885,23
STAT,1875,19,30-34,1894,1.5386151329488287
STAT,1850,18,15-19,1868,5.075302362759277
SIM,1869,43,35-39,1912,5
STAT,1827,37,25-29,1864,2.877487745566563
STAT,1847,34,45-49,1881,1.3427425193834133
SIM,1819,37,40-44,1856,7
STAT,1838,100,na,1938,0.7240677336438658
SIM,1821,94,na,1915,7
SIM,1827,28,35-39,1855,8
STAT,1845,76,na,1921,667.3334620974091
STAT,1837,45,40-44,1882,0.11509904687992054
STAT,1889,63,na,1952,2080.9840920305187
STAT,1864,27,50-100,1891,0.5400991692058091
STAT,1878,28,40-44,1906,2.9356249791572324
SIM,1886,28,40-44,1914,3
STAT,1815,53,40-44,1868,0.024000073682276794
STAT,1900,47,35-39,1947,0.10301690980094205
SIM,1856,44,35-39,1900,1
SIM,1869,55,na,1924,1898
STAT,1851,47,15-19,1898,2.919588254033133E-4
SIM,1828,73,na,1901,581
SIM,1944,20,15-19,1964,5
STAT,1844,91,na,1935,40.67989936617958
SIM,1857,29,25-29,1886,40
STAT,1888,61,na,1949,2085.416274779105
STAT,1820,35,15-19,1855,0.14971670007053475
STAT,1840,32,35-39,1872,8.590088416702345
SIM,1850,12,na,1862,2127
SIM,1853,36,35-39,1889,13
SIM,1931,1,na,1932,5065
STAT,1870,20,na,1890,2202.315673442745
SIM,1914,20,30-34,1934,35
STAT,1901,49,45-49,1950,0.1723523473202238
STAT,1845,36,35-39,1881,5.289215060137478
SIM,1892,39,20-24,1931,3
STAT,1819,46,35-39,1865,0.2526878042014782
STAT,1824,46,45-49,1870,0.28128723188476884
STAT,1848,81,na,1929,389.57947556935267
STAT,1859,32,15-19,1891,0.10736464075362348
STAT,1954,16,na,1970,4299.676950772386
STAT,1849,47,25-29,1896,0.041323994424867824
SIM,1829,26,45-49,1855,3
STAT,1876,48,30-34,1924,0.0932185240244035
STAT,1906,20,30-34,1926,24.648935338835557
SIM,1830,53,50-100,1883,1
SIM,1878,60,na,1938,1920
STAT,1817,48,20-24,1865,0.02642751863152099
STAT,1824,51,na,1875,1293.3370761937613
STAT,1869,53,35-39,1922,0.007746040004917499
SIM,1823,103,na,1926,1
STAT,1891,37,45-49,1928,2.330997411676708
STAT,1898,39,20-24,1937,0.21063099301296798
STAT,1888,17,45-49,1905,0.07290057888178404
STAT,1871,22,15-19,1893,3.089679352446893
SIM,1825,53,na,1878,1208
SIM,1873,32,40-44,1905,7
STAT,1876,47,20-24,1923,0.011648504931765077
STAT,1812,43,15-19,1855,0.04970351659578013
SIM,1840,38,45-49,1878,3
STAT,1822,53,50-100,1875,0.019875560469351808
STAT,1903,24,na,1927,3158.8042667936907
STAT,1949,16,15-19,1965,49.88113008072239
STAT,1832,38,45-49,1870,1.511802713303289
SIM,1817,39,30-34,1856,5
STAT,1927,42,50-100,1969,0.13920376496528977
STAT,1890,40,na,1930,2696.4810259571177
STAT,1894,10,na,1904,3147.816647048665
STAT,1936,1,na,1937,3776.368839652668
STAT,1901,48,35-39,1949,0.103111113621053
SIM,1849,35,na,1884,1788
STAT,1835,47,30-34,1882,0.06366237829942682
SIM,1875,24,15-19,1899,3
SIM,1904,46,na,1950,3017
SIM,1864,36,40-44,1900,6
STAT,1837,47,50-100,1884,0.16094156121504388
STAT,1849,29,30-34,1878,21.208305151572908
SIM,1965,3,na,1968,4562
STAT,1929,22,25-29,1951,110.35490702067013
STAT,1881,33,35-39,1914,9.19836068749026
STAT,1891,45,na,1936,2657.4754402364956
STAT,1886,37,35-39,1923,7.05965374296481
SIM,1833,24,15-19,1857,1
SIM,1874,43,45-49,1917,1
STAT,1852,16,25-29,1868,5.238099042370203
STAT,1855,40,30-34,1895,0.8224532897669343
SIM,1906,32,45-49,1938,1
STAT,1803,52,30-34,1855,0.017061729628077442
STAT,1949,0,na,1949,4855.276497198392
SIM,1860,16,25-29,1876,6
STAT,1874,23,50-100,1897,0.392517858435364
STAT,1912,45,50-100,1957,0.20626557479176685
SIM,1870,33,30-34,1903,20
STAT,1853,46,35-39,1899,0.10411987545483506
SIM,1927,26,50-100,1953,2
SIM,1845,47,50-100,1892,1
STAT,1894,4,na,1898,3196.865051417717
STAT,1895,48,35-39,1943,0.09613296005962152
STAT,1846,15,na,1861,2057.2672495222514
STAT,1878,23,50-100,1901,0.39980328590472575
STAT,1874,35,15-19,1909,0.05473392443620816
SIM,1832,49,50-100,1881,3
SIM,1893,60,na,1953,2340
STAT,1832,23,45-49,1855,0.6580120192270136
STAT,1809,105,na,1914,0.012317100152101999
STAT,1793,82,na,1875,164.78815244139665
STAT,1825,39,15-19,1864,0.0663876753442323
STAT,1831,54,35-39,1885,0.005351926823010212
SIM,1883,18,15-19,1901,5
STAT,1828,39,35-39,1867,6.4267732103735495
STAT,1874,53,45-49,1927,0.013787212559223811
STAT,1855,22,30-34,1877,14.737817399130986
STAT,1886,36,50-100,1922,1.2313378127842163
STAT,1777,95,na,1872,2.30049603101315
SIM,1815,100,na,1915,1
SIM,1894,36,50-100,1930,1
SIM,1828,29,35-39,1857,8
STAT,1814,42,35-39,1856,5.63998730723486
STAT,1936,20,15-19,1956,4.810218706383161
SIM,1937,22,25-29,1959,89
STAT,1919,26,50-100,1945,1.019473071574176
STAT,1875,36,15-19,1911,0.05476244947362201
STAT,1867,24,15-19,1891,2.9079171572040683
STAT,1948,16,na,1964,3980.736218445
STAT,1886,19,35-39,1905,0.5447427534132838
SIM,1842,45,na,1887,1568
SIM,1871,34,30-34,1905,22
SIM,1944,0,na,1944,4153
SIM,1862,85,na,1947,191
STAT,1845,32,15-19,1877,0.11926820620164562
SIM,1921,18,na,1939,3845
STAT,1872,86,na,1958,274.0369499650798
SIM,1880,22,35-39,1902,11
STAT,1813,41,35-39,1854,6.692269644459456
SIM,1850,27,20-24,1877,10
STAT,1929,40,25-29,1969,0.08761051684137547
STAT,1842,27,20-24,1869,10.331111289312288
STAT,1850,36,45-49,1886,1.4405237940618865
STAT,1857,39,30-34,1896,3.9292588861881113
STAT,1839,39,15-19,1878,0.04382437417380843
STAT,1861,83,na,1944,311.42703193501814
SIM,1857,29,30-34,1886,24
STAT,1878,46,40-44,1924,0.16884509748225127
SIM,1866,34,20-24,1900,2
SIM,1881,38,50-100,1919,1
STAT,1939,30,40-44,1969,3.7758512923120198
SIM,1822,42,35-39,1864,4
SIM,1858,9,na,1867,2279
STAT,1873,1,na,1874,3345.126232563821
STAT,1856,68,na,1924,1130.7041793308067
STAT,1892,48,15-19,1940,2.635715860718179E-4
SIM,1878,36,40-44,1914,4
STAT,1858,49,20-24,1907,0.00871373978294672
STAT,1820,35,20-24,1855,2.0552017151187254
SIM,1833,40,na,1873,1563
SIM,1784,89,na,1873,23
STAT,1841,25,40-44,1866,2.5825796990016943
STAT,1851,50,40-44,1901,0.00783103947703588
SIM,1874,31,45-49,1905,1
STAT,1823,41,na,1864,1470.1018912459833
STAT,1941,23,50-100,1964,0.64211545476957
STAT,1910,0,na,1910,4202.073661851261
SIM,1831,93,na,1924,14
STAT,1842,48,na,1890,1582.0089867283662
SIM,1929,34,35-39,1963,11
STAT,1860,26,25-29,1886,33.062699510437675
STAT,1921,44,50-100,1965,0.12459671573824821
SIM,1827,88,na,1915,63
STAT,1883,42,35-39,1925,1.6745087883544028
STAT,1797,95,na,1892,3.2372655167301323
STAT,1819,36,na,1855,1467.8510488721163
SIM,1852,37,30-34,1889,3
SIM,1887,20,na,1907,2500
STAT,1916,6,na,1922,4003.970226593153
STAT,1867,24,20-24,1891,60.74275956576621
STAT,1848,44,35-39,1892,1.286943847455149
STAT,1882,76,na,1958,967.8450684122274
SIM,1826,29,30-34,1855,25
STAT,1924,19,15-19,1943,50.78603774676996
STAT,1862,39,40-44,1901,3.492054080213787
SIM,1866,98,na,1964,7
SIM,1930,19,15-19,1949,50
STAT,1866,43,45-49,1909,1.2941405779711126
STAT,1872,42,25-29,1914,0.6081451306353235
STAT,1822,37,45-49,1859,3.615148693530529
STAT,1830,25,30-34,1855,29.776035815749786
STAT,1846,51,40-44,1897,0.007458270758077671
STAT,1910,38,35-39,1948,2.1738600911515644
STAT,1890,71,na,1961,1708.2284587793652
STAT,1812,89,na,1901,45.183344372996245
STAT,1870,43,na,1913,2123.989268057216
STAT,1881,27,50-100,1908,0.5834915597837197
SIM,1932,19,15-19,1951,47
STAT,1895,23,15-19,1918,4.054468978436697
SIM,1891,42,35-39,1933,4
SIM,1889,32,na,1921,2807
STAT,1909,17,25-29,1926,8.026088086102773
STAT,1841,31,40-44,1872,3.637608940210953
STAT,1861,52,20-24,1913,5.757988570111822E-4
STAT,1922,19,15-19,1941,49.35530451307492
STAT,1851,84,na,1935,243.94738677831933
STAT,1900,20,35-39,1920,7.693550902494476
STAT,1833,37,20-24,1870,0.5866902455107615
STAT,1898,60,na,1958,2503.094798457728
STAT,1880,50,na,1930,2171.00151505226
STAT,1857,41,45-49,1898,1.1196673437109244
STAT,1891,19,45-49,1910,0.07597242308599321
STAT,1816,51,35-39,1867,0.022138728765664188
STAT,1893,17,na,1910,3027.231956138911
SIM,1867,20,na,1887,2112
STAT,1916,39,na,1955,3602.8789269286153
STAT,1876,18,30-34,1894,1.5503571738669477
STAT,1821,63,na,1884,991.1600694902531
STAT,1923,26,45-49,1949,1.8803837137568613
SIM,1879,32,40-44,1911,5
STAT,1834,92,na,1926,25.77917060775995
SIM,1931,26,45-49,1957,1
STAT,1844,37,30-34,1881,3.9536444556229497
STAT,1845,18,35-39,1863,0.4856255912466318
SIM,1853,18,35-39,1871,1
STAT,1872,16,50-100,1888,0.04688315944735114
SIM,1849,16,20-24,1865,17
SIM,1822,40,40-44,1862,5
SIM,1918,15,20-24,1933,26
STAT,1922,37,15-19,1959,0.020643916213064547
STAT,1940,23,40-44,1963,3.2343824429190753
SIM,1841,37,20-24,1878,4
STAT,1825,56,na,1881,1246.2341887161717
STAT,1828,32,15-19,1860,0.1533515422387666
SIM,1852,19,30-34,1871,2
SIM,1829,40,30-34,1869,4
SIM,1943,25,25-29,1968,73
SIM,1897,30,35-39,1927,18
STAT,1861,45,50-100,1906,0.19458827934982953
STAT,1856,24,45-49,1880,0.5906468249586417
SIM,1917,17,25-29,1934,9
STAT,1874,38,20-24,1912,0.7405872832977682
STAT,1872,51,50-100,1923,0.014388979865897608
STAT,1892,15,15-19,1907,7.05323263970657
STAT,1820,51,20-24,1871,0.001193093500865136
STAT,1860,43,45-49,1903,1.140759421878318
SIM,1878,91,na,1969,232
STAT,1851,35,15-19,1886,0.042493422738822166
STAT,1898,46,50-100,1944,0.17767022741827848
STAT,1895,41,15-19,1936,0.0011875832420218603
STAT,1763,100,na,1863,0.07245418634292417
STAT,1865,84,na,1949,285.57299896593713
STAT,1834,81,na,1915,334.7096430979346
STAT,1888,31,30-34,1919,19.564850868242132
STAT,1869,33,15-19,1902,0.12967327639605403
SIM,1889,18,15-19,1907,7
SIM,1894,37,30-34,1931,15
STAT,1814,40,40-44,1854,7.582617459914244
STAT,1914,33,40-44,1947,3.704943310459509
SIM,1877,37,35-39,1914,9
SIM,1801,86,na,1887,56
STAT,1869,37,35-39,1906,6.467739629988397
SIM,1833,42,45-49,1875,2
STAT,1861,91,na,1952,45.45870975673666
SIM,1909,22,15-19,1931,4
STAT,1886,37,30-34,1923,5.319580304914358
STAT,1895,35,50-100,1930,1.5279354899460327
STAT,1873,17,na,1890,2421.8247497971724
STAT,1853,30,20-24,1883,2.1076518192566516
STAT,1881,31,40-44,1912,3.971875370177515
STAT,1865,45,15-19,1910,3.4680097250342536E-4
SIM,1897,50,na,1947,2785
STAT,1872,52,30-34,1924,0.005614174067082776
SIM,1922,33,40-44,1955,4
SIM,1833,71,na,1904,819
SIM,1870,39,40-44,1909,5
SIM,1927,34,na,1961,4302
SIM,1923,21,na,1944,3969
STAT,1841,63,na,1904,1220.8059390830374
STAT,1836,27,25-29,1863,34.565436731865184
SIM,1844,27,25-29,1871,38
STAT,1805,51,25-29,1856,0.010543926793597174
STAT,1892,21,45-49,1913,0.8274267075932151
STAT,1910,14,na,1924,3683.760994848175
STAT,1889,30,35-39,1919,11.905851381850853
STAT,1851,17,15-19,1868,5.2911181912924885
STAT,1851,29,15-19,1880,0.3839803715501822
STAT,1870,27,30-34,1897,23.310116335312674
SIM,1852,55,na,1907,1586
STAT,1849,66,na,1915,1181.3834808983024
SIM,1875,24,20-24,1899,62
STAT,1815,41,40-44,1856,6.655918541284263
STAT,1904,39,20-24,1943,0.2231480506587275
STAT,1821,50,25-29,1871,0.005410864039508166
STAT,1912,33,40-44,1945,3.621526814831584
SIM,1902,21,20-24,1923,96
STAT,1807,47,20-24,1854,0.044436367774057864
STAT,1935,25,25-29,1960,84.8289191659204
STAT,1914,15,40-44,1929,0.2745541493946669
SIM,1816,42,50-100,1858,3
SIM,1823,35,40-44,1858,7
SIM,1838,40,na,1878,1576
STAT,1799,99,na,1898,0.6331770002794663
STAT,1871,26,35-39,1897,9.067652123616776
STAT,1856,39,45-49,1895,1.4601239263673134
SIM,1920,33,40-44,1953,10
STAT,1848,10,na,1858,2158.6861969306
SIM,1794,96,na,1890,2
STAT,1898,71,na,1969,2050.559691864076
STAT,1825,42,45-49,1867,1.6717342008858527
STAT,1850,43,na,1893,1615.3642090881374
SIM,1896,31,30-34,1927,31
STAT,1902,43,25-29,1945,0.05901923404619872
SIM,1922,15,40-44,1937,1
SIM,1833,30,45-49,1863,1
STAT,1882,26,40-44,1908,2.763122204575099
SIM,1821,83,na,1904,178
STAT,1892,33,45-49,1925,2.0542478249964184
SIM,1880,21,25-29,1901,64
STAT,1857,52,35-39,1909,0.006377471256817802
STAT,1856,42,40-44,1898,1.6621767401989185
STAT,1915,31,35-39,1946,8.827440032146827
SIM,1891,5,na,1896,3214
SIM,1881,20,30-34,1901,16
STAT,1897,22,40-44,1919,2.6327161066988243
STAT,1852,49,25-29,1901,0.04284915113122421
SIM,1883,47,na,1930,2126
STAT,1825,30,45-49,1855,3.8538778062124304
STAT,1930,29,20-24,1959,21.906423152730554
STAT,1932,31,35-39,1963,11.483187286453278
SIM,1917,32,20-24,1949,1
STAT,1906,23,35-39,1929,8.002534772471433
SIM,1873,29,45-49,1902,3
SIM,1891,65,na,1956,1971
SIM,1868,29,35-39,1897,9
STAT,1863,38,45-49,1901,1.6472075635105472
STAT,1851,32,45-49,1883,1.3309739941266852
STAT,1811,47,50-100,1858,0.8177356533099869
STAT,1877,25,20-24,1902,11.578564324295051
SIM,1917,13,na,1930,3972
STAT,1812,45,35-39,1857,0.47593094613438763
STAT,1847,88,na,1935,101.01171454344473
SIM,1844,30,20-24,1874,1
STAT,1832,35,50-100,1867,0.9617160953850147
STAT,1846,18,na,1864,2021.1290296119093
STAT,1892,15,45-49,1907,0.07763600674126149
SIM,1849,34,20-24,1883,2
STAT,1821,52,20-24,1873,0.0010832327117509975
SIM,1832,55,na,1887,1293
STAT,1836,42,20-24,1878,0.11930570197116751
SIM,1838,31,40-44,1869,4
STAT,1819,46,30-34,1865,0.1747155673972736
STAT,1845,54,30-34,1899,0.004077563810756845
STAT,1889,45,35-39,1934,0.16490589333055722
SIM,1923,31,35-39,1954,12
STAT,1865,73,na,1938,1019.62013395017
SIM,1851,14,na,1865,2149
STAT,1880,37,35-39,1917,7.030472786816852
SIM,1919,30,30-34,1949,18
SIM,1841,32,50-100,1873,5
SIM,1863,47,na,1910,1943
SIM,1890,41,35-39,1931,5
STAT,1842,41,35-39,1883,1.3513335206436088
STAT,1840,30,40-44,1870,3.7557287113825017
STAT,1841,43,40-44,1884,1.5787895360070565
STAT,1842,23,35-39,1865,5.20370070985501
STAT,1850,52,45-49,1902,0.010162383985176755
STAT,1916,36,50-100,1952,0.4081175692102515
STAT,1860,36,50-100,1896,0.9471482233902797
SIM,1794,99,na,1893,1
STAT,1842,30,45-49,1872,1.5316018769213704
STAT,1878,40,30-34,1918,1.1420527337821507
STAT,1894,31,20-24,1925,3.298235575785965
SIM,1886,40,30-34,1926,2
SIM,1928,17,35-39,1945,6
SIM,1914,23,35-39,1937,10
STAT,1882,41,35-39,1923,1.672122573603471
SIM,1822,48,na,1870,1385
STAT,1813,46,35-39,1859,0.4307307504929727
STAT,1831,41,25-29,1872,0.49562761391715837
SIM,1889,42,45-49,1931,2
STAT,1827,40,20-24,1867,0.15133135856271127
SIM,1850,23,35-39,1873,3
SIM,1827,37,50-100,1864,1
STAT,1897,37,40-44,1934,5.530604319558868
STAT,1852,17,50-100,1869,0.04501941430583177
STAT,1851,20,45-49,1871,0.6195248777931539
STAT,1941,21,35-39,1962,9.194738608454518
SIM,1889,36,45-49,1925,2
STAT,1818,74,na,1892,535.0551735751416
SIM,1858,28,30-34,1886,25
STAT,1863,32,35-39,1895,8.409653175433562
STAT,1866,25,15-19,1891,0.39785089982809485
STAT,1902,39,na,1941,3133.789491963808
SIM,1869,28,40-44,1897,6
SIM,1885,31,20-24,1916,1
SIM,1859,38,25-29,1897,5
STAT,1847,52,40-44,1899,0.007704888943789162
SIM,1866,37,25-29,1903,4
SIM,1891,24,35-39,1915,11
SIM,1841,33,35-39,1874,9
SIM,1911,6,na,1917,3802
SIM,1934,16,na,1950,4666
STAT,1821,71,na,1892,720.7905724963042
SIM,1909,3,na,1912,3717
STAT,1833,51,na,1884,1373.9289137769758
SIM,1830,37,45-49,1867,1
SIM,1860,73,na,1933,947
STAT,1842,25,na,1867,1932.7028355944126
STAT,1872,25,40-44,1897,2.8596708071908044
STAT,1878,49,45-49,1927,0.22724883358279646
SIM,1824,33,35-39,1857,9
SIM,1885,25,20-24,1910,13
STAT,1854,47,35-39,1901,0.10034319558375694
SIM,1820,53,na,1873,1186
SIM,1845,96,na,1941,4
STAT,1866,28,15-19,1894,0.39377893904000194
SIM,1848,17,15-19,1865,6
SIM,1850,41,35-39,1891,3
SIM,1911,28,na,1939,3424
STAT,1787,74,na,1861,430.86091168757713
STAT,1791,70,na,1861,616.2209807367728
STAT,1824,82,na,1906,246.3264476846425
STAT,1877,31,20-24,1908,2.660683360371143
STAT,1832,50,35-39,1882,0.005648614375529539
STAT,1862,35,25-29,1897,2.3422009093139784
STAT,1929,26,40-44,1955,5.513603536787376
STAT,1811,48,25-29,1859,0.188509599351631
STAT,1833,33,35-39,1866,7.858921826804938
STAT,1811,64,na,1875,888.8224725465035
SIM,1874,29,30-34,1903,26
SIM,1895,72,na,1967,1892
STAT,1773,85,na,1858,57.05448670204838
STAT,1896,42,40-44,1938,0.1947735566903434
STAT,1880,30,15-19,1910,0.1426908264134385
SIM,1853,36,30-34,1889,3
STAT,1905,37,15-19,1942,0.016546323714825752
STAT,1857,38,15-19,1895,0.041613720548110265
STAT,1909,32,20-24,1941,2.198316492139792
SIM,1859,25,na,1884,2037
SIM,1937,26,40-44,1963,3
STAT,1831,51,30-34,1882,0.003927031786009775
STAT,1898,42,45-49,1940,0.13274455016302908
SIM,1870,17,25-29,1887,8
SIM,1849,18,15-19,1867,4
STAT,1862,17,25-29,1879,5.229974461027055
STAT,1883,24,35-39,1907,5.36905611382858
STAT,1878,47,50-100,1925,0.24040988673562586
SIM,1801,94,na,1895,5
STAT,1914,17,50-100,1931,0.07320116882698471
STAT,1845,36,30-34,1881,3.9855218523150144
STAT,1833,51,35-39,1884,0.005506696160166178
SIM,1816,48,na,1864,1274
STAT,1897,43,40-44,1940,0.1959127871970983
SIM,1920,0,na,1920,4332
SIM,1940,31,35-39,1971,12
STAT,1877,43,20-24,1920,0.15456246251074882
STAT,1870,46,35-39,1916,0.12996166969659892
STAT,1821,38,40-44,1859,8.588175049849424
STAT,1832,38,50-100,1870,0.9310846346596858
SIM,1931,23,40-44,1954,6
SIM,1861,43,30-34,1904,1
STAT,1858,16,20-24,1874,15.449613727258999
SIM,1879,35,45-49,1914,1
SIM,1929,33,50-100,1962,2
STAT,1851,30,50-100,1881,0.7140003721247934
STAT,1896,45,na,1941,2837.5306595325433
STAT,1909,41,50-100,1950,0.1043769094910784
STAT,1773,82,na,1855,107.6369
STAT,1955,16,40-44,1971,1.7544762265713651
SIM,1850,29,na,1879,1842
SIM,1883,39,na,1922,2205
SIM,1945,8,na,1953,3938
STAT,1856,17,na,1873,2008.2281359981869
STAT,1940,26,45-49,1966,1.6648407297112215
SIM,1834,23,20-24,1857,49
STAT,1887,32,25-29,1919,10.821275861170875
SIM,1842,85,na,1927,149
STAT,1830,28,35-39,1858,8.84977610299696
STAT,1843,26,25-29,1869,37.83019296392687
STAT,1874,98,na,1972,22.793254888696985
STAT,1925,36,20-24,1961,0.29920059713367814
STAT,1879,41,30-34,1920,1.1403558944800791
STAT,1877,46,25-29,1923,0.056626575633897926
STAT,1886,38,na,1924,2339.8939874220405
STAT,1854,100,na,1954,0.7644844632089212
STAT,1863,10,na,1873,2290.4409403051723
STAT,1851,53,45-49,1904,0.010471319949273134
SIM,1817,78,na,1895,434
STAT,1805,56,na,1861,1072.0500771579932
STAT,1854,26,35-39,1880,8.06218702247008
STAT,1914,18,45-49,1932,0.09734584235287737
STAT,1832,103,na,1935,0.08677758040079517
STAT,1900,7,na,1907,3414.552524920603
SIM,1832,78,na,1910,446
STAT,1885,50,50-100,1935,0.014418662957318756
SIM,1860,28,20-24,1888,11
STAT,1829,51,40-44,1880,0.008370640762401042
SIM,1876,65,na,1941,1633
STAT,1835,35,30-34,1870,4.197327718181839
SIM,1851,26,25-29,1877,43
SIM,1848,35,45-49,1883,3
SIM,1895,32,25-29,1927,15
STAT,1850,33,40-44,1883,3.1608131453498434
STAT,1871,26,30-34,1897,23.664877196112162
STAT,1903,32,na,1935,3207.2809324536265
SIM,1918,18,25-29,1936,55
STAT,1841,22,50-100,1863,0.3534460162805033
SIM,1832,25,40-44,1857,2
STAT,1830,40,25-29,1870,0.5021288547530224
SIM,1843,17,30-34,1860,1
STAT,1852,28,20-24,1880,10.307068742778322
SIM,1907,14,na,1921,3631
SIM,1907,28,20-24,1935,3
STAT,1866,46,15-19,1912,3.4938447968338514E-4
SIM,1883,33,45-49,1916,3
SIM,1917,21,na,1938,3633
STAT,1912,36,45-49,1948,0.6314472100539824
SIM,1866,58,na,1924,1709
STAT,1900,49,30-34,1949,0.07006829299745536
STAT,1862,53,20-24,1915,5.850957213310173E-4
STAT,1804,50,25-29,1854,0.010964037295335174
SIM,1887,41,30-34,1928,1
SIM,1845,42,35-39,1887,6
STAT,1806,97,na,1903,1.7876056450767275
SIM,1839,25,na,1864,1903
SIM,1927,25,40-44,1952,6
SIM,1862,26,35-39,1888,8
STAT,1834,29,15-19,1863,0.36298766608030764
SIM,1828,27,40-44,1855,2
SIM,1811,53,na,1864,1190
STAT,1911,50,na,1961,3255.2857671590555
STAT,1867,17,50-100,1884,0.04442488503932601
SIM,1861,5,na,1866,2478
SIM,1944,23,na,1967,3677
STAT,1815,50,35-39,1865,0.02084227166290947
STAT,1837,58,na,1895,1248.3736503019707
STAT,1951,19,na,1970,4138.116610223805
STAT,1891,16,40-44,1907,0.21439504399355086
SIM,1833,28,30-34,1861,17
SIM,1836,37,na,1873,1633
STAT,1852,46,20-24,1898,0.009143154131727494
STAT,1910,35,30-34,1945,1.6618434272780558
STAT,1879,32,50-100,1911,0.9047302533862959
STAT,1919,25,40-44,1944,4.789958797319123
SIM,1816,42,45-49,1858,2
STAT,1837,42,35-39,1879,1.3488873589190817
SIM,1849,32,na,1881,1830
STAT,1869,43,na,1912,2098.2153493549713
STAT,1872,28,45-49,1900,1.0490861525140673
SIM,1917,4,na,1921,4043
STAT,1892,19,30-34,1911,1.8754465074407805
SIM,1778,89,na,1867,33
STAT,1848,48,20-24,1896,0.008536456964525962
SIM,1880,28,45-49,1908,2
STAT,1861,25,30-34,1886,20.186978418201402
STAT,1879,23,30-34,1902,17.534071587060094
STAT,1880,16,35-39,1896,0.5467555741800323
SIM,1895,46,50-100,1941,2
STAT,1887,46,50-100,1933,0.2602122449535868
STAT,1893,29,20-24,1922,13.961005191482561
SIM,1864,21,40-44,1885,1
STAT,1862,32,20-24,1894,2.1782269981625175
STAT,1875,33,45-49,1908,1.6853036212052612
STAT,1914,36,45-49,1950,0.6459916594340107
SIM,1844,24,20-24,1868,60
SIM,1877,37,30-34,1914,8
STAT,1860,19,15-19,1879,5.193164167666002
STAT,1895,45,30-34,1940,0.06798598968806698
SIM,1953,15,40-44,1968,1
STAT,1871,41,25-29,1912,0.6041291937126714
STAT,1925,18,20-24,1943,154.33063617837254
STAT,1870,32,50-100,1902,0.8481405553829304
SIM,1854,31,25-29,1885,12
STAT,1779,99,na,1878,0.34342150407025235
STAT,1901,42,25-29,1943,0.05889175308505544
STAT,1860,40,40-44,1900,1.7443283623335752
SIM,1872,98,na,1970,25
SIM,1849,66,na,1915,1204
STAT,1863,17,50-100,1880,0.04642372480167344
STAT,1830,46,35-39,1876,0.10394320374015427
STAT,1944,2,na,1946,4116.452803069489
SIM,1943,22,20-24,1965,114
SIM,1770,86,na,1856,51
STAT,1846,17,40-44,1863,0.16199969023683777
STAT,1858,34,20-24,1892,1.98750524459306
STAT,1887,18,40-44,1905,0.19273016570561946
STAT,1945,15,40-44,1960,1.4441810927050651
STAT,1816,96,na,1912,4.001353180812556
SIM,1846,40,30-34,1886,1
SIM,1870,40,na,1910,2169
STAT,1886,35,na,1921,2373.8907422350976
STAT,1909,57,na,1966,3048.298106033794
SIM,1881,80,na,1961,659
STAT,1832,55,na,1887,1268.9703089434593
SIM,1890,32,40-44,1922,4
STAT,1846,35,40-44,1881,3.2907637843076194
STAT,1923,23,40-44,1946,3.6847773525916554
STAT,1891,34,40-44,1925,5.027536303162833
STAT,1884,27,25-29,1911,39.49005657550999
SIM,1909,0,na,1909,3835
SIM,1934,13,na,1947,5006
STAT,1856,36,40-44,1892,3.2544769640260296
SIM,1887,23,30-34,1910,22
STAT,1803,78,na,1881,309.4068429602831
STAT,1750,104,na,1854,1.0
SIM,1902,24,25-29,1926,74
STAT,1845,84,na,1929,234.32174734500097
STAT,1859,48,30-34,1907,0.07206290112086423
STAT,1935,22,20-24,1957,143.03759793912025
STAT,1811,110,na,1921,1.1969560672680227E-4
SIM,1866,16,20-24,1882,20
STAT,1860,37,15-19,1897,0.0431132080162935
SIM,1847,54,50-100,1901,1
STAT,1833,96,na,1929,5.2128742816969265
STAT,1925,20,50-100,1945,0.7485879315797028
STAT,1843,41,50-100,1884,0.7948721905097796
SIM,1812,78,na,1890,311
SIM,1877,50,na,1927,2153
STAT,1905,41,50-100,1946,0.10060394504715704
STAT,1773,111,na,1884,8.571499924000302E-4
STAT,1824,43,40-44,1867,2.774039372106329
SIM,1899,29,30-34,1928,42
STAT,1836,24,20-24,1860,56.6103708319424
STAT,1914,49,25-29,1963,0.04939865676998142
SIM,1865,17,na,1882,2227
STAT,1897,42,50-100,1939,0.09257280084786082
SIM,1861,8,na,1869,2423
SIM,1933,18,20-24,1951,164
STAT,1856,21,40-44,1877,1.8036036128495878
SIM,1825,36,25-29,1861,1
STAT,1863,50,30-34,1913,0.0050141120640558616
STAT,1901,46,40-44,1947,0.1280571980316693
SIM,1832,43,40-44,1875,6
STAT,1837,48,45-49,1885,0.15268198287788526
SIM,1922,36,45-49,1958,3
STAT,1836,45,25-29,1881,0.03905382866793968
STAT,1846,31,25-29,1877,8.623420755512042
SIM,1849,55,na,1904,1553
STAT,1870,51,na,1921,2002.6579726668463
SIM,1854,35,40-44,1889,9
STAT,1826,38,20-24,1864,0.8119698583033128
SIM,1874,25,45-49,1899,1
STAT,1869,37,30-34,1906,4.873562019566016
STAT,1882,32,40-44,1914,3.98652694758313
STAT,1850,34,15-19,1884,0.10272155586185919
STAT,1933,31,na,1964,4817.755881288883
STAT,1866,25,45-49,1891,0.97362270971693
STAT,1923,8,na,1931,4424.7176264435975
STAT,1925,47,50-100,1972,0.25894937216409775
STAT,1887,36,40-44,1923,4.6470759956151255
STAT,1812,42,30-34,1854,4.318562117375997
STAT,1894,40,15-19,1934,0.016951321043456966
STAT,1858,109,na,1967,0.005032301649258404
STAT,1825,45,15-19,1870,4.3113235054368396E-4
STAT,1949,22,15-19,1971,5.868440891418604
SIM,1823,38,45-49,1861,4
SIM,1831,32,35-39,1863,11
SIM,1836,36,35-39,1872,13
SIM,1861,30,20-24,1891,2
STAT,1934,16,na,1950,4714.692931206568
STAT,1781,89,na,1870,32.75417256609013
SIM,1853,39,35-39,1892,12
SIM,1892,27,25-29,1919,55
STAT,1867,39,20-24,1906,0.6768617618798751
SIM,1893,38,30-34,1931,10
STAT,1831,104,na,1935,0.04067802369555364
STAT,1893,47,20-24,1940,0.00807560610362345
SIM,1805,53,na,1858,1148
STAT,1856,51,35-39,1907,0.006400268177957564
SIM,1828,70,na,1898,703
SIM,1886,43,35-39,1929,4
SIM,1823,41,40-44,1864,3
STAT,1927,44,40-44,1971,0.29539052966801754
SIM,1890,29,45-49,1919,1
STAT,1878,43,35-39,1921,1.767984925583636
STAT,1854,22,15-19,1876,2.791256090232629
STAT,1882,29,45-49,1911,1.0133514736559839
STAT,1845,39,35-39,1884,5.126989674069316
STAT,1892,36,15-19,1928,0.06675096481559321
STAT,1841,46,45-49,1887,0.1642926618749004
STAT,1838,22,30-34,1860,15.76165267091973
STAT,1883,61,na,1944,1730.1082194853434
SIM,1810,48,50-100,1858,3
STAT,1844,19,30-34,1863,1.405622067000478
STAT,1883,21,30-34,1904,16.541597340145
STAT,1911,39,na,1950,3397.5119724915385
SIM,1945,20,30-34,1965,38
SIM,1838,34,45-49,1872,2
STAT,1823,32,35-39,1855,27.039198762021403
STAT,1851,18,30-34,1869,1.412689770479311
SIM,1895,36,40-44,1931,8
SIM,1818,37,25-29,1855,2
STAT,1872,21,25-29,1893,54.44429826445137
STAT,1900,4,na,1904,3447.7518053721174
STAT,1834,47,15-19,1881,2.6258213406964154E-4
STAT,1877,28,25-29,1905,41.322830888215904
STAT,1897,25,45-49,1922,1.4122909055240833
STAT,1838,40,30-34,1878,0.9408077347253
STAT,1909,35,25-29,1944,0.8885510599544858
STAT,1876,36,30-34,1912,5.222716314425506
STAT,1832,66,na,1898,991.0414532254074
STAT,1890,23,35-39,1913,6.719310095026482
STAT,1927,30,15-19,1957,0.14951874266821738
SIM,1846,22,30-34,1868,20
STAT,1852,55,na,1907,1570.9915894557564
STAT,1929,29,45-49,1958,2.0406709049958214
STAT,1810,52,45-49,1862,0.04925646691075688
SIM,1864,32,na,1896,2137
STAT,1892,18,15-19,1910,7.00221983562924
SIM,1858,91,na,1949,22
SIM,1937,29,45-49,1966,2
SIM,1884,36,30-34,1920,6
SIM,1862,44,30-34,1906,1
STAT,1809,45,30-34,1854,0.36641725554927224
STAT,1819,49,35-39,1868,0.241623952656034
STAT,1865,44,40-44,1909,1.9048159815318892
STAT,1868,54,30-34,1922,0.005221417243859199
STAT,1947,24,35-39,1971,10.046919033849544
SIM,1869,24,na,1893,2123
SIM,1824,30,30-34,1854,17
SIM,1885,28,25-29,1913,41
STAT,1892,75,na,1967,1557.8845695923699
SIM,1891,21,30-34,1912,27
STAT,1849,91,na,1940,41.76825488536393
STAT,1937,20,30-34,1957,26.455004527536676
SIM,1869,32,na,1901,2165
STAT,1866,29,30-34,1895,21.776398158413585
SIM,1830,31,35-39,1861,14
STAT,1813,43,30-34,1856,3.8783194796848885
STAT,1938,30,25-29,1968,8.788404372744658
STAT,1902,29,45-49,1931,1.4696192993549617
STAT,1831,24,40-44,1855,2.162586569361426
STAT,1875,48,15-19,1923,3.833369488220935E-4
SIM,1905,33,40-44,1938,4
SIM,1901,29,na,1930,3182
STAT,1842,20,30-34,1862,16.2309432033805
SIM,1871,1,na,1872,3178
SIM,1873,44,40-44,1917,4
STAT,1838,40,na,1878,1720.465804834577
STAT,1899,38,25-29,1937,0.8005462830778386
STAT,1856,39,15-19,1895,0.04113025633835937
STAT,1925,46,30-34,1971,0.10231522094271471
STAT,1948,20,40-44,1968,3.6498982336728942
STAT,1949,22,45-49,1971,1.2404245608438522
STAT,1821,34,25-29,1855,27.85281085986159
STAT,1875,83,na,1958,475.0827842463937
SIM,1841,19,20-24,1860,11
SIM,1885,17,na,1902,2397
STAT,1885,38,30-34,1923,4.9912088069114375
STAT,1880,34,30-34,1914,17.206345565444785
SIM,1838,49,45-49,1887,2
SIM,1857,43,45-49,1900,2
SIM,1910,29,45-49,1939,2
STAT,1869,36,50-100,1905,1.1280967395297667
STAT,1876,68,na,1944,1490.3829068560092
STAT,1910,25,20-24,1935,16.90230857978765
STAT,1870,44,15-19,1914,0.012610786888074552
SIM,1872,33,35-39,1905,11
STAT,1818,47,30-34,1865,0.20689160775952573
SIM,1884,18,30-34,1902,1
SIM,1819,48,50-100,1867,1
SIM,1853,40,na,1893,1879
SIM,1862,22,15-19,1884,3
SIM,1764,97,na,1861,1
SIM,1850,20,30-34,1870,20
STAT,1839,36,na,1875,1724.4059249642462
STAT,1934,27,na,1961,4760.667906008324
STAT,1855,43,na,1898,1625.080397051481
SIM,1913,54,na,1967,3172
STAT,1891,35,15-19,1926,0.06628550581396395
SIM,1924,46,na,1970,4102
STAT,1864,30,30-34,1894,14.859921019769299
SIM,1820,42,30-34,1862,3
STAT,1939,33,40-44,1972,3.7692474016616644
SIM,1843,35,30-34,1878,5
SIM,1864,42,40-44,1906,5
SIM,1821,43,30-34,1864,1
STAT,1889,49,20-24,1938,0.007729663716290825
STAT,1945,19,na,1964,3795.8453635213036
SIM,1856,14,na,1870,2222
SIM,1908,39,na,1947,3216
STAT,1907,19,15-19,1926,8.189836392373927
SIM,1818,63,na,1881,839
SIM,1915,19,15-19,1934,8
STAT,1895,27,35-39,1922,11.895196929959425
SIM,1829,66,na,1895,888
STAT,1865,76,na,1941,813.2937733726083
SIM,1841,15,na,1856,2095
SIM,1863,41,40-44,1904,6
STAT,1809,52,50-100,1861,0.05236359097147873
STAT,1828,36,35-39,1864,6.868614517370423
STAT,1919,21,20-24,1940,115.37301540050599
STAT,1854,40,15-19,1894,0.010044720936921136
STAT,1929,35,50-100,1964,0.5101242560977438
STAT,1824,44,15-19,1868,0.016607703927368735
STAT,1841,28,45-49,1869,0.9367598264233902
SIM,1927,21,20-24,1948,124
STAT,1914,40,50-100,1954,0.11072008607050475
SIM,1842,14,na,1856,2088
SIM,1881,0,na,1881,2812
STAT,1891,31,35-39,1922,11.890038850108343
SIM,1935,16,30-34,1951,21
STAT,1854,23,30-34,1877,14.962505116780196
STAT,1933,15,45-49,1948,0.6346644840671138
SIM,1920,33,na,1953,3811
STAT,1897,61,na,1958,2426.2753173986375
STAT,1936,25,40-44,1961,4.21691604361918
SIM,1935,30,50-100,1965,2
STAT,1885,41,20-24,1926,0.15014787101106103
SIM,1935,18,25-29,1953,57
SIM,1835,52,na,1887,1394
SIM,1841,40,45-49,1881,4
SIM,1918,19,35-39,1937,4
STAT,1850,38,30-34,1888,3.7720783824410584
SIM,1867,29,20-24,1896,9
STAT,1866,47,25-29,1913,0.04993507765887732
SIM,1924,23,na,1947,4036
SIM,1871,90,na,1961,144
SIM,1827,57,na,1884,1115
STAT,1896,45,50-100,1941,0.1746946592993154
SIM,1853,16,15-19,1869,3
SIM,1873,91,na,1964,108
STAT,1889,66,na,1955,1911.5316479065011
STAT,1865,26,40-44,1891,2.5803511573072733
STAT,1898,32,30-34,1930,22.32795686574041
SIM,1944,25,40-44,1969,4
STAT,1927,16,30-34,1943,14.353880773920714
SIM,1918,29,na,1947,3692
SIM,1832,40,35-39,1872,1
STAT,1920,24,35-39,1944,9.82752294332337
SIM,1872,42,30-34,1914,2
STAT,1807,50,45-49,1857,0.053488512192750214
STAT,1846,69,na,1915,1034.7244202118557
STAT,1845,16,15-19,1861,5.314694836571012
SIM,1944,9,na,1953,3964
STAT,1906,42,45-49,1948,0.14279070999364513
SIM,1862,23,30-34,1885,17
STAT,1885,39,50-100,1924,1.1438962916082103
STAT,1850,74,na,1924,781.2937275415197
STAT,1864,42,30-34,1906,0.9694822011780391
STAT,1894,17,50-100,1911,0.059535923712384684
SIM,1881,42,40-44,1923,4
STAT,1841,47,20-24,1888,0.008247519785329569
STAT,1852,35,30-34,1887,4.156670606363772
SIM,1869,86,na,1955,174
STAT,1780,84,na,1864,87.69243508859415
STAT,1816,53,20-24,1869,0.0018231742995632966
STAT,1911,24,25-29,1935,82.22132783129933
SIM,1860,35,30-34,1895,6
SIM,1910,15,15-19,1925,8
STAT,1876,14,na,1890,2510.4522788073077
STAT,1902,15,15-19,1917,7.948394010367949
STAT,1927,45,na,1972,4377.48076445629
STAT,1948,24,20-24,1972,120.53849411410478
SIM,1878,30,30-34,1908,21
STAT,1883,44,20-24,1927,0.14505500234405377
STAT,1839,42,50-100,1881,0.7424200383165341
SIM,1919,31,40-44,1950,10
STAT,1862,54,30-34,1916,0.004664881029297339
STAT,1873,42,40-44,1915,2.1541938986895075
SIM,1848,39,na,1887,1787
STAT,1907,17,na,1924,3504.195268150974
STAT,1918,25,20-24,1943,18.47588803007134
STAT,1790,94,na,1884,4.060261845911181
STAT,1858,74,na,1932,823.0520725894771
STAT,1865,41,35-39,1906,1.561517406220122
STAT,1894,29,50-100,1923,0.7718111640042254
SIM,1865,31,30-34,1896,16
STAT,1868,19,na,1887,2292.0438154859407
STAT,1949,9,na,1958,4317.887609354477
STAT,1886,15,20-24,1901,17.77749020368925
SIM,1856,29,45-49,1885,2
STAT,1888,31,50-100,1919,1.0267180845045814
STAT,1931,36,45-49,1967,0.8537100782126812
SIM,1812,89,na,1901,41
STAT,1887,31,na,1918,2531.4322584528404
SIM,1910,26,40-44,1936,4
STAT,1882,40,25-29,1922,0.5962592677811963
SIM,1838,94,na,1932,14
SIM,1876,34,na,1910,2335
SIM,1848,34,35-39,1882,9
STAT,1909,45,35-39,1954,0.1129668638546339
SIM,1879,3,na,1882,2900
SIM,1852,44,na,1896,1758
SIM,1873,26,40-44,1899,2
STAT,1896,20,30-34,1916,22.37190100070952
STAT,1907,25,45-49,1932,1.5509603080479408
STAT,1772,89,na,1861,29.787775935190567
STAT,1951,18,30-34,1969,13.708137199522584
STAT,1871,45,40-44,1916,0.16193472237044482
SIM,1889,35,35-39,1924,10
STAT,1825,87,na,1912,99.61157991606242
STAT,1870,49,40-44,1919,0.15516578774950943
STAT,1854,48,45-49,1902,0.16780690736716158
STAT,1873,31,na,1904,2297.604790242947
STAT,1906,21,50-100,1927,0.562653768857729
STAT,1944,15,20-24,1959,137.90060870990547
SIM,1778,80,na,1858,194
SIM,1870,43,na,1913,2120
STAT,1879,23,35-39,1902,5.744335216468734
STAT,1880,52,25-29,1932,0.003502012437454097
STAT,1801,97,na,1898,2.0442435166773727
STAT,1911,48,50-100,1959,0.20167462185217047
STAT,1932,32,45-49,1964,1.9761915760241218
SIM,1873,41,35-39,1914,2
STAT,1927,18,25-29,1945,50.77434379132288
STAT,1865,24,50-100,1889,0.3492511310349778
STAT,1848,29,45-49,1877,0.9412523386617294
STAT,1844,40,20-24,1884,0.11714608000212409
STAT,1859,44,15-19,1903,0.010271032862061385
SIM,1851,19,15-19,1870,4
SIM,1952,15,20-24,1967,153
STAT,1921,20,na,1941,3920.1136422119157
STAT,1934,31,50-100,1965,1.0670158612006426
STAT,1892,37,25-29,1929,3.4061098018122413
SIM,1887,23,35-39,1910,8
STAT,1883,41,na,1924,2149.5834262371773
SIM,1863,61,na,1924,1601
STAT,1902,31,20-24,1933,3.6183042676674826
SIM,1840,41,40-44,1881,4
SIM,1808,50,na,1858,1244
STAT,1842,43,20-24,1885,0.11551723273619545
STAT,1887,51,na,1938,2285.760942845075
STAT,1934,37,40-44,1971,1.9515026242331772
STAT,1843,19,15-19,1862,5.407215606621172
STAT,1782,99,na,1881,0.31842967954709056
SIM,1909,26,30-34,1935,40
STAT,1900,43,20-24,1943,0.014349168649284842
STAT,1889,32,na,1921,2783.0877743751616
STAT,1856,34,50-100,1890,0.6721204578821597
SIM,1920,20,25-29,1940,104
STAT,1825,46,25-29,1871,0.06123395484138437
SIM,1911,50,na,1961,3299
SIM,1936,30,30-34,1966,19
STAT,1859,29,20-24,1888,8.868558774419078
SIM,1861,80,na,1941,454
STAT,1833,40,45-49,1873,1.1323216341972995
STAT,1914,5,na,1919,3915.6245396515174
STAT,1840,41,30-34,1881,0.8459618586132951
SIM,1863,22,35-39,1885,4
SIM,1913,51,na,1964,3218
STAT,1919,24,25-29,1943,94.95371787428576
SIM,1909,46,na,1955,3188
STAT,1942,22,na,1964,3616.936684240138
STAT,1856,50,25-29,1906,0.0026583748085857195
SIM,1922,14,na,1936,4348
STAT,1861,33,15-19,1894,0.11124405695227205
SIM,1847,36,40-44,1883,9
STAT,1877,40,15-19,1917,0.01367461383527384
SIM,1846,22,35-39,1868,5
SIM,1897,27,40-44,1924,3
STAT,1924,47,25-29,1971,0.05966438643857401
SIM,1883,16,na,1899,2395
STAT,1838,109,na,1947,4.852328602335446E-4
STAT,1844,33,15-19,1877,0.11831426338995776
SIM,1868,28,25-29,1896,35
STAT,1905,46,45-49,1951,0.18225045570630813
STAT,1840,48,15-19,1888,2.773360214109403E-4
STAT,1832,41,40-44,1873,1.6903760305707547
STAT,1848,64,na,1912,1252.3543101776781
SIM,1848,31,50-100,1879,4
SIM,1849,38,50-100,1887,1
SIM,1945,21,40-44,1966,3
STAT,1844,18,20-24,1862,15.727298877544376
STAT,1805,52,50-100,1857,0.04406077596963686
SIM,1833,23,35-39,1856,4
STAT,1830,47,45-49,1877,0.1729700963082156
SIM,1876,68,na,1944,1532
STAT,1881,60,na,1941,1739.622453004987
STAT,1855,22,35-39,1877,4.828254697111591
SIM,1882,39,30-34,1921,3
STAT,1806,106,na,1912,0.004040129280858492
STAT,1849,25,45-49,1874,0.9624473142627349
SIM,1855,47,50-100,1902,3
STAT,1889,27,40-44,1916,3.493642316271159
STAT,1804,54,40-44,1858,0.030075691557395326
STAT,1926,42,30-34,1968,0.1489079054905208
STAT,1857,31,30-34,1888,13.219978917837905
STAT,1850,30,35-39,1880,8.367752517475383
STAT,1852,89,na,1941,79.81676084614546
STAT,1928,33,35-39,1961,10.788964920347905
STAT,1900,45,15-19,1945,2.9866053208866335E-4
SIM,1868,39,na,1907,2104
STAT,1841,34,50-100,1875,0.7449687803307182
STAT,1865,49,30-34,1914,0.08136244847363559
SIM,1894,15,20-24,1909,22
STAT,1898,49,na,1947,2817.607907865329
SIM,1872,44,na,1916,2144
STAT,1937,21,40-44,1958,3.0937823107512634
SIM,1915,22,40-44,1937,3
STAT,1937,9,na,1946,3658.0406067628765
STAT,1896,14,na,1910,3213.907388985787
STAT,1813,47,45-49,1860,0.7138647484870826
SIM,1823,41,na,1864,1431
SIM,1836,33,30-34,1869,15
SIM,1863,16,na,1879,2262
SIM,1901,17,30-34,1918,2
STAT,1859,51,20-24,1910,5.589973916091902E-4
STAT,1865,48,20-24,1913,0.010171901728855508
SIM,1894,53,na,1947,2724
STAT,1908,21,15-19,1929,4.63598890273083
SIM,1932,9,na,1941,4841
SIM,1916,21,15-19,1937,4
STAT,1890,29,na,1919,2736.7975980828824
STAT,1907,48,35-39,1955,0.10819381636706771
STAT,1924,40,40-44,1964,0.2818673664707873
SIM,1848,70,na,1918,1000
SIM,1903,21,na,1924,3155
STAT,1856,46,50-100,1902,0.18223389455176092
STAT,1902,26,40-44,1928,4.00723522280913
STAT,1829,32,35-39,1861,9.882443067180336
STAT,1839,36,40-44,1875,3.524405719997335
STAT,1880,38,45-49,1918,1.9716942897069132
SIM,1936,31,40-44,1967,7
STAT,1818,43,15-19,1861,0.03186451713532287
STAT,1896,23,35-39,1919,7.263271748796112
STAT,1905,36,na,1941,3257.2560334936347
STAT,1807,48,30-34,1855,0.35265904788336133
STAT,1807,82,na,1889,175.96085262951263
STAT,1821,97,na,1918,2.901003752918518
STAT,1835,43,15-19,1878,0.010192807149866409
STAT,1907,22,40-44,1929,2.891216085777417
STAT,1903,39,35-39,1942,2.0311876008885394
STAT,1875,30,40-44,1905,4.242780379964269
STAT,1814,51,30-34,1865,0.015758601703604005
STAT,1824,48,30-34,1872,0.11215782620456863
STAT,1923,49,30-34,1972,0.09794851918326165
SIM,1900,34,30-34,1934,27
STAT,1886,17,15-19,1903,5.923418458998122
STAT,1828,33,30-34,1861,18.142545541451355
STAT,1926,5,na,1931,4657.56198496037
SIM,1926,25,20-24,1951,20
STAT,1959,2,na,1961,4861.771729480245
STAT,1867,52,50-100,1919,0.013324831521921085
SIM,1852,24,na,1876,1964
STAT,1865,22,na,1887,2054.943332782634
STAT,1860,98,na,1958,3.9465680344568153
STAT,1865,40,25-29,1905,0.5568187643408952
STAT,1871,47,35-39,1918,0.13050481357184893
SIM,1852,18,20-24,1870,12
STAT,1923,41,35-39,1964,0.22267976752365853
STAT,1763,92,na,1855,3.67308
SIM,1859,2,na,1861,2719
SIM,1863,44,45-49,1907,2
SIM,1883,30,40-44,1913,4
STAT,1871,101,na,1972,5.172863681743738
STAT,1808,106,na,1914,0.004719296280988017
STAT,1895,24,30-34,1919,21.821511827421777
STAT,1917,26,15-19,1943,0.7017693907786117
STAT,1848,51,45-49,1899,0.010505108207593575
STAT,1885,34,15-19,1919,0.13288364201699154
STAT,1925,35,50-100,1960,0.47693243273551233
STAT,1908,47,40-44,1955,0.134668263482838
SIM,1888,37,40-44,1925,4
STAT,1881,46,na,1927,2058.005229514654
SIM,1774,90,na,1864,16
SIM,1858,15,na,1873,2178
STAT,1891,39,30-34,1930,6.169189730487621
STAT,1924,48,35-39,1972,0.14461445844192142
STAT,1878,94,na,1972,97.98194634414655
STAT,1928,31,40-44,1959,4.625710856787247
SIM,1927,24,25-29,1951,102
SIM,1865,96,na,1961,13
SIM,1785,82,na,1867,119
SIM,1911,39,35-39,1950,9
STAT,1867,31,na,1898,2125.309060028632
STAT,1818,50,20-24,1868,0.001573698955051089
STAT,1837,20,50-100,1857,0.344285456663324
STAT,1874,39,30-34,1913,5.094084451717457
STAT,1838,22,35-39,1860,5.163673255111503
STAT,1874,19,45-49,1893,0.06273270171755095
STAT,1869,19,35-39,1888,0.5027330270157954
STAT,1824,40,35-39,1864,2.410204432204446
STAT,1933,38,35-39,1971,3.109181254249588
STAT,1936,28,na,1964,3384.625202593916
STAT,1917,42,20-24,1959,0.017410067242988887
SIM,1831,41,30-34,1872,1
STAT,1854,98,na,1952,2.3392557531718943
STAT,1845,22,na,1867,1869.6729844203387
SIM,1939,24,20-24,1963,98
STAT,1960,9,na,1969,4833.8331522123235
STAT,1881,49,15-19,1930,3.5723934221429225E-4
SIM,1832,24,na,1856,1735
SIM,1880,73,na,1953,1203
STAT,1918,41,25-29,1959,0.07182634156496882
SIM,1909,25,20-24,1934,13
STAT,1850,15,40-44,1865,0.15921783365072267
SIM,1902,34,35-39,1936,10
STAT,1890,32,30-34,1922,20.166445250523573
STAT,1890,43,na,1933,2650.2601670532554
SIM,1894,17,15-19,1911,4
STAT,1832,89,na,1921,63.521507316595994
SIM,1817,47,na,1864,1399
STAT,1782,107,na,1889,0.007398863396731062
SIM,1898,26,45-49,1924,2
STAT,1823,41,30-34,1864,1.5326806665922712
STAT,1883,47,25-29,1930,0.053081318218171
STAT,1918,40,15-19,1958,0.0015467097338832743
STAT,1887,30,30-34,1917,18.5944033483433
SIM,1903,24,40-44,1927,2
STAT,1812,48,40-44,1860,0.5542361975121834
STAT,1863,41,na,1904,1927.969201703312
STAT,1818,53,25-29,1871,0.0071143566380865
STAT,1920,21,30-34,1941,30.27774788212655
SIM,1891,31,45-49,1922,4
SIM,1954,2,na,1956,4439
STAT,1900,44,na,1944,2998.5195385179345
SIM,1869,18,30-34,1887,1
SIM,1882,82,na,1964,615
STAT,1901,35,20-24,1936,0.22209277166738395
SIM,1918,16,30-34,1934,2
STAT,1845,17,25-29,1862,5.044955351059464
SIM,1913,31,na,1944,3435
STAT,1874,44,50-100,1918,1.0062690161134107
STAT,1908,28,30-34,1936,34.86052004681195
STAT,1868,41,20-24,1909,0.14389386024060896
STAT,1841,40,35-39,1881,1.3208317214104257
STAT,1767,106,na,1873,0.009018556197348098
STAT,1918,29,50-100,1947,0.9935121598388547
STAT,1932,39,30-34,1971,2.3084994803218435
SIM,1886,23,15-19,1909,2
SIM,1891,34,50-100,1925,1
STAT,1807,68,na,1875,746.8311355788749
STAT,1878,23,15-19,1901,3.2344082106140393
STAT,1869,18,25-29,1887,5.222677141636839
SIM,1882,44,50-100,1926,3
STAT,1871,23,30-34,1894,16.63042982478316
SIM,1935,15,20-24,1950,165
STAT,1883,31,45-49,1914,1.6211456791482615
SIM,1913,19,15-19,1932,6
SIM,1876,88,na,1964,264
SIM,1783,81,na,1864,173
STAT,1881,42,30-34,1923,1.047371879093503
SIM,1870,63,na,1933,1629
STAT,1925,43,25-29,1968,0.08155424391886536
SIM,1898,35,na,1933,3014
SIM,1858,0,na,1858,3023
STAT,1881,15,50-100,1896,0.04489527243740143
STAT,1864,45,35-39,1909,0.11938194534063361
STAT,1850,40,45-49,1890,1.0642697427863277
SIM,1951,16,15-19,1967,47
STAT,1824,50,45-49,1874,0.01708689867965644
STAT,1836,26,15-19,1862,0.37341158399011387
STAT,1947,8,na,1955,4182.518583729602
SIM,1889,32,30-34,1921,25
STAT,1905,19,15-19,1924,8.05813702581833
STAT,1895,49,45-49,1944,0.1606882201079644
SIM,1896,34,na,1930,2989
SIM,1869,27,30-34,1896,23
SIM,1824,40,45-49,1864,2
STAT,1857,19,45-49,1876,0.056507737220795766
STAT,1800,78,na,1878,315.15742994629784
SIM,1905,22,50-100,1927,1
SIM,1930,23,na,1953,4320
SIM,1919,18,40-44,1937,1
STAT,1853,17,na,1870,2047.7777450460187
STAT,1875,15,45-49,1890,0.06369253101056209
STAT,1943,16,15-19,1959,45.474854948438534
STAT,1935,8,na,1943,5150.584837335001
SIM,1853,17,25-29,1870,8
STAT,1896,68,na,1964,2122.597888369316
STAT,1770,94,na,1864,2.88069083313124
STAT,1885,44,25-29,1929,0.5962268838294991
STAT,1918,54,na,1972,3596.8039330003044
STAT,1879,53,30-34,1932,0.005783364941864271
SIM,1916,28,30-34,1944,44
STAT,1865,29,45-49,1894,0.946321752790279
STAT,1814,43,45-49,1857,4.451967874894038
SIM,1843,95,na,1938,10
STAT,1903,35,na,1938,3221.8073285166283
STAT,1891,41,45-49,1932,1.7579499031393413
STAT,1891,38,20-24,1929,0.8968880484715863
STAT,1892,30,40-44,1922,5.171603655159743
SIM,1848,31,30-34,1879,27
STAT,1878,40,na,1918,2295.9299142482446
STAT,1867,46,30-34,1913,0.0861054238767617
SIM,1877,34,30-34,1911,20
SIM,1883,37,25-29,1920,3
STAT,1884,42,15-19,1926,0.012876152262181565
STAT,1871,48,45-49,1919,0.218247077289264
STAT,1906,41,35-39,1947,0.17376088033343703
SIM,1818,40,na,1858,1397
STAT,1927,15,20-24,1942,160.00632334584517
STAT,1927,19,50-100,1946,0.43776401262001163
SIM,1874,53,na,1927,2007
STAT,1820,54,25-29,1874,0.005394582906422549
SIM,1850,30,45-49,1880,3
STAT,1816,40,45-49,1856,4.844451810355401
STAT,1932,12,na,1944,4956.57172086023
STAT,1824,47,20-24,1871,0.014101866412444035
STAT,1850,54,na,1904,1474.1505804540602
STAT,1912,30,50-100,1942,0.7745618785888155
SIM,1936,33,35-39,1969,9
STAT,1907,45,na,1952,3153.286909504642
STAT,1912,48,45-49,1960,0.19672616759687184
SIM,1839,29,45-49,1868,2
SIM,1909,29,35-39,1938,16
STAT,1925,23,50-100,1948,0.7418485042108856
SIM,1891,11,na,1902,3183
STAT,1875,37,25-29,1912,2.794370335150247
SIM,1845,76,na,1921,662
SIM,1943,25,20-24,1968,20
SIM,1861,35,na,1896,2057
SIM,1895,30,30-34,1925,34
STAT,1810,88,na,1898,62.168438498025495
SIM,1866,44,na,1910,2006
SIM,1898,25,35-39,1923,14
STAT,1935,25,20-24,1960,23.52560063089737
SIM,1870,2,na,1872,2931
SIM,1839,44,35-39,1883,1
STAT,1822,51,25-29,1873,0.004850630609167687
STAT,1947,11,na,1958,4181.054872865429
SIM,1910,7,na,1917,3658
SIM,1827,27,25-29,1854,37
STAT,1862,16,15-19,1878,5.509606394748672
STAT,1898,35,35-39,1933,9.13094433977436
SIM,1822,43,45-49,1865,2
STAT,1892,34,20-24,1926,3.170359093256593
STAT,1915,7,na,1922,3938.9805893543885
STAT,1838,74,na,1912,756.9027951565171
SIM,1835,66,na,1901,1023
SIM,1858,94,na,1952,9
STAT,1838,52,30-34,1890,0.004038257300345608
SIM,1877,18,25-29,1895,5
STAT,1853,49,40-44,1902,0.12431236481530897
STAT,1912,20,25-29,1932,84.10654791513542
STAT,1909,42,30-34,1951,0.11293578561808212
STAT,1780,101,na,1881,0.11414309578371985
STAT,1844,43,25-29,1887,0.45581717873816024
SIM,1871,38,45-49,1909,1
SIM,1894,18,25-29,1912,11
SIM,1887,20,30-34,1907,24
SIM,1926,29,50-100,1955,2
STAT,1881,34,45-49,1915,1.5769986836902463
SIM,1830,74,na,1904,681
SIM,1853,71,na,1924,1020
STAT,1869,34,30-34,1903,15.82911512147233
STAT,1841,91,na,1932,39.64740821668384
STAT,1920,38,50-100,1958,0.4338520972294734
STAT,1855,52,30-34,1907,0.0041933716118618255
SIM,1791,68,na,1859,673
STAT,1879,16,25-29,1895,5.609252132499065
SIM,1852,43,25-29,1895,3
SIM,1870,16,15-19,1886,9
STAT,1886,18,25-29,1904,5.64127954742128
SIM,1889,52,na,1941,2487
SIM,1890,49,na,1939,2628
STAT,1837,22,15-19,1859,2.726272778850955
STAT,1865,51,45-49,1916,0.012517714173771288
SIM,1857,24,35-39,1881,5
SIM,1874,25,na,1899,2286
STAT,1929,26,na,1955,4431.3657189252335
STAT,1840,33,45-49,1873,1.4638837811674419
STAT,1870,29,na,1899,2193.3426761026326
STAT,1804,53,30-34,1857,0.017349881951551595
STAT,1863,27,na,1890,1981.8013154312453
STAT,1833,65,na,1898,1025.9594143134084
STAT,1928,30,30-34,1958,18.633463535254283
SIM,1879,62,na,1941,1767
STAT,1900,28,30-34,1928,32.88696303311493
STAT,1919,50,na,1969,3730.4207567365884
STAT,1902,41,30-34,1943,0.10691389121736938
SIM,1910,31,20-24,1941,1
SIM,1910,49,50-100,1959,3
STAT,1907,45,30-34,1952,0.07651552266030409
STAT,1823,44,35-39,1867,2.2176215197499305
STAT,1839,39,45-49,1878,1.5557650981516822
SIM,1847,39,45-49,1886,1
SIM,1934,35,25-29,1969,2
STAT,1825,43,20-24,1868,0.17350513335909548
SIM,1928,24,45-49,1952,1
STAT,1834,45,50-100,1879,0.18176923772884845
STAT,1926,35,25-29,1961,1.1388697438157813
STAT,1830,51,50-100,1881,0.009930554103150293
STAT,1910,32,25-29,1942,8.416498447580098
STAT,1856,79,na,1935,517.263773321863
STAT,1902,40,20-24,1942,0.01485071355468255
STAT,1922,43,40-44,1965,0.2708053672202033
STAT,1890,35,35-39,1925,8.247001291738284
STAT,1829,110,na,1939,1.6938105578719444E-4
SIM,1904,20,40-44,1924,2
STAT,1863,31,25-29,1894,8.540357016861707
STAT,1923,25,50-100,1948,1.0869879188033105
STAT,1859,54,25-29,1913,0.0025969759290505336
SIM,1792,64,na,1856,775
SIM,1868,25,20-24,1893,11
STAT,1830,44,40-44,1874,1.66413586740877
STAT,1879,56,na,1935,2014.0000612805736
SIM,1904,57,na,1961,2802
STAT,1842,46,25-29,1888,0.04155351454353567
STAT,1863,53,35-39,1916,0.007034293548490189
STAT,1867,29,50-100,1896,0.5633520895436823
SIM,1902,31,30-34,1933,32
SIM,1921,49,na,1970,3792
STAT,1910,31,15-19,1941,0.11749668921540989
SIM,1842,45,50-100,1887,1
STAT,1860,13,na,1873,2104.237397948387
STAT,1942,27,50-100,1969,0.9868478816964462
SIM,1842,36,25-29,1878,5
STAT,1802,59,na,1861,972.400744408497
SIM,1814,50,na,1864,1254
STAT,1834,36,25-29,1870,2.239958305448739
STAT,1849,42,50-100,1891,0.7605433239851604
SIM,1915,25,45-49,1940,1
SIM,1798,80,na,1878,226
SIM,1881,35,na,1916,1968
STAT,1916,46,20-24,1962,0.010734291592703872
STAT,1926,45,35-39,1971,0.15101043259127883
SIM,1885,62,na,1947,1724
STAT,1806,51,40-44,1857,0.030328097023507066
STAT,1830,28,50-100,1858,0.5867112029756298
STAT,1829,25,50-100,1854,1.835377828545067
STAT,1830,43,30-34,1873,0.8624095673986754
STAT,1842,45,15-19,1887,2.922866417975476E-4
SIM,1909,28,25-29,1937,56
STAT,1816,73,na,1889,568.5738291340638
STAT,1850,18,45-49,1868,0.05586462670051839
STAT,1863,52,25-29,1915,0.0029256773753399017
STAT,1914,27,na,1941,3567.0043809800695
STAT,1913,22,35-39,1935,8.617494893291303
STAT,1903,55,na,1958,2835.9794884261564
SIM,1850,43,na,1893,1696
STAT,1933,35,30-34,1968,2.349256969815971
SIM,1807,57,na,1864,1015
STAT,1817,58,na,1875,1057.3312359856368
STAT,1896,45,45-49,1941,0.16786620383692383
STAT,1838,24,50-100,1862,0.35568062212739604
STAT,1855,21,50-100,1876,0.3398443636087369
SIM,1928,39,na,1967,4475
SIM,1946,24,na,1970,3821
SIM,1926,17,35-39,1943,6
SIM,1900,37,35-39,1937,3
SIM,1942,18,30-34,1960,14
STAT,1856,100,na,1956,0.9317683885631489
SIM,1865,34,35-39,1899,11
STAT,1883,47,na,1930,2073.342276497654
SIM,1825,42,na,1867,1431
STAT,1862,79,na,1941,563.3654600232571
STAT,1861,94,na,1955,15.67861149943453
STAT,1934,18,30-34,1952,15.533611123896163
SIM,1890,18,na,1908,3021
SIM,1831,44,35-39,1875,1
STAT,1857,34,35-39,1891,7.477567477957895
STAT,1872,55,na,1927,1960.6107704852118
SIM,1835,19,30-34,1854,1
STAT,1785,93,na,1878,6.794016982269184
STAT,1948,23,40-44,1971,3.6461766020211943
STAT,1869,12,na,1881,2432.095082272609
SIM,1879,16,35-39,1895,1
STAT,1928,34,45-49,1962,1.8565526320042802
STAT,1871,44,30-34,1915,1.062180634806317
STAT,1826,45,30-34,1871,0.0929696217322511
STAT,1883,46,15-19,1929,3.713980155043743E-4
STAT,1924,28,15-19,1952,0.7738464196686154
STAT,1843,41,na,1884,1738.9719621940978
STAT,1829,91,na,1920,35.51903574733576
STAT,1850,37,20-24,1887,0.5512730324971696
SIM,1767,94,na,1861,1
STAT,1849,24,35-39,1873,5.012610596830436
SIM,1931,25,50-100,1956,1
STAT,1887,85,na,1972,646.0228595694981
SIM,1936,34,45-49,1970,1
STAT,1858,40,na,1898,1731.3795788245116
STAT,1886,0,na,1886,3314.899592852436
SIM,1845,22,15-19,1867,2
SIM,1921,22,35-39,1943,11
STAT,1829,54,45-49,1883,0.009894305028921666
SIM,1878,69,na,1947,1448
STAT,1883,34,50-100,1917,0.841058632540568
SIM,1852,78,na,1930,573
STAT,1927,19,35-39,1946,4.9029578497454995
SIM,1935,19,35-39,1954,6
STAT,1846,103,na,1949,0.10118848816462618
STAT,1866,44,20-24,1910,0.13645728949473215
SIM,1865,41,45-49,1906,4
STAT,1854,13,na,1867,2047.0410483901942
STAT,1893,36,30-34,1929,6.418863642729583
STAT,1888,39,na,1927,2602.8317670661145
STAT,1957,4,na,1961,4897.473114268519
SIM,1794,73,na,1867,485
STAT,1820,49,45-49,1869,0.3778778094612848
STAT,1822,52,35-39,1874,0.011557433573280762
STAT,1841,107,na,1948,0.0032266158478720325
SIM,1952,4,na,1956,4396
SIM,1910,57,na,1967,3020
SIM,1931,25,na,1956,4533
STAT,1887,8,na,1895,2746.4115615932005
STAT,1910,23,50-100,1933,0.5817692966373861
STAT,1936,18,50-100,1954,0.33790779518969805
STAT,1910,36,40-44,1946,1.3586384982837163
SIM,1883,67,na,1950,1434
STAT,1927,30,50-100,1957,0.961997899002883
SIM,1920,29,35-39,1949,19
STAT,1930,17,50-100,1947,0.45760646832649465
STAT,1872,40,30-34,1912,1.10111775396561
STAT,1874,33,na,1907,2294.3354367313427
STAT,1916,24,50-100,1940,0.6472579226318155
STAT,1809,91,na,1900,24.342862489904775
SIM,1920,24,40-44,1944,3
STAT,1846,53,35-39,1899,0.005972549981144563
STAT,1816,38,30-34,1854,19.690249162928048
SIM,1948,17,20-24,1965,123
STAT,1941,26,na,1967,3662.3040670661367
STAT,1947,24,50-100,1971,0.7020908602218248
STAT,1764,91,na,1855,12.243599999999999
STAT,1896,2,na,1898,3328.1622931873753
STAT,1893,32,15-19,1925,0.1706921186035022
STAT,1912,49,na,1961,3315.0904129869987
STAT,1936,7,na,1943,3614.7202540032863
STAT,1883,29,30-34,1912,23.148455444263195
STAT,1887,17,30-34,1904,1.6839175266872388
STAT,1846,38,na,1884,1716.7717957531177
SIM,1856,41,35-39,1897,4
STAT,1883,40,40-44,1923,2.103544009910417
SIM,1877,15,20-24,1892,8
SIM,1835,83,na,1918,222
SIM,1843,28,20-24,1871,11
STAT,1912,24,40-44,1936,3.1516939661652366
STAT,1835,53,25-29,1888,0.002208052015447527
STAT,1872,49,50-100,1921,0.22801616074274847
SIM,1862,39,50-100,1901,1
STAT,1876,45,na,1921,2216.044287470151
STAT,1909,40,na,1949,3317.9819639718553
SIM,1891,2,na,1893,3250
SIM,1807,88,na,1895,50
STAT,1898,17,40-44,1915,0.23390135723991065
SIM,1911,17,25-29,1928,8
STAT,1847,15,35-39,1862,0.509888579990845
SIM,1852,75,na,1927,740
STAT,1929,17,45-49,1946,0.6022942874595045
SIM,1880,40,30-34,1920,3
STAT,1901,24,30-34,1925,23.40550404382603
SIM,1863,43,35-39,1906,3
STAT,1910,34,na,1944,3414.51656499934
STAT,1881,52,40-44,1933,0.009551611815578193
STAT,1837,41,25-29,1878,0.4845149671081848
SIM,1858,20,35-39,1878,4
STAT,1864,4,na,1868,2558.2709973481706
STAT,1835,28,20-24,1863,9.471174449248922
SIM,1872,34,45-49,1906,3
STAT,1895,20,15-19,1915,4.0913023737245435
SIM,1828,26,30-34,1854,29
STAT,1826,103,na,1929,0.07833295798144994
SIM,1873,45,50-100,1918,2
SIM,1908,30,na,1938,3312
STAT,1893,44,15-19,1937,0.0011339368136014443
STAT,1933,16,25-29,1949,54.93713050678227
SIM,1788,79,na,1867,245
SIM,1868,44,30-34,1912,7
STAT,1861,40,20-24,1901,0.12584222559366878
STAT,1912,29,35-39,1941,13.873853021316576
STAT,1832,80,na,1912,374.0395192532892
STAT,1866,38,na,1904,2041.8522100087378
SIM,1935,32,na,1967,4944
STAT,1903,17,25-29,1920,7.616270346445496
SIM,1790,83,na,1873,101
STAT,1848,41,35-39,1889,1.3197471244904957
STAT,1821,40,na,1861,1520.7416126725805
STAT,1942,28,35-39,1970,14.87817299672156
SIM,1839,26,40-44,1865,3
SIM,1941,16,25-29,1957,50
SIM,1864,34,50-100,1898,6
STAT,1851,33,20-24,1884,2.041800281139948
STAT,1811,49,35-39,1860,0.45037359606558236
SIM,1893,41,50-100,1934,1
SIM,1894,34,30-34,1928,31
STAT,1884,46,30-34,1930,0.09062321263551687
STAT,1912,45,40-44,1957,0.14378121510643216
STAT,1840,51,40-44,1891,0.007366710069652535
STAT,1957,1,na,1958,4903.600183600877
SIM,1850,28,30-34,1878,26
SIM,1879,28,35-39,1907,15
SIM,1932,23,20-24,1955,121
SIM,1827,43,30-34,1870,3
STAT,1867,42,15-19,1909,0.012234244584729558
SIM,1899,21,35-39,1920,9
STAT,1928,18,40-44,1946,1.6607494496244037
SIM,1833,34,50-100,1867,4
SIM,1929,15,na,1944,4558
STAT,1843,44,50-100,1887,0.7649008158166116
STAT,1870,33,25-29,1903,9.441255398434501
SIM,1916,18,20-24,1934,28
STAT,1873,21,40-44,1894,2.0042143324900725
SIM,1899,62,na,1961,2503
STAT,1842,28,30-34,1870,22.016805502874153
STAT,1907,46,50-100,1953,0.19276383572178618
SIM,1898,22,30-34,1920,26
STAT,1908,18,20-24,1926,24.77314402486229
SIM,1884,29,20-24,1913,11
STAT,1886,34,30-34,1920,17.277762898337865
SIM,1900,17,15-19,1917,8
STAT,1853,26,15-19,1879,0.39260361846648223
STAT,1857,16,40-44,1873,0.16105074062395766
STAT,1889,42,35-39,1931,2.109301321501921
SIM,1915,26,25-29,1941,65
STAT,1876,29,20-24,1905,11.35938908157407
SIM,1936,18,40-44,1954,1
SIM,1881,89,na,1970,215
SIM,1828,42,35-39,1870,4
STAT,1861,15,na,1876,2094.3188576269704
SIM,1879,46,50-100,1925,2
STAT,1890,45,45-49,1935,0.2753039444856125
STAT,1852,7,na,1859,2274.4333214049766
STAT,1924,23,20-24,1947,123.58029742529946
SIM,1882,8,na,1890,2382
STAT,1836,93,na,1929,18.45551549664487
STAT,1887,33,35-39,1920,10.654059363967335
SIM,1895,33,35-39,1928,15
STAT,1813,44,40-44,1857,7.192080593170548
STAT,1855,44,45-49,1899,1.0456679573470016
SIM,1937,10,na,1947,3518
STAT,1907,26,25-29,1933,58.893242193657166
STAT,1934,33,25-29,1967,11.913739004157668
STAT,1870,45,25-29,1915,0.05385012544985263
STAT,1858,15,45-49,1873,0.057262888660766495
SIM,1900,33,20-24,1933,3
STAT,1919,43,35-39,1962,0.20582267639687052
SIM,1943,28,25-29,1971,74
SIM,1821,44,40-44,1865,5
STAT,1921,41,50-100,1962,0.12519294007721915
SIM,1906,52,na,1958,3055
STAT,1935,28,25-29,1963,84.71445157457313
STAT,1823,54,45-49,1877,0.01600394025918009
STAT,1922,46,45-49,1968,0.23647548173979935
STAT,1869,15,20-24,1884,16.631453705223286
SIM,1823,95,na,1918,6
STAT,1803,54,25-29,1857,0.009753587951431325
STAT,1892,33,50-100,1925,1.0793505454539627
SIM,1841,38,na,1879,1729
SIM,1798,89,na,1887,41
STAT,1861,60,na,1921,1496.1379398829113
STAT,1950,18,15-19,1968,50.68140943484786
SIM,1825,76,na,1901,451
SIM,1939,22,na,1961,3391
STAT,1911,46,35-39,1957,0.11556819594804824
STAT,1873,39,15-19,1912,0.05330513002186862
STAT,1896,65,na,1961,2249.350101030353
SIM,1867,23,na,1890,2037
SIM,1871,35,40-44,1906,5
STAT,1936,21,25-29,1957,83.43824674165762
SIM,1939,26,45-49,1965,1
STAT,1873,50,25-29,1923,0.0034452742927926615
STAT,1890,39,15-19,1929,0.06420724839042759
SIM,1878,15,na,1893,2575
SIM,1829,25,35-39,1854,9
STAT,1872,52,na,1924,2030.7698795980302
STAT,1861,18,20-24,1879,15.89104696132291
STAT,1891,59,na,1950,2272.5056992747
STAT,1942,21,15-19,1963,5.2741081474320985
STAT,1920,46,45-49,1966,0.22753711681283362
SIM,1860,50,na,1910,1828
SIM,1900,67,na,1967,2284
STAT,1888,16,35-39,1904,0.613868955003396
STAT,1925,21,15-19,1946,6.038331367574411
STAT,1890,74,na,1964,1545.634636510921
SIM,1868,70,na,1938,1203
STAT,1900,46,25-29,1946,0.042703521948865814
STAT,1847,31,40-44,1878,3.785637014316731
SIM,1874,21,30-34,1895,24
SIM,1904,23,45-49,1927,5
STAT,1838,36,50-100,1874,1.0209595707293058
STAT,1843,75,na,1918,742.7109610593194
STAT,1877,27,15-19,1904,0.4447723027441254
STAT,1819,43,30-34,1862,2.1819701976711916
STAT,1905,67,na,1972,2528.165122579083
STAT,1808,46,25-29,1854,0.2229518802159564
SIM,1909,9,na,1918,3666
SIM,1924,38,35-39,1962,7
STAT,1833,30,35-39,1863,8.110869763632351
SIM,1824,35,50-100,1859,3
SIM,1933,21,15-19,1954,9
SIM,1898,15,na,1913,3215
STAT,1926,32,20-24,1958,2.7865754183072116
STAT,1854,39,50-100,1893,0.875192498369279
STAT,1927,38,45-49,1965,0.7999843870949441
STAT,1925,47,40-44,1972,0.18050542567943725
STAT,1912,15,na,1927,3705.8070683698024
SIM,1838,27,35-39,1865,9
STAT,1778,91,na,1869,15.453984717378294
STAT,1892,52,na,1944,2533.7213123956863
STAT,1809,94,na,1903,8.395801064433307
STAT,1941,29,na,1970,3657.03287689462
STAT,1836,43,30-34,1879,0.8526750105783746
SIM,1944,21,25-29,1965,105
STAT,1779,106,na,1885,0.012733273008005625
SIM,1818,94,na,1912,8
STAT,1814,103,na,1917,0.05921371640173122
STAT,1941,22,45-49,1963,1.098379851169245
SIM,1865,39,30-34,1904,6
STAT,1857,50,40-44,1907,0.007953146059668669
STAT,1969,1,na,1970,4645.910923901576
STAT,1823,48,15-19,1871,4.7032665173538964E-4
SIM,1811,70,na,1881,630
SIM,1844,43,30-34,1887,3
STAT,1843,48,35-39,1891,0.09973463865192769
STAT,1852,31,15-19,1883,0.11319480366010556
STAT,1872,22,35-39,1894,5.533215655261254
SIM,1855,31,40-44,1886,7
STAT,1880,19,na,1899,2496.985490039554
STAT,1849,21,30-34,1870,15.634911082364086
STAT,1947,14,na,1961,4178.881098514627
STAT,1850,23,na,1873,1793.7043971236783
STAT,1916,31,15-19,1947,0.12584212834202235
SIM,1857,21,30-34,1878,21
STAT,1823,75,na,1898,541.7421642724902
STAT,1899,16,45-49,1915,0.08477509384216073
SIM,1902,45,na,1947,3040
STAT,1943,21,na,1964,3671.439111527826
SIM,1911,59,na,1970,3107
SIM,1904,44,45-49,1948,1
STAT,1812,54,35-39,1866,0.026029151759273325
SIM,1856,68,na,1924,1169
SIM,1805,76,na,1881,370
STAT,1840,54,50-100,1894,0.010228574325302903
STAT,1829,46,na,1875,1524.7062344117091
STAT,1838,71,na,1909,910.36647857338
STAT,1846,16,30-34,1862,1.42007577639502
STAT,1827,52,20-24,1879,6.241180742025982E-4
STAT,1927,31,25-29,1958,10.748149839496243
STAT,1948,7,na,1955,4249.773884617224
STAT,1901,45,30-34,1946,0.07292099507825776
STAT,1846,32,35-39,1878,8.438072004189133
STAT,1878,42,25-29,1920,0.630753438019732
SIM,1841,30,35-39,1871,11
SIM,1843,16,na,1859,2122
SIM,1854,32,35-39,1886,10
STAT,1884,49,35-39,1933,0.12796673732805258
SIM,1895,17,30-34,1912,2
STAT,1911,34,35-39,1945,8.332631590594335
STAT,1916,38,35-39,1954,2.328262884810012
STAT,1862,33,30-34,1895,14.010326679646825
STAT,1882,45,na,1927,2088.7850209333474
STAT,1769,103,na,1872,0.04358177125433662
STAT,1804,106,na,1910,0.004114565188423752
SIM,1854,16,30-34,1870,1
SIM,1891,40,40-44,1931,6
SIM,1857,30,na,1887,1942
STAT,1826,41,15-19,1867,0.01386130267014456
STAT,1876,51,20-24,1927,7.231031636084545E-4
SIM,1801,63,na,1864,883
STAT,1852,43,15-19,1895,0.010416532426688442
STAT,1864,49,15-19,1913,3.306726013467734E-4
SIM,1938,29,na,1967,3435
STAT,1897,18,35-39,1915,0.6914312545445369
SIM,1812,55,na,1867,1141
SIM,1918,31,25-29,1949,12
STAT,1922,49,15-19,1971,3.974681066721713E-4
SIM,1829,41,40-44,1870,6
STAT,1825,53,na,1878,1322.4639489445212
STAT,1902,44,35-39,1946,0.16537606905730065
STAT,1843,41,15-19,1884,0.010390486909724134
SIM,1810,44,30-34,1854,3
STAT,1888,32,40-44,1920,4.839819653892679
SIM,1853,33,30-34,1886,19
STAT,1913,6,na,1919,3857.7761243710993
STAT,1910,35,50-100,1945,0.38282887032179097
STAT,1795,83,na,1878,131.37271346274693
SIM,1863,30,na,1893,2079
SIM,1847,23,na,1870,1845
STAT,1920,44,na,1964,3862.2442119645248
STAT,1806,48,15-19,1854,0.0011641202356458254
STAT,1866,21,30-34,1887,15.754093578187508
SIM,1809,69,na,1878,759
SIM,1891,29,30-34,1920,39
STAT,1815,46,na,1861,1316.1128816644568
SIM,1850,97,na,1947,1
SIM,1874,40,40-44,1914,8
STAT,1930,40,30-34,1970,0.15935872595256126
STAT,1857,35,15-19,1892,0.04221833403142959
SIM,1896,32,40-44,1928,5
STAT,1926,16,15-19,1942,52.69999503004885
STAT,1870,74,na,1944,1027.297425040362
SIM,1824,38,30-34,1862,7
STAT,1759,106,na,1865,0.0052074980125373415
STAT,1819,39,na,1858,1437.4136661178873
STAT,1779,76,na,1855,344.72703
STAT,1874,67,na,1941,1530.5778009414332
SIM,1950,21,15-19,1971,5
STAT,1845,33,30-34,1878,14.471678658674428
STAT,1827,36,15-19,1863,0.057540036460531775
STAT,1867,88,na,1955,121.77061072809973
STAT,1910,37,na,1947,3398.148612767684
SIM,1934,16,15-19,1950,49
STAT,1866,40,40-44,1906,1.9788625644527607
STAT,1894,27,15-19,1921,0.5513485196638698
SIM,1928,21,40-44,1949,5
SIM,1787,94,na,1881,5
STAT,1762,99,na,1861,0.06444421752756167
STAT,1816,52,45-49,1868,0.036580343738145435
STAT,1846,50,30-34,1896,0.004257291042404859
STAT,1901,20,na,1921,3145.9320083142456
STAT,1833,38,30-34,1871,4.01404335932517
STAT,1837,26,30-34,1863,20.55094973123816
STAT,1892,55,na,1947,2446.1191820449267
SIM,1893,19,20-24,1912,18
SIM,1815,40,35-39,1855,1
STAT,1841,94,na,1935,13.674306061815914
STAT,1916,15,45-49,1931,0.10058523062460746
SIM,1847,20,na,1867,1886
STAT,1912,27,45-49,1939,1.6079579756810725
STAT,1835,46,na,1881,1498.6587594413518
STAT,1845,53,na,1898,1492.2996973110032
STAT,1854,27,50-100,1881,0.48289962927695346
STAT,1874,31,35-39,1905,9.817960653297332
STAT,1861,43,25-29,1904,0.5001181753226561
SIM,1846,44,45-49,1890,4
SIM,1952,18,25-29,1970,48
SIM,1838,49,na,1887,1423
SIM,1843,61,na,1904,1319
SIM,1871,31,25-29,1902,17
STAT,1860,23,20-24,1883,54.149227232779964
STAT,1834,33,50-100,1867,0.7189705668787865
STAT,1894,40,50-100,1934,1.2967759650644617
STAT,1898,36,15-19,1934,0.07215760095838192
STAT,1899,8,na,1907,3365.407577483434
SIM,1888,45,50-100,1933,2
STAT,1805,52,35-39,1857,0.025116077583385115
SIM,1777,87,na,1864,36
STAT,1942,25,30-34,1967,38.88171735929432
STAT,1885,18,50-100,1903,0.045989336458842484
SIM,1935,31,25-29,1966,17
STAT,1876,30,50-100,1906,0.9007560918234877
STAT,1902,56,na,1958,2778.326675535634
STAT,1853,52,30-34,1905,0.004390956906363283
STAT,1909,16,15-19,1925,8.426062908964552
SIM,1929,16,40-44,1945,1
STAT,1901,27,35-39,1928,12.75865219825913
STAT,1910,39,45-49,1949,0.6095543463837357
STAT,1911,21,20-24,1932,99.9025918573271
SIM,1844,97,na,1941,2
SIM,1894,22,na,1916,3012
STAT,1872,43,35-39,1915,1.704614447930614
SIM,1836,68,na,1904,943
STAT,1907,23,20-24,1930,95.31836742394712
STAT,1820,46,40-44,1866,0.2864576265217129
SIM,1917,16,15-19,1933,10
STAT,1907,48,na,1955,3082.9302583034355
STAT,1921,39,20-24,1960,0.27749410223194304
SIM,1909,17,35-39,1926,1
STAT,1883,43,45-49,1926,1.3756800040966795
SIM,1849,89,na,1938,53
SIM,1917,44,na,1961,3594
SIM,1941,18,15-19,1959,39
STAT,1814,61,na,1875,965.5693531109886
STAT,1829,60,na,1889,1188.8910534921506
STAT,1884,26,na,1910,2235.5598506814526
SIM,1900,15,25-29,1915,10
SIM,1835,100,na,1935,1
SIM,1880,43,35-39,1923,1
STAT,1840,54,45-49,1894,0.009828760361302882
STAT,1933,18,15-19,1951,57.242256857889664
SIM,1858,49,na,1907,1777
STAT,1759,109,na,1868,0.001281580311049216
STAT,1906,49,30-34,1955,0.07354444445109584
STAT,1835,50,20-24,1885,4.8817042452457333E-4
STAT,1830,54,na,1884,1282.9683334411789
STAT,1945,17,50-100,1962,0.3866291321828547
SIM,1818,43,na,1861,1337
STAT,1874,16,40-44,1890,0.17703239936608375
STAT,1859,59,na,1918,1465.225324469814
SIM,1841,38,30-34,1879,11
STAT,1894,33,na,1927,2887.6559921425164
STAT,1811,46,30-34,1857,0.32789965393118087
STAT,1917,55,na,1972,3511.1530721453837
SIM,1891,43,45-49,1934,1
STAT,1777,98,na,1875,0.5277872559229321
SIM,1907,37,na,1944,3338
STAT,1820,47,na,1867,1373.1826437337888
SIM,1837,32,35-39,1869,9
SIM,1920,27,45-49,1947,4
SIM,1859,96,na,1955,7
SIM,1882,31,35-39,1913,10
SIM,1915,23,20-24,1938,106
STAT,1944,18,25-29,1962,44.04094412172096
STAT,1838,44,45-49,1882,1.0588414657022667
STAT,1856,17,35-39,1873,0.4800526414206973
STAT,1883,22,50-100,1905,0.37755972803876864
STAT,1900,21,45-49,1921,0.9166615010953384
STAT,1834,33,20-24,1867,2.1210686054830066
STAT,1856,93,na,1949,21.623693125082102
STAT,1869,66,na,1935,1498.771181721319
SIM,1926,28,25-29,1954,86
SIM,1840,20,40-44,1860,1
SIM,1851,90,na,1941,41
STAT,1836,100,na,1936,0.6704171953812954
STAT,1838,20,na,1858,1919.397158909183
STAT,1931,33,40-44,1964,4.841251991180833
SIM,1869,23,15-19,1892,3
SIM,1810,77,na,1887,346
SIM,1932,26,25-29,1958,97
SIM,1856,26,40-44,1882,2
SIM,1942,11,na,1953,3729
STAT,1921,18,50-100,1939,0.4024163588575476
STAT,1918,31,50-100,1949,0.8333632382108797
STAT,1864,26,na,1890,2021.882095978429
STAT,1924,26,25-29,1950,72.65370539373806
STAT,1842,24,15-19,1866,2.9207320491132065
STAT,1863,16,30-34,1879,1.5192673050377388
STAT,1913,44,45-49,1957,0.15277840130382894
SIM,1849,86,na,1935,124
SIM,1926,31,50-100,1957,1
STAT,1843,72,na,1915,911.1223325563759
STAT,1890,42,40-44,1932,2.5947758250951933
SIM,1850,24,15-19,1874,3
SIM,1871,16,30-34,1887,1
SIM,1841,83,na,1924,222
STAT,1791,79,na,1870,262.579991880853
STAT,1919,40,30-34,1959,0.13124492546302316
SIM,1861,38,na,1899,2027
STAT,1886,30,15-19,1916,0.1432830845551803
STAT,1918,28,25-29,1946,65.93874466580156
STAT,1949,19,20-24,1968,148.8704665947619
STAT,1811,87,na,1898,76.31255626141555
STAT,1823,51,40-44,1874,0.012324101623983556
STAT,1842,42,45-49,1884,1.1026612159760387
SIM,1830,30,25-29,1860,11
STAT,1876,44,15-19,1920,0.01328631665829921
SIM,1865,42,na,1907,1980
SIM,1878,33,35-39,1911,11
STAT,1901,23,na,1924,3117.609643789174
STAT,1870,30,20-24,1900,2.5222515626337167
STAT,1808,98,na,1906,1.262660181824966
SIM,1884,30,50-100,1914,1
STAT,1902,34,25-29,1936,7.7735207188914055
SIM,1842,33,20-24,1875,4
SIM,1888,15,30-34,1903,1
STAT,1882,48,20-24,1930,0.010892396350846581
SIM,1901,32,25-29,1933,18
STAT,1885,19,20-24,1904,16.596245701774286
SIM,1809,80,na,1889,246
STAT,1827,41,50-100,1868,0.9891234568486916
SIM,1909,15,na,1924,3583
SIM,1850,42,45-49,1892,2
SIM,1826,28,20-24,1854,9
STAT,1854,41,25-29,1895,0.46450588436873036
STAT,1848,26,40-44,1874,2.5949652332410835
STAT,1909,26,na,1935,3391.7592718828014
STAT,1937,21,na,1958,3360.102852549026
SIM,1871,38,50-100,1909,1
STAT,1836,29,50-100,1865,0.5152278274287362
STAT,1854,45,40-44,1899,0.12450918149216832
STAT,1864,31,40-44,1895,3.6764997739076914
STAT,1861,47,40-44,1908,0.1336762793572489
STAT,1863,38,50-100,1901,1.0144773778906486
STAT,1881,15,na,1896,2314.4198239438488
STAT,1839,51,35-39,1890,0.005767745574808827
SIM,1863,40,30-34,1903,1
STAT,1911,30,na,1941,3506.325312285278
SIM,1901,36,40-44,1937,3
SIM,1874,24,35-39,1898,3
SIM,1945,24,45-49,1969,1
SIM,1884,63,na,1947,1707
STAT,1810,53,20-24,1863,0.0024548112367985164
SIM,1910,34,25-29,1944,12
STAT,1874,0,na,1874,3557.9986558948417
STAT,1905,43,40-44,1948,0.21168921209978345
SIM,1957,10,na,1967,4695
STAT,1847,34,na,1881,1837.4587313639875
STAT,1890,24,45-49,1914,0.8003831517962002
STAT,1883,25,15-19,1908,0.42291814105963227
SIM,1939,23,40-44,1962,2
STAT,1924,44,20-24,1968,0.01978048683851816
STAT,1823,33,45-49,1856,3.991592641502561
STAT,1855,12,na,1867,2010.9538985494278
SIM,1831,33,45-49,1864,2
SIM,1892,41,na,1933,2787
STAT,1821,53,30-34,1874,0.008565723581928867
SIM,1930,31,40-44,1961,3
SIM,1935,35,40-44,1970,3
STAT,1878,26,na,1904,2355.0867019876437
SIM,1881,21,40-44,1902,1
STAT,1858,100,na,1958,1.289801446915077
STAT,1904,32,35-39,1936,7.8782444316967934
STAT,1880,35,40-44,1915,4.392555059418904
SIM,1903,20,25-29,1923,84
SIM,1874,56,na,1930,1914
STAT,1932,35,15-19,1967,0.024417388628828376
SIM,1869,4,na,1873,2573
STAT,1820,42,25-29,1862,1.1584120815277699
SIM,1900,25,50-100,1925,1
STAT,1893,48,30-34,1941,0.06462598299026279
SIM,1879,40,25-29,1919,3
STAT,1915,32,45-49,1947,1.5138475770344584
SIM,1913,43,40-44,1956,1
STAT,1848,49,30-34,1897,0.06828094278116845
SIM,1892,4,na,1896,3174
SIM,1905,56,na,1961,2859
STAT,1805,87,na,1892,58.990342230828034
STAT,1862,36,35-39,1898,5.727060322075489
STAT,1937,24,45-49,1961,1.0342517536362412
SIM,1906,47,50-100,1953,2
STAT,1831,42,35-39,1873,1.3791977319246622
SIM,1898,69,na,1967,2175
STAT,1861,30,45-49,1891,1.3789838893882016
STAT,1840,44,35-39,1884,1.2822120775335462
STAT,1927,35,40-44,1962,1.7615100109810284
SIM,1883,34,20-24,1917,2
SIM,1834,87,na,1921,98
SIM,1812,58,na,1870,1059
STAT,1875,34,20-24,1909,2.600960602402331
STAT,1906,30,45-49,1936,1.3884728968295275
SIM,1923,32,45-49,1955,2
STAT,1912,19,50-100,1931,0.07116932615612574
STAT,1849,12,na,1861,2118.0435037322036
STAT,1848,19,na,1867,2025.9166404533623
STAT,1906,45,15-19,1951,3.134773514851735E-4
SIM,1819,39,35-39,1858,13
STAT,1845,51,50-100,1896,0.010688994274508834
SIM,1889,55,na,1944,2393
STAT,1846,40,20-24,1886,0.11627170496071139
STAT,1930,22,35-39,1952,11.395888374850033
SIM,1924,35,30-34,1959,2
SIM,1893,77,na,1970,1471
STAT,1850,51,35-39,1901,0.006089796231051182
STAT,1916,35,30-34,1951,1.7798792055873833
SIM,1890,63,na,1953,2084
STAT,1852,47,30-34,1899,0.07320308822396561
STAT,1911,31,30-34,1942,14.549269882017315
STAT,1917,45,25-29,1962,0.05258604189192979
STAT,1857,78,na,1935,581.8981386171743
STAT,1940,27,20-24,1967,17.582774102308434
STAT,1867,85,na,1952,243.1573716555069
STAT,1845,28,50-100,1873,0.544507407997057
STAT,1779,79,na,1858,259.40821240192736
SIM,1904,41,40-44,1945,2
SIM,1941,18,na,1959,3458
SIM,1925,18,30-34,1943,17
STAT,1879,45,45-49,1924,0.2353572198895853
STAT,1874,41,45-49,1915,1.4515918069798939
STAT,1897,30,25-29,1927,13.044682593745717
SIM,1858,60,na,1918,1551
STAT,1812,80,na,1892,266.05723197496985
STAT,1895,46,40-44,1941,0.11939079184973495
SIM,1919,34,45-49,1953,2
SIM,1900,64,na,1964,2418
STAT,1851,36,25-29,1887,2.1562468848044993
SIM,1845,29,35-39,1874,8
SIM,1856,34,na,1890,1845
SIM,1914,30,45-49,1944,4
SIM,1839,22,25-29,1861,48
SIM,1820,36,na,1856,1521
STAT,1914,8,na,1922,3884.1095302709064
STAT,1902,5,na,1907,3493.6993958060657
SIM,1912,32,35-39,1944,14
STAT,1832,35,na,1867,1658.8643441410825
STAT,1920,33,30-34,1953,16.234884176074328
SIM,1859,16,15-19,1875,7
SIM,1803,95,na,1898,6
SIM,1882,41,45-49,1923,3
STAT,1960,10,na,1970,4833.30143056558
SIM,1830,43,na,1873,1616
STAT,1908,43,25-29,1951,0.062024441898214204
SIM,1870,49,na,1919,2065
STAT,1843,45,30-34,1888,0.07131543244040824
STAT,1950,16,25-29,1966,48.42324075766747
STAT,1910,43,15-19,1953,0.001362448414073818
STAT,1907,28,15-19,1935,0.6272814905620246
STAT,1849,110,na,1959,3.762699670511125E-4
STAT,1857,53,45-49,1910,0.010634595475901471
STAT,1864,52,40-44,1916,0.008841289166346064
STAT,1814,54,35-39,1868,0.0214626051676765
SIM,1946,25,50-100,1971,2
STAT,1864,7,na,1871,2375.6342791263196
STAT,1866,24,35-39,1890,5.050820947907842
STAT,1797,64,na,1861,830.4219498382068
STAT,1781,80,na,1861,219.9281237817915
STAT,1836,46,35-39,1882,0.09371413775226178
STAT,1901,24,50-100,1925,0.535840352157003
STAT,1818,42,50-100,1860,2.534247703971408
STAT,1892,21,50-100,1913,0.4838752860354043
STAT,1812,51,30-34,1863,0.0191117489767644
STAT,1842,79,na,1921,497.84164786182737
STAT,1895,18,na,1913,3105.4091549496757
SIM,1935,18,na,1953,4785
SIM,1845,42,na,1887,1649
SIM,1885,48,na,1933,2107
STAT,1901,41,15-19,1942,0.001273788204655608
STAT,1938,25,50-100,1963,0.9322621527215808
STAT,1881,45,35-39,1926,0.1289732728144176
STAT,1876,54,25-29,1930,0.0033593743697185687
STAT,1917,18,30-34,1935,2.471267201857483
STAT,1850,20,na,1870,1832.902319997632
SIM,1867,26,20-24,1893,9
STAT,1902,16,20-24,1918,23.692806256661992
STAT,1904,24,30-34,1928,23.981419260789792
SIM,1859,79,na,1938,562
STAT,1840,44,45-49,1884,1.0597501152002051
STAT,1917,38,na,1955,3673.088352296854
STAT,1822,53,40-44,1875,0.013854625223281986
STAT,1843,12,na,1855,2200.96206
SIM,1847,28,45-49,1875,4
STAT,1841,37,15-19,1878,0.04526687669795286
STAT,1883,47,20-24,1930,0.011058608477972302
STAT,1884,10,na,1894,2418.1722113881506
STAT,1934,36,35-39,1970,3.1559995302327746
STAT,1886,1,na,1887,3127.276275896988
STAT,1913,24,na,1937,3461.0449878056766
STAT,1929,32,35-39,1961,10.966420698800881
SIM,1855,65,na,1920,1273
SIM,1901,32,30-34,1933,34
STAT,1839,108,na,1947,0.0012213422005170774
STAT,1907,24,50-100,1931,0.5622537729192225
STAT,1836,33,15-19,1869,0.11249678066700189
STAT,1898,18,na,1916,3221.351033088548
STAT,1827,97,na,1924,2.9813222256462093
STAT,1869,3,na,1872,2878.4156015317376
STAT,1839,20,35-39,1859,5.071962347082787
SIM,1851,51,na,1902,1615
SIM,1924,18,15-19,1942,50
STAT,1835,40,45-49,1875,1.147929102102569
SIM,1933,38,35-39,1971,10
STAT,1909,19,na,1928,3557.966408902524
STAT,1825,54,20-24,1879,7.168052707012683E-4
STAT,1839,28,45-49,1867,0.9259395588662881
SIM,1910,38,40-44,1948,1
STAT,1916,45,30-34,1961,0.08678173661442329
STAT,1865,23,40-44,1888,1.7975797725136413
STAT,1848,26,45-49,1874,0.961821578852562
STAT,1906,32,40-44,1938,3.4254629414373703
STAT,1859,36,50-100,1895,0.9300804901977402
STAT,1902,38,40-44,1940,1.2533713538731088
SIM,1864,25,40-44,1889,2
SIM,1905,34,40-44,1939,2
STAT,1822,66,na,1888,850.4802630030224
SIM,1842,15,na,1857,2041
STAT,1854,17,30-34,1871,1.3729663033854713
STAT,1871,67,na,1938,1484.6253808175472
STAT,1856,25,40-44,1881,2.3300367757130327
STAT,1788,89,na,1877,36.59750874667503
STAT,1805,70,na,1875,682.1454447832925
STAT,1872,25,na,1897,2278.259141062287
SIM,1881,1,na,1882,2652
STAT,1846,36,50-100,1882,0.9134148418118528
SIM,1870,42,30-34,1912,1
STAT,1845,31,15-19,1876,0.12051310659274875
SIM,1914,32,40-44,1946,6
STAT,1898,42,35-39,1940,0.1606101881986006
SIM,1921,17,35-39,1938,5
SIM,1846,29,na,1875,1836
STAT,1792,94,na,1886,3.8950797345207118
STAT,1846,18,35-39,1864,0.4831365082109993
STAT,1925,38,35-39,1963,2.7400456300608225
STAT,1943,4,na,1947,4008.378892588096
SIM,1899,29,20-24,1928,18
STAT,1806,49,15-19,1855,0.0011442474396325928
SIM,1923,25,45-49,1948,1
STAT,1872,47,45-49,1919,0.22273249009696286
STAT,1926,6,na,1932,4642.844089087895
SIM,1889,30,40-44,1919,6
SIM,1871,15,30-34,1886,2
SIM,1940,22,40-44,1962,3
STAT,1777,114,na,1891,1.7660920526202872E-4
STAT,1784,75,na,1859,321.86309406078016
STAT,1892,45,20-24,1937,0.00808760653197872
STAT,1809,84,na,1893,139.7459782777069
STAT,1955,2,na,1957,4934.761785754048
SIM,1930,40,na,1970,4561
STAT,1915,25,45-49,1940,1.6758062934670153
STAT,1863,48,na,1911,1844.823106304117
STAT,1972,0,na,1972,4790.524920556206
STAT,1913,17,35-39,1930,0.8103014976022513
SIM,1843,40,45-49,1883,1
SIM,1806,64,na,1870,842
SIM,1862,17,30-34,1879,2
STAT,1838,41,25-29,1879,0.5188066475304363
STAT,1839,82,na,1921,311.10414908717985
STAT,1863,15,30-34,1878,1.5282688083187355
STAT,1932,28,25-29,1960,81.40545256871134
STAT,1857,42,50-100,1899,0.7858246917467965
STAT,1798,83,na,1881,135.55968967560406
SIM,1940,28,25-29,1968,63
STAT,1927,37,30-34,1964,2.1409170035272593
STAT,1831,51,40-44,1882,0.006945328930982726
SIM,1896,63,na,1959,2356
STAT,1814,54,45-49,1868,0.03617982008935955
STAT,1844,42,50-100,1886,0.7595619974377051
STAT,1932,22,40-44,1954,4.167799469997897
STAT,1810,46,50-100,1856,0.8880927631183276
SIM,1858,14,na,1872,2218
SIM,1917,28,25-29,1945,63
SIM,1910,25,35-39,1935,20
SIM,1814,83,na,1897,149
STAT,1877,24,na,1901,2303.983106250812
STAT,1905,25,50-100,1930,0.8792041471297372
STAT,1920,34,40-44,1954,4.014905735234418
STAT,1888,20,30-34,1908,19.997296441380495
STAT,1897,48,50-100,1945,0.17283283130592508
SIM,1856,26,45-49,1882,1
STAT,1928,38,50-100,1966,0.5008061858349219
STAT,1892,29,na,1921,2803.0947276800753
STAT,1903,37,45-49,1940,0.578305962366481
STAT,1894,48,35-39,1942,0.09476211969172119
SIM,1884,78,na,1962,861
SIM,1955,16,na,1971,4268
STAT,1875,48,25-29,1923,0.0552005666116871
SIM,1934,25,20-24,1959,26
STAT,1830,54,50-100,1884,0.009357552889045384
SIM,1905,21,35-39,1926,8
STAT,1881,61,na,1942,1704.464683229756
STAT,1831,46,45-49,1877,0.17576171830830467
STAT,1885,75,na,1960,1117.1175757704568
STAT,1837,25,30-34,1862,20.699572662958197
SIM,1809,48,50-100,1857,3
STAT,1874,35,50-100,1909,1.1966824693778346
STAT,1879,42,25-29,1921,0.6333057919847879
SIM,1829,33,na,1862,1612
STAT,1888,23,50-100,1911,0.4536919840505217
STAT,1912,30,15-19,1942,0.12038645648329532
STAT,1826,28,50-100,1854,1.9486573025622673
STAT,1871,21,15-19,1892,3.099007364614381
SIM,1910,16,20-24,1926,31
SIM,1912,24,30-34,1936,26
STAT,1902,25,35-39,1927,12.95072099864468
STAT,1859,26,20-24,1885,9.0623638871234
STAT,1909,28,25-29,1937,59.20033104960733
SIM,1867,50,na,1917,1893
STAT,1929,26,50-100,1955,1.177411109692244
SIM,1873,23,40-44,1896,3
SIM,1937,32,35-39,1969,9
STAT,1822,50,na,1872,1296.6060670231518
STAT,1873,47,50-100,1920,0.23440993494815937
STAT,1877,34,15-19,1911,0.13840942111193635
STAT,1929,23,na,1952,4349.3674182766135
STAT,1900,17,25-29,1917,7.426754953887957
SIM,1764,91,na,1855,6
STAT,1844,54,30-34,1898,0.0040638316768705
STAT,1818,45,na,1863,1386.6162893636272
STAT,1816,40,35-39,1856,5.861395560304766
SIM,1846,9,na,1855,2169
STAT,1842,46,20-24,1888,0.008656982600394105
STAT,1875,46,50-100,1921,0.23904089801803538
SIM,1887,11,na,1898,2707
SIM,1899,16,15-19,1915,7
SIM,1837,52,na,1889,1384
SIM,1838,22,35-39,1860,4
STAT,1914,37,20-24,1951,0.2485979528762912
STAT,1882,15,40-44,1897,0.16891482269221217
SIM,1916,25,na,1941,3572
STAT,1824,34,50-100,1858,1.6459252793512311
SIM,1912,11,na,1923,3635
STAT,1899,21,45-49,1920,0.9054874188679493
STAT,1945,20,25-29,1965,95.70240173208231
STAT,1803,53,30-34,1856,0.016723230087295187
STAT,1865,18,45-49,1883,0.057444701945738134
SIM,1875,5,na,1880,2672
STAT,1825,49,25-29,1874,0.058756378137515615
STAT,1840,79,na,1919,486.8685772774585
STAT,1857,41,35-39,1898,1.3547070864482351
STAT,1886,32,15-19,1918,0.14214053870522855
STAT,1843,44,na,1887,1673.4024519230097
STAT,1827,81,na,1908,300.0968968086001
STAT,1871,35,35-39,1906,6.687008153714726
STAT,1869,23,25-29,1892,52.18573979183472
SIM,1828,28,35-39,1856,12
STAT,1860,37,25-29,1897,2.2105314851023117
SIM,1925,27,20-24,1952,25
SIM,1920,32,40-44,1952,4
SIM,1812,44,35-39,1856,2
SIM,1942,27,20-24,1969,15
SIM,1847,33,40-44,1880,7
SIM,1808,71,na,1879,585
STAT,1842,86,na,1928,158.00082285753587
SIM,1936,16,40-44,1952,5
SIM,1897,24,40-44,1921,2
STAT,1919,38,35-39,1957,2.4522904319463925
STAT,1844,15,20-24,1859,16.00850634975682
SIM,1901,27,35-39,1928,17
SIM,1941,24,na,1965,3421
STAT,1864,50,50-100,1914,0.012934657147151482
SIM,1785,69,na,1854,572
SIM,1793,88,na,1881,37
SIM,1937,19,na,1956,3250
SIM,1826,84,na,1910,160
SIM,1919,16,40-44,1935,2
SIM,1927,38,35-39,1965,12
STAT,1944,0,na,1944,4534.445837780743
STAT,1910,27,35-39,1937,13.691971820275716
SIM,1874,31,35-39,1905,7
STAT,1912,32,40-44,1944,3.6368744249046836
SIM,1900,26,na,1926,3088
STAT,1926,25,20-24,1951,20.814634320546034
STAT,1889,24,40-44,1913,2.415073886814071
STAT,1882,49,50-100,1931,0.2210539571603449
STAT,1883,42,50-100,1925,0.9769298142889034
STAT,1917,27,20-24,1944,18.083692775383074
STAT,1919,41,50-100,1960,0.12044304217389841
SIM,1859,3,na,1862,2568
SIM,1852,15,20-24,1867,13
SIM,1843,17,20-24,1860,10
STAT,1887,19,35-39,1906,0.5766004398653075
STAT,1819,41,15-19,1860,0.028059844973913926
STAT,1858,20,45-49,1878,0.6019749854887223
SIM,1902,44,40-44,1946,1
STAT,1855,38,50-100,1893,0.8652197144506275
STAT,1882,38,15-19,1920,0.05136404924444206
STAT,1914,21,35-39,1935,8.745400633614667
SIM,1928,4,na,1932,4796
SIM,1888,29,45-49,1917,1
STAT,1919,30,25-29,1949,9.495946182427199
STAT,1868,19,25-29,1887,5.142682279710216
STAT,1856,48,15-19,1904,2.9223863233716825E-4
SIM,1880,32,na,1912,2438
SIM,1884,46,na,1930,2218
STAT,1918,48,45-49,1966,0.21787836199262975
SIM,1916,24,15-19,1940,4
SIM,1879,23,35-39,1902,5
STAT,1943,25,20-24,1968,18.380646097644565
SIM,1876,27,na,1903,2389
STAT,1821,44,35-39,1865,2.8456476391022663
SIM,1888,21,35-39,1909,9
STAT,1934,27,20-24,1961,23.19738237801429
STAT,1903,42,40-44,1945,0.20967188225386207
SIM,1931,24,40-44,1955,4
STAT,1902,40,na,1942,3123.0642263510285
SIM,1886,18,30-34,1904,3
SIM,1945,2,na,1947,4016
STAT,1908,35,50-100,1943,0.3747956618253273
STAT,1923,24,40-44,1947,3.6730597606104136
STAT,1855,52,40-44,1907,0.007416376225418492
STAT,1881,45,45-49,1926,0.21741208815549729
STAT,1834,67,na,1901,981.1806982016212
SIM,1893,39,na,1932,2894
SIM,1936,20,25-29,1956,74
STAT,1839,33,40-44,1872,3.5216906250791737
SIM,1817,48,na,1865,1379
STAT,1903,31,50-100,1934,1.2364968518763935
STAT,1908,24,15-19,1932,4.593099836377409
STAT,1869,32,15-19,1901,0.13022281668245403
STAT,1828,27,50-100,1855,1.1324479949019892
STAT,1906,54,na,1960,2969.157444312516
STAT,1843,31,50-100,1874,0.8029801243743155
SIM,1800,75,na,1875,396
SIM,1825,67,na,1892,806
STAT,1906,35,20-24,1941,0.23104881124442467
SIM,1821,53,na,1874,1247
SIM,1927,30,25-29,1957,11
STAT,1885,41,50-100,1926,0.9988097315988269
SIM,1876,19,25-29,1895,6
STAT,1838,45,50-100,1883,0.1768050493826689
STAT,1917,49,40-44,1966,0.15465339378280343
SIM,1836,27,30-34,1863,33
STAT,1895,18,30-34,1913,1.9597738165624834
STAT,1923,35,20-24,1958,0.2890731848436697
STAT,1811,105,na,1916,0.012700223655094565
STAT,1815,47,15-19,1862,9.733970417681678E-4
STAT,1888,46,50-100,1934,0.2748702920576617
STAT,1901,39,na,1940,3108.2584144651664
STAT,1834,51,na,1885,1393.8178647531702
STAT,1914,27,50-100,1941,0.9477508409090291
STAT,1801,88,na,1889,49.39444546840071
SIM,1922,21,35-39,1943,15
STAT,1851,47,25-29,1898,0.042042105878567645
STAT,1864,31,25-29,1895,8.68328204091321
STAT,1860,99,na,1959,2.711844759196657
STAT,1832,25,50-100,1857,0.5409946880712577
SIM,1884,18,20-24,1902,13
STAT,1908,46,35-39,1954,0.11095586653516311
STAT,1895,22,15-19,1917,4.0670361200476455
SIM,1873,94,na,1967,55
STAT,1819,62,na,1881,987.5619708333302
STAT,1899,19,50-100,1918,0.06308540794493786
STAT,1903,32,15-19,1935,0.19140062095392374
STAT,1855,47,45-49,1902,0.16636464951953675
STAT,1881,45,na,1926,2072.6380541771446
STAT,1938,16,na,1954,3438.064941676639
STAT,1879,21,50-100,1900,0.40388101408151017
STAT,1885,59,na,1944,1829.1483434769798
SIM,1869,57,na,1926,1817
SIM,1917,42,na,1959,3613
STAT,1828,27,30-34,1855,44.5795391315224
STAT,1835,40,50-100,1875,0.8103028932797867
SIM,1888,34,40-44,1922,5
SIM,1865,43,na,1908,1968
STAT,1868,38,50-100,1906,1.1019030926638964
SIM,1842,31,na,1873,1799
STAT,1928,16,40-44,1944,1.6692015870658394
SIM,1925,36,35-39,1961,5
STAT,1875,20,45-49,1895,0.6808151378856997
STAT,1942,21,na,1963,3618.1306673603663
SIM,1905,41,na,1946,3162
STAT,1938,33,50-100,1971,0.7847860551061174
SIM,1846,45,na,1891,1606
STAT,1865,38,15-19,1903,0.047966493733947915
STAT,1928,39,15-19,1967,0.022880244521694165
STAT,1914,34,40-44,1948,3.688789757625905
STAT,1874,16,45-49,1890,0.06322584154151138
STAT,1938,30,35-39,1968,8.689269677761049
STAT,1915,20,50-100,1935,0.6202078967751931
STAT,1920,32,15-19,1952,0.13297866782447115
STAT,1876,41,45-49,1917,1.4662107862114795
SIM,1884,41,45-49,1925,6
STAT,1908,37,20-24,1945,0.23310486494790134
STAT,1834,47,25-29,1881,0.03781185880278181
STAT,1927,41,15-19,1968,0.0018222812763765473
SIM,1847,20,35-39,1867,7
STAT,1890,35,45-49,1925,2.3243984129941646
SIM,1922,34,40-44,1956,4
STAT,1952,15,20-24,1967,153.57099021532855
STAT,1798,67,na,1865,737.9394724104565
STAT,1930,17,35-39,1947,5.125193394833065
SIM,1902,17,25-29,1919,6
STAT,1862,45,35-39,1907,0.11394203668905196
STAT,1809,50,45-49,1859,0.05238565256457458
SIM,1796,69,na,1865,681
SIM,1860,12,na,1872,2330
SIM,1900,10,na,1910,3368
STAT,1915,28,25-29,1943,63.19305495739677
STAT,1890,5,na,1895,3026.908280563019
STAT,1853,33,15-19,1886,0.10763363144316208
SIM,1830,46,na,1876,1573
SIM,1855,22,35-39,1877,6
STAT,1917,54,na,1971,3530.322724539635
STAT,1891,28,15-19,1919,0.5286500096958802
SIM,1893,16,20-24,1909,25
STAT,1879,63,na,1942,1761.8792566362042
STAT,1913,40,na,1953,3459.449101875293
SIM,1945,22,na,1967,3670
STAT,1838,65,na,1903,1152.595531598545
SIM,1905,4,na,1909,3580
SIM,1889,42,35-39,1931,5
SIM,1864,26,na,1890,2129
STAT,1837,50,20-24,1887,4.864114743734917E-4
SIM,1934,0,na,1934,5274
SIM,1832,22,40-44,1854,4
STAT,1886,24,15-19,1910,3.2722218377227192
STAT,1750,105,na,1855,0.6266700000000001
STAT,1931,37,20-24,1968,0.32981539723614517
STAT,1898,30,40-44,1928,5.59048867525511
SIM,1926,19,na,1945,4111
SIM,1907,1,na,1908,3784
STAT,1920,46,35-39,1966,0.1349796457551092
STAT,1892,44,50-100,1936,0.08561648984491024
STAT,1855,41,25-29,1896,0.45685709621787485
STAT,1824,37,15-19,1861,0.08439134469022072
SIM,1920,26,30-34,1946,52
SIM,1857,30,45-49,1887,1
STAT,1947,20,35-39,1967,10.06069511006571
SIM,1894,24,15-19,1918,3
SIM,1786,70,na,1856,602
STAT,1813,73,na,1886,534.1117768349328
STAT,1912,26,30-34,1938,36.59396399364888
STAT,1902,19,25-29,1921,7.514074847827712
STAT,1843,71,na,1914,962.9990937359307
STAT,1903,40,15-19,1943,0.0013019102291234805
SIM,1910,19,25-29,1929,10
STAT,1849,30,45-49,1879,1.4860281290505537
STAT,1842,54,20-24,1896,5.110312820604313E-4
STAT,1868,15,50-100,1883,0.04552433560273709
STAT,1892,21,35-39,1913,6.924254532728893
STAT,1931,21,na,1952,4487.962490498402
STAT,1847,22,35-39,1869,5.263633408249882
STAT,1897,44,na,1941,2890.588993844668
STAT,1893,30,na,1923,2883.261905699871
STAT,1782,106,na,1888,0.011806634108431968
STAT,1910,32,30-34,1942,14.346906282494631
STAT,1954,18,35-39,1972,4.898784677749405
STAT,1886,46,35-39,1932,0.1401341218469053
STAT,1825,30,35-39,1855,22.38099452506673
STAT,1914,49,15-19,1963,3.430459418165704E-4
STAT,1921,25,45-49,1946,1.8314374284789803
SIM,1872,77,na,1949,742
SIM,1821,37,na,1858,1526
SIM,1933,33,50-100,1966,1
SIM,1780,81,na,1861,168
STAT,1879,44,50-100,1923,1.0290935889745012
STAT,1869,20,45-49,1889,0.6442070504689261
STAT,1930,36,na,1966,4640.350624727459
SIM,1930,18,15-19,1948,54
SIM,1869,15,15-19,1884,9
SIM,1936,28,35-39,1964,14
STAT,1937,8,na,1945,3664.9673951396903
STAT,1871,99,na,1970,12.117143487466487
STAT,1827,43,15-19,1870,0.012483284156687145
STAT,1848,51,35-39,1899,0.006231843860650053
SIM,1833,30,35-39,1863,10
STAT,1903,34,40-44,1937,3.3181799234501126
STAT,1778,108,na,1886,0.004438783353664897
STAT,1925,35,30-34,1960,2.0703428869693847
SIM,1880,48,na,1928,2308
STAT,1888,23,35-39,1911,6.492331531878921
STAT,1814,90,na,1904,32.52929872063045
SIM,1847,46,na,1893,1612
SIM,1912,27,35-39,1939,14
STAT,1922,18,15-19,1940,49.491405879242826
SIM,1876,16,20-24,1892,16
STAT,1928,20,25-29,1948,109.61040400385633
STAT,1894,34,15-19,1928,0.17157504855130556
STAT,1814,51,40-44,1865,0.027870584779524903
STAT,1901,55,na,1956,2753.8528433847837
STAT,1928,28,35-39,1956,17.466917478625575
STAT,1832,47,15-19,1879,2.867269268925647E-4
STAT,1923,27,45-49,1950,1.8739528014558127
SIM,1911,34,40-44,1945,4
STAT,1841,27,50-100,1868,0.5436099063609072
STAT,1877,50,50-100,1927,0.015018242748610298
STAT,1856,94,na,1950,14.787578780518647
STAT,1925,33,50-100,1958,0.9270532432545282
SIM,1931,27,45-49,1958,3
STAT,1881,42,40-44,1923,2.0491374777916818
STAT,1943,17,20-24,1960,135.81089589296457
STAT,1875,45,20-24,1920,0.011762566889124354
SIM,1879,36,40-44,1915,8
SIM,1933,35,30-34,1968,1
STAT,1853,47,35-39,1900,0.10334105878643292
STAT,1877,53,30-34,1930,0.005741691960101539
STAT,1916,48,35-39,1964,0.12457553307596543
SIM,1896,23,35-39,1919,9
SIM,1896,32,25-29,1928,18
STAT,1885,16,20-24,1901,16.72670827487732
STAT,1945,25,30-34,1970,40.644908450979635
STAT,1904,27,35-39,1931,13.072591258711187
SIM,1918,32,25-29,1950,13
SIM,1887,27,na,1914,2464
STAT,1896,42,25-29,1938,0.055606878965715145
STAT,1856,33,40-44,1889,3.2144439797698583
SIM,1856,23,40-44,1879,1
STAT,1908,38,35-39,1946,2.1282442227880236
SIM,1916,38,35-39,1954,4
STAT,1888,32,25-29,1920,11.430850446438857
STAT,1943,22,na,1965,3670.227536621021
STAT,1848,23,40-44,1871,1.8147707483550557
STAT,1868,47,na,1915,2019.8439846808037
SIM,1951,17,20-24,1968,130
STAT,1808,54,20-24,1862,0.002578390844019652
STAT,1870,44,30-34,1914,1.0498479340198987
SIM,1863,7,na,1870,2406
STAT,1924,22,50-100,1946,0.7335543955077803
STAT,1872,36,50-100,1908,1.1697516293274044
SIM,1932,8,na,1940,4847
STAT,1829,51,25-29,1880,0.0028162903280421208
STAT,1830,34,35-39,1864,8.202587106520166
STAT,1852,40,45-49,1892,1.1485796293644592
SIM,1857,29,na,1886,1932
STAT,1941,18,25-29,1959,42.15046988427581
SIM,1853,15,na,1868,2225
STAT,1872,84,na,1956,342.0489457731451
STAT,1842,38,50-100,1880,1.0150148485303474
STAT,1941,15,45-49,1956,0.4862975173880594
SIM,1922,30,25-29,1952,9
STAT,1879,30,30-34,1909,17.378864951180198
SIM,1877,20,20-24,1897,57
STAT,1901,46,25-29,1947,0.043084664422908106
SIM,1892,3,na,1895,3189
STAT,1860,34,20-24,1894,2.057531613042941
SIM,1845,25,30-34,1870,26
SIM,1905,57,na,1962,2838
STAT,1843,28,na,1871,1906.9330960142638
SIM,1836,22,25-29,1858,52
SIM,1888,12,na,1900,2804
STAT,1932,2,na,1934,5116.161853900741
STAT,1845,45,35-39,1890,0.09959652184252804
SIM,1880,36,50-100,1916,1
STAT,1804,54,50-100,1858,0.04314596869802442
STAT,1804,109,na,1913,2.4109885925880343E-4
STAT,1858,53,50-100,1911,0.011020807907176355
STAT,1789,101,na,1890,0.12590361044462434
SIM,1903,35,45-49,1938,2
STAT,1934,28,35-39,1962,19.070312674057494
SIM,1908,22,na,1930,3244
STAT,1876,18,20-24,1894,17.24454655909342
SIM,1841,40,35-39,1881,3
SIM,1943,18,25-29,1961,49
STAT,1816,97,na,1913,2.503446617575376
SIM,1868,33,50-100,1901,5
SIM,1923,17,45-49,1940,1
STAT,1855,13,na,1868,2001.8241678500135
STAT,1859,27,na,1886,1830.3154259978883
SIM,1839,59,na,1898,1400
STAT,1840,30,25-29,1870,8.870407636507743
STAT,1917,22,15-19,1939,5.344427538436134
STAT,1851,39,25-29,1890,2.090112689206752
STAT,1821,41,30-34,1862,1.978299382877356
STAT,1869,20,20-24,1889,63.66347489410172
STAT,1937,17,45-49,1954,0.459030214628352
SIM,1805,79,na,1884,269
SIM,1878,46,50-100,1924,4
SIM,1835,45,na,1880,1535
SIM,1848,41,35-39,1889,4
STAT,1870,77,na,1947,800.1414388723435
SIM,1831,31,na,1862,1677
STAT,1868,16,20-24,1884,16.376712543419167
SIM,1901,26,20-24,1927,16
STAT,1880,44,na,1924,2266.358513935425
SIM,1898,31,45-49,1929,2
STAT,1848,40,50-100,1888,0.7798852679645851
STAT,1833,40,35-39,1873,1.3700177562575828
STAT,1877,56,na,1933,1999.487854517287
STAT,1783,100,na,1883,0.17882689304254779
SIM,1897,27,45-49,1924,1
STAT,1867,62,na,1929,1621.1984009741532
STAT,1889,27,45-49,1916,1.294915448398944
SIM,1860,28,na,1888,2020
SIM,1838,35,40-44,1873,5
STAT,1860,83,na,1943,304.7906057491705
SIM,1840,20,25-29,1860,49
STAT,1878,51,20-24,1929,7.291809235042535E-4
SIM,1869,29,35-39,1898,11
STAT,1843,106,na,1949,0.008759687565057406
STAT,1850,27,15-19,1877,0.3758789502248586
STAT,1925,43,30-34,1968,0.14600840383799532
STAT,1897,26,40-44,1923,3.7976293554405864
STAT,1862,42,30-34,1904,0.9253055495185707
STAT,1830,31,50-100,1861,0.7790950997738662
STAT,1896,59,na,1955,2426.477587721581
STAT,1903,45,45-49,1948,0.1807063726892619
STAT,1823,51,na,1874,1294.2307267095398
STAT,1834,44,20-24,1878,0.11551160311726093
STAT,1827,65,na,1892,937.8435557897018
STAT,1812,46,35-39,1858,0.468239204895318
STAT,1892,45,na,1937,2688.6114774243547
STAT,1869,28,30-34,1897,22.946199717896782
SIM,1881,21,25-29,1902,57
STAT,1821,49,40-44,1870,0.2538802138748185
SIM,1776,92,na,1868,11
STAT,1886,76,na,1962,1157.2472547408145
SIM,1847,30,na,1877,1817
SIM,1853,23,15-19,1876,3
SIM,1819,35,30-34,1854,2
SIM,1925,22,15-19,1947,9
SIM,1818,49,na,1867,1255
SIM,1914,18,na,1932,4043
STAT,1762,96,na,1858,0.28089663965958267
STAT,1881,29,na,1910,2161.2944259476258
STAT,1943,28,25-29,1971,66.1877406735898
SIM,1942,28,35-39,1970,16
STAT,1878,17,40-44,1895,0.1798764744842507
STAT,1882,62,na,1944,1680.1419785167177
SIM,1857,13,na,1870,2272
SIM,1888,30,25-29,1918,12
STAT,1916,18,15-19,1934,9.072077849112771
SIM,1869,21,25-29,1890,54
STAT,1851,20,35-39,1871,5.184444620690819
SIM,1850,34,na,1884,1799
SIM,1896,8,na,1904,3320
STAT,1889,41,na,1930,2707.730883930769
SIM,1923,28,25-29,1951,74
STAT,1914,30,25-29,1944,8.858179919579165
SIM,1884,62,na,1946,1766
SIM,1887,30,30-34,1917,22
STAT,1936,29,50-100,1965,0.8988341675472182
STAT,1869,49,50-100,1918,0.2198964985771305
STAT,1863,54,40-44,1917,0.00850189557415106
SIM,1931,38,25-29,1969,1
STAT,1919,35,30-34,1954,1.8600299425145792
STAT,1814,40,25-29,1854,2.1647994650891653
STAT,1935,18,25-29,1953,55.815899623696325
SIM,1859,31,na,1890,1974
STAT,1923,38,25-29,1961,1.0767613312713553
SIM,1875,15,15-19,1890,5
STAT,1899,20,30-34,1919,23.19761091442041
STAT,1840,41,40-44,1881,1.6550875423227356
SIM,1878,93,na,1971,145
STAT,1771,113,na,1884,3.3232450332173634E-4
SIM,1858,28,20-24,1886,9
SIM,1886,26,30-34,1912,25
STAT,1832,39,15-19,1871,0.04212843357059233
SIM,1846,101,na,1947,1
SIM,1863,44,40-44,1907,4
SIM,1806,48,na,1854,1235
STAT,1831,86,na,1917,135.3145294344012
STAT,1769,86,na,1855,55.8417
STAT,1902,24,na,1926,3133.222100061625
STAT,1922,40,25-29,1962,0.07765087462499771
STAT,1936,22,25-29,1958,83.41071212023287
STAT,1878,26,30-34,1904,24.850190531289943
STAT,1839,48,15-19,1887,2.682823186408684E-4
SIM,1944,22,25-29,1966,100
STAT,1828,82,na,1910,264.8678814963682
STAT,1845,23,15-19,1868,2.864098784352554
SIM,1817,64,na,1881,950
SIM,1905,37,45-49,1942,3
STAT,1848,59,na,1907,1400.1173090492023
STAT,1867,15,15-19,1882,5.445292129373407
STAT,1861,40,50-100,1901,0.8371243542957191
STAT,1918,45,40-44,1963,0.15924071523059302
STAT,1927,45,30-34,1972,0.10622098091303013
STAT,1910,24,30-34,1934,25.33087097836852
SIM,1800,91,na,1891,8
SIM,1820,68,na,1888,757
STAT,1869,36,30-34,1905,4.897018739327395
STAT,1840,47,na,1887,1580.0196865259766
STAT,1920,43,30-34,1963,0.13318435516397958
SIM,1945,18,35-39,1963,3
SIM,1948,19,15-19,1967,40
SIM,1856,66,na,1922,1252
SIM,1822,48,50-100,1870,1
STAT,1838,81,na,1919,368.81454286576474
SIM,1888,15,25-29,1903,5
STAT,1860,29,25-29,1889,32.355630109479954
SIM,1938,20,35-39,1958,9
STAT,1810,47,15-19,1857,0.0014221953521626844
STAT,1881,31,25-29,1912,9.380910156822944
SIM,1922,37,45-49,1959,3
STAT,1890,32,40-44,1922,5.009024708431224
STAT,1926,39,40-44,1965,1.724852188911224
SIM,1919,27,45-49,1946,1
SIM,1936,24,40-44,1960,2
STAT,1859,2,na,1861,2620.9238307938504
STAT,1917,38,25-29,1955,0.9612860251540183
SIM,1842,20,35-39,1862,5
STAT,1910,35,35-39,1945,2.205444508614083
STAT,1866,30,45-49,1896,1.5310587402161673
SIM,1837,84,na,1921,185
SIM,1882,41,35-39,1923,3
SIM,1934,16,30-34,1950,13
STAT,1830,31,30-34,1861,14.846216959944776
STAT,1839,50,na,1889,1471.3953622628628
STAT,1874,32,na,1906,2304.0585638708767
SIM,1879,20,30-34,1899,16
STAT,1940,20,25-29,1960,88.94442888950029
SIM,1925,33,30-34,1958,18
STAT,1863,40,20-24,1903,0.13321122072876543
STAT,1771,89,na,1860,24.16326926979953
SIM,1801,60,na,1861,973
SIM,1875,38,25-29,1913,3
STAT,1917,33,30-34,1950,15.519228517755572
STAT,1891,16,45-49,1907,0.07656963994929936
STAT,1902,17,35-39,1919,0.7315105802101434
STAT,1903,62,na,1965,2665.147300778842
STAT,1878,15,15-19,1893,5.863465471161292
SIM,1832,25,45-49,1857,4
SIM,1807,86,na,1893,65
SIM,1879,32,25-29,1911,12
STAT,1926,17,20-24,1943,157.0471857458695
SIM,1877,36,30-34,1913,3
SIM,1887,43,na,1930,2387
STAT,1823,41,40-44,1864,2.99862298968653
STAT,1921,27,35-39,1948,15.808590994687087
SIM,1843,25,20-24,1868,12
STAT,1916,5,na,1921,4016.662881298055
STAT,1936,31,15-19,1967,0.11796239903096709
SIM,1840,24,40-44,1864,1
STAT,1823,67,na,1890,834.2020153096053
STAT,1867,38,25-29,1905,2.541182190904198
SIM,1911,5,na,1916,3816
STAT,1953,5,na,1958,4493.2881719000525
STAT,1822,82,na,1904,241.00519618321994
STAT,1826,96,na,1922,4.686744846728819
STAT,1837,21,15-19,1858,2.745988979725382
SIM,1845,21,15-19,1866,5
STAT,1908,45,20-24,1953,0.00957812475430426
STAT,1783,74,na,1857,354.42903343351924
STAT,1914,37,45-49,1951,0.6428973593853222
STAT,1866,31,35-39,1897,8.85660985087949
STAT,1965,3,na,1968,4638.164175633609
STAT,1835,25,20-24,1860,9.678148556121123
STAT,1787,88,na,1875,44.8983297962962
STAT,1901,30,15-19,1931,0.189817422060761
SIM,1854,36,50-100,1890,3
STAT,1840,108,na,1948,0.0012756429193468274
STAT,1862,27,30-34,1889,20.367335265787485
SIM,1831,41,40-44,1872,3
SIM,1932,18,25-29,1950,52
STAT,1874,28,15-19,1902,0.4365221224245292
STAT,1914,25,na,1939,3591.204109935002
STAT,1918,39,na,1957,3738.0667200764724
SIM,1918,43,40-44,1961,3
SIM,1828,48,na,1876,1327
SIM,1838,31,25-29,1869,11
STAT,1851,63,na,1914,1308.4596327311717
SIM,1824,47,50-100,1871,1
STAT,1920,30,25-29,1950,9.641307772917404
STAT,1927,33,15-19,1960,0.1492572372882862
STAT,1855,77,na,1932,612.1943207224268
SIM,1847,14,na,1861,2100
STAT,1789,74,na,1863,398.19494169521244
STAT,1864,42,40-44,1906,1.896749714347203
SIM,1934,17,20-24,1951,143
STAT,1904,15,40-44,1919,0.24895261156195278
SIM,1838,35,50-100,1873,4
STAT,1843,50,45-49,1893,0.01062051844253862
STAT,1846,51,25-29,1897,0.002509324721500593
SIM,1882,35,50-100,1917,2
SIM,1913,18,15-19,1931,6
SIM,1854,2,na,1856,2663
STAT,1847,58,na,1905,1455.093881411069
SIM,1883,21,35-39,1904,4
STAT,1929,41,25-29,1970,0.08749399485397642
SIM,1878,19,35-39,1897,1
STAT,1881,0,na,1881,3268.779763924755
STAT,1819,52,30-34,1871,0.010166406549634069
STAT,1924,18,25-29,1942,48.627824174242164
SIM,1929,22,35-39,1951,14
SIM,1902,28,40-44,1930,10
STAT,1920,40,15-19,1960,0.0016067916262599378
STAT,1876,26,20-24,1902,11.480424253420221
STAT,1907,16,20-24,1923,24.658165542975436
STAT,1874,41,35-39,1915,1.7563088881634539
SIM,1884,26,20-24,1910,15
STAT,1870,53,20-24,1923,6.721020501086603E-4
SIM,1820,52,na,1872,1213
STAT,1832,24,40-44,1856,1.8036867733113526
STAT,1807,50,35-39,1857,0.03173047337891753
SIM,1912,20,15-19,1932,4
SIM,1913,25,50-100,1938,4
STAT,1853,44,30-34,1897,0.8410944272404064
STAT,1886,43,30-34,1929,1.1392222621417403
STAT,1928,24,40-44,1952,3.9414552614123974
STAT,1922,18,50-100,1940,0.4085695861119987
SIM,1872,42,40-44,1914,8
STAT,1830,39,40-44,1869,3.381600475427825
STAT,1934,35,20-24,1969,0.3442418057469737
STAT,1873,20,35-39,1893,5.62907750780155
STAT,1922,47,20-24,1969,0.011994357533752869
STAT,1940,27,45-49,1967,1.664091551382852
STAT,1899,26,15-19,1925,0.5893851170455376
SIM,1883,46,50-100,1929,2
STAT,1857,79,na,1936,520.659178509103
STAT,1937,18,35-39,1955,3.8457521784409407
SIM,1872,13,na,1885,2442
SIM,1896,36,40-44,1932,6
STAT,1926,16,30-34,1942,14.153878700720044
SIM,1831,90,na,1921,39
SIM,1888,41,50-100,1929,1
SIM,1848,40,45-49,1888,3
STAT,1869,80,na,1949,565.6672084272748
STAT,1915,17,45-49,1932,0.0987596555256793
STAT,1856,36,45-49,1892,1.4820679370094174
SIM,1925,38,25-29,1963,1
SIM,1927,20,na,1947,4194
STAT,1833,27,15-19,1860,0.3652668945280694
STAT,1910,26,20-24,1936,16.70423094029624
STAT,1880,18,50-100,1898,0.04857026180849319
STAT,1774,111,na,1885,0.0011526753310955277
STAT,1905,18,15-19,1923,8.080358010346783
STAT,1880,76,na,1956,979.9271513892731
SIM,1859,16,20-24,1875,15
STAT,1873,10,na,1883,2547.0584353423096
STAT,1826,37,25-29,1863,3.1203656798525254
SIM,1903,32,40-44,1935,3
SIM,1870,70,na,1940,1274
STAT,1861,15,20-24,1876,16.175182284342903
STAT,1849,65,na,1914,1218.1094817737824
SIM,1866,65,na,1931,1447
SIM,1911,10,na,1921,3777
STAT,1892,49,15-19,1941,2.6135231331709326E-4
SIM,1874,84,na,1958,350
STAT,1863,29,50-100,1892,0.5274125967942507
SIM,1920,22,15-19,1942,6
STAT,1772,90,na,1862,24.10724706434972
STAT,1918,47,30-34,1965,0.08961619004532202
STAT,1925,24,15-19,1949,5.9824687673565125
SIM,1882,2,na,1884,2745
SIM,1864,21,25-29,1885,53
SIM,1908,27,20-24,1935,19
STAT,1901,43,20-24,1944,0.014477239529386664
STAT,1921,20,15-19,1941,5.714305314001627
SIM,1898,0,na,1898,3459
STAT,1832,71,na,1903,807.098567712144
STAT,1916,41,15-19,1957,0.001488789996143836
SIM,1794,89,na,1883,38
SIM,1886,37,50-100,1923,1
SIM,1919,49,na,1968,3747
STAT,1884,9,na,1893,2422.1930518542285
STAT,1877,83,na,1960,536.5408291013069
SIM,1790,75,na,1865,354
SIM,1861,44,50-100,1905,3
STAT,1836,37,30-34,1873,4.131038163397106
SIM,1935,23,na,1958,4696
SIM,1862,51,na,1913,1889
STAT,1810,49,40-44,1859,0.5884918389301522
SIM,1919,20,25-29,1939,104
SIM,1915,35,na,1950,3590
STAT,1911,28,40-44,1939,4.278049831216045
SIM,1933,24,15-19,1957,9
STAT,1894,45,30-34,1939,0.06701652053765011
STAT,1905,47,20-24,1952,0.00919765572011929
STAT,1949,20,45-49,1969,1.2412808971987486
STAT,1848,18,45-49,1866,0.05799406872896712
STAT,1867,51,45-49,1918,0.012934108352904651
STAT,1857,95,na,1952,9.901862503686443
STAT,1808,49,25-29,1857,0.21210594424394819
STAT,1841,85,na,1926,187.56046845826623
STAT,1936,30,25-29,1966,8.489058524022342
SIM,1844,37,30-34,1881,4
STAT,1890,48,15-19,1938,2.5733774765480434E-4
STAT,1856,14,na,1870,2069.616596808343
STAT,1900,26,15-19,1926,0.596658368583035
SIM,1851,31,50-100,1882,4
STAT,1871,25,30-34,1896,23.74394453140173
STAT,1886,60,na,1946,1903.6020937687344
STAT,1893,41,45-49,1934,1.8020138452084524
STAT,1828,38,35-39,1866,6.569304681838724
STAT,1902,22,30-34,1924,23.74641233929956
STAT,1785,104,na,1889,0.033762625055275594
SIM,1777,93,na,1870,4
SIM,1903,34,30-34,1937,19
STAT,1937,29,15-19,1966,0.6493644460013095
SIM,1899,24,15-19,1923,4
STAT,1888,39,45-49,1927,2.2023602747894255
STAT,1853,41,15-19,1894,0.010287818062565481
STAT,1929,40,35-39,1969,0.24705223624569891
STAT,1869,64,na,1933,1589.6188934013983
STAT,1914,45,20-24,1959,0.010400787692037852
STAT,1873,21,25-29,1894,55.05902134534937
SIM,1896,46,50-100,1942,1
STAT,1955,17,50-100,1972,0.4698172892953515
STAT,1945,16,40-44,1961,1.4438200474318887
STAT,1836,52,30-34,1888,0.003803372147043097
STAT,1920,37,45-49,1957,0.7051581358424596
STAT,1820,86,na,1906,118.20108039176557
STAT,1827,54,30-34,1881,0.00440325058045506
STAT,1900,16,50-100,1916,0.06436593967865989
SIM,1910,22,30-34,1932,28
STAT,1888,24,na,1912,2622.895045147694
SIM,1836,30,na,1866,1743
SIM,1887,44,50-100,1931,1
SIM,1949,7,na,1956,4296
SIM,1846,45,50-100,1891,1
STAT,1896,75,na,1971,1710.9854214387215
STAT,1901,37,35-39,1938,2.018640236179927
SIM,1854,59,na,1913,1515
STAT,1847,38,45-49,1885,1.5061339305541097
STAT,1892,61,na,1953,2210.608563885683
SIM,1869,25,40-44,1894,4
SIM,1938,33,40-44,1971,3
STAT,1826,50,45-49,1876,0.013624749971955816
STAT,1852,48,na,1900,1687.888552919055
STAT,1878,22,15-19,1900,3.2444335101604356
STAT,1897,22,25-29,1919,72.3249853896021
STAT,1775,110,na,1885,0.0017865861015816473
STAT,1931,30,50-100,1961,1.024634025899573
SIM,1870,27,30-34,1897,24
STAT,1892,48,25-29,1940,0.037954340009780096
SIM,1922,27,50-100,1949,1
SIM,1886,22,15-19,1908,3
SIM,1908,26,30-34,1934,38
SIM,1849,41,50-100,1890,1
STAT,1912,44,35-39,1956,0.18200825235321336
SIM,1875,58,na,1933,1910
SIM,1919,28,35-39,1947,20
STAT,1920,18,40-44,1938,1.478675468293919
STAT,1852,25,20-24,1877,10.532309694567145
STAT,1853,100,na,1953,0.7873242763914563
STAT,1894,42,15-19,1936,0.0011639406823367696
SIM,1816,90,na,1906,22
SIM,1927,26,40-44,1953,6
STAT,1925,37,20-24,1962,0.29892832459028656
SIM,1954,15,na,1969,4140
SIM,1855,31,25-29,1886,10
SIM,1917,17,20-24,1934,26
STAT,1804,53,na,1857,1151.3664736231915
SIM,1966,5,na,1971,4541
SIM,1834,37,25-29,1871,2
STAT,1871,83,na,1954,371.79557082485775
STAT,1856,21,25-29,1877,49.547919206353924
SIM,1862,99,na,1961,2
STAT,1921,22,40-44,1943,3.5879988027100502
STAT,1777,89,na,1866,33.06102109907506
STAT,1912,22,15-19,1934,4.818252313351074
SIM,1890,49,50-100,1939,1
STAT,1875,97,na,1972,34.487095179997624
STAT,1852,32,na,1884,1877.2000456433811
SIM,1874,30,50-100,1904,1
STAT,1919,26,40-44,1945,4.774008234524049
SIM,1835,29,na,1864,1718
STAT,1847,30,35-39,1877,8.932461894192011
STAT,1847,31,25-29,1878,8.941046082234331
STAT,1837,17,30-34,1854,1.7514147016264594
SIM,1928,29,15-19,1957,4
SIM,1849,80,na,1929,379
STAT,1817,37,20-24,1854,2.673101211892569
SIM,1865,4,na,1869,2480
SIM,1910,27,25-29,1937,71
STAT,1936,26,40-44,1962,4.215144938880862
SIM,1858,23,15-19,1881,6
STAT,1845,42,30-34,1887,0.8246392935177431
SIM,1849,10,na,1859,2163
SIM,1938,28,45-49,1966,2
STAT,1851,48,15-19,1899,2.8964067232961096E-4
STAT,1791,88,na,1879,43.95153845229575
SIM,1850,66,na,1916,1208
STAT,1893,28,25-29,1921,50.52468539737913
SIM,1845,17,30-34,1862,2
STAT,1889,19,45-49,1908,0.07577525065609582
STAT,1925,46,35-39,1971,0.14797655928172945
STAT,1888,56,na,1944,2276.252274688107
SIM,1855,30,35-39,1885,15
STAT,1853,70,na,1923,1040.5308202597355
STAT,1902,27,25-29,1929,56.39406105744882
SIM,1881,25,40-44,1906,2
SIM,1890,6,na,1896,3130
STAT,1884,51,45-49,1935,0.013612736558775937
SIM,1944,26,40-44,1970,6
STAT,1871,16,50-100,1887,0.04645296061678457
SIM,1906,58,na,1964,2921
STAT,1873,48,15-19,1921,3.787435255932858E-4
STAT,1805,53,40-44,1858,0.03010034338400201
SIM,1897,20,25-29,1917,89
SIM,1859,95,na,1954,13
STAT,1842,70,na,1912,999.146799562908
STAT,1854,28,na,1882,1788.6356138101899
SIM,1936,27,45-49,1963,1
SIM,1825,31,50-100,1856,4
SIM,1855,81,na,1936,379
STAT,1851,8,na,1859,2189.402740538129
SIM,1924,30,35-39,1954,12
STAT,1869,27,40-44,1896,2.7392538484015967
STAT,1877,30,20-24,1907,2.671154285169005
STAT,1779,85,na,1864,81.91577617349216
SIM,1901,35,35-39,1936,4
STAT,1934,38,25-29,1972,1.2822575197897461
SIM,1862,21,15-19,1883,3
STAT,1829,38,50-100,1867,1.0760318915993083
STAT,1823,44,45-49,1867,1.8328673565032432
SIM,1924,16,25-29,1940,57
STAT,1934,33,30-34,1967,20.308361966833736
SIM,1907,33,50-100,1940,3
STAT,1939,29,25-29,1968,62.44074310156082
SIM,1878,40,30-34,1918,2
STAT,1922,31,35-39,1953,9.79475217032089
SIM,1831,44,45-49,1875,1
STAT,1880,15,30-34,1895,1.5916646206089005
STAT,1927,40,25-29,1967,0.08484892275945766
STAT,1858,80,na,1938,458.7693286854343
SIM,1940,25,45-49,1965,1
SIM,1951,16,30-34,1967,17
STAT,1848,38,15-19,1886,0.041259087991400795
SIM,1919,24,40-44,1943,2
STAT,1892,20,45-49,1912,0.8298581920960564
STAT,1909,35,na,1944,3395.166956907467
STAT,1875,21,35-39,1896,5.680654055542345
STAT,1853,48,25-29,1901,0.042179875095139485
STAT,1921,24,30-34,1945,30.478016436968645
SIM,1837,38,50-100,1875,1
STAT,1868,79,na,1947,630.5768805433372
STAT,1848,43,na,1891,1653.0434101868298
SIM,1946,23,na,1969,3760
STAT,1828,31,15-19,1859,0.1590288330806812
STAT,1766,89,na,1855,32.372
STAT,1887,82,na,1969,861.3103757823549
SIM,1896,31,35-39,1927,13
STAT,1873,25,40-44,1898,2.8919589568224096
STAT,1865,26,45-49,1891,0.9564048844752839
STAT,1917,26,30-34,1943,38.95038023568943
STAT,1916,30,35-39,1946,8.9842552670397
STAT,1818,77,na,1895,416.74378424893314
SIM,1820,90,na,1910,25
STAT,1932,27,50-100,1959,1.2316242592081292
STAT,1865,51,35-39,1916,0.007425762655809739
STAT,1872,44,40-44,1916,2.10398016631194
SIM,1810,103,na,1913,1
SIM,1911,30,25-29,1941,15
SIM,1864,58,na,1922,1764
SIM,1930,31,35-39,1961,12
STAT,1880,40,20-24,1920,0.1594527666422485
STAT,1780,102,na,1882,0.07153005383478372
STAT,1923,20,25-29,1943,102.14642501017346
SIM,1948,20,40-44,1968,3
STAT,1898,45,na,1943,2906.38127338037
SIM,1901,11,na,1912,3495
STAT,1894,31,na,1925,2911.744342366957
STAT,1805,50,25-29,1855,0.010758668789339705
STAT,1922,17,na,1939,4024.4852736167923
SIM,1873,62,na,1935,1745
SIM,1873,26,45-49,1899,1
STAT,1930,33,50-100,1963,1.0074235861182042
STAT,1858,58,na,1916,1466.6448584774305
STAT,1915,37,15-19,1952,0.01832466967769622
STAT,1908,43,30-34,1951,0.11104375842795174
STAT,1824,50,35-39,1874,0.010136295841045763
SIM,1835,39,50-100,1874,1
STAT,1831,43,40-44,1874,1.6905792989372739
SIM,1859,19,25-29,1878,5
STAT,1827,39,50-100,1866,1.1680854941283034
STAT,1921,38,15-19,1959,0.02023747065982684
STAT,1888,31,35-39,1919,11.348095258340743
STAT,1845,51,na,1896,1523.90775783695
SIM,1807,49,na,1856,1185
SIM,1878,16,30-34,1894,1
STAT,1915,22,40-44,1937,3.2830993191655318
STAT,1941,20,na,1961,3567.3019118076736
SIM,1787,92,na,1879,8
SIM,1868,13,na,1881,2384
SIM,1898,30,30-34,1928,21
STAT,1802,89,na,1891,35.83770279847365
SIM,1883,61,na,1944,1725
STAT,1812,43,30-34,1855,4.137817463313798
SIM,1869,28,45-49,1897,1
SIM,1820,43,30-34,1863,2
SIM,1860,27,25-29,1887,36
STAT,1939,27,20-24,1966,17.333844955519105
STAT,1852,27,25-29,1879,37.4341407245806
STAT,1893,46,na,1939,2704.854414171691
STAT,1838,52,40-44,1890,0.0071420418237411075
STAT,1882,46,na,1928,2074.0381986855577
STAT,1943,16,30-34,1959,12.213389783168658
STAT,1932,38,na,1970,4770.608885121272
STAT,1938,22,35-39,1960,8.802513971914372
SIM,1829,40,35-39,1869,2
SIM,1843,96,na,1939,7
STAT,1850,102,na,1952,0.206395871662951
STAT,1902,20,50-100,1922,0.5468887259540423
SIM,1946,22,35-39,1968,13
STAT,1903,30,25-29,1933,13.877055055026629
STAT,1908,48,25-29,1956,0.04518298923304675
STAT,1851,101,na,1952,0.4184476591856353
STAT,1864,45,45-49,1909,0.20124385043651566
STAT,1879,42,na,1921,2279.3825351531545
STAT,1916,16,25-29,1932,8.706748338062836
STAT,1949,6,na,1955,4319.572023882882
SIM,1910,47,50-100,1957,3
STAT,1830,85,na,1915,163.75460635058482
STAT,1870,42,50-100,1912,0.9767212955312515
SIM,1895,46,na,1941,2810
STAT,1917,35,20-24,1952,0.2611048963856114
SIM,1885,30,20-24,1915,3
SIM,1891,32,na,1923,2933
STAT,1876,39,na,1915,2274.554330411214
STAT,1839,36,45-49,1875,1.6049917613056002
STAT,1854,21,15-19,1875,2.8114422455557198
STAT,1797,66,na,1863,770.7474631371754
STAT,1866,13,na,1879,2334.615176932989
STAT,1940,24,40-44,1964,3.233250409064054
STAT,1873,27,45-49,1900,1.0646789096839935
STAT,1916,53,na,1969,3483.9005613749114
SIM,1914,35,45-49,1949,3
SIM,1930,24,na,1954,4335
SIM,1816,63,na,1879,872
SIM,1862,25,30-34,1887,28
STAT,1891,41,35-39,1932,2.126977449847561
STAT,1854,25,30-34,1879,21.192966715915556
STAT,1877,38,30-34,1915,5.19876119534017
SIM,1840,27,45-49,1867,4
SIM,1841,30,na,1871,1865
STAT,1832,27,45-49,1859,0.9115804045124122
SIM,1885,38,30-34,1923,9
STAT,1918,43,15-19,1961,0.001539991273448817
STAT,1839,66,na,1905,1092.8462438554807
SIM,1845,44,na,1889,1596
SIM,1923,22,40-44,1945,4
STAT,1927,43,40-44,1970,0.2959083693143176
STAT,1873,7,na,1880,2608.1535900872495
STAT,1876,17,30-34,1893,1.5544297798902609
STAT,1928,27,45-49,1955,2.0108850958931974
STAT,1849,31,35-39,1880,8.540806377738276
STAT,1906,35,45-49,1941,0.5975136517398276
SIM,1924,17,na,1941,4156
SIM,1874,30,45-49,1904,2
SIM,1857,31,35-39,1888,13
STAT,1812,47,25-29,1859,0.18953405463018286
STAT,1924,24,na,1948,4045.6537167824044
STAT,1928,38,na,1966,4487.582601916206
SIM,1877,38,35-39,1915,15
SIM,1896,31,na,1927,3032
SIM,1847,36,45-49,1883,1
STAT,1851,47,na,1898,1642.1535567891249
SIM,1903,37,35-39,1940,6
STAT,1902,24,20-24,1926,91.29543820228781
STAT,1904,20,15-19,1924,4.496262143654836
STAT,1844,29,na,1873,1832.4661379847034
STAT,1884,15,15-19,1899,5.565879159405134
SIM,1905,30,25-29,1935,11
STAT,1812,110,na,1922,1.1885254990471032E-4
STAT,1944,23,na,1967,3723.497022325442
STAT,1912,35,45-49,1947,0.6343907832884412
SIM,1881,20,35-39,1901,9
SIM,1867,18,20-24,1885,16
SIM,1785,85,na,1870,59
SIM,1922,7,na,1929,4393
STAT,1941,27,15-19,1968,0.6898417671758335
SIM,1892,27,20-24,1919,20
SIM,1907,21,na,1928,3307
STAT,1850,40,35-39,1890,1.2876804620081121
STAT,1871,28,35-39,1899,9.004831777902202
SIM,1897,40,40-44,1937,1
SIM,1877,28,na,1905,2309
SIM,1842,39,25-29,1881,2
SIM,1858,27,30-34,1885,2
STAT,1888,36,40-44,1924,4.908850989532469
STAT,1920,10,na,1930,4212.498865926771
STAT,1865,28,na,1893,2041.4871282000126
SIM,1860,40,45-49,1900,2
STAT,1869,38,35-39,1907,6.435659641423654
SIM,1847,51,na,1898,1543
STAT,1870,47,35-39,1917,0.12898955640726847
SIM,1910,24,20-24,1934,100
SIM,1938,5,na,1943,3670
STAT,1889,39,15-19,1928,0.06483235059546683
STAT,1828,35,30-34,1863,5.291532974180179
SIM,1932,16,20-24,1948,159
STAT,1863,32,na,1895,1981.6251114449822
SIM,1826,52,na,1878,1310
STAT,1897,20,20-24,1917,87.58458372783033
SIM,1939,27,25-29,1966,70
STAT,1889,40,40-44,1929,2.6497371592190273
SIM,1925,28,35-39,1953,13
STAT,1924,16,20-24,1940,152.90788069927
STAT,1834,39,25-29,1873,2.171256598910725
SIM,1861,44,30-34,1905,1
STAT,1859,43,na,1902,1729.912951864356
STAT,1882,83,na,1965,613.514189475227
SIM,1926,18,25-29,1944,60
STAT,1901,34,30-34,1935,22.889096940654767
STAT,1918,18,25-29,1936,44.44132412727104
SIM,1868,30,45-49,1898,1
STAT,1936,35,30-34,1971,1.6929275577861187
STAT,1861,84,na,1945,260.96650995058707
STAT,1865,98,na,1963,8.57827510744892
STAT,1872,41,25-29,1913,0.611649884473356
SIM,1844,81,na,1925,333
STAT,1846,54,40-44,1900,0.0072186348069007995
SIM,1848,95,na,1943,10
STAT,1896,30,30-34,1926,21.974243157704667
STAT,1840,53,35-39,1893,0.005899228589944749
STAT,1859,18,20-24,1877,15.423712469622231
SIM,1789,99,na,1888,1
STAT,1917,28,35-39,1945,14.821189174196617
STAT,1841,29,15-19,1870,0.38003922531829637
STAT,1943,18,35-39,1961,4.202087132678149
SIM,1927,22,25-29,1949,104
SIM,1911,36,30-34,1947,2
SIM,1908,22,15-19,1930,4
STAT,1870,98,na,1968,15.960541468182761
STAT,1936,29,45-49,1965,1.5600910692477081
SIM,1879,30,20-24,1909,2
SIM,1916,6,na,1922,3918
SIM,1924,31,50-100,1955,5
STAT,1927,7,na,1934,4695.831377835043
SIM,1836,35,30-34,1871,6
STAT,1916,31,50-100,1947,0.8096634636616026
SIM,1810,53,na,1863,1188
SIM,1840,26,45-49,1866,1
STAT,1858,25,15-19,1883,0.34945240859960425
SIM,1814,67,na,1881,762
STAT,1810,46,25-29,1856,0.2082823403694762
STAT,1862,47,na,1909,1804.5544813257798
STAT,1850,15,45-49,1865,0.05686349819033128
STAT,1853,44,50-100,1897,0.7728975800924351
STAT,1873,28,45-49,1901,1.0609312399219055
SIM,1831,52,na,1883,1364
SIM,1950,20,35-39,1970,13
SIM,1889,41,45-49,1930,2
STAT,1895,26,30-34,1921,31.150776295558757
STAT,1849,48,20-24,1897,0.008540809129474667
SIM,1881,28,45-49,1909,2
STAT,1799,73,na,1872,509.7829327052255
SIM,1890,10,na,1900,3102
SIM,1931,20,25-29,1951,125
SIM,1874,9,na,1883,2565
SIM,1855,35,40-44,1890,1
STAT,1812,67,na,1879,802.2224521219821
STAT,1932,25,45-49,1957,2.1395701529201308
SIM,1898,32,35-39,1930,12
SIM,1857,51,na,1908,1716
SIM,1870,23,15-19,1893,3
SIM,1951,18,35-39,1969,10
STAT,1850,52,40-44,1902,0.007372034477438655
STAT,1931,41,40-44,1972,0.31612909031505787
STAT,1919,22,25-29,1941,95.55188930827394
STAT,1862,23,15-19,1885,2.7019146402693957
STAT,1815,39,15-19,1854,0.18764191956114842
SIM,1944,16,na,1960,3713
STAT,1867,94,na,1961,37.821552997892574
SIM,1880,44,40-44,1924,6
STAT,1907,0,na,1907,4074.070119007682
SIM,1894,24,na,1918,2972
STAT,1832,26,45-49,1858,0.9241883165354355
STAT,1927,16,na,1943,4334.566263603456
STAT,1954,17,45-49,1971,0.5833752241337734
SIM,1888,37,45-49,1925,3
STAT,1914,48,25-29,1962,0.04955177174467245
SIM,1876,43,na,1919,2281
STAT,1903,36,30-34,1939,1.5535398572165529
STAT,1897,60,na,1957,2452.6660035973446
SIM,1797,70,na,1867,665
STAT,1896,38,na,1934,2926.9234738830824
STAT,1889,20,25-29,1909,67.16230602044024
SIM,1906,28,25-29,1934,63
STAT,1879,53,40-44,1932,0.010228430539385805
STAT,1912,41,30-34,1953,0.11712774474180072
SIM,1907,18,15-19,1925,7
STAT,1833,66,na,1899,995.0267379718597
STAT,1881,54,35-39,1935,0.007636757379678609
STAT,1923,39,15-19,1962,0.02097714609360868
SIM,1878,17,30-34,1895,5
STAT,1892,2,na,1894,3153.493799312346
STAT,1892,24,na,1916,2780.3534091010174
STAT,1831,40,25-29,1871,0.5022474010483846
STAT,1846,95,na,1941,9.374317882515966
STAT,1765,93,na,1858,5.941511332653802
STAT,1878,18,30-34,1896,1.5633880927312358
STAT,1834,20,35-39,1854,8.709337807833755
STAT,1847,35,40-44,1882,3.41197205557149
STAT,1786,103,na,1889,0.05237766443093762
STAT,1871,32,30-34,1903,16.35178400624075
STAT,1829,29,na,1858,1737.888034845497
STAT,1912,39,na,1951,3433.171232567037
STAT,1918,30,50-100,1948,0.8366428782937914
STAT,1911,36,50-100,1947,0.3848545442957781
SIM,1866,37,20-24,1903,3
STAT,1852,28,25-29,1880,37.16536359417811
STAT,1942,20,35-39,1962,9.332468148957808
STAT,1851,44,20-24,1895,0.11488821249124433
STAT,1933,24,50-100,1957,0.8239738239407779
SIM,1860,28,25-29,1888,43
SIM,1920,35,45-49,1955,1
STAT,1862,43,20-24,1905,0.12705306804762997
SIM,1866,21,35-39,1887,7
SIM,1839,27,20-24,1866,14
STAT,1864,51,30-34,1915,0.0050498481599193495
STAT,1899,62,na,1961,2496.6329650540315
STAT,1782,73,na,1855,424.76919
SIM,1949,16,15-19,1965,47
STAT,1898,18,20-24,1916,22.612323542255304
SIM,1910,26,25-29,1936,63
STAT,1854,50,na,1904,1572.7647253656676
SIM,1818,70,na,1888,603
STAT,1890,47,15-19,1937,2.5939736271475956E-4
SIM,1907,16,25-29,1923,11
SIM,1859,40,45-49,1899,2
STAT,1925,28,30-34,1953,43.57114840840014
STAT,1845,34,30-34,1879,14.32218621813032
SIM,1838,96,na,1934,8
STAT,1837,80,na,1917,390.4936755392672
SIM,1922,10,na,1932,4373
SIM,1871,25,35-39,1896,16
STAT,1945,27,45-49,1972,1.7905287622596209
SIM,1811,48,na,1859,1291
STAT,1841,48,na,1889,1526.616061458362
STAT,1847,42,40-44,1889,1.6642220031686568
SIM,1933,28,30-34,1961,47
STAT,1897,21,50-100,1918,0.5167641289594613
SIM,1836,83,na,1919,233
STAT,1839,18,40-44,1857,0.1585947489197265
STAT,1922,42,50-100,1964,0.12739459440505999
SIM,1783,89,na,1872,28
STAT,1852,85,na,1937,208.27975949875818
STAT,1927,36,40-44,1963,1.7600655727720245
SIM,1853,34,30-34,1887,23
STAT,1894,30,20-24,1924,3.3112155407055326
SIM,1948,23,45-49,1971,1
SIM,1918,39,45-49,1957,2
STAT,1902,26,25-29,1928,56.5875906173602
STAT,1842,65,na,1907,1203.4435755342386
STAT,1882,51,35-39,1933,0.007951743165679946
SIM,1910,15,30-34,1925,3
STAT,1906,4,na,1910,3618.79789394275
STAT,1887,77,na,1964,1188.5874034206352
STAT,1853,40,50-100,1893,0.7913785199208382
STAT,1851,51,20-24,1902,5.437175085584717E-4
SIM,1945,17,na,1962,3690
SIM,1852,20,na,1872,2006
STAT,1867,41,50-100,1908,0.941313367939151
SIM,1935,36,40-44,1971,2
SIM,1901,4,na,1905,3544
SIM,1886,42,na,1928,2256
SIM,1846,40,35-39,1886,7
STAT,1910,34,20-24,1944,2.2021265394233427
STAT,1871,30,na,1901,2252.848305140764
SIM,1928,15,30-34,1943,18
STAT,1879,45,40-44,1924,0.1707337118997827
STAT,1828,44,na,1872,1464.3013584373991
STAT,1852,24,20-24,1876,61.308659416995376
STAT,1912,48,15-19,1960,3.334339017216799E-4
SIM,1901,37,25-29,1938,1
STAT,1858,21,35-39,1879,5.001409921490278
STAT,1902,61,na,1963,2658.441826823498
STAT,1894,41,15-19,1935,0.016857919264507526
SIM,1827,31,na,1858,1631
SIM,1926,29,40-44,1955,5
SIM,1865,17,20-24,1882,17
STAT,1902,15,30-34,1917,2.1347365331653507
STAT,1904,23,40-44,1927,2.8144687100714934
STAT,1819,44,30-34,1863,2.110881360869966
STAT,1882,45,50-100,1927,0.22801862519764088
STAT,1841,50,35-39,1891,0.005974891102063108
STAT,1843,46,15-19,1889,2.9094019693521374E-4
STAT,1883,30,45-49,1913,1.6275255794195864
SIM,1942,26,30-34,1968,44
SIM,1906,26,20-24,1932,13
STAT,1769,91,na,1860,14.66479275126402
STAT,1920,39,35-39,1959,2.4965856609759713
SIM,1948,0,na,1948,4240
STAT,1867,18,50-100,1885,0.04416322246644438
STAT,1929,19,15-19,1948,54.425003273841604
STAT,1812,104,na,1916,0.028687576298991692
STAT,1853,40,15-19,1893,0.010344818009799478
STAT,1919,37,45-49,1956,0.6918712278451886
STAT,1936,34,40-44,1970,3.585575331186794
SIM,1894,20,45-49,1914,1
STAT,1849,28,na,1877,1835.0917216923544
STAT,1921,18,45-49,1939,0.5365551451433969
SIM,1845,50,na,1895,1539
STAT,1803,52,50-100,1855,0.04328885109329614
STAT,1899,22,35-39,1921,7.554691107640192
STAT,1895,74,na,1969,1742.7703675250111
STAT,1896,33,50-100,1929,1.1391345647467062
STAT,1837,19,45-49,1856,0.05531753664864951
STAT,1837,96,na,1933,5.42039373836337
SIM,1824,98,na,1922,1
SIM,1868,47,50-100,1915,1
STAT,1918,29,40-44,1947,4.652437974498636
STAT,1900,18,15-19,1918,7.757382359819883
STAT,1897,36,45-49,1933,2.530723904404243
SIM,1824,88,na,1912,55
SIM,1874,57,na,1931,1882
STAT,1829,83,na,1912,243.33264052544575
STAT,1864,46,35-39,1910,0.11853910880652876
STAT,1910,21,15-19,1931,4.735354688507415
STAT,1932,16,na,1948,4615.723529514442
STAT,1776,109,na,1885,0.0026590379599985446
SIM,1869,36,35-39,1905,13
STAT,1934,26,30-34,1960,49.81626999338601
STAT,1887,55,na,1942,2184.532193530427
SIM,1907,38,30-34,1945,1
STAT,1847,54,35-39,1901,0.006160255319957661
STAT,1887,45,na,1932,2400.64611722092
SIM,1909,15,20-24,1924,21
SIM,1766,93,na,1859,6
STAT,1902,34,50-100,1936,0.6953752739038412
STAT,1828,66,na,1894,930.4275441538712
STAT,1895,22,50-100,1917,0.5027239293272641
STAT,1908,40,na,1948,3282.0879291668257
SIM,1855,42,40-44,1897,5
STAT,1849,38,na,1887,1719.723495716395
SIM,1837,31,na,1868,1751
SIM,1840,35,na,1875,1749
STAT,1779,91,na,1870,17.40982435714774
SIM,1887,41,35-39,1928,4
SIM,1795,74,na,1869,421
STAT,1823,33,40-44,1856,9.926703389545809
STAT,1863,25,35-39,1888,8.128913375652267
STAT,1903,25,na,1928,3229.3273022181465
SIM,1939,16,45-49,1955,1
STAT,1879,41,35-39,1920,1.7961461479245646
STAT,1853,33,na,1886,1803.6059240450343
SIM,1869,19,30-34,1888,1
SIM,1870,33,na,1903,2199
STAT,1782,95,na,1877,2.267237371959977
STAT,1907,44,15-19,1951,0.0013125971429267115
STAT,1881,43,30-34,1924,1.041087647818942
STAT,1864,34,40-44,1898,3.630187806686659
SIM,1920,37,35-39,1957,1
STAT,1862,85,na,1947,220.9078949386299
STAT,1890,24,40-44,1914,2.3917881660571596
STAT,1913,16,45-49,1929,0.09670136447065242
SIM,1926,16,35-39,1942,7
STAT,1895,33,30-34,1928,21.433503194521098
SIM,1911,31,25-29,1942,15
SIM,1920,25,na,1945,3825
SIM,1886,64,na,1950,1653
SIM,1927,15,25-29,1942,60
STAT,1924,27,15-19,1951,0.776579981202448
STAT,1810,53,25-29,1863,0.011783093386984304
STAT,1812,44,20-24,1856,0.5471797268065073
SIM,1853,85,na,1938,185
STAT,1803,90,na,1893,26.047146598106764
STAT,1908,36,30-34,1944,1.619422471284189
SIM,1827,53,na,1880,1217
SIM,1877,35,30-34,1912,9
SIM,1903,55,na,1958,2836
STAT,1886,20,45-49,1906,0.7001663163233828
SIM,1873,19,20-24,1892,17
STAT,1910,25,50-100,1935,0.9216488121034193
STAT,1865,19,20-24,1884,15.498667225763702
STAT,1910,17,30-34,1927,2.2809227806196812
SIM,1847,21,25-29,1868,61
SIM,1840,45,na,1885,1603
STAT,1782,89,na,1871,32.5830523419633
STAT,1913,40,50-100,1953,0.10943013563669877
STAT,1881,46,35-39,1927,0.12806272150834783
SIM,1886,33,30-34,1919,23
STAT,1847,80,na,1927,455.1561608733596
STAT,1930,16,45-49,1946,0.6116404769371556
STAT,1878,33,30-34,1911,17.09834236820605
STAT,1830,35,25-29,1865,2.347443656659089
SIM,1864,35,50-100,1899,2
STAT,1870,51,30-34,1921,0.005536457167470036
STAT,1879,26,na,1905,2364.6165983299293
STAT,1866,5,na,1871,2470.336896446313
SIM,1932,10,na,1942,4834
STAT,1866,54,45-49,1920,0.012292557612052602
STAT,1857,17,20-24,1874,15.51847219938472
STAT,1939,18,45-49,1957,0.47216929314344563
SIM,1925,37,25-29,1962,1
STAT,1841,24,45-49,1865,0.5957447440363032
SIM,1874,79,na,1953,633
STAT,1849,47,20-24,1896,0.008609165906774458
SIM,1861,50,na,1911,1873
STAT,1919,34,na,1953,3821.7216771818944
SIM,1849,29,30-34,1878,24
STAT,1838,44,na,1882,1635.1185532551483
STAT,1825,31,50-100,1856,1.786032319942625
STAT,1886,35,30-34,1921,5.370101003662022
SIM,1860,33,na,1893,2006
STAT,1878,19,30-34,1897,1.5590887754762244
STAT,1933,38,50-100,1971,0.5397026960057328
STAT,1860,44,25-29,1904,0.4863673994807166
SIM,1865,40,45-49,1905,5
SIM,1866,29,30-34,1895,22
SIM,1894,35,30-34,1929,9
STAT,1864,30,35-39,1894,8.619120094469352
STAT,1881,30,25-29,1911,9.417828042750529
STAT,1811,43,50-100,1854,3.911413501627787
STAT,1878,37,50-100,1915,1.2074267206122054
STAT,1848,19,20-24,1867,15.646887212459728
SIM,1856,19,20-24,1875,21
SIM,1893,12,na,1905,3219
SIM,1831,68,na,1899,912
SIM,1840,19,na,1859,1980
STAT,1891,15,45-49,1906,0.0767369264489581
STAT,1921,31,50-100,1952,0.8728332525821182
SIM,1937,19,15-19,1956,35
STAT,1850,31,45-49,1881,1.297654806120675
SIM,1836,42,30-34,1878,3
STAT,1853,11,na,1864,2139.381464396
STAT,1919,15,25-29,1934,9.1187055748804
STAT,1918,16,35-39,1934,0.8677519209938824
STAT,1828,42,30-34,1870,1.0141584027675326
STAT,1903,44,30-34,1947,0.10585294371014904
SIM,1915,15,20-24,1930,24
STAT,1801,101,na,1902,0.21713346434902825
SIM,1934,15,30-34,1949,21
STAT,1869,24,15-19,1893,2.997863582055031
SIM,1823,34,45-49,1857,1
STAT,1871,36,25-29,1907,2.709471633112161
STAT,1867,57,na,1924,1782.543664577809
SIM,1862,32,30-34,1894,19
SIM,1925,26,30-34,1951,47
STAT,1890,41,30-34,1931,1.3339062894058122
STAT,1917,37,25-29,1954,0.9660777708976704
STAT,1840,45,35-39,1885,0.10087112635981926
STAT,1839,29,20-24,1868,9.71322249327947
SIM,1833,65,na,1898,1064
STAT,1871,27,35-39,1898,9.036640753354005
SIM,1806,85,na,1891,70
STAT,1823,45,35-39,1868,0.17189341019238635
SIM,1845,32,30-34,1877,21
STAT,1871,62,na,1933,1711.749630770591
STAT,1808,46,na,1854,1327.1911883076286
STAT,1855,53,30-34,1908,0.004148125132169837
STAT,1821,45,25-29,1866,0.09057102731650624
STAT,1869,35,30-34,1904,4.919846828612154
STAT,1890,36,35-39,1926,8.208735205744617
STAT,1838,44,40-44,1882,1.5913153756096587
STAT,1838,40,35-39,1878,1.4818428149002774
STAT,1894,25,na,1919,2919.8269776848006
STAT,1899,40,na,1939,3032.7919761945213
STAT,1915,10,na,1925,3916.256795086766
SIM,1786,91,na,1877,14
SIM,1881,27,na,1908,2001
STAT,1933,34,15-19,1967,0.1633892055005558
STAT,1854,32,30-34,1886,12.875144152713169
STAT,1903,18,40-44,1921,0.24518368749531225
STAT,1948,19,25-29,1967,46.82244618208066
STAT,1858,29,30-34,1887,18.84462013100268
SIM,1825,46,na,1871,1360
STAT,1770,88,na,1858,31.315620520673168
STAT,1839,21,25-29,1860,49.398316442073906
STAT,1837,32,30-34,1869,13.819118357644928
STAT,1907,15,20-24,1922,24.712037785347494
STAT,1910,37,25-29,1947,0.8893313907920091
SIM,1936,34,na,1970,2876
SIM,1929,20,30-34,1949,39
STAT,1871,50,20-24,1921,7.010248743386375E-4
STAT,1886,15,50-100,1901,0.049127173809770386
SIM,1892,28,20-24,1920,15
SIM,1907,22,45-49,1929,1
STAT,1903,31,25-29,1934,13.822656999210915
STAT,1823,50,30-34,1873,0.0071084091233260035
SIM,1890,25,45-49,1915,2
STAT,1850,84,na,1934,234.195658197092
SIM,1781,76,na,1857,307
STAT,1842,34,50-100,1876,0.7719998073316554
STAT,1921,22,na,1943,3896.8627398354192
STAT,1854,50,20-24,1904,5.390075212521827E-4
STAT,1874,53,40-44,1927,0.010001571135535611
SIM,1877,39,35-39,1916,15
STAT,1814,68,na,1882,743.7551171792813
STAT,1839,52,45-49,1891,0.0096249600210176
SIM,1932,26,50-100,1958,1
SIM,1916,36,30-34,1952,5
STAT,1922,44,40-44,1966,0.270331457827568
STAT,1899,30,na,1929,3114.1830712427727
SIM,1856,28,na,1884,1923
SIM,1846,44,40-44,1890,8
STAT,1845,39,50-100,1884,0.8899610293567788
SIM,1847,29,20-24,1876,11
STAT,1884,16,50-100,1900,0.04584819278209688
STAT,1882,25,45-49,1907,1.0275706223890662
STAT,1869,39,35-39,1908,6.402644707463153
SIM,1875,19,30-34,1894,1
STAT,1855,40,35-39,1895,1.2954256784337352
STAT,1794,74,na,1868,429.46651469159605
STAT,1942,28,30-34,1970,38.82925062298167
STAT,1943,27,25-29,1970,66.21952604609199
SIM,1843,28,25-29,1871,42
SIM,1836,67,na,1903,1003
SIM,1913,55,na,1968,3156
SIM,1814,41,40-44,1855,7
SIM,1879,78,na,1957,836
STAT,1878,24,50-100,1902,0.3985319114555488
STAT,1884,28,20-24,1912,10.913225500146497
SIM,1896,35,40-44,1931,6
STAT,1808,99,na,1907,0.7361182594021374
STAT,1916,47,20-24,1963,0.010707670549553967
SIM,1871,22,30-34,1893,19
STAT,1860,26,20-24,1886,9.169277082742889
SIM,1895,39,50-100,1934,1
STAT,1873,32,40-44,1905,4.158513564420027
STAT,1845,37,35-39,1882,5.234577468566258
STAT,1849,20,40-44,1869,1.8423120146200276
STAT,1915,47,50-100,1962,0.21528733769311412
STAT,1830,52,25-29,1882,0.0022833046908528323
STAT,1925,32,15-19,1957,0.14417685123326504
SIM,1908,15,15-19,1923,8
SIM,1877,43,30-34,1920,3
SIM,1948,17,25-29,1965,39
STAT,1931,37,45-49,1968,0.8529332020415075
SIM,1865,27,na,1892,2026
STAT,1812,52,20-24,1864,0.0023222481835411526
STAT,1863,11,na,1874,2272.4151701049705
STAT,1847,33,50-100,1880,0.7833766601950811
SIM,1876,64,na,1940,1678
STAT,1809,51,20-24,1860,0.002610549464968941
STAT,1900,8,na,1908,3406.93807279003
SIM,1910,41,na,1951,3251
SIM,1918,36,40-44,1954,2
SIM,1901,34,20-24,1935,2
STAT,1891,32,45-49,1923,2.0390630169712507
SIM,1885,30,45-49,1915,1
STAT,1829,54,40-44,1883,0.007177563641553002
SIM,1881,32,40-44,1913,3
SIM,1923,47,50-100,1970,1
SIM,1928,18,35-39,1946,10
SIM,1829,44,40-44,1873,8
SIM,1911,42,na,1953,3408
STAT,1823,37,50-100,1860,1.962468372718899
STAT,1824,41,45-49,1865,1.9420417145538673
STAT,1835,28,25-29,1863,34.15128499233651
SIM,1897,10,na,1907,3320
STAT,1883,46,45-49,1929,0.21912501358139053
SIM,1925,40,na,1965,4169
STAT,1863,22,30-34,1885,15.086341728136139
STAT,1950,17,15-19,1967,50.6976326773046
STAT,1880,22,30-34,1902,17.705381343153384
STAT,1832,23,40-44,1855,1.9663399425370305
STAT,1946,15,50-100,1961,0.3927818268201852
SIM,1900,16,15-19,1916,9
STAT,1872,53,30-34,1925,0.005553597128898955
SIM,1902,12,na,1914,3465
STAT,1877,30,45-49,1907,1.7232396935727736
STAT,1887,39,na,1926,2464.0301877465304
SIM,1781,92,na,1873,8
SIM,1832,41,45-49,1873,4
STAT,1875,32,50-100,1907,0.8892511472117398
STAT,1909,17,20-24,1926,25.10985942249169
SIM,1889,18,20-24,1907,23
STAT,1864,54,35-39,1918,0.0070688362959690386
SIM,1917,39,40-44,1956,3
STAT,1909,39,40-44,1948,1.3247660958773884
STAT,1887,39,50-100,1926,1.2840511665861272
STAT,1921,23,40-44,1944,3.5769118864096745
SIM,1800,54,na,1854,1107
SIM,1888,39,na,1927,2546
SIM,1853,37,35-39,1890,14
SIM,1834,66,na,1900,1017
SIM,1864,79,na,1943,542
STAT,1856,44,35-39,1900,1.321725309213103
STAT,1838,47,45-49,1885,0.1655961310730395
SIM,1848,44,50-100,1892,1
SIM,1836,38,35-39,1874,13
STAT,1946,19,15-19,1965,47.521912355086506
STAT,1857,40,45-49,1897,1.1258708923276497
STAT,1842,45,45-49,1887,0.1724492638081753
SIM,1817,38,25-29,1855,2
STAT,1876,29,25-29,1905,40.959834067298324
SIM,1895,25,na,1920,3004
STAT,1907,49,na,1956,3073.4040038052767
STAT,1836,40,15-19,1876,0.010643672491016335
SIM,1840,23,40-44,1863,1
STAT,1809,47,na,1856,1328.5140891130402
STAT,1824,36,na,1860,1525.8105136361833
STAT,1922,38,na,1960,4040.343975194892
STAT,1834,36,20-24,1870,0.5997051473225188
STAT,1934,29,35-39,1963,19.060586814593723
STAT,1895,29,35-39,1924,11.810179730720144
SIM,1813,101,na,1914,2
STAT,1862,63,na,1925,1437.8598664644426
SIM,1879,56,na,1935,1994
STAT,1918,46,40-44,1964,0.15888879324993344
STAT,1792,67,na,1859,663.9313819753277
STAT,1840,51,45-49,1891,0.010155044264156482
STAT,1937,15,na,1952,3397.978463585971
STAT,1849,102,na,1951,0.21131784338482415
STAT,1918,42,25-29,1960,0.07172291163311527
STAT,1919,17,50-100,1936,0.391126855887501
STAT,1768,104,na,1872,0.01907435044216509
STAT,1843,27,20-24,1870,10.416117263130568
STAT,1881,52,45-49,1933,0.013166941533483158
STAT,1900,37,30-34,1937,1.5076268880628039
STAT,1920,44,30-34,1964,0.13295128254244265
SIM,1903,33,40-44,1936,3
SIM,1851,27,20-24,1878,10
SIM,1923,26,20-24,1949,17
STAT,1935,29,40-44,1964,5.995971916359327
STAT,1904,20,na,1924,3223.3407285763274
STAT,1833,32,50-100,1865,0.7185573721795423
STAT,1901,44,20-24,1945,0.01438574337556094
SIM,1908,28,35-39,1936,15
SIM,1865,42,50-100,1907,1
STAT,1834,54,25-29,1888,0.0021607584462510986
STAT,1912,37,35-39,1949,2.2296529643426535
STAT,1901,49,40-44,1950,0.12502848234877761
SIM,1854,80,na,1934,406
STAT,1853,5,na,1858,2243.2451458534915
STAT,1911,47,45-49,1958,0.19433181751490436
SIM,1888,22,25-29,1910,71
STAT,1928,17,na,1945,4381.789915705723
STAT,1835,30,na,1865,1757.5936143710808
SIM,1869,33,30-34,1902,22
STAT,1863,51,25-29,1914,0.002955408787744612
STAT,1848,41,30-34,1889,0.8378947416806074
STAT,1869,43,30-34,1912,1.0437045838915007
STAT,1870,21,45-49,1891,0.6474380944711424
STAT,1819,47,35-39,1866,0.2489430602498145
SIM,1870,11,na,1881,2467
SIM,1885,25,na,1910,2265
SIM,1830,24,35-39,1854,6
STAT,1911,16,25-29,1927,8.21045678192044
SIM,1815,68,na,1883,727
STAT,1898,32,50-100,1930,1.1717194911669482
SIM,1875,35,20-24,1910,4
STAT,1799,68,na,1867,729.9004378989323
STAT,1867,35,20-24,1902,0.6902369277101399
STAT,1829,61,na,1890,1145.3776409343384
STAT,1886,38,35-39,1924,7.024637860399706
SIM,1848,17,20-24,1865,19
SIM,1884,29,25-29,1913,43
SIM,1942,29,35-39,1971,11
SIM,1816,85,na,1901,79
STAT,1851,54,25-29,1905,0.0025259890352348187
STAT,1853,53,20-24,1906,5.384601622433938E-4
STAT,1832,65,na,1897,1021.8502378980338
SIM,1856,41,30-34,1897,3
SIM,1889,40,30-34,1929,1
STAT,1869,42,na,1911,2110.8806331538945
STAT,1921,15,40-44,1936,1.513299776524282
STAT,1810,50,20-24,1860,0.0026071220578449943
SIM,1823,43,35-39,1866,3
SIM,1912,26,35-39,1938,18
STAT,1893,25,20-24,1918,14.156903272693047
SIM,1929,23,35-39,1952,17
STAT,1908,39,35-39,1947,2.11732632992512
STAT,1849,81,na,1930,389.77809592734855
SIM,1834,34,20-24,1868,1
SIM,1931,28,20-24,1959,20
STAT,1823,36,45-49,1859,3.378271723074756
SIM,1894,38,35-39,1932,12
SIM,1866,81,na,1947,415
STAT,1808,46,20-24,1854,0.046448310545008815
STAT,1846,63,na,1909,1258.0637788982738
STAT,1923,28,20-24,1951,19.73046931376655
SIM,1899,20,35-39,1919,13
STAT,1847,9,na,1856,2237.3637625736997
STAT,1876,53,50-100,1929,0.014492547476867249
STAT,1848,15,40-44,1863,0.16528688246889478
STAT,1917,18,50-100,1935,0.07596106658064164
STAT,1911,49,50-100,1960,0.20105144727064725
SIM,1935,19,40-44,1954,1
STAT,1792,73,na,1865,446.73657066457656
STAT,1864,27,na,1891,2014.967259210183
SIM,1918,44,40-44,1962,2
STAT,1926,40,50-100,1966,0.13721411152802698
STAT,1911,44,na,1955,3306.8141006781125
STAT,1826,34,20-24,1860,3.1935160920233243
SIM,1862,28,35-39,1890,9
SIM,1890,34,35-39,1924,15
SIM,1909,18,25-29,1927,13
SIM,1881,24,40-44,1905,3
SIM,1852,31,45-49,1883,1
STAT,1854,28,35-39,1882,7.231614912003624
STAT,1882,34,35-39,1916,9.229603580444802
STAT,1818,41,45-49,1859,3.7343467683950884
STAT,1829,50,25-29,1879,0.0028726698428304946
STAT,1831,52,30-34,1883,0.003850012210905471
SIM,1831,36,45-49,1867,1
STAT,1909,56,na,1965,3069.4775007892395
STAT,1815,43,35-39,1858,4.864858760110625
STAT,1901,36,20-24,1937,0.2210622612068474
STAT,1915,26,20-24,1941,17.647589127898307
STAT,1878,78,na,1956,806.6321075988499
SIM,1880,16,na,1896,2595
SIM,1916,39,35-39,1955,4
SIM,1924,38,30-34,1962,1
STAT,1875,37,20-24,1912,0.7481381548212505
STAT,1888,43,40-44,1931,2.4920814490125323
SIM,1785,90,na,1875,13
SIM,1891,30,45-49,1921,2
STAT,1830,32,20-24,1862,2.2614646475911497
STAT,1898,41,45-49,1939,0.13350955994149385
SIM,1854,96,na,1950,3
SIM,1815,46,na,1861,1293
STAT,1780,88,na,1868,37.61839753107095
STAT,1850,78,na,1928,550.0600348887212
STAT,1899,39,20-24,1938,0.21323113689760584
SIM,1896,43,40-44,1939,2
STAT,1855,40,25-29,1895,0.4593883258935484
SIM,1886,36,35-39,1922,10
SIM,1915,40,na,1955,3506
SIM,1955,3,na,1958,4549
SIM,1865,70,na,1935,1170
STAT,1890,20,35-39,1910,6.780352615294365
STAT,1889,42,30-34,1931,1.3391750988574658
SIM,1852,30,na,1882,1940
STAT,1906,39,15-19,1945,0.01650522012037997
STAT,1814,84,na,1898,137.2554861040393
STAT,1890,27,45-49,1917,1.2824300997312046
STAT,1835,52,na,1887,1369.0445010311018
STAT,1844,31,45-49,1875,1.4791938777271374
SIM,1840,51,na,1891,1493
STAT,1868,40,20-24,1908,0.1446911082470503
SIM,1845,82,na,1927,311
STAT,1878,36,35-39,1914,6.98936151806302
STAT,1870,54,35-39,1924,0.007749997254791751
SIM,1923,38,na,1961,4016
STAT,1830,26,35-39,1856,10.180859537527173
STAT,1876,12,na,1888,2533.4033638543306
SIM,1935,17,na,1952,4737
SIM,1885,47,na,1932,2122
STAT,1916,38,30-34,1954,1.7543893564242987
STAT,1866,51,40-44,1917,0.00921333969022395
STAT,1805,51,50-100,1856,0.044958132617638716
STAT,1861,18,25-29,1879,5.079396923175492
STAT,1871,53,25-29,1924,0.003263986986935282
STAT,1856,35,45-49,1891,1.488976789311824
SIM,1896,30,20-24,1926,2
SIM,1877,12,na,1889,2533
SIM,1883,37,20-24,1920,3
STAT,1869,58,na,1927,1808.3878999199628
SIM,1826,41,45-49,1867,1
SIM,1840,31,40-44,1871,4
STAT,1948,16,20-24,1964,146.62468911656507
STAT,1899,24,na,1923,3042.656236309561
SIM,1918,22,20-24,1940,108
STAT,1879,48,45-49,1927,0.23010589125927705
STAT,1926,18,35-39,1944,4.847973636809902
SIM,1796,91,na,1887,16
SIM,1860,24,20-24,1884,56
SIM,1841,30,30-34,1871,23
STAT,1819,67,na,1886,819.5917301020638
STAT,1885,32,45-49,1917,1.6412494547003926
SIM,1893,32,45-49,1925,5
SIM,1872,30,35-39,1902,9
STAT,1878,25,na,1903,2362.95534328077
STAT,1908,31,50-100,1939,0.7401061109475864
SIM,1856,40,50-100,1896,3
STAT,1823,53,35-39,1876,0.009684751407083456
STAT,1871,33,20-24,1904,2.520848902517802
SIM,1915,18,25-29,1933,10
STAT,1810,106,na,1916,0.005498325752969091
STAT,1907,18,25-29,1925,7.841799474295444
STAT,1870,9,na,1879,2501.8812829311555
SIM,1786,75,na,1861,350
SIM,1903,25,40-44,1928,9
SIM,1934,18,35-39,1952,4
STAT,1837,35,35-39,1872,5.55023353768254
STAT,1890,44,35-39,1934,2.0633069858456787
STAT,1932,29,15-19,1961,0.8726662972819096
STAT,1871,39,50-100,1910,1.1382618739087902
STAT,1896,41,25-29,1937,0.05592734263903684
STAT,1857,57,na,1914,1496.6742467746017
STAT,1870,41,15-19,1911,0.012841179526053225
STAT,1844,50,na,1894,1533.2650022672385
STAT,1920,36,30-34,1956,1.8869542475342849
SIM,1864,35,45-49,1899,1
STAT,1822,50,25-29,1872,0.0049481238680887185
STAT,1842,53,45-49,1895,0.010168541638364975
STAT,1877,41,15-19,1918,0.013599266713041484
STAT,1815,102,na,1917,0.12547926238105866
SIM,1811,91,na,1902,17
STAT,1903,35,40-44,1938,1.2819640447341063
SIM,1833,97,na,1930,3
STAT,1888,30,20-24,1918,3.0408891976624237
STAT,1880,18,35-39,1898,0.5439870330429702
STAT,1884,47,15-19,1931,3.7167469097064025E-4
SIM,1877,49,50-100,1926,2
STAT,1865,42,45-49,1907,1.2832012514769688
SIM,1863,63,na,1926,1520
STAT,1840,49,15-19,1889,2.7380553385837896E-4
SIM,1845,35,35-39,1880,17
SIM,1823,33,na,1856,1532
STAT,1887,40,30-34,1927,1.2268764502453957
STAT,1904,26,35-39,1930,13.117452947792634
STAT,1833,30,30-34,1863,13.983664546749996
STAT,1941,16,20-24,1957,131.94817746244732
SIM,1907,11,na,1918,3651
SIM,1846,67,na,1913,1083
STAT,1871,24,30-34,1895,16.57754505794035
STAT,1927,39,45-49,1966,0.7990884045813978
STAT,1832,31,40-44,1863,3.4708970390631304
STAT,1858,38,20-24,1896,0.5688488090243139
SIM,1841,36,na,1877,1760
SIM,1873,42,45-49,1915,2
STAT,1905,47,45-49,1952,0.18088722229762488
STAT,1859,42,45-49,1901,1.126964577372319
SIM,1911,35,40-44,1946,2
STAT,1928,3,na,1931,4828.577386696236
STAT,1910,39,40-44,1949,1.3385220266155764
STAT,1910,38,50-100,1948,0.37734633525472383
STAT,1841,41,45-49,1882,1.0777723558107852
STAT,1844,42,25-29,1886,0.4616945503642978
STAT,1890,20,25-29,1910,66.51473879199189
STAT,1812,50,30-34,1862,0.01949836271348765
STAT,1924,26,50-100,1950,1.0986870273471623
STAT,1926,27,25-29,1953,74.54792371194299
SIM,1871,34,na,1905,2285
SIM,1810,47,na,1857,1327
STAT,1846,50,35-39,1896,0.00615723911370643
STAT,1785,87,na,1872,55.86767471129613
STAT,1898,61,na,1959,2476.161498426322
SIM,1880,11,na,1891,2652
SIM,1815,40,30-34,1855,3
STAT,1873,35,45-49,1908,1.929725424049649
SIM,1893,19,25-29,1912,8
STAT,1915,48,30-34,1963,0.08461677385446123
STAT,1882,18,45-49,1900,0.05989039224908443
STAT,1826,51,20-24,1877,6.791723890371939E-4
STAT,1879,40,20-24,1919,0.15839942355934147
STAT,1866,20,40-44,1886,1.856355672612784
STAT,1874,31,30-34,1905,16.926799752658873
STAT,1883,43,40-44,1926,2.0674867894277975
SIM,1860,71,na,1931,1079
SIM,1882,31,30-34,1913,25
STAT,1834,43,45-49,1877,1.1026074788641567
STAT,1859,64,na,1923,1310.5910759201781
STAT,1879,54,30-34,1933,0.005716104407590389
STAT,1910,25,30-34,1935,36.28129456685688
SIM,1826,28,25-29,1854,42
SIM,1839,97,na,1936,5
SIM,1913,31,35-39,1944,9
STAT,1875,52,20-24,1927,7.123662342179164E-4
STAT,1880,41,50-100,1921,1.0548630159959225
STAT,1816,52,40-44,1868,0.02653624933160554
STAT,1848,27,na,1875,1860.5197861274003
STAT,1870,43,30-34,1913,1.0565251731139793
STAT,1911,42,15-19,1953,0.0013843485063980302
STAT,1821,33,30-34,1854,54.866071692157085
STAT,1889,16,40-44,1905,0.2138386211487203
SIM,1911,26,na,1937,3491
STAT,1885,11,na,1896,2434.231289322619
SIM,1875,28,20-24,1903,12
STAT,1901,27,30-34,1928,33.29769750135479
STAT,1930,16,35-39,1946,5.137780958180607
SIM,1830,51,na,1881,1455
STAT,1864,52,45-49,1916,0.012187758441358922
STAT,1872,31,na,1903,2271.9524872990714
SIM,1863,40,35-39,1903,4
SIM,1881,35,45-49,1916,6
SIM,1809,50,na,1859,1256
STAT,1894,30,45-49,1924,2.1361619152439872
STAT,1949,16,na,1965,4045.5492361915117
STAT,1931,34,40-44,1965,4.838008352346741
STAT,1858,45,20-24,1903,0.008988280468538619
STAT,1912,21,25-29,1933,83.86011572974408
STAT,1909,15,30-34,1924,2.2679704295259393
STAT,1912,23,na,1935,3443.499965646278
STAT,1842,49,na,1891,1568.688471060113
SIM,1871,0,na,1871,3354
STAT,1823,42,30-34,1865,1.4894608594832743
STAT,1923,35,45-49,1958,0.7475700626448095
SIM,1854,64,na,1918,1321
STAT,1933,30,35-39,1963,11.647290878605473
STAT,1905,31,35-39,1936,7.970767436146008
STAT,1928,33,na,1961,4465.175953945972
STAT,1857,42,35-39,1899,1.3469446148428865
STAT,1864,37,45-49,1901,1.6831222831675063
SIM,1822,54,na,1876,1240
SIM,1887,48,50-100,1935,1
STAT,1825,107,na,1932,0.0026663725473942738
STAT,1940,32,40-44,1972,3.825749049483111
SIM,1868,38,30-34,1906,8
SIM,1872,37,45-49,1909,2
STAT,1885,19,25-29,1904,5.304805879627141
STAT,1855,54,45-49,1909,0.009995581138366873
STAT,1886,31,15-19,1917,0.14272141486372394
SIM,1822,43,40-44,1865,9
SIM,1841,14,na,1855,2132
STAT,1884,35,20-24,1919,0.726452354015336
STAT,1829,45,na,1874,1544.365807142513
SIM,1941,30,35-39,1971,6
SIM,1900,48,50-100,1948,2
STAT,1873,26,na,1899,2296.3103893363736
STAT,1898,17,50-100,1915,0.06265213402525457
SIM,1814,44,45-49,1858,3
STAT,1872,51,40-44,1923,0.010030103236322129
SIM,1839,23,40-44,1862,1
STAT,1901,47,25-29,1948,0.042762391133024755
STAT,1909,42,50-100,1951,0.10377882979969455
SIM,1875,41,50-100,1916,2
STAT,1860,48,40-44,1908,0.12978890211174102
SIM,1939,16,20-24,1955,117
SIM,1920,28,45-49,1948,2
STAT,1890,33,30-34,1923,20.081342851566358
STAT,1892,41,40-44,1933,2.672948565526451
SIM,1890,45,50-100,1935,3
STAT,1819,40,15-19,1859,0.028991432280496027
STAT,1817,45,50-100,1862,0.5671745389638647
STAT,1839,51,30-34,1890,0.003987984081346274
SIM,1917,15,30-34,1932,3
SIM,1942,22,15-19,1964,7
SIM,1821,34,35-39,1855,9
SIM,1842,79,na,1921,461
STAT,1808,53,45-49,1861,0.05173518540850037
STAT,1817,44,20-24,1861,0.37034989741204216
SIM,1826,47,na,1873,1424
STAT,1919,37,35-39,1956,2.4547697493932805
STAT,1823,51,45-49,1874,0.016988831693415453
STAT,1920,47,35-39,1967,0.13464489623363654
STAT,1814,43,40-44,1857,6.690789094041026
STAT,1852,41,20-24,1893,0.12120771582227413
STAT,1900,38,na,1938,3096.6474413390692
STAT,1920,24,50-100,1944,0.6867591959167918
STAT,1899,49,25-29,1948,0.041185286169887564
SIM,1805,84,na,1889,92
SIM,1810,69,na,1879,723
SIM,1855,12,na,1867,2295
SIM,1867,17,30-34,1884,1
SIM,1905,19,na,1924,3473
SIM,1879,39,45-49,1918,2
STAT,1927,19,40-44,1946,1.6343193778736422
STAT,1837,52,35-39,1889,0.005454416914469769
STAT,1797,72,na,1869,549.3016800953799
STAT,1912,28,45-49,1940,1.6022979636066756
SIM,1864,41,30-34,1905,4
SIM,1850,42,40-44,1892,4
SIM,1930,18,na,1948,4413
STAT,1917,15,15-19,1932,9.26845354360503
STAT,1914,42,40-44,1956,0.2340960013705003
SIM,1926,7,na,1933,4523
STAT,1836,47,35-39,1883,0.09252115677867552
STAT,1875,44,45-49,1919,1.432939552450165
STAT,1933,17,15-19,1950,57.39262553679606
STAT,1934,22,15-19,1956,6.757933278252766
SIM,1901,28,35-39,1929,17
SIM,1831,42,30-34,1873,4
STAT,1881,34,40-44,1915,3.921842628912262
STAT,1861,31,45-49,1892,1.373578272541799
SIM,1941,17,15-19,1958,35
STAT,1841,64,na,1905,1189.370186151649
STAT,1897,39,na,1936,2969.8708228338623
STAT,1859,17,30-34,1876,1.3948723386218183
STAT,1880,25,35-39,1905,9.656088282873297
SIM,1919,17,40-44,1936,1
SIM,1870,34,30-34,1904,19
SIM,1963,6,na,1969,4681
STAT,1870,48,25-29,1918,0.052648612678529286
STAT,1880,66,na,1946,1629.173499486708
STAT,1885,43,25-29,1928,0.6000190039343644
STAT,1866,30,50-100,1896,0.8044545873510944
STAT,1844,18,50-100,1862,0.04346157622154046
SIM,1822,32,na,1854,1618
SIM,1858,39,25-29,1897,2
STAT,1811,66,na,1877,824.9512985874242
STAT,1869,46,35-39,1915,0.12838462711943385
STAT,1872,78,na,1950,740.861472355617
SIM,1882,40,45-49,1922,1
SIM,1883,44,45-49,1927,3
SIM,1877,24,15-19,1901,6
STAT,1890,42,45-49,1932,1.7265315725112047
STAT,1906,36,20-24,1942,0.2299767447602505
SIM,1817,53,50-100,1870,1
STAT,1825,50,40-44,1875,0.011072200623505113
STAT,1764,92,na,1856,7.495287047999999
STAT,1912,34,30-34,1946,14.516777453157117
STAT,1834,51,20-24,1885,4.777144562818037E-4
STAT,1940,28,20-24,1968,17.574334370739322
STAT,1907,40,35-39,1947,0.17622975446251016
STAT,1842,42,40-44,1884,1.6571713555884748
SIM,1935,33,na,1968,4942
STAT,1847,79,na,1926,514.3937444886756
STAT,1858,21,45-49,1879,0.5976528050929133
SIM,1925,15,15-19,1940,49
SIM,1927,37,35-39,1964,2
STAT,1935,32,50-100,1967,1.0805446857334735
SIM,1903,36,45-49,1939,3
STAT,1820,54,20-24,1874,0.0011238714912635123
STAT,1952,17,25-29,1969,49.061251045422665
STAT,1874,40,45-49,1914,1.459634392482472
STAT,1893,14,na,1907,3085.4156896738155
SIM,1867,42,45-49,1909,2
STAT,1818,52,25-29,1870,0.007257906418018559
STAT,1831,64,na,1895,1060.1640366988786
STAT,1862,30,15-19,1892,0.11567992820254787
STAT,1892,51,na,1943,2559.469576333602
STAT,1924,40,na,1964,4185.2539073461485
STAT,1864,43,30-34,1907,0.9636653079709707
SIM,1869,26,30-34,1895,23
STAT,1789,68,na,1857,626.8129261249039
STAT,1843,37,25-29,1880,2.4249614297991497
STAT,1894,15,50-100,1909,0.05981253629668196
STAT,1847,20,30-34,1867,16.299999828113396
SIM,1890,31,30-34,1921,27
STAT,1922,1,na,1923,4566.066470757106
SIM,1840,40,30-34,1880,1
SIM,1848,30,40-44,1878,7
SIM,1847,24,na,1871,1823
STAT,1942,24,15-19,1966,5.268783090671528
SIM,1839,19,20-24,1858,10
SIM,1909,16,35-39,1925,3
SIM,1845,28,35-39,1873,8
SIM,1829,97,na,1926,1
SIM,1827,37,30-34,1864,6
STAT,1840,33,40-44,1873,3.64053684770444
STAT,1928,24,50-100,1952,0.7713220250818441
STAT,1850,34,50-100,1884,0.6609065803923536
STAT,1831,50,40-44,1881,0.007084270383981586
STAT,1842,27,na,1869,1905.0488583449378
STAT,1911,60,na,1971,3058.93954200273
STAT,1888,46,45-49,1934,0.26412617684098294
STAT,1911,44,40-44,1955,0.22270643612101268
SIM,1902,6,na,1908,3497
STAT,1845,30,15-19,1875,0.12177100103342403
SIM,1851,37,25-29,1888,1
SIM,1864,64,na,1928,1590
SIM,1920,34,30-34,1954,22
STAT,1945,27,35-39,1972,15.560330829109164
SIM,1902,47,50-100,1949,1
SIM,1944,15,25-29,1959,48
STAT,1806,50,30-34,1856,0.017496037638018738
STAT,1880,82,na,1962,677.2196883347943
STAT,1842,53,20-24,1895,5.170445097083388E-4
STAT,1876,6,na,1882,2647.5100604012664
SIM,1872,43,30-34,1915,1
STAT,1849,54,45-49,1903,0.010172760433016395
SIM,1830,41,35-39,1871,4
SIM,1894,28,30-34,1922,42
SIM,1888,9,na,1897,2820
STAT,1863,26,na,1889,1996.1335543514876
STAT,1851,79,na,1930,512.6653717152681
STAT,1912,55,na,1967,3229.9823529456053
STAT,1898,43,35-39,1941,0.159646527069409
STAT,1859,53,25-29,1912,0.002627534151229331
STAT,1877,17,50-100,1894,0.04802757047701776
STAT,1819,37,30-34,1856,13.855666322279369
STAT,1907,27,15-19,1934,0.6294973211324107
SIM,1808,98,na,1906,1
STAT,1867,52,20-24,1919,6.510504258706529E-4
SIM,1933,36,30-34,1969,4
STAT,1779,75,na,1854,379.0
STAT,1856,32,40-44,1888,3.2479957761373566
STAT,1832,49,na,1881,1418.5165541859526
STAT,1860,46,15-19,1906,3.079755351475982E-4
STAT,1860,33,50-100,1893,0.7004878007511344
STAT,1886,28,30-34,1914,25.04618831193715
STAT,1893,18,20-24,1911,21.19402745230248
SIM,1815,84,na,1899,113
SIM,1967,1,na,1968,4513
SIM,1816,47,na,1863,1299
STAT,1925,36,30-34,1961,2.068645205802069
STAT,1841,17,45-49,1858,0.057642371870837344
STAT,1903,41,na,1944,3131.2148713202214
STAT,1910,38,na,1948,3381.293795648357
SIM,1855,20,30-34,1875,22
SIM,1909,29,40-44,1938,5
STAT,1822,41,35-39,1863,2.8053634124304043
STAT,1851,36,20-24,1887,0.5772930471830143
STAT,1939,30,50-100,1969,0.7977480095668574
STAT,1896,46,50-100,1942,0.1734613150046622
STAT,1857,53,40-44,1910,0.00771458789751637
SIM,1765,92,na,1857,8
SIM,1834,27,20-24,1861,10
STAT,1878,29,35-39,1907,9.421441499004215
STAT,1914,19,na,1933,3753.3947752209037
STAT,1860,46,na,1906,1732.2412492515903
STAT,1823,35,na,1858,1538.236073572259
STAT,1778,90,na,1868,25.24418425524894
SIM,1796,75,na,1871,382
SIM,1940,29,25-29,1969,59
SIM,1828,32,na,1860,1591
SIM,1876,40,45-49,1916,1
SIM,1840,34,45-49,1874,2
STAT,1941,29,50-100,1970,0.9716713561637231
STAT,1884,29,50-100,1913,0.5929101083393901
SIM,1920,21,25-29,1941,96
SIM,1831,36,na,1867,1612
STAT,1817,47,25-29,1864,0.12887411791820758
STAT,1932,29,25-29,1961,81.36393578790121
SIM,1876,38,50-100,1914,3
STAT,1779,107,na,1886,0.007979560195926888
STAT,1947,9,na,1956,4182.016681499555
SIM,1895,41,na,1936,2918
STAT,1873,41,30-34,1914,1.1074146607467112
STAT,1900,15,20-24,1915,23.34277998188031
STAT,1901,42,30-34,1943,0.10543523493056638
STAT,1899,22,45-49,1921,0.9027619017371568
STAT,1931,37,na,1968,4707.082723894795
SIM,1891,43,40-44,1934,8
SIM,1838,38,45-49,1876,4
SIM,1870,41,30-34,1911,4
STAT,1896,45,40-44,1941,0.12177412741809748
STAT,1921,26,45-49,1947,1.8253387418421456
SIM,1819,38,35-39,1857,7
STAT,1832,34,45-49,1866,1.350309115873506
STAT,1893,42,20-24,1935,0.19012148421035804
STAT,1905,44,40-44,1949,0.21035133627931282
STAT,1920,42,40-44,1962,0.26098174304778493
STAT,1844,34,na,1878,1781.9833695178334
STAT,1877,45,30-34,1922,0.0958407428352287
SIM,1886,29,35-39,1915,11
STAT,1832,40,30-34,1872,0.8752655541386587
SIM,1816,69,na,1885,687
SIM,1939,19,25-29,1958,51
STAT,1781,94,na,1875,3.722997300548121
STAT,1853,51,30-34,1904,0.004435578829386913
STAT,1888,21,30-34,1909,19.93870436280725
SIM,1872,30,25-29,1902,9
SIM,1934,27,25-29,1961,74
STAT,1878,41,na,1919,2283.2793404207387
SIM,1910,9,na,1919,3646
STAT,1863,64,na,1927,1443.5564390724635
STAT,1851,40,40-44,1891,1.6660742979552885
STAT,1846,41,20-24,1887,0.11479156615656154
STAT,1863,6,na,1869,2363.9852898748973
STAT,1829,67,na,1896,971.6571214228038
STAT,1912,45,na,1957,3350.3307704154568
SIM,1896,26,na,1922,3033
STAT,1901,4,na,1905,3478.5240834656397
STAT,1853,110,na,1963,8.946092194215736E-4
SIM,1874,20,40-44,1894,3
STAT,1904,26,na,1930,3244.4127335868834
SIM,1903,21,25-29,1924,85
STAT,1911,49,35-39,1960,0.11460587419933844
STAT,1815,40,30-34,1855,3.5618206578404665
STAT,1871,20,15-19,1891,3.108114139041773
STAT,1845,27,30-34,1872,21.589897606408044
STAT,1869,26,na,1895,2189.8138225023763
STAT,1897,29,45-49,1926,1.3927481373653972
STAT,1909,41,na,1950,3299.69988335037
STAT,1862,37,35-39,1899,5.699627703132749
STAT,1868,40,45-49,1908,1.3635564001991367
SIM,1918,25,25-29,1943,69
STAT,1878,53,35-39,1931,0.008330660634792715
STAT,1931,21,35-39,1952,11.571911765895582
SIM,1853,27,30-34,1880,3
SIM,1906,49,50-100,1955,3
STAT,1882,31,30-34,1913,16.115436274357926
STAT,1884,63,na,1947,1665.718886802305
SIM,1780,91,na,1871,13
STAT,1833,52,40-44,1885,0.006601849466797587
STAT,1836,53,20-24,1889,4.62246465773512E-4
STAT,1829,50,35-39,1879,0.006982183716226001
STAT,1852,27,na,1879,1914.3605402079095
STAT,1864,30,25-29,1894,8.71745446240584
SIM,1832,40,30-34,1872,1
SIM,1877,22,na,1899,2306
STAT,1870,32,25-29,1902,9.481266342399428
STAT,1885,81,na,1966,798.9452080692358
STAT,1862,34,30-34,1896,13.949241655323567
STAT,1898,45,50-100,1943,0.17893349791354804
SIM,1842,40,40-44,1882,5
SIM,1896,21,30-34,1917,31
STAT,1941,19,15-19,1960,44.12714595319947
SIM,1892,38,25-29,1930,3
STAT,1903,38,45-49,1941,0.5754375647931432
SIM,1794,68,na,1862,717
STAT,1862,53,na,1915,1707.245029408907
STAT,1929,18,na,1947,4426.246801068062
STAT,1834,43,50-100,1877,0.778311159320819
STAT,1906,39,25-29,1945,0.846267545919001
STAT,1872,54,45-49,1926,0.013382294155305155
STAT,1846,15,30-34,1861,1.4284895800213464
STAT,1876,42,45-49,1918,1.4578093984064875
STAT,1851,43,45-49,1894,1.08958266917083
SIM,1855,49,na,1904,1746
SIM,1847,25,40-44,1872,3
STAT,1831,30,20-24,1861,2.273410668330316
STAT,1909,27,25-29,1936,59.40945232178001
STAT,1867,19,30-34,1886,1.428314512392648
STAT,1897,33,40-44,1930,5.4559525716950965
STAT,1809,51,45-49,1860,0.051340804195991165
SIM,1898,11,na,1909,3267
SIM,1917,27,25-29,1944,70
STAT,1859,29,25-29,1888,31.978365491989294
SIM,1867,29,25-29,1896,36
STAT,1911,40,25-29,1951,0.06510189108763034
SIM,1917,2,na,1919,4080
STAT,1862,46,25-29,1908,0.04654804310469345
STAT,1819,83,na,1902,198.25014031538223
SIM,1914,56,na,1970,3577
SIM,1884,42,45-49,1926,2
SIM,1886,7,na,1893,2542
SIM,1829,30,30-34,1859,16
STAT,1864,12,na,1876,2291.277682753679
STAT,1863,18,35-39,1881,0.4703638306385624
STAT,1824,40,30-34,1864,1.5302155864890026
STAT,1834,40,40-44,1874,1.7220209520762235
STAT,1823,49,15-19,1872,4.635961767237292E-4
SIM,1872,34,40-44,1906,5
STAT,1884,38,25-29,1922,2.674513214887628
STAT,1852,33,50-100,1885,0.7133222799475235
SIM,1868,45,na,1913,2069
SIM,1971,0,na,1971,4488
SIM,1838,42,40-44,1880,7
STAT,1913,16,35-39,1929,0.8122916120517781
SIM,1936,17,40-44,1953,1
STAT,1910,9,na,1919,3713.0755931382705
STAT,1948,21,na,1969,3962.663556458506
STAT,1850,68,na,1918,1075.8546139421192
STAT,1919,34,40-44,1953,3.9543731708678598
STAT,1936,36,na,1972,3491.7203673806957
SIM,1849,8,na,1857,2199
SIM,1889,31,40-44,1920,6
STAT,1896,41,35-39,1937,0.15770909206334224
STAT,1873,96,na,1969,40.865254552476436
STAT,1910,28,35-39,1938,13.643776079468347
SIM,1878,77,na,1955,797
STAT,1846,104,na,1950,0.04702836175939165
STAT,1899,46,20-24,1945,0.00878811853839001
SIM,1864,28,45-49,1892,1
STAT,1857,16,45-49,1873,0.05751810766444481
STAT,1909,18,35-39,1927,0.7751296906474117
STAT,1854,35,35-39,1889,5.171101093773888
SIM,1910,31,na,1941,3386
STAT,1847,45,45-49,1892,0.17537731082657113
STAT,1856,28,45-49,1884,0.8451568199118045
SIM,1912,26,45-49,1938,1
STAT,1891,31,30-34,1922,20.499196704310048
STAT,1816,41,35-39,1857,5.644804076702485
STAT,1836,27,50-100,1863,0.5227069524682844
STAT,1855,44,40-44,1899,1.5715171271697452
SIM,1876,11,na,1887,2605
SIM,1795,90,na,1885,21
STAT,1807,98,na,1905,1.1652998633298377
STAT,1825,53,45-49,1878,0.014380019940894323
STAT,1843,51,20-24,1894,5.349231326694643E-4
SIM,1860,33,50-100,1893,3
SIM,1864,32,40-44,1896,5
STAT,1904,26,45-49,1930,1.5094265699461744
STAT,1928,17,40-44,1945,1.6651120431775286
SIM,1801,55,na,1856,1078
STAT,1890,44,na,1934,2633.510522797481
STAT,1883,32,35-39,1915,9.376317355248224
STAT,1810,87,na,1897,79.78290918870854
SIM,1879,88,na,1967,322
STAT,1803,54,20-24,1857,0.002031997584668566
STAT,1887,42,20-24,1929,0.16757884467593887
STAT,1891,24,50-100,1915,0.4738470160166505
SIM,1929,30,35-39,1959,11
STAT,1839,45,na,1884,1568.109505778275
STAT,1865,41,30-34,1906,0.9913923655788978
STAT,1836,44,30-34,1880,0.8418204576937116
STAT,1875,41,40-44,1916,2.1928853188806428
SIM,1858,30,na,1888,1962
STAT,1814,46,45-49,1860,0.6507219191867077
STAT,1916,34,15-19,1950,0.124256925871955
STAT,1842,31,35-39,1873,8.802737191067628
SIM,1839,26,45-49,1865,2
STAT,1852,17,20-24,1869,16.2910286656584
STAT,1885,40,20-24,1925,0.15097976954123316
STAT,1863,42,35-39,1905,1.5018730292222713
STAT,1870,82,na,1952,431.9011211955305
SIM,1905,25,50-100,1930,1
STAT,1861,53,30-34,1914,0.004594660127863062
STAT,1870,45,20-24,1915,0.011218776658710716
SIM,1873,41,30-34,1914,4
STAT,1842,49,25-29,1891,0.0401612665990569
STAT,1925,45,20-24,1970,0.012711798619909035
STAT,1924,40,35-39,1964,0.22692161730409677
SIM,1883,41,40-44,1924,3
STAT,1903,47,35-39,1950,0.10564568780993906
SIM,1861,34,na,1895,2035
SIM,1888,26,40-44,1914,5
SIM,1901,21,15-19,1922,3
STAT,1892,37,20-24,1929,0.9119194654309741
STAT,1933,22,na,1955,4576.068044234624
STAT,1855,51,40-44,1906,0.007491743161624433
STAT,1936,15,25-29,1951,39.36941717740639
STAT,1805,54,na,1859,1115.2004587652896
SIM,1877,28,30-34,1905,34
SIM,1878,32,50-100,1910,1
STAT,1808,50,40-44,1858,0.03985634091919932
SIM,1875,63,na,1938,1703
SIM,1854,15,30-34,1869,1
SIM,1954,1,na,1955,4442
SIM,1901,25,30-34,1926,38
SIM,1846,61,na,1907,1302
STAT,1871,17,30-34,1888,1.5023685792623138
STAT,1959,1,na,1960,4864.6418681824725
STAT,1835,20,na,1855,1756.7071174222963
SIM,1844,44,30-34,1888,2
STAT,1945,24,40-44,1969,3.478911871288604
STAT,1812,53,35-39,1865,0.026555697143614707
SIM,1850,31,35-39,1881,6
STAT,1923,32,40-44,1955,4.238500707213073
SIM,1885,63,na,1948,1686
STAT,1847,20,50-100,1867,0.3731685347045241
STAT,1860,41,20-24,1901,0.12248194695980717
STAT,1814,52,30-34,1866,0.015446201118439553
SIM,1914,39,25-29,1953,4
STAT,1858,48,25-29,1906,0.04218111398684917
STAT,1881,37,45-49,1918,1.8183468931386406
STAT,1898,17,45-49,1915,0.08353617870033944
SIM,1931,32,40-44,1963,10
STAT,1832,87,na,1919,106.52921244895532
STAT,1837,28,35-39,1865,7.7618192779725925
SIM,1849,21,35-39,1870,7
STAT,1914,45,45-49,1959,0.20454881684739237
SIM,1842,43,50-100,1885,1
STAT,1842,42,15-19,1884,0.010174498670279749
STAT,1840,36,45-49,1876,1.6591552948134751
STAT,1909,17,30-34,1926,2.257481839667299
SIM,1890,42,45-49,1932,3
SIM,1840,43,35-39,1883,3
STAT,1828,45,35-39,1873,0.12108205461269882
STAT,1804,91,na,1895,19.63730520149466
SIM,1831,33,40-44,1864,8
SIM,1871,12,na,1883,2541
STAT,1824,46,na,1870,1387.5035870081135
SIM,1880,31,20-24,1911,1
SIM,1904,56,na,1960,2803
STAT,1817,98,na,1915,1.4406085145739123
STAT,1927,32,25-29,1959,10.741915912589333
SIM,1873,47,50-100,1920,2
STAT,1898,40,30-34,1938,0.10312573938844911
STAT,1908,55,na,1963,3039.502472860278
SIM,1895,16,30-34,1911,2
STAT,1822,87,na,1909,91.00317882045323
SIM,1874,34,50-100,1908,3
STAT,1847,64,na,1911,1279.0644781831277
SIM,1868,31,20-24,1899,2
STAT,1848,50,45-49,1898,0.010605328562509286
STAT,1849,51,40-44,1900,0.007624540019625715
STAT,1875,11,na,1886,2539.3640238329494
STAT,1911,46,30-34,1957,0.0799071525907242
SIM,1865,42,35-39,1907,4
SIM,1860,17,20-24,1877,12
STAT,1907,48,30-34,1955,0.0748082958541855
STAT,1889,62,na,1951,2131.631660278742
STAT,1890,59,na,1949,2244.753592378744
SIM,1870,37,35-39,1907,15
STAT,1825,46,20-24,1871,0.01275707452037048
STAT,1838,97,na,1935,3.6639998796406754
STAT,1865,15,40-44,1880,0.1799133540484219
STAT,1865,47,50-100,1912,0.2098511317944384
STAT,1850,30,30-34,1880,14.426547044221842
SIM,1850,13,na,1863,2119
STAT,1925,39,35-39,1964,2.7369767789551553
SIM,1915,19,na,1934,3749
STAT,1901,23,15-19,1924,4.34877706095121
STAT,1791,72,na,1863,509.81045354785635
STAT,1853,54,35-39,1907,0.006208974929516069
STAT,1882,42,45-49,1924,1.3740927706113557
SIM,1936,18,na,1954,2730
STAT,1773,91,na,1864,12.125974246598386
STAT,1880,51,25-29,1931,0.003537600700501137
STAT,1837,86,na,1923,140.06105088707145
STAT,1931,30,25-29,1961,11.454266679480568
STAT,1839,33,50-100,1872,0.7440498761663136
STAT,1912,25,40-44,1937,4.367653409557173
STAT,1944,19,40-44,1963,1.4209969857343587
SIM,1916,41,na,1957,3522
STAT,1860,50,45-49,1910,0.011302162156136584
STAT,1918,49,45-49,1967,0.21720511785407243
STAT,1932,26,20-24,1958,22.597181279205586
SIM,1902,16,25-29,1918,7
STAT,1822,72,na,1894,652.3268227560545
STAT,1875,21,45-49,1896,0.6788203495316946
STAT,1905,40,25-29,1945,0.06149022912455135
STAT,1835,52,25-29,1887,0.002252218010636101
SIM,1852,79,na,1931,508
STAT,1879,41,25-29,1920,0.6369555472706487
SIM,1862,35,35-39,1897,11
STAT,1918,33,na,1951,3780.56848700322
SIM,1830,73,na,1903,743
SIM,1858,15,15-19,1873,6
STAT,1868,63,na,1931,1609.4014517968099
SIM,1935,32,25-29,1967,10
STAT,1854,12,na,1866,2056.376999970058
SIM,1823,31,40-44,1854,2
STAT,1877,48,35-39,1925,0.13551989675132523
STAT,1877,77,na,1954,847.378296775997
STAT,1832,43,35-39,1875,1.326051355457318
STAT,1837,34,50-100,1871,0.7102901916887898
STAT,1887,16,30-34,1903,1.688053257167299
STAT,1847,51,30-34,1898,0.004400774425892553
STAT,1877,54,20-24,1931,7.035020197475959E-4
SIM,1952,19,40-44,1971,2
STAT,1831,53,45-49,1884,0.009202301172335604
SIM,1940,26,20-24,1966,15
SIM,1885,41,na,1926,2188
SIM,1920,25,40-44,1945,9
STAT,1892,44,45-49,1936,0.1212900276278617
STAT,1794,90,na,1884,29.311731793575014
SIM,1843,41,45-49,1884,2
STAT,1802,99,na,1901,0.646069188952563
STAT,1896,48,45-49,1944,0.1641207457511955
SIM,1836,23,15-19,1859,2
SIM,1859,35,50-100,1894,3
STAT,1921,37,na,1958,3968.8090373504024
STAT,1873,44,35-39,1917,1.71296621351447
SIM,1894,77,na,1971,1494
STAT,1901,45,35-39,1946,0.10546424912791874
STAT,1876,92,na,1968,139.5549296368686
SIM,1890,22,40-44,1912,3
STAT,1815,51,45-49,1866,0.03443707486754675
STAT,1838,40,25-29,1878,0.5254962143389713
STAT,1854,34,na,1888,1723.5455046154539
STAT,1897,49,15-19,1946,2.791163434889006E-4
STAT,1881,30,35-39,1911,9.311593341793701
SIM,1841,36,50-100,1877,1
SIM,1910,37,40-44,1947,4
STAT,1867,28,20-24,1895,10.369174521898584
SIM,1909,25,25-29,1934,57
SIM,1891,32,35-39,1923,12
SIM,1806,69,na,1875,691
STAT,1922,47,45-49,1969,0.23588902254508468
SIM,1879,4,na,1883,2713
STAT,1840,42,30-34,1882,0.8351927641531479
STAT,1841,21,40-44,1862,1.819170657110139
STAT,1913,16,50-100,1929,0.07252602335298931
SIM,1824,41,35-39,1865,1
STAT,1933,38,30-34,1971,2.3428258618203848
SIM,1884,0,na,1884,3277
SIM,1919,26,50-100,1945,4
SIM,1921,16,35-39,1937,5
STAT,1882,22,40-44,1904,1.915541421213306
STAT,1856,52,45-49,1908,0.010680485908686171
SIM,1927,34,40-44,1961,4
STAT,1951,3,na,1954,4446.031925153701
STAT,1856,78,na,1934,578.103372213625
STAT,1879,48,50-100,1927,0.23946613051043886
STAT,1878,50,30-34,1928,0.005938174985522882
SIM,1873,78,na,1951,715
STAT,1914,38,20-24,1952,0.24736490703002476
STAT,1855,24,50-100,1879,0.3325765496022055
STAT,1835,41,45-49,1876,1.1333159646328033
SIM,1917,17,30-34,1934,2
STAT,1821,42,20-24,1863,0.2650645812596969
SIM,1881,44,35-39,1925,5
STAT,1919,18,na,1937,3832.509634642151
SIM,1891,59,na,1950,2295
STAT,1835,79,na,1914,436.1925796292074
SIM,1854,86,na,1940,146
STAT,1859,50,20-24,1909,5.643303130676798E-4
STAT,1844,18,25-29,1862,5.027056664226857
STAT,1806,53,35-39,1859,0.023824490729472694
STAT,1895,36,35-39,1931,8.761463491550389
STAT,1883,43,15-19,1926,0.012693703351144494
STAT,1843,34,20-24,1877,2.2962523658330967
STAT,1866,47,20-24,1913,0.010403141664210419
STAT,1836,31,na,1867,1747.9435786590764
SIM,1851,34,20-24,1885,1
STAT,1849,51,50-100,1900,0.010938008337923504
SIM,1879,43,40-44,1922,5
STAT,1821,36,35-39,1857,15.7433247476631
STAT,1820,52,30-34,1872,0.009434436331168233
STAT,1920,45,45-49,1965,0.22804108761646605
SIM,1800,70,na,1870,663
SIM,1869,22,15-19,1891,3
STAT,1859,96,na,1955,6.473691873079735
STAT,1833,36,50-100,1869,0.9442686007596531
STAT,1902,37,40-44,1939,1.2596190644326948
STAT,1839,25,40-44,1864,2.5527489968916015
STAT,1915,29,15-19,1944,0.6753079933527713
STAT,1868,41,na,1909,2094.1178898782873
SIM,1852,18,25-29,1870,6
SIM,1886,26,na,1912,2336
STAT,1872,31,20-24,1903,2.573520762476623
STAT,1881,38,50-100,1919,1.114323572109702
STAT,1908,32,15-19,1940,0.11456298412098374
STAT,1863,16,50-100,1879,0.04669878061952243
SIM,1838,39,45-49,1877,1
SIM,1858,24,na,1882,1962
STAT,1859,37,15-19,1896,0.04233630244510149
STAT,1879,39,40-44,1918,4.278982806654924
STAT,1856,36,35-39,1892,5.258399817618204
STAT,1906,5,na,1911,3604.974085987888
STAT,1824,30,30-34,1854,57.38606368067626
SIM,1855,36,40-44,1891,4
SIM,1935,15,25-29,1950,76
STAT,1788,101,na,1889,0.13721176113847192
SIM,1937,21,40-44,1958,2
STAT,1886,16,25-29,1902,5.669990001060842
STAT,1829,98,na,1927,1.991188916975252
SIM,1890,23,30-34,1913,29
STAT,1874,22,50-100,1896,0.39373449803429006
STAT,1892,39,na,1931,2759.08568673635
STAT,1834,43,20-24,1877,0.11700102618053916
SIM,1844,22,20-24,1866,55
STAT,1845,13,na,1858,2115.6525387115094
STAT,1915,37,na,1952,3590.0563592542244
STAT,1945,17,40-44,1962,1.4434157778186083
SIM,1894,62,na,1956,2375
SIM,1823,32,30-34,1855,16
SIM,1924,9,na,1933,4470
STAT,1763,91,na,1854,6.0
STAT,1820,41,25-29,1861,1.1948879921642306
STAT,1890,27,50-100,1917,0.7388619894383683
SIM,1894,16,25-29,1910,10
SIM,1919,32,30-34,1951,27
SIM,1888,42,30-34,1930,1
STAT,1945,18,50-100,1963,0.38650541086055606
STAT,1873,32,na,1905,2288.253538746657
STAT,1833,41,35-39,1874,1.3525332921548086
STAT,1877,46,na,1923,2211.8190952322957
STAT,1770,89,na,1859,25.343731687380796
STAT,1899,61,na,1960,2526.59842234302
SIM,1800,85,na,1885,69
SIM,1827,32,na,1859,1598
STAT,1817,46,25-29,1863,0.13092928273221316
STAT,1788,99,na,1887,0.35766240866933374
STAT,1891,21,30-34,1912,20.89090407664293
STAT,1790,93,na,1883,6.632464056178216
STAT,1887,45,25-29,1932,0.06146088946426994
SIM,1846,39,na,1885,1695
STAT,1927,22,na,1949,4250.847190231353
SIM,1835,51,na,1886,1411
SIM,1887,39,40-44,1926,7
STAT,1854,20,15-19,1874,2.831774385644647
STAT,1929,21,40-44,1950,4.029178638032728
STAT,1836,22,20-24,1858,57.43213553378363
SIM,1900,21,45-49,1921,4
SIM,1903,22,25-29,1925,74
STAT,1820,54,30-34,1874,0.00906589636066925
SIM,1864,42,45-49,1906,3
SIM,1949,22,15-19,1971,4
STAT,1865,34,35-39,1899,8.619096991387087
STAT,1780,108,na,1888,0.0043323344842531395
STAT,1910,40,20-24,1950,0.015941410455986873
SIM,1833,22,45-49,1855,2
STAT,1852,18,20-24,1870,16.195074506817672
SIM,1825,39,35-39,1864,15
STAT,1879,31,30-34,1910,17.310739800571575
STAT,1881,51,na,1932,1973.3959314991669
STAT,1889,31,na,1920,2794.4612315877257
SIM,1860,18,20-24,1878,17
STAT,1882,23,30-34,1905,16.32334704042903
STAT,1902,49,35-39,1951,0.10308273620495477
STAT,1807,49,50-100,1856,0.8802632815358447
SIM,1872,32,25-29,1904,14
SIM,1935,33,25-29,1968,16
STAT,1882,41,30-34,1923,1.0616145213490726
STAT,1843,41,20-24,1884,0.1194905930080368
SIM,1812,70,na,1882,640
STAT,1847,43,30-34,1890,0.8398022095195523
STAT,1850,20,30-34,1870,15.269515416038814
SIM,1945,16,na,1961,3667
SIM,1823,66,na,1889,841
SIM,1870,48,na,1918,2064
SIM,1949,15,25-29,1964,52
STAT,1832,50,na,1882,1401.0224523235981
STAT,1840,40,40-44,1880,1.8422289306646873
STAT,1887,76,na,1963,1246.3037291159974
STAT,1901,42,20-24,1943,0.014564627293145537
STAT,1958,14,na,1972,4871.170188587333
STAT,1879,57,na,1936,1984.374120379137
STAT,1894,17,15-19,1911,7.2117863517074365
STAT,1817,39,35-39,1856,20.6280137151972
STAT,1895,75,na,1970,1674.1400704518762
STAT,1888,37,40-44,1925,4.885337593292609
STAT,1891,81,na,1972,1088.457421192067
STAT,1850,39,20-24,1889,0.5399425573846756
SIM,1841,41,35-39,1882,4
SIM,1861,0,na,1861,3163
SIM,1842,36,30-34,1878,13
SIM,1815,47,na,1862,1269
STAT,1826,44,25-29,1870,0.6095360731481649
STAT,1834,36,30-34,1870,4.146305822208238
STAT,1917,19,30-34,1936,12.283711955647647
STAT,1933,30,45-49,1963,2.0055961217131957
STAT,1870,48,35-39,1918,0.12796537932939472
SIM,1855,43,30-34,1898,2
SIM,1916,19,na,1935,3554
STAT,1847,52,45-49,1899,0.010621225422854102
SIM,1841,67,na,1908,1098
STAT,1927,15,25-29,1942,51.14424672393326
STAT,1890,18,40-44,1908,0.21070447738385242
STAT,1909,42,20-24,1951,0.015600739417607104
STAT,1841,18,45-49,1859,0.05730285830051813
SIM,1885,10,na,1895,2468
STAT,1847,36,40-44,1883,3.3767263842374367
STAT,1809,53,50-100,1862,0.0513192031258626
STAT,1944,25,25-29,1969,67.26131425526418
SIM,1872,20,30-34,1892,21
STAT,1876,53,25-29,1929,0.003398903618805274
SIM,1808,65,na,1873,824
SIM,1894,37,50-100,1931,2
STAT,1862,84,na,1946,268.0725856595756
SIM,1762,94,na,1856,3
SIM,1890,41,30-34,1931,1
STAT,1862,53,25-29,1915,0.002808459331382055
SIM,1920,24,na,1944,3753
STAT,1897,37,35-39,1934,8.936037669570737
SIM,1891,26,na,1917,2970
STAT,1952,3,na,1955,4453.51014063317
SIM,1882,45,na,1927,2071
STAT,1820,53,na,1873,1246.5248159331388
STAT,1950,22,45-49,1972,1.2610821331495543
STAT,1882,50,45-49,1932,0.01353224676395003
STAT,1831,33,25-29,1864,8.299944276509855
SIM,1831,27,40-44,1858,3
SIM,1836,23,25-29,1859,52
SIM,1876,29,40-44,1905,6
SIM,1920,46,50-100,1966,3
SIM,1869,25,30-34,1894,24
STAT,1861,18,15-19,1879,5.3194606422359705
SIM,1841,23,35-39,1864,5
STAT,1870,18,40-44,1888,0.16991388552657516
STAT,1871,39,40-44,1910,4.058459721360123
STAT,1866,39,30-34,1905,4.595284105272997
STAT,1919,27,40-44,1946,4.757681126361977
SIM,1837,62,na,1899,1151
STAT,1837,81,na,1918,341.36176128291663
SIM,1882,77,na,1959,858
STAT,1815,50,30-34,1865,0.014410942114680995
SIM,1840,14,na,1854,2070
STAT,1830,79,na,1909,417.61155328221076
SIM,1936,24,30-34,1960,26
SIM,1851,36,25-29,1887,3
SIM,1853,15,25-29,1868,5
SIM,1901,5,na,1906,3530
SIM,1845,48,50-100,1893,1
STAT,1828,30,15-19,1858,0.16496615862899347
SIM,1927,27,40-44,1954,5
STAT,1927,33,25-29,1960,10.73525592472353
SIM,1908,3,na,1911,3609
STAT,1854,47,40-44,1901,0.12270539317373579
SIM,1930,1,na,1931,4975
SIM,1941,30,45-49,1971,1
STAT,1843,36,25-29,1879,2.4502727472785377
STAT,1860,33,20-24,1893,2.0665417350075734
SIM,1823,41,45-49,1864,2
SIM,1889,34,45-49,1923,4
STAT,1935,1,na,1936,5392.942825590019
STAT,1874,45,15-19,1919,3.9006265828690615E-4
STAT,1833,23,35-39,1856,4.860000436256561
STAT,1782,74,na,1856,386.35731214829997
STAT,1890,28,na,1918,2746.7959352873268
STAT,1828,45,na,1873,1452.055986222497
STAT,1845,15,25-29,1860,5.104914139430134
SIM,1874,39,30-34,1913,6
STAT,1861,47,na,1908,1756.7192999186818
SIM,1787,86,na,1873,56
SIM,1873,31,30-34,1904,23
STAT,1818,38,40-44,1856,13.394653997563509
STAT,1949,16,50-100,1965,0.4117869013785089
STAT,1814,50,40-44,1864,0.02843427076459131
STAT,1949,17,25-29,1966,47.616691464727985
STAT,1885,19,15-19,1904,5.55552293277703
STAT,1835,28,15-19,1863,0.3662885175487438
STAT,1933,28,30-34,1961,49.12590638692165
STAT,1843,29,35-39,1872,8.444505810425792
SIM,1889,29,50-100,1918,4
SIM,1941,28,30-34,1969,34
STAT,1864,20,30-34,1884,15.502764073279453
STAT,1860,29,35-39,1889,7.380299603295274
STAT,1920,21,20-24,1941,117.13911692383857
STAT,1881,67,na,1948,1445.9468986341067
STAT,1848,65,na,1913,1217.4887661823316
SIM,1925,19,30-34,1944,16
STAT,1828,50,50-100,1878,0.012780729492804361
STAT,1858,44,20-24,1902,0.1161906327453389
STAT,1806,107,na,1913,0.0015692266139782465
STAT,1824,49,20-24,1873,0.013708689252981434
SIM,1806,54,na,1860,1113
STAT,1852,20,50-100,1872,0.3734038494640737
STAT,1872,34,25-29,1906,9.628910248792224
SIM,1880,34,25-29,1914,10
STAT,1828,105,na,1933,0.016644655932874772
STAT,1893,40,na,1933,2798.2422089132956
STAT,1929,5,na,1934,4847.827520288894
STAT,1839,44,35-39,1883,1.2403539482536727
STAT,1894,25,50-100,1919,0.7826410665801157
STAT,1867,29,20-24,1896,10.331430726638873
STAT,1875,44,20-24,1919,0.15205356512188797
SIM,1851,29,35-39,1880,8
STAT,1861,31,na,1892,1879.6555211886503
SIM,1846,35,na,1881,1785
STAT,1918,40,20-24,1958,0.017787160978957637
STAT,1841,25,35-39,1866,8.318676396274823
STAT,1883,19,50-100,1902,0.045116713009396334
SIM,1914,24,na,1938,3788
STAT,1775,92,na,1867,9.696205442382386
STAT,1808,53,20-24,1861,0.002630602747721964
SIM,1831,31,25-29,1862,12
SIM,1911,21,20-24,1932,90
SIM,1897,35,35-39,1932,14
STAT,1777,108,na,1885,0.004704661814022244
SIM,1826,38,40-44,1864,9
SIM,1847,44,35-39,1891,1
STAT,1858,79,na,1937,518.4771582268368
STAT,1878,18,40-44,1896,0.179405198121102
STAT,1931,40,50-100,1971,0.14867894222578695
STAT,1890,22,25-29,1912,66.1202278570033
STAT,1809,78,na,1887,339.2821013172645
SIM,1859,33,20-24,1892,4
SIM,1871,53,50-100,1924,1
STAT,1854,65,na,1919,1216.9322500213855
STAT,1864,41,40-44,1905,1.907680724900885
SIM,1883,8,na,1891,2464
SIM,1886,63,na,1949,1711
SIM,1861,16,15-19,1877,3
STAT,1861,42,25-29,1903,0.5031369973064952
SIM,1893,29,40-44,1922,3
STAT,1855,38,40-44,1893,3.0849310178212606
STAT,1833,44,15-19,1877,0.009924904875412305
STAT,1853,16,15-19,1869,5.3256159619456795
STAT,1960,8,na,1968,4834.413281806141
STAT,1798,89,na,1887,38.087968415838205
SIM,1869,30,50-100,1899,1
STAT,1879,16,35-39,1895,0.5431437133498244
STAT,1935,17,25-29,1952,55.96252142984251
SIM,1887,31,30-34,1918,18
STAT,1867,45,25-29,1912,0.0516005849177514
STAT,1899,48,25-29,1947,0.04153501096218921
SIM,1856,29,na,1885,1915
STAT,1903,21,20-24,1924,92.900299605523
SIM,1829,27,na,1856,1687
STAT,1889,35,35-39,1924,8.327291583281061
STAT,1856,84,na,1940,246.1354964443435
STAT,1807,49,20-24,1856,0.04300960829256212
SIM,1894,30,na,1924,3072
SIM,1888,37,35-39,1925,18
SIM,1872,41,40-44,1913,7
STAT,1885,29,40-44,1914,2.7992123998679928
SIM,1862,20,15-19,1882,6
STAT,1856,51,30-34,1907,0.004425328281039492
SIM,1932,32,45-49,1964,1
SIM,1855,71,na,1926,983
STAT,1820,49,35-39,1869,0.22416480253530247
STAT,1879,41,na,1920,2292.5186671157267
STAT,1880,37,40-44,1917,4.351230892380313
STAT,1809,101,na,1910,0.2397089727550636
STAT,1833,39,20-24,1872,0.5745228809644682
STAT,1842,64,na,1906,1237.9069037341985
STAT,1907,38,30-34,1945,1.58814589568918
STAT,1823,31,25-29,1854,32.04054065295657
SIM,1846,38,40-44,1884,2
SIM,1860,34,na,1894,1994
SIM,1852,18,15-19,1870,7
SIM,1926,17,25-29,1943,53
STAT,1894,19,40-44,1913,0.2210755275246561
STAT,1844,28,40-44,1872,2.555837328158492
STAT,1870,45,30-34,1915,0.09049812836432138
SIM,1814,89,na,1903,34
STAT,1827,28,40-44,1855,5.401915297605969
STAT,1848,34,35-39,1882,7.583304846370735
SIM,1835,28,40-44,1863,2
STAT,1813,46,40-44,1859,0.5267221736738678
STAT,1838,30,30-34,1868,15.107682874571902
STAT,1891,16,35-39,1907,0.6431850947410009
STAT,1831,92,na,1923,25.40052175791339
STAT,1769,92,na,1861,8.977492826468806
STAT,1803,54,30-34,1857,0.01639144657635605
STAT,1809,90,na,1899,33.11954080259151
STAT,1838,54,45-49,1892,0.009625841027069204
STAT,1890,31,40-44,1921,5.029494752072157
STAT,1838,38,40-44,1876,3.5654012029279625
STAT,1951,7,na,1958,4421.990380882228
SIM,1878,44,na,1922,2315
SIM,1832,30,30-34,1862,19
STAT,1918,17,25-29,1935,8.939648876816085
SIM,1835,40,50-100,1875,1
SIM,1924,5,na,1929,4514
STAT,1924,32,45-49,1956,1.7344849777366158
SIM,1799,71,na,1870,551
STAT,1924,38,30-34,1962,2.02842036737528
STAT,1823,40,40-44,1863,3.086264446788183
STAT,1894,0,na,1894,3568.295612570543
SIM,1932,38,30-34,1970,1
STAT,1833,28,na,1861,1717.8628682914018
STAT,1882,19,45-49,1901,0.05972569367039944
SIM,1893,19,15-19,1912,10
STAT,1907,32,45-49,1939,1.389274581556455
SIM,1953,5,na,1958,4371
STAT,1881,41,40-44,1922,2.0609467023964134
STAT,1920,34,50-100,1954,0.848254555311323
SIM,1887,43,25-29,1930,3
STAT,1937,22,30-34,1959,26.43675371726721
SIM,1831,40,40-44,1871,7
SIM,1915,38,30-34,1953,1
STAT,1870,16,15-19,1886,5.578621148033076
SIM,1914,49,50-100,1963,2
STAT,1850,44,15-19,1894,0.009590921241361414
STAT,1866,31,50-100,1897,0.801301125368678
SIM,1926,35,25-29,1961,1
STAT,1884,34,20-24,1918,2.50180824968812
STAT,1929,24,45-49,1953,1.3358424669739744
STAT,1827,87,na,1914,97.77140689825258
STAT,1875,37,30-34,1912,5.172557882821093
STAT,1772,113,na,1885,4.0967998709900977E-4
STAT,1830,46,40-44,1876,0.127107688851978
SIM,1883,37,30-34,1920,8
STAT,1829,48,40-44,1877,0.1363466199808413
SIM,1856,34,35-39,1890,13
SIM,1846,30,30-34,1876,23
SIM,1902,31,20-24,1933,4
SIM,1945,22,30-34,1967,35
STAT,1879,43,25-29,1922,0.6295059572328794
SIM,1882,21,30-34,1903,16
STAT,1900,26,50-100,1926,0.8412512240411688
SIM,1837,22,30-34,1859,23
STAT,1817,44,50-100,1861,2.4636318792993386
STAT,1808,46,30-34,1854,0.37468302452962304
SIM,1852,28,40-44,1880,2
STAT,1902,62,na,1964,2626.912706757372
SIM,1820,40,50-100,1860,3
STAT,1817,43,20-24,1860,0.38560017810840685
SIM,1892,34,20-24,1926,3
STAT,1918,35,25-29,1953,0.9896894227799219
STAT,1873,26,40-44,1899,2.8823287334961916
SIM,1832,25,35-39,1857,10
STAT,1870,52,20-24,1922,6.794331336204243E-4
STAT,1834,45,na,1879,1515.0809042572914
STAT,1838,59,na,1897,1325.4898106240194
SIM,1823,35,35-39,1858,11
SIM,1891,39,30-34,1930,7
STAT,1935,35,25-29,1970,1.3028355173187522
SIM,1866,6,na,1872,2481
SIM,1831,37,50-100,1868,1
SIM,1936,32,30-34,1968,9
SIM,1926,32,20-24,1958,3
STAT,1832,33,45-49,1865,1.3652794672875521
STAT,1942,20,45-49,1962,1.115200684450784
SIM,1855,39,45-49,1894,1
SIM,1776,86,na,1862,70
STAT,1916,54,na,1970,3466.7249316073335
SIM,1863,30,30-34,1893,14
STAT,1849,47,30-34,1896,0.06944726907778122
SIM,1918,15,25-29,1933,7
STAT,1841,30,30-34,1871,14.797957667783574
STAT,1856,33,30-34,1889,12.941423191582967
SIM,1867,39,40-44,1906,3
STAT,1902,46,30-34,1948,0.073000913496797
SIM,1838,36,40-44,1874,2
STAT,1851,50,45-49,1901,0.010795124522581774
STAT,1928,32,30-34,1960,18.612413665534312
STAT,1918,32,20-24,1950,2.4485374878792654
SIM,1864,33,30-34,1897,20
STAT,1910,43,25-29,1953,0.06335384702317898
STAT,1882,26,35-39,1908,8.900216892476491
SIM,1881,42,45-49,1923,3
STAT,1900,43,15-19,1943,0.0012477538629822532
SIM,1944,23,25-29,1967,99
STAT,1808,49,35-39,1857,0.5155352863507677
STAT,1839,36,35-39,1875,5.694535435371513
STAT,1953,19,40-44,1972,1.5973894650471665
STAT,1893,27,25-29,1920,50.70316052241805
SIM,1893,45,na,1938,2832
SIM,1859,9,na,1868,2326
STAT,1866,23,45-49,1889,0.6079221488641712
SIM,1924,18,na,1942,4100
STAT,1846,30,na,1876,1843.691715886146
STAT,1827,28,na,1855,1557.4424008469407
STAT,1883,39,30-34,1922,4.884817433572868
SIM,1843,86,na,1929,135
SIM,1871,37,40-44,1908,3
SIM,1807,48,na,1855,1207
SIM,1890,26,35-39,1916,14
STAT,1860,36,25-29,1896,2.221170893683055
SIM,1914,27,50-100,1941,5
STAT,1929,17,na,1946,4437.874031029358
STAT,1933,22,45-49,1955,1.4099537909801834
STAT,1865,50,45-49,1915,0.012637135100470731
SIM,1927,34,30-34,1961,19
STAT,1834,46,25-29,1880,0.042087239781085695
STAT,1870,83,na,1953,367.4787499580052
SIM,1866,37,30-34,1903,5
SIM,1788,71,na,1859,537
STAT,1936,23,25-29,1959,83.38318658523319
SIM,1841,20,30-34,1861,17
STAT,1862,50,20-24,1912,6.031886333333337E-4
STAT,1871,61,na,1932,1750.0584093512912
SIM,1888,5,na,1893,2845
STAT,1957,9,na,1966,4893.75215360773
STAT,1861,28,40-44,1889,2.3500276294609708
STAT,1871,47,40-44,1918,0.1595887430855453
SIM,1943,17,25-29,1960,39
SIM,1941,22,45-49,1963,1
STAT,1866,43,15-19,1909,0.011941321050334543
SIM,1919,35,35-39,1954,9
STAT,1861,47,30-34,1908,0.07558331697288827
STAT,1909,25,na,1934,3403.0915668002476
SIM,1834,36,25-29,1870,3
STAT,1815,53,35-39,1868,0.019626228523757703
STAT,1820,49,na,1869,1338.4496646799641
STAT,1841,15,40-44,1856,0.16331688761679602
STAT,1862,49,40-44,1911,0.13507894894014535
STAT,1863,37,40-44,1900,3.635137796932512
SIM,1950,20,45-49,1970,1
STAT,1844,18,15-19,1862,5.264646664968044
STAT,1847,39,45-49,1886,1.4905755670514864
STAT,1853,18,40-44,1871,0.16220784256618498
STAT,1927,29,40-44,1956,5.33212215572431
STAT,1855,30,30-34,1885,12.854958105189926
STAT,1844,19,50-100,1863,0.0432055875375956
STAT,1876,29,15-19,1905,0.43931339341755155
SIM,1810,45,50-100,1855,5
STAT,1895,36,50-100,1931,1.520845869272683
STAT,1888,8,na,1896,2901.1199998690013
STAT,1846,94,na,1940,14.091632918218933
SIM,1812,54,na,1866,1165
STAT,1806,51,45-49,1857,0.041807423505113385
STAT,1843,50,na,1893,1575.7376490230947
STAT,1834,39,35-39,1873,5.333822752382411
STAT,1832,34,na,1866,1658.029632421449
STAT,1888,45,45-49,1933,0.2660041662547413
SIM,1928,31,40-44,1959,5
STAT,1848,52,35-39,1900,0.006169151511411915
STAT,1892,3,na,1895,3127.4459405300254
SIM,1823,70,na,1893,730
SIM,1896,25,na,1921,3021
SIM,1866,59,na,1925,1682
STAT,1835,101,na,1936,0.3560290473477868
STAT,1816,48,30-34,1864,0.25083363758166427
STAT,1916,30,45-49,1946,1.5470367923200314
STAT,1932,37,na,1969,4775.432071513503
STAT,1832,51,45-49,1883,0.009335216173558309
STAT,1886,39,na,1925,2327.890331266565
STAT,1802,68,na,1870,707.4525091529557
STAT,1840,43,45-49,1883,1.07341468412917
SIM,1868,14,na,1882,2380
STAT,1847,46,35-39,1893,0.10330288396477207
STAT,1858,39,20-24,1897,0.5659306146340188
STAT,1826,36,25-29,1862,3.211446160034389
STAT,1850,15,35-39,1865,0.47765347329659996
SIM,1946,22,45-49,1968,2
STAT,1838,42,25-29,1880,0.5122022389073739
STAT,1857,49,30-34,1906,0.07058665185476382
SIM,1811,85,na,1896,106
STAT,1861,99,na,1960,3.195330813856513
STAT,1897,42,30-34,1939,0.10074098937903224
STAT,1919,34,30-34,1953,15.920394626166958
STAT,1851,102,na,1953,0.21499003833639574
STAT,1911,32,50-100,1943,0.7604045106442248
SIM,1911,24,25-29,1935,94
SIM,1800,69,na,1869,727
SIM,1824,51,na,1875,1269
SIM,1842,39,35-39,1881,12
SIM,1799,67,na,1866,715
STAT,1938,22,45-49,1960,1.0518728218175324
STAT,1811,72,na,1883,587.9320477637273
SIM,1873,32,45-49,1905,2
SIM,1864,36,35-39,1900,8
SIM,1869,28,35-39,1897,9
SIM,1908,19,30-34,1927,3
SIM,1840,33,45-49,1873,3
STAT,1838,46,40-44,1884,0.1216763020962293
STAT,1873,42,45-49,1915,1.4333738365478992
STAT,1901,45,25-29,1946,0.043391004917626576
STAT,1903,24,25-29,1927,76.45833654045902
STAT,1824,108,na,1932,9.670359156039737E-4
SIM,1847,36,35-39,1883,12
SIM,1836,20,20-24,1856,59
SIM,1870,42,50-100,1912,3
SIM,1829,82,na,1911,199
SIM,1925,5,na,1930,4478
SIM,1834,29,35-39,1863,11
STAT,1895,48,40-44,1943,0.11755687660180895
STAT,1895,21,15-19,1916,4.07931485776953
STAT,1897,27,40-44,1924,3.7846414630449776
STAT,1812,47,35-39,1859,0.46067305409702713
STAT,1936,30,15-19,1966,0.11802731405369665
SIM,1841,51,na,1892,1515
STAT,1846,44,25-29,1890,0.44665572955979443
STAT,1821,48,40-44,1869,0.2576240514329434
SIM,1872,83,na,1955,284
STAT,1889,32,30-34,1921,20.36277961634549
SIM,1806,70,na,1876,643
SIM,1847,52,na,1899,1521
SIM,1887,80,na,1967,869
SIM,1922,8,na,1930,4382
STAT,1875,47,25-29,1922,0.055642367005712436
STAT,1879,47,40-44,1926,0.1682602599712049
STAT,1910,32,20-24,1942,2.221143079792207
STAT,1848,17,50-100,1865,0.04375325823774567
STAT,1933,9,na,1942,5034.291078927034
STAT,1829,82,na,1911,285.99106826835356
STAT,1874,42,35-39,1916,1.7462452382342764
STAT,1822,88,na,1910,70.91149700047357
STAT,1817,51,20-24,1868,0.0016133162203874891
STAT,1923,15,50-100,1938,0.4175717444449102
SIM,1929,21,na,1950,4452
STAT,1864,8,na,1872,2356.9380373495956
STAT,1892,23,na,1915,2789.223138682026
STAT,1881,25,50-100,1906,0.5874501581161328
SIM,1902,39,na,1941,3155
SIM,1854,49,50-100,1903,2
SIM,1899,61,na,1960,2529
STAT,1892,33,15-19,1925,0.16775830448466228
SIM,1864,48,na,1912,1991
SIM,1909,39,40-44,1948,2
SIM,1869,95,na,1964,24
STAT,1891,40,45-49,1931,1.7676898743469927
STAT,1814,53,45-49,1867,0.036911556307308455
SIM,1900,27,30-34,1927,40
STAT,1849,18,15-19,1867,5.23433560238498
SIM,1881,34,45-49,1915,1
STAT,1877,40,50-100,1917,1.0461078819556535
SIM,1857,18,15-19,1875,3
SIM,1885,40,50-100,1925,1
SIM,1897,32,30-34,1929,39
STAT,1871,43,25-29,1914,0.5970635282321014
STAT,1922,23,na,1945,3944.223067625674
STAT,1926,37,na,1963,4344.113323508216
STAT,1825,42,15-19,1867,0.015425460837414548
STAT,1901,38,35-39,1939,2.0086277806084736
SIM,1924,30,45-49,1954,1
STAT,1840,69,na,1909,1022.021733045089
SIM,1824,83,na,1907,203
STAT,1804,52,25-29,1856,0.010533016767696
STAT,1859,29,15-19,1888,0.3429829387772997
SIM,1860,98,na,1958,2
STAT,1944,22,20-24,1966,113.41529421686234
SIM,1916,51,na,1967,3429
STAT,1876,50,20-24,1926,7.300016794795362E-4
STAT,1893,35,25-29,1928,3.483826905718669
STAT,1856,54,35-39,1910,0.006194626092498163
STAT,1884,42,20-24,1926,0.14807574301738854
STAT,1804,90,na,1894,26.71742204284987
STAT,1864,32,25-29,1896,8.647941083006689
STAT,1925,43,50-100,1968,0.1341698843134652
SIM,1838,43,30-34,1881,3
SIM,1876,33,na,1909,2346
STAT,1830,41,50-100,1871,0.8147165306397688
STAT,1927,8,na,1935,4685.359673862471
STAT,1860,26,30-34,1886,19.68211864277207
STAT,1817,38,20-24,1855,2.45815544365924
SIM,1816,38,30-34,1854,4
SIM,1840,41,45-49,1881,3
STAT,1886,7,na,1893,2600.4689291026216
STAT,1840,14,na,1854,2133.0
STAT,1844,28,na,1872,1845.7183960684754
STAT,1944,22,na,1966,3724.7261819654877
STAT,1814,53,na,1867,1151.1398846700051
SIM,1895,56,na,1951,2537
STAT,1839,29,45-49,1868,0.9192913128336281
SIM,1883,62,na,1945,1695
STAT,1812,54,25-29,1866,0.010709136615749069
SIM,1883,29,30-34,1912,36
SIM,1884,32,20-24,1916,1
STAT,1837,24,30-34,1861,14.509232927611832
SIM,1929,25,50-100,1954,1
STAT,1875,29,30-34,1904,24.26531398770257
STAT,1884,29,20-24,1913,10.873501359325967
SIM,1875,95,na,1970,67
STAT,1937,25,35-39,1962,13.835802633761189
STAT,1897,34,30-34,1931,21.87001597058758
STAT,1898,24,na,1922,3005.554037629754
SIM,1877,24,25-29,1901,54
SIM,1887,76,na,1963,1109
STAT,1838,53,30-34,1891,0.003994684504074876
STAT,1775,88,na,1863,39.50248836723401
SIM,1860,47,50-100,1907,3
STAT,1945,24,30-34,1969,29.73754698886692
SIM,1848,33,45-49,1881,4
STAT,1875,27,na,1902,2316.211545816581
STAT,1913,21,30-34,1934,26.38355006729233
STAT,1918,43,25-29,1961,0.07160958943273493
STAT,1924,48,30-34,1972,0.09999056836310087
SIM,1921,21,30-34,1942,38
STAT,1832,41,45-49,1873,1.1247551938670868
STAT,1823,73,na,1896,625.0406986383852
SIM,1918,33,25-29,1951,13
SIM,1873,68,na,1941,1445
SIM,1847,29,45-49,1876,1
STAT,1901,37,50-100,1938,0.3504027229814565
SIM,1903,6,na,1909,3481
STAT,1823,35,40-44,1858,7.824115305600965
SIM,1874,23,45-49,1897,1
SIM,1882,24,35-39,1906,7
STAT,1910,48,30-34,1958,0.07833150125556033
SIM,1935,29,40-44,1964,7
STAT,1828,51,50-100,1879,0.012529775414877575
STAT,1848,30,50-100,1878,0.7859297779365669
STAT,1877,23,20-24,1900,67.34733945601981
STAT,1900,18,25-29,1918,7.407296855908773
STAT,1941,24,50-100,1965,0.6418907143604007
SIM,1872,28,40-44,1900,2
SIM,1873,26,35-39,1899,14
SIM,1885,23,20-24,1908,63
STAT,1834,28,30-34,1862,20.292643753995996
STAT,1905,11,na,1916,3530.78720387731
STAT,1800,102,na,1902,0.11686175068627162
STAT,1897,9,na,1906,3278.0993222176216
STAT,1921,45,50-100,1966,0.24202840238809645
STAT,1891,22,45-49,1913,0.815382804584779
STAT,1853,48,35-39,1901,0.10252053077966862
STAT,1863,32,30-34,1895,14.498786491069138
STAT,1916,49,35-39,1965,0.12419059467876073
SIM,1945,25,35-39,1970,18
SIM,1953,17,40-44,1970,1
STAT,1865,4,na,1869,2591.0497045075144
STAT,1868,73,na,1941,1071.3256191575308
SIM,1901,21,na,1922,3214
SIM,1856,31,30-34,1887,18
SIM,1879,37,40-44,1916,2
SIM,1879,44,30-34,1923,1
SIM,1830,83,na,1913,226
STAT,1926,42,20-24,1968,0.02056986116548814
STAT,1951,20,50-100,1971,0.7432105351469248
STAT,1865,19,45-49,1884,0.057106352651277746
STAT,1873,34,45-49,1907,1.6578492070273256
STAT,1869,31,15-19,1900,0.13075498948967695
STAT,1890,26,40-44,1916,3.471830888669294
SIM,1867,2,na,1869,2822
STAT,1881,44,45-49,1925,1.3467243452854274
STAT,1907,1,na,1908,3776.500037515361
STAT,1868,29,40-44,1897,2.682618642129879
STAT,1811,88,na,1899,59.46427009002023
STAT,1837,17,40-44,1854,0.20098202295283982
SIM,1843,18,20-24,1861,9
STAT,1946,21,40-44,1967,3.5359713941423347
SIM,1814,43,45-49,1857,2
SIM,1887,9,na,1896,2712
STAT,1809,62,na,1871,975.9302765070445
STAT,1841,40,30-34,1881,0.8385833418216406
STAT,1807,51,35-39,1858,0.031101078774087344
STAT,1867,84,na,1951,295.07241178495116
SIM,1898,19,15-19,1917,7
STAT,1938,22,na,1960,3413.9002549664156
SIM,1864,45,50-100,1909,1
SIM,1851,28,20-24,1879,12
SIM,1868,26,25-29,1894,35
SIM,1917,36,na,1953,3661
STAT,1850,20,50-100,1870,0.34957685604533284
STAT,1856,41,30-34,1897,0.8544815264625212
STAT,1817,97,na,1914,2.382391828166353
SIM,1907,42,na,1949,3249
STAT,1863,70,na,1933,1165.1318784448547
STAT,1843,28,20-24,1871,10.341329541181286
STAT,1858,52,20-24,1910,5.4434950889737E-4
SIM,1860,34,25-29,1894,10
STAT,1867,37,25-29,1904,2.5538492833496127
STAT,1900,25,15-19,1925,0.5986518793412416
STAT,1841,22,30-34,1863,15.438520316782013
STAT,1820,46,30-34,1866,0.1619690321184704
STAT,1852,54,na,1906,1590.9306252496435
SIM,1875,37,25-29,1912,4
STAT,1848,31,30-34,1879,14.821749866190142
SIM,1851,45,50-100,1896,2
STAT,1865,26,35-39,1891,8.311498101952028
STAT,1830,42,25-29,1872,0.48841188384243667
STAT,1842,38,30-34,1880,4.40613518307001
SIM,1900,32,na,1932,3090
STAT,1873,52,45-49,1925,0.013841992264178581
SIM,1842,28,30-34,1870,35
STAT,1852,34,25-29,1886,7.89177529704803
SIM,1850,38,30-34,1888,5
STAT,1813,49,45-49,1862,0.6900722249408564
SIM,1882,42,35-39,1924,4
SIM,1780,75,na,1855,379
STAT,1842,34,15-19,1876,0.11998824597431809
STAT,1912,24,na,1936,3422.999688527469
STAT,1849,49,20-24,1898,0.008468895516604494
SIM,1881,29,45-49,1910,3
SIM,1884,27,25-29,1911,42
SIM,1888,43,45-49,1931,1
STAT,1851,85,na,1936,201.0272835485418
SIM,1927,23,25-29,1950,108
SIM,1840,35,35-39,1875,13
SIM,1817,70,na,1887,707
STAT,1931,40,40-44,1971,0.31655010195065214
SIM,1913,39,na,1952,3349
STAT,1832,30,40-44,1862,3.5092013149845442
SIM,1854,22,30-34,1876,21
SIM,1900,63,na,1963,2458
STAT,1900,31,45-49,1931,2.2947748353296507
STAT,1856,45,50-100,1901,0.18352961362394604
STAT,1859,65,na,1924,1274.1042203665604
STAT,1837,42,30-34,1879,0.8563955959321204
STAT,1921,16,40-44,1937,1.51000078301146
STAT,1915,36,15-19,1951,0.018412867312121287
SIM,1835,82,na,1917,267
STAT,1855,99,na,1954,1.3413063069628803
STAT,1878,25,30-34,1903,24.933218147721853
SIM,1868,23,20-24,1891,58
STAT,1846,48,40-44,1894,0.11919169916277013
STAT,1823,66,na,1889,865.8937256690937
SIM,1909,32,20-24,1941,2
SIM,1924,22,45-49,1946,1
SIM,1876,80,na,1956,577
SIM,1891,1,na,1892,3250
STAT,1878,48,40-44,1926,0.16625153399202855
SIM,1940,17,na,1957,3379
SIM,1794,95,na,1889,3
STAT,1886,37,50-100,1923,1.2254397046609804
SIM,1920,18,40-44,1938,3
STAT,1876,27,25-29,1903,41.254689052836746
STAT,1812,44,30-34,1856,3.9611053468040662
SIM,1871,33,na,1904,2298
STAT,1824,31,45-49,1855,4.7217505236425685
STAT,1897,45,35-39,1942,0.10076871179032326
STAT,1873,29,45-49,1902,1.05706945020859
STAT,1854,51,50-100,1905,0.010927437390963454
SIM,1880,10,na,1890,2659
STAT,1937,31,40-44,1968,3.6591494051599147
STAT,1903,32,25-29,1935,13.76639878522413
STAT,1881,20,30-34,1901,16.344307827951287
STAT,1881,21,20-24,1902,63.04789044473106
STAT,1907,61,na,1968,2847.8956785526716
STAT,1846,22,30-34,1868,15.496009642058494
SIM,1886,25,30-34,1911,30
STAT,1896,60,na,1956,2402.916490344804
SIM,1856,26,35-39,1882,9
SIM,1862,84,na,1946,244
STAT,1945,20,15-19,1965,5.515261588230436
SIM,1896,33,25-29,1929,17
SIM,1840,30,40-44,1870,4
SIM,1790,81,na,1871,158
SIM,1923,29,25-29,1952,75
SIM,1866,50,na,1916,1906
STAT,1920,43,na,1963,3869.014988193865
STAT,1825,49,35-39,1874,0.1428106427475683
STAT,1916,44,50-100,1960,0.11335002010468531
STAT,1855,34,25-29,1889,7.234449250195945
STAT,1911,31,20-24,1942,2.2524723782368525
SIM,1830,52,na,1882,1434
SIM,1828,32,30-34,1860,23
SIM,1918,37,40-44,1955,2
STAT,1923,41,45-49,1964,0.18404514621316845
STAT,1840,20,20-24,1860,61.91724549393058
SIM,1845,24,30-34,1869,23
STAT,1878,21,15-19,1899,3.2542287386638136
STAT,1880,29,40-44,1909,2.9563044302855532
SIM,1832,31,45-49,1863,1
SIM,1910,30,20-24,1940,5
STAT,1936,34,30-34,1970,14.43560629403496
SIM,1949,19,40-44,1968,1
STAT,1860,40,45-49,1900,1.160654404619018
SIM,1893,76,na,1969,1545
STAT,1837,47,40-44,1884,0.11218727728069192
SIM,1833,96,na,1929,4
SIM,1822,53,na,1875,1270
STAT,1851,32,15-19,1883,0.1086927963855874
STAT,1953,4,na,1957,4494.231960611781
SIM,1821,38,40-44,1859,7
STAT,1838,49,45-49,1887,0.16140688890918903
STAT,1873,36,35-39,1909,6.814926794504132
STAT,1921,49,20-24,1970,0.011701106340915372
SIM,1892,29,20-24,1921,14
STAT,1888,42,40-44,1930,2.507124194177598
STAT,1936,6,na,1942,3624.4337364168837
STAT,1816,44,15-19,1860,0.0379679897634839
SIM,1857,39,30-34,1896,5
STAT,1943,16,na,1959,3688.183575730066
SIM,1877,21,20-24,1898,60
SIM,1911,32,25-29,1943,12
STAT,1848,102,na,1950,0.2112101615367609
SIM,1857,14,na,1871,2263
SIM,1929,6,na,1935,4910
SIM,1822,37,40-44,1859,7
STAT,1891,13,na,1904,3015.0646819291987
STAT,1912,18,40-44,1930,0.2664315690758176
STAT,1919,30,15-19,1949,0.13202653970858486
SIM,1885,57,na,1942,1915
STAT,1851,39,35-39,1890,5.134487845576165
STAT,1918,49,na,1967,3671.532251465274
SIM,1869,3,na,1872,2731
SIM,1927,35,na,1962,4347
STAT,1811,44,50-100,1855,3.7260099515741882
STAT,1869,28,40-44,1897,2.7296116748552244
SIM,1926,6,na,1932,4525
STAT,1787,73,na,1860,473.69736434532484
STAT,1866,54,20-24,1920,6.250453260284052E-4
STAT,1924,40,45-49,1964,0.1875510411210753
STAT,1910,49,45-49,1959,0.19038338651855768
STAT,1953,15,25-29,1968,49.54997992619467
STAT,1841,33,35-39,1874,8.319925325569292
SIM,1843,26,25-29,1869,42
STAT,1852,52,25-29,1904,0.002676797214050304
SIM,1805,85,na,1890,70
STAT,1817,54,25-29,1871,0.007293030225199916
SIM,1929,21,30-34,1950,49
STAT,1869,21,20-24,1890,63.20637114436207
STAT,1838,28,na,1866,1863.3049314622244
SIM,1880,32,35-39,1912,12
SIM,1831,23,25-29,1854,46
STAT,1860,18,30-34,1878,1.4030156146060626
STAT,1881,28,40-44,1909,2.722767574171702
SIM,1843,15,na,1858,2124
STAT,1900,39,na,1939,3080.761639965002
SIM,1818,48,na,1866,1272
STAT,1896,1,na,1897,3398.3379723156945
SIM,1897,27,35-39,1924,15
SIM,1813,41,35-39,1854,2
STAT,1874,49,30-34,1923,0.09151200674918601
STAT,1915,24,50-100,1939,0.638463167159987
STAT,1864,26,50-100,1890,0.5419526472594361
SIM,1844,16,15-19,1860,4
SIM,1864,95,na,1959,26
STAT,1826,29,35-39,1855,18.18471753517434
STAT,1846,49,50-100,1895,0.16955022535344944
STAT,1835,51,na,1886,1396.4284631943435
STAT,1877,93,na,1970,118.55946376719248
SIM,1845,42,30-34,1887,3
SIM,1855,44,na,1899,1810
STAT,1840,109,na,1949,4.954724663035013E-4
STAT,1872,46,na,1918,2139.3610563372586
SIM,1777,92,na,1869,5
SIM,1878,41,30-34,1919,1
SIM,1929,16,35-39,1945,5
STAT,1912,46,50-100,1958,0.20580972787147714
STAT,1884,45,25-29,1929,0.05430797002766344
STAT,1942,18,30-34,1960,12.028833642796254
SIM,1889,56,na,1945,2354
STAT,1851,46,25-29,1897,0.04235895083078188
STAT,1857,32,50-100,1889,0.6865874140665409
STAT,1889,27,35-39,1916,11.253275120464233
SIM,1950,18,30-34,1968,16
STAT,1871,40,20-24,1911,0.15023609802835364
STAT,1889,19,na,1908,2929.7473780894115
STAT,1919,23,25-29,1942,95.25663397031133
STAT,1947,15,na,1962,3919.227784250409
STAT,1900,47,30-34,1947,0.07122883474437217
STAT,1887,41,30-34,1928,1.2201163610045438
SIM,1902,43,na,1945,3086
STAT,1852,26,25-29,1878,37.70486163109182
STAT,1930,42,na,1972,4616.567798014298
SIM,1772,89,na,1861,31
SIM,1830,36,40-44,1866,2
STAT,1848,80,na,1928,445.6513253212755
STAT,1884,32,na,1916,2227.716149853831
SIM,1858,29,20-24,1887,12
STAT,1789,84,na,1873,96.72765672358435
STAT,1835,26,25-29,1861,34.647030208571465
STAT,1896,32,20-24,1928,3.374855905920779
STAT,1856,42,45-49,1898,1.105991736662609
SIM,1898,21,40-44,1919,2
SIM,1889,20,25-29,1909,52
STAT,1904,25,na,1929,3255.2527251616743
SIM,1820,39,35-39,1859,8
STAT,1837,48,50-100,1885,0.1588927751407764
SIM,1924,28,30-34,1952,52
STAT,1812,82,na,1894,200.67632449033098
STAT,1849,39,30-34,1888,3.8500889024621023
STAT,1856,35,50-100,1891,0.9170266713332903
STAT,1890,75,na,1965,1484.767544525121
STAT,1898,20,25-29,1918,73.64402601618781
STAT,1916,28,30-34,1944,38.136814422473236
SIM,1881,22,25-29,1903,48
STAT,1832,28,45-49,1860,0.9005346901157931
STAT,1873,51,30-34,1924,0.005735259646078638
SIM,1790,74,na,1864,387
STAT,1866,46,na,1912,1965.150274893789
SIM,1880,27,40-44,1907,2
SIM,1810,90,na,1900,31
STAT,1872,32,35-39,1904,9.602507339193394
STAT,1941,19,25-29,1960,42.13571721981632
SIM,1919,41,40-44,1960,1
STAT,1827,59,na,1886,1129.5447400991302
STAT,1856,13,na,1869,2079.0555088183783
SIM,1838,28,40-44,1866,2
SIM,1881,36,35-39,1917,14
STAT,1904,18,50-100,1922,0.0662014261992002
SIM,1815,74,na,1889,437
SIM,1878,15,30-34,1893,2
SIM,1840,28,45-49,1868,5
STAT,1853,52,20-24,1905,5.443335209342746E-4
STAT,1953,15,na,1968,4208.62410536868
SIM,1854,58,na,1912,1548
STAT,1816,101,na,1917,0.26590865151452886
SIM,1860,26,25-29,1886,38
SIM,1899,38,25-29,1937,2
STAT,1883,35,15-19,1918,0.052485433020983414
STAT,1878,43,30-34,1921,1.1224766055762498
STAT,1884,31,na,1915,2236.820007283475
SIM,1911,11,na,1922,3769
STAT,1911,36,30-34,1947,1.6706367896403276
STAT,1887,49,40-44,1936,0.0998967406601007
STAT,1904,23,30-34,1927,24.057923457384277
STAT,1937,16,na,1953,3390.5708705353527
SIM,1831,37,na,1868,1600
SIM,1882,3,na,1885,2599
STAT,1866,47,30-34,1913,0.08391867298552047
STAT,1927,25,25-29,1952,76.11423100809036
STAT,1872,15,35-39,1887,0.5282025963900211
STAT,1893,4,na,1897,3153.184461245819
SIM,1886,43,30-34,1929,1
STAT,1860,54,25-29,1914,0.0026446325488072367
SIM,1784,74,na,1858,344
STAT,1931,27,na,1958,4569.05996574504
STAT,1897,19,40-44,1916,0.22984328617249863
STAT,1829,41,20-24,1870,0.1356835054619471
STAT,1842,52,45-49,1894,0.010279456979170222
SIM,1904,24,35-39,1928,10
SIM,1855,43,na,1898,1828
SIM,1862,39,40-44,1901,5
STAT,1915,29,25-29,1944,62.96303223735182
STAT,1804,63,na,1867,896.3765479822857
STAT,1872,47,na,1919,2123.358635635855
SIM,1903,26,40-44,1929,4
STAT,1840,27,40-44,1867,2.601137909763769
STAT,1888,47,35-39,1935,0.15551301642590834
SIM,1906,57,na,1963,2953
STAT,1845,29,50-100,1874,0.5405978448076382
SIM,1889,25,35-39,1914,14
STAT,1811,51,25-29,1862,0.011475223921199583
STAT,1840,25,50-100,1865,0.5635272726072507
SIM,1909,17,25-29,1926,9
STAT,1898,46,15-19,1944,2.893649481564385E-4
STAT,1812,51,20-24,1863,0.002369225167447701
STAT,1825,52,na,1877,1348.916191908673
STAT,1877,26,25-29,1903,41.61111106782716
STAT,1857,94,na,1951,14.88464689989544
SIM,1837,40,30-34,1877,1
STAT,1888,33,25-29,1921,11.382612257554886
STAT,1916,46,30-34,1962,0.08658994897650543
SIM,1830,31,30-34,1861,21
SIM,1866,43,na,1909,2017
STAT,1905,20,40-44,1925,2.861696168562901
STAT,1896,31,30-34,1927,21.88810412452646
STAT,1861,16,25-29,1877,5.139765046176492
STAT,1887,23,30-34,1910,18.760465677384776
SIM,1823,97,na,1920,4
SIM,1904,62,na,1966,2658
SIM,1838,47,na,1885,1463
STAT,1814,102,na,1916,0.12096281337173401
SIM,1895,23,30-34,1918,24
SIM,1863,31,20-24,1894,2
STAT,1846,26,50-100,1872,0.5495801640900999
SIM,1867,19,20-24,1886,13
SIM,1879,29,40-44,1908,3
STAT,1827,40,50-100,1867,1.0066824964662513
SIM,1814,40,40-44,1854,3
STAT,1916,22,45-49,1938,1.1137834837113394
STAT,1900,29,30-34,1929,32.7672544876744
STAT,1853,80,na,1933,458.75585427795124
SIM,1935,25,25-29,1960,94
STAT,1832,53,35-39,1885,0.005322766120211912
SIM,1857,20,40-44,1877,3
STAT,1852,19,35-39,1871,0.4982953434635843
STAT,1822,36,40-44,1858,8.338651956346355
STAT,1829,40,30-34,1869,0.9974666807949583
SIM,1885,26,25-29,1911,46
STAT,1957,0,na,1957,4932.752752367368
STAT,1890,29,45-49,1919,1.2732643317375112
STAT,1921,23,30-34,1944,30.575245718353013
SIM,1922,40,40-44,1962,1
SIM,1853,39,50-100,1892,1
SIM,1840,21,25-29,1861,53
STAT,1823,38,45-49,1861,2.9970728261123742
STAT,1888,40,15-19,1928,0.015567421816392153
SIM,1881,31,40-44,1912,5
SIM,1887,21,na,1908,2495
STAT,1897,40,40-44,1937,0.1993295299784561
STAT,1903,44,50-100,1947,0.09727027238506544
STAT,1878,31,na,1909,2356.4142343527233
STAT,1846,40,30-34,1886,0.8417060238870342
SIM,1794,67,na,1861,744
SIM,1831,38,45-49,1869,1
STAT,1831,31,35-39,1862,8.412995044209232
STAT,1915,42,45-49,1957,0.15827527421411788
SIM,1810,68,na,1878,723
STAT,1876,19,20-24,1895,17.197124056055905
STAT,1969,2,na,1971,4643.1698364564745
STAT,1832,81,na,1913,326.9778669408403
STAT,1892,44,20-24,1936,0.012870452967128956
SIM,1828,49,50-100,1877,3
SIM,1912,16,40-44,1928,1
SIM,1939,20,na,1959,3397
SIM,1803,89,na,1892,36
SIM,1913,20,40-44,1933,5
STAT,1930,4,na,1934,4929.824838736725
STAT,1908,2,na,1910,3734.6719208344934
STAT,1832,35,35-39,1867,5.540364496621736
STAT,1941,26,15-19,1967,0.6901523357269103
STAT,1777,99,na,1876,0.3231008023309005
STAT,1843,21,50-100,1864,0.3719550961099717
STAT,1896,39,40-44,1935,5.410445902261729
STAT,1903,40,na,1943,3148.56345596258
SIM,1870,17,na,1887,2361
STAT,1825,53,20-24,1878,7.311874823705154E-4
SIM,1903,2,na,1905,3532
SIM,1854,40,30-34,1894,3
SIM,1862,29,na,1891,2056
STAT,1873,31,40-44,1904,4.175507881497723
SIM,1949,17,15-19,1966,45
STAT,1836,95,na,1931,8.39598660762976
STAT,1825,46,30-34,1871,0.10290706398912998
SIM,1858,1,na,1859,2847
SIM,1854,25,35-39,1879,10
STAT,1831,51,50-100,1882,0.009963626075955682
STAT,1938,21,30-34,1959,26.87775949964473
SIM,1844,25,25-29,1869,43
STAT,1904,16,40-44,1920,0.24840989486874776
SIM,1883,83,na,1966,601
STAT,1819,52,na,1871,1246.5938557124634
SIM,1858,95,na,1953,5
SIM,1877,28,40-44,1905,3
STAT,1892,37,30-34,1929,6.304926689028426
SIM,1840,41,na,1881,1657
STAT,1875,39,20-24,1914,0.7406084770648259
STAT,1899,34,na,1933,3062.9006482836357
SIM,1810,75,na,1885,408
SIM,1933,38,na,1971,4853
SIM,1840,32,30-34,1872,21
SIM,1848,24,35-39,1872,7
SIM,1835,67,na,1902,983
STAT,1873,22,25-29,1895,54.89329369109988
STAT,1855,25,50-100,1880,0.5264702386011679
STAT,1859,19,20-24,1878,15.332866803176161
STAT,1897,43,45-49,1940,0.1303579327674867
STAT,1887,43,35-39,1930,1.8992985222354741
SIM,1881,26,40-44,1907,2
SIM,1888,40,40-44,1928,8
STAT,1851,14,na,1865,2109.127549714653
SIM,1930,20,40-44,1950,7
SIM,1871,32,30-34,1903,30
SIM,1804,90,na,1894,28
SIM,1853,48,na,1901,1780
STAT,1852,31,20-24,1883,2.1485654212959853
STAT,1805,108,na,1913,6.133132104786037E-4
SIM,1815,78,na,1893,313
STAT,1914,21,45-49,1935,1.045047956953653
STAT,1860,22,15-19,1882,2.6110143432339146
STAT,1906,21,na,1927,3263.204534992297
SIM,1871,98,na,1969,16
SIM,1886,8,na,1894,2540
STAT,1901,17,30-34,1918,2.1075527727032495
SIM,1908,21,15-19,1929,3
SIM,1888,61,na,1949,2035
STAT,1879,52,40-44,1931,0.010339999129998488
SIM,1939,16,na,1955,3426
STAT,1855,31,20-24,1886,1.9696059398581565
STAT,1865,31,30-34,1896,15.049455493571122
STAT,1876,61,na,1937,1822.396928809402
SIM,1927,20,20-24,1947,115
STAT,1835,19,35-39,1854,0.8636719298307223
STAT,1829,48,50-100,1877,0.1956000574932178
STAT,1883,50,40-44,1933,0.009887275857689812
STAT,1832,32,30-34,1864,13.821043843387908
STAT,1949,19,50-100,1968,0.41139582718064105
SIM,1906,36,na,1942,3342
SIM,1932,26,15-19,1958,3
STAT,1837,20,15-19,1857,2.7852690237574076
STAT,1920,32,25-29,1952,9.564427545092526
SIM,1848,62,na,1910,1323
STAT,1862,19,40-44,1881,0.15180931088028918
SIM,1867,28,na,1895,2070
STAT,1851,43,20-24,1894,0.1156189240915026
SIM,1863,14,na,1877,2314
SIM,1946,21,30-34,1967,34
STAT,1846,25,35-39,1871,8.34965314037998
STAT,1906,29,20-24,1935,16.02255015689749
STAT,1802,67,na,1869,734.3289486744401
STAT,1836,25,25-29,1861,35.067193837366155
STAT,1875,51,45-49,1926,0.014152240278475338
STAT,1910,46,40-44,1956,0.1392682955062429
STAT,1926,15,30-34,1941,14.184801568138585
STAT,1824,33,35-39,1857,20.499648406631263
STAT,1838,66,na,1904,1117.844776320849
STAT,1924,44,15-19,1968,0.0017200424266851694
STAT,1922,20,40-44,1942,3.6645971991554576
SIM,1822,33,25-29,1855,15
SIM,1827,63,na,1890,909
STAT,1813,51,50-100,1864,0.04448597004647705
STAT,1834,32,15-19,1866,0.11291255084307847
SIM,1832,33,35-39,1865,12
SIM,1885,17,15-19,1902,5
SIM,1851,29,na,1880,1867
SIM,1860,31,20-24,1891,3
STAT,1843,81,na,1924,390.1374654006822
STAT,1869,27,na,1896,2182.324659229419
STAT,1921,19,45-49,1940,0.5350796184942525
STAT,1947,25,50-100,1972,1.0647793089219637
SIM,1909,35,25-29,1944,1
STAT,1842,50,40-44,1892,0.007604604899828961
STAT,1830,38,40-44,1868,3.427408223800077
STAT,1832,50,30-34,1882,0.0039056133664533534
STAT,1843,18,30-34,1861,1.4608450036811962
SIM,1914,29,20-24,1943,25
STAT,1854,42,30-34,1896,0.8268502141539473
STAT,1902,47,45-49,1949,0.17664616236133693
SIM,1851,18,30-34,1869,1
SIM,1931,24,na,1955,4422
SIM,1814,42,30-34,1856,6
SIM,1942,3,na,1945,3812
STAT,1834,50,45-49,1884,0.009582972711877233
STAT,1919,20,20-24,1939,115.71205171202222
STAT,1883,46,na,1929,2088.967755307354
STAT,1910,39,50-100,1949,0.37541054855486716
SIM,1845,20,15-19,1865,2
STAT,1849,54,20-24,1903,5.172590246987556E-4
STAT,1912,43,50-100,1955,0.1063720902267577
SIM,1876,32,45-49,1908,1
STAT,1873,33,30-34,1906,16.671616033246092
STAT,1911,39,35-39,1950,2.1842868832380744
STAT,1817,66,na,1883,812.5473156473561
STAT,1868,27,15-19,1895,0.4092292709415485
STAT,1901,39,25-29,1940,0.8134640634288979
STAT,1868,32,45-49,1900,1.5728875678645913
STAT,1930,18,50-100,1948,0.4564075393794793
SIM,1906,29,25-29,1935,63
STAT,1814,52,na,1866,1174.1652320900632
STAT,1870,19,50-100,1889,0.04524456741037071
SIM,1880,47,na,1927,2322
STAT,1850,23,35-39,1873,4.895463388291206
SIM,1878,23,30-34,1901,22
STAT,1840,23,25-29,1863,50.33469163339036
SIM,1925,33,50-100,1958,4
STAT,1767,105,na,1872,0.014391236531744137
STAT,1849,101,na,1950,0.4113002518292346
SIM,1916,10,na,1926,3884
STAT,1828,52,30-34,1880,0.004841477610308704
STAT,1891,24,35-39,1915,6.780750005556772
STAT,1803,53,na,1856,1101.3287955955489
STAT,1881,24,25-29,1905,51.8893571523278
SIM,1870,15,25-29,1885,7
SIM,1922,21,45-49,1943,2
STAT,1807,67,na,1874,775.203586857873
SIM,1921,24,35-39,1945,15
STAT,1917,33,50-100,1950,0.8144131884287904
SIM,1836,27,40-44,1863,1
STAT,1913,47,20-24,1960,0.01018750145092092
STAT,1821,34,na,1855,1505.0481584933143
STAT,1849,27,50-100,1876,0.5465723045859167
STAT,1901,31,15-19,1932,0.18907333776628282
STAT,1914,37,50-100,1951,0.3959457459095545
STAT,1850,41,35-39,1891,1.2805853426624474
SIM,1901,58,na,1959,2690
STAT,1808,48,20-24,1856,0.044929025043709755
STAT,1901,35,30-34,1936,1.5355288450435836
STAT,1903,28,40-44,1931,4.011964898627196
SIM,1945,23,na,1968,3642
STAT,1873,54,35-39,1927,0.00802828328082932
STAT,1847,32,25-29,1879,8.848685076204854
STAT,1895,43,30-34,1938,0.0977099952398256
SIM,1836,34,30-34,1870,20
STAT,1913,24,35-39,1937,8.924073519213982
STAT,1869,24,25-29,1893,52.01978913929669
STAT,1925,21,20-24,1946,126.13320483712013
STAT,1856,18,40-44,1874,0.15907505299783228
STAT,1851,36,30-34,1887,3.9913506384629773
SIM,1933,21,20-24,1954,138
STAT,1893,32,20-24,1925,3.2399295008317854
STAT,1895,25,30-34,1920,31.25485496258416
SIM,1911,28,40-44,1939,6
SIM,1918,19,40-44,1937,1
SIM,1855,32,25-29,1887,17
STAT,1810,45,25-29,1855,0.21182681387149366
STAT,1852,36,15-19,1888,0.04334392672003341
SIM,1876,25,25-29,1901,50
STAT,1828,34,30-34,1862,17.524363321798926
SIM,1854,42,35-39,1896,4
SIM,1881,33,30-34,1914,22
STAT,1826,41,20-24,1867,0.15940497209706136
SIM,1885,0,na,1885,3175
STAT,1910,47,40-44,1957,0.1389229101333873
SIM,1947,0,na,1947,4220
STAT,1891,42,35-39,1933,2.1147898690599343
SIM,1916,16,25-29,1932,15
SIM,1937,32,45-49,1969,1
STAT,1892,47,25-29,1939,0.03825810939840343
STAT,1821,52,25-29,1873,0.005199516773861768
SIM,1831,30,na,1861,1705
STAT,1846,42,35-39,1888,1.2922114221798928
STAT,1887,26,50-100,1913,0.6781520645660081
SIM,1944,27,40-44,1971,6
STAT,1870,76,na,1946,876.9826594975161
STAT,1832,25,40-44,1857,2.5333803978735463
STAT,1822,39,45-49,1861,3.2542513974707803
STAT,1830,48,na,1878,1424.128790758594
STAT,1859,23,50-100,1882,0.3166924451856022
STAT,1918,39,40-44,1957,1.4873847636821693
STAT,1934,21,50-100,1955,0.8356198900701738
SIM,1844,29,40-44,1873,2
SIM,1830,39,45-49,1869,1
SIM,1908,25,30-34,1933,48
STAT,1896,35,25-29,1931,3.6289103836833143
SIM,1869,94,na,1963,35
STAT,1859,39,40-44,1898,3.267090696729498
STAT,1828,27,40-44,1855,5.3030493924517375
STAT,1906,28,20-24,1934,16.08108530741649
SIM,1914,28,20-24,1942,19
STAT,1815,41,45-49,1856,4.428765442644132
STAT,1829,51,na,1880,1420.8160771548758
STAT,1874,16,35-39,1890,0.5310971673483572
STAT,1883,51,40-44,1934,0.00979384110083464
STAT,1829,44,25-29,1873,0.5239731420620644
STAT,1882,32,45-49,1914,1.6030086731394289
STAT,1813,67,na,1880,793.786749080745
STAT,1836,29,40-44,1865,2.412718844061939
STAT,1860,51,20-24,1911,5.692554482353244E-4
SIM,1824,82,na,1906,236
STAT,1844,99,na,1943,1.3295120390735962
STAT,1897,38,na,1935,2961.8139324810836
STAT,1921,26,35-39,1947,15.86284191403308
SIM,1886,21,15-19,1907,2
STAT,1805,104,na,1909,0.022333072666241918
SIM,1839,81,na,1920,371
STAT,1834,38,20-24,1872,0.5873792328554305
STAT,1912,17,na,1929,3688.6689743588013
SIM,1898,24,45-49,1922,1
STAT,1936,27,40-44,1963,4.213248123658364
STAT,1887,44,35-39,1931,1.8872949555749456
SIM,1831,43,45-49,1874,4
STAT,1845,49,40-44,1894,0.11807225743469242
SIM,1859,36,25-29,1895,2
SIM,1879,57,na,1936,1965
STAT,1824,51,35-39,1875,0.009936681907304413
STAT,1895,18,40-44,1913,0.22489208627571636
STAT,1867,42,20-24,1909,0.14069380512539525
STAT,1893,37,15-19,1930,0.06730775707410087
STAT,1867,47,15-19,1914,3.53145798737097E-4
SIM,1965,4,na,1969,4562
STAT,1862,15,25-29,1877,5.292132182963461
STAT,1838,108,na,1946,0.0012492800397351888
STAT,1890,34,45-49,1924,1.9969172908087276
STAT,1830,52,na,1882,1334.8061267967082
STAT,1860,28,20-24,1888,9.038078962074582
STAT,1808,52,na,1860,1215.1000166193514
STAT,1843,44,25-29,1887,0.46493971449736526
STAT,1839,41,30-34,1880,0.8992803868785737
SIM,1846,66,na,1912,1127
STAT,1769,85,na,1854,69.0
STAT,1842,33,na,1875,1845.1192331798206
STAT,1929,32,45-49,1961,1.8883542148836348
STAT,1857,45,15-19,1902,3.008699955351646E-4
STAT,1823,43,45-49,1866,1.8848779870087402
STAT,1907,40,45-49,1947,0.1456541440107148
SIM,1878,13,na,1891,2611
STAT,1838,51,40-44,1889,0.007284898686993039
STAT,1841,108,na,1949,0.0012532498614719763
STAT,1870,52,50-100,1922,0.013905730917533743
SIM,1896,37,40-44,1933,10
STAT,1908,16,25-29,1924,7.9587605723756205
STAT,1949,19,15-19,1968,49.83375794996801
STAT,1822,50,50-100,1872,0.021098250530829227
STAT,1826,46,15-19,1872,3.790527797730833E-4
STAT,1894,15,25-29,1909,6.9183180946281935
STAT,1850,99,na,1949,1.3332867749947925
SIM,1767,93,na,1860,4
STAT,1821,93,na,1914,15.781674072753821
SIM,1818,39,40-44,1857,3
SIM,1863,34,25-29,1897,14
STAT,1843,18,na,1861,2103.8645466749763
SIM,1862,24,30-34,1886,12
SIM,1835,24,25-29,1859,51
STAT,1846,43,35-39,1889,1.2757615707755425
STAT,1884,19,30-34,1903,1.4799609148831432
STAT,1861,53,50-100,1914,0.011657526079422555
STAT,1827,31,45-49,1858,2.1214175600982657
STAT,1848,26,35-39,1874,8.358571099765395
SIM,1828,35,35-39,1863,10
SIM,1854,43,35-39,1897,1
STAT,1831,96,na,1927,5.23670230524821
STAT,1762,97,na,1859,0.17195930486680328
STAT,1833,48,30-34,1881,0.06198631243520004
SIM,1907,31,20-24,1938,1
STAT,1882,61,na,1943,1717.7433811296457
STAT,1939,15,40-44,1954,1.325758097186682
STAT,1905,38,50-100,1943,0.3599684158470261
STAT,1854,24,30-34,1878,14.855074330041717
SIM,1907,43,na,1950,3229
STAT,1865,52,35-39,1917,0.007351059483492293
SIM,1891,10,na,1901,3188
SIM,1900,11,na,1911,3364
SIM,1904,21,30-34,1925,34
STAT,1812,54,50-100,1866,0.04566256894761704
STAT,1888,44,30-34,1932,1.2657227728766947
SIM,1892,19,30-34,1911,1
SIM,1861,44,na,1905,1967
SIM,1866,28,na,1894,2093
STAT,1844,66,na,1910,1150.600168661827
SIM,1850,44,na,1894,1686
STAT,1894,22,45-49,1916,0.8473993048159083
SIM,1925,24,na,1949,3987
STAT,1849,23,45-49,1872,0.6033231106136762
STAT,1864,44,45-49,1908,1.2465727872867705
SIM,1921,10,na,1931,4194
SIM,1904,25,na,1929,3179
STAT,1927,22,20-24,1949,129.43530912025523
SIM,1895,26,35-39,1921,12
SIM,1936,35,35-39,1971,5
STAT,1841,31,45-49,1872,1.4627064503308707
SIM,1873,34,35-39,1907,9
SIM,1947,15,40-44,1962,1
SIM,1863,38,40-44,1901,3
SIM,1935,22,20-24,1957,115
STAT,1854,17,40-44,1871,0.15755351650539418
SIM,1845,81,na,1926,369
STAT,1848,19,45-49,1867,0.05765248366415353
STAT,1875,33,15-19,1908,0.13762880729142266
SIM,1869,49,50-100,1918,2
STAT,1887,26,35-39,1913,10.229042678504298
SIM,1897,42,na,1939,2973
SIM,1926,39,40-44,1965,1
STAT,1846,50,25-29,1896,0.0025332640669331113
SIM,1835,31,45-49,1866,2
SIM,1845,29,na,1874,1838
STAT,1930,0,na,1930,5502.600847978994
SIM,1840,25,40-44,1865,2
STAT,1916,42,15-19,1958,0.0014866461385493895
STAT,1861,62,na,1923,1433.8124194004172
STAT,1928,35,35-39,1963,2.8930214399380945
SIM,1912,34,35-39,1946,9
STAT,1909,47,30-34,1956,0.07736472959014061
STAT,1833,29,na,1862,1705.5905401895736
STAT,1942,21,50-100,1963,0.6519293887025868
SIM,1821,41,30-34,1862,4
SIM,1930,23,45-49,1953,1
SIM,1933,24,25-29,1957,136
STAT,1828,37,35-39,1865,6.716942117793911
SIM,1830,32,25-29,1862,11
SIM,1895,19,na,1914,3140
SIM,1901,20,15-19,1921,4
STAT,1814,48,50-100,1862,0.6555294320650898
STAT,1871,68,na,1939,1431.2234058695396
SIM,1878,43,35-39,1921,3
SIM,1924,24,15-19,1948,5
STAT,1859,32,20-24,1891,2.037902334154603
SIM,1846,44,50-100,1890,4
SIM,1884,31,na,1915,2344
STAT,1900,60,na,1960,2605.283885391266
STAT,1901,23,50-100,1924,0.5375497603950598
SIM,1834,82,na,1916,265
STAT,1906,20,25-29,1926,79.21743490581856
STAT,1788,102,na,1890,0.08598649435264621
STAT,1880,32,30-34,1912,17.354931561384678
SIM,1858,34,20-24,1892,5
SIM,1835,38,50-100,1873,3
SIM,1937,26,35-39,1963,20
SIM,1851,22,15-19,1873,5
STAT,1852,47,50-100,1899,0.18573014898101783
STAT,1874,22,45-49,1896,0.6732859659845133
STAT,1853,43,na,1896,1701.6517144924837
STAT,1839,34,45-49,1873,1.4014666736765489
STAT,1886,39,35-39,1925,6.988601468175854
STAT,1898,17,na,1915,3229.813143524582
SIM,1892,41,45-49,1933,3
STAT,1916,24,15-19,1940,5.2363159912703106
SIM,1910,25,na,1935,3358
STAT,1829,104,na,1933,0.040883699722005985
STAT,1834,48,15-19,1882,2.5923946350293496E-4
STAT,1918,47,40-44,1965,0.15849474904267358
SIM,1795,84,na,1879,95
SIM,1886,32,na,1918,2322
SIM,1917,45,50-100,1962,1
STAT,1853,21,45-49,1874,0.6154405298430667
STAT,1920,28,40-44,1948,4.813507132737985
SIM,1915,33,20-24,1948,4
STAT,1836,45,30-34,1881,0.06563212936617385
STAT,1949,21,45-49,1970,1.2408340360757573
STAT,1819,48,35-39,1867,0.24525538144308104
STAT,1907,33,20-24,1940,2.1443949358239673
STAT,1856,31,40-44,1887,3.281897780206896
STAT,1840,21,35-39,1861,5.205479829382382
STAT,1931,15,50-100,1946,0.4654285354360502
STAT,1951,21,15-19,1972,6.010408011039086
STAT,1868,48,30-34,1916,0.08621430644176911
STAT,1845,45,25-29,1890,0.04097685428742707
STAT,1847,24,25-29,1871,50.89701106514602
STAT,1904,34,35-39,1938,7.810794047867783
SIM,1867,99,na,1966,10
STAT,1908,18,30-34,1926,2.227209710998834
SIM,1929,22,50-100,1951,4
STAT,1813,41,30-34,1854,4.248857558349397
STAT,1922,23,45-49,1945,1.2152730713165005
STAT,1925,24,25-29,1949,103.80951477351154
SIM,1864,22,25-29,1886,59
SIM,1872,46,na,1918,2111
SIM,1899,28,30-34,1927,31
STAT,1875,25,15-19,1900,0.4433229469074888
STAT,1895,28,35-39,1923,11.853325836765965
SIM,1822,87,na,1909,75
STAT,1894,38,30-34,1932,6.4444869238760925
STAT,1864,21,20-24,1885,59.54674579399935
STAT,1869,35,50-100,1904,1.133355509091953
STAT,1917,18,40-44,1935,0.28358805086258354
STAT,1812,57,na,1869,1105.2275457710564
SIM,1802,71,na,1873,600
SIM,1872,21,20-24,1893,69
SIM,1925,18,40-44,1943,1
SIM,1797,85,na,1882,84
STAT,1872,33,35-39,1905,9.561984758221996
STAT,1825,54,50-100,1879,0.014670613959504633
STAT,1948,15,na,1963,3981.7316513578394
SIM,1865,74,na,1939,925
SIM,1903,36,35-39,1939,8
SIM,1920,33,30-34,1953,25
STAT,1871,32,20-24,1903,2.5315319674203156
STAT,1855,44,na,1899,1614.8098889421158
STAT,1856,22,25-29,1878,49.1921651464523
STAT,1923,33,na,1956,4093.7782911708946
STAT,1921,31,30-34,1952,16.632464819056835
SIM,1855,24,25-29,1879,61
STAT,1848,32,45-49,1880,1.465058193919962
STAT,1849,21,40-44,1870,1.8290842143550547
STAT,1907,26,15-19,1933,0.6316575900905201
STAT,1857,28,15-19,1885,0.3455385324945254
SIM,1879,84,na,1963,555
STAT,1827,47,30-34,1874,0.0848093221609029
STAT,1925,31,15-19,1956,0.1442605223362201
STAT,1851,42,45-49,1893,1.0961596269324247
STAT,1865,24,45-49,1889,0.5972194113140427
STAT,1822,51,na,1873,1271.1796297214614
STAT,1845,52,30-34,1897,0.004170544056522681
SIM,1924,45,na,1969,4113
STAT,1845,38,35-39,1883,5.180504283315969
STAT,1889,30,25-29,1919,12.041683619660294
STAT,1913,39,na,1952,3471.3295845686807
SIM,1835,21,20-24,1856,63
STAT,1880,30,20-24,1910,2.7084332995412312
SIM,1764,92,na,1856,4
SIM,1882,76,na,1958,901
SIM,1939,30,40-44,1969,3
SIM,1899,35,20-24,1934,4
STAT,1901,15,25-29,1916,7.527854858486412
STAT,1952,20,na,1972,4150.850273225386
STAT,1845,14,na,1859,2106.047476185759
SIM,1873,93,na,1966,73
SIM,1894,61,na,1955,2408
STAT,1884,41,45-49,1925,1.4034949293874985
SIM,1853,38,35-39,1891,15
SIM,1897,30,25-29,1927,21
SIM,1889,22,30-34,1911,26
STAT,1817,50,45-49,1867,0.03236938887114282
STAT,1903,19,na,1922,3376.2941252407386
STAT,1850,8,na,1858,2112.543559788907
STAT,1913,41,35-39,1954,0.18653546986769276
SIM,1968,1,na,1969,4483
STAT,1843,22,15-19,1865,2.9875109254944032
STAT,1903,5,na,1908,3522.2247915810626
SIM,1836,37,35-39,1873,10
STAT,1930,24,35-39,1954,11.324548133018073
SIM,1873,24,45-49,1897,3
STAT,1955,16,50-100,1971,0.4699488749803462
STAT,1831,28,50-100,1859,0.5478382188275419
SIM,1854,31,na,1885,1928
STAT,1866,50,40-44,1916,0.009301236373957852
STAT,1831,32,35-39,1863,8.309224117800401
STAT,1902,39,45-49,1941,0.5678491886994207
STAT,1851,36,50-100,1887,0.9194634289246301
STAT,1896,33,35-39,1929,12.59061055601428
STAT,1849,53,45-49,1902,0.01029246176332385
STAT,1932,1,na,1933,5224.038243631737
SIM,1867,32,20-24,1899,2
STAT,1830,31,20-24,1861,2.298444794464863
STAT,1930,39,20-24,1969,0.32415219248547206
SIM,1929,31,25-29,1960,12
STAT,1844,105,na,1949,0.02058338023634066
STAT,1884,49,40-44,1933,0.15648503842886033
STAT,1875,49,15-19,1924,3.801092517130115E-4
SIM,1856,32,45-49,1888,1
STAT,1920,26,30-34,1946,40.74654297518683
STAT,1911,38,na,1949,3415.031081941901
STAT,1946,23,30-34,1969,30.20534324728693
SIM,1857,21,40-44,1878,4
SIM,1945,3,na,1948,3992
STAT,1878,51,30-34,1929,0.005882059231909694
STAT,1917,39,na,1956,3668.9744933422785
STAT,1798,82,na,1880,167.50239673248996
STAT,1932,18,20-24,1950,169.15265548565665
SIM,1853,79,na,1932,534
SIM,1874,47,na,1921,2138
SIM,1947,18,na,1965,3747
STAT,1803,84,na,1887,109.80960556264071
STAT,1929,26,35-39,1955,17.75971661885987
STAT,1824,52,na,1876,1267.9747417807453
STAT,1862,35,30-34,1897,4.335563409125349
SIM,1940,18,20-24,1958,109
STAT,1903,29,35-39,1932,12.875790626132982
SIM,1932,19,25-29,1951,61
STAT,1855,108,na,1963,0.006614070695700669
STAT,1819,99,na,1918,0.9457725526750186
STAT,1828,50,20-24,1878,6.244656351218349E-4
SIM,1943,16,35-39,1959,6
STAT,1879,32,20-24,1911,2.669086921345261
SIM,1902,38,40-44,1940,4
STAT,1907,39,na,1946,3261.4752019065922
SIM,1847,79,na,1926,450
SIM,1888,35,45-49,1923,6
STAT,1914,15,35-39,1929,0.8236624004949272
SIM,1884,47,na,1931,2205
STAT,1845,50,20-24,1895,5.272460598443936E-4
STAT,1950,16,15-19,1966,50.711831990261906
SIM,1888,23,25-29,1911,64
SIM,1838,32,25-29,1870,12
STAT,1886,46,25-29,1932,0.057655180978069355
SIM,1950,16,25-29,1966,57
STAT,1825,52,45-49,1877,0.014668545445883745
SIM,1884,17,30-34,1901,1
SIM,1768,88,na,1856,33
SIM,1865,64,na,1929,1469
SIM,1887,32,20-24,1919,2
STAT,1803,74,na,1877,452.0488861788868
STAT,1880,17,35-39,1897,0.5454160230232915
SIM,1851,40,45-49,1891,2
SIM,1885,19,na,1904,2379
STAT,1897,23,25-29,1920,72.10150118474826
SIM,1843,23,20-24,1866,56
STAT,1808,52,45-49,1860,0.05278281470631721
STAT,1849,43,15-19,1892,0.009882093062527861
STAT,1835,23,20-24,1858,56.744002500179114
SIM,1911,26,30-34,1937,45
STAT,1837,50,30-34,1887,0.003923719081398476
STAT,1874,11,na,1885,2535.692764108571
STAT,1935,16,35-39,1951,5.432158034791033
STAT,1861,43,15-19,1904,0.010755230295147656
STAT,1829,42,35-39,1871,1.523484079098583
STAT,1910,60,na,1970,3014.4570215223057
STAT,1922,37,20-24,1959,0.2833846323614473
STAT,1917,25,30-34,1942,39.08051836183433
STAT,1926,39,30-34,1965,2.099994974192892
STAT,1889,43,50-100,1932,1.2232097713965155
STAT,1942,16,25-29,1958,42.79211885378196
SIM,1892,66,na,1958,2043
STAT,1889,30,40-44,1919,5.098446289842391
SIM,1922,15,35-39,1937,8
STAT,1913,39,20-24,1952,0.24322877098806894
STAT,1899,34,15-19,1933,0.1827844514865052
SIM,1842,42,45-49,1884,1
SIM,1837,42,35-39,1879,3
STAT,1848,23,30-34,1871,15.512560363663399
STAT,1907,19,25-29,1926,7.820234525741129
STAT,1835,85,na,1920,171.04063239830313
STAT,1878,72,na,1950,1241.997182965973
STAT,1962,10,na,1972,4754.6709615062355
STAT,1880,11,na,1891,2570.8405497573312
STAT,1895,41,20-24,1936,0.0136572065456138
STAT,1948,16,45-49,1964,0.540252983182684
STAT,1938,31,25-29,1969,8.78357075033965
SIM,1916,18,15-19,1934,8
STAT,1772,112,na,1884,6.537411829176595E-4
STAT,1903,36,40-44,1939,1.27601573156654
STAT,1777,90,na,1867,26.75628437548145
STAT,1908,18,15-19,1926,8.29270500209557
SIM,1907,34,25-29,1941,9
SIM,1911,36,40-44,1947,2
STAT,1843,40,45-49,1883,1.1405886330815447
STAT,1912,33,30-34,1945,14.580347769431837
SIM,1880,33,35-39,1913,11
STAT,1787,102,na,1889,0.08537258783467144
STAT,1858,42,na,1900,1711.973535994001
STAT,1854,43,25-29,1897,0.4590732000573898
SIM,1915,19,25-29,1934,8
SIM,1892,76,na,1968,1438
STAT,1933,23,20-24,1956,139.29207397610332
SIM,1931,29,20-24,1960,21
STAT,1854,27,35-39,1881,7.283913410289502
SIM,1836,77,na,1913,531
SIM,1852,21,20-24,1873,60
SIM,1896,22,20-24,1918,90
STAT,1848,16,40-44,1864,0.16431334273115306
STAT,1937,34,45-49,1971,1.4686182663316856
STAT,1860,38,15-19,1898,0.04289936650453268
STAT,1912,26,40-44,1938,4.353109123703346
STAT,1870,33,15-19,1903,0.13126614839783074
SIM,1840,82,na,1922,269
SIM,1916,18,30-34,1934,4
STAT,1834,102,na,1936,0.18146253131869994
STAT,1924,26,15-19,1950,0.7792449990993673
SIM,1834,72,na,1906,753
SIM,1813,42,35-39,1855,1
SIM,1898,22,40-44,1920,2
SIM,1941,23,20-24,1964,106
STAT,1881,22,35-39,1903,5.322798001220063
STAT,1844,47,30-34,1891,0.06763768141843261
STAT,1851,24,15-19,1875,2.847693196142243
STAT,1858,33,15-19,1891,0.10516805831127991
SIM,1951,15,30-34,1966,16
STAT,1909,26,35-39,1935,13.713188275517103
SIM,1946,24,35-39,1970,9
SIM,1894,39,35-39,1933,14
STAT,1830,27,35-39,1857,9.388952208782618
SIM,1846,31,20-24,1877,2
STAT,1843,48,40-44,1891,0.1219612149845293
STAT,1904,49,20-24,1953,0.00897931786512582
STAT,1801,89,na,1890,39.974924717576705
STAT,1862,16,na,1878,2131.0768177593245
STAT,1919,24,na,1943,3753.9671612691295
STAT,1844,21,20-24,1865,60.838914651977426
SIM,1883,43,45-49,1926,1
STAT,1873,25,50-100,1898,0.6175679085044824
SIM,1857,45,na,1902,1806
SIM,1920,26,40-44,1946,8
STAT,1924,19,25-29,1943,48.49409765776299
STAT,1923,29,20-24,1952,19.65865040546444
STAT,1872,40,25-29,1912,0.6150387479746964
STAT,1869,51,20-24,1920,6.780092062203152E-4
STAT,1892,43,45-49,1935,1.7577455352053337
SIM,1836,49,50-100,1885,1
STAT,1869,53,30-34,1922,0.005355833372401537
STAT,1878,62,na,1940,1797.486803502314
SIM,1884,24,20-24,1908,66
STAT,1910,20,15-19,1930,4.749270049753193
SIM,1859,64,na,1923,1452
SIM,1897,30,40-44,1927,7
STAT,1830,41,30-34,1871,0.8866032852888399
STAT,1876,24,20-24,1900,66.78655241978494
STAT,1875,43,45-49,1918,1.4420533294925577
STAT,1938,24,35-39,1962,8.796529279103831
SIM,1917,26,35-39,1943,20
STAT,1862,26,na,1888,1944.1997026860715
SIM,1879,33,25-29,1912,12
SIM,1861,37,30-34,1898,4
SIM,1847,34,45-49,1881,1
STAT,1933,16,15-19,1949,57.53358281469204
SIM,1842,24,15-19,1866,3
SIM,1862,27,35-39,1889,11
STAT,1834,66,na,1900,1014.4757937525811
STAT,1838,31,20-24,1869,2.3147630419142886
STAT,1820,42,15-19,1862,0.024912089438610195
STAT,1834,24,15-19,1858,2.6920061116857203
SIM,1941,16,15-19,1957,34
STAT,1943,15,30-34,1958,12.21644389414219
STAT,1851,4,na,1855,2376.4246000000003
STAT,1798,88,na,1886,47.06285483237144
STAT,1893,79,na,1972,1304.989684392622
STAT,1947,21,25-29,1968,98.65911684007855
SIM,1926,40,na,1966,4208
STAT,1853,37,30-34,1890,3.9524566288343173
STAT,1830,86,na,1916,132.53806574197282
STAT,1864,11,na,1875,2301.72752572045
STAT,1839,31,40-44,1870,3.5955918714907162
STAT,1933,23,na,1956,4574.557941780025
STAT,1907,36,25-29,1943,0.866390594212262
STAT,1858,48,na,1906,1647.583176801415
STAT,1836,48,35-39,1884,0.09134336245288294
STAT,1860,52,na,1912,1644.314942892388
SIM,1872,24,25-29,1896,47
STAT,1825,34,15-19,1859,0.20898069768406352
STAT,1860,32,45-49,1892,1.338836357150993
STAT,1873,6,na,1879,2628.842581201304
STAT,1818,76,na,1894,456.76558478806356
SIM,1875,64,na,1939,1642
STAT,1863,33,25-29,1896,8.469704141239836
STAT,1889,24,30-34,1913,20.643918514704154
STAT,1845,42,20-24,1887,0.11391413856362387
STAT,1910,8,na,1918,3720.106594602068
SIM,1840,72,na,1912,810
STAT,1903,43,30-34,1946,0.10652618922605778
SIM,1916,20,na,1936,3542
STAT,1806,98,na,1904,1.0809472575214456
SIM,1839,26,na,1865,1878
STAT,1853,45,30-34,1898,0.07250333022179847
STAT,1817,48,15-19,1865,8.809165128331874E-4
SIM,1838,24,25-29,1862,52
STAT,1867,25,na,1892,2131.208650119687
STAT,1946,20,na,1966,3841.7397077266737
STAT,1809,99,na,1908,0.7955803541822013
STAT,1873,20,50-100,1893,0.3933667481933944
STAT,1897,15,25-29,1912,7.192695561830827
STAT,1862,42,50-100,1904,0.8502807733674251
STAT,1892,25,15-19,1917,0.5403745580303321
STAT,1793,89,na,1882,37.470782913727874
STAT,1849,35,15-19,1884,0.04228646418479091
SIM,1847,31,40-44,1878,7
STAT,1859,35,25-29,1894,2.191312798976638
SIM,1861,13,na,1874,2361
STAT,1927,44,30-34,1971,0.15098241942177248
STAT,1911,34,25-29,1945,8.427697450186484
SIM,1837,25,na,1862,1775
STAT,1878,54,35-39,1932,0.008233775051610076
SIM,1913,23,45-49,1936,1
SIM,1914,55,na,1969,3600
STAT,1871,35,25-29,1906,2.7221021872610525
SIM,1907,24,15-19,1931,4
SIM,1816,53,na,1869,1161
SIM,1918,21,na,1939,3712
SIM,1844,21,45-49,1865,3
STAT,1892,34,50-100,1926,1.0746445770757838
STAT,1940,29,20-24,1969,17.565371460210258
STAT,1915,18,20-24,1933,26.733151053978805
STAT,1893,39,40-44,1932,5.194136810593565
SIM,1892,15,15-19,1907,5
STAT,1884,39,15-19,1923,0.05189490456761939
SIM,1897,24,30-34,1921,34
STAT,1946,26,35-39,1972,15.806688950628192
SIM,1906,26,na,1932,3351
SIM,1848,31,40-44,1879,6
STAT,1905,23,45-49,1928,0.949010792440047
STAT,1862,19,50-100,1881,0.04066319838323075
STAT,1912,19,35-39,1931,0.7970966006316323
STAT,1868,42,na,1910,2082.118594369285
SIM,1814,52,na,1866,1206
SIM,1920,19,35-39,1939,5
STAT,1883,25,na,1908,2224.5940533579014
SIM,1874,21,40-44,1895,7
SIM,1937,23,30-34,1960,26
STAT,1852,16,30-34,1868,1.4733097040143783
STAT,1888,22,20-24,1910,76.90704302191885
SIM,1873,21,40-44,1894,6
STAT,1890,65,na,1955,1951.952357066756
SIM,1860,16,30-34,1876,1
STAT,1897,30,15-19,1927,0.18136626633754183
STAT,1773,112,na,1885,5.371501857373269E-4
STAT,1922,41,50-100,1963,0.127578307167381
SIM,1860,65,na,1925,1377
STAT,1857,22,45-49,1879,0.599537529386822
SIM,1845,27,35-39,1872,11
SIM,1864,34,45-49,1898,1
STAT,1827,54,50-100,1881,0.011171883675270016
SIM,1929,24,35-39,1953,17
STAT,1820,45,50-100,1865,0.4170246062835317
STAT,1847,70,na,1917,1032.3661464010038
STAT,1906,27,50-100,1933,0.879966645223666
STAT,1920,18,30-34,1938,12.885599995737161
STAT,1866,53,45-49,1919,0.012437202274505094
STAT,1923,39,na,1962,4109.7131930310825
STAT,1848,96,na,1944,6.186030157668637
SIM,1804,68,na,1872,683
STAT,1856,34,45-49,1890,1.2791970083818465
STAT,1836,21,45-49,1857,0.58535533625
STAT,1834,42,45-49,1876,1.1168246567445146
STAT,1883,18,15-19,1901,5.4802095179488
SIM,1923,18,20-24,1941,144
STAT,1866,21,40-44,1887,1.8430270388834238
STAT,1900,66,na,1966,2396.54478491872
SIM,1903,33,30-34,1936,20
SIM,1861,9,na,1870,2408
SIM,1890,47,na,1937,2670
SIM,1853,35,30-34,1888,4
STAT,1849,7,na,1856,2196.0222412238995
STAT,1865,32,45-49,1897,1.496975152984588
STAT,1855,32,35-39,1887,7.302942945344033
STAT,1918,15,20-24,1933,28.097905228115533
SIM,1830,42,35-39,1872,7
SIM,1855,46,50-100,1901,1
SIM,1829,31,20-24,1860,2
STAT,1879,10,na,1889,2574.115899745849
STAT,1830,34,25-29,1864,8.29616930629497
STAT,1837,43,25-29,1880,0.47225773310112384
SIM,1928,28,50-100,1956,1
STAT,1866,77,na,1943,752.8760812481775
STAT,1826,48,40-44,1874,0.15794061157371628
STAT,1865,21,40-44,1886,1.8236737122650843
STAT,1872,1,na,1873,3318.659082116036
STAT,1898,23,45-49,1921,0.8889980900562657
SIM,1946,16,35-39,1962,6
SIM,1941,26,25-29,1967,57
STAT,1881,82,na,1963,643.5596337777104
SIM,1891,18,15-19,1909,9
STAT,1849,44,na,1893,1643.433625086645
STAT,1933,26,25-29,1959,82.60018668729663
SIM,1841,20,na,1861,1906
STAT,1929,23,30-34,1952,34.23142602395763
SIM,1856,23,30-34,1879,18
STAT,1914,56,na,1970,3313.160904264452
STAT,1867,49,40-44,1916,0.14868387659661916
STAT,1912,6,na,1918,3815.3697853269255
STAT,1843,43,na,1886,1694.979541486129
STAT,1866,35,15-19,1901,0.04937451182147597
STAT,1887,83,na,1970,790.0283290826075
SIM,1785,84,na,1869,72
SIM,1926,15,20-24,1941,154
STAT,1921,38,na,1959,3964.800540222681
SIM,1842,46,50-100,1888,4
STAT,1839,44,na,1883,1583.130962637937
STAT,1822,42,35-39,1864,2.7310313206730252
STAT,1864,24,25-29,1888,48.40762962568563
STAT,1927,37,40-44,1964,1.7584639131008017
SIM,1916,20,45-49,1936,1
STAT,1763,108,na,1871,0.0017233548893082842
SIM,1890,48,50-100,1938,4
STAT,1845,105,na,1950,0.02065293374045049
STAT,1904,18,45-49,1922,0.08826856826560026
SIM,1925,25,30-34,1950,50
SIM,1819,37,35-39,1856,14
STAT,1917,49,30-34,1966,0.08744420879623073
SIM,1934,17,na,1951,4669
STAT,1930,20,50-100,1950,0.8011099983679306
SIM,1863,79,na,1942,532
STAT,1783,90,na,1873,24.190311496857284
SIM,1811,54,na,1865,1173
SIM,1899,39,na,1938,3024
STAT,1850,19,15-19,1869,5.045408831842627
STAT,1878,28,35-39,1906,9.455860832434276
STAT,1861,68,na,1929,1198.835307093654
SIM,1836,36,na,1872,1640
SIM,1876,12,na,1888,2590
SIM,1886,28,35-39,1914,15
STAT,1889,17,40-44,1906,0.213314716526906
STAT,1851,78,na,1929,572.9641151987886
STAT,1908,20,45-49,1928,0.9827982185889966
SIM,1801,54,na,1855,1100
STAT,1783,105,na,1888,0.017283327292460564
STAT,1909,39,30-34,1948,1.612893070611306
STAT,1949,7,na,1956,4318.967283799538
SIM,1933,16,25-29,1949,63
STAT,1793,73,na,1866,488.48812382231733
STAT,1905,38,na,1943,3225.5751743588175
SIM,1827,29,40-44,1856,2
STAT,1773,90,na,1863,19.807857569013013
SIM,1820,36,30-34,1856,2
STAT,1902,38,30-34,1940,1.5259704923424826
STAT,1852,23,20-24,1875,61.75203905742769
STAT,1826,47,na,1873,1394.389213386577
STAT,1880,40,30-34,1920,1.1542993564391688
STAT,1867,27,30-34,1894,22.336357201675895
STAT,1926,30,50-100,1956,0.9456231353306638
STAT,1862,57,na,1919,1619.4366878416495
STAT,1796,87,na,1883,62.54419554780259
SIM,1888,32,40-44,1920,6
STAT,1840,53,50-100,1893,0.010348932409222158
STAT,1841,51,35-39,1892,0.0059184283811486126
STAT,1874,8,na,1882,2596.5152955665185
STAT,1945,19,45-49,1964,0.5151601786223399
SIM,1934,30,50-100,1964,1
SIM,1910,38,30-34,1948,4
STAT,1875,82,na,1957,517.9481752282867
STAT,1839,42,45-49,1881,1.051761723962382
STAT,1843,45,50-100,1888,0.18094080745990135
STAT,1905,42,na,1947,3162.2001490035673
STAT,1925,16,25-29,1941,49.58113435635696
STAT,1934,16,15-19,1950,58.13159046200874
SIM,1888,20,20-24,1908,79
STAT,1952,16,35-39,1968,4.751929986623459
SIM,1855,41,40-44,1896,6
STAT,1858,49,15-19,1907,2.904577372683684E-4
STAT,1876,67,na,1943,1545.9922480171876
SIM,1915,16,20-24,1931,28
STAT,1923,23,na,1946,4001.972230051551
SIM,1812,54,50-100,1866,1
SIM,1847,42,45-49,1889,2
SIM,1865,33,na,1898,2014
SIM,1871,33,25-29,1904,12
SIM,1878,26,35-39,1904,10
SIM,1896,32,na,1928,3018
STAT,1886,43,20-24,1929,0.15737004487233652
SIM,1839,32,45-49,1871,2
STAT,1876,43,50-100,1919,1.0228676737860518
STAT,1842,17,15-19,1859,5.4268270535215155
STAT,1898,55,na,1953,2644.2477995974828
SIM,1863,32,35-39,1895,8
SIM,1814,68,na,1882,732
SIM,1887,35,25-29,1922,4
STAT,1908,56,na,1964,3021.052692850016
STAT,1845,35,30-34,1880,4.425408794566673
STAT,1938,16,35-39,1954,3.9194688369033073
STAT,1910,29,25-29,1939,59.59732083355101
SIM,1846,8,na,1854,2188
SIM,1899,27,50-100,1926,1
SIM,1884,43,50-100,1927,1
SIM,1881,33,na,1914,1968
SIM,1910,35,na,1945,3354
SIM,1850,17,15-19,1867,4
STAT,1879,35,25-29,1914,2.8700120875769675
STAT,1943,23,30-34,1966,28.876765304483044
STAT,1819,52,20-24,1871,0.0012602983792421062
STAT,1830,70,na,1900,838.1284464939383
STAT,1878,44,25-29,1922,0.6230064738336989
STAT,1956,15,40-44,1971,1.7491847810479988
SIM,1879,25,25-29,1904,47
STAT,1830,24,30-34,1854,39.69610768030606
STAT,1907,15,45-49,1922,0.0910539160525925
STAT,1911,37,45-49,1948,0.621895352030949
SIM,1917,23,30-34,1940,39
SIM,1861,43,50-100,1904,1
SIM,1938,25,40-44,1963,3
SIM,1886,44,25-29,1930,3
SIM,1890,22,50-100,1912,1
STAT,1912,36,35-39,1948,2.240384405645694
STAT,1895,10,na,1905,3193.353346149119
STAT,1919,45,35-39,1964,0.13272963080619318
STAT,1847,41,40-44,1888,1.6856807187179366
STAT,1929,24,na,1953,4335.536429886495
SIM,1902,28,30-34,1930,36
SIM,1922,20,na,1942,3992
STAT,1891,47,50-100,1938,0.16123918640993914
STAT,1767,90,na,1857,20.142446453566
STAT,1884,23,15-19,1907,3.0702534774030252
SIM,1880,30,30-34,1910,28
STAT,1936,19,50-100,1955,0.3369785487529263
STAT,1908,26,15-19,1934,0.6378326616100435
STAT,1919,29,45-49,1948,1.7508267537680884
STAT,1949,19,30-34,1968,13.384080298730845
STAT,1838,34,25-29,1872,8.502226467779689
STAT,1838,96,na,1934,5.856309245809438
STAT,1847,43,50-100,1890,0.7717101367839858
STAT,1845,15,50-100,1860,0.04413469546784686
STAT,1882,22,50-100,1904,0.37486136214798665
STAT,1877,25,na,1902,2355.421520440497
STAT,1935,37,30-34,1972,2.4074613922009567
SIM,1890,31,na,1921,2856
SIM,1892,23,15-19,1915,4
STAT,1880,17,50-100,1897,0.04869785017595417
SIM,1920,36,35-39,1956,7
STAT,1872,30,30-34,1902,16.688418501441706
STAT,1909,49,40-44,1958,0.1360248784758267
STAT,1781,88,na,1869,40.47222607943919
SIM,1915,36,25-29,1951,4
STAT,1852,26,na,1878,1928.2050524847498
STAT,1928,4,na,1932,4804.917357501425
SIM,1848,21,30-34,1869,20
STAT,1842,71,na,1913,950.5283162961771
STAT,1848,33,40-44,1881,3.28129669197522
STAT,1898,29,15-19,1927,0.5760601796262023
STAT,1909,23,30-34,1932,25.15052542609701
STAT,1874,42,na,1916,2228.8274317988094
STAT,1894,46,30-34,1940,0.06654338390265435
SIM,1849,37,30-34,1886,3
SIM,1908,16,15-19,1924,5
STAT,1912,29,45-49,1941,1.5964655990191465
SIM,1872,50,na,1922,2053
SIM,1894,36,30-34,1930,10
STAT,1858,29,50-100,1887,0.4787073329556619
SIM,1911,30,50-100,1941,5
SIM,1920,29,45-49,1949,2
STAT,1892,40,40-44,1932,2.6877581127275807
STAT,1917,23,na,1940,3655.0419161981094
STAT,1844,24,25-29,1868,49.45807882583572
STAT,1876,37,15-19,1913,0.05476503950297494
STAT,1819,45,30-34,1864,0.1773448017464638
SIM,1852,24,25-29,1876,49
STAT,1858,51,45-49,1909,0.01081433211646161
STAT,1896,32,50-100,1928,1.1439620847443275
SIM,1846,34,25-29,1880,14
STAT,1837,59,na,1896,1226.8267210977588
STAT,1787,89,na,1876,36.33621830414252
STAT,1837,53,35-39,1890,0.005347455798777017
SIM,1856,33,40-44,1889,7
STAT,1873,25,na,1898,2303.9826515660875
STAT,1809,46,15-19,1855,0.001486274807918502
STAT,1886,36,30-34,1922,5.34518373500503
STAT,1822,32,25-29,1854,31.148602587086582
STAT,1906,22,50-100,1928,0.5609601810134669
SIM,1900,15,15-19,1915,7
STAT,1882,52,35-39,1934,0.007871748629433207
SIM,1866,29,50-100,1895,3
SIM,1927,29,45-49,1956,5
SIM,1807,70,na,1877,592
SIM,1902,61,na,1963,2683
SIM,1907,26,25-29,1933,67
SIM,1914,20,25-29,1934,101
STAT,1925,20,45-49,1945,1.2800853142263766
SIM,1902,34,25-29,1936,15
STAT,1912,16,30-34,1928,2.333576979732314
STAT,1903,46,35-39,1949,0.10644187302012965
STAT,1862,38,35-39,1900,5.671357549725211
SIM,1837,25,35-39,1862,9
STAT,1813,46,na,1859,1319.332009661844
SIM,1888,27,40-44,1915,6
SIM,1854,65,na,1919,1270
STAT,1896,16,35-39,1912,0.6867636097210804
STAT,1857,31,40-44,1888,3.2836327980346818
STAT,1917,21,15-19,1938,5.360562832562148
STAT,1906,47,15-19,1953,3.08935945157338E-4
STAT,1864,22,35-39,1886,5.006188205940274
SIM,1877,35,50-100,1912,1
STAT,1835,36,15-19,1871,0.043767881139850244
STAT,1882,24,45-49,1906,0.6370000526562352
SIM,1847,33,30-34,1880,22
SIM,1916,21,20-24,1937,108
STAT,1863,50,25-29,1913,0.002983603844071084
STAT,1801,53,20-24,1854,0.002609819498256943
STAT,1812,88,na,1900,59.045443034115586
SIM,1870,27,na,1897,2220
SIM,1864,85,na,1949,202
SIM,1862,5,na,1867,2501
STAT,1872,7,na,1879,2587.517479919633
SIM,1837,83,na,1920,217
STAT,1946,24,45-49,1970,1.1820756109731732
STAT,1951,18,40-44,1969,1.573064987245225
SIM,1929,35,40-44,1964,2
SIM,1843,31,20-24,1874,3
STAT,1850,21,45-49,1871,0.5934843665009122
STAT,1885,10,na,1895,2437.961370219054
STAT,1922,44,na,1966,4013.9651649552366
SIM,1872,22,35-39,1894,8
STAT,1827,38,50-100,1865,1.1969632550652063
STAT,1909,48,45-49,1957,0.1880921354788442
STAT,1908,18,na,1926,3529.181463736573
STAT,1869,95,na,1964,37.0746857382676
STAT,1824,83,na,1907,209.58439474800122
SIM,1916,35,30-34,1951,1
STAT,1829,25,35-39,1854,27.68428958685365
STAT,1857,24,35-39,1881,4.500308520314339
SIM,1925,34,na,1959,4129
SIM,1870,38,35-39,1908,9
STAT,1877,22,45-49,1899,0.683596176836604
STAT,1909,45,50-100,1954,0.19817615484609624
STAT,1873,18,40-44,1891,0.17492775106697483
STAT,1885,25,25-29,1910,40.083330199333986
SIM,1834,33,20-24,1867,2
STAT,1904,15,50-100,1919,0.06668371902399213
STAT,1882,77,na,1959,923.0241632940573
SIM,1815,49,50-100,1864,2
STAT,1863,30,20-24,1893,2.2626995673509356
STAT,1874,21,30-34,1895,17.250244244106913
SIM,1908,36,35-39,1944,7
SIM,1908,55,na,1963,2956
STAT,1835,31,20-24,1866,2.1695809457817643
STAT,1899,38,30-34,1937,1.4818622768104772
SIM,1902,39,35-39,1941,5
STAT,1910,59,na,1969,3044.0144013595063
SIM,1875,23,15-19,1898,3
SIM,1823,33,45-49,1856,1
SIM,1784,102,na,1886,1
STAT,1821,65,na,1886,919.9348707862533
STAT,1904,38,15-19,1942,0.016339642672053296
SIM,1850,65,na,1915,1246
STAT,1800,70,na,1870,672.7264884301569
STAT,1888,55,na,1943,2307.5893378967453
STAT,1821,51,30-34,1872,0.008913898330507104
SIM,1865,24,35-39,1889,4
SIM,1877,16,25-29,1893,7
STAT,1825,31,na,1856,1658.667624576006
STAT,1838,44,50-100,1882,0.7474175030597792
STAT,1893,15,na,1908,3041.29691729917
STAT,1877,42,15-19,1919,0.01352134291477575
SIM,1909,37,30-34,1946,2
SIM,1882,12,na,1894,2367
STAT,1893,24,20-24,1917,82.08253087890851
STAT,1867,23,15-19,1890,2.9171938335948995
STAT,1858,11,na,1869,2077.5481486181766
STAT,1793,83,na,1876,133.36305177082232
STAT,1804,54,35-39,1858,0.024594607638700146
STAT,1889,34,40-44,1923,5.0144882587669075
STAT,1838,32,35-39,1870,8.582723114811712
STAT,1932,37,15-19,1969,0.02437516476675588
STAT,1908,35,30-34,1943,1.6269716195991293
STAT,1809,48,40-44,1857,0.6131516692827332
STAT,1919,42,30-34,1961,0.13088162837977185
SIM,1879,22,20-24,1901,72
STAT,1837,24,50-100,1861,0.3321711195324727
STAT,1887,18,35-39,1905,0.5781904636403185
STAT,1898,20,40-44,1918,2.6807307655929202
STAT,1936,20,20-24,1956,100.47946435362589
STAT,1899,30,35-39,1929,13.216021235652029
STAT,1893,18,na,1911,3019.300608413827
STAT,1894,62,na,1956,2243.8720774792664
SIM,1828,27,35-39,1855,8
STAT,1841,23,45-49,1864,0.60005312547723
SIM,1906,22,40-44,1928,3
STAT,1799,74,na,1873,463.6832621006919
STAT,1870,45,na,1915,2103.371684007302
STAT,1833,50,na,1883,1401.4105751475097
STAT,1845,78,na,1923,550.3561829968112
STAT,1867,28,50-100,1895,0.565410182608377
SIM,1893,25,25-29,1918,58
SIM,1946,8,na,1954,4079
STAT,1908,21,20-24,1929,96.84002124011585
STAT,1911,15,35-39,1926,0.7967552067723489
SIM,1786,76,na,1862,322
SIM,1869,30,na,1899,2175
SIM,1902,34,40-44,1936,3
SIM,1775,91,na,1866,11
STAT,1808,83,na,1891,154.30300636492916
SIM,1832,53,na,1885,1332
STAT,1844,35,na,1879,1782.6358796271086
SIM,1932,19,na,1951,4442
STAT,1876,32,20-24,1908,2.6361726317007395
SIM,1881,64,na,1945,1448
SIM,1845,13,na,1858,2125
STAT,1867,5,na,1872,2505.6541578094507
SIM,1920,16,30-34,1936,19
STAT,1855,78,na,1933,553.3685684442088
SIM,1942,16,15-19,1958,40
SIM,1933,20,45-49,1953,1
STAT,1793,80,na,1873,251.59783738156847
STAT,1863,97,na,1960,9.10533041093555
STAT,1920,24,25-29,1944,96.40724585222513
SIM,1879,31,35-39,1910,12
SIM,1826,34,25-29,1860,11
SIM,1826,46,na,1872,1441
SIM,1847,26,40-44,1873,2
STAT,1942,26,50-100,1968,0.9872921631698721
SIM,1851,20,na,1871,1925
STAT,1845,19,40-44,1864,0.1609217614885744
SIM,1866,40,40-44,1906,6
STAT,1843,26,30-34,1869,22.520192156720647
STAT,1945,17,na,1962,3798.3898593073764
STAT,1876,39,40-44,1915,4.22621581793086
STAT,1867,39,15-19,1906,0.04930781667177074
STAT,1826,40,45-49,1866,1.530595118687651
SIM,1887,58,na,1945,2033
STAT,1784,105,na,1889,0.017255721305294135
SIM,1819,47,50-100,1866,3
SIM,1925,21,15-19,1946,6
STAT,1889,10,na,1899,3021.0247020428005
SIM,1846,32,35-39,1878,6
STAT,1867,51,50-100,1918,0.013460241551933535
STAT,1837,40,20-24,1877,0.12137134088854915
STAT,1839,33,30-34,1872,14.17840504168406
SIM,1865,31,40-44,1896,4
STAT,1821,44,25-29,1865,1.00913338894956
SIM,1851,26,30-34,1877,27
SIM,1860,23,20-24,1883,58
SIM,1944,20,20-24,1964,116
SIM,1879,45,45-49,1924,3
STAT,1855,15,35-39,1870,0.46771341018654067
SIM,1884,39,40-44,1923,7
STAT,1939,26,45-49,1965,1.6412706502700751
STAT,1863,43,35-39,1906,1.4928617910469375
STAT,1833,22,40-44,1855,1.8119008346415062
SIM,1838,30,35-39,1868,12
SIM,1855,28,40-44,1883,2
SIM,1916,28,40-44,1944,3
STAT,1852,28,15-19,1880,0.39861592142510455
STAT,1902,36,40-44,1938,1.2656816796783539
STAT,1839,26,40-44,1865,2.5344202590939195
STAT,1893,31,45-49,1924,2.0987149775528633
SIM,1907,28,30-34,1935,1
STAT,1930,28,15-19,1958,0.8476420394215207
SIM,1826,53,na,1879,1289
SIM,1850,37,50-100,1887,3
STAT,1897,21,35-39,1918,7.394893819886963
STAT,1916,16,15-19,1932,9.118248840695788
SIM,1838,44,45-49,1882,3
STAT,1934,25,30-34,1959,49.83720161806559
SIM,1847,83,na,1930,253
STAT,1905,37,20-24,1942,0.22713586968987814
STAT,1931,39,20-24,1970,0.32911326352720965
SIM,1891,42,50-100,1933,3
STAT,1866,18,15-19,1884,5.274236121927484
SIM,1834,26,30-34,1860,25
SIM,1933,28,40-44,1961,6
STAT,1856,26,40-44,1882,2.3133071116634136
SIM,1901,29,25-29,1930,64
STAT,1898,32,40-44,1930,5.545909863632343
STAT,1863,17,35-39,1880,0.5199458141123239
STAT,1889,20,15-19,1909,3.8705160985247957
STAT,1897,35,45-49,1932,2.5425212027851667
STAT,1906,24,40-44,1930,2.8485614886899597
STAT,1827,50,na,1877,1349.8853249196272
STAT,1836,41,15-19,1877,0.010508178540205696
STAT,1845,53,25-29,1898,0.002454869065621331
SIM,1950,18,15-19,1968,42
STAT,1893,17,30-34,1910,1.9104374426301336
STAT,1910,15,50-100,1925,0.07043605987558602
SIM,1951,4,na,1955,4354
STAT,1878,41,20-24,1919,0.1568917776256938
STAT,1905,3,na,1908,3608.981644492658
SIM,1906,20,na,1926,3350
SIM,1839,41,40-44,1880,3
SIM,1856,50,na,1906,1733
SIM,1816,91,na,1907,16
SIM,1933,18,15-19,1951,51
SIM,1868,78,na,1946,624
STAT,1835,38,40-44,1873,3.3417789958935744
STAT,1948,17,20-24,1965,146.5836342036125
SIM,1843,38,40-44,1881,7
STAT,1865,23,30-34,1888,15.365612849388143
SIM,1943,15,20-24,1958,116
SIM,1910,36,40-44,1946,3
SIM,1869,21,15-19,1890,3
STAT,1821,37,35-39,1858,14.795807176956666
STAT,1846,23,50-100,1869,0.35221497164256327
STAT,1956,4,na,1960,4915.402943783708
STAT,1847,28,40-44,1875,2.6301968022268363
STAT,1861,26,15-19,1887,0.3610975617602082
STAT,1831,65,na,1896,1030.649069917182
STAT,1879,33,35-39,1912,9.957590754571958
SIM,1835,98,na,1933,2
SIM,1873,37,50-100,1910,1
STAT,1941,21,na,1962,3566.0176831194235
SIM,1829,32,35-39,1861,8
SIM,1928,34,45-49,1962,2
STAT,1920,29,35-39,1949,15.448218412812976
SIM,1867,38,na,1905,2020
STAT,1849,50,40-44,1899,0.007697279309096677
STAT,1813,52,35-39,1865,0.024854657462751523
SIM,1924,16,15-19,1940,41
SIM,1786,69,na,1855,658
STAT,1914,39,20-24,1953,0.24609592505696082
STAT,1926,26,35-39,1952,17.062690584903763
SIM,1897,20,15-19,1917,3
SIM,1867,35,25-29,1902,2
SIM,1859,32,45-49,1891,1
STAT,1859,37,50-100,1896,0.9256254046496933
SIM,1856,60,na,1916,1488
STAT,1812,98,na,1910,1.3971921418522595
STAT,1880,43,35-39,1923,1.7869436335368278
SIM,1890,5,na,1895,3136
STAT,1916,28,15-19,1944,0.6871113673743651
STAT,1868,44,15-19,1912,0.012288014510518521
SIM,1942,25,30-34,1967,44
STAT,1863,53,50-100,1916,0.01234016064473851
SIM,1864,26,40-44,1890,7
STAT,1925,28,40-44,1953,5.1830942310529045
SIM,1829,38,40-44,1867,6
STAT,1849,75,na,1924,742.0268236190947
STAT,1911,17,25-29,1928,8.190341162804737
SIM,1907,23,20-24,1930,85
STAT,1882,16,40-44,1898,0.1685465883787432
SIM,1875,26,na,1901,2332
SIM,1907,15,na,1922,3568
STAT,1884,27,30-34,1911,23.508303624257824
STAT,1898,25,35-39,1923,12.423023502523938
SIM,1873,23,30-34,1896,17
SIM,1924,23,20-24,1947,114
SIM,1860,30,45-49,1890,1
STAT,1826,33,20-24,1859,3.3750000062130954
STAT,1900,45,20-24,1945,0.008959823844019303
STAT,1930,41,35-39,1971,0.2506681248936316
STAT,1934,35,50-100,1969,0.5482791671159276
STAT,1781,95,na,1876,2.279144487449549
STAT,1837,27,35-39,1864,7.81795217458612
SIM,1864,20,35-39,1884,9
SIM,1887,33,35-39,1920,14
STAT,1918,44,50-100,1962,0.11760315749342375
STAT,1858,52,50-100,1910,0.011141019507664053
STAT,1863,63,na,1926,1481.710484036401
STAT,1909,45,25-29,1954,0.04647779494546905
STAT,1928,32,na,1960,4467.946080515901
SIM,1938,21,25-29,1959,88
STAT,1851,31,50-100,1882,0.7066247482807443
STAT,1931,27,20-24,1958,22.263731313771494
STAT,1935,15,20-24,1950,175.89389081488514
SIM,1843,40,50-100,1883,3
SIM,1947,19,20-24,1966,133
SIM,1895,40,na,1935,2940
STAT,1939,19,20-24,1958,128.10192055451864
SIM,1850,20,40-44,1870,1
STAT,1854,54,50-100,1908,0.010576336319676489
SIM,1879,23,na,1902,2339
SIM,1934,26,35-39,1960,23
STAT,1847,21,20-24,1868,62.60896067429984
SIM,1915,34,na,1949,3575
SIM,1875,34,20-24,1909,1
STAT,1831,54,45-49,1885,0.009021819489068543
SIM,1862,50,na,1912,1906
SIM,1942,18,40-44,1960,1
SIM,1918,30,20-24,1948,2
STAT,1854,53,35-39,1907,0.006099796864120544
STAT,1919,49,15-19,1968,3.752383065554249E-4
STAT,1867,34,20-24,1901,2.377086990550456
SIM,1825,36,30-34,1861,3
SIM,1839,34,35-39,1873,15
STAT,1826,38,15-19,1864,0.059150129570074324
STAT,1828,76,na,1904,537.8187916881974
SIM,1871,43,35-39,1914,5
STAT,1877,49,35-39,1926,0.13437881922067912
STAT,1916,23,20-24,1939,109.72904311011848
STAT,1847,44,45-49,1891,1.0863466521323741
STAT,1942,18,15-19,1960,44.78768587725694
SIM,1838,21,20-24,1859,56
SIM,1938,29,20-24,1967,15
STAT,1852,30,45-49,1882,1.400570235414123
STAT,1894,49,35-39,1943,0.09396422264391692
STAT,1893,29,15-19,1922,0.5399283819003035
STAT,1925,18,15-19,1943,51.66152658413314
STAT,1897,43,50-100,1940,0.09201736404277362
STAT,1934,18,40-44,1952,1.782545609868496
SIM,1828,46,50-100,1874,1
STAT,1883,15,na,1898,2349.24008701524
SIM,1864,27,na,1891,2119
SIM,1914,24,40-44,1938,4
STAT,1841,49,20-24,1890,0.008038874466094097
STAT,1892,30,na,1922,2845.714022953986
STAT,1900,29,50-100,1929,0.8323821278980297
STAT,1842,20,40-44,1862,1.898812333565748
STAT,1880,50,25-29,1930,0.0035713499576004617
STAT,1926,45,25-29,1971,0.06213000592488456
STAT,1874,36,50-100,1910,1.1911298627199214
STAT,1846,17,35-39,1863,0.485999042571747
STAT,1862,42,20-24,1904,0.12781998797548283
SIM,1854,17,35-39,1871,2
SIM,1855,44,45-49,1899,4
STAT,1861,21,20-24,1882,55.93983991653783
SIM,1896,29,40-44,1925,6
STAT,1843,38,15-19,1881,0.04259418078909273
STAT,1888,29,40-44,1917,3.319186117147371
STAT,1911,24,15-19,1935,4.738356853266411
SIM,1889,32,40-44,1921,1
STAT,1852,38,40-44,1890,3.309409094987631
SIM,1844,65,na,1909,1173
STAT,1921,21,50-100,1942,0.7042723183378008
SIM,1878,21,25-29,1899,56
SIM,1967,2,na,1969,4512
SIM,1860,38,40-44,1898,6
STAT,1857,63,na,1920,1328.8619732805053
STAT,1865,16,40-44,1881,0.1627568336860698
STAT,1920,24,40-44,1944,3.509339235817061
SIM,1875,27,30-34,1902,28
SIM,1916,24,25-29,1940,101
STAT,1882,21,40-44,1903,1.9213246082842415
SIM,1897,11,na,1908,3317
STAT,1835,34,25-29,1869,7.968966242851924
STAT,1885,27,15-19,1912,0.42701546601459145
SIM,1816,84,na,1900,103
STAT,1917,36,35-39,1953,2.384650771617803
STAT,1934,21,15-19,1955,6.760164132416462
SIM,1834,22,15-19,1856,2
STAT,1816,48,50-100,1864,0.6364126160218629
SIM,1870,35,30-34,1905,5
SIM,1944,1,na,1945,4070
STAT,1926,35,15-19,1961,0.022212001276389923
STAT,1869,54,25-29,1923,0.0031498780041890086
STAT,1885,22,20-24,1907,64.8590168993461
SIM,1937,24,45-49,1961,1
SIM,1817,79,na,1896,385
STAT,1839,22,25-29,1861,49.04363653001979
SIM,1908,33,30-34,1941,17
SIM,1900,19,30-34,1919,1
STAT,1836,64,na,1900,1097.754267263375
STAT,1927,30,20-24,1957,2.838034873908316
SIM,1855,21,20-24,1876,58
STAT,1821,41,20-24,1862,0.2732785980402401
STAT,1921,34,35-39,1955,9.525715235512939
SIM,1865,21,30-34,1886,19
SIM,1901,32,50-100,1933,1
STAT,1865,33,40-44,1898,3.7071215263327693
STAT,1867,56,na,1923,1809.1563545532879
SIM,1851,33,20-24,1884,2
SIM,1890,21,40-44,1911,3
STAT,1834,53,50-100,1887,0.009397519349991954
SIM,1806,91,na,1897,14
SIM,1920,22,25-29,1942,113
STAT,1848,54,50-100,1902,0.010581172991632044
SIM,1843,34,25-29,1877,17
STAT,1857,34,45-49,1891,1.2875938696773288
SIM,1929,38,45-49,1967,1
SIM,1942,21,15-19,1963,3
STAT,1810,105,na,1915,0.013277772888116615
STAT,1901,45,na,1946,3005.1525653057442
STAT,1949,22,20-24,1971,122.58440485838625
SIM,1865,41,35-39,1906,2
SIM,1847,45,na,1892,1612
SIM,1928,24,35-39,1952,13
SIM,1892,27,30-34,1919,41
STAT,1818,83,na,1901,191.3967674320134
STAT,1901,19,40-44,1920,0.24055333409158136
SIM,1875,41,45-49,1916,1
STAT,1818,36,15-19,1854,0.20933013871238038
SIM,1947,23,40-44,1970,4
STAT,1851,28,30-34,1879,21.4662304439594
STAT,1898,22,30-34,1920,22.778827419926305
SIM,1885,26,na,1911,2256
STAT,1923,47,15-19,1970,4.071319733279946E-4
STAT,1860,30,50-100,1890,0.7091108691087498
SIM,1935,30,20-24,1965,3
STAT,1799,67,na,1866,757.6296843459955
STAT,1894,58,na,1952,2403.216530817318
STAT,1923,29,50-100,1952,1.0719465751216537
STAT,1771,95,na,1866,1.6813608050669369
STAT,1909,45,40-44,1954,0.1381423360522374
STAT,1812,51,na,1863,1244.4926974651332
STAT,1881,28,50-100,1909,0.5814376694932811
SIM,1824,48,50-100,1872,1
STAT,1856,20,35-39,1876,5.08732278124531
SIM,1869,26,na,1895,2174
STAT,1867,41,45-49,1908,1.3335272750685245
SIM,1848,31,na,1879,1882
SIM,1902,37,45-49,1939,3
STAT,1804,69,na,1873,716.6883375377399
SIM,1859,30,na,1889,1989
STAT,1907,38,50-100,1945,0.3658516134391223
STAT,1880,45,na,1925,2258.6335140690303
SIM,1874,78,na,1952,707
SIM,1785,91,na,1876,11
SIM,1839,31,30-34,1870,24
SIM,1866,12,na,1878,2393
SIM,1931,29,50-100,1960,1
SIM,1875,29,20-24,1904,11
STAT,1949,1,na,1950,4500.647101843021
SIM,1934,28,25-29,1962,103
STAT,1935,35,40-44,1970,1.9808181897875772
SIM,1933,18,30-34,1951,20
STAT,1834,35,na,1869,1683.5519659938643
STAT,1887,15,30-34,1902,1.6917412530990545
SIM,1917,25,20-24,1942,18
SIM,1937,18,na,1955,3259
STAT,1911,35,50-100,1946,0.38664859377087507
STAT,1903,26,30-34,1929,33.96145381088656
STAT,1783,80,na,1863,200.69939200708794
SIM,1836,46,na,1882,1498
STAT,1943,26,35-39,1969,15.111433872192608
STAT,1804,51,30-34,1855,0.018059869458441215
STAT,1856,21,50-100,1877,0.35295572290970517
STAT,1861,78,na,1939,612.9372707986018
STAT,1939,23,40-44,1962,3.1885914854045527
STAT,1871,42,30-34,1913,1.0753886441650442
STAT,1877,53,20-24,1930,7.117800213964363E-4
SIM,1865,34,45-49,1899,2
STAT,1853,49,na,1902,1633.662543120019
SIM,1879,42,40-44,1921,3
SIM,1844,37,50-100,1881,4
STAT,1786,94,na,1880,4.043473422476492
STAT,1843,33,20-24,1876,2.320220240921818
STAT,1925,18,30-34,1943,13.874972480527129
STAT,1854,40,20-24,1894,0.11551428453556618
SIM,1856,97,na,1953,1
STAT,1908,31,15-19,1939,0.11503116094603408
STAT,1932,17,45-49,1949,0.6248967042188995
SIM,1833,32,na,1865,1665
SIM,1847,22,25-29,1869,57
STAT,1908,24,25-29,1932,79.70078639145525
STAT,1876,35,25-29,1911,2.834620055800731
STAT,1895,44,25-29,1939,0.05423182923391101
STAT,1841,20,40-44,1861,1.8323267632704214
STAT,1885,44,15-19,1929,0.012822084379571653
STAT,1927,27,50-100,1954,1.1432616758762448
SIM,1935,27,50-100,1962,1
STAT,1908,28,40-44,1936,4.146903787169874
STAT,1865,37,50-100,1902,1.05394943327749
STAT,1911,38,40-44,1949,1.3588481905634633
SIM,1891,31,35-39,1922,15
STAT,1874,24,35-39,1898,5.5990680597141536
SIM,1874,85,na,1959,307
STAT,1844,26,15-19,1870,0.39272160713508064
STAT,1835,24,na,1859,1747.849717813177
SIM,1905,3,na,1908,3590
SIM,1796,90,na,1886,28
STAT,1862,31,15-19,1893,0.1152264628839939
STAT,1836,37,50-100,1873,0.9516424034843273
STAT,1872,52,40-44,1924,0.009929200397764725
STAT,1891,44,na,1935,2666.06886941888
STAT,1809,68,na,1877,780.2946752645328
STAT,1849,34,na,1883,1775.2310784893832
SIM,1871,30,20-24,1901,1
STAT,1886,29,na,1915,2365.0215524510713
STAT,1821,34,30-34,1855,47.47837471833386
STAT,1909,25,20-24,1934,16.72860431380188
SIM,1829,64,na,1893,953
SIM,1801,92,na,1893,14
SIM,1889,77,na,1966,1297
STAT,1924,18,na,1942,4130.2990095290315
SIM,1884,35,25-29,1919,4
SIM,1770,92,na,1862,7
SIM,1906,25,45-49,1931,1
STAT,1885,26,50-100,1911,0.604131402229038
STAT,1876,77,na,1953,843.0031069939271
SIM,1834,40,45-49,1874,2
STAT,1853,12,na,1865,2129.668672547642
SIM,1826,31,20-24,1857,3
STAT,1885,48,30-34,1933,0.08996141003710165
SIM,1893,26,50-100,1919,3
SIM,1893,22,20-24,1915,82
SIM,1874,18,15-19,1892,8
STAT,1864,28,40-44,1892,2.520284107101292
STAT,1867,63,na,1930,1582.678726967007
SIM,1851,13,na,1864,2161
STAT,1825,38,30-34,1863,6.55343220178669
STAT,1883,31,35-39,1914,9.414634919370062
STAT,1865,20,50-100,1885,0.35946428920200174
SIM,1821,47,na,1868,1364
SIM,1939,17,20-24,1956,113
SIM,1901,24,30-34,1925,29
STAT,1913,28,15-19,1941,0.6620233612716492
STAT,1898,35,45-49,1933,2.5735357351976402
STAT,1846,64,na,1910,1225.668636591643
SIM,1842,46,na,1888,1545
STAT,1788,68,na,1856,683.1107161599998
SIM,1872,12,na,1884,2449
SIM,1911,29,35-39,1940,11
STAT,1858,47,25-29,1905,0.042518712564612204
SIM,1901,27,na,1928,3223
STAT,1863,40,30-34,1903,0.964333385965524
STAT,1924,15,45-49,1939,0.5646349201730245
STAT,1927,40,15-19,1967,0.0018247081382003537
SIM,1921,41,na,1962,3859
SIM,1933,22,na,1955,4585
STAT,1930,21,30-34,1951,34.88995296454385
SIM,1903,56,na,1959,2818
SIM,1834,28,20-24,1862,12
STAT,1920,27,45-49,1947,1.7904244746416231
STAT,1939,17,na,1956,3480.190065695064
STAT,1832,39,50-100,1871,0.9210806357405256
STAT,1773,102,na,1875,0.05750514251386412
SIM,1888,34,30-34,1922,38
SIM,1900,42,na,1942,3010
SIM,1850,72,na,1922,905
STAT,1888,62,na,1950,2039.76651252419
STAT,1892,29,30-34,1921,29.577441034894715
STAT,1828,53,25-29,1881,0.00257012722829842
STAT,1898,14,na,1912,3291.8905099217227
SIM,1854,27,na,1881,1932
STAT,1850,22,40-44,1872,1.760777886419933
SIM,1791,91,na,1882,13
SIM,1871,40,30-34,1911,4
STAT,1880,54,40-44,1934,0.010176701058555324
STAT,1899,45,20-24,1944,0.00885060380122667
STAT,1819,68,na,1887,789.5946727803284
SIM,1921,0,na,1921,4408
STAT,1862,45,25-29,1907,0.04687900890758097
SIM,1925,16,15-19,1941,46
STAT,1906,27,45-49,1933,1.5273430339164202
STAT,1889,33,45-49,1922,2.0251884908698163
SIM,1907,30,45-49,1937,1
SIM,1838,41,40-44,1879,7
STAT,1859,37,na,1896,1776.2290155973794
STAT,1955,16,35-39,1971,5.263428374967852
SIM,1769,91,na,1860,4
STAT,1897,32,40-44,1929,5.479074265093791
SIM,1845,9,na,1854,2157
SIM,1833,38,30-34,1871,8
SIM,1847,43,40-44,1890,7
STAT,1877,46,30-34,1923,0.09516410719081198
STAT,1918,18,na,1936,3774.710469613293
STAT,1944,27,30-34,1971,40.00561635127699
SIM,1841,19,15-19,1860,6
STAT,1868,48,na,1916,2003.8064234424382
STAT,1869,16,25-29,1885,5.284748135664162
STAT,1873,63,na,1936,1710.9842012558963
SIM,1883,40,40-44,1923,5
STAT,1875,40,40-44,1915,2.205035062072663
STAT,1916,26,25-29,1942,64.51045787519887
SIM,1916,26,na,1942,3567
SIM,1890,41,na,1931,2767
STAT,1928,19,45-49,1947,0.5914935663913573
STAT,1844,43,15-19,1887,0.009802520627550777
STAT,1885,44,na,1929,2145.9288122575576
STAT,1917,16,15-19,1933,9.248248314879971
STAT,1926,28,25-29,1954,74.28551502047696
SIM,1896,20,30-34,1916,26
STAT,1830,49,45-49,1879,0.16855952130208146
STAT,1858,37,30-34,1895,3.952572718930347
SIM,1934,23,30-34,1957,41
STAT,1888,25,25-29,1913,47.529095374448
STAT,1870,37,30-34,1907,4.93342755782988
SIM,1850,30,35-39,1880,9
SIM,1864,29,45-49,1893,1
SIM,1906,18,20-24,1924,23
STAT,1842,23,45-49,1865,0.6218259200761808
STAT,1794,68,na,1862,676.0386297236076
SIM,1929,22,45-49,1951,1
SIM,1897,33,45-49,1930,2
STAT,1884,37,25-29,1921,2.6878449257191934
SIM,1914,27,45-49,1941,2
STAT,1913,30,na,1943,3582.5071076149693
STAT,1861,24,25-29,1885,45.47544984855898
SIM,1838,31,na,1869,1706
STAT,1813,42,25-29,1855,2.284768813038674
STAT,1839,43,40-44,1882,1.5605533513265357
SIM,1926,37,30-34,1963,5
STAT,1852,64,na,1916,1320.7566517769649
STAT,1831,102,na,1933,0.17879717874318335
STAT,1857,21,30-34,1878,15.42525475681899
STAT,1904,31,30-34,1935,23.751497251795666
STAT,1826,28,20-24,1854,35.73683013706112
STAT,1837,49,na,1886,1436.9744262549812
SIM,1892,37,25-29,1929,2
SIM,1924,26,25-29,1950,76
SIM,1832,22,30-34,1854,13
STAT,1938,32,na,1970,3592.1228479436054
STAT,1880,33,25-29,1913,10.138168170621471
STAT,1821,54,35-39,1875,0.0121440888607924
STAT,1912,22,25-29,1934,83.60769678139754
SIM,1829,34,25-29,1863,13
STAT,1903,39,45-49,1942,0.5724855700857547
SIM,1807,80,na,1887,211
STAT,1926,23,30-34,1949,32.88792513201193
STAT,1952,18,25-29,1970,49.045551445088165
STAT,1911,28,30-34,1939,35.9629857735733
STAT,1833,21,45-49,1854,0.7349269175493124
SIM,1896,25,25-29,1921,64
STAT,1856,29,45-49,1885,0.8390885939448375
STAT,1917,47,40-44,1964,0.15556522531902756
STAT,1842,30,35-39,1872,8.894618601218212
STAT,1850,90,na,1940,55.503941888292026
SIM,1860,27,na,1887,2045
STAT,1947,25,40-44,1972,4.986169159814264
STAT,1893,19,20-24,1912,21.135743876808654
SIM,1864,31,40-44,1895,4
SIM,1915,41,na,1956,3502
SIM,1865,71,na,1936,1120
SIM,1837,20,25-29,1857,49
STAT,1843,49,na,1892,1589.2694095334934
STAT,1918,37,30-34,1955,1.8147434647042897
STAT,1836,52,20-24,1888,4.714924323723334E-4
STAT,1935,32,20-24,1967,3.1877652790161743
SIM,1912,31,30-34,1943,18
STAT,1882,30,na,1912,2211.2492041217856
STAT,1900,48,25-29,1948,0.04204756985382708
SIM,1819,98,na,1917,1
SIM,1912,39,na,1951,3279
STAT,1911,38,35-39,1949,2.195550055020329
SIM,1837,30,20-24,1867,1
STAT,1861,39,40-44,1900,3.399486611545455
SIM,1928,21,30-34,1949,37
SIM,1928,32,40-44,1960,8
STAT,1859,31,15-19,1890,0.10780340059404121
SIM,1926,24,30-34,1950,37
STAT,1904,40,35-39,1944,0.17208347082999953
SIM,1818,36,25-29,1854,2
STAT,1870,29,35-39,1899,8.86788202201198
STAT,1883,40,na,1923,2161.493254067086
STAT,1896,21,20-24,1917,86.29922895363774
SIM,1931,17,20-24,1948,155
STAT,1868,26,15-19,1894,0.41063363798345187
STAT,1854,99,na,1953,1.3637627115416826
SIM,1883,19,15-19,1902,6
SIM,1909,27,35-39,1936,15
STAT,1902,43,35-39,1945,0.16642789334322983
SIM,1868,18,35-39,1886,2
STAT,1866,20,50-100,1886,0.363279023027339
STAT,1879,35,na,1914,2348.4612328611965
STAT,1866,29,15-19,1895,0.3923455837018966
STAT,1923,17,20-24,1940,150.406515033979
STAT,1900,35,25-29,1935,3.8092825368833063
STAT,1940,26,na,1966,3610.038044276665
SIM,1880,29,45-49,1909,2
SIM,1852,20,45-49,1872,1
SIM,1885,27,25-29,1912,37
STAT,1877,27,25-29,1904,41.46880106797517
STAT,1908,17,25-29,1925,7.9392616089733
STAT,1932,40,40-44,1972,0.32114657799028723
SIM,1856,35,na,1891,1863
SIM,1961,8,na,1969,4704
STAT,1928,40,20-24,1968,0.021329730098658527
SIM,1835,33,20-24,1868,1
STAT,1941,22,35-39,1963,9.191704344713731
STAT,1873,50,35-39,1923,0.008373930657261542
SIM,1852,45,na,1897,1758
STAT,1944,16,na,1960,3742.9488475431745
STAT,1877,8,na,1885,2612.049102113695
STAT,1859,47,30-34,1906,0.07263966002143445
STAT,1891,23,40-44,1914,2.429082558217228
STAT,1894,24,20-24,1918,83.21960783576286
STAT,1912,17,45-49,1929,0.09540406733009178
SIM,1890,62,na,1952,2141
SIM,1926,35,40-44,1961,4
SIM,1910,32,25-29,1942,11
STAT,1910,28,50-100,1938,0.9045377175140203
STAT,1920,0,na,1920,4775.195923605679
STAT,1936,17,30-34,1953,11.022147197539983
STAT,1913,35,35-39,1948,2.2758453220877137
STAT,1921,34,50-100,1955,0.8618383858695209
SIM,1877,80,na,1957,595
STAT,1866,84,na,1950,289.7459927112145
SIM,1882,67,na,1949,1421
SIM,1839,45,50-100,1884,2
SIM,1907,52,na,1959,3048
SIM,1928,38,na,1966,4483
STAT,1930,32,30-34,1962,19.20908997284033
STAT,1868,34,20-24,1902,2.4172228946114873
STAT,1860,52,20-24,1912,5.63528738426077E-4
SIM,1890,32,50-100,1922,4
STAT,1845,23,na,1868,1856.2487323922005
STAT,1765,92,na,1857,9.705497292714238
STAT,1929,27,40-44,1956,5.511122415195821
SIM,1828,39,50-100,1867,3
STAT,1824,32,40-44,1856,10.044916489769731
SIM,1864,30,na,1894,2158
SIM,1832,32,40-44,1864,3
SIM,1937,27,40-44,1964,4
STAT,1902,32,25-29,1934,13.654909031735494
STAT,1913,46,45-49,1959,0.20085230130518358
STAT,1864,21,50-100,1885,0.3523684957985172
STAT,1902,45,30-34,1947,0.07351996444578425
SIM,1871,20,25-29,1891,53
SIM,1891,29,20-24,1920,16
SIM,1898,42,na,1940,2935
STAT,1937,33,25-29,1970,8.631935694438706
STAT,1829,76,na,1905,580.7097859534608
STAT,1930,30,35-39,1960,11.154346031715022
STAT,1918,35,40-44,1953,1.5047139756500865
SIM,1944,17,30-34,1961,19
STAT,1833,81,na,1914,328.2927462542186
SIM,1935,17,35-39,1952,7
STAT,1876,20,35-39,1896,5.725039683293709
SIM,1826,30,45-49,1856,1
STAT,1822,35,40-44,1857,8.721555444255388
SIM,1872,8,na,1880,2515
SIM,1889,21,25-29,1910,73
SIM,1937,25,45-49,1962,1
SIM,1853,86,na,1939,150
STAT,1895,25,50-100,1920,0.7939628475948807
STAT,1885,21,45-49,1906,0.6582861126380962
SIM,1939,22,45-49,1961,1
SIM,1924,24,na,1948,3980
SIM,1848,20,25-29,1868,50
SIM,1905,27,20-24,1932,14
STAT,1904,42,30-34,1946,0.10802957154843894
STAT,1918,24,30-34,1942,29.099783259880994
SIM,1921,35,35-39,1956,2
STAT,1924,46,20-24,1970,0.012460984329000906
STAT,1851,44,50-100,1895,0.7642563554816924
STAT,1827,33,20-24,1860,3.011882884466742
SIM,1835,20,15-19,1855,5
SIM,1830,35,40-44,1865,5
STAT,1877,15,30-34,1892,1.5697568674153866
STAT,1900,48,30-34,1948,0.07066327779650186
STAT,1807,103,na,1910,0.0514809646416288
STAT,1829,30,20-24,1859,2.7831011890938724
SIM,1878,22,na,1900,2385
STAT,1863,20,25-29,1883,49.1887194402287
SIM,1924,27,30-34,1951,52
STAT,1862,94,na,1956,18.48182616974441
STAT,1863,33,30-34,1896,14.437601612076826
SIM,1920,34,na,1954,3809
STAT,1907,49,25-29,1956,0.044376478513130015
STAT,1872,29,45-49,1901,1.0452674789189162
SIM,1885,16,15-19,1901,4
STAT,1915,43,45-49,1958,0.1580251992808596
SIM,1869,31,25-29,1900,10
STAT,1887,30,na,1917,2541.3945249908043
STAT,1811,49,25-29,1860,0.18529656336857753
STAT,1837,71,na,1908,842.6031742784144
STAT,1932,40,50-100,1972,0.15083783963674297
STAT,1846,36,35-39,1882,5.262105089585466
SIM,1887,24,25-29,1911,48
STAT,1880,48,35-39,1928,0.13741123197174498
STAT,1820,38,40-44,1858,9.33663789678517
STAT,1917,40,45-49,1957,0.16452638009351012
SIM,1903,62,na,1965,2644
STAT,1907,38,15-19,1945,0.01673333994376357
STAT,1865,30,30-34,1895,15.108681525149702
STAT,1915,32,35-39,1947,8.791512351215987
SIM,1907,24,20-24,1931,94
STAT,1821,108,na,1929,9.891283304499985E-4
SIM,1880,23,30-34,1903,21
SIM,1916,29,na,1945,3527
STAT,1806,49,50-100,1855,0.7025685181205735
SIM,1900,29,40-44,1929,6
STAT,1909,46,25-29,1955,0.046149661713154044
STAT,1830,54,30-34,1884,0.0036881560342000405
SIM,1888,44,40-44,1932,6
SIM,1923,32,35-39,1955,11
STAT,1916,27,30-34,1943,38.27153020880823
STAT,1926,43,20-24,1969,0.020537360784846668
STAT,1849,13,na,1862,2108.4275862252593
STAT,1879,24,25-29,1903,56.17228988893663
SIM,1882,36,50-100,1918,1
STAT,1828,51,na,1879,1335.962213253178
SIM,1911,24,40-44,1935,3
SIM,1837,36,35-39,1873,9
STAT,1891,75,na,1966,1521.9252877552447
STAT,1890,10,na,1900,2991.8965093214165
SIM,1916,19,20-24,1935,135
STAT,1878,47,40-44,1925,0.16758213615308404
STAT,1830,41,25-29,1871,0.49521985507040633
STAT,1895,47,40-44,1942,0.11849774872669892
STAT,1896,27,35-39,1923,12.046997947736218
STAT,1891,51,na,1942,2529.8290944048927
STAT,1925,37,na,1962,4266.266414949372
SIM,1823,48,na,1871,1304
STAT,1922,36,15-19,1958,0.02066271928761628
STAT,1806,48,na,1854,1206.1184976897948
STAT,1895,65,na,1960,2200.9112932379
STAT,1914,16,40-44,1930,0.27395562134898643
STAT,1924,33,15-19,1957,0.14155733862301978
STAT,1807,89,na,1896,37.684255046579715
STAT,1850,53,na,1903,1491.496686922975
STAT,1942,17,30-34,1959,12.0326841017088
STAT,1946,22,40-44,1968,3.5348045235822676
STAT,1810,53,na,1863,1205.2249248249243
STAT,1835,46,30-34,1881,0.06448325007285423
STAT,1917,43,25-29,1960,0.07028599989837589
STAT,1944,28,45-49,1972,1.7630536369935124
STAT,1844,20,15-19,1864,2.933583485877233
SIM,1950,17,30-34,1967,11
SIM,1919,3,na,1922,4224
STAT,1929,27,na,1956,4429.3716043517215
STAT,1842,37,50-100,1879,1.0256093935658837
STAT,1808,105,na,1913,0.011396513598135758
STAT,1873,78,na,1951,749.2264373073734
SIM,1852,39,35-39,1891,10
SIM,1874,32,na,1906,2282
STAT,1828,35,na,1863,1608.0095343700357
SIM,1849,15,20-24,1864,17
SIM,1859,48,50-100,1907,3
STAT,1858,73,na,1931,880.872546544669
STAT,1903,24,40-44,1927,2.7831750399552075
STAT,1914,4,na,1918,3930.6395828580353
STAT,1875,17,50-100,1892,0.047548481080343465
STAT,1944,17,35-39,1961,4.265848351001138
STAT,1899,71,na,1970,2092.327534240643
STAT,1952,20,15-19,1972,6.050647491059312
STAT,1853,109,na,1962,0.0021366863775623343
SIM,1922,16,40-44,1938,2
STAT,1891,46,15-19,1937,2.6458340137068504E-4
STAT,1885,37,30-34,1922,5.016088606399174
STAT,1927,17,35-39,1944,4.929393174816438
STAT,1892,20,50-100,1912,0.4852972068514792
SIM,1879,63,na,1942,1719
STAT,1844,39,35-39,1883,5.139069059467356
SIM,1935,28,45-49,1963,3
SIM,1799,89,na,1888,28
SIM,1957,11,na,1968,4695
STAT,1848,30,30-34,1878,14.97645666352435
STAT,1838,23,25-29,1861,50.29153373076256
STAT,1851,18,15-19,1869,5.259953505145776
SIM,1866,15,20-24,1881,21
STAT,1774,85,na,1859,76.72554387549529
STAT,1818,46,30-34,1864,0.210128171824086
SIM,1832,25,na,1857,1764
SIM,1836,39,na,1875,1610
STAT,1778,99,na,1877,0.3048411383508197
STAT,1924,39,50-100,1963,0.4667516461688263
STAT,1882,15,na,1897,2332.4504009091825
STAT,1920,25,25-29,1945,68.67613516811832
STAT,1927,28,45-49,1955,1.977354833088838
SIM,1858,30,35-39,1888,8
SIM,1819,37,50-100,1856,4
SIM,1861,81,na,1942,395
STAT,1841,17,na,1858,2025.5613105691652
STAT,1901,26,50-100,1927,0.8487596579639279
SIM,1876,51,50-100,1927,2
SIM,1856,30,30-34,1886,27
SIM,1910,0,na,1910,3838
SIM,1820,83,na,1903,170
STAT,1796,72,na,1868,587.1258557858687
STAT,1878,93,na,1971,124.85593855974633
STAT,1900,32,45-49,1932,2.2854351017498593
SIM,1846,23,25-29,1869,52
STAT,1866,6,na,1872,2450.89534507128
SIM,1783,74,na,1857,391
SIM,1865,95,na,1960,18
SIM,1893,37,30-34,1930,9
STAT,1953,18,45-49,1971,0.5706958423312446
SIM,1873,33,40-44,1906,4
STAT,1903,25,25-29,1928,57.24022756587141
SIM,1936,33,na,1969,2866
SIM,1863,23,25-29,1886,52
STAT,1874,23,35-39,1897,5.616929896785932
STAT,1840,15,35-39,1855,0.5006346856463559
STAT,1869,33,na,1902,2172.922035263266
SIM,1916,17,25-29,1933,9
STAT,1858,15,20-24,1873,15.541151107280879
SIM,1838,65,na,1903,1055
SIM,1952,17,35-39,1969,5
STAT,1933,28,15-19,1961,0.8851019473491133
STAT,1949,15,15-19,1964,49.89360348159278
STAT,1821,51,25-29,1872,0.005304137798437433
SIM,1928,14,na,1942,4701
SIM,1878,31,20-24,1909,2
STAT,1861,20,45-49,1881,0.5701456771506364
STAT,1820,71,na,1891,711.0942329109222
STAT,1839,40,30-34,1879,0.9108758362743459
STAT,1915,19,na,1934,3797.930903898891
SIM,1931,18,na,1949,4515
STAT,1821,96,na,1917,4.636783749570072
SIM,1911,25,25-29,1936,61
SIM,1841,61,na,1902,1299
STAT,1908,19,20-24,1927,24.70501787879391
SIM,1878,37,35-39,1915,16
STAT,1845,82,na,1927,328.6519606400295
STAT,1933,39,25-29,1972,1.264246994809422
SIM,1897,31,30-34,1928,26
STAT,1900,21,35-39,1921,7.67100879835017
SIM,1847,40,30-34,1887,4
SIM,1861,23,20-24,1884,58
STAT,1849,96,na,1945,6.189183998159577
STAT,1939,20,50-100,1959,0.6246274549428035
STAT,1804,51,25-29,1855,0.010746368499798029
STAT,1840,38,50-100,1878,1.0008336248719583
STAT,1889,31,30-34,1920,20.44599481524353
STAT,1848,49,20-24,1897,0.008464579996884653
STAT,1844,20,45-49,1864,0.6200776448969905
STAT,1875,45,na,1920,2205.3251328981632
SIM,1861,6,na,1867,2455
STAT,1927,44,na,1971,4386.050020495182
SIM,1894,52,na,1946,2754
STAT,1847,30,na,1877,1911.6001712701895
STAT,1884,19,50-100,1903,0.045490592643194445
SIM,1862,47,na,1909,1952
SIM,1914,46,na,1960,3740
STAT,1876,47,30-34,1923,0.09396460297200117
STAT,1923,40,45-49,1963,0.1842902522486591
SIM,1907,36,na,1943,3348
STAT,1855,23,25-29,1878,47.02472870841186
STAT,1895,40,15-19,1935,0.01719654091877429
SIM,1836,98,na,1934,3
STAT,1837,46,40-44,1883,0.11363383601313916
STAT,1871,42,25-29,1913,0.6006675334326975
STAT,1935,7,na,1942,5162.096312111008
SIM,1937,27,50-100,1964,4
SIM,1842,18,15-19,1860,9
STAT,1853,23,20-24,1876,59.95038741557891
SIM,1903,22,na,1925,3163
STAT,1816,66,na,1882,877.1056620112369
SIM,1835,36,25-29,1871,5
SIM,1815,53,na,1868,1141
SIM,1935,23,15-19,1958,6
SIM,1899,42,45-49,1941,1
STAT,1871,52,50-100,1923,0.014069083354648838
STAT,1850,45,15-19,1895,2.8440812791449886E-4
STAT,1836,46,na,1882,1505.9862960532955
SIM,1897,34,35-39,1931,18
SIM,1926,27,35-39,1953,19
STAT,1839,35,na,1874,1742.4049682866462
SIM,1874,47,50-100,1921,3
STAT,1838,23,50-100,1861,0.35825287778992776
STAT,1856,107,na,1963,0.017488097469202556
SIM,1854,39,45-49,1893,3
STAT,1840,51,na,1891,1506.6765018208014
STAT,1810,47,50-100,1857,0.8732286797755343
STAT,1894,27,25-29,1921,51.405543780492536
SIM,1785,81,na,1866,144
STAT,1940,19,50-100,1959,0.35908681792373864
STAT,1924,38,15-19,1962,0.02137224775650417
SIM,1899,24,na,1923,3016
STAT,1817,51,na,1868,1214.4309293189308
SIM,1874,88,na,1962,198
STAT,1911,35,30-34,1946,1.6784246801562528
STAT,1907,37,30-34,1944,1.596062365019677
STAT,1899,7,na,1906,3372.9292096208887
SIM,1777,86,na,1863,50
SIM,1915,31,na,1946,3605
STAT,1921,40,35-39,1961,0.21487302714215173
SIM,1811,63,na,1874,903
SIM,1885,16,na,1901,2407
STAT,1906,17,20-24,1923,24.387528417029195
SIM,1892,45,na,1937,2736
SIM,1914,17,20-24,1931,23
STAT,1772,103,na,1875,0.04385869477242827
SIM,1896,59,na,1955,2458
STAT,1815,42,40-44,1857,6.347428441472773
STAT,1896,24,25-29,1920,71.0255566293899
SIM,1899,31,35-39,1930,19
STAT,1917,40,15-19,1957,0.0015181212608494758
STAT,1790,105,na,1895,0.0059023292875554564
STAT,1888,16,45-49,1904,0.07307962396048727
STAT,1853,29,35-39,1882,7.4355845033588475
STAT,1878,44,30-34,1922,1.115382553429008
STAT,1832,56,na,1888,1244.085801185078
STAT,1909,19,50-100,1928,0.06901767328392758
STAT,1835,49,40-44,1884,0.10974459546345008
SIM,1919,21,na,1940,3791
STAT,1829,33,25-29,1862,9.737447255803174
STAT,1835,30,45-49,1865,1.4142694776083145
SIM,1941,27,30-34,1968,37
SIM,1882,27,na,1909,2163
STAT,1915,43,15-19,1958,0.0014581334290701463
STAT,1827,36,25-29,1863,2.9502342345267105
SIM,1920,18,na,1938,3813
SIM,1773,96,na,1869,2
STAT,1833,22,35-39,1855,5.074031271109178
STAT,1902,40,30-34,1942,0.10750625065849773
SIM,1831,47,50-100,1878,1
STAT,1851,7,na,1858,2206.770020600253
STAT,1874,20,30-34,1894,17.300935986547493
STAT,1846,39,45-49,1885,1.4376237594962473
STAT,1930,35,35-39,1965,2.9857658513163954
SIM,1861,29,35-39,1890,5
SIM,1886,73,na,1959,1298
STAT,1915,37,50-100,1952,0.40064386367903254
STAT,1954,18,na,1972,4297.097529852974
STAT,1776,100,na,1876,0.17839159796448878
SIM,1930,25,35-39,1955,18
SIM,1907,27,30-34,1934,49
STAT,1919,17,30-34,1936,12.724662965261055
SIM,1895,37,35-39,1932,17
SIM,1921,30,35-39,1951,14
SIM,1903,46,na,1949,3052
STAT,1862,52,25-29,1914,0.0028390931464320575
SIM,1790,68,na,1858,623
STAT,1887,37,35-39,1924,7.472516941224919
SIM,1906,11,na,1917,3639
STAT,1846,20,25-29,1866,50.52443358781484
STAT,1901,28,25-29,1929,55.73772708967012
SIM,1824,73,na,1897,680
STAT,1894,16,15-19,1910,7.229498623334606
SIM,1915,37,30-34,1952,4
STAT,1813,54,30-34,1867,0.01650917220513172
STAT,1852,17,na,1869,2109.3183337819783
STAT,1859,20,35-39,1879,5.0889050042085335
SIM,1885,15,30-34,1900,3
SIM,1843,30,45-49,1873,1
SIM,1904,32,25-29,1936,7
STAT,1904,35,na,1939,3247.6723802185675
STAT,1908,49,na,1957,3119.5915045295196
STAT,1785,69,na,1854,658.0
STAT,1781,79,na,1860,241.79351097968438
SIM,1902,21,na,1923,3166
STAT,1878,10,na,1888,2571.5967518310626
SIM,1850,39,30-34,1889,7
SIM,1860,40,na,1900,1953
STAT,1868,37,25-29,1905,2.596969728764662
STAT,1842,39,30-34,1881,3.9681640434980556
STAT,1833,97,na,1930,3.261434794343681
SIM,1846,76,na,1922,617
SIM,1849,65,na,1914,1237
STAT,1938,28,20-24,1966,17.073878321565957
STAT,1808,53,50-100,1861,0.05383966743838952
STAT,1832,101,na,1933,0.3450324182414308
STAT,1880,45,30-34,1925,0.09717831006204034
STAT,1933,27,30-34,1960,49.14949814603177
SIM,1941,1,na,1942,3842
STAT,1902,48,35-39,1950,0.10395806309622499
STAT,1823,47,50-100,1870,0.2929746625927335
STAT,1822,32,30-34,1854,53.096437304766475
SIM,1876,37,25-29,1913,4
STAT,1842,28,20-24,1870,10.256933910255022
STAT,1913,30,35-39,1943,8.65621957781926
SIM,1860,41,50-100,1901,1
SIM,1850,28,20-24,1878,13
STAT,1917,41,50-100,1958,0.11598180673209976
SIM,1867,20,35-39,1887,4
SIM,1918,28,45-49,1946,1
STAT,1933,32,na,1965,4814.961582877739
SIM,1902,38,35-39,1940,7
SIM,1830,32,30-34,1862,23
SIM,1875,73,na,1948,1057
STAT,1946,1,na,1947,4319.489958080545
STAT,1890,16,50-100,1906,0.05672592187497967
STAT,1831,31,na,1862,1728.2550511389143
STAT,1836,101,na,1937,0.3603425383454925
STAT,1937,30,20-24,1967,2.2819888693787203
STAT,1862,52,30-34,1914,0.004771253805960752
SIM,1837,33,25-29,1870,12
STAT,1835,45,na,1880,1517.9186429448496
STAT,1918,38,45-49,1956,0.6781049596757671
SIM,1842,86,na,1928,120
STAT,1841,32,40-44,1873,3.6000324398585732
SIM,1837,22,15-19,1859,3
STAT,1811,94,na,1905,8.65695252658858
SIM,1926,38,45-49,1964,2
STAT,1899,16,20-24,1915,23.007965094810515
SIM,1835,39,35-39,1874,14
SIM,1904,35,35-39,1939,5
STAT,1827,39,35-39,1866,6.729241022108976
SIM,1928,37,40-44,1965,3
STAT,1891,20,30-34,1911,20.952294298938817
STAT,1852,42,15-19,1894,0.010479408879968252
SIM,1885,24,20-24,1909,60
STAT,1834,46,50-100,1880,0.1794553153325602
STAT,1859,31,45-49,1890,1.3200830914321375
STAT,1918,27,35-39,1945,15.093717550185
STAT,1877,24,20-24,1901,67.13317491654966
STAT,1904,45,35-39,1949,0.10805929966836833
SIM,1867,31,45-49,1898,1
STAT,1857,48,na,1905,1654.5170597149752
SIM,1918,17,35-39,1935,3
STAT,1953,17,30-34,1970,13.92943880439115
SIM,1854,36,35-39,1890,13
SIM,1817,40,45-49,1857,1
SIM,1830,42,na,1872,1613
SIM,1866,37,na,1903,2075
STAT,1848,33,35-39,1881,7.6624580379022635
STAT,1903,16,35-39,1919,0.7392944974691971
STAT,1921,43,45-49,1964,0.1768214520093526
SIM,1828,30,25-29,1858,8
STAT,1806,88,na,1894,45.68091088191569
SIM,1809,49,50-100,1858,1
SIM,1935,27,30-34,1962,62
SIM,1863,48,na,1911,1926
STAT,1816,49,30-34,1865,0.24685874506707434
SIM,1837,33,30-34,1870,21
STAT,1812,51,50-100,1863,0.048490139840578074
SIM,1943,20,15-19,1963,7
STAT,1903,27,45-49,1930,1.4922840971920148
STAT,1905,21,40-44,1926,2.8533113987890113
STAT,1944,25,40-44,1969,4.763092131606681
STAT,1912,19,40-44,1931,0.2656988822608592
SIM,1878,23,15-19,1901,2
STAT,1847,15,45-49,1862,0.06070101018102735
STAT,1802,74,na,1876,449.42278452336535
SIM,1930,22,25-29,1952,112
SIM,1949,16,na,1965,4019
SIM,1911,27,45-49,1938,1
STAT,1806,64,na,1870,832.6866204585106
SIM,1920,19,40-44,1939,2
STAT,1876,31,45-49,1907,1.7076220282400947
SIM,1893,67,na,1960,2031
SIM,1844,10,na,1854,2216
SIM,1895,21,25-29,1916,70
SIM,1913,21,40-44,1934,3
SIM,1848,24,na,1872,1866
STAT,1887,21,25-29,1908,60.66238342831936
STAT,1853,26,25-29,1879,36.60480037157354
SIM,1856,33,35-39,1889,10
STAT,1858,19,50-100,1877,0.041944235766307104
STAT,1893,43,15-19,1936,0.0011411488744882093
SIM,1878,62,na,1940,1814
SIM,1884,31,45-49,1915,2
STAT,1911,32,20-24,1943,2.2433048156574293
STAT,1927,27,30-34,1954,45.00522659471521
STAT,1795,87,na,1882,56.35641152836321
STAT,1855,20,20-24,1875,57.84562450349324
STAT,1929,25,45-49,1954,2.05044026229538
SIM,1841,45,na,1886,1614
SIM,1862,30,25-29,1892,13
SIM,1889,35,45-49,1924,1
STAT,1865,27,na,1892,2048.6985470857535
SIM,1909,21,20-24,1930,92
STAT,1909,30,15-19,1939,0.11674682858661126
STAT,1909,49,35-39,1958,0.11123529807553852
SIM,1918,36,na,1954,3718
SIM,1853,16,25-29,1869,5
STAT,1911,29,na,1940,3425.817174489595
STAT,1886,17,25-29,1903,5.656098525558243
SIM,1835,73,na,1908,705
STAT,1803,106,na,1909,0.004011340707889212
STAT,1883,29,20-24,1912,10.78413385562658
SIM,1840,20,na,1860,1850
STAT,1897,44,40-44,1941,0.1946746183820126
STAT,1854,30,25-29,1884,7.7115996538677
STAT,1935,36,25-29,1971,1.3017671921945504
STAT,1937,22,na,1959,3358.994018607685
SIM,1871,83,na,1954,350
STAT,1886,45,na,1931,2268.008286936647
STAT,1811,44,25-29,1855,2.2648295926443205
STAT,1849,111,na,1960,1.4834067181023058E-4
STAT,1917,40,20-24,1957,0.017458393556825966
STAT,1816,38,20-24,1854,2.8479191553656293
STAT,1831,28,45-49,1859,0.9508734129652695
STAT,1837,43,30-34,1880,0.8454936799959047
SIM,1911,57,na,1968,3185
STAT,1896,24,30-34,1920,22.09998789842215
SIM,1849,18,25-29,1867,9
SIM,1962,4,na,1966,4682
STAT,1829,33,30-34,1862,16.59861806900348
STAT,1861,36,30-34,1897,4.201052419391611
STAT,1881,14,na,1895,2347.994106287391
STAT,1967,4,na,1971,4639.649824782568
SIM,1878,34,25-29,1912,13
SIM,1845,43,30-34,1888,1
SIM,1946,17,40-44,1963,1
STAT,1908,25,na,1933,3366.2768135948954
STAT,1895,2,na,1897,3286.225005107475
STAT,1874,20,25-29,1894,55.602229933425
SIM,1859,25,30-34,1884,31
SIM,1894,17,25-29,1911,11
STAT,1907,40,na,1947,3250.312937204499
SIM,1854,20,25-29,1874,57
SIM,1863,20,20-24,1883,65
SIM,1841,22,35-39,1863,5
STAT,1903,22,20-24,1925,92.62066970371035
SIM,1861,15,15-19,1876,4
STAT,1765,107,na,1872,0.007266465591084875
STAT,1901,17,15-19,1918,7.847179066284962
SIM,1861,26,25-29,1887,43
STAT,1814,50,50-100,1864,0.04079122017922625
SIM,1911,22,20-24,1933,105
STAT,1828,40,25-29,1868,0.5857929351320923
STAT,1845,16,25-29,1861,5.07484619514889
STAT,1825,86,na,1911,125.44749060646355
STAT,1895,31,25-29,1926,12.678682673314514
SIM,1873,90,na,1963,135
STAT,1902,6,na,1908,3482.659305715318
STAT,1853,15,15-19,1868,5.357169691428191
SIM,1816,94,na,1910,3
STAT,1837,28,na,1865,1740.123873340689
SIM,1927,17,30-34,1944,17
SIM,1873,30,30-34,1903,22
SIM,1878,34,30-34,1912,19
STAT,1949,18,25-29,1967,47.60145412345928
STAT,1903,30,50-100,1933,1.2413629948160723
SIM,1911,16,35-39,1927,3
STAT,1955,16,na,1971,4616.954317539695
STAT,1861,13,na,1874,2142.716557344837
STAT,1899,55,na,1954,2676.8898369692924
STAT,1922,22,25-29,1944,100.07532775170368
STAT,1923,9,na,1932,4416.354910129619
STAT,1938,17,40-44,1955,1.3032887882098312
STAT,1858,108,na,1966,0.011345767347383334
STAT,1889,34,35-39,1923,11.709793252869673
STAT,1820,35,50-100,1855,3.273351074182908
STAT,1800,54,20-24,1854,0.002068925284785127
STAT,1854,83,na,1937,285.86804317308884
STAT,1845,52,25-29,1897,0.0024816460262445093
SIM,1889,24,35-39,1913,8
SIM,1879,15,30-34,1894,2
SIM,1879,47,na,1926,2203
SIM,1906,25,50-100,1931,5
STAT,1872,26,35-39,1898,9.180533620251786
SIM,1858,61,na,1919,1517
SIM,1875,33,na,1908,2269
SIM,1789,71,na,1860,589
SIM,1924,34,50-100,1958,6
SIM,1871,36,40-44,1907,5
STAT,1952,11,na,1963,4447.857271205165
STAT,1856,43,40-44,1899,1.6522036797577255
STAT,1915,46,25-29,1961,0.05061636965391752
SIM,1904,26,50-100,1930,4
STAT,1920,28,35-39,1948,15.50465535831725
STAT,1955,15,45-49,1970,0.6267551887709877
STAT,1815,84,na,1899,142.38026277680007
STAT,1928,41,35-39,1969,0.2428818252129945
SIM,1853,30,na,1883,2000
SIM,1890,2,na,1892,3173
SIM,1782,92,na,1874,5
STAT,1842,58,na,1900,1408.2720551655098
SIM,1876,95,na,1971,65
SIM,1861,65,na,1926,1429
STAT,1876,46,na,1922,2200.3990148006123
SIM,1859,34,20-24,1893,2
SIM,1878,43,50-100,1921,2
STAT,1839,51,na,1890,1442.541299208887
STAT,1849,17,45-49,1866,0.05795649355647516
STAT,1895,44,30-34,1939,0.09709246806990993
STAT,1937,24,35-39,1961,8.655053465616794
STAT,1833,45,15-19,1878,2.925064166808301E-4
STAT,1880,51,na,1931,2150.485550735015
STAT,1924,36,25-29,1960,1.0979202937655528
STAT,1846,33,25-29,1879,8.44618107844622
SIM,1838,41,na,1879,1562
SIM,1880,20,20-24,1900,62
SIM,1934,9,na,1943,5040
SIM,1867,37,50-100,1904,3
SIM,1859,24,na,1883,2019
STAT,1939,32,45-49,1971,1.5165794196541256
SIM,1834,51,na,1885,1361
STAT,1937,35,45-49,1972,0.6450120375043404
SIM,1904,20,30-34,1924,24
STAT,1897,40,25-29,1937,0.056907586615706295
SIM,1847,43,35-39,1890,2
STAT,1769,104,na,1873,0.02731138859195513
SIM,1816,38,na,1854,1436
STAT,1838,26,35-39,1864,8.4318102937775
STAT,1855,23,30-34,1878,14.631999870205227
SIM,1854,36,40-44,1890,2
SIM,1918,23,15-19,1941,5
SIM,1885,32,na,1917,2263
SIM,1801,61,na,1862,940
SIM,1796,84,na,1880,100
STAT,1864,17,40-44,1881,0.15975132833822958
STAT,1887,9,na,1896,2741.2208437417894
STAT,1840,48,na,1888,1559.9060359165007
SIM,1824,33,na,1857,1569
STAT,1865,83,na,1948,340.7914352135962
STAT,1941,27,na,1968,3660.6560302359576
SIM,1805,75,na,1880,418
SIM,1927,13,na,1940,4567
STAT,1827,66,na,1893,909.567572582642
SIM,1854,22,15-19,1876,4
SIM,1932,36,25-29,1968,2
STAT,1857,109,na,1966,0.004312979252017491
SIM,1782,89,na,1871,31
SIM,1851,44,na,1895,1697
STAT,1900,29,na,1929,3105.397731554581
STAT,1926,34,30-34,1960,17.97596056555472
SIM,1883,68,na,1951,1368
SIM,1913,25,35-39,1938,15
STAT,1854,43,na,1897,1652.2878012661836
SIM,1906,51,na,1957,3066
STAT,1853,98,na,1951,2.409143588647781
SIM,1861,26,30-34,1887,29
STAT,1905,25,35-39,1930,13.261652089584802
SIM,1854,33,25-29,1887,15
STAT,1928,42,40-44,1970,0.30125766855330016
STAT,1902,42,20-24,1944,0.014684260405511481
STAT,1931,26,15-19,1957,0.8614159269238956
SIM,1920,15,25-29,1935,47
STAT,1856,32,50-100,1888,0.6862246325142146
STAT,1912,15,25-29,1927,8.314757429054547
STAT,1891,39,20-24,1930,0.892287012782927
STAT,1911,46,50-100,1957,0.20273963456182917
STAT,1839,43,35-39,1882,1.2563472487300054
STAT,1853,26,30-34,1879,21.79071988906572
SIM,1873,47,na,1920,2163
STAT,1846,22,15-19,1868,2.8700255761913844
STAT,1928,31,30-34,1959,18.623215130309905
STAT,1949,15,20-24,1964,149.04924565103005
STAT,1832,42,40-44,1874,1.6686155373941185
STAT,1824,48,20-24,1872,0.013903863267205628
STAT,1863,45,30-34,1908,0.08118542929246916
SIM,1871,33,30-34,1904,20
SIM,1827,78,na,1905,398
SIM,1934,34,30-34,1968,24
SIM,1864,70,na,1934,1271
SIM,1909,36,25-29,1945,1
SIM,1784,99,na,1883,1
STAT,1827,36,30-34,1863,5.461071910910221
STAT,1830,92,na,1922,24.879338801993118
STAT,1899,19,25-29,1918,7.29688032501434
STAT,1863,17,na,1880,2175.115233205825
SIM,1900,25,25-29,1925,59
SIM,1846,26,35-39,1872,8
SIM,1898,9,na,1907,3279
SIM,1915,21,45-49,1936,5
SIM,1848,34,45-49,1882,2
SIM,1902,33,35-39,1935,2
STAT,1854,28,50-100,1882,0.4794324099387449
STAT,1883,29,15-19,1912,0.41706595356164394
SIM,1837,21,30-34,1858,22
SIM,1937,34,na,1971,3390
SIM,1788,89,na,1877,31
SIM,1917,14,na,1931,3969
STAT,1882,32,50-100,1914,0.8422587891621557
STAT,1852,47,20-24,1899,0.00907476333882217
STAT,1918,24,na,1942,3697.3525175626005
SIM,1884,20,35-39,1904,7
STAT,1816,38,15-19,1854,0.20746433543355386
SIM,1848,23,35-39,1871,7
STAT,1854,43,30-34,1897,0.8218891128690234
STAT,1851,105,na,1956,0.026634669207478152
SIM,1813,89,na,1902,43
STAT,1909,50,na,1959,3159.547319548179
STAT,1917,45,15-19,1962,3.651805422811592E-4
SIM,1904,31,40-44,1935,2
STAT,1835,30,15-19,1865,0.1154950472679184
STAT,1917,20,50-100,1937,0.6645631712892707
STAT,1852,3,na,1855,2596.2368
STAT,1893,39,na,1932,2795.490548579734
STAT,1915,21,50-100,1936,0.644424955519924
SIM,1863,23,30-34,1886,19
SIM,1913,24,na,1937,3343
STAT,1816,42,50-100,1858,3.1590788508580636
STAT,1887,34,25-29,1921,10.72862841710085
STAT,1894,27,30-34,1921,30.6015548205451
SIM,1859,22,20-24,1881,58
SIM,1895,34,25-29,1929,13
SIM,1913,28,50-100,1941,5
SIM,1863,32,na,1895,2054
STAT,1900,44,15-19,1944,0.0012398680585682046
SIM,1830,44,30-34,1874,1
SIM,1847,39,na,1886,1679
SIM,1903,19,35-39,1922,5
STAT,1800,94,na,1894,7.96660056030372
STAT,1822,97,na,1919,2.774940120317757
STAT,1875,50,45-49,1925,0.014287254836681982
SIM,1882,23,35-39,1905,4
STAT,1918,33,20-24,1951,2.438204659680414
STAT,1900,39,40-44,1939,1.2258416628065674
SIM,1945,24,35-39,1969,13
STAT,1841,47,45-49,1888,0.1622012162892329
SIM,1926,33,20-24,1959,2
STAT,1855,84,na,1939,235.60431206130394
STAT,1835,49,35-39,1884,0.08974441238501589
STAT,1789,99,na,1888,0.32818606946051276
STAT,1931,15,35-39,1946,5.212800562691607
SIM,1950,19,20-24,1969,151
SIM,1926,21,20-24,1947,123
STAT,1862,50,50-100,1912,0.01234526020677441
STAT,1865,33,35-39,1898,8.656840817350739
STAT,1878,40,15-19,1918,0.013718352128887135
STAT,1857,106,na,1963,0.04200091867900052
STAT,1836,23,20-24,1859,57.019772800651026
SIM,1943,21,20-24,1964,104
STAT,1885,42,50-100,1927,0.9930865518367656
SIM,1805,78,na,1883,300
STAT,1822,47,35-39,1869,0.19529889088241154
STAT,1873,43,40-44,1916,2.1412687352973694
STAT,1843,59,na,1902,1402.1226796349497
SIM,1907,27,25-29,1934,62
SIM,1933,19,20-24,1952,156
STAT,1850,49,30-34,1899,0.06672455814032649
STAT,1906,40,45-49,1946,0.14440931131876825
STAT,1852,30,50-100,1882,0.735892831013928
SIM,1822,63,na,1885,967
STAT,1901,19,35-39,1920,0.7216599604914908
STAT,1850,38,20-24,1888,0.5455783820714736
SIM,1918,25,40-44,1943,9
STAT,1942,19,20-24,1961,133.74929608249946
STAT,1921,45,35-39,1966,0.1379640734414483
STAT,1821,56,na,1877,1199.8539356045317
STAT,1829,36,na,1865,1695.7071062160276
SIM,1937,23,25-29,1960,83
STAT,1787,95,na,1882,2.5283951678384744
STAT,1831,25,40-44,1856,2.8088909829549507
SIM,1881,43,40-44,1924,3
STAT,1906,42,35-39,1948,0.17276523048912654
SIM,1801,64,na,1865,849
STAT,1858,50,45-49,1908,0.010917502515230541
SIM,1940,30,45-49,1970,1
SIM,1852,85,na,1937,171
STAT,1931,26,45-49,1957,2.1080613599902644
STAT,1900,32,15-19,1932,0.18663800589880458
SIM,1919,34,35-39,1953,8
STAT,1918,21,20-24,1939,113.63304222555708
SIM,1835,36,30-34,1871,7
SIM,1895,31,20-24,1926,4
STAT,1818,73,na,1891,572.6434924174208
STAT,1898,30,na,1928,3076.2086731968475
SIM,1844,23,20-24,1867,58
SIM,1831,86,na,1917,114
STAT,1818,41,50-100,1859,2.636009476019182
STAT,1898,42,50-100,1940,0.0937020351406818
SIM,1871,43,na,1914,2206
SIM,1875,57,na,1932,1943
STAT,1920,23,35-39,1943,9.858874163162229
STAT,1923,26,50-100,1949,1.083368249033695
SIM,1864,43,40-44,1907,7
STAT,1929,23,25-29,1952,110.01391035797624
SIM,1887,27,35-39,1914,12
STAT,1879,27,35-39,1906,9.527661494336627
STAT,1865,34,50-100,1899,0.7798121668613889
STAT,1935,21,20-24,1956,143.08481592837657
SIM,1928,36,35-39,1964,10
STAT,1902,48,40-44,1950,0.12712585972164547
SIM,1920,1,na,1921,4251
SIM,1840,28,50-100,1868,1
STAT,1842,21,50-100,1863,0.3689195691124579
STAT,1861,20,15-19,1881,2.697355656663372
STAT,1905,36,45-49,1941,0.5902215834052632
STAT,1925,19,20-24,1944,153.906226928882
STAT,1926,46,30-34,1972,0.10418217506001862
STAT,1852,45,25-29,1897,0.04419918402429039
STAT,1852,33,na,1885,1857.8085691718852
SIM,1882,9,na,1891,2380
STAT,1877,16,15-19,1893,5.832029352951447
STAT,1914,27,20-24,1941,17.380999095781508
SIM,1887,42,na,1929,2404
SIM,1876,37,30-34,1913,8
SIM,1871,39,45-49,1910,1
STAT,1912,14,na,1926,3759.5656006537706
SIM,1803,71,na,1874,548
STAT,1922,36,45-49,1958,0.7335264474761447
STAT,1941,30,40-44,1971,3.8855275363845285
SIM,1907,29,20-24,1936,18
STAT,1932,30,45-49,1962,1.9784265669266745
SIM,1844,19,30-34,1863,2
STAT,1893,48,20-24,1941,0.008011485791160677
SIM,1890,33,40-44,1923,7
SIM,1840,42,40-44,1882,3
SIM,1895,37,40-44,1932,6
STAT,1846,36,40-44,1882,3.2567701944157217
SIM,1889,20,40-44,1909,4
STAT,1872,23,25-29,1895,54.11269442601194
SIM,1849,81,na,1930,324
STAT,1799,77,na,1876,348.9231643432047
SIM,1922,27,20-24,1949,22
SIM,1900,29,35-39,1929,14
STAT,1909,46,30-34,1955,0.07755707112653441
STAT,1887,37,40-44,1924,4.624816501596129
STAT,1944,23,20-24,1967,113.37786716977078
STAT,1866,24,45-49,1890,0.6035572678353266
STAT,1922,25,35-39,1947,16.159206004653857
STAT,1882,33,40-44,1915,3.9697038038643297
SIM,1888,83,na,1971,818
SIM,1897,57,na,1954,2562
STAT,1876,43,na,1919,2237.76630631382
SIM,1930,36,45-49,1966,3
STAT,1920,25,30-34,1945,40.882682307270045
STAT,1874,46,15-19,1920,3.873088159194006E-4
STAT,1893,46,25-29,1939,0.03905503918229415
STAT,1944,9,na,1953,4006.7694009089582
SIM,1828,63,na,1891,935
STAT,1806,52,40-44,1858,0.02972502591002998
STAT,1868,37,30-34,1905,4.80715675835685
STAT,1889,33,50-100,1922,1.0640820818545762
STAT,1901,25,20-24,1926,15.617585836351486
SIM,1839,63,na,1902,1288
STAT,1845,52,50-100,1897,0.010581462992107271
STAT,1909,10,na,1919,3668.816120706844
SIM,1906,46,50-100,1952,2
SIM,1930,24,45-49,1954,1
STAT,1857,46,15-19,1903,2.9874585336668634E-4
STAT,1866,68,na,1934,1331.0433059662525
STAT,1870,29,50-100,1899,0.5879115661715623
STAT,1916,20,na,1936,3636.402233886916
SIM,1829,88,na,1917,65
STAT,1882,45,40-44,1927,0.1589445792440763
STAT,1925,17,25-29,1942,49.45966057718389
SIM,1868,17,20-24,1885,20
SIM,1877,6,na,1883,2635
SIM,1803,68,na,1871,694
STAT,1837,34,40-44,1871,3.3619013849509347
STAT,1804,105,na,1909,0.009936163217637656
STAT,1929,27,50-100,1956,1.1768812746928823
SIM,1924,29,20-24,1953,20
STAT,1833,41,na,1874,1566.322060524461
STAT,1852,49,40-44,1901,0.12735720018704833
STAT,1921,40,40-44,1961,0.26690138650387135
SIM,1932,33,20-24,1965,2
SIM,1810,78,na,1888,310
STAT,1916,29,20-24,1945,17.70206572113301
SIM,1823,42,40-44,1865,7
SIM,1868,4,na,1872,2548
STAT,1859,58,na,1917,1490.9592816714635
STAT,1853,18,na,1871,2035.716334127697
STAT,1922,24,45-49,1946,1.2114085029497144
STAT,1842,28,15-19,1870,0.39667700523462407
SIM,1933,17,25-29,1950,58
STAT,1815,54,40-44,1869,0.023523931306241034
STAT,1836,19,30-34,1855,1.894473089590542
STAT,1952,20,45-49,1972,1.278937948901092
SIM,1816,78,na,1894,286
STAT,1841,44,40-44,1885,1.5586915452136862
SIM,1842,30,na,1872,1811
STAT,1860,46,50-100,1906,0.18909713742992015
STAT,1856,47,na,1903,1656.8830118497422
SIM,1934,30,45-49,1964,2
SIM,1852,48,na,1900,1719
STAT,1877,53,50-100,1930,0.01456776386113784
SIM,1862,43,30-34,1905,1
STAT,1902,34,15-19,1936,0.10807886040545087
STAT,1818,52,na,1870,1251.854706425197
STAT,1838,23,30-34,1861,15.648484004742523
STAT,1843,40,na,1883,1761.3945143619255
STAT,1915,40,40-44,1955,0.23852956929898486
SIM,1882,39,20-24,1921,4
SIM,1870,98,na,1968,9
STAT,1870,26,30-34,1896,23.390110513268052
STAT,1924,33,20-24,1957,2.6869184190590194
SIM,1896,35,na,1931,3015
STAT,1849,17,50-100,1866,0.043467370167356384
SIM,1904,23,35-39,1927,6
SIM,1904,34,45-49,1938,1
SIM,1885,72,na,1957,1225
STAT,1925,30,50-100,1955,0.9286774821524075
STAT,1937,21,30-34,1958,26.44548072590676
SIM,1880,23,25-29,1903,60
SIM,1868,15,30-34,1883,4
SIM,1909,24,30-34,1933,28
SIM,1841,85,na,1926,145
STAT,1892,19,15-19,1911,6.982963731081259
SIM,1945,21,30-34,1966,35
STAT,1863,48,35-39,1911,0.11479711727968044
SIM,1854,30,20-24,1884,2
STAT,1855,35,50-100,1890,0.8777906525571055
STAT,1811,48,40-44,1859,0.5602924246569555
STAT,1874,39,20-24,1913,0.7367880705344513
SIM,1903,16,30-34,1919,2
STAT,1909,31,50-100,1940,0.7482001642085272
SIM,1886,31,25-29,1917,9
STAT,1902,45,25-29,1947,0.043747416438670056
SIM,1868,1,na,1869,3058
STAT,1855,26,35-39,1881,7.1745329377724385
STAT,1831,55,na,1886,1282.964934308118
SIM,1909,35,40-44,1944,3
STAT,1802,54,30-34,1856,0.01629910875325836
STAT,1926,30,45-49,1956,1.7997343654487128
SIM,1873,33,35-39,1906,11
STAT,1863,39,45-49,1902,1.638757388709738
SIM,1904,47,na,1951,2985
SIM,1900,24,50-100,1924,1
STAT,1846,30,20-24,1876,2.2995044744801643
SIM,1901,36,na,1937,3217
STAT,1868,32,na,1900,2152.3977630155023
SIM,1825,74,na,1899,559
SIM,1865,20,25-29,1885,56
STAT,1806,67,na,1873,744.5631057270414
SIM,1893,21,15-19,1914,6
STAT,1940,17,20-24,1957,130.02868062523984
STAT,1885,21,15-19,1906,3.1143475093965813
STAT,1849,24,45-49,1873,0.59899125067947
STAT,1870,73,na,1943,1099.4663995037909
STAT,1877,18,35-39,1895,0.5364995677151189
STAT,1939,26,na,1965,3558.9287207415973
SIM,1853,70,na,1923,1088
STAT,1841,92,na,1933,28.496178181659342
STAT,1911,23,30-34,1934,25.665228371989212
STAT,1853,58,na,1911,1466.6017819916653
STAT,1861,8,na,1869,2214.1719878136773
STAT,1888,18,40-44,1906,0.20358687172955411
SIM,1895,0,na,1895,3442
STAT,1844,84,na,1928,233.53261497176032
STAT,1876,46,25-29,1922,0.0563342008869288
SIM,1863,26,35-39,1889,12
SIM,1880,26,40-44,1906,2
STAT,1856,50,35-39,1906,0.00646132772495842
STAT,1842,18,na,1860,2086.6948998618705
SIM,1839,66,na,1905,1179
STAT,1857,39,15-19,1896,0.04140024216169844
SIM,1913,33,40-44,1946,8
STAT,1868,22,20-24,1890,62.15748681758057
SIM,1926,36,25-29,1962,1
STAT,1811,46,20-24,1857,0.04064871893386849
STAT,1862,16,25-29,1878,5.260961524405804
STAT,1916,23,15-19,1939,5.253020596768033
STAT,1887,31,20-24,1918,2.8674426566359363
STAT,1878,31,25-29,1909,10.114280206960693
STAT,1905,22,30-34,1927,24.316534874974984
STAT,1932,32,35-39,1964,11.476527037827136
SIM,1898,25,45-49,1923,2
STAT,1844,36,30-34,1880,4.390013050446739
SIM,1913,21,na,1934,3356
SIM,1829,27,40-44,1856,1
STAT,1935,34,35-39,1969,11.927627615716037
SIM,1876,22,20-24,1898,71
SIM,1819,44,40-44,1863,7
SIM,1859,28,35-39,1887,6
STAT,1928,34,35-39,1962,10.781736313851274
SIM,1777,89,na,1866,23
STAT,1806,104,na,1910,0.022194339630498224
STAT,1948,22,45-49,1970,1.2205519417304918
SIM,1849,19,15-19,1868,3
STAT,1832,45,45-49,1877,0.17356505296359895
SIM,1917,31,50-100,1948,4
SIM,1923,40,40-44,1963,2
STAT,1865,43,na,1908,1969.7393417230603
STAT,1905,33,40-44,1938,3.385086285854015
STAT,1863,36,40-44,1899,3.652633913377589
STAT,1907,24,na,1931,3260.8846917196547
SIM,1837,48,50-100,1885,1
SIM,1846,23,30-34,1869,16
STAT,1765,89,na,1854,32.0
SIM,1784,96,na,1880,1
SIM,1830,38,45-49,1868,1
STAT,1831,41,50-100,1872,0.8153873597060151
STAT,1921,28,na,1949,3930.640384350328
SIM,1924,23,15-19,1947,3
STAT,1876,83,na,1959,506.11619150218326
STAT,1888,71,na,1959,1606.1902432520642
STAT,1962,6,na,1968,4757.049041279656
STAT,1929,38,20-24,1967,0.31940913063789145
SIM,1830,45,na,1875,1597
SIM,1839,30,25-29,1869,12
SIM,1852,36,30-34,1888,6
STAT,1829,36,35-39,1865,6.4257092319605205
SIM,1935,25,40-44,1960,7
STAT,1937,32,40-44,1969,3.657027098504923
SIM,1863,69,na,1932,1207
STAT,1898,21,25-29,1919,73.42824901996038
STAT,1868,102,na,1970,2.31249474739307
SIM,1882,83,na,1965,563
STAT,1833,38,20-24,1871,0.5805752318773798
STAT,1842,55,na,1897,1472.444853243146
SIM,1859,37,25-29,1896,2
STAT,1928,43,25-29,1971,0.08587166984562233
STAT,1813,42,30-34,1855,4.090473180800833
STAT,1907,32,50-100,1939,0.7299578264812815
STAT,1907,46,20-24,1953,0.009418428828362097
SIM,1935,8,na,1943,5134
SIM,1852,20,15-19,1872,3
SIM,1915,32,50-100,1947,1
STAT,1821,53,50-100,1874,0.021732868866603715
STAT,1822,38,45-49,1860,3.4294893176924144
SIM,1913,22,30-34,1935,35
SIM,1850,81,na,1931,358
STAT,1897,45,na,1942,2871.3555090307905
SIM,1851,5,na,1856,2278
STAT,1844,81,na,1925,379.62164713330657
STAT,1880,33,30-34,1913,17.281693750195636
STAT,1878,27,50-100,1905,0.6291070946625295
STAT,1820,34,25-29,1854,31.56506043181187
SIM,1895,3,na,1898,3303
STAT,1856,5,na,1861,2199.920391137516
STAT,1921,42,30-34,1963,0.13604319156352718
STAT,1913,8,na,1921,3838.857499213668
SIM,1849,25,na,1874,1894
STAT,1841,24,50-100,1865,0.34838875247712486
STAT,1864,58,na,1922,1669.7068398508723
STAT,1933,36,20-24,1969,0.3395085387127898
SIM,1922,19,15-19,1941,55
STAT,1833,49,30-34,1882,0.061197021969682346
SIM,1895,23,15-19,1918,8
SIM,1866,18,25-29,1884,5
STAT,1922,21,40-44,1943,3.653859929361933
STAT,1847,46,50-100,1893,0.18122277303364484
SIM,1845,30,25-29,1875,18
STAT,1916,23,45-49,1939,1.110341892746671
STAT,1843,99,na,1942,1.3663405684600571
SIM,1826,37,na,1863,1615
SIM,1882,20,30-34,1902,16
SIM,1887,24,30-34,1911,21
STAT,1873,46,45-49,1919,0.22694487969778096
STAT,1822,44,30-34,1866,1.643953833142766
STAT,1891,35,na,1926,2781.023186731661
STAT,1935,24,25-29,1959,118.7405539277705
SIM,1918,27,30-34,1945,45
STAT,1891,23,35-39,1914,6.80238157897792
STAT,1786,70,na,1856,616.2846678399999
STAT,1882,48,45-49,1930,0.2142171201037159
STAT,1887,23,15-19,1910,3.4746375072726408
STAT,1824,32,35-39,1856,23.456809402614777
STAT,1804,108,na,1912,6.207328834448226E-4
STAT,1879,24,30-34,1903,17.47831323941324
SIM,1848,40,na,1888,1755
SIM,1832,32,35-39,1864,7
STAT,1890,50,na,1940,2522.7747452836743
STAT,1954,15,na,1969,4300.752138807087
STAT,1927,25,40-44,1952,5.390009083706755
SIM,1804,53,na,1857,1100
STAT,1905,36,15-19,1941,0.01662596207315617
SIM,1943,24,25-29,1967,95
STAT,1921,50,na,1971,3877.5369156371894
SIM,1895,36,50-100,1931,4
STAT,1887,36,50-100,1923,1.30334900285587
STAT,1933,16,na,1949,4666.192238120354
SIM,1870,16,25-29,1886,8
STAT,1818,49,35-39,1867,0.29008415535517856
STAT,1906,35,50-100,1941,0.3679949607437589
STAT,1914,19,45-49,1933,0.09707814128640695
STAT,1924,34,20-24,1958,2.685118183718251
STAT,1918,36,25-29,1954,0.9850972638582234
STAT,1907,21,45-49,1928,0.9704316996101265
SIM,1924,23,45-49,1947,1
SIM,1858,39,na,1897,1890
STAT,1926,30,15-19,1956,0.14697369129305612
STAT,1869,54,30-34,1923,0.005293545030280509
STAT,1930,41,50-100,1971,0.1462429856466386
SIM,1930,21,40-44,1951,3
SIM,1946,15,45-49,1961,1
SIM,1909,33,20-24,1942,1
STAT,1811,97,na,1908,2.3269821647836086
STAT,1957,3,na,1960,4898.844790809945
SIM,1817,63,na,1880,985
SIM,1794,74,na,1868,432
SIM,1862,28,50-100,1890,1
SIM,1897,20,na,1917,3018
SIM,1798,88,na,1886,47
SIM,1952,3,na,1955,4397
SIM,1900,22,20-24,1922,84
STAT,1906,39,na,1945,3233.6010141662987
SIM,1904,33,45-49,1937,1
STAT,1943,20,50-100,1963,0.6617729576239305
SIM,1890,40,35-39,1930,4
SIM,1928,33,30-34,1961,24
STAT,1829,92,na,1921,25.5289517530401
SIM,1844,15,15-19,1859,4
STAT,1887,6,na,1893,2759.946403892625
SIM,1854,55,na,1909,1633
STAT,1902,44,25-29,1946,0.05864623248702673
STAT,1919,49,na,1968,3742.284820193172
STAT,1938,15,45-49,1953,0.4676227641399967
STAT,1848,43,50-100,1891,0.7555948370812782
STAT,1881,16,35-39,1897,0.5017309812858709
SIM,1844,26,25-29,1870,38
STAT,1913,32,25-29,1945,8.685164621222139
STAT,1833,103,na,1936,0.0871265399386427
SIM,1888,44,35-39,1932,2
SIM,1921,32,25-29,1953,10
STAT,1807,48,20-24,1855,0.04371806540517139
STAT,1832,96,na,1928,5.191995658472826
STAT,1837,49,45-49,1886,0.15073834123584984
STAT,1955,17,40-44,1972,1.7539849732279238
STAT,1868,94,na,1962,42.981274104764864
STAT,1840,17,50-100,1857,0.04417450762962277
STAT,1857,20,25-29,1877,49.932629637275525
STAT,1903,29,40-44,1932,3.997361346396194
SIM,1852,29,na,1881,1917
STAT,1858,18,25-29,1876,4.880295858757598
STAT,1914,19,15-19,1933,8.819550920557896
STAT,1910,49,50-100,1959,0.19812779513629336
STAT,1931,23,40-44,1954,4.107079919654185
STAT,1944,26,25-29,1970,67.233064503277
STAT,1872,20,20-24,1892,65.7328590641894
SIM,1878,22,30-34,1900,25
SIM,1919,31,30-34,1950,25
STAT,1837,30,25-29,1867,8.276995354736625
STAT,1906,61,na,1967,2808.459945405554
STAT,1847,17,40-44,1864,0.16796660359978557
SIM,1886,57,na,1943,1932
STAT,1882,40,35-39,1922,1.6813870160619728
SIM,1802,86,na,1888,57
SIM,1911,29,40-44,1940,8
STAT,1901,16,30-34,1917,2.1127289586519473
STAT,1861,43,50-100,1904,0.8227750574557181
SIM,1908,9,na,1917,3566
SIM,1775,82,na,1857,158
SIM,1950,16,na,1966,4022
STAT,1836,26,25-29,1862,34.8154113856139
STAT,1878,4,na,1882,2835.724833817947
STAT,1830,30,na,1860,1710.142139746169
SIM,1919,42,40-44,1961,3
SIM,1900,38,25-29,1938,1
STAT,1808,74,na,1882,488.97948808656474
STAT,1828,53,30-34,1881,0.0043192416336297395
STAT,1880,46,45-49,1926,0.23524965434010167
STAT,1850,22,35-39,1872,4.930867013447761
STAT,1888,31,na,1919,2674.0306718818297
SIM,1795,59,na,1854,948
STAT,1841,33,na,1874,1780.5136888022605
STAT,1953,15,40-44,1968,1.5993077755595617
STAT,1864,98,na,1962,7.456169355465769
STAT,1868,33,15-19,1901,0.12790639874961038
SIM,1892,30,35-39,1922,11
SIM,1883,12,na,1895,2457
SIM,1921,23,35-39,1944,10
STAT,1934,19,25-29,1953,55.07520597961797
STAT,1918,36,30-34,1954,1.8234779239600578
SIM,1862,34,40-44,1896,4
STAT,1836,50,25-29,1886,0.0023546057382913613
STAT,1913,49,na,1962,3366.84133154939
STAT,1883,77,na,1960,956.1498341488051
SIM,1766,101,na,1867,1
STAT,1818,36,na,1854,1455.0196721109264
STAT,1852,49,35-39,1901,0.10414724338378978
STAT,1866,36,15-19,1902,0.04914541408662432
STAT,1879,17,25-29,1896,5.595509464774444
STAT,1838,50,na,1888,1519.713846655529
SIM,1800,60,na,1860,976
STAT,1814,46,na,1860,1283.3640862162997
STAT,1891,20,25-29,1911,67.33706697419368
STAT,1880,43,40-44,1923,2.2196258866857277
SIM,1942,19,25-29,1961,49
STAT,1905,28,50-100,1933,0.8702055880881769
STAT,1921,42,25-29,1963,0.07598808929233448
SIM,1923,31,45-49,1954,1
STAT,1940,16,45-49,1956,0.47923755601198675
SIM,1885,15,25-29,1900,8
STAT,1884,30,35-39,1914,9.53001110684101
STAT,1900,47,25-29,1947,0.04238409960468831
STAT,1921,44,na,1965,3938.9149419343357
STAT,1930,20,30-34,1950,34.99248093367953
SIM,1863,85,na,1948,186
STAT,1822,47,40-44,1869,0.2388226431568823
STAT,1919,15,40-44,1934,0.29432134484548783
SIM,1888,21,na,1909,2565
STAT,1861,24,30-34,1885,14.149933334173854
STAT,1870,19,30-34,1889,1.471956892347978
STAT,1898,8,na,1906,3324.3697438010604
SIM,1939,7,na,1946,3707
STAT,1750,120,na,1870,5.6574727896812E-4
SIM,1821,68,na,1889,824
SIM,1874,17,15-19,1891,6
SIM,1937,15,40-44,1952,1
STAT,1915,31,45-49,1946,1.5200341158861146
SIM,1878,38,40-44,1916,9
STAT,1851,32,na,1883,1821.3542443338258
SIM,1844,50,50-100,1894,1
STAT,1908,62,na,1970,2856.4105785369143
STAT,1834,60,na,1894,1180.461035366537
SIM,1871,27,na,1898,2294
SIM,1793,73,na,1866,411
SIM,1869,88,na,1957,127
SIM,1909,39,35-39,1948,11
STAT,1871,43,30-34,1914,1.068936312300053
STAT,1822,107,na,1929,0.0024359454787981068
STAT,1805,85,na,1890,91.7880117967061
STAT,1873,51,25-29,1924,0.0034127164507257715
STAT,1854,34,40-44,1888,3.1322522782000415
STAT,1951,16,20-24,1967,152.56646176404672
STAT,1909,41,30-34,1950,0.11358663704836927
SIM,1926,36,30-34,1962,2
STAT,1872,27,40-44,1899,2.84040059688922
STAT,1913,23,35-39,1936,8.95254260469692
STAT,1856,63,na,1919,1320.1959878846021
STAT,1804,52,30-34,1856,0.017701320016314092
SIM,1842,19,20-24,1861,19
STAT,1877,5,na,1882,2674.7031589977773
STAT,1944,26,30-34,1970,40.02362698341953
SIM,1920,31,na,1951,3849
SIM,1875,70,na,1945,1280
STAT,1817,88,na,1905,60.88022214966784
STAT,1864,53,40-44,1917,0.00874589165624119
STAT,1909,34,25-29,1943,8.258684315301101
SIM,1832,71,na,1903,810
SIM,1927,15,40-44,1942,5
STAT,1870,27,na,1897,2209.1317543000837
STAT,1892,26,15-19,1918,0.5385751107520912
STAT,1826,65,na,1891,922.4105048666208
STAT,1861,35,25-29,1896,2.2801137811345114
STAT,1929,37,45-49,1966,0.8268567569380547
STAT,1920,20,30-34,1940,30.366722378696124
SIM,1875,54,50-100,1929,1
STAT,1854,40,50-100,1894,0.7684210955232251
SIM,1832,44,50-100,1876,3
STAT,1872,39,50-100,1911,1.1524318819922212
STAT,1925,34,na,1959,4237.836137695177
STAT,1850,50,na,1900,1537.6182313548084
STAT,1926,31,20-24,1957,2.7881925699978103
SIM,1888,43,na,1931,2507
STAT,1843,40,15-19,1883,0.010524463327888148
STAT,1927,29,35-39,1956,17.175151936656157
SIM,1912,30,30-34,1942,12
STAT,1878,48,50-100,1926,0.23850103223494507
STAT,1849,43,50-100,1892,0.7559800640412496
STAT,1856,40,25-29,1896,0.4799223438029574
STAT,1786,73,na,1859,463.756218986048
SIM,1915,37,25-29,1952,5
SIM,1910,59,na,1969,2961
STAT,1877,51,25-29,1928,0.0034889089836405017
SIM,1822,38,50-100,1860,4
STAT,1878,40,20-24,1918,0.15776104096139118
SIM,1917,34,25-29,1951,13
STAT,1899,15,45-49,1914,0.08496030731210108
STAT,1859,46,25-29,1905,0.04354934805849205
STAT,1835,34,30-34,1869,13.584035281017835
STAT,1927,40,50-100,1967,0.13959016237198116
STAT,1825,83,na,1908,224.45411439027512
STAT,1867,40,45-49,1907,1.3409157206895235
SIM,1935,29,35-39,1964,23
STAT,1904,30,30-34,1934,23.844969532362533
SIM,1867,75,na,1942,854
SIM,1870,79,na,1949,580
SIM,1941,17,na,1958,3486
STAT,1872,26,50-100,1898,0.6086393442735877
STAT,1930,42,35-39,1972,0.25030716279378484
STAT,1825,35,15-19,1860,0.07775882714647014
STAT,1854,53,40-44,1907,0.007459180148065682
STAT,1922,48,15-19,1970,3.987000899501172E-4
STAT,1853,29,40-44,1882,2.3084188726448636
STAT,1848,21,35-39,1869,5.155840222056335
SIM,1934,31,20-24,1965,3
STAT,1840,16,40-44,1856,0.16589532538777438
SIM,1856,21,35-39,1877,9
SIM,1875,40,45-49,1915,4
SIM,1861,84,na,1945,240
SIM,1873,30,25-29,1903,9
SIM,1890,65,na,1955,1953
SIM,1905,32,na,1937,3273
SIM,1843,65,na,1908,1196
STAT,1870,22,15-19,1892,3.053805895775703
SIM,1902,23,25-29,1925,83
SIM,1922,26,45-49,1948,3
SIM,1941,27,25-29,1968,66
STAT,1890,43,40-44,1933,2.5792071701446213
STAT,1953,19,35-39,1972,4.792168117680666
SIM,1843,34,30-34,1877,21
STAT,1818,45,25-29,1863,0.12699206691713572
STAT,1765,104,na,1869,0.029526128637826984
STAT,1835,45,25-29,1880,0.04270871032725121
STAT,1844,29,30-34,1873,21.33111849667772
STAT,1871,52,na,1923,2005.800051828473
STAT,1871,49,45-49,1920,0.21640943689848846
STAT,1805,63,na,1868,885.5854845678224
SIM,1868,17,15-19,1885,6
STAT,1820,48,45-49,1868,0.38346141174566434
STAT,1835,27,50-100,1862,0.5201789337431847
SIM,1892,42,na,1934,2780
STAT,1860,19,30-34,1879,1.3947518526360327
STAT,1900,20,45-49,1920,0.9193552118661055
STAT,1809,45,15-19,1854,0.0015141196148649244
STAT,1933,20,40-44,1953,4.238509907489599
STAT,1870,38,30-34,1908,4.908957757143044
SIM,1877,17,25-29,1894,10
SIM,1852,29,30-34,1881,25
STAT,1839,50,35-39,1889,0.005883113429154548
SIM,1812,85,na,1897,113
STAT,1919,44,35-39,1963,0.205462486713176
SIM,1920,15,30-34,1935,18
SIM,1924,20,40-44,1944,5
SIM,1896,72,na,1968,1912
STAT,1846,33,50-100,1879,0.7555476718023822
SIM,1907,23,15-19,1930,4
SIM,1821,62,na,1883,996
STAT,1841,30,na,1871,1836.8517231904486
SIM,1863,91,na,1954,40
SIM,1916,29,25-29,1945,65
STAT,1876,36,15-19,1912,0.05502862662450632
SIM,1897,33,50-100,1930,1
SIM,1911,20,30-34,1931,31
STAT,1854,32,15-19,1886,0.10501426155073007
STAT,1885,16,50-100,1901,0.046223392350101984
STAT,1903,25,30-34,1928,34.07492330549389
STAT,1873,39,50-100,1912,1.1654438318126106
SIM,1880,22,25-29,1902,53
STAT,1843,34,50-100,1877,0.7783519405699878
SIM,1772,93,na,1865,2
STAT,1831,71,na,1902,814.0482404301367
SIM,1830,98,na,1928,2
SIM,1836,44,40-44,1880,5
STAT,1841,35,50-100,1876,1.010466825156745
STAT,1916,20,40-44,1936,3.348182302646217
STAT,1907,37,25-29,1944,0.8622405832659854
STAT,1776,89,na,1865,29.817654965574782
STAT,1840,52,40-44,1892,0.0072926009663518325
STAT,1889,41,35-39,1930,2.121457271668582
SIM,1852,35,25-29,1887,4
STAT,1827,29,30-34,1856,36.43750166811933
STAT,1832,28,50-100,1860,0.5188359606006445
STAT,1848,34,40-44,1882,3.2474008971471173
SIM,1868,23,na,1891,2130
SIM,1835,29,30-34,1864,23
SIM,1789,74,na,1863,415
SIM,1936,34,35-39,1970,3
SIM,1876,58,na,1934,1928
STAT,1952,14,na,1966,4445.54478348468
SIM,1941,20,40-44,1961,4
STAT,1928,44,45-49,1972,0.19978615244861703
SIM,1926,28,na,1954,4067
SIM,1905,26,45-49,1931,2
STAT,1868,88,na,1956,138.38289500964447
STAT,1923,6,na,1929,4446.5234825399275
STAT,1830,45,35-39,1875,0.10529439388031665
SIM,1931,26,50-100,1957,2
STAT,1874,24,40-44,1898,1.9993877744456614
SIM,1922,44,na,1966,4033
STAT,1876,35,30-34,1911,5.247062685285228
STAT,1941,16,50-100,1957,0.3646319572565344
STAT,1908,29,25-29,1937,58.34674194255949
SIM,1826,93,na,1919,34
STAT,1899,41,35-39,1940,0.1635298741593704
SIM,1932,37,25-29,1969,1
STAT,1871,30,25-29,1901,9.669751052165559
SIM,1861,19,30-34,1880,1
STAT,1788,74,na,1862,433.95919333434864
STAT,1868,25,25-29,1893,38.41376554221174
SIM,1921,30,40-44,1951,11
STAT,1883,45,50-100,1928,0.22965997248713135
SIM,1887,31,50-100,1918,4
SIM,1899,30,45-49,1929,2
STAT,1848,40,35-39,1888,1.3367641318894488
SIM,1856,38,na,1894,1842
SIM,1888,41,25-29,1929,4
STAT,1916,23,50-100,1939,0.6493227690373543
SIM,1902,30,30-34,1932,40
STAT,1798,98,na,1896,0.9010214012304542
STAT,1813,52,40-44,1865,0.030393695341501922
SIM,1928,35,na,1963,4503
STAT,1849,50,35-39,1899,0.006294504122422007
SIM,1878,25,35-39,1903,11
SIM,1893,36,25-29,1929,3
STAT,1791,78,na,1869,288.6858536240785
STAT,1885,49,30-34,1934,0.08920393496458928
STAT,1924,37,25-29,1961,1.0969211862982267
STAT,1895,35,40-44,1930,5.447836552311262
SIM,1884,35,30-34,1919,6
STAT,1884,45,50-100,1929,0.23156315161265167
SIM,1844,96,na,1940,6
SIM,1941,4,na,1945,3765
STAT,1853,19,30-34,1872,1.4051997640937257
STAT,1920,37,50-100,1957,0.43429073086764985
STAT,1906,45,na,1951,3126.337352671229
SIM,1871,22,15-19,1893,2
STAT,1881,53,40-44,1934,0.009448549924088103
STAT,1828,44,40-44,1872,1.9190409715826715
SIM,1919,40,na,1959,3817
SIM,1909,36,30-34,1945,4
SIM,1898,45,na,1943,2882
STAT,1830,29,50-100,1859,0.5612465180624513
STAT,1861,49,45-49,1910,0.1812709830472215
SIM,1900,23,20-24,1923,99
STAT,1885,36,25-29,1921,2.7228835686918544
SIM,1833,44,50-100,1877,1
STAT,1869,17,25-29,1886,5.253620969145103
STAT,1902,41,20-24,1943,0.014768886122996245
SIM,1901,15,20-24,1916,22
STAT,1912,15,30-34,1927,2.338675291868588
STAT,1823,52,40-44,1875,0.012081190485436242
STAT,1826,31,na,1857,1608.606898390934
SIM,1855,50,na,1905,1739
STAT,1914,26,45-49,1940,1.6506400904591874
SIM,1876,36,na,1912,2351
SIM,1831,46,na,1877,1483
SIM,1884,87,na,1971,342
STAT,1885,20,na,1905,2239.2161286969113
STAT,1909,28,na,1937,3369.3787127328737
STAT,1933,27,25-29,1960,82.56301660328728
SIM,1856,40,35-39,1896,1
STAT,1813,98,na,1911,1.373897173049863
STAT,1929,18,45-49,1947,0.600716276426361
STAT,1830,52,40-44,1882,0.006786488995089285
STAT,1913,30,40-44,1943,3.7068554927428323
STAT,1866,47,50-100,1913,0.21291762429754066
STAT,1917,41,20-24,1958,0.01743517389339538
STAT,1918,30,na,1948,3827.107627954881
SIM,1942,16,20-24,1958,114
STAT,1883,20,35-39,1903,5.435115729380236
SIM,1842,29,30-34,1871,21
STAT,1816,45,15-19,1861,0.0010874262014343179
SIM,1838,25,na,1863,1741
STAT,1878,43,25-29,1921,0.6269689173916139
SIM,1906,31,45-49,1937,2
STAT,1951,19,25-29,1970,48.719864220537275
SIM,1846,16,25-29,1862,7
SIM,1897,35,40-44,1932,12
STAT,1883,36,15-19,1919,0.05224190061176604
SIM,1835,36,na,1871,1659
STAT,1872,38,40-44,1910,4.13017049812615
STAT,1894,28,50-100,1922,0.7746308201897156
STAT,1909,44,35-39,1953,0.1756975760456271
STAT,1814,62,na,1876,930.2295147871268
STAT,1935,36,30-34,1971,2.4096541775024845
STAT,1861,25,15-19,1886,0.3637089923251023
SIM,1921,20,30-34,1941,29
STAT,1784,90,na,1874,24.151673252181702
STAT,1871,46,35-39,1917,0.13148834640294288
SIM,1880,38,40-44,1918,5
SIM,1822,32,35-39,1854,9
STAT,1900,44,20-24,1944,0.014258481903421364
STAT,1863,22,15-19,1885,2.7941507272553756
STAT,1932,31,45-49,1963,1.9773384323148646
STAT,1825,29,20-24,1854,38.64993943472837
STAT,1903,18,50-100,1921,0.06567418603734952
SIM,1833,29,20-24,1862,11
STAT,1785,91,na,1876,18.128770622819744
STAT,1889,35,40-44,1924,5.153845194447666
STAT,1895,40,20-24,1935,0.19776020988470358
STAT,1899,16,50-100,1915,0.06358132038162055
STAT,1820,43,15-19,1863,0.02416026470312884
STAT,1818,42,15-19,1860,0.033127423387684096
STAT,1834,29,30-34,1863,20.146942571842303
SIM,1857,17,15-19,1874,5
STAT,1888,15,na,1903,2831.697725985263
SIM,1934,34,25-29,1968,17
STAT,1885,33,15-19,1918,0.13346555182293948
STAT,1770,92,na,1862,7.686672477473451
STAT,1884,40,45-49,1924,1.4112710327781057
SIM,1937,34,40-44,1971,4
SIM,1891,20,35-39,1911,8
STAT,1892,54,na,1946,2477.233231431708
SIM,1938,18,20-24,1956,119
STAT,1838,16,25-29,1854,5.135385504145457
STAT,1810,72,na,1882,597.956539783912
STAT,1823,109,na,1932,3.74397232254225E-4
STAT,1880,24,40-44,1904,2.0583359841355335
STAT,1776,95,na,1871,2.074811806231339
SIM,1820,37,30-34,1857,5
SIM,1940,19,20-24,1959,108
STAT,1863,79,na,1942,580.5464968662112
STAT,1923,16,45-49,1939,0.5555485840560271
SIM,1867,59,na,1926,1695
STAT,1937,33,30-34,1970,14.71414427459903
STAT,1857,27,15-19,1884,0.3480374413232264
STAT,1932,19,20-24,1951,168.68748568307112
STAT,1936,15,40-44,1951,1.270713229447511
SIM,1821,33,40-44,1854,7
STAT,1908,26,20-24,1934,16.49253011796519
SIM,1856,81,na,1937,373
SIM,1940,31,45-49,1971,5
STAT,1869,50,20-24,1919,6.844775187727171E-4
STAT,1831,26,40-44,1857,2.706405933270689
STAT,1845,53,30-34,1898,0.004125543886152801
SIM,1904,30,40-44,1934,6
STAT,1904,42,25-29,1946,0.06034084201267897
SIM,1901,18,25-29,1919,9
STAT,1876,30,45-49,1906,1.714342249859545
STAT,1914,24,50-100,1938,0.6309762806187907
STAT,1881,36,na,1917,2159.333593904099
STAT,1878,7,na,1885,2633.280496229958
STAT,1905,17,50-100,1922,0.06688152879563977
STAT,1914,40,na,1954,3500.2287083678702
SIM,1892,40,45-49,1932,4
SIM,1911,25,30-34,1936,45
STAT,1849,17,15-19,1866,5.2653485050799
STAT,1875,26,15-19,1901,0.44184668149428674
STAT,1929,34,40-44,1963,4.690097520750485
SIM,1850,19,na,1869,2026
STAT,1847,53,40-44,1900,0.0076217531920856766
STAT,1835,35,15-19,1870,0.044224722523518174
STAT,1897,41,25-29,1938,0.05659402581345375
STAT,1938,23,50-100,1961,0.614927335586241
SIM,1868,24,20-24,1892,57
SIM,1878,5,na,1883,2724
SIM,1848,20,30-34,1868,19
STAT,1835,48,na,1883,1460.7457694240527
STAT,1896,10,na,1906,3234.1054489449493
SIM,1816,39,30-34,1855,5
STAT,1920,29,40-44,1949,4.79598596677482
STAT,1926,34,25-29,1960,10.545454275278459
STAT,1861,44,15-19,1905,0.010687257239682325
STAT,1859,43,20-24,1902,0.11886811804012466
STAT,1921,30,30-34,1951,16.697920668075696
SIM,1809,81,na,1890,202
SIM,1916,26,20-24,1942,15
SIM,1878,44,35-39,1922,3
STAT,1839,41,50-100,1880,0.826365759102069
STAT,1832,104,na,1936,0.04033074826707357
SIM,1856,34,40-44,1890,4
STAT,1842,35,15-19,1877,0.04789374945565113
STAT,1891,49,30-34,1940,0.06251486415169899
STAT,1903,31,na,1934,3220.387911252426
SIM,1898,18,15-19,1916,6
STAT,1909,31,20-24,1940,2.2073002039699516
STAT,1843,96,na,1939,6.194890331627316
STAT,1856,51,25-29,1907,0.0026332531666445847
STAT,1901,47,50-100,1948,0.18233408570072004
STAT,1913,20,30-34,1933,26.461081034724078
SIM,1895,30,20-24,1925,3
SIM,1917,31,20-24,1948,2
SIM,1872,28,na,1900,2219
SIM,1887,28,40-44,1915,3
SIM,1859,25,25-29,1884,40
STAT,1861,39,35-39,1900,5.492698204885243
SIM,1815,50,na,1865,1219
STAT,1841,95,na,1936,9.09669536456242
STAT,1907,34,20-24,1941,2.135045373903775
SIM,1934,37,35-39,1971,9
SIM,1930,31,50-100,1961,5
STAT,1859,24,15-19,1883,2.5436461280094815
SIM,1837,24,35-39,1861,5
SIM,1935,26,30-34,1961,56
SIM,1938,13,na,1951,3618
STAT,1831,37,40-44,1868,3.4569173419391364
SIM,1847,21,na,1868,1859
STAT,1837,32,15-19,1869,0.1127136513888591
STAT,1911,45,35-39,1956,0.11582416735790921
STAT,1869,45,40-44,1914,0.1581123310008657
STAT,1874,82,na,1956,483.1589785953158
STAT,1829,35,50-100,1864,1.1349367170195317
SIM,1905,26,na,1931,3262
STAT,1896,15,35-39,1911,0.6882640252962261
STAT,1858,70,na,1928,1040.5613823466065
SIM,1797,69,na,1866,721
SIM,1832,22,na,1854,1763
SIM,1834,88,na,1922,71
SIM,1895,38,40-44,1933,5
SIM,1861,29,40-44,1890,4
STAT,1887,38,40-44,1925,4.601877411748213
STAT,1844,48,30-34,1892,0.0671006382279703
STAT,1877,17,15-19,1894,5.817740881036716
SIM,1867,24,15-19,1891,2
STAT,1906,41,45-49,1947,0.14361361601340186
STAT,1881,23,35-39,1904,5.306350555396293
STAT,1822,40,15-19,1862,0.02197461810646799
STAT,1926,37,35-39,1963,2.792864257334824
SIM,1915,34,20-24,1949,2
STAT,1927,26,30-34,1953,45.15967267526461
STAT,1844,32,15-19,1876,0.1195492066951183
STAT,1922,31,50-100,1953,0.8861794827742181
STAT,1949,18,30-34,1967,13.388766366959276
STAT,1851,19,20-24,1870,15.62072759301953
STAT,1885,33,20-24,1918,2.533327152030927
STAT,1923,42,35-39,1965,0.22235910865842431
SIM,1803,65,na,1868,772
STAT,1879,28,40-44,1907,2.947504033005899
STAT,1933,23,45-49,1956,1.409488506229159
STAT,1938,27,45-49,1965,1.6167039994164771
SIM,1920,18,35-39,1938,2
STAT,1841,40,25-29,1881,0.46839790455556213
STAT,1916,36,20-24,1952,0.2562401371568022
SIM,1909,62,na,1971,2856
SIM,1929,17,na,1946,4515
STAT,1915,3,na,1918,3996.8634512414583
SIM,1806,79,na,1885,264
STAT,1799,107,na,1906,0.0015766859106106403
SIM,1860,34,30-34,1894,18
STAT,1901,24,na,1925,3107.695645121921
SIM,1941,24,20-24,1965,107
STAT,1898,47,15-19,1945,2.872004983442284E-4
STAT,1863,57,na,1920,1668.8248796514379
STAT,1958,2,na,1960,4881.753231288954
STAT,1928,41,40-44,1969,0.3016921051847662
STAT,1830,42,30-34,1872,0.8744148207208919
STAT,1846,37,40-44,1883,3.223127758307406
STAT,1902,49,40-44,1951,0.12605545998278914
STAT,1852,34,30-34,1886,13.452454283028814
STAT,1869,36,na,1905,2164.7614154582348
STAT,1953,16,30-34,1969,13.933340139630248
SIM,1909,20,15-19,1929,4
STAT,1931,19,15-19,1950,55.81723771019047
STAT,1924,21,45-49,1945,1.258165045309294
STAT,1839,31,35-39,1870,8.396397650995512
SIM,1796,78,na,1874,287
STAT,1858,19,15-19,1877,5.080846120630993
SIM,1893,33,20-24,1926,3
SIM,1882,24,40-44,1906,1
SIM,1898,39,na,1937,2985
STAT,1902,30,20-24,1932,3.632543839518393
SIM,1854,37,40-44,1891,8
STAT,1914,23,40-44,1937,3.234574506312869
STAT,1935,31,30-34,1966,20.602504885630907
SIM,1850,48,50-100,1898,1
SIM,1936,31,30-34,1967,15
STAT,1875,42,na,1917,2240.384387205734
STAT,1898,70,na,1968,2106.87650072855
STAT,1934,17,na,1951,4703.141933525116
STAT,1860,15,na,1875,2056.7088298921403
STAT,1863,41,15-19,1904,0.011519759483283489
STAT,1905,48,15-19,1953,3.0415394357921274E-4
STAT,1834,25,15-19,1859,0.37360252203044
STAT,1834,82,na,1916,288.7941742577599
SIM,1818,64,na,1882,811
STAT,1847,33,na,1880,1852.9695290545928
STAT,1851,54,na,1905,1535.5330862576004
SIM,1902,20,20-24,1922,83
STAT,1859,43,15-19,1902,0.010336358648721304
STAT,1863,32,25-29,1895,8.505597763803083
STAT,1891,30,35-39,1921,11.93683122852416
SIM,1851,60,na,1911,1404
STAT,1855,81,na,1936,382.9893183324191
SIM,1839,21,35-39,1860,9
SIM,1847,31,35-39,1878,7
STAT,1890,46,45-49,1936,0.15419797365970553
STAT,1905,29,15-19,1934,0.614947696373136
SIM,1860,80,na,1940,483
STAT,1840,22,35-39,1862,5.168104484207415
SIM,1880,57,na,1937,2081
STAT,1895,19,na,1914,3096.869279773563
SIM,1914,49,na,1963,3704
SIM,1823,94,na,1917,9
STAT,1910,42,25-29,1952,0.06373626461084403
STAT,1896,22,50-100,1918,0.5091394602833275
SIM,1922,23,40-44,1945,4
SIM,1815,46,50-100,1861,1
STAT,1818,42,20-24,1860,0.3809653483820974
STAT,1883,1,na,1884,3093.820482916357
STAT,1920,48,50-100,1968,0.23554896563098365
SIM,1929,39,na,1968,4657
SIM,1944,15,40-44,1959,1
SIM,1953,2,na,1955,4375
SIM,1866,19,15-19,1885,8
STAT,1876,31,15-19,1907,0.13945141996619514
SIM,1846,27,40-44,1873,1
STAT,1831,48,20-24,1879,0.008710132489277253
SIM,1852,32,20-24,1884,1
STAT,1878,33,15-19,1911,0.1394601704059632
SIM,1840,66,na,1906,1089
SIM,1838,19,na,1857,1908
SIM,1841,23,40-44,1864,1
STAT,1849,99,na,1948,1.365081983643095
STAT,1880,48,40-44,1928,0.1680343061379418
SIM,1866,40,35-39,1906,4
SIM,1909,16,na,1925,3563
STAT,1865,49,20-24,1914,0.010086254316298539
SIM,1908,31,na,1939,3310
SIM,1932,21,45-49,1953,1
STAT,1860,45,20-24,1905,0.009304967250388915
STAT,1815,50,25-29,1865,0.00857510596906537
STAT,1820,38,35-39,1858,15.085611468850967
STAT,1916,23,na,1939,3603.664237847667
STAT,1930,32,25-29,1962,11.268859833084901
STAT,1827,39,40-44,1866,4.164795498899957
SIM,1835,39,40-44,1874,6
STAT,1933,24,20-24,1957,139.24332175021175
STAT,1911,26,35-39,1937,13.876041261100996
STAT,1914,7,na,1921,3892.790452981054
SIM,1926,34,na,1960,4169
STAT,1913,33,45-49,1946,1.4724252555482773
SIM,1820,37,na,1857,1490
SIM,1887,17,25-29,1904,11
STAT,1924,48,25-29,1972,0.05949851944427476
SIM,1921,33,45-49,1954,4
SIM,1901,18,30-34,1919,2
STAT,1833,23,40-44,1856,1.735471930760568
STAT,1838,27,40-44,1865,2.5989076456459577
STAT,1844,32,20-24,1876,2.26917917910595
STAT,1931,12,na,1943,4899.500215248669
SIM,1873,40,35-39,1913,2
STAT,1872,49,20-24,1921,0.01114085520051327
STAT,1902,55,na,1957,2795.2941107881175
STAT,1808,102,na,1910,0.11395280643724363
STAT,1929,15,40-44,1944,1.6942597887632957
STAT,1865,23,50-100,1888,0.3517768890987065
SIM,1902,39,40-44,1941,3
STAT,1846,85,na,1931,193.28463612961428
STAT,1802,101,na,1903,0.19466114365243434
SIM,1871,9,na,1880,2582
STAT,1882,41,25-29,1923,0.5929738792157216
STAT,1884,25,na,1909,2243.0291377100248
STAT,1948,15,45-49,1963,0.5403880802027348
STAT,1860,15,15-19,1875,5.3173381770555865
STAT,1788,80,na,1868,245.73423179911907
STAT,1878,56,na,1934,2005.8832224531257
STAT,1864,16,35-39,1880,0.5297730666049864
STAT,1894,39,50-100,1933,1.4769617899638934
STAT,1865,40,35-39,1905,1.5701690376173938
STAT,1871,46,40-44,1917,0.16079146323050947
SIM,1900,26,25-29,1926,61
STAT,1850,48,30-34,1898,0.06729114962012796
STAT,1884,41,15-19,1925,0.012950357812446887
SIM,1918,15,30-34,1933,3
STAT,1858,27,na,1885,1811.8553809923096
STAT,1837,42,25-29,1879,0.47834709157689764
STAT,1942,26,20-24,1968,18.10615559978687
STAT,1863,24,50-100,1887,0.34044141966090197
STAT,1934,16,20-24,1950,173.6589282442507
SIM,1793,95,na,1888,1
STAT,1896,34,35-39,1930,12.535715493990056
SIM,1818,42,na,1860,1364
STAT,1866,41,50-100,1907,0.9243215066972785
STAT,1912,18,35-39,1930,0.7992946609492424
SIM,1879,60,na,1939,1860
STAT,1829,43,35-39,1872,1.5003027285714077
SIM,1864,33,na,1897,2133
STAT,1926,17,50-100,1943,0.43399176723334776
STAT,1916,34,50-100,1950,0.7994643313087919
STAT,1892,76,na,1968,1491.8770003787408
STAT,1947,18,20-24,1965,144.23644381025593
STAT,1850,26,50-100,1876,0.5337986373500098
STAT,1818,49,40-44,1867,0.35473148058770976
SIM,1863,33,35-39,1896,10
STAT,1886,43,15-19,1929,0.013684352467132994
STAT,1893,47,30-34,1940,0.06514322015831987
SIM,1850,29,20-24,1879,9
SIM,1858,79,na,1937,513
SIM,1847,44,40-44,1891,2
STAT,1848,30,25-29,1878,8.78581917082726
STAT,1878,47,na,1925,2202.296281114729
SIM,1854,89,na,1943,61
STAT,1895,43,25-29,1938,0.05457675432122111
STAT,1926,44,35-39,1970,0.233760757197773
SIM,1861,25,25-29,1886,39
STAT,1815,47,na,1862,1299.3674554309282
STAT,1842,29,20-24,1871,10.183289124779392
SIM,1896,19,na,1915,3203
STAT,1835,42,15-19,1877,0.01032423465705066
STAT,1867,45,30-34,1912,0.08671765048921554
STAT,1935,27,35-39,1962,19.332594667700405
STAT,1835,61,na,1896,1165.8973653726712
SIM,1855,34,na,1889,1899
STAT,1844,25,15-19,1869,0.3955617404313779
STAT,1912,48,na,1960,3325.3657932882593
STAT,1813,48,45-49,1861,0.7018605463297862
STAT,1861,93,na,1954,22.92663922357578
STAT,1855,33,35-39,1888,7.227503544718631
STAT,1809,49,30-34,1858,0.3404131230284393
STAT,1830,45,40-44,1875,0.1287600013624234
STAT,1861,32,50-100,1893,0.7187732511248844
STAT,1851,29,30-34,1880,21.312102909371763
SIM,1890,16,na,1906,3040
STAT,1905,40,50-100,1945,0.10116134405288844
STAT,1872,56,na,1928,1933.985676222023
SIM,1943,27,35-39,1970,23
SIM,1923,23,na,1946,3925
STAT,1904,19,45-49,1923,0.08802582970286983
SIM,1857,2,na,1859,2694
SIM,1803,74,na,1877,408
STAT,1828,97,na,1925,3.0496957019510758
SIM,1904,32,30-34,1936,23
STAT,1823,42,na,1865,1451.564384469221
SIM,1854,21,25-29,1875,62
STAT,1804,84,na,1888,114.79855417510838
SIM,1889,22,na,1911,2793
STAT,1884,41,na,1925,2167.396901790076
SIM,1904,41,na,1945,3113
STAT,1762,109,na,1871,5.880486177719092E-4
STAT,1896,38,50-100,1934,1.5252733184186527
SIM,1930,22,30-34,1952,39
SIM,1843,39,30-34,1882,6
STAT,1939,22,40-44,1961,3.1896440679469755
SIM,1866,96,na,1962,15
STAT,1810,54,20-24,1864,0.0024060447170274764
STAT,1930,33,45-49,1963,1.9173545789639692
SIM,1950,17,25-29,1967,64
SIM,1821,84,na,1905,150
STAT,1850,23,40-44,1873,1.7481355011954376
STAT,1942,17,25-29,1959,42.780137060502895
SIM,1883,31,na,1914,2272
STAT,1828,52,25-29,1880,0.0028808792114264595
SIM,1841,39,na,1880,1711
STAT,1897,29,na,1926,2993.6201478875823
SIM,1825,77,na,1902,414
SIM,1852,39,40-44,1891,8
SIM,1935,30,na,1965,4920
STAT,1841,79,na,1920,478.3219251829976
STAT,1868,21,45-49,1889,0.6335166933703402
STAT,1901,7,na,1908,3445.0284889091
STAT,1835,39,30-34,1874,4.0265630310964475
SIM,1895,22,25-29,1917,69
STAT,1797,97,na,1894,1.308060962991274
STAT,1893,35,30-34,1928,6.448786009815127
SIM,1868,27,25-29,1895,36
STAT,1922,22,30-34,1944,31.13898203971428
STAT,1924,30,40-44,1954,4.332984331214453
SIM,1885,78,na,1963,936
STAT,1915,48,15-19,1963,3.496557956790899E-4
SIM,1916,29,30-34,1945,47
STAT,1921,33,35-39,1954,9.567429226942409
SIM,1881,88,na,1969,252
STAT,1869,53,25-29,1922,0.0031869421412922365
STAT,1937,23,50-100,1960,0.6050373730479318
SIM,1947,22,40-44,1969,4
STAT,1844,39,40-44,1883,3.180621947866836
STAT,1814,99,na,1913,0.7814018664000555
SIM,1865,20,30-34,1885,21
SIM,1891,63,na,1954,2079
STAT,1826,87,na,1913,96.1624913257493
SIM,1859,27,na,1886,2024
STAT,1827,32,na,1859,1611.8946286110468
SIM,1878,84,na,1962,519
STAT,1907,33,45-49,1940,1.3834118428222864
STAT,1909,37,35-39,1946,2.1622441596813746
STAT,1861,32,15-19,1893,0.11171549634685582
STAT,1831,29,45-49,1860,0.9320471743188381
SIM,1923,45,na,1968,4005
SIM,1909,8,na,1917,3673
SIM,1856,30,25-29,1886,16
STAT,1924,8,na,1932,4487.282934666022
STAT,1905,60,na,1965,2801.8843482431944
STAT,1861,48,30-34,1909,0.07498318543612353
STAT,1848,49,na,1897,1586.9963743897094
SIM,1880,39,50-100,1919,1
STAT,1836,50,50-100,1886,0.010039777316041224
SIM,1811,44,50-100,1855,1
SIM,1931,3,na,1934,4992
STAT,1870,22,20-24,1892,63.79019320687107
STAT,1910,18,25-29,1928,8.088181614429848
SIM,1932,30,40-44,1962,7
SIM,1909,19,na,1928,3537
STAT,1837,21,50-100,1858,0.33943007365293254
SIM,1902,23,30-34,1925,26
SIM,1892,29,na,1921,2824
STAT,1887,22,25-29,1909,60.479789654200125
SIM,1915,33,45-49,1948,1
STAT,1880,39,45-49,1919,1.9615794980007164
STAT,1797,94,na,1891,4.866312183167176
STAT,1872,53,na,1925,2008.8578725971684
STAT,1908,29,30-34,1937,34.73362775384155
STAT,1845,42,15-19,1887,0.009905577801410909
SIM,1920,32,50-100,1952,3
SIM,1907,39,25-29,1946,1
STAT,1885,26,15-19,1911,0.4284808705920161
STAT,1830,33,40-44,1863,3.5697968757237435
SIM,1929,28,20-24,1957,26
STAT,1821,42,50-100,1863,1.7632556591152044
SIM,1886,48,50-100,1934,3
STAT,1890,37,50-100,1927,1.4180760580535785
SIM,1821,87,na,1908,71
SIM,1946,24,40-44,1970,3
SIM,1916,17,30-34,1933,2
STAT,1839,18,50-100,1857,0.04248072598753125
STAT,1852,46,30-34,1898,0.07375477393298435
STAT,1867,54,50-100,1921,0.013027760901660187
STAT,1870,34,15-19,1904,0.13069382799081622
STAT,1825,39,30-34,1864,6.300793175577761
STAT,1917,47,50-100,1964,0.2231706735423499
SIM,1833,39,30-34,1872,4
STAT,1867,30,35-39,1897,9.05491674859461
STAT,1869,41,25-29,1910,0.5898690141640535
STAT,1881,11,na,1892,2359.1352565425027
SIM,1789,90,na,1879,19
STAT,1839,20,50-100,1859,0.35443486657736567
SIM,1828,31,25-29,1859,14
STAT,1853,25,25-29,1878,36.86952355066731
STAT,1935,20,15-19,1955,6.852316826846083
STAT,1839,44,40-44,1883,1.5406875071641488
SIM,1877,37,na,1914,2307
SIM,1931,40,na,1971,4686
STAT,1804,87,na,1891,59.703989091909826
STAT,1857,20,30-34,1877,15.536809045767608
STAT,1917,44,25-29,1961,0.07016299939855375
SIM,1771,92,na,1863,5
SIM,1924,27,25-29,1951,70
SIM,1827,84,na,1911,166
STAT,1905,24,45-49,1929,0.9459929381200878
SIM,1889,25,na,1914,2834
STAT,1811,45,30-34,1856,0.33360258409715876
SIM,1839,30,30-34,1869,20
STAT,1861,29,30-34,1890,19.613422686261835
STAT,1813,41,25-29,1854,2.3732357630223575
STAT,1921,46,40-44,1967,0.16833750239794606
SIM,1918,4,na,1922,4104
SIM,1792,91,na,1883,4
STAT,1836,54,40-44,1890,0.006465393608210195
SIM,1807,55,na,1862,1062
STAT,1925,17,30-34,1942,13.911420401980315
SIM,1809,68,na,1877,790
SIM,1809,84,na,1893,144
SIM,1897,31,25-29,1928,19
SIM,1891,23,45-49,1914,3
SIM,1822,47,na,1869,1404
STAT,1819,54,40-44,1873,0.017277346150979155
STAT,1898,21,30-34,1919,22.847598691989184
STAT,1889,31,25-29,1920,11.994480219871223
SIM,1873,21,35-39,1894,9
STAT,1938,24,40-44,1962,3.1411786587733315
SIM,1909,2,na,1911,3730
STAT,1847,89,na,1936,77.29719432008022
STAT,1826,107,na,1933,0.0025740483905192266
STAT,1865,34,40-44,1899,3.690958476477958
STAT,1873,19,na,1892,2408.837000138083
SIM,1834,32,na,1866,1656
SIM,1890,19,15-19,1909,7
STAT,1884,0,na,1884,3289.405660701996
STAT,1920,35,35-39,1955,2.506245838306598
SIM,1836,61,na,1897,1183
SIM,1933,17,30-34,1950,19
STAT,1911,30,30-34,1941,14.60652746969853
STAT,1968,3,na,1971,4640.580270758613
STAT,1961,7,na,1968,4796.095970296872
STAT,1883,23,45-49,1906,0.6436321225750835
STAT,1911,23,25-29,1934,82.48362576122004
STAT,1916,27,25-29,1943,64.2898321092657
SIM,1895,47,50-100,1942,1
SIM,1927,25,50-100,1952,1
SIM,1913,24,45-49,1937,5
SIM,1918,18,35-39,1936,7
STAT,1820,47,30-34,1867,0.15960902186374828
STAT,1896,66,na,1962,2210.3913572805063
SIM,1866,42,50-100,1908,2
STAT,1882,19,15-19,1901,5.426080367954953
STAT,1854,37,na,1891,1696.525557290998
STAT,1870,29,40-44,1899,2.7530836628584296
STAT,1904,40,40-44,1944,0.21375096525512394
STAT,1934,19,30-34,1953,15.490893693305447
STAT,1886,45,40-44,1931,0.1725824435145289
STAT,1935,33,20-24,1968,3.185788864543185
SIM,1867,22,na,1889,2056
SIM,1830,31,25-29,1861,9
SIM,1889,39,50-100,1928,3
STAT,1936,21,na,1957,3298.7064148109293
SIM,1887,15,35-39,1902,2
STAT,1865,21,35-39,1886,5.106999934774924
STAT,1880,32,25-29,1912,10.181132549982399
STAT,1934,32,50-100,1966,1.0663969920011458
STAT,1916,39,25-29,1955,0.9429114768264841
SIM,1924,39,25-29,1963,3
SIM,1858,64,na,1922,1420
SIM,1876,36,25-29,1912,3
STAT,1826,44,30-34,1870,1.09126619101003
STAT,1880,20,25-29,1900,57.241557707272584
SIM,1858,45,na,1903,1833
SIM,1940,5,na,1945,3664
STAT,1874,66,na,1940,1582.5159752491088
SIM,1868,15,25-29,1883,11
STAT,1868,36,25-29,1904,2.6094690856850926
SIM,1942,19,30-34,1961,14
STAT,1860,68,na,1928,1173.2884495357814
STAT,1822,43,25-29,1865,0.9429454110814197
STAT,1910,44,15-19,1954,0.001353837740096871
STAT,1840,91,na,1931,40.355827769781754
STAT,1862,53,30-34,1915,0.004719771977394435
STAT,1861,16,na,1877,2081.9833195555484
STAT,1886,51,na,1937,2159.470620488661
STAT,1915,43,20-24,1958,0.01676853352862362
STAT,1863,44,25-29,1907,0.5260579696708593
STAT,1891,29,na,1920,2770.632892857531
STAT,1930,30,50-100,1960,1.0091886374646297
STAT,1836,24,na,1860,1756.3993927064769
SIM,1911,20,na,1931,3471
SIM,1932,2,na,1934,4927
SIM,1834,44,30-34,1878,4
STAT,1816,39,20-24,1855,2.6669930851893864
STAT,1845,26,50-100,1871,0.5524115598548746
SIM,1928,22,30-34,1950,46
STAT,1866,22,na,1888,2076.7509561716492
STAT,1936,18,45-49,1954,0.45054372691959743
SIM,1854,71,na,1925,959
STAT,1845,44,40-44,1889,1.572555901144255
STAT,1919,18,45-49,1937,0.5201361380334344
SIM,1843,49,na,1892,1563
STAT,1902,33,25-29,1935,13.597285315621576
SIM,1910,33,25-29,1943,13
SIM,1833,72,na,1905,770
STAT,1879,31,50-100,1910,0.9084275535291596
STAT,1861,90,na,1951,61.848584703043066
STAT,1832,54,40-44,1886,0.0063813357192949475
STAT,1827,35,25-29,1862,3.0242204416336422
STAT,1942,29,25-29,1971,65.19344441169163
STAT,1835,50,50-100,1885,0.009991220959691016
STAT,1846,21,25-29,1867,50.16166815465433
SIM,1917,34,30-34,1951,21
STAT,1894,26,25-29,1920,51.58195406338932
SIM,1873,53,na,1926,2037
SIM,1853,24,na,1877,1981
STAT,1924,45,20-24,1969,0.012488584099861602
SIM,1815,99,na,1914,1
SIM,1871,44,25-29,1915,2
STAT,1836,18,40-44,1854,0.29997776262954284
STAT,1838,72,na,1910,861.3250363726319
SIM,1917,11,na,1928,3983
SIM,1907,17,20-24,1924,21
STAT,1908,48,50-100,1956,0.1926552471166811
SIM,1866,74,na,1940,894
STAT,1796,109,na,1905,1.6575054004782841E-4
STAT,1896,44,na,1940,2856.537572009031
STAT,1911,35,25-29,1946,0.9067351670610383
SIM,1889,21,30-34,1910,20
SIM,1891,66,na,1957,1937
SIM,1933,29,25-29,1962,81
SIM,1853,44,40-44,1897,5
SIM,1835,35,25-29,1870,5
SIM,1824,32,45-49,1856,1
SIM,1897,46,50-100,1943,1
SIM,1871,32,25-29,1903,13
STAT,1762,106,na,1868,0.0023894421457017444
STAT,1854,49,45-49,1903,0.16639397320713012
SIM,1944,22,na,1966,3693
STAT,1915,19,20-24,1934,26.659634888580353
SIM,1790,84,na,1874,82
SIM,1923,19,20-24,1942,143
STAT,1876,17,50-100,1893,0.047779594175986484
STAT,1825,44,50-100,1869,1.129094794621802
SIM,1900,22,45-49,1922,5
STAT,1950,20,40-44,1970,3.7710983801092057
STAT,1925,29,25-29,1954,72.92589292735973
STAT,1877,15,25-29,1892,5.581000329773395
STAT,1823,76,na,1899,498.5598963583303
STAT,1903,41,50-100,1944,0.09904735059997782
SIM,1783,80,na,1863,207
STAT,1813,45,40-44,1858,0.5357525915703234
STAT,1915,41,na,1956,3537.0503380696814
SIM,1881,82,na,1963,543
STAT,1850,47,50-100,1897,0.1720968863021441
STAT,1817,54,30-34,1871,0.012256342579919165
STAT,1879,15,35-39,1894,0.5443303535204989
STAT,1819,50,25-29,1869,0.006295547247141682
SIM,1898,36,na,1934,2992
SIM,1818,79,na,1897,251
STAT,1879,21,20-24,1900,68.25184533604254
STAT,1841,18,15-19,1859,5.205965730059749
STAT,1899,58,na,1957,2601.8376597483248
SIM,1819,43,na,1862,1420
STAT,1877,19,40-44,1896,0.17834140829372225
SIM,1857,82,na,1939,313
SIM,1932,37,na,1969,4641
STAT,1844,44,15-19,1888,0.009677734539962056
STAT,1901,16,25-29,1917,7.511444134894913
SIM,1846,33,35-39,1879,7
SIM,1873,34,40-44,1907,3
STAT,1842,22,45-49,1864,0.6263229186319579
SIM,1887,21,20-24,1908,71
SIM,1834,35,na,1869,1629
STAT,1865,30,25-29,1895,8.863387834111773
STAT,1870,25,25-29,1895,39.42278961394655
STAT,1930,23,35-39,1953,11.360675079771745
STAT,1911,25,50-100,1936,0.9230097616911307
STAT,1849,29,15-19,1878,0.3821102463084279
STAT,1862,78,na,1940,629.6274531977931
STAT,1808,68,na,1876,769.7201336555357
STAT,1893,15,50-100,1908,0.05899528350587095
STAT,1926,46,25-29,1972,0.06199269861179057
SIM,1875,30,35-39,1905,9
STAT,1884,45,30-34,1929,0.09126756162055796
STAT,1876,40,50-100,1916,1.040706610134687
SIM,1778,87,na,1865,55
SIM,1845,75,na,1920,725
SIM,1793,79,na,1872,245
STAT,1863,42,na,1905,1916.9219381775517
STAT,1858,40,35-39,1898,1.3565040083243598
SIM,1818,98,na,1916,3
SIM,1921,19,na,1940,3846
STAT,1930,30,40-44,1960,4.776628929511702
STAT,1903,34,na,1937,3206.8698613631195
SIM,1807,58,na,1865,998
SIM,1882,20,25-29,1902,51
STAT,1853,22,20-24,1875,60.38394413446438
SIM,1808,80,na,1888,210
STAT,1851,38,na,1889,1728.1401721841087
SIM,1902,26,35-39,1928,16
STAT,1838,33,35-39,1871,8.49406358503571
STAT,1909,34,30-34,1943,14.077893630741455
SIM,1843,31,na,1874,1845
STAT,1886,41,25-29,1927,0.6438526025992318
SIM,1906,19,20-24,1925,33
SIM,1837,21,25-29,1858,54
STAT,1828,35,50-100,1863,1.2189786098524915
STAT,1909,43,20-24,1952,0.01550713498110146
STAT,1925,18,na,1943,4189.9461594936765
STAT,1820,35,30-34,1855,14.209474231219682
STAT,1835,23,15-19,1858,2.7164860407773928
STAT,1900,19,50-100,1919,0.0638639074812499
STAT,1893,55,na,1948,2478.3945953468365
STAT,1826,40,15-19,1866,0.014123139341614969
STAT,1844,35,25-29,1879,2.3963707423939096
STAT,1924,33,45-49,1957,1.733409597050419
SIM,1843,23,15-19,1866,5
STAT,1847,16,35-39,1863,0.5068853362546989
SIM,1908,15,na,1923,3490
STAT,1910,15,20-24,1925,25.488467325097137
STAT,1932,36,15-19,1968,0.024397366370152728
SIM,1861,22,20-24,1883,58
SIM,1856,3,na,1859,2525
STAT,1880,36,40-44,1916,4.372173603943203
SIM,1861,68,na,1929,1269
SIM,1865,12,na,1877,2337
SIM,1932,33,45-49,1965,1
STAT,1900,32,20-24,1932,3.542600479947098
SIM,1878,22,25-29,1900,64
STAT,1818,39,30-34,1857,14.790405023197248
SIM,1870,64,na,1934,1584
SIM,1791,69,na,1860,645
SIM,1872,23,35-39,1895,5
STAT,1927,17,50-100,1944,0.44012430906403877
STAT,1884,59,na,1943,1814.3009765184552
STAT,1773,84,na,1857,70.498562587481
STAT,1900,42,na,1942,3035.8055450871384
STAT,1904,33,35-39,1937,7.844998240195031
SIM,1896,17,35-39,1913,3
SIM,1842,83,na,1925,239
STAT,1860,12,na,1872,2113.834205240177
STAT,1843,44,30-34,1887,0.8323920660976195
STAT,1891,45,15-19,1936,2.6646464174137917E-4
STAT,1961,10,na,1971,4794.369582451071
STAT,1898,34,45-49,1932,2.210954016919312
SIM,1829,26,35-39,1855,8
SIM,1845,72,na,1917,906
STAT,1847,86,na,1933,163.25398899639072
STAT,1918,20,15-19,1938,5.455901189046414
STAT,1871,53,40-44,1924,0.009701294731136977
SIM,1846,20,20-24,1866,61
SIM,1865,23,35-39,1888,6
STAT,1828,42,15-19,1870,0.012182083779581947
STAT,1895,33,15-19,1928,0.17481928619366421
SIM,1845,97,na,1942,3
STAT,1857,23,35-39,1880,4.981158719322229
STAT,1795,68,na,1863,688.9726586700403
SIM,1926,39,35-39,1965,6
STAT,1840,19,45-49,1859,0.05820755258157593
STAT,1883,32,50-100,1915,0.8483216236321145
STAT,1913,46,15-19,1959,3.404273427986545E-4
STAT,1907,48,50-100,1955,0.18980286585047637
STAT,1906,46,15-19,1952,3.1126420138368805E-4
SIM,1771,95,na,1866,1
STAT,1903,56,na,1959,2818.7650929314104
SIM,1937,22,40-44,1959,3
STAT,1946,15,35-39,1961,4.39915727544519
STAT,1864,23,35-39,1887,4.970243774621624
SIM,1826,39,30-34,1865,3
SIM,1839,43,45-49,1882,1
STAT,1824,39,na,1863,1482.9991771640616
STAT,1839,38,na,1877,1688.9637080138918
STAT,1821,52,30-34,1873,0.008738076884734018
STAT,1885,26,na,1911,2253.8545977440417
STAT,1775,101,na,1876,0.11985987201268504
SIM,1915,30,40-44,1945,3
SIM,1891,32,50-100,1923,1
STAT,1802,107,na,1909,0.0016087889911534177
STAT,1852,30,15-19,1882,0.11437631095224224
STAT,1900,45,na,1945,2978.5679023181833
STAT,1893,20,35-39,1913,7.03623303735201
SIM,1915,48,50-100,1963,2
STAT,1841,48,20-24,1889,0.008142528858462323
STAT,1918,39,35-39,1957,2.4032321803251997
SIM,1908,37,na,1945,3249
STAT,1881,17,40-44,1898,0.16683392312005868
STAT,1935,24,30-34,1959,36.94676859131871
SIM,1805,91,na,1896,12
STAT,1854,17,50-100,1871,0.04220182451579982
STAT,1845,20,na,1865,1896.8134401354926
STAT,1908,17,30-34,1925,2.2330603290609723
STAT,1852,18,50-100,1870,0.04475424995557043
STAT,1830,48,45-49,1878,0.17075054630380504
SIM,1843,46,na,1889,1587
SIM,1912,33,35-39,1945,6
SIM,1857,60,na,1917,1507
STAT,1913,32,30-34,1945,14.804879207758702
STAT,1802,58,na,1860,991.850941368738
STAT,1929,22,40-44,1951,4.01705081033225
SIM,1928,25,50-100,1953,1
STAT,1863,106,na,1969,0.11199564677243078
STAT,1888,17,35-39,1905,0.6123649760636379
STAT,1859,36,15-19,1895,0.04254006937741931
STAT,1839,40,25-29,1879,0.5087774962168811
STAT,1907,30,40-44,1937,3.482762720191021
STAT,1911,33,35-39,1944,8.36912095797109
SIM,1921,32,30-34,1953,18
SIM,1943,24,30-34,1967,35
STAT,1857,26,na,1883,1843.9532548062161
STAT,1888,18,na,1906,2811.217352136724
SIM,1826,52,50-100,1878,1
STAT,1848,34,na,1882,1786.906903034792
SIM,1891,41,na,1932,2835
SIM,1867,78,na,1945,646
STAT,1824,33,40-44,1857,8.778570554071116
STAT,1904,43,45-49,1947,0.13978929243812718
STAT,1880,54,50-100,1934,0.014599286087358934
STAT,1892,31,50-100,1923,1.088354309761272
STAT,1818,52,50-100,1870,0.030946906750702902
SIM,1892,26,na,1918,2846
STAT,1820,45,40-44,1865,0.29069467690505274
STAT,1928,43,30-34,1971,0.15373798893330554
SIM,1905,23,40-44,1928,3
SIM,1837,37,40-44,1874,9
STAT,1936,16,50-100,1952,0.33962752668087626
SIM,1832,33,40-44,1865,5
SIM,1876,33,20-24,1909,2
STAT,1920,16,35-39,1936,4.458602643674177
STAT,1867,41,15-19,1908,0.012304750806852824
STAT,1854,42,25-29,1896,0.4618442656512978
SIM,1870,42,na,1912,2135
STAT,1868,33,20-24,1901,2.4278081380935754
SIM,1865,49,na,1914,1882
STAT,1854,46,40-44,1900,0.12363014667083362
SIM,1954,15,35-39,1969,5
STAT,1881,30,na,1911,2194.155550619483
SIM,1840,49,50-100,1889,2
SIM,1859,29,40-44,1888,2
SIM,1810,44,na,1854,1366
STAT,1912,32,50-100,1944,0.7683854868489267
STAT,1782,80,na,1862,218.77913582438248
STAT,1946,25,45-49,1971,1.819641464367632
STAT,1851,25,15-19,1876,0.39520911762769145
SIM,1924,24,20-24,1948,124
SIM,1839,33,35-39,1872,13
STAT,1852,41,50-100,1893,0.8062947898823959
SIM,1887,34,35-39,1921,9
STAT,1880,41,15-19,1921,0.013789060040241656
SIM,1901,42,na,1943,3119
STAT,1880,22,15-19,1902,3.279224682020894
SIM,1902,32,20-24,1934,3
STAT,1898,24,35-39,1922,7.415852104307788
STAT,1829,37,40-44,1866,3.9064356131512357
SIM,1894,55,na,1949,2648
SIM,1917,37,35-39,1954,10
STAT,1869,25,50-100,1894,0.5889268056518373
STAT,1838,20,20-24,1858,61.86415649377393
STAT,1916,24,20-24,1940,109.3801047530283
SIM,1926,20,15-19,1946,9
STAT,1801,73,na,1874,521.1333859819985
STAT,1859,74,na,1933,836.6968457518374
SIM,1929,17,40-44,1946,5
STAT,1811,48,35-39,1859,0.4581830586031982
STAT,1896,28,40-44,1924,3.726893011225587
STAT,1870,15,15-19,1885,5.611673907347353
SIM,1910,56,na,1966,3046
SIM,1886,19,25-29,1905,5
SIM,1888,77,na,1965,1257
STAT,1874,63,na,1937,1722.8020124512418
STAT,1882,49,20-24,1931,0.01080068237357245
STAT,1848,12,na,1860,2131.97403065277
SIM,1897,22,35-39,1919,8
STAT,1893,31,15-19,1924,0.17138967457903884
STAT,1925,46,50-100,1971,0.25959316320885567
STAT,1912,30,na,1942,3543.1266443283785
STAT,1920,22,20-24,1942,116.78652818189786
SIM,1886,11,na,1897,2530
STAT,1856,48,50-100,1904,0.17943467098745086
STAT,1903,28,35-39,1931,12.922829726336849
SIM,1933,26,20-24,1959,19
SIM,1812,43,40-44,1855,8
SIM,1835,32,20-24,1867,2
SIM,1911,28,35-39,1939,15
STAT,1922,29,15-19,1951,0.7493083396136616
STAT,1838,75,na,1913,702.1181708430885
SIM,1845,18,25-29,1863,7
STAT,1832,50,25-29,1882,0.00232400131962344
STAT,1889,22,35-39,1911,6.8057570398506355
SIM,1809,65,na,1874,878
SIM,1948,18,20-24,1966,128
STAT,1833,35,na,1868,1659.4738345207486
STAT,1791,94,na,1885,4.043055568321273
STAT,1837,54,25-29,1891,0.002174508960481427
STAT,1871,34,40-44,1905,4.026750299029287
STAT,1939,32,na,1971,3645.0659885855684
STAT,1861,46,40-44,1907,0.1346837135344869
STAT,1939,25,45-49,1964,1.641960273584981
STAT,1904,19,na,1923,3403.3994152862815
STAT,1925,26,20-24,1951,20.440028846064344
SIM,1836,35,50-100,1871,4
SIM,1848,86,na,1934,123
STAT,1879,34,35-39,1913,9.914175658882025
STAT,1853,64,na,1917,1289.1802150707233
STAT,1874,30,35-39,1904,9.856598519493748
STAT,1866,17,15-19,1883,5.305485431116763
SIM,1931,0,na,1931,5158
STAT,1837,18,25-29,1855,4.985895604140269
STAT,1869,11,na,1880,2443.1871519424276
STAT,1832,49,50-100,1881,0.15614837267900844
STAT,1836,49,na,1885,1449.201720997472
SIM,1828,57,na,1885,1134
SIM,1890,19,na,1909,3001
SIM,1833,87,na,1920,89
STAT,1886,23,50-100,1909,0.4057677474233493
STAT,1827,32,20-24,1859,3.1453144679433236
STAT,1900,37,15-19,1937,0.015884959495717936
STAT,1936,0,na,1936,4073.9285833829595
SIM,1922,41,na,1963,4047
STAT,1816,72,na,1888,625.1017834076149
SIM,1812,88,na,1900,58
STAT,1885,45,15-19,1930,3.8022468567764717E-4
STAT,1913,45,45-49,1958,0.20129716804656658
STAT,1911,39,40-44,1950,1.3518772993458736
SIM,1882,30,35-39,1912,11
STAT,1893,30,45-49,1923,2.1069743168750144
STAT,1801,95,na,1896,5.059213011911389
STAT,1924,33,na,1957,4166.2126523761535
SIM,1942,18,na,1960,3474
SIM,1869,85,na,1954,207
SIM,1940,2,na,1942,3711
STAT,1919,41,30-34,1960,0.13107036971215735
STAT,1855,27,40-44,1882,2.211381406395712
STAT,1926,41,30-34,1967,0.1491226420951378
SIM,1846,20,na,1866,1900
STAT,1891,24,40-44,1915,2.421358075682098
STAT,1894,23,20-24,1917,83.48509042330898
STAT,1863,48,40-44,1911,0.14038047452113286
STAT,1845,40,25-29,1885,0.47256424220320764
STAT,1911,20,20-24,1931,100.1961666255399
STAT,1941,21,45-49,1962,1.0987424361731821
STAT,1875,19,15-19,1894,5.72881904487681
SIM,1929,32,50-100,1961,2
STAT,1869,43,15-19,1912,0.012536992887307781
SIM,1928,25,35-39,1953,24
SIM,1863,27,40-44,1890,1
STAT,1896,69,na,1965,2073.9267187890086
STAT,1945,2,na,1947,4172.70367985264
STAT,1770,95,na,1865,1.7635013142262825
STAT,1852,110,na,1962,7.550580411204002E-4
STAT,1857,33,45-49,1890,1.2932323627790459
SIM,1864,48,50-100,1912,6
STAT,1876,43,15-19,1919,0.013370820242230104
STAT,1850,26,15-19,1876,0.37859727868582294
STAT,1867,34,45-49,1901,1.5335282877277983
SIM,1857,54,na,1911,1642
SIM,1917,24,20-24,1941,100
STAT,1862,7,na,1869,2284.360432467823
STAT,1893,42,45-49,1935,1.7916883058754083
STAT,1766,103,na,1869,0.04766363458158478
STAT,1890,16,45-49,1906,0.0756345624999729
STAT,1888,24,35-39,1912,6.471685917607549
STAT,1872,15,40-44,1887,0.17606754232410776
STAT,1905,48,20-24,1953,0.009124626333701546
SIM,1825,40,40-44,1865,2
STAT,1913,24,40-44,1937,3.186723808726415
SIM,1873,37,45-49,1910,1
STAT,1894,35,15-19,1929,0.06888824639210747
SIM,1853,44,35-39,1897,2
STAT,1840,22,40-44,1862,1.8454937165578291
SIM,1831,25,45-49,1856,4
STAT,1884,31,40-44,1915,4.065041825107075
STAT,1915,21,40-44,1936,3.2930112831277465
STAT,1873,29,20-24,1902,11.168984866261695
SIM,1875,34,45-49,1909,1
SIM,1892,31,40-44,1923,6
STAT,1886,11,na,1897,2581.5111813948706
STAT,1829,41,15-19,1870,0.011798566329594013
STAT,1862,42,15-19,1904,0.011114782163404474
STAT,1836,51,30-34,1887,0.003879448124769833
STAT,1920,38,45-49,1958,0.7044459261252585
SIM,1880,66,na,1946,1712
STAT,1897,19,35-39,1916,0.6895298185945394
SIM,1853,28,30-34,1881,27
SIM,1853,64,na,1917,1372
STAT,1915,13,na,1928,3898.386747583662
STAT,1820,77,na,1897,460.49145000882925
STAT,1878,52,20-24,1930,7.218453634138007E-4
STAT,1824,67,na,1891,836.8962308395612
SIM,1915,27,20-24,1942,19
SIM,1949,17,20-24,1966,144
STAT,1911,23,na,1934,3407.7334242981133
SIM,1874,18,20-24,1892,16
STAT,1854,52,35-39,1906,0.006166331581889128
STAT,1857,15,45-49,1872,0.057858896565213924
STAT,1911,27,40-44,1938,4.293161760613403
SIM,1922,35,na,1957,4067
STAT,1819,38,30-34,1857,12.740460890037694
STAT,1909,24,20-24,1933,96.99339987702537
STAT,1884,48,35-39,1932,0.12905336667546
STAT,1864,95,na,1959,19.28534417570159
SIM,1931,28,15-19,1959,2
STAT,1845,28,30-34,1873,21.434882141594034
STAT,1843,49,30-34,1892,0.06837874072519465
SIM,1797,60,na,1857,1005
STAT,1847,41,35-39,1888,1.3570829420207127
STAT,1896,32,15-19,1928,0.17780056770225017
STAT,1866,18,20-24,1884,15.755945862854523
STAT,1923,28,15-19,1951,0.7630568304075159
STAT,1826,51,45-49,1877,0.013357056477494082
STAT,1950,10,na,1960,4389.31323659051
STAT,1925,43,na,1968,4241.554514086422
SIM,1878,44,40-44,1922,5
SIM,1892,51,na,1943,2605
STAT,1855,18,45-49,1873,0.05470207278629563
STAT,1878,16,na,1894,2489.9140147271823
STAT,1782,100,na,1882,0.1949362812251379
SIM,1848,18,na,1866,2103
SIM,1848,28,20-24,1876,12
STAT,1782,98,na,1880,0.5201569465632503
STAT,1865,37,45-49,1902,1.711298364939459
SIM,1857,20,35-39,1877,10
SIM,1842,25,20-24,1867,9
STAT,1883,48,50-100,1931,0.22453576176895898
STAT,1827,44,15-19,1871,0.012267140202768092
SIM,1774,91,na,1865,6
SIM,1839,40,40-44,1879,7
STAT,1883,62,na,1945,1692.236150560809
SIM,1840,28,20-24,1868,12
STAT,1813,51,35-39,1864,0.025358452057889894
SIM,1896,41,na,1937,2942
SIM,1907,17,15-19,1924,9
SIM,1878,26,40-44,1904,6
SIM,1933,25,15-19,1958,5
SIM,1807,95,na,1902,6
SIM,1934,20,na,1954,4562
STAT,1750,111,na,1861,0.03795529159698029
STAT,1922,17,45-49,1939,0.5461904671733255
STAT,1843,47,35-39,1890,0.1005328696368442
SIM,1837,43,40-44,1880,6
STAT,1850,75,na,1925,724.7436875420643
SIM,1827,38,30-34,1865,5
STAT,1834,25,20-24,1859,9.660293706473562
STAT,1872,23,50-100,1895,0.3854730024116885
STAT,1931,38,20-24,1969,0.32948228368493676
STAT,1898,31,40-44,1929,5.56857395964811
SIM,1871,26,25-29,1897,45
STAT,1832,28,20-24,1860,9.51504021184438
STAT,1876,37,20-24,1913,0.7517745385921055
STAT,1896,34,40-44,1930,5.368173186529201
SIM,1781,85,na,1866,70
STAT,1821,46,45-49,1867,0.36569208975412376
SIM,1894,29,30-34,1923,41
SIM,1930,30,na,1960,4550
SIM,1887,37,45-49,1924,3
STAT,1882,52,40-44,1934,0.009626024016079605
STAT,1879,37,45-49,1916,1.9684327269691162
SIM,1888,46,na,1934,2454
STAT,1817,40,40-44,1857,6.157611986179375
STAT,1863,26,25-29,1889,35.38171520256528
STAT,1924,33,50-100,1957,0.9107745284212556
SIM,1905,63,na,1968,2643
SIM,1917,22,25-29,1939,89
STAT,1807,83,na,1890,142.4051180330645
STAT,1871,31,30-34,1902,16.418607739741493
STAT,1827,28,50-100,1855,1.1535604695878632
STAT,1886,29,30-34,1915,24.95502018648169
STAT,1794,83,na,1877,128.90646395731866
SIM,1855,23,35-39,1878,5
STAT,1853,34,15-19,1887,0.10652177603035418
STAT,1847,23,35-39,1870,5.22584052037865
STAT,1868,47,40-44,1915,0.1536985611570091
STAT,1826,33,15-19,1859,0.17780815946749703
STAT,1923,46,15-19,1969,4.0814417087175667E-4
SIM,1909,53,na,1962,3082
STAT,1849,40,50-100,1889,0.774789421315362
STAT,1861,29,25-29,1890,32.94730168112348
SIM,1844,28,na,1872,1914
STAT,1929,33,na,1962,4535.804762334876
STAT,1925,25,15-19,1950,0.7931395140828335
SIM,1869,37,25-29,1906,3
SIM,1886,34,20-24,1920,1
STAT,1845,46,30-34,1891,0.06837770178727968
STAT,1849,90,na,1939,56.8275576671618
SIM,1838,87,na,1925,103
STAT,1831,49,na,1880,1434.089629709321
STAT,1860,45,15-19,1905,3.1016530218099604E-4
STAT,1880,42,35-39,1922,1.7977300136185388
STAT,1882,21,35-39,1903,5.380460651045894
STAT,1847,25,30-34,1872,22.593660353837713
SIM,1811,69,na,1880,698
SIM,1847,47,50-100,1894,2
STAT,1845,44,35-39,1889,1.2660100843058721
SIM,1849,59,na,1908,1447
SIM,1827,39,50-100,1866,1
STAT,1858,26,15-19,1884,0.3469433403058592
SIM,1926,25,na,1951,4125
STAT,1912,43,35-39,1955,0.1823273251722649
STAT,1867,52,45-49,1919,0.012803991222874428
STAT,1878,34,20-24,1912,2.6355703865264264
SIM,1836,92,na,1928,20
SIM,1874,26,na,1900,2288
SIM,1896,36,50-100,1932,1
STAT,1841,39,na,1880,1691.049584021047
SIM,1890,21,35-39,1911,8
STAT,1855,31,15-19,1886,0.10376652041413846
STAT,1829,32,50-100,1861,0.8941133102230002
STAT,1907,18,na,1925,3495.01427654842
SIM,1838,28,35-39,1866,8
SIM,1855,25,30-34,1880,28
SIM,1959,12,na,1971,4855
STAT,1918,3,na,1921,4170.524098782103
STAT,1786,88,na,1874,43.95608089121606
SIM,1919,38,45-49,1957,2
STAT,1801,98,na,1899,1.2361336120996402
SIM,1846,82,na,1928,279
SIM,1822,35,50-100,1857,3
SIM,1865,30,40-44,1895,5
SIM,1826,39,25-29,1865,2
SIM,1862,33,20-24,1895,2
STAT,1827,46,40-44,1873,0.15200178386949495
STAT,1950,17,20-24,1967,151.45115565030406
SIM,1868,38,na,1906,2107
SIM,1846,36,45-49,1882,2
STAT,1830,33,35-39,1863,8.33616138125018
STAT,1866,62,na,1928,1591.9337806966273
STAT,1844,46,40-44,1890,0.12052519620916756
STAT,1880,24,35-39,1904,5.764146111240906
SIM,1884,24,15-19,1908,2
SIM,1839,22,40-44,1861,4
STAT,1860,18,25-29,1878,4.988180507651593
STAT,1903,32,30-34,1935,23.4664373134703
STAT,1778,114,na,1892,1.0327622917558487E-4
STAT,1876,24,15-19,1900,3.1972495658800355
SIM,1843,39,25-29,1882,5
SIM,1845,33,20-24,1878,5
STAT,1824,36,45-49,1860,3.144015542225969
SIM,1837,28,45-49,1865,4
STAT,1917,48,40-44,1965,0.15513275399264065
STAT,1908,31,na,1939,3385.5134803512838
SIM,1869,79,na,1948,592
STAT,1862,47,45-49,1909,0.18929111003472215
STAT,1866,90,na,1956,77.38468872983957
STAT,1846,110,na,1956,2.1002775084494094E-4
STAT,1923,48,na,1971,4049.0753701933577
STAT,1812,42,na,1854,1374.3840881003916
SIM,1861,99,na,1960,3
STAT,1891,27,45-49,1918,1.2982849077311387
STAT,1860,30,40-44,1890,3.3563194886196417
SIM,1863,36,45-49,1899,3
SIM,1873,13,na,1886,2505
STAT,1835,39,25-29,1874,2.175269671525055
STAT,1897,54,na,1951,2645.609953670114
SIM,1821,33,35-39,1854,11
SIM,1837,46,na,1883,1528
STAT,1855,36,45-49,1891,1.418655991400969
STAT,1813,83,na,1896,167.89668929883044
STAT,1848,22,40-44,1870,1.8278950347042326
STAT,1919,25,50-100,1944,1.0228792595083396
SIM,1842,21,na,1863,1859
SIM,1920,40,na,1960,3830
SIM,1941,17,20-24,1958,104
STAT,1935,33,na,1968,4939.738319225585
STAT,1891,27,15-19,1918,0.5305174310531872
SIM,1838,16,na,1854,1941
SIM,1851,97,na,1948,3
STAT,1829,46,45-49,1875,0.19293265164352644
STAT,1788,83,na,1871,130.2549633111035
STAT,1870,50,25-29,1920,0.0033258500450409514
STAT,1894,37,40-44,1931,5.3196301177098055
STAT,1905,32,35-39,1937,7.938326412680892
STAT,1838,49,20-24,1887,0.008207130255997936
STAT,1844,47,25-29,1891,0.0402472150015837
STAT,1849,20,35-39,1869,5.159194473891673
STAT,1837,33,20-24,1870,2.1173322680710673
SIM,1842,92,na,1934,18
SIM,1910,10,na,1920,3643
STAT,1839,47,15-19,1886,2.71741589069726E-4
STAT,1850,44,45-49,1894,1.0394160165573267
SIM,1879,29,35-39,1908,8
STAT,1848,40,40-44,1888,1.6604420060313245
STAT,1824,36,15-19,1860,0.08856382862327622
SIM,1911,32,30-34,1943,22
STAT,1899,42,40-44,1941,0.2019623269554562
STAT,1837,51,20-24,1888,4.768729453610276E-4
SIM,1856,22,40-44,1878,3
STAT,1852,70,na,1922,1066.016982087795
STAT,1933,17,20-24,1950,171.45138745786204
SIM,1913,32,35-39,1945,8
STAT,1928,38,45-49,1966,0.8131593223649705
STAT,1886,47,30-34,1933,0.09616797797055812
SIM,1868,23,15-19,1891,2
STAT,1809,49,25-29,1858,0.202559872907655
STAT,1926,38,40-44,1964,1.7267861894434011
STAT,1820,43,20-24,1863,0.277843029079438
STAT,1845,29,na,1874,1828.1589250530546
STAT,1800,57,na,1857,1036.5147582339027
STAT,1881,53,35-39,1934,0.007726617946395187
SIM,1830,36,na,1866,1695
STAT,1867,34,15-19,1901,0.12523421093505663
STAT,1772,96,na,1868,1.2688855188062556
STAT,1913,27,50-100,1940,0.936709017769621
STAT,1843,34,na,1877,1841.084247260491
SIM,1881,15,30-34,1896,2
SIM,1871,23,20-24,1894,63
STAT,1839,29,na,1868,1791.11064661701
SIM,1938,22,na,1960,3336
SIM,1883,26,20-24,1909,15
SIM,1867,84,na,1951,251
STAT,1878,19,25-29,1897,5.543071765250822
STAT,1886,45,35-39,1931,0.14113050319949375
STAT,1899,1,na,1900,3523.7650137545183
STAT,1913,42,40-44,1955,0.23037465018467343
SIM,1906,24,45-49,1930,1
STAT,1896,37,45-49,1933,2.488932361435122
SIM,1877,29,30-34,1906,33
STAT,1939,22,35-39,1961,8.932251387627959
SIM,1834,100,na,1934,1
STAT,1922,7,na,1929,4370.614644328299
STAT,1829,28,45-49,1857,1.3597342043615095
STAT,1907,27,20-24,1934,16.27700203020022
SIM,1936,7,na,1943,3014
STAT,1869,45,35-39,1914,0.12929746723813498
STAT,1889,46,50-100,1935,0.28724965010583675
SIM,1789,65,na,1854,762
SIM,1855,4,na,1859,2423
SIM,1861,36,40-44,1897,3
STAT,1870,34,20-24,1904,2.4807166982775537
SIM,1815,90,na,1905,28
STAT,1853,36,40-44,1889,3.2802756202781205
SIM,1838,45,50-100,1883,1
STAT,1861,17,50-100,1878,0.04417427203586248
SIM,1851,30,40-44,1881,2
STAT,1815,45,50-100,1860,0.617761337944511
SIM,1855,99,na,1954,3
STAT,1868,97,na,1965,17.992698350328006
STAT,1881,23,40-44,1904,1.894860415024841
STAT,1917,48,na,1965,3614.839663276598
STAT,1885,48,25-29,1933,0.053530755869791655
STAT,1918,16,40-44,1934,0.28925065707856207
SIM,1828,33,50-100,1861,4
STAT,1908,19,50-100,1927,0.06827103789111494
STAT,1933,35,50-100,1968,0.5411841916559582
SIM,1890,56,na,1946,2409
STAT,1840,20,15-19,1860,2.9641429165508435
STAT,1857,30,40-44,1887,3.3179067750206466
STAT,1861,44,20-24,1905,0.12290345161822455
STAT,1841,54,45-49,1895,0.009656223049904338
STAT,1819,54,35-39,1873,0.014128670950439117
STAT,1873,15,30-34,1888,1.5465392628779648
SIM,1832,36,45-49,1868,1
STAT,1879,32,15-19,1911,0.14061790579836936
STAT,1937,28,45-49,1965,1.589938785250712
STAT,1875,26,20-24,1901,11.4248926727473
STAT,1818,39,25-29,1857,7.990218761774096
STAT,1896,19,45-49,1915,0.08111987660224594
STAT,1765,113,na,1878,4.401053511242763E-4
STAT,1824,54,45-49,1878,0.015780171573435836
SIM,1947,22,35-39,1969,15
STAT,1880,26,na,1906,2380.341103391937
SIM,1884,56,na,1940,1988
STAT,1868,15,20-24,1883,16.473742889035588
STAT,1918,46,35-39,1964,0.12993242468626687
STAT,1924,27,20-24,1951,20.08013935294613
SIM,1898,21,35-39,1919,9
STAT,1923,39,50-100,1962,0.4586366361698859
SIM,1793,70,na,1863,557
SIM,1932,27,20-24,1959,17
STAT,1849,39,25-29,1888,2.0799330738206416
SIM,1857,39,25-29,1896,1
SIM,1822,32,40-44,1854,4
STAT,1801,70,na,1871,692.5330648555954
STAT,1826,62,na,1888,1022.2878718499513
STAT,1843,30,40-44,1873,3.840285764850819
SIM,1873,84,na,1957,339
STAT,1847,39,20-24,1886,0.5763813292540281
STAT,1854,33,20-24,1887,1.972698797787268
SIM,1818,37,50-100,1855,3
SIM,1876,15,20-24,1891,15
SIM,1868,39,30-34,1907,4
STAT,1838,36,45-49,1874,1.6577327041442116
SIM,1921,24,40-44,1945,5
STAT,1891,45,45-49,1936,0.15721427095200063
SIM,1849,31,na,1880,1852
STAT,1830,35,30-34,1865,4.34526806915787
SIM,1934,24,20-24,1958,130
STAT,1833,75,na,1908,624.9761755868725
STAT,1855,59,na,1914,1376.4328138552464
SIM,1859,15,20-24,1874,22
SIM,1917,20,na,1937,3627
STAT,1877,62,na,1939,1791.7558669554926
STAT,1878,87,na,1965,362.2603429968393
STAT,1823,38,20-24,1861,1.15891931785979
STAT,1930,24,40-44,1954,4.043916388727326
STAT,1847,28,35-39,1875,8.472054537058279
SIM,1881,31,35-39,1912,9
STAT,1846,41,15-19,1887,0.009981875857091631
STAT,1890,29,20-24,1919,13.453297746066587
STAT,1848,46,50-100,1894,0.17743837373501237
STAT,1868,18,25-29,1886,5.173152145849269
STAT,1868,25,50-100,1893,0.580902317976215
SIM,1872,25,30-34,1897,29
SIM,1908,16,20-24,1924,22
SIM,1818,67,na,1885,721
STAT,1840,25,45-49,1865,0.9781046348862856
STAT,1833,26,15-19,1859,0.3683934222035827
STAT,1897,16,30-34,1913,2.0186648773011475
STAT,1862,41,30-34,1903,0.930638105865178
SIM,1938,17,15-19,1955,40
SIM,1872,99,na,1971,17
STAT,1855,90,na,1945,55.837790273107686
STAT,1864,26,45-49,1890,0.9406579272034447
STAT,1943,23,50-100,1966,0.6610981784855398
SIM,1870,28,30-34,1898,31
STAT,1837,65,na,1902,1066.80186105487
SIM,1838,25,30-34,1863,23
SIM,1876,18,25-29,1894,10
STAT,1861,26,20-24,1887,9.336951164935838
SIM,1862,13,na,1875,2374
SIM,1882,49,50-100,1931,3
STAT,1885,47,40-44,1932,0.16037871036748688
SIM,1842,28,25-29,1870,45
STAT,1966,2,na,1968,4642.162983243124
STAT,1838,18,45-49,1856,0.058502222431375865
STAT,1855,15,40-44,1870,0.15590447908886357
STAT,1873,31,35-39,1904,9.75061292298042
STAT,1845,60,na,1905,1343.3817864556424
SIM,1929,42,40-44,1971,3
STAT,1874,15,45-49,1889,0.06360044818129923
STAT,1862,28,30-34,1890,20.22109779857913
SIM,1916,48,50-100,1964,2
SIM,1850,28,na,1878,1841
SIM,1853,3,na,1856,2578
SIM,1906,21,40-44,1927,2
STAT,1928,27,50-100,1955,1.1585555912911172
SIM,1855,28,35-39,1883,8
STAT,1874,45,45-49,1919,0.23013716209182308
SIM,1872,26,45-49,1898,5
STAT,1839,47,45-49,1886,0.16032767249622262
SIM,1809,90,na,1899,35
SIM,1826,62,na,1888,1010
STAT,1846,26,25-29,1872,36.34250185738072
SIM,1880,26,na,1906,2460
STAT,1874,97,na,1971,32.1706890357186
STAT,1844,29,25-29,1873,35.83274615287369
STAT,1871,36,30-34,1907,5.015404965419839
STAT,1939,33,50-100,1972,0.7963527637762077
SIM,1899,20,40-44,1919,2
SIM,1814,40,35-39,1854,4
SIM,1817,85,na,1902,141
STAT,1858,3,na,1861,2447.6418022915555
STAT,1851,69,na,1920,1076.1736865471387
SIM,1942,15,15-19,1957,43
STAT,1865,19,15-19,1884,5.188113188213695
SIM,1873,19,15-19,1892,7
STAT,1865,77,na,1942,742.0329729497001
SIM,1890,19,20-24,1909,26
STAT,1934,15,15-19,1949,58.25859419735899
STAT,1942,25,15-19,1967,0.70053229104697
STAT,1872,62,na,1934,1733.058880127714
SIM,1844,87,na,1931,105
STAT,1807,54,45-49,1861,0.04936917593007804
STAT,1821,43,40-44,1864,3.6422315024689143
STAT,1902,46,na,1948,3008.4460892110424
SIM,1852,29,25-29,1881,45
SIM,1884,84,na,1968,497
STAT,1864,25,30-34,1889,21.48860050388193
SIM,1775,85,na,1860,78
STAT,1882,19,20-24,1901,16.209556521286785
STAT,1826,47,35-39,1873,0.13090097130706516
STAT,1850,26,45-49,1876,0.9265051518667355
STAT,1922,29,50-100,1951,1.0564781977017121
SIM,1844,38,30-34,1882,7
SIM,1852,82,na,1934,333
SIM,1938,8,na,1946,3642
STAT,1868,48,25-29,1916,0.051301074413066604
STAT,1842,80,na,1922,440.5102036940594
STAT,1761,96,na,1857,0.9176929650089278
STAT,1944,22,15-19,1966,5.429491223319945
SIM,1875,16,15-19,1891,7
SIM,1898,19,20-24,1917,24
SIM,1892,11,na,1903,3122
SIM,1820,38,45-49,1858,1
SIM,1938,30,45-49,1968,2
STAT,1891,69,na,1960,1844.7623683562144
STAT,1870,19,25-29,1889,5.233289353358469
STAT,1813,103,na,1916,0.06069643875603353
STAT,1881,21,15-19,1902,3.018269891924414
SIM,1878,29,45-49,1907,1
SIM,1863,54,na,1917,1812
SIM,1930,29,50-100,1959,1
SIM,1924,17,15-19,1941,40
SIM,1949,22,na,1971,4001
SIM,1855,59,na,1914,1498
STAT,1814,77,na,1891,356.64469952071624
SIM,1837,35,50-100,1872,2
SIM,1874,20,35-39,1894,3
SIM,1885,37,40-44,1922,4
STAT,1820,46,25-29,1866,0.09637826611682151
SIM,1867,44,na,1911,1984
STAT,1834,40,50-100,1874,0.8088079961675336
STAT,1825,49,na,1874,1420.5984490381863
STAT,1838,31,15-19,1869,0.1219507423195475
SIM,1804,59,na,1863,976
STAT,1867,16,15-19,1883,5.413219358731399
STAT,1888,29,35-39,1917,10.69133905847325
STAT,1871,32,15-19,1903,0.1333709744982197
SIM,1840,30,35-39,1870,8
STAT,1838,35,30-34,1873,4.478200776855025
STAT,1874,27,15-19,1901,0.43806410808498825
STAT,1844,31,50-100,1875,0.7772035580759258
SIM,1911,35,35-39,1946,9
SIM,1914,40,na,1954,3784
STAT,1908,25,15-19,1933,0.6399637408671314
SIM,1849,44,45-49,1893,1
STAT,1895,19,30-34,1914,1.9543844385669367
STAT,1919,45,40-44,1964,0.16230937672584078
STAT,1893,38,35-39,1931,8.43566747204041
STAT,1839,29,15-19,1868,0.3756494917023297
STAT,1858,95,na,1953,9.86036498341392
SIM,1909,25,na,1934,3389
STAT,1872,18,45-49,1890,0.06177666973908963
SIM,1802,80,na,1882,215
STAT,1867,16,na,1883,2303.739662166587
STAT,1872,16,25-29,1888,5.422819870555149
STAT,1834,28,25-29,1862,34.08828058035902
SIM,1836,28,30-34,1864,25
SIM,1908,34,20-24,1942,2
STAT,1828,28,30-34,1856,36.62950450349445
STAT,1796,78,na,1874,332.466562195356
STAT,1866,20,35-39,1886,5.198522211068917
STAT,1793,98,na,1891,0.5908660725115851
STAT,1911,51,na,1962,3243.0458926745378
STAT,1914,22,35-39,1936,9.086150399513095
STAT,1826,51,50-100,1877,0.013900394345274918
SIM,1922,22,35-39,1944,10
STAT,1821,40,30-34,1861,2.0377607673170415
STAT,1906,36,na,1942,3282.198378941847
STAT,1836,38,30-34,1874,4.0883645391692145
SIM,1880,16,25-29,1896,9
SIM,1861,28,na,1889,2063
STAT,1916,17,15-19,1933,9.095909131036088
STAT,1862,44,40-44,1906,1.7880855235751576
STAT,1903,35,35-39,1938,2.0713250004644994
STAT,1854,36,25-29,1890,2.0832721381601305
STAT,1828,38,50-100,1866,1.1403231776293326
STAT,1870,36,40-44,1906,4.071623881791572
SIM,1839,38,20-24,1877,2
SIM,1890,38,50-100,1928,1
STAT,1898,29,20-24,1927,14.895270239475572
SIM,1902,15,na,1917,3406
SIM,1891,20,40-44,1911,2
STAT,1889,59,na,1948,2266.6078293308306
SIM,1900,16,20-24,1916,20
STAT,1866,50,35-39,1916,0.007606151257926754
SIM,1883,40,50-100,1923,1
STAT,1831,47,45-49,1878,0.17351614034851776
STAT,1860,15,20-24,1875,15.884706432437818
SIM,1914,31,40-44,1945,12
SIM,1939,4,na,1943,3740
SIM,1937,15,35-39,1952,5
STAT,1832,30,35-39,1862,8.194659107901108
STAT,1880,21,30-34,1901,17.758835437821226
STAT,1887,40,25-29,1927,0.6852823443823384
STAT,1800,85,na,1885,90.52061745512404
STAT,1864,21,15-19,1885,2.850660802833014
SIM,1843,34,na,1877,1782
STAT,1827,49,45-49,1876,0.2013389981405529
SIM,1832,31,na,1863,1718
SIM,1828,97,na,1925,1
STAT,1854,18,30-34,1872,1.3648795318585312
SIM,1935,21,30-34,1956,40
STAT,1887,27,25-29,1914,44.691304073580184
STAT,1826,93,na,1919,15.951720767674535
STAT,1829,43,40-44,1872,1.8635790808975718
STAT,1813,49,15-19,1862,0.0011696129561334938
STAT,1875,40,50-100,1915,1.0356726425911693
SIM,1862,36,25-29,1898,4
SIM,1791,75,na,1866,375
SIM,1872,21,15-19,1893,2
STAT,1809,46,20-24,1855,0.04458828345889393
STAT,1893,24,15-19,1917,3.9295086617044768
STAT,1909,22,25-29,1931,81.0799962869046
SIM,1929,24,40-44,1953,3
STAT,1835,54,20-24,1889,4.5099004508422397E-4
SIM,1852,7,na,1859,2354
SIM,1822,35,45-49,1857,1
STAT,1818,67,na,1885,823.0635108604046
STAT,1842,48,50-100,1890,0.17269729081211435
STAT,1890,47,20-24,1937,0.007781927726685544
STAT,1913,58,na,1971,3212.7064760807125
STAT,1862,27,50-100,1889,0.5173886592947814
SIM,1837,25,40-44,1862,2
STAT,1852,41,45-49,1893,1.1422509556066613
STAT,1835,39,na,1874,1618.0835131960175
STAT,1884,56,na,1940,1904.0793672212167
SIM,1895,27,25-29,1922,65
STAT,1927,21,30-34,1948,33.55703536699241
STAT,1852,23,45-49,1875,0.6248653408850143
STAT,1896,16,40-44,1912,0.22892121649462543
STAT,1921,49,15-19,1970,3.900365349410869E-4
SIM,1846,35,30-34,1881,6
SIM,1865,18,na,1883,2202
SIM,1866,41,40-44,1907,4
STAT,1896,41,na,1937,2908.725055037765
STAT,1913,18,na,1931,3719.8953558132575
STAT,1947,22,50-100,1969,0.7025685256726172
SIM,1820,46,na,1866,1366
STAT,1918,32,15-19,1950,0.12899850172014843
STAT,1877,52,30-34,1929,0.005804320579150574
STAT,1853,39,45-49,1892,1.4635060643579765
STAT,1882,38,50-100,1920,1.1230047529064386
STAT,1906,31,40-44,1937,3.43946154994565
STAT,1860,33,45-49,1893,1.3331864677238152
STAT,1929,15,35-39,1944,5.082779072003024
STAT,1881,26,45-49,1907,1.0162318190082404
STAT,1963,5,na,1968,4717.528635732177
SIM,1863,94,na,1957,19
SIM,1865,28,20-24,1893,8
STAT,1848,43,45-49,1891,1.070426022265921
STAT,1802,52,na,1854,1116.8318064294044
SIM,1896,2,na,1898,3393
SIM,1874,32,35-39,1906,10
STAT,1819,39,45-49,1858,4.400557592841713
STAT,1828,46,25-29,1874,0.04916247673639653
STAT,1829,25,40-44,1854,8.594742824749048
SIM,1856,13,na,1869,2238
SIM,1906,21,35-39,1927,18
STAT,1895,59,na,1954,2395.9021888523603
STAT,1776,86,na,1862,56.2528931777919
STAT,1853,28,50-100,1881,0.4965199397121395
STAT,1830,31,15-19,1861,0.12109103341899163
SIM,1785,75,na,1860,302
STAT,1863,41,20-24,1904,0.13247722690254995
STAT,1847,24,na,1871,1901.0070834411047
STAT,1873,18,35-39,1891,0.5247832228166002
STAT,1888,42,35-39,1930,2.01839852569089
STAT,1911,45,40-44,1956,0.14163641004247063
SIM,1883,29,25-29,1912,49
STAT,1929,33,35-39,1962,10.959621517967625
SIM,1905,35,na,1940,3263
STAT,1875,29,25-29,1904,40.76170860785116
SIM,1834,97,na,1931,4
SIM,1850,6,na,1856,2210
SIM,1866,99,na,1965,7
STAT,1868,45,15-19,1913,3.64387436282053E-4
STAT,1887,23,50-100,1910,0.429497887179701
SIM,1841,49,50-100,1890,6
STAT,1861,47,25-29,1908,0.044975196442964924
STAT,1891,37,50-100,1928,1.4356078702236577
SIM,1862,18,30-34,1880,2
SIM,1834,33,45-49,1867,1
STAT,1833,49,50-100,1882,0.1552684768277661
STAT,1870,54,40-44,1924,0.009477139478289966
SIM,1848,46,na,1894,1694
STAT,1897,35,50-100,1932,1.5658805242101839
STAT,1876,21,na,1897,2313.4900251678855
SIM,1860,23,15-19,1883,5
STAT,1918,43,30-34,1961,0.12820426442760738
SIM,1854,26,25-29,1880,40
SIM,1927,19,na,1946,4218
STAT,1822,40,20-24,1862,0.25270809457539817
STAT,1853,103,na,1956,0.1291914799139712
STAT,1942,2,na,1944,4008.2238666077706
STAT,1838,34,50-100,1872,0.7605611758976498
STAT,1857,28,20-24,1885,8.934639125720366
SIM,1879,26,30-34,1905,24
STAT,1883,20,40-44,1903,1.9408415518662119
SIM,1851,69,na,1920,1050
STAT,1773,81,na,1854,133.0
SIM,1870,44,40-44,1914,6
STAT,1878,21,50-100,1899,0.4022532896539934
STAT,1849,36,20-24,1885,0.5744814183097272
STAT,1942,15,na,1957,3635.5408910496762
SIM,1827,39,45-49,1866,3
STAT,1881,50,30-34,1931,0.005507607550396598
SIM,1904,27,45-49,1931,1
STAT,1943,22,25-29,1965,92.83558834567086
STAT,1866,104,na,1970,0.6021377488404047
SIM,1863,33,40-44,1896,4
STAT,1871,77,na,1948,809.5408048497028
STAT,1864,39,20-24,1903,0.6442856378444602
STAT,1826,33,45-49,1859,2.177311138037383
STAT,1852,23,15-19,1875,2.9562340458537997
STAT,1829,39,na,1868,1644.1668894709792
SIM,1826,90,na,1916,90
STAT,1879,36,30-34,1915,5.287925244765273
SIM,1888,32,35-39,1920,10
STAT,1879,19,45-49,1898,0.06415562848782519
STAT,1867,48,35-39,1915,0.1226197407611939
STAT,1932,21,40-44,1953,4.180382421085364
STAT,1926,24,20-24,1950,126.83280446081439
STAT,1848,25,45-49,1873,0.9687774005887891
STAT,1872,48,45-49,1920,0.22096399412559303
SIM,1859,18,na,1877,2196
SIM,1937,33,35-39,1970,17
STAT,1841,51,40-44,1892,0.00723739240368576
STAT,1921,30,25-29,1951,9.795702335642362
STAT,1893,24,45-49,1917,0.8305884213905085
STAT,1921,49,45-49,1970,0.23012174930481705
SIM,1940,21,40-44,1961,3
STAT,1918,19,45-49,1937,0.5108830148826845
SIM,1857,18,20-24,1875,21
SIM,1874,41,50-100,1915,1
STAT,1831,29,15-19,1860,0.3808619122008704
SIM,1816,38,25-29,1854,2
SIM,1861,28,50-100,1889,1
STAT,1835,36,20-24,1871,0.6008135655097566
STAT,1849,18,20-24,1867,15.63674937424875
STAT,1855,33,40-44,1888,3.0950359995729237
SIM,1896,24,35-39,1920,10
SIM,1779,75,na,1854,335
SIM,1832,62,na,1894,1120
SIM,1887,36,30-34,1923,11
SIM,1829,33,35-39,1862,7
SIM,1911,35,na,1946,3482
SIM,1840,97,na,1937,4
SIM,1925,16,20-24,1941,141
SIM,1939,28,20-24,1967,15
STAT,1854,51,20-24,1905,5.3391390017635E-4
STAT,1913,39,15-19,1952,0.017718654420469777
STAT,1935,28,40-44,1963,5.99903142238474
STAT,1811,57,na,1868,1094.943828968186
STAT,1864,23,40-44,1887,1.7748390505366463
SIM,1879,21,30-34,1900,16
STAT,1823,52,35-39,1875,0.009879478223490413
STAT,1842,24,50-100,1866,0.3610299611071717
STAT,1889,38,45-49,1927,2.3134159964907055
STAT,1844,26,20-24,1870,10.154658617358299
STAT,1845,29,45-49,1874,0.9383064197931147
STAT,1840,38,20-24,1878,0.6283820267884908
SIM,1879,38,na,1917,2303
STAT,1916,38,na,1954,3621.457001345516
STAT,1947,17,15-19,1964,48.29799381455938
STAT,1837,62,na,1899,1153.769366948674
STAT,1819,53,20-24,1872,0.0012354180744319164
SIM,1849,41,40-44,1890,6
SIM,1871,58,na,1929,1866
SIM,1883,43,na,1926,2176
STAT,1895,28,na,1923,2931.749130964435
STAT,1803,109,na,1912,2.3505027250303166E-4
SIM,1761,93,na,1854,2
SIM,1798,73,na,1871,478
SIM,1863,16,25-29,1879,7
STAT,1796,100,na,1896,0.24733406930625929
STAT,1874,57,na,1931,1940.362096419888
SIM,1954,12,na,1966,4435
STAT,1837,53,40-44,1890,0.006539174504567237
SIM,1833,31,35-39,1864,8
STAT,1846,14,na,1860,2095.2528905220306
STAT,1872,31,15-19,1903,0.13558310793628656
STAT,1943,24,20-24,1967,111.67986770259765
STAT,1857,45,45-49,1902,0.17751344677580633
STAT,1848,19,15-19,1867,5.237729200773551
STAT,1917,16,20-24,1933,27.627678474552734
STAT,1856,32,na,1888,1787.2342396981107
STAT,1864,28,35-39,1892,8.118017779569143
SIM,1893,61,na,1954,2279
SIM,1886,19,30-34,1905,1
SIM,1923,18,15-19,1941,45
STAT,1855,16,25-29,1871,4.80180444363412
STAT,1932,24,45-49,1956,1.3899077072372399
STAT,1825,38,25-29,1863,3.5403599056688386
STAT,1862,44,35-39,1906,1.4395254901910395
SIM,1864,29,20-24,1893,12
STAT,1951,20,na,1971,4124.730187224533
STAT,1829,30,na,1859,1778.5534204907922
STAT,1869,42,30-34,1911,1.0500046115608659
STAT,1934,24,50-100,1958,0.8347761979765538
SIM,1852,26,20-24,1878,13
SIM,1872,23,40-44,1895,1
SIM,1896,22,15-19,1918,4
SIM,1888,33,40-44,1921,6
STAT,1923,18,50-100,1941,0.4145516391009181
STAT,1928,23,na,1951,4294.4018148895075
STAT,1847,55,na,1902,1521.4002783130672
SIM,1865,30,35-39,1895,8
STAT,1821,45,30-34,1866,0.15220964459610317
STAT,1895,37,25-29,1932,3.549473667364706
STAT,1891,38,na,1929,2741.195842647693
SIM,1847,92,na,1939,22
STAT,1876,38,35-39,1914,6.863691235939539
SIM,1884,38,35-39,1922,12
STAT,1850,44,na,1894,1605.1551072867012
STAT,1883,17,15-19,1900,5.494605384055025
STAT,1905,51,na,1956,2970.519489695443
SIM,1891,17,15-19,1908,5
STAT,1917,34,20-24,1951,2.3921628320643116
SIM,1877,42,30-34,1919,8
SIM,1836,52,na,1888,1351
SIM,1853,29,45-49,1882,2
STAT,1892,29,25-29,1921,49.68520223728726
SIM,1928,28,45-49,1956,4
SIM,1942,27,na,1969,3555
SIM,1853,33,na,1886,1943
SIM,1909,31,30-34,1940,18
STAT,1857,30,35-39,1887,7.747949613774006
STAT,1849,36,15-19,1885,0.041849645009762036
SIM,1861,38,30-34,1899,4
SIM,1923,20,na,1943,3920
STAT,1865,80,na,1945,531.0307900971136
STAT,1909,38,40-44,1947,1.331597189459315
SIM,1870,44,35-39,1914,3
STAT,1884,87,na,1971,421.52493022559304
SIM,1847,32,40-44,1879,4
STAT,1915,18,15-19,1933,8.948809050826112
SIM,1889,31,na,1920,2817
SIM,1920,22,30-34,1942,39
SIM,1911,21,15-19,1932,4
SIM,1860,18,na,1878,2218
STAT,1930,39,45-49,1969,0.8382876293899982
STAT,1869,17,30-34,1886,1.477675525499898
SIM,1882,30,40-44,1912,4
STAT,1825,31,35-39,1856,19.74063300050286
STAT,1870,16,20-24,1886,16.665247964981603
STAT,1833,26,45-49,1859,0.9015342233050702
SIM,1932,33,50-100,1965,4
SIM,1930,32,35-39,1962,13
STAT,1892,40,35-39,1932,2.163820613570605
STAT,1939,20,45-49,1959,1.0681129072540345
SIM,1856,44,na,1900,1811
STAT,1884,34,15-19,1918,0.13180501315517865
STAT,1851,28,25-29,1879,36.05971184667539
STAT,1852,101,na,1953,0.43354402586332247
STAT,1853,50,25-29,1903,0.002664532498540097
SIM,1844,56,na,1900,1436
SIM,1927,10,na,1937,4588
STAT,1817,43,15-19,1860,0.03353045208130501
STAT,1871,19,45-49,1890,0.06084928261722278
STAT,1919,41,25-29,1960,0.07321047707570022
STAT,1922,44,35-39,1966,0.21763445831450534
SIM,1894,1,na,1895,3416
STAT,1853,38,30-34,1891,3.9328524439552974
STAT,1839,32,40-44,1871,3.558449407458217
STAT,1859,26,50-100,1885,0.49415243320100016
STAT,1873,16,na,1889,2436.173813559035
STAT,1903,21,15-19,1924,4.4473839691101125
STAT,1888,33,50-100,1921,1.018224225877827
SIM,1834,30,50-100,1864,5
SIM,1889,43,35-39,1932,2
STAT,1821,43,35-39,1864,2.932233956291762
STAT,1889,26,45-49,1915,1.299359257058083
STAT,1857,54,na,1911,1559.4761015153238
STAT,1869,47,25-29,1916,0.052426001344212096
STAT,1886,42,na,1928,2304.064049471262
STAT,1892,22,35-39,1914,6.9034125265853765
STAT,1889,44,45-49,1933,1.721928709592901
STAT,1922,32,35-39,1954,9.754887528987686
STAT,1890,43,35-39,1933,2.0764300235947974
STAT,1882,49,15-19,1931,3.60022429097753E-4
SIM,1846,38,35-39,1884,11
STAT,1886,44,20-24,1930,0.15637546618874346
STAT,1901,61,na,1962,2619.029445065023
SIM,1857,40,50-100,1897,4
SIM,1856,19,15-19,1875,8
SIM,1852,51,na,1903,1665
STAT,1888,36,50-100,1924,1.3767681114774426
SIM,1948,21,40-44,1969,5
SIM,1917,38,40-44,1955,2
STAT,1910,10,na,1920,3706.911887653661
STAT,1864,34,50-100,1898,0.7669727626812608
STAT,1806,70,na,1876,665.7657332174226
STAT,1868,45,20-24,1913,0.010931632704289719
STAT,1862,46,30-34,1908,0.07822657319376845
SIM,1843,37,35-39,1880,7
SIM,1900,19,25-29,1919,7
SIM,1929,27,45-49,1956,2
STAT,1834,29,na,1863,1730.608476750473
SIM,1805,60,na,1865,973
SIM,1877,17,30-34,1894,1
STAT,1912,22,30-34,1934,26.014989178124317
STAT,1839,47,50-100,1886,0.166849475849165
STAT,1839,50,40-44,1889,0.007194207262489752
SIM,1855,21,15-19,1876,3
STAT,1838,38,35-39,1876,5.760773618142031
STAT,1869,29,30-34,1898,22.86267555092364
SIM,1892,16,15-19,1908,6
STAT,1841,50,50-100,1891,0.010481666072935334
SIM,1873,44,na,1917,2192
SIM,1919,23,40-44,1942,5
SIM,1878,24,20-24,1902,72
SIM,1947,20,45-49,1967,2
STAT,1848,37,15-19,1885,0.041689743036972725
STAT,1877,39,30-34,1916,5.172091550408077
STAT,1893,44,50-100,1937,0.08674615990166237
STAT,1833,22,50-100,1855,0.354579445492009
STAT,1825,41,50-100,1866,1.2067189793974564
SIM,1821,35,25-29,1856,2
STAT,1839,44,50-100,1883,0.7236383354612228
STAT,1822,42,40-44,1864,3.392310592761862
STAT,1823,45,na,1868,1406.3474210709178
STAT,1894,39,30-34,1933,6.411426705956606
SIM,1869,25,25-29,1894,34
STAT,1826,30,40-44,1856,6.544911151903666
SIM,1873,22,40-44,1895,3
SIM,1914,34,45-49,1948,2
STAT,1870,39,45-49,1909,1.8267376032116498
SIM,1841,32,45-49,1873,1
STAT,1849,50,na,1899,1574.2861811194432
STAT,1841,48,15-19,1889,2.714173898674269E-4
SIM,1889,31,35-39,1920,10
SIM,1921,25,na,1946,3855
SIM,1811,60,na,1871,1016
STAT,1827,48,30-34,1875,0.08368878153732036
STAT,1906,34,45-49,1940,1.3656083918426396
SIM,1874,6,na,1880,2621
STAT,1795,101,na,1896,0.11023295115168814
STAT,1835,37,35-39,1872,5.455816083379789
STAT,1860,6,na,1866,2209.043141033532
SIM,1861,59,na,1920,1664
SIM,1878,35,50-100,1913,1
SIM,1860,74,na,1934,879
STAT,1833,44,45-49,1877,1.0756114903563831
SIM,1896,29,35-39,1925,13
STAT,1831,44,40-44,1875,1.6683142476453714
STAT,1888,46,na,1934,2517.9739078417992
SIM,1820,74,na,1894,519
SIM,1866,44,45-49,1910,2
STAT,1912,40,30-34,1952,0.11777669432754553
SIM,1868,94,na,1962,30
STAT,1868,43,25-29,1911,0.575026805991012
STAT,1939,6,na,1945,3781.437276654834
STAT,1898,28,15-19,1926,0.5781646991310393
STAT,1916,17,20-24,1933,27.17258926770877
STAT,1797,88,na,1885,47.35613745581319
SIM,1839,40,35-39,1879,1
SIM,1855,28,na,1883,1989
SIM,1885,39,30-34,1924,6
SIM,1905,22,35-39,1927,7
STAT,1833,32,45-49,1865,1.367576942590174
STAT,1879,39,35-39,1918,6.913738415979066
SIM,1850,34,45-49,1884,1
STAT,1859,37,20-24,1896,0.5811618968088775
STAT,1873,33,50-100,1906,0.8748878176748518
STAT,1841,18,20-24,1859,15.551998869690552
STAT,1893,21,40-44,1914,2.505227380624337
SIM,1830,67,na,1897,1020
SIM,1929,27,15-19,1956,5
STAT,1832,46,15-19,1878,2.904284721099124E-4
STAT,1862,24,15-19,1886,2.682514893152261
SIM,1873,7,na,1880,2602
SIM,1858,76,na,1934,733
STAT,1866,31,na,1897,2086.944623833311
SIM,1829,38,35-39,1867,11
STAT,1831,30,15-19,1861,0.11977213804605334
STAT,1931,38,15-19,1969,0.024002023685622906
SIM,1912,34,40-44,1946,2
SIM,1895,31,na,1926,2971
STAT,1900,11,na,1911,3389.66000473785
STAT,1915,49,20-24,1964,0.010457269976676127
STAT,1852,37,35-39,1889,5.402968714898187
STAT,1824,44,50-100,1868,1.2704892576045737
STAT,1866,36,20-24,1902,0.6746324175824426
STAT,1805,54,40-44,1859,0.029499550173019567
STAT,1839,69,na,1908,978.5169920848284
SIM,1837,77,na,1914,500
SIM,1912,28,50-100,1940,1
SIM,1860,37,35-39,1897,16
SIM,1870,24,15-19,1894,6
STAT,1808,77,na,1885,367.9586567544332
STAT,1813,52,na,1865,1207.271890024191
STAT,1878,54,40-44,1932,0.010068730611320676
STAT,1927,36,35-39,1963,2.8438144098617952
SIM,1915,25,na,1940,3590
STAT,1851,21,35-39,1872,5.147220308314259
SIM,1841,26,45-49,1867,1
SIM,1834,30,40-44,1864,6
STAT,1918,15,50-100,1933,0.0776471064259469
STAT,1880,26,25-29,1906,42.19184173402437
STAT,1904,46,40-44,1950,0.13120817007867527
SIM,1867,13,na,1880,2327
SIM,1815,42,45-49,1857,2
SIM,1887,39,35-39,1926,12
STAT,1856,29,20-24,1885,8.865801395900125
SIM,1940,24,45-49,1964,3
STAT,1872,45,40-44,1917,0.16395061728669788
STAT,1911,48,45-49,1959,0.19379157506221287
STAT,1852,20,40-44,1872,1.908093531940373
STAT,1897,23,na,1920,2978.8057115798424
STAT,1874,33,45-49,1907,1.6766100332171336
SIM,1935,36,35-39,1971,6
SIM,1842,52,na,1894,1461
SIM,1874,94,na,1968,58
STAT,1822,54,40-44,1876,0.013581647085408256
STAT,1845,43,20-24,1888,0.11246401157970894
SIM,1850,16,15-19,1866,6
STAT,1889,38,15-19,1927,0.06516665553837868
SIM,1837,23,20-24,1860,48
STAT,1883,17,45-49,1900,0.06047995896741245
STAT,1879,6,na,1885,2656.768840597785
SIM,1848,42,35-39,1890,4
SIM,1869,19,25-29,1888,6
STAT,1930,42,40-44,1972,0.3109153796084151
SIM,1904,10,na,1914,3470
SIM,1882,27,45-49,1909,4
STAT,1813,53,25-29,1866,0.010022759385545497
STAT,1888,22,15-19,1910,3.6817443183682603
SIM,1830,100,na,1930,1
STAT,1946,18,45-49,1964,0.5232640751588209
SIM,1824,67,na,1891,843
SIM,1840,17,35-39,1857,1
SIM,1848,41,50-100,1889,3
STAT,1852,39,30-34,1891,4.008511762698241
SIM,1841,44,45-49,1885,1
STAT,1874,30,50-100,1904,0.8917750266704223
SIM,1882,33,45-49,1915,1
SIM,1937,19,20-24,1956,105
STAT,1880,44,25-29,1924,0.6296871856539435
STAT,1852,104,na,1956,0.06210301670678914
STAT,1930,36,40-44,1966,1.8464054641650296
STAT,1904,34,40-44,1938,3.3448186657848042
SIM,1877,46,na,1923,2229
STAT,1842,16,15-19,1858,5.45898044836237
SIM,1808,49,na,1857,1240
STAT,1833,25,50-100,1858,0.5240526589585751
STAT,1923,17,na,1940,4083.4095914765717
STAT,1951,19,30-34,1970,13.703339351502748
STAT,1865,22,40-44,1887,1.8105797350110202
SIM,1824,44,45-49,1868,1
SIM,1860,39,30-34,1899,5
SIM,1849,28,na,1877,1842
SIM,1838,20,30-34,1858,18
STAT,1899,49,na,1948,2852.3899969878553
SIM,1830,42,40-44,1872,4
STAT,1853,54,50-100,1907,0.010892315986134476
STAT,1906,16,45-49,1922,0.09007892296185385
SIM,1860,20,40-44,1880,1
STAT,1864,53,35-39,1917,0.007152014221363499
STAT,1887,42,15-19,1929,0.014572074237131988
STAT,1883,35,45-49,1918,1.8632326506609815
SIM,1943,28,40-44,1971,6
STAT,1861,27,35-39,1888,7.624352173478464
SIM,1915,4,na,1919,3908
SIM,1807,64,na,1871,817
STAT,1801,67,na,1868,774.498511804835
STAT,1879,34,50-100,1913,0.8969843141251199
STAT,1886,82,na,1968,799.7641702965166
STAT,1902,18,na,1920,3358.1855866045603
STAT,1915,24,45-49,1939,1.0917719742439393
STAT,1929,19,20-24,1948,162.5860855192328
SIM,1848,30,35-39,1878,11
STAT,1846,70,na,1916,989.2689764319485
SIM,1883,46,na,1929,2140
SIM,1924,17,20-24,1941,123
STAT,1874,27,45-49,1901,1.0720326738678339
STAT,1921,2,na,1923,4404.430380686226
STAT,1898,31,35-39,1929,13.003689791633487
SIM,1875,79,na,1954,581
STAT,1917,19,25-29,1936,43.67262338414722
STAT,1937,16,45-49,1953,0.4601576007501899
STAT,1858,44,15-19,1902,0.010103533827903993
SIM,1861,39,45-49,1900,1
SIM,1901,48,50-100,1949,3
SIM,1809,59,na,1868,1079
STAT,1845,69,na,1914,1033.7101864820982
STAT,1816,44,45-49,1860,4.1147806017274595
SIM,1923,24,45-49,1947,1
STAT,1890,18,35-39,1908,0.6321133955529435
SIM,1890,25,na,1915,2861
SIM,1891,35,45-49,1926,3
STAT,1921,34,40-44,1955,4.079199877686201
SIM,1962,7,na,1969,4680
STAT,1868,49,30-34,1917,0.08548838198152939
STAT,1766,96,na,1862,1.3789670670333418
STAT,1844,44,na,1888,1619.6843486517844
SIM,1868,69,na,1937,1268
SIM,1871,43,40-44,1914,7
SIM,1838,41,35-39,1879,1
STAT,1859,80,na,1939,466.3749269607252
SIM,1887,20,15-19,1907,3
SIM,1908,32,25-29,1940,9
STAT,1873,47,15-19,1920,3.817748176453903E-4
SIM,1863,35,50-100,1898,1
SIM,1897,30,50-100,1927,1
SIM,1825,43,45-49,1868,2
STAT,1816,63,na,1879,980.9163842089569
STAT,1889,30,50-100,1919,1.0771810287885655
SIM,1936,27,na,1963,2807
STAT,1897,32,35-39,1929,12.794690814002264
STAT,1884,34,45-49,1918,1.6139896169635215
STAT,1930,39,15-19,1969,0.023613738847405582
SIM,1875,31,40-44,1906,4
SIM,1939,31,40-44,1970,4
STAT,1857,19,50-100,1876,0.04238080291559681
STAT,1867,46,15-19,1913,3.558072368688761E-4
STAT,1828,29,45-49,1857,1.4029813417729498
STAT,1840,52,35-39,1892,0.005963575570348815
STAT,1940,28,15-19,1968,0.6796703954782005
STAT,1934,23,na,1957,4634.530825019329
STAT,1839,53,45-49,1892,0.009521106702390826
STAT,1879,16,40-44,1895,0.18104791493239972
STAT,1882,24,na,1906,2160.461034896946
STAT,1843,15,15-19,1858,5.536507810724527
STAT,1889,41,40-44,1930,2.63513710747173
SIM,1860,41,45-49,1901,4
SIM,1813,64,na,1877,865
STAT,1922,48,20-24,1970,0.011961013219809032
SIM,1787,70,na,1857,590
STAT,1819,51,30-34,1870,0.010371149933541692
STAT,1873,72,na,1945,1211.0004410301476
SIM,1850,59,na,1909,1428
STAT,1825,35,20-24,1860,1.067416492894621
STAT,1926,26,40-44,1952,5.2972078989216165
STAT,1860,77,na,1937,663.6454321965128
SIM,1933,30,50-100,1963,1
SIM,1821,90,na,1911,31
STAT,1877,35,15-19,1912,0.055572079886061526
SIM,1879,24,35-39,1903,6
SIM,1894,46,na,1940,2917
SIM,1910,23,20-24,1933,85
STAT,1862,40,25-29,1902,0.5226959356841647
STAT,1866,32,35-39,1898,8.820563448786412
STAT,1902,36,35-39,1938,2.0450168758761347
STAT,1949,22,na,1971,4025.853350991914
STAT,1863,43,40-44,1906,1.8543364292321491
SIM,1948,12,na,1960,4013
STAT,1902,47,50-100,1949,0.18383176866395262
STAT,1904,10,na,1914,3509.433537304834
STAT,1892,26,20-24,1918,13.926013466359363
STAT,1792,88,na,1880,42.34291214494169
STAT,1907,21,na,1928,3291.3339100898665
STAT,1913,42,35-39,1955,0.18546662162535096
SIM,1910,18,35-39,1928,1
STAT,1836,54,35-39,1890,0.00528712095348609
STAT,1902,23,20-24,1925,91.58668385695293
STAT,1902,18,35-39,1920,0.7295940224899926
SIM,1847,35,45-49,1882,3
SIM,1897,41,40-44,1938,2
STAT,1869,44,20-24,1913,0.14326422182316487
STAT,1817,43,45-49,1860,3.6338624891855713
STAT,1920,21,15-19,1941,5.607760502118156
STAT,1854,54,25-29,1908,0.002480443679624273
STAT,1890,40,30-34,1930,1.3412968349664773
STAT,1861,32,20-24,1893,2.120486495073695
STAT,1833,44,na,1877,1507.2630949522297
STAT,1847,95,na,1942,9.782706885660378
STAT,1894,33,25-29,1927,12.39449389672405
SIM,1907,39,30-34,1946,2
SIM,1862,44,na,1906,1981
SIM,1883,22,35-39,1905,8
STAT,1892,79,na,1971,1273.9796318583506
STAT,1920,35,40-44,1955,1.5511409611012488
SIM,1892,34,45-49,1926,4
SIM,1912,30,25-29,1942,9
STAT,1853,54,40-44,1907,0.007592689324870035
STAT,1827,42,25-29,1869,0.5907450013320668
STAT,1900,38,20-24,1938,0.21697558039100337
STAT,1828,29,na,1857,1612.0628113704656
SIM,1897,7,na,1904,3340
STAT,1840,29,na,1869,1851.5551198306516
STAT,1950,19,na,1969,4109.016274261199
STAT,1895,34,20-24,1929,3.3038001627596487
STAT,1851,25,20-24,1876,10.218978531008663
STAT,1845,41,30-34,1886,0.835272310024353
STAT,1903,20,30-34,1923,24.083138759299473
SIM,1910,36,35-39,1946,5
STAT,1889,23,40-44,1912,2.4227783218776415
STAT,1921,13,na,1934,4260.427609112386
SIM,1887,34,40-44,1921,4
STAT,1885,45,20-24,1930,0.011406750604087074
STAT,1912,25,35-39,1937,14.068528200402557
SIM,1933,29,30-34,1962,58
STAT,1830,51,35-39,1881,0.005660739326801773
SIM,1864,31,35-39,1895,11
STAT,1892,47,50-100,1939,0.16312832872455396
STAT,1868,57,na,1925,1812.6410071616106
STAT,1834,85,na,1919,169.6772558352761
SIM,1919,26,45-49,1945,1
SIM,1916,35,na,1951,3586
STAT,1858,44,45-49,1902,1.0949704017235218
SIM,1928,25,40-44,1953,7
SIM,1930,39,na,1969,4554
STAT,1886,47,25-29,1933,0.057223920224353395
SIM,1856,40,40-44,1896,6
STAT,1828,43,20-24,1871,0.13777205457500816
STAT,1832,59,na,1891,1175.1321614435476
SIM,1877,43,na,1920,2243
SIM,1888,36,45-49,1924,2
SIM,1849,62,na,1911,1345
SIM,1920,25,35-39,1945,12
SIM,1813,67,na,1880,757
STAT,1855,3,na,1858,2379.9896302314623
STAT,1871,52,35-39,1923,0.00801983581283225
STAT,1882,21,na,1903,2180.634808596748
STAT,1925,29,30-34,1954,43.41254942819358
STAT,1893,36,15-19,1929,0.06763171297927156
STAT,1914,38,15-19,1952,0.018019962381965255
STAT,1867,15,50-100,1882,0.0449528703424873
STAT,1817,100,na,1917,0.4708005208344188
SIM,1897,23,40-44,1920,2
STAT,1778,81,na,1859,169.50225405500055
SIM,1873,31,50-100,1904,1
SIM,1842,21,35-39,1863,5
SIM,1812,43,35-39,1855,3
STAT,1858,41,40-44,1899,1.675677466256455
STAT,1836,34,15-19,1870,0.11133468892271178
STAT,1855,28,na,1883,1749.1266245091838
SIM,1921,50,na,1971,3778
SIM,1865,42,40-44,1907,3
STAT,1826,49,30-34,1875,0.0881132276246215
STAT,1850,47,na,1897,1576.5089274860993
STAT,1932,17,50-100,1949,0.46867252816417454
STAT,1871,34,35-39,1905,9.403235394983088
STAT,1939,23,na,1962,3463.0734387771754
STAT,1887,24,na,1911,2483.0235485482913
STAT,1826,45,15-19,1871,3.841716669166107E-4
SIM,1889,29,20-24,1918,16
STAT,1904,49,15-19,1953,2.993103322206277E-4
SIM,1853,92,na,1945,24
STAT,1847,21,15-19,1868,2.997257158565425
STAT,1884,16,15-19,1900,5.553745542837632
STAT,1807,52,na,1859,1178.9661460567818
STAT,1879,34,40-44,1913,4.245550400698426
SIM,1801,79,na,1880,272
SIM,1906,18,15-19,1924,9
STAT,1854,19,45-49,1873,0.05560820145722666
SIM,1854,18,na,1872,2135
STAT,1856,31,35-39,1887,7.6638616943785465
SIM,1848,77,na,1925,607
STAT,1841,70,na,1911,959.9715547301952
STAT,1929,21,35-39,1950,11.28327666470122
STAT,1930,20,25-29,1950,112.45980982348625
STAT,1909,24,15-19,1933,4.643331545261499
STAT,1876,25,20-24,1901,11.518781796803577
SIM,1893,27,20-24,1920,13
SIM,1907,20,40-44,1927,5
SIM,1828,26,na,1854,1646
STAT,1917,47,35-39,1964,0.12721455370846405
STAT,1943,1,na,1944,4147.307934461083
STAT,1866,39,25-29,1905,2.4825097903706603
SIM,1873,25,45-49,1898,4
SIM,1908,36,40-44,1944,2
SIM,1928,20,na,1948,4305
SIM,1889,41,50-100,1930,4
SIM,1865,80,na,1945,469
SIM,1938,32,40-44,1970,7
STAT,1812,53,40-44,1865,0.0324738238607319
STAT,1893,64,na,1957,2131.347715961073
SIM,1961,5,na,1966,4707
SIM,1869,22,20-24,1891,60
STAT,1920,17,40-44,1937,1.4825597749041677
SIM,1912,7,na,1919,3657
STAT,1927,33,30-34,1960,18.29949968266039
SIM,1937,21,35-39,1958,7
STAT,1944,19,na,1963,3739.3941674081047
STAT,1764,114,na,1878,2.129933433129328E-4
STAT,1935,32,15-19,1967,0.16794390400972048
SIM,1846,11,na,1857,2144
SIM,1956,2,na,1958,4776
STAT,1865,25,45-49,1890,0.9596003536529486
STAT,1927,38,na,1965,4414.874082597768
STAT,1880,23,20-24,1903,68.28724863665082
STAT,1893,24,na,1917,2817.038888722287
STAT,1904,49,45-49,1953,0.17659324464571097
STAT,1816,41,40-44,1857,7.011610785461153
STAT,1894,49,na,1943,2677.464895073866
SIM,1874,39,25-29,1913,5
SIM,1882,21,na,1903,2175
STAT,1848,37,45-49,1885,1.4799857018060374
STAT,1879,20,15-19,1899,3.276998633763377
SIM,1819,89,na,1908,36
STAT,1840,85,na,1925,190.91179731481745
STAT,1883,32,40-44,1915,4.015223178841541
SIM,1798,70,na,1868,637
SIM,1846,33,40-44,1879,4
STAT,1870,37,25-29,1907,2.6651849878756333
STAT,1868,49,50-100,1917,0.21690027438456447
SIM,1878,27,25-29,1905,50
STAT,1818,54,20-24,1872,0.0014528430442282227
STAT,1810,78,na,1888,338.59955776959157
STAT,1899,45,45-49,1944,0.17406186815176075
SIM,1876,49,50-100,1925,2
STAT,1855,49,20-24,1904,0.008321392491838227
STAT,1944,21,30-34,1965,29.324903202798236
STAT,1938,23,35-39,1961,8.799609142303638
SIM,1859,58,na,1917,1655
SIM,1937,0,na,1937,3692
STAT,1885,27,20-24,1912,11.041399818418602
STAT,1966,5,na,1971,4638.125438673908
SIM,1896,26,30-34,1922,39
STAT,1916,35,na,1951,3674.073823476173
SIM,1884,25,20-24,1909,10
STAT,1900,51,na,1951,2835.498543036209
SIM,1799,95,na,1894,4
STAT,1937,29,50-100,1966,0.9155635181062465
SIM,1819,52,na,1871,1241
STAT,1921,37,45-49,1958,0.719156471020672
SIM,1824,41,40-44,1865,6
SIM,1845,18,30-34,1863,5
SIM,1891,32,40-44,1923,8
STAT,1830,30,30-34,1860,15.087066890885856
STAT,1926,22,25-29,1948,106.023743139005
SIM,1948,18,15-19,1966,39
SIM,1934,22,25-29,1956,121
STAT,1823,34,50-100,1857,1.8213354872368408
SIM,1925,34,20-24,1959,2
STAT,1858,98,na,1956,2.8228554441074816
STAT,1911,54,na,1965,3199.1717442307104
STAT,1915,34,50-100,1949,0.7886014387022084
STAT,1835,70,na,1905,875.4197681158463
STAT,1911,15,40-44,1926,0.26558508430117583
STAT,1821,41,15-19,1862,0.02376335763480474
SIM,1923,34,50-100,1957,1
SIM,1946,23,35-39,1969,18
SIM,1879,42,35-39,1921,4
STAT,1809,47,35-39,1856,0.5106920328837136
STAT,1874,30,40-44,1904,4.220894125117716
STAT,1856,69,na,1925,1085.8265304531672
SIM,1828,66,na,1894,846
STAT,1888,26,30-34,1914,28.199698811032594
STAT,1839,35,45-49,1874,1.6217443807588385
SIM,1783,71,na,1854,505
STAT,1843,33,15-19,1876,0.12223824884090763
STAT,1886,29,50-100,1915,0.6339289979993737
STAT,1837,18,30-34,1855,1.4023729443379482
STAT,1910,18,30-34,1928,2.274946762934457
STAT,1878,50,25-29,1928,0.003533459461462775
STAT,1841,20,35-39,1861,5.13123186322937
SIM,1771,86,na,1857,56
SIM,1926,31,30-34,1957,23
SIM,1837,26,25-29,1863,29
STAT,1798,73,na,1871,496.5340669420637
STAT,1785,107,na,1892,0.0034030689121188618
STAT,1880,41,20-24,1921,0.1585741818980497
STAT,1946,15,40-44,1961,1.4663858433837216
STAT,1822,39,15-19,1861,0.09166906435157351
SIM,1820,35,40-44,1855,5
SIM,1843,24,20-24,1867,61
STAT,1905,17,45-49,1922,0.08917537172751969
SIM,1792,85,na,1877,53
STAT,1853,32,25-29,1885,7.822302219096465
STAT,1904,30,25-29,1934,13.988461700387438
STAT,1814,48,20-24,1862,0.03202912661331671
STAT,1896,17,25-29,1913,7.075092988845711
STAT,1933,38,na,1971,4836.123229518045
SIM,1856,37,45-49,1893,5
SIM,1833,38,25-29,1871,1
SIM,1851,33,45-49,1884,2
STAT,1818,36,20-24,1854,2.873531542607081
STAT,1947,17,45-49,1964,0.5316233796497224
SIM,1838,23,35-39,1861,5
STAT,1864,36,na,1900,1998.750899735529
STAT,1845,46,25-29,1891,0.04068755769615784
STAT,1899,27,15-19,1926,0.5873694199452418
SIM,1850,31,40-44,1881,5
SIM,1859,80,na,1939,475
STAT,1869,46,50-100,1915,0.22522331660564707
STAT,1830,44,50-100,1874,0.7816202205011444
SIM,1883,40,35-39,1923,2
STAT,1882,2,na,1884,2914.3241591566352
STAT,1838,33,40-44,1871,3.637415383567331
SIM,1844,59,na,1903,1361
SIM,1851,15,15-19,1866,4
SIM,1829,35,30-34,1864,3
STAT,1862,32,na,1894,1922.9797243270832
STAT,1875,40,35-39,1915,1.7751970679075628
STAT,1888,49,na,1937,2458.877707132187
STAT,1852,35,15-19,1887,0.04379634294263078
SIM,1923,21,40-44,1944,3
STAT,1858,16,50-100,1874,0.04269420768491594
STAT,1804,78,na,1882,323.4640361535884
STAT,1843,33,45-49,1876,1.4968418856174333
STAT,1918,31,30-34,1949,15.880335333275667
SIM,1935,33,30-34,1968,17
STAT,1853,95,na,1948,9.860075376922357
SIM,1917,24,15-19,1941,6
STAT,1835,24,20-24,1859,56.33658056222783
STAT,1829,26,25-29,1855,77.52782554387996
STAT,1886,42,30-34,1928,1.1460988552733806
STAT,1874,94,na,1968,76.84990748250762
STAT,1813,50,20-24,1863,0.002217639555890718
STAT,1844,49,45-49,1893,0.1622150163924667
STAT,1864,50,30-34,1914,0.005098024491362727
SIM,1846,51,na,1897,1518
STAT,1887,15,25-29,1902,6.01469481511665
STAT,1844,44,20-24,1888,0.11129394119848122
STAT,1881,39,20-24,1920,0.6960485281340244
STAT,1951,15,15-19,1966,51.08374761039188
SIM,1877,46,50-100,1923,1
STAT,1835,42,20-24,1877,0.11872869214344282
SIM,1859,18,25-29,1877,9
SIM,1860,17,15-19,1877,6
STAT,1870,36,na,1906,2191.352768318621
STAT,1843,51,45-49,1894,0.010520154543256633
STAT,1881,39,na,1920,2127.361753625241
SIM,1786,85,na,1871,67
SIM,1861,32,25-29,1893,7
STAT,1823,106,na,1929,0.006389419772500179
SIM,1825,52,na,1877,1226
SIM,1834,26,na,1860,1734
SIM,1902,27,40-44,1929,5
SIM,1954,15,40-44,1969,2
STAT,1909,42,15-19,1951,0.0013565861095840516
STAT,1899,45,15-19,1944,2.9501986719802844E-4
SIM,1865,58,na,1923,1683
STAT,1791,63,na,1854,800.0000000000001
STAT,1819,77,na,1896,431.66619170964765
STAT,1840,40,50-100,1880,0.8652679214479211
SIM,1836,26,40-44,1862,2
STAT,1858,64,na,1922,1289.2180803957651
STAT,1900,36,30-34,1936,1.5148831784877603
STAT,1939,26,20-24,1965,17.341648697432937
SIM,1930,29,45-49,1959,2
STAT,1865,43,45-49,1908,1.275502043968107
STAT,1907,39,20-24,1946,0.22852471528322799
STAT,1886,17,30-34,1903,1.5908795876443886
STAT,1882,40,40-44,1922,2.0885102788618615
SIM,1919,31,25-29,1950,12
SIM,1881,11,na,1892,2161
SIM,1857,32,35-39,1889,9
SIM,1899,39,25-29,1938,3
STAT,1854,74,na,1928,799.152344690956
STAT,1895,17,40-44,1912,0.2254828513462434
STAT,1954,16,45-49,1970,0.5835386149459585
STAT,1809,50,50-100,1859,0.05451659427427699
SIM,1924,39,30-34,1963,2
STAT,1916,39,30-34,1955,1.745389339025842
STAT,1863,46,45-49,1909,0.196534022523268
STAT,1892,44,15-19,1936,0.0011191698836759397
SIM,1909,28,40-44,1937,3
STAT,1871,54,25-29,1925,0.0032260268182772245
STAT,1963,8,na,1971,4715.500388061332
SIM,1861,96,na,1957,7
STAT,1937,29,20-24,1966,16.79070911197712
SIM,1953,16,35-39,1969,9
STAT,1807,106,na,1913,0.004355404082910009
STAT,1873,40,30-34,1913,1.1135503230265869
STAT,1840,27,35-39,1867,8.378453738241552
SIM,1852,4,na,1856,2400
STAT,1945,16,35-39,1961,4.331459891509289
SIM,1873,16,na,1889,2429
STAT,1952,19,45-49,1971,0.5651685948907148
SIM,1904,19,na,1923,3352
SIM,1804,50,na,1854,1169
STAT,1890,13,na,1903,2978.244357395879
STAT,1840,34,40-44,1874,3.6029301020676527
SIM,1873,43,45-49,1916,2
SIM,1890,40,40-44,1930,5
STAT,1870,17,35-39,1887,0.5127617940331467
STAT,1847,27,na,1874,1913.154132478431
SIM,1826,99,na,1925,2
STAT,1923,16,15-19,1939,50.47159907471397
SIM,1841,46,50-100,1887,2
STAT,1823,37,45-49,1860,3.1864611445690114
SIM,1945,26,50-100,1971,4
STAT,1849,32,35-39,1881,7.691847572771532
STAT,1887,20,50-100,1907,0.43339972131332516
STAT,1891,60,na,1951,2230.078017869241
SIM,1823,57,na,1880,1111
STAT,1892,14,na,1906,3045.235216887366
STAT,1846,79,na,1925,492.9198568427743
SIM,1869,32,30-34,1901,27
STAT,1881,76,na,1957,931.2215364375941
STAT,1922,29,45-49,1951,1.8337111122366974
STAT,1817,109,na,1926,3.1550623333851E-4
SIM,1867,29,50-100,1896,1
STAT,1834,37,20-24,1871,0.593510193150677
STAT,1943,19,35-39,1962,4.200616402181709
SIM,1951,19,35-39,1970,5
STAT,1889,56,na,1945,2378.768052968087
STAT,1926,42,15-19,1968,0.0017886836762160182
STAT,1824,30,na,1854,1507.0037786158257
SIM,1875,8,na,1883,2607
STAT,1831,34,30-34,1865,13.97268888414727
STAT,1844,27,35-39,1871,8.29207437551373
STAT,1924,36,50-100,1960,0.46817345690131446
SIM,1890,35,50-100,1925,1
STAT,1857,49,25-29,1906,0.042001974252571156
SIM,1912,14,na,1926,3613
STAT,1858,32,45-49,1890,1.29327018093983
STAT,1940,4,na,1944,3855.199942721724
SIM,1852,27,35-39,1879,17
STAT,1854,46,35-39,1900,0.10109941923966967
SIM,1866,32,45-49,1898,1
SIM,1808,74,na,1882,433
SIM,1931,16,15-19,1947,47
STAT,1846,39,50-100,1885,0.8853995174832807
STAT,1896,20,15-19,1916,4.143513687923115
SIM,1831,37,45-49,1868,1
STAT,1809,52,20-24,1861,0.0025584817448545782
STAT,1874,46,20-24,1920,0.011619274698282951
STAT,1924,45,15-19,1969,4.162857704829058E-4
STAT,1942,12,na,1954,3883.1940105565245
STAT,1846,24,35-39,1870,5.004007049486087
SIM,1887,30,25-29,1917,11
STAT,1786,85,na,1871,82.92592847233294
STAT,1827,32,15-19,1859,0.16570742976649952
SIM,1909,56,na,1965,3028
SIM,1884,53,na,1937,2073
SIM,1959,8,na,1967,4855
STAT,1869,22,50-100,1891,0.37289855403223376
SIM,1889,28,45-49,1917,1
STAT,1897,51,na,1948,2733.4358756969054
STAT,1919,26,35-39,1945,15.37742654428368
STAT,1936,23,30-34,1959,25.94513161059839
STAT,1851,43,15-19,1894,0.01005382002923314
SIM,1851,66,na,1917,1211
STAT,1918,18,30-34,1936,12.499922885446122
SIM,1839,32,na,1871,1818
SIM,1871,80,na,1951,520
STAT,1899,33,45-49,1932,2.248048731931407
STAT,1875,43,50-100,1918,1.0179199943718837
SIM,1925,29,35-39,1954,14
STAT,1866,93,na,1959,42.1398536214361
STAT,1880,51,50-100,1931,0.015083936426603571
STAT,1863,21,30-34,1884,15.195445023404185
STAT,1780,94,na,1874,3.460476628694103
STAT,1894,23,15-19,1917,3.9966529105387196
STAT,1917,29,35-39,1946,14.76724004560254
SIM,1824,42,50-100,1866,4
STAT,1826,30,50-100,1856,1.3827848185795621
SIM,1896,33,50-100,1929,3
SIM,1823,42,35-39,1865,3
STAT,1823,82,na,1905,245.5334502778731
STAT,1890,28,45-49,1918,1.2779159457801512
STAT,1929,20,20-24,1949,133.63830689578506
STAT,1811,54,50-100,1865,0.046068139878054644
STAT,1896,39,35-39,1935,8.741892494605677
SIM,1871,21,30-34,1892,19
STAT,1876,43,20-24,1919,0.15376442448069605
STAT,1880,36,35-39,1916,7.064310835719951
SIM,1926,18,30-34,1944,12
SIM,1854,24,35-39,1878,8
STAT,1856,50,40-44,1906,0.007901280742585037
STAT,1813,45,35-39,1858,0.43811543804215053
STAT,1898,25,40-44,1923,3.856797255895963
STAT,1879,32,na,1911,2356.3200881006583
STAT,1879,30,25-29,1909,10.195172882726823
SIM,1894,17,30-34,1911,3
SIM,1875,17,na,1892,2448
SIM,1907,23,45-49,1930,5
STAT,1861,17,25-29,1878,5.109491830054514
STAT,1879,49,45-49,1928,0.228168399654874
STAT,1896,46,40-44,1942,0.12091440207852575
STAT,1860,27,20-24,1887,9.103441673288797
STAT,1878,22,20-24,1900,67.77216611778468
STAT,1905,20,35-39,1925,8.013868954685044
STAT,1877,33,25-29,1910,9.998625905724397
STAT,1883,31,na,1914,2218.435954744199
STAT,1875,22,35-39,1897,5.6635552868351615
SIM,1830,29,40-44,1859,2
SIM,1886,22,20-24,1908,73
STAT,1903,23,35-39,1926,7.8188429926991425
STAT,1818,37,35-39,1855,23.97097734945277
SIM,1890,33,35-39,1923,19
SIM,1885,33,25-29,1918,12
STAT,1902,33,30-34,1935,23.178163619296093
SIM,1910,33,30-34,1943,20
STAT,1781,101,na,1882,0.1228022850827234
STAT,1878,19,na,1897,2470.4935415636432
STAT,1772,99,na,1871,0.2911118285025511
STAT,1815,42,35-39,1857,5.110093962616652
STAT,1815,87,na,1902,75.40559601318036
SIM,1928,23,na,1951,4255
STAT,1900,29,25-29,1929,55.043560531826685
SIM,1825,29,30-34,1854,20
SIM,1909,20,45-49,1929,1
STAT,1925,37,15-19,1962,0.021776238305973767
SIM,1917,51,na,1968,3509
STAT,1919,33,40-44,1952,3.971689738126089
STAT,1895,15,15-19,1910,7.350104659314143
STAT,1873,41,na,1914,2226.295136709898
STAT,1882,33,35-39,1915,9.2700208714443
STAT,1874,39,15-19,1913,0.053673309904464526
SIM,1839,34,40-44,1873,6
SIM,1911,23,35-39,1934,7
STAT,1867,47,na,1914,1986.3062151320714
STAT,1910,28,40-44,1938,4.23578673361293
SIM,1845,66,na,1911,1165
STAT,1821,87,na,1908,95.13739102068233
STAT,1834,21,35-39,1855,4.865815090946585
STAT,1866,99,na,1965,6.739661891692979
STAT,1815,48,50-100,1863,0.5878800473140279
STAT,1855,51,35-39,1906,0.006126425496765044
SIM,1924,39,na,1963,4139
SIM,1826,34,30-34,1860,24
STAT,1838,48,45-49,1886,0.1634880923244797
STAT,1853,22,15-19,1875,2.890739709942679
SIM,1802,89,na,1891,21
STAT,1885,25,30-34,1910,23.861477503724156
STAT,1826,54,50-100,1880,0.013097059393017512
SIM,1859,43,25-29,1902,3
STAT,1845,91,na,1936,40.81736121721015
STAT,1914,34,35-39,1948,8.614032616306192
STAT,1895,28,50-100,1923,0.7858367240043446
STAT,1872,35,30-34,1907,5.101511813791103
STAT,1929,37,15-19,1966,0.023291742402015335
SIM,1872,35,40-44,1907,3
SIM,1909,22,na,1931,3343
SIM,1822,44,40-44,1866,7
STAT,1876,28,25-29,1904,41.10947254737076
SIM,1916,45,50-100,1961,2
SIM,1930,33,na,1963,4559
STAT,1872,93,na,1965,83.17843353293651
STAT,1887,61,na,1948,1974.2069849046488
STAT,1829,48,35-39,1877,0.11149840444706843
STAT,1891,39,15-19,1930,0.06500104884446221
SIM,1861,22,15-19,1883,2
SIM,1840,29,na,1869,1785
STAT,1904,28,50-100,1932,0.8636193540537271
SIM,1903,31,na,1934,3236
STAT,1890,19,na,1909,2901.4992653890254
STAT,1917,44,30-34,1961,0.12561440163507295
SIM,1922,34,35-39,1956,13
SIM,1867,24,45-49,1891,1
SIM,1813,44,30-34,1857,1
SIM,1913,20,35-39,1933,9
STAT,1850,32,45-49,1882,1.2842500319734487
STAT,1859,38,35-39,1897,5.3060001543273545
STAT,1824,48,15-19,1872,4.634617012301506E-4
SIM,1848,49,na,1897,1634
SIM,1853,61,na,1914,1483
SIM,1946,20,30-34,1966,38
STAT,1917,17,na,1934,3926.1955643778215
SIM,1828,34,35-39,1862,9
SIM,1936,24,na,1960,2726
STAT,1850,45,20-24,1895,0.008532251342687355
STAT,1924,15,20-24,1939,153.24194814622882
STAT,1945,21,15-19,1966,5.513276094058674
SIM,1859,86,na,1945,193
STAT,1854,16,40-44,1870,0.1584870049646359
SIM,1877,27,40-44,1904,5
STAT,1867,103,na,1970,1.2091313308559573
SIM,1927,26,35-39,1953,18
SIM,1879,53,50-100,1932,1
SIM,1817,37,25-29,1854,1
STAT,1833,100,na,1933,0.6445141314249354
STAT,1928,21,15-19,1949,6.298261766838899
SIM,1936,26,45-49,1962,1
STAT,1953,17,50-100,1970,0.42815889259406315
SIM,1836,31,20-24,1867,2
SIM,1898,33,35-39,1931,20
STAT,1887,25,35-39,1912,10.263219198435088
STAT,1920,31,25-29,1951,9.603513846447564
STAT,1906,47,20-24,1953,0.009268086507237648
SIM,1935,23,20-24,1958,132
STAT,1841,42,45-49,1883,1.0640523137213136
STAT,1918,20,45-49,1938,1.1532251856411524
SIM,1853,95,na,1948,6
STAT,1908,47,25-29,1955,0.04530894810878918
STAT,1927,23,20-24,1950,129.03535401507364
SIM,1822,37,35-39,1859,11
STAT,1942,29,30-34,1971,38.80944770516395
SIM,1893,25,30-34,1918,32
STAT,1937,21,25-29,1958,84.99122250756675
SIM,1897,26,na,1923,3056
STAT,1919,28,50-100,1947,1.0124102012820768
STAT,1895,22,20-24,1917,84.9553078131256
SIM,1895,25,35-39,1920,13
STAT,1830,53,25-29,1883,0.002238515667642116
STAT,1877,31,na,1908,2348.9012665641476
SIM,1834,29,na,1863,1705
STAT,1871,26,50-100,1897,0.6011556703462906
SIM,1945,21,25-29,1966,91
STAT,1836,55,na,1891,1305.738433222862
SIM,1829,42,na,1871,1484
STAT,1770,114,na,1884,2.1843193722186232E-4
STAT,1828,31,20-24,1859,3.018547147907867
STAT,1860,51,45-49,1911,0.011195356723761096
STAT,1873,47,na,1920,2147.3331858451256
STAT,1891,33,45-49,1924,2.0304581710396308
STAT,1891,46,20-24,1937,0.007937509023217798
SIM,1932,15,20-24,1947,183
STAT,1881,28,35-39,1909,8.770231703037068
SIM,1891,35,na,1926,2930
STAT,1854,21,20-24,1875,58.72751908758883
SIM,1819,83,na,1902,147
STAT,1857,24,40-44,1881,1.6070284805949469
SIM,1884,25,na,1909,2356
STAT,1797,57,na,1854,1022.9999999999998
STAT,1822,35,na,1857,1505.2399074601235
STAT,1933,29,20-24,1962,22.874535346510136
SIM,1934,26,40-44,1960,9
STAT,1914,44,45-49,1958,0.1552463034120035
SIM,1835,42,na,1877,1581
SIM,1875,11,na,1886,2536
STAT,1859,12,na,1871,2089.1870310024874
SIM,1935,18,40-44,1953,1
SIM,1797,63,na,1860,886
STAT,1875,76,na,1951,919.4912695701344
STAT,1884,19,na,1903,2345.109489271145
STAT,1885,18,25-29,1903,5.319434324018193
STAT,1835,27,25-29,1862,34.39826453167391
STAT,1934,37,25-29,1971,1.2835539092380763
STAT,1837,21,20-24,1858,57.360282067346795
STAT,1938,20,30-34,1958,26.88743897767669
SIM,1901,33,20-24,1934,2
STAT,1833,38,15-19,1871,0.042293565259284294
STAT,1845,19,35-39,1864,0.4827652565141891
SIM,1880,63,na,1943,1892
STAT,1875,38,20-24,1913,0.7444273895733371
SIM,1864,43,35-39,1907,2
SIM,1884,28,25-29,1912,47
SIM,1912,4,na,1916,3692
STAT,1893,61,na,1954,2239.776523309683
SIM,1843,27,25-29,1870,38
STAT,1913,55,na,1968,3280.4046741741345
SIM,1845,21,20-24,1866,57
STAT,1766,106,na,1872,0.01173015822295824
STAT,1839,91,na,1930,38.637987750734155
STAT,1944,18,40-44,1962,1.4214945088124429
STAT,1857,100,na,1957,1.1054358954389492
SIM,1936,21,15-19,1957,4
STAT,1848,40,na,1888,1706.184504767826
STAT,1918,34,35-39,1952,9.094956993741384
SIM,1817,57,na,1874,1184
SIM,1941,29,20-24,1970,19
SIM,1865,24,40-44,1889,4
STAT,1808,47,20-24,1855,0.04568213919596259
STAT,1857,4,na,1861,2333.1390794841036
STAT,1928,26,45-49,1954,2.0177859237524314
SIM,1851,19,30-34,1870,1
SIM,1831,34,40-44,1865,5
SIM,1846,14,na,1860,2113
STAT,1864,37,50-100,1901,1.0365964304207498
STAT,1852,79,na,1931,531.1608376701463
STAT,1814,44,40-44,1858,6.394120940913956
SIM,1893,18,25-29,1911,8
STAT,1932,37,20-24,1969,0.33460449242694384
STAT,1828,26,40-44,1854,7.127676090219325
STAT,1833,45,20-24,1878,0.008775200219383208
STAT,1860,37,30-34,1897,4.091834899140308
STAT,1930,27,na,1957,4500.185709991606
STAT,1940,16,15-19,1956,43.538740774008375
SIM,1867,35,30-34,1902,8
SIM,1862,21,20-24,1883,59
STAT,1868,27,20-24,1895,10.581499635217412
STAT,1824,42,45-49,1866,1.8932137400185358
STAT,1898,39,na,1937,3006.098310256482
SIM,1814,74,na,1888,444
STAT,1859,24,45-49,1883,0.537655774277656
STAT,1895,56,na,1951,2514.4603804535986
STAT,1843,19,30-34,1862,1.4522406266095138
SIM,1926,34,35-39,1960,7
SIM,1925,19,25-29,1944,62
STAT,1850,38,15-19,1888,0.03974412554869037
SIM,1852,14,na,1866,2244
SIM,1861,30,50-100,1891,3
SIM,1931,34,45-49,1965,2
STAT,1919,31,15-19,1950,0.13150899567292718
SIM,1860,49,na,1909,1841
STAT,1923,34,45-49,1957,1.702131100701359
SIM,1910,19,na,1929,3530
STAT,1828,26,na,1854,1544.9324830822482
STAT,1881,35,40-44,1916,4.030834004060437
STAT,1927,18,40-44,1945,1.6388261497855527
STAT,1913,36,40-44,1949,1.4020081025164133
SIM,1832,42,45-49,1874,6
STAT,1842,107,na,1949,0.0033582900263397757
SIM,1918,39,na,1957,3687
STAT,1886,26,50-100,1912,0.6406835606488368
SIM,1831,27,35-39,1858,9
SIM,1915,56,na,1971,3319
STAT,1861,22,na,1883,1906.0480302010994
SIM,1799,58,na,1857,999
STAT,1909,28,30-34,1937,35.24176660293308
STAT,1874,49,50-100,1923,0.23218335536715534
SIM,1869,35,35-39,1904,15
SIM,1853,26,40-44,1879,1
STAT,1844,29,50-100,1873,0.541871514178538
STAT,1917,4,na,1921,4089.5507925327674
SIM,1913,29,45-49,1942,1
STAT,1865,40,40-44,1905,1.9503624943501359
SIM,1934,19,35-39,1953,8
SIM,1821,39,40-44,1860,5
SIM,1858,70,na,1928,1119
SIM,1914,16,15-19,1930,9
SIM,1887,37,50-100,1924,1
STAT,1918,28,40-44,1946,4.669434716868036
SIM,1945,15,30-34,1960,16
STAT,1844,24,30-34,1868,15.38914998207691
STAT,1851,37,20-24,1888,0.5713296100056139
SIM,1912,42,na,1954,3230
STAT,1774,94,na,1868,3.74114228445601
STAT,1779,113,na,1892,1.856587316509827E-4
STAT,1919,16,25-29,1935,9.098826796727156
SIM,1904,28,20-24,1932,17
STAT,1886,14,na,1900,2569.3198482030116
STAT,1900,39,35-39,1939,1.9806456298147255
STAT,1869,32,20-24,1901,2.4717763708290836
STAT,1905,29,45-49,1934,1.5049030748345595
STAT,1778,84,na,1862,89.84710726477867
STAT,1926,19,35-39,1945,4.834641709308675
STAT,1831,39,50-100,1870,0.9470847975743897
SIM,1877,32,20-24,1909,2
STAT,1840,40,35-39,1880,1.4831144648813162
SIM,1844,19,25-29,1863,7
SIM,1917,28,30-34,1945,49
SIM,1829,46,50-100,1875,3
SIM,1868,27,30-34,1895,19
STAT,1803,68,na,1871,711.5863498692411
STAT,1806,79,na,1885,283.69167277258987
SIM,1927,16,25-29,1943,61
STAT,1877,23,15-19,1900,3.224095930053523
STAT,1904,44,na,1948,3099.7222923112063
STAT,1920,47,40-44,1967,0.16465147272885608
STAT,1814,50,35-39,1864,0.023252324277003286
STAT,1865,49,15-19,1914,3.362081814697797E-4
STAT,1913,15,45-49,1928,0.09691263401280033
SIM,1866,68,na,1934,1290
STAT,1845,26,40-44,1871,2.5868435460696344
STAT,1899,30,40-44,1929,5.659500717277847
STAT,1905,20,na,1925,3247.922943311941
SIM,1885,23,15-19,1908,3
STAT,1895,47,35-39,1942,0.09690236483642267
STAT,1823,34,40-44,1857,8.620631917277905
SIM,1833,47,na,1880,1439
STAT,1928,23,40-44,1951,3.954029073867297
SIM,1846,85,na,1931,163
SIM,1825,31,45-49,1856,2
SIM,1909,18,30-34,1927,1
STAT,1890,25,40-44,1915,3.483430712943396
STAT,1893,43,20-24,1936,0.013123211347818362
STAT,1871,51,20-24,1922,6.94400189276137E-4
STAT,1851,23,50-100,1874,0.35454732145875273
STAT,1875,44,15-19,1919,0.013222049855168103
STAT,1952,16,40-44,1968,1.5839767539181842
SIM,1906,25,20-24,1931,19
STAT,1851,111,na,1962,2.3444762986523222E-4
SIM,1843,17,15-19,1860,6
STAT,1905,44,35-39,1949,0.16934654773356553
STAT,1953,16,25-29,1969,49.537592431213135
SIM,1926,28,40-44,1954,5
SIM,1915,7,na,1922,3883
STAT,1911,18,45-49,1929,0.09416577314405766
STAT,1901,30,na,1931,3180.751428019338
STAT,1836,19,25-29,1855,6.735472962230279
STAT,1881,41,35-39,1922,1.659196538928918
STAT,1851,91,na,1942,42.4940865154297
SIM,1854,21,30-34,1875,18
SIM,1871,52,na,1923,2046
SIM,1886,82,na,1968,720
STAT,1935,18,30-34,1953,15.699227122035074
STAT,1793,67,na,1860,725.9817450033601
SIM,1773,87,na,1860,52
SIM,1886,25,25-29,1911,46
SIM,1788,80,na,1868,205
SIM,1843,71,na,1914,919
STAT,1900,26,20-24,1926,15.427880549660344
SIM,1936,23,40-44,1959,2
SIM,1875,42,na,1917,2208
SIM,1903,22,30-34,1925,27
STAT,1855,38,35-39,1893,4.98445706661524
STAT,1914,26,15-19,1940,0.6745001310337622
SIM,1871,36,35-39,1907,11
STAT,1845,24,15-19,1869,2.843534555080902
SIM,1852,24,30-34,1876,14
SIM,1839,37,45-49,1876,2
STAT,1834,47,30-34,1881,0.0635449299893341
STAT,1853,16,20-24,1869,15.909435004988902
STAT,1856,43,35-39,1899,1.330131741821414
STAT,1928,31,25-29,1959,10.925161017079514
SIM,1861,16,20-24,1877,14
SIM,1870,27,50-100,1897,1
STAT,1855,45,40-44,1900,0.1224589505174536
STAT,1842,38,25-29,1880,2.380325890431122
SIM,1850,38,25-29,1888,1
SIM,1889,25,40-44,1914,3
STAT,1864,64,na,1928,1467.714719384022
STAT,1938,27,15-19,1965,0.660632845253302
STAT,1908,34,na,1942,3342.8669962031995
STAT,1906,16,15-19,1922,8.183671807098376
SIM,1880,35,30-34,1915,9
SIM,1928,21,25-29,1949,119
STAT,1867,53,20-24,1920,6.440255917755088E-4
STAT,1856,38,na,1894,1734.527206653681
SIM,1893,28,35-39,1921,11
SIM,1827,29,35-39,1856,8
SIM,1899,21,na,1920,3037
STAT,1837,109,na,1946,4.4911445875917423E-4
SIM,1872,28,35-39,1900,9
SIM,1927,41,na,1968,4329
STAT,1893,18,50-100,1911,0.05856859761690292
STAT,1858,0,na,1858,2915.145566911349
STAT,1869,25,15-19,1894,0.41769699351765516
SIM,1839,19,15-19,1858,6
STAT,1871,16,40-44,1887,0.17342442847514605
SIM,1854,5,na,1859,2356
SIM,1896,10,na,1906,3309
STAT,1879,46,40-44,1925,0.16952833189377026
SIM,1884,18,15-19,1902,4
SIM,1860,43,na,1903,1919
STAT,1937,15,30-34,1952,11.252377924917434
STAT,1834,43,15-19,1877,0.010174002826075326
SIM,1842,40,50-100,1882,2
STAT,1901,18,20-24,1919,23.380787208794597
SIM,1817,88,na,1905,63
SIM,1792,88,na,1880,27
SIM,1936,31,25-29,1967,11
STAT,1873,50,40-44,1923,0.01024012089440779
STAT,1750,114,na,1864,0.009340906956413915
SIM,1878,53,na,1931,2161
SIM,1943,18,30-34,1961,18
STAT,1846,21,30-34,1867,15.60807562504633
STAT,1944,24,35-39,1968,9.597428298802587
SIM,1873,40,40-44,1913,3
STAT,1854,31,30-34,1885,13.00953262472659
SIM,1867,81,na,1948,417
STAT,1825,77,na,1902,488.7222405909898
STAT,1931,19,45-49,1950,0.6143888433158531
SIM,1918,23,20-24,1941,105
STAT,1842,16,45-49,1858,0.06008782987017809
STAT,1848,74,na,1922,799.517805623453
SIM,1957,1,na,1958,4703
STAT,1880,28,50-100,1908,0.6336150221757318
SIM,1844,22,15-19,1866,6
STAT,1931,34,35-39,1965,11.297678773619882
STAT,1946,21,35-39,1967,9.90210340687633
STAT,1883,39,25-29,1922,2.6389243461797927
STAT,1790,84,na,1874,102.8916783927616
STAT,1887,22,30-34,1909,18.818615198347672
STAT,1885,28,35-39,1913,9.04940586468549
SIM,1836,38,50-100,1874,1
STAT,1809,53,na,1862,1207.650583978646
STAT,1831,40,na,1871,1603.4215017448703
SIM,1849,96,na,1945,4
SIM,1922,38,na,1960,4055
SIM,1935,26,25-29,1961,82
STAT,1936,33,40-44,1969,3.587979277302587
SIM,1887,36,na,1923,2468
SIM,1937,20,20-24,1957,94
SIM,1886,15,15-19,1901,5
STAT,1908,44,20-24,1952,0.015242433428992015
STAT,1843,21,45-49,1864,0.6360431901129852
SIM,1851,21,45-49,1872,1
STAT,1902,23,50-100,1925,0.5419651669546143
SIM,1829,73,na,1902,616
STAT,1771,104,na,1875,0.02229524364907979
STAT,1843,45,15-19,1888,2.946916212740323E-4
STAT,1850,48,25-29,1898,0.04004101426408398
STAT,1846,45,30-34,1891,0.06893144718050953
SIM,1790,90,na,1880,20
STAT,1860,33,15-19,1893,0.10887347605571064
SIM,1908,39,45-49,1947,4
SIM,1929,15,45-49,1944,1
STAT,1852,42,20-24,1894,0.12051319561061248
STAT,1910,44,na,1954,3274.1458960974783
STAT,1911,31,15-19,1942,0.1186690272854426
STAT,1940,27,50-100,1967,0.9587532252401307
STAT,1865,46,na,1911,1936.847692590831
STAT,1911,20,na,1931,3438.6914592270577
SIM,1826,37,35-39,1863,11
STAT,1901,28,30-34,1929,33.18048960615003
SIM,1876,27,20-24,1903,8
SIM,1828,31,30-34,1859,20
STAT,1840,54,na,1894,1458.2666400256076
SIM,1895,22,30-34,1917,27
SIM,1903,29,50-100,1932,5
STAT,1867,31,40-44,1898,3.862389549522877
SIM,1934,23,na,1957,4543
STAT,1915,47,30-34,1962,0.08485266426110712
SIM,1940,23,na,1963,3365
SIM,1930,18,20-24,1948,161
STAT,1917,45,na,1962,3641.9778475011217
STAT,1860,43,50-100,1903,0.8052419425477593
STAT,1903,17,40-44,1920,0.2458277562165998
SIM,1926,24,25-29,1950,108
STAT,1914,31,30-34,1945,15.040612793754784
STAT,1914,41,40-44,1955,0.23443358573395726
STAT,1822,45,45-49,1867,0.33877585353842216
STAT,1841,32,35-39,1873,8.406767231066208
STAT,1875,48,30-34,1923,0.09276761978316622
STAT,1922,18,20-24,1940,147.84774395442417
STAT,1761,107,na,1868,0.0048919981359956625
STAT,1862,22,25-29,1884,47.22346263800603
STAT,1845,16,30-34,1861,1.4273919002322062
STAT,1837,37,50-100,1874,0.9436275577213656
STAT,1856,2,na,1858,2620.108943137957
STAT,1918,24,25-29,1942,93.52169391799586
SIM,1871,24,35-39,1895,5
STAT,1878,25,25-29,1903,41.88367697646469
SIM,1870,22,25-29,1892,55
STAT,1859,35,30-34,1894,4.05625988420176
SIM,1813,98,na,1911,4
SIM,1913,6,na,1919,3734
SIM,1944,23,30-34,1967,32
STAT,1859,21,40-44,1880,1.80416455682258
STAT,1787,67,na,1854,703.9999999999999
STAT,1898,28,45-49,1926,1.414887540216354
SIM,1922,31,30-34,1953,24
STAT,1838,45,40-44,1883,0.12324521366620006
STAT,1826,52,20-24,1878,6.658282920116134E-4
STAT,1855,22,na,1877,1769.079041905595
STAT,1828,41,30-34,1869,1.031298719386776
STAT,1784,84,na,1868,85.95872836974178
SIM,1853,16,30-34,1869,2
SIM,1797,91,na,1888,14
STAT,1880,29,na,1909,2355.245776935194
STAT,1913,39,45-49,1952,0.6290121571217488
STAT,1944,20,50-100,1964,0.6715995226955095
STAT,1868,23,na,1891,2126.6278773729514
SIM,1800,100,na,1900,1
SIM,1908,29,35-39,1937,20
SIM,1869,36,50-100,1905,1
STAT,1863,24,35-39,1887,4.871716145145671
STAT,1885,15,20-24,1900,16.76325216459614
SIM,1934,29,45-49,1963,2
STAT,1837,24,25-29,1861,46.630176889041564
STAT,1957,14,na,1971,4890.082927214353
STAT,1836,32,25-29,1868,8.17573285648537
STAT,1934,34,20-24,1968,3.141970439196881
STAT,1871,46,na,1917,2113.056019193308
STAT,1916,49,40-44,1965,0.1518673554283753
STAT,1946,25,50-100,1971,1.048372081027272
STAT,1815,53,na,1868,1180.2302064636879
STAT,1860,9,na,1869,2157.297019542589
SIM,1844,32,25-29,1876,15
STAT,1891,30,40-44,1921,5.111712798827393
STAT,1817,82,na,1899,206.91214405980918
STAT,1830,50,20-24,1880,5.43861661338765E-4
SIM,1887,67,na,1954,1573
STAT,1842,89,na,1931,74.80993501127581
STAT,1908,21,50-100,1929,0.573051846284348
SIM,1855,96,na,1951,5
STAT,1895,32,30-34,1927,21.52433589198528
SIM,1893,15,20-24,1908,26
SIM,1903,37,na,1940,3202
STAT,1860,74,na,1934,852.0509131436768
STAT,1927,26,25-29,1953,75.86077061883341
STAT,1864,35,40-44,1899,3.7310738438213655
STAT,1919,2,na,1921,4269.651366095853
STAT,1871,29,50-100,1900,0.5948178401180242
STAT,1906,38,50-100,1944,0.36272486375476803
SIM,1918,33,30-34,1951,22
STAT,1884,22,45-49,1906,0.6509773854766023
SIM,1891,39,25-29,1930,2
SIM,1845,24,25-29,1869,60
SIM,1835,26,20-24,1861,7
SIM,1836,41,30-34,1877,4
STAT,1832,25,na,1857,1752.0938737236238
SIM,1876,4,na,1880,2744
SIM,1928,31,35-39,1959,14
STAT,1940,31,40-44,1971,3.827969271660673
SIM,1905,66,na,1971,2524
STAT,1894,17,20-24,1911,21.544070592434842
SIM,1867,38,35-39,1905,18
SIM,1872,38,45-49,1910,4
STAT,1802,83,na,1885,134.89643544470894
SIM,1872,68,na,1940,1423
STAT,1816,48,25-29,1864,0.14925637794892513
SIM,1841,41,40-44,1882,6
SIM,1921,20,25-29,1941,104
STAT,1931,28,50-100,1959,1.2134136669901028
STAT,1857,27,45-49,1884,0.8517189651964627
STAT,1851,49,20-24,1900,0.008616064515035118
STAT,1897,44,35-39,1941,0.15672576717348558
SIM,1784,90,na,1874,12
SIM,1848,15,na,1863,2122
SIM,1827,47,na,1874,1365
SIM,1919,25,30-34,1944,38
STAT,1799,83,na,1882,139.176787174007
SIM,1912,37,45-49,1949,3
STAT,1891,49,25-29,1940,0.03719892707059223
STAT,1800,54,na,1854,1099.7995682569506
STAT,1864,38,45-49,1902,1.6747739966429955
STAT,1874,29,na,1903,2287.7944361433892
SIM,1959,2,na,1961,4856
STAT,1887,46,30-34,1933,0.10255922384599153
STAT,1904,37,45-49,1941,0.582948671284471
STAT,1926,28,na,1954,4227.9498870480265
STAT,1913,20,25-29,1933,85.0413592145384
SIM,1893,36,na,1929,2965
STAT,1833,41,40-44,1874,1.6800294377104168
SIM,1865,27,45-49,1892,4
STAT,1926,29,45-49,1955,1.9427057629757605
STAT,1857,88,na,1945,102.2420604400328
SIM,1917,19,35-39,1936,5
STAT,1862,107,na,1969,0.047008532418170386
STAT,1856,47,15-19,1903,2.945775783089413E-4
SIM,1831,40,35-39,1871,4
SIM,1875,48,na,1923,2119
SIM,1923,25,20-24,1948,16
STAT,1781,73,na,1854,427.0
STAT,1855,50,na,1905,1546.8667882236903
SIM,1812,48,na,1860,1285
SIM,1908,19,25-29,1927,9
STAT,1838,19,na,1857,2043.623882010611
STAT,1899,18,na,1917,3261.1171476054237
SIM,1886,35,35-39,1921,10
SIM,1870,26,40-44,1896,5
SIM,1917,30,45-49,1947,1
STAT,1884,46,15-19,1930,3.744757697282071E-4
STAT,1937,25,40-44,1962,4.295402453369499
STAT,1827,29,25-29,1856,61.208967918020086
STAT,1858,33,na,1891,1762.2905633422104
SIM,1958,3,na,1961,4850
STAT,1759,113,na,1872,1.976521055565501E-4
STAT,1890,15,30-34,1905,1.8495156443096787
SIM,1881,42,na,1923,1925
STAT,1879,3,na,1882,3008.800850972356
STAT,1853,30,50-100,1883,0.7144227298244271
SIM,1882,42,40-44,1924,6
STAT,1887,47,45-49,1934,0.24817077539648327
STAT,1810,48,20-24,1858,0.04195169814880435
STAT,1921,15,35-39,1936,4.5398990667180925
SIM,1900,38,30-34,1938,2
STAT,1775,79,na,1854,236.0
STAT,1862,26,40-44,1888,2.440359409916836
STAT,1937,26,50-100,1963,0.9168831970865844
STAT,1930,27,45-49,1957,2.075350001681107
STAT,1878,35,35-39,1913,7.021943335138061
SIM,1902,52,na,1954,2863
SIM,1952,11,na,1963,4397
STAT,1861,54,30-34,1915,0.004541224230576013
SIM,1895,62,na,1957,2345
STAT,1882,35,50-100,1917,1.1393210977680803
STAT,1795,93,na,1888,6.853451820969254
STAT,1848,52,40-44,1900,0.007543990973700688
STAT,1837,100,na,1937,0.6701716123346051
SIM,1823,88,na,1911,66
SIM,1844,29,35-39,1873,13
STAT,1843,68,na,1911,1102.5263524419145
SIM,1826,68,na,1894,802
STAT,1874,42,40-44,1916,2.169072970485839
STAT,1901,24,15-19,1925,4.334947949897385
STAT,1832,28,na,1860,1716.1811716271084
STAT,1909,26,40-44,1935,4.257336138811441
SIM,1945,25,40-44,1970,4
SIM,1826,31,na,1857,1700
STAT,1855,48,45-49,1903,0.1650437142023517
STAT,1871,12,na,1883,2472.737194553346
STAT,1910,36,25-29,1946,0.8936117912722026
STAT,1941,27,20-24,1968,17.837336979669356
STAT,1893,41,50-100,1934,1.2720097694432113
STAT,1806,73,na,1879,500.9908817779389
STAT,1842,35,20-24,1877,0.6574504779917518
STAT,1851,47,30-34,1898,0.07065409528243569
STAT,1877,27,50-100,1904,0.6271013092327613
STAT,1905,42,45-49,1947,0.1417056033656278
STAT,1920,21,50-100,1941,0.6931719589247328
STAT,1882,52,na,1934,1968.7627249967134
STAT,1833,46,50-100,1879,0.1773121418485155
STAT,1876,18,15-19,1894,5.772538898007672
SIM,1919,18,na,1937,3805
STAT,1901,38,40-44,1939,1.243160099654416
STAT,1928,25,30-34,1953,45.916696122175914
STAT,1836,29,35-39,1865,7.771542270971888
SIM,1868,60,na,1928,1698
STAT,1824,98,na,1922,1.7150273103190445
SIM,1831,24,30-34,1855,16
STAT,1852,54,20-24,1906,5.452332182746669E-4
SIM,1858,16,15-19,1874,10
STAT,1849,59,na,1908,1400.8311346447451
STAT,1901,36,15-19,1937,0.01610387535907044
SIM,1914,5,na,1919,4204
STAT,1855,35,30-34,1890,3.81045093399558
STAT,1856,40,30-34,1896,0.8592158055511081
STAT,1917,44,50-100,1961,0.11542944989784971
SIM,1928,30,20-24,1958,1
STAT,1902,41,15-19,1943,0.0012842510365805753
STAT,1807,51,40-44,1858,0.0380321762417488
SIM,1900,26,30-34,1926,40
STAT,1965,6,na,1971,4635.150005231936
SIM,1831,83,na,1914,192
STAT,1868,28,35-39,1896,8.672476898841115
STAT,1846,48,na,1894,1566.3688375837878
STAT,1886,25,15-19,1911,0.4559237558110161
SIM,1848,100,na,1948,1
SIM,1851,35,na,1886,1805
SIM,1917,26,40-44,1943,5
SIM,1858,34,45-49,1892,1
SIM,1906,42,na,1948,3237
STAT,1819,39,50-100,1858,2.7102025433446597
SIM,1814,49,50-100,1863,2
SIM,1894,20,20-24,1914,82
SIM,1819,80,na,1899,273
STAT,1787,98,na,1885,0.5800726145719838
STAT,1902,15,na,1917,3382.6507515674048
SIM,1899,35,45-49,1934,1
STAT,1923,24,35-39,1947,10.286004470922116
STAT,1855,53,na,1908,1500.4678292048934
STAT,1886,20,20-24,1906,69.19362442323884
STAT,1919,48,45-49,1967,0.2220770051545011
STAT,1871,24,25-29,1895,53.27737601942617
SIM,1931,24,35-39,1955,13
STAT,1768,91,na,1859,10.241932414294277
STAT,1859,29,50-100,1888,0.48358463111288147
STAT,1837,46,35-39,1883,0.09292486611289051
STAT,1860,49,30-34,1909,0.0727674096033905
STAT,1940,21,30-34,1961,27.66557917813184
SIM,1927,36,45-49,1963,4
SIM,1820,77,na,1897,395
STAT,1844,52,50-100,1896,0.010545827481968188
STAT,1954,15,30-34,1969,14.241905575876794
SIM,1874,0,na,1874,3303
STAT,1888,40,na,1928,2605.3937892958106
SIM,1884,21,40-44,1905,2
STAT,1831,35,45-49,1866,1.6115096661258446
STAT,1914,34,na,1948,3565.0473969282743
STAT,1933,23,15-19,1956,6.668281366754526
SIM,1850,50,na,1900,1605
STAT,1894,15,30-34,1909,1.9459015764737808
SIM,1845,34,35-39,1879,8
SIM,1868,63,na,1931,1581
STAT,1869,73,na,1942,1086.1247324705203
STAT,1909,19,35-39,1928,0.7729980839981313
SIM,1835,24,30-34,1859,20
SIM,1862,31,30-34,1893,22
STAT,1870,40,15-19,1910,0.012912326444763879
STAT,1882,37,15-19,1919,0.05162008486537431
SIM,1868,37,40-44,1905,4
STAT,1881,3,na,1884,2744.563456274999
SIM,1932,37,30-34,1969,2
SIM,1861,19,25-29,1880,7
STAT,1872,38,35-39,1910,6.67329590411718
STAT,1930,15,45-49,1945,0.6129767662876626
SIM,1941,23,15-19,1964,3
STAT,1851,60,na,1911,1398.5662020902278
SIM,1877,23,25-29,1900,52
SIM,1909,24,25-29,1933,77
STAT,1898,47,20-24,1945,0.008616022529267171
SIM,1837,32,50-100,1869,4
SIM,1877,35,25-29,1912,2
STAT,1890,31,35-39,1921,11.744836297142006
SIM,1880,38,35-39,1918,16
STAT,1836,22,15-19,1858,2.749428795916644
STAT,1869,35,25-29,1904,2.657848272131618
STAT,1871,15,na,1886,2408.909504283834
SIM,1930,20,35-39,1950,17
STAT,1933,35,15-19,1968,0.024752710439192686
SIM,1910,23,50-100,1933,1
SIM,1903,25,35-39,1928,17
STAT,1843,65,na,1908,1219.2325601804491
STAT,1830,27,40-44,1857,2.9148528220375858
STAT,1924,37,30-34,1961,2.0304711432299416
SIM,1919,15,na,1934,4050
STAT,1910,43,30-34,1953,0.11342382243226355
STAT,1853,19,25-29,1872,4.9959458751833115
STAT,1815,46,15-19,1861,9.896175251180859E-4
SIM,1863,35,30-34,1898,10
STAT,1823,40,35-39,1863,2.4846442085940845
STAT,1926,22,na,1948,4191.617337044176
STAT,1909,30,45-49,1939,1.4295978934455826
SIM,1935,24,35-39,1959,12
SIM,1823,48,50-100,1871,1
SIM,1880,26,35-39,1906,12
STAT,1867,22,45-49,1889,0.6210726314885586
STAT,1902,49,na,1951,2937.292511032062
SIM,1918,24,35-39,1942,16
STAT,1820,53,30-34,1873,0.009248330674450302
SIM,1825,83,na,1908,161
SIM,1767,87,na,1854,49
STAT,1907,55,na,1962,2994.500740273579
STAT,1919,36,45-49,1955,0.6925014041229406
STAT,1887,24,20-24,1911,72.35003319006888
SIM,1824,36,na,1860,1546
STAT,1826,110,na,1936,1.5083006398274861E-4
SIM,1788,86,na,1874,61
SIM,1960,6,na,1966,4670
SIM,1773,81,na,1854,163
STAT,1902,44,50-100,1946,0.09648251090443603
STAT,1837,34,35-39,1871,7.850685478320831
STAT,1868,51,50-100,1919,0.013687510880197208
STAT,1936,36,45-49,1972,0.632707009474289
SIM,1895,24,20-24,1919,89
STAT,1811,53,20-24,1864,0.0022965487639853297
SIM,1853,24,15-19,1877,6
SIM,1845,35,na,1880,1766
SIM,1858,23,20-24,1881,59
STAT,1848,49,15-19,1897,2.821524183719409E-4
SIM,1919,35,40-44,1954,1
STAT,1895,25,na,1920,2962.06555045329
STAT,1920,34,na,1954,3880.223645362176
STAT,1894,40,na,1934,2837.0058374391533
STAT,1877,37,40-44,1914,4.291340327971214
SIM,1876,25,30-34,1901,28
STAT,1919,5,na,1924,4197.53947613299
STAT,1946,23,25-29,1969,97.07477339720658
STAT,1872,33,40-44,1905,4.094731586218379
STAT,1935,20,45-49,1955,1.4483884643249423
STAT,1925,47,25-29,1972,0.06073079695207319
SIM,1794,80,na,1874,208
STAT,1916,35,15-19,1951,0.0187535187332427
SIM,1844,50,na,1894,1547
SIM,1828,33,20-24,1861,2
SIM,1944,26,35-39,1970,21
STAT,1931,16,40-44,1947,1.733812319540645
STAT,1858,22,35-39,1880,4.965499798253976
SIM,1907,46,50-100,1953,1
SIM,1836,21,na,1857,1784
SIM,1894,27,40-44,1921,4
STAT,1916,47,15-19,1963,3.5692203769101326E-4
STAT,1941,15,20-24,1956,131.98117275563618
SIM,1952,17,na,1969,4153
STAT,1857,85,na,1942,204.1618296943053
STAT,1883,48,20-24,1931,0.0109708031266572
STAT,1858,9,na,1867,2110.6388781308247
STAT,1873,53,45-49,1926,0.013692637167648089
STAT,1866,48,20-24,1914,0.01032054071939659
STAT,1927,24,35-39,1951,10.89191099228711
SIM,1848,24,40-44,1872,4
SIM,1813,42,40-44,1855,6
SIM,1818,36,30-34,1854,6
SIM,1838,56,na,1894,1303
STAT,1859,52,50-100,1911,0.011325718251573694
SIM,1885,27,30-34,1912,21
SIM,1905,34,35-39,1939,8
SIM,1918,30,na,1948,3774
SIM,1830,35,35-39,1865,10
SIM,1827,36,40-44,1863,4
STAT,1877,27,30-34,1904,24.686243854218063
SIM,1899,55,na,1954,2666
STAT,1822,35,35-39,1857,14.091796028780491
STAT,1886,39,40-44,1925,4.3253163087242825
SIM,1867,25,20-24,1892,13
SIM,1894,39,40-44,1933,8
SIM,1937,6,na,1943,3553
STAT,1851,94,na,1945,14.6561193017593
STAT,1864,33,na,1897,2006.285700596833
SIM,1857,20,na,1877,2007
STAT,1916,45,25-29,1961,0.05163871881006949
STAT,1907,33,15-19,1940,0.11297508622469812
STAT,1874,26,na,1900,2312.171063331592
STAT,1819,48,40-44,1867,0.29991229433019256
STAT,1836,24,50-100,1860,0.33499246601412047
STAT,1835,20,40-44,1855,2.3167195136619023
STAT,1911,22,50-100,1933,0.589395204521129
STAT,1825,47,20-24,1872,0.012582616054017752
STAT,1945,26,45-49,1971,1.7913348629479477
STAT,1842,47,20-24,1889,0.008546779211891089
STAT,1901,31,20-24,1932,3.5888258336793735
SIM,1862,78,na,1940,626
STAT,1929,21,50-100,1950,0.7884890276263722
STAT,1831,32,40-44,1863,3.5582615233588224
STAT,1886,27,40-44,1913,2.989944677756574
STAT,1862,19,35-39,1881,0.45542790627213336
STAT,1907,45,15-19,1952,3.1617957928302073E-4
SIM,1919,21,15-19,1940,8
SIM,1937,30,30-34,1967,15
SIM,1943,20,45-49,1963,2
SIM,1883,77,na,1960,976
STAT,1864,41,35-39,1905,1.5358074289143566
STAT,1887,30,15-19,1917,0.15166257662375043
STAT,1802,80,na,1882,254.4906627263951
STAT,1942,5,na,1947,3940.5273327149735
STAT,1881,9,na,1890,2366.678951506608
SIM,1909,34,35-39,1943,10
SIM,1849,22,35-39,1871,9
STAT,1819,36,40-44,1855,12.74686777257596
STAT,1929,42,30-34,1971,0.15641690885443915
SIM,1835,29,25-29,1864,45
SIM,1814,43,na,1857,1360
SIM,1870,19,35-39,1889,2
STAT,1841,36,15-19,1877,0.04573936433149725
SIM,1912,22,40-44,1934,4
SIM,1880,33,40-44,1913,8
STAT,1877,17,20-24,1894,17.37958033100559
SIM,1844,36,40-44,1880,10
STAT,1831,37,35-39,1868,5.585491530991389
SIM,1904,30,35-39,1934,15
STAT,1827,103,na,1930,0.07964356375090402
STAT,1859,25,20-24,1884,9.127902225099614
SIM,1927,28,50-100,1955,1
STAT,1867,78,na,1945,693.0424858027737
STAT,1932,18,15-19,1950,56.6231347484951
STAT,1827,72,na,1899,700.8426743439436
STAT,1910,33,20-24,1943,2.2117698559954833
SIM,1859,21,15-19,1880,7
SIM,1872,37,50-100,1909,1
SIM,1872,41,35-39,1913,3
STAT,1850,13,na,1863,2044.3678668979733
SIM,1940,18,15-19,1958,37
SIM,1943,16,40-44,1959,1
STAT,1946,19,20-24,1965,141.96419368733658
SIM,1843,20,40-44,1863,1
STAT,1816,45,20-24,1861,0.03262281473914367
STAT,1915,37,20-24,1952,0.2515477066542514
SIM,1958,0,na,1958,4859
STAT,1853,17,35-39,1870,0.4895066939510046
STAT,1844,13,na,1857,2120.637097684329
STAT,1847,53,35-39,1900,0.006232742110705162
STAT,1845,38,40-44,1883,3.20626662803413
STAT,1892,38,20-24,1930,0.9073963448824365
STAT,1897,41,30-34,1938,0.10132156192888477
SIM,1925,18,na,1943,4113
STAT,1882,55,na,1937,1900.7458412385038
STAT,1835,53,50-100,1888,0.009414888521173753
STAT,1846,46,45-49,1892,0.16686953201825813
STAT,1904,22,40-44,1926,2.8231923745087264
STAT,1847,103,na,1950,0.10559673059134357
STAT,1931,32,45-49,1963,1.9479069301600198
SIM,1822,72,na,1894,671
STAT,1840,20,na,1860,1921.088253497733
STAT,1846,23,20-24,1869,59.520801749634344
STAT,1899,42,50-100,1941,0.09485874418033464
SIM,1900,57,na,1957,2612
SIM,1913,26,40-44,1939,5
STAT,1908,45,50-100,1953,0.19603227887666302
SIM,1946,17,na,1963,3813
STAT,1812,73,na,1885,539.7878710068559
STAT,1888,77,na,1965,1275.0125750241916
SIM,1820,43,na,1863,1397
STAT,1964,7,na,1971,4675.482097476257
STAT,1878,47,35-39,1925,0.13704146679635903
STAT,1915,25,20-24,1940,17.706551945878093
STAT,1935,16,40-44,1951,1.8107194497688406
SIM,1819,44,35-39,1863,5
SIM,1918,36,35-39,1954,9
STAT,1836,36,40-44,1872,3.4284863937460974
STAT,1883,36,20-24,1919,0.7171387272614237
SIM,1853,38,40-44,1891,5
STAT,1831,25,35-39,1856,9.047641444966379
STAT,1807,58,na,1865,1047.0599160843988
STAT,1911,41,25-29,1952,0.06474317966773747
STAT,1929,30,30-34,1959,18.928202049307682
STAT,1832,52,45-49,1884,0.009152144425924201
STAT,1865,12,na,1877,2320.635448315488
STAT,1905,26,40-44,1931,4.103444076324863
STAT,1924,39,20-24,1963,0.29305404828295506
SIM,1854,23,20-24,1877,56
STAT,1837,34,na,1871,1680.0363637123153
STAT,1880,4,na,1884,2839.2349919493377
SIM,1912,15,35-39,1927,4
STAT,1884,42,50-100,1926,0.9850255760775941
SIM,1892,42,50-100,1934,1
STAT,1806,52,35-39,1858,0.02430784834696906
SIM,1854,49,na,1903,1746
SIM,1877,77,na,1954,778
SIM,1876,7,na,1883,2680
STAT,1862,29,45-49,1891,0.8883294991297505
STAT,1887,44,40-44,1931,2.3442758129500922
SIM,1881,36,50-100,1917,2
STAT,1933,39,30-34,1972,2.340201896855145
SIM,1813,95,na,1908,8
STAT,1920,9,na,1929,4219.503241307341
SIM,1928,29,20-24,1957,21
STAT,1899,23,35-39,1922,7.531347112117583
STAT,1847,50,30-34,1897,0.004442758493657618
SIM,1836,44,35-39,1880,5
STAT,1842,45,50-100,1887,0.1794641488208864
SIM,1940,25,20-24,1965,19
STAT,1827,106,na,1933,0.0067380225905420395
STAT,1897,48,15-19,1945,2.8148645947770296E-4
SIM,1886,37,25-29,1923,3
SIM,1904,24,40-44,1928,4
STAT,1913,27,45-49,1940,1.6258297980527208
SIM,1903,15,25-29,1918,9
STAT,1887,49,35-39,1936,0.08169126007398576
STAT,1836,26,30-34,1862,20.7255023828966
STAT,1815,52,45-49,1867,0.033753865937175935
STAT,1910,26,15-19,1936,0.6460199862962278
STAT,1932,25,20-24,1957,22.606676083160508
STAT,1844,17,25-29,1861,5.0568414604287835
STAT,1853,27,na,1880,1858.50795844703
SIM,1817,54,na,1871,1253
STAT,1926,43,50-100,1969,0.13661809305141498
SIM,1795,68,na,1863,688
SIM,1852,17,25-29,1869,8
STAT,1861,53,na,1914,1661.9893297150177
SIM,1889,62,na,1951,2077
STAT,1859,18,15-19,1877,5.163022401167796
SIM,1930,26,40-44,1956,7
STAT,1882,43,45-49,1925,1.3658482139876875
STAT,1868,26,na,1894,2159.976270769391
STAT,1891,42,40-44,1933,2.626855290883136
SIM,1894,23,25-29,1917,77
SIM,1899,32,40-44,1931,9
SIM,1869,34,20-24,1903,3
SIM,1926,16,40-44,1942,1
STAT,1863,23,20-24,1886,57.94725067093743
STAT,1876,16,25-29,1892,5.540080706157819
STAT,1891,66,na,1957,1966.1479638161388
STAT,1803,100,na,1903,0.35074359560424034
STAT,1848,71,na,1919,961.621774843134
SIM,1805,69,na,1874,700
STAT,1904,15,35-39,1919,0.7468577914436806
SIM,1921,27,45-49,1948,1
STAT,1909,29,45-49,1938,1.5481998646498263
SIM,1890,30,30-34,1920,27
SIM,1847,61,na,1908,1302
STAT,1922,26,40-44,1948,5.000010384074707
STAT,1935,19,45-49,1954,0.6416414370661166
STAT,1964,4,na,1968,4677.867410387684
STAT,1810,46,30-34,1856,0.35003004760557554
STAT,1873,43,35-39,1916,1.723861015130092
SIM,1890,43,45-49,1933,2
SIM,1960,9,na,1969,4667
STAT,1909,16,30-34,1925,2.2630262539895725
SIM,1859,27,20-24,1886,6
STAT,1872,23,30-34,1895,16.83745891927341
STAT,1884,81,na,1965,774.6041564748109
SIM,1874,63,na,1937,1665
STAT,1895,35,35-39,1930,8.802306192282577
STAT,1834,20,na,1854,1693.5957593560458
STAT,1932,22,na,1954,4526.574102943786
STAT,1938,20,50-100,1958,0.6155549884087468
SIM,1827,32,25-29,1859,9
STAT,1789,90,na,1879,27.177400177310517
STAT,1873,36,50-100,1909,1.1829591340319898
SIM,1881,43,35-39,1924,3
STAT,1896,49,45-49,1945,0.16273884907197048
SIM,1869,48,na,1917,2043
SIM,1872,31,25-29,1903,11
STAT,1866,17,45-49,1883,0.058398286819160025
SIM,1850,45,50-100,1895,5
STAT,1828,44,35-39,1872,1.5449531685658873
SIM,1835,27,35-39,1862,11
SIM,1822,34,30-34,1856,23
STAT,1831,46,na,1877,1490.281962141053
STAT,1935,19,50-100,1954,0.4812310777995875
SIM,1876,21,15-19,1897,3
SIM,1905,41,40-44,1946,1
STAT,1941,3,na,1944,3923.7086863998948
STAT,1882,30,30-34,1912,16.17885739534769
STAT,1910,41,na,1951,3333.962869996412
SIM,1858,31,40-44,1889,4
STAT,1857,46,20-24,1903,0.008962383484611538
STAT,1769,110,na,1879,0.0016541588362712395
STAT,1919,40,na,1959,3812.674417469102
SIM,1931,21,30-34,1952,44
STAT,1936,26,35-39,1962,13.577287362515767
SIM,1871,89,na,1960,168
SIM,1855,30,50-100,1885,4
SIM,1830,25,25-29,1855,40
SIM,1926,20,45-49,1946,1
STAT,1878,37,25-29,1915,2.8315537334581626
STAT,1800,88,na,1888,47.98175500088339
STAT,1803,99,na,1902,0.6256909852547232
SIM,1863,38,35-39,1901,12
STAT,1894,18,35-39,1912,0.6650554466522338
STAT,1929,40,40-44,1969,0.30687232022489536
STAT,1896,30,25-29,1926,12.89101495346289
STAT,1850,16,na,1866,1986.4222280483102
STAT,1868,21,15-19,1889,2.997163540716772
SIM,1832,47,50-100,1879,1
SIM,1866,22,35-39,1888,5
STAT,1881,25,30-34,1906,23.1253509471962
STAT,1832,42,35-39,1874,1.3433443578274633
STAT,1865,37,15-19,1902,0.04820559347759681
SIM,1828,94,na,1922,9
STAT,1928,35,40-44,1963,1.7905203026149121
SIM,1861,90,na,1951,50
STAT,1889,25,na,1914,2802.2183037716127
SIM,1900,22,15-19,1922,4
STAT,1836,86,na,1922,140.11237597898287
SIM,1868,33,25-29,1901,8
SIM,1798,79,na,1877,275
STAT,1824,47,50-100,1871,0.28861818781420534
STAT,1827,27,35-39,1854,25.946443894523377
STAT,1923,21,30-34,1944,31.69028979948508
STAT,1790,87,na,1877,54.53921375115091
SIM,1928,33,25-29,1961,19
STAT,1947,21,na,1968,3900.459013809359
SIM,1851,38,na,1889,1750
STAT,1868,25,30-34,1893,22.86759103498965
SIM,1927,33,40-44,1960,6
STAT,1892,48,30-34,1940,0.06378437757562504
SIM,1862,34,35-39,1896,8
SIM,1835,76,na,1911,579
STAT,1846,33,30-34,1879,14.397503799491323
SIM,1867,18,15-19,1885,4
SIM,1840,42,35-39,1882,2
SIM,1858,53,50-100,1911,1
SIM,1888,15,na,1903,2763
STAT,1856,53,45-49,1909,0.01056524346573145
SIM,1924,30,na,1954,4129
SIM,1870,29,45-49,1899,1
SIM,1849,32,45-49,1881,1
SIM,1895,44,40-44,1939,1
STAT,1770,111,na,1881,8.87563478582379E-4
STAT,1906,28,15-19,1934,0.6219204312402442
STAT,1818,98,na,1916,1.5661981114928212
SIM,1868,100,na,1968,1
SIM,1844,26,30-34,1870,26
SIM,1893,30,na,1923,3008
STAT,1925,40,na,1965,4260.058980101776
SIM,1868,30,20-24,1898,2
STAT,1807,48,15-19,1855,0.001457267564976844
STAT,1840,37,45-49,1877,1.6420162206180515
STAT,1871,28,40-44,1899,2.7956004819408147
STAT,1846,48,35-39,1894,0.09746984767096718
STAT,1876,52,na,1928,2088.7096309047843
STAT,1865,52,40-44,1917,0.008989295576225945
SIM,1866,34,na,1900,2080
SIM,1858,26,25-29,1884,42
SIM,1904,16,na,1920,3395
STAT,1883,50,35-39,1933,0.00808538915460713
STAT,1838,31,50-100,1869,0.7846264341158361
STAT,1925,44,20-24,1969,0.020134033072475424
STAT,1857,1,na,1858,2778.772628485916
SIM,1931,31,40-44,1962,3
SIM,1853,22,25-29,1875,69
SIM,1865,89,na,1954,67
STAT,1850,41,40-44,1891,1.5906603450372911
SIM,1853,6,na,1859,2387
SIM,1905,31,30-34,1936,19
STAT,1795,90,na,1885,29.87252635592594
SIM,1918,29,50-100,1947,5
STAT,1829,45,30-34,1874,0.08017631010685791
SIM,1836,24,15-19,1860,2
STAT,1881,38,45-49,1919,1.8093278925486729
SIM,1936,35,40-44,1971,6
STAT,1898,16,45-49,1914,0.08374134499557861
STAT,1904,41,na,1945,3156.352636021337
SIM,1865,45,50-100,1910,3
STAT,1895,49,50-100,1944,0.1672246898038191
SIM,1846,31,50-100,1877,3
SIM,1859,37,30-34,1896,3
SIM,1862,75,na,1937,863
STAT,1922,20,35-39,1942,10.262305987740705
STAT,1774,91,na,1865,16.306727531335554
SIM,1918,26,25-29,1944,65
STAT,1837,31,30-34,1868,13.963359865050904
STAT,1910,46,35-39,1956,0.11388762509250941
SIM,1854,33,30-34,1887,18
SIM,1843,23,45-49,1866,1
SIM,1913,22,25-29,1935,91
STAT,1905,18,20-24,1923,24.13879098704053
STAT,1900,19,15-19,1919,7.736049558330378
SIM,1887,42,25-29,1929,4
STAT,1822,32,na,1854,1456.6227549211078
STAT,1871,18,30-34,1889,1.4935196283304586
SIM,1848,27,45-49,1875,1
STAT,1814,47,45-49,1861,0.640225833836527
STAT,1854,34,35-39,1888,7.314410703709944
STAT,1825,46,na,1871,1476.259331606459
STAT,1791,104,na,1895,0.012242835487723511
STAT,1828,34,25-29,1862,10.280528344477634
STAT,1904,30,50-100,1934,1.2513288043036856
SIM,1914,38,25-29,1952,1
STAT,1857,45,50-100,1902,0.18473433244295207
STAT,1845,22,25-29,1867,50.05808100619562
STAT,1824,61,na,1885,1042.6321074134826
STAT,1839,97,na,1936,3.582061293993956
STAT,1916,42,20-24,1958,0.017096429669924966
SIM,1899,17,15-19,1916,7
STAT,1946,20,20-24,1966,116.9782738301863
SIM,1877,74,na,1951,1024
STAT,1896,36,30-34,1932,6.68617630982546
STAT,1880,1,na,1881,3381.5337246045233
SIM,1856,75,na,1931,740
SIM,1912,30,50-100,1942,1
STAT,1833,72,na,1905,766.6909211636033
STAT,1823,49,45-49,1872,0.2735219744858097
STAT,1837,31,na,1868,1733.1951498690787
SIM,1818,39,35-39,1857,14
SIM,1897,1,na,1898,3413
STAT,1846,43,40-44,1889,1.5846685673725147
SIM,1898,73,na,1971,1904
SIM,1862,24,25-29,1886,49
STAT,1931,22,35-39,1953,11.537080311480237
SIM,1810,84,na,1894,118
STAT,1847,30,50-100,1877,0.8081638334128626
STAT,1846,45,na,1891,1602.1154995984423
SIM,1845,31,30-34,1876,26
STAT,1833,48,25-29,1881,0.03688441696132656
STAT,1876,24,45-49,1900,0.6758092927994429
SIM,1878,40,25-29,1918,1
SIM,1854,43,40-44,1897,9
STAT,1879,66,na,1945,1618.411198695839
SIM,1904,20,25-29,1924,81
STAT,1840,19,15-19,1859,5.288157222125783
SIM,1839,25,45-49,1864,1
SIM,1900,28,20-24,1928,17
SIM,1841,76,na,1917,631
SIM,1894,15,na,1909,3244
SIM,1927,44,na,1971,4312
SIM,1801,70,na,1871,626
STAT,1879,52,35-39,1931,0.008455606784685276
STAT,1839,60,na,1899,1271.6542045287108
STAT,1854,24,25-29,1878,47.741651620429316
STAT,1863,36,35-39,1899,5.901719298135784
SIM,1876,28,35-39,1904,10
SIM,1912,25,45-49,1937,1
STAT,1886,23,25-29,1909,56.961670433148605
SIM,1842,24,na,1866,1821
STAT,1907,49,30-34,1956,0.07457713821999608
STAT,1843,52,20-24,1895,5.295418059548096E-4
SIM,1917,29,45-49,1946,2
STAT,1802,54,25-29,1856,0.00969864313160522
STAT,1887,34,30-34,1921,18.28820232053987
SIM,1831,30,25-29,1861,13
SIM,1863,23,na,1886,2063
STAT,1810,47,na,1857,1325.923016829073
STAT,1920,37,na,1957,3891.5564207059315
STAT,1937,31,35-39,1968,8.544816700063466
SIM,1870,16,30-34,1886,2
STAT,1940,24,35-39,1964,9.054366204408474
SIM,1836,34,25-29,1870,14
STAT,1824,51,40-44,1875,0.01215114241862461
SIM,1936,25,30-34,1961,27
SIM,1885,17,20-24,1902,15
STAT,1890,21,25-29,1911,66.31985060733138
SIM,1895,34,30-34,1929,23
STAT,1830,61,na,1891,1116.2322159052057
SIM,1912,45,na,1957,3200
STAT,1780,91,na,1871,15.083374333856586
STAT,1895,25,25-29,1920,52.50297981765898
STAT,1901,34,25-29,1935,13.427706647989206
STAT,1906,38,25-29,1944,0.850631284408014
SIM,1844,16,20-24,1860,15
STAT,1838,51,35-39,1889,0.005957276977400696
STAT,1945,23,40-44,1968,3.4801299167594686
SIM,1789,68,na,1857,715
SIM,1913,18,20-24,1931,20
STAT,1819,46,na,1865,1363.5381220444667
STAT,1835,23,45-49,1858,0.5741893062426678
STAT,1891,34,50-100,1925,1.0621994269317323
SIM,1904,39,45-49,1943,2
SIM,1859,89,na,1948,91
STAT,1874,49,25-29,1923,0.05445342497883362
STAT,1919,23,30-34,1942,29.639619284830832
STAT,1836,39,45-49,1875,1.5134237924463865
STAT,1923,31,40-44,1954,4.255821902355658
SIM,1819,41,30-34,1860,6
SIM,1874,44,50-100,1918,3
STAT,1840,24,30-34,1864,15.549460286613026
STAT,1868,28,50-100,1896,0.5749568457866752
SIM,1937,9,na,1946,3523
STAT,1904,25,45-49,1929,1.5144697542277532
STAT,1864,67,na,1931,1338.4164784790887
STAT,1878,32,30-34,1910,17.17080315753083
SIM,1927,23,30-34,1950,32
STAT,1876,21,40-44,1897,2.0383813460427813
SIM,1881,29,20-24,1910,10
SIM,1845,36,25-29,1881,1
STAT,1905,22,25-29,1927,78.1491570371574
STAT,1870,67,na,1937,1467.387784874288
STAT,1866,44,50-100,1910,0.9077376041175861
SIM,1844,39,45-49,1883,2
SIM,1864,40,30-34,1904,4
SIM,1867,28,25-29,1895,34
STAT,1872,36,45-49,1908,1.8993264642955694
SIM,1899,8,na,1907,3362
SIM,1928,29,na,1957,4336
SIM,1802,55,na,1857,1100
STAT,1890,81,na,1971,1061.8827780745783
SIM,1849,54,50-100,1903,1
STAT,1936,16,25-29,1952,39.28359184795964
SIM,1886,32,30-34,1918,28
STAT,1920,40,20-24,1960,0.01847810270397091
SIM,1857,23,na,1880,2009
SIM,1804,84,na,1888,89
STAT,1885,66,na,1951,1542.602519071091
SIM,1897,29,na,1926,3019
STAT,1837,36,25-29,1873,2.2360125396228736
STAT,1862,16,30-34,1878,1.4797401888846422
STAT,1935,36,na,1971,4974.072009718317
STAT,1781,107,na,1888,0.007437720872373446
SIM,1834,21,45-49,1855,1
SIM,1918,21,30-34,1939,38
SIM,1944,16,25-29,1960,49
SIM,1880,36,45-49,1916,2
STAT,1859,28,25-29,1887,32.20963063998437
STAT,1880,35,30-34,1915,5.347903784421048
STAT,1958,12,na,1970,4872.9730229247325
STAT,1843,36,na,1879,1822.7330341246548
STAT,1914,48,30-34,1962,0.08327450609571779
STAT,1866,27,20-24,1893,10.217965437592381
STAT,1885,44,20-24,1929,0.14745396240095746
STAT,1879,33,40-44,1912,4.264142060080376
SIM,1926,15,15-19,1941,49
SIM,1926,11,na,1937,4491
SIM,1934,30,na,1964,4810
SIM,1888,20,na,1908,2572
STAT,1882,43,40-44,1925,2.052710754226128
STAT,1827,73,na,1900,659.142535220479
SIM,1925,22,45-49,1947,1
STAT,1877,25,30-34,1902,24.85372343831192
STAT,1926,20,45-49,1946,1.2992046979985787
SIM,1785,77,na,1862,258
SIM,1841,43,45-49,1884,1
SIM,1899,35,50-100,1934,2
STAT,1843,34,15-19,1877,0.12097552773038106
STAT,1845,42,25-29,1887,0.46060933700259926
STAT,1866,39,15-19,1905,0.04841775008229831
STAT,1865,46,45-49,1911,0.20316818000936848
SIM,1830,81,na,1911,319
SIM,1945,20,20-24,1965,105
SIM,1836,25,35-39,1861,9
STAT,1769,94,na,1863,3.3644442852872274
SIM,1865,29,20-24,1894,8
SIM,1885,25,30-34,1910,31
STAT,1929,21,25-29,1950,110.68807813585904
SIM,1928,23,25-29,1951,130
STAT,1861,18,30-34,1879,1.4286718744571474
SIM,1800,83,na,1883,99
STAT,1856,48,45-49,1904,0.17242093820271034
SIM,1834,95,na,1929,7
STAT,1824,50,40-44,1874,0.012395241742751114
STAT,1870,16,30-34,1886,1.4982757968290186
SIM,1853,22,30-34,1875,30
SIM,1890,43,40-44,1933,6
SIM,1915,49,50-100,1964,3
SIM,1878,35,40-44,1913,5
STAT,1836,44,25-29,1880,0.47020602333835115
STAT,1820,34,20-24,1854,8.33012873203818
SIM,1887,33,40-44,1920,4
STAT,1815,52,40-44,1867,0.024485855267687488
STAT,1818,37,na,1855,1447.1044444589045
SIM,1909,31,na,1940,3398
SIM,1854,29,45-49,1883,1
STAT,1896,45,35-39,1941,0.09958164648276382
STAT,1873,45,40-44,1918,0.1658017611490739
SIM,1870,31,20-24,1901,2
SIM,1826,76,na,1902,487
SIM,1871,26,40-44,1897,2
STAT,1863,38,35-39,1901,5.8443177503867325
STAT,1852,72,na,1924,959.5126263669212
STAT,1863,26,40-44,1889,2.5055467790074823
STAT,1854,28,40-44,1882,2.2450953701122294
SIM,1862,28,40-44,1890,4
STAT,1847,50,35-39,1897,0.006425477163160491
STAT,1838,52,35-39,1890,0.00584045477587387
STAT,1813,44,30-34,1857,3.676074956951593
SIM,1951,10,na,1961,4352
SIM,1821,44,30-34,1865,2
SIM,1900,18,na,1918,3272
STAT,1872,36,35-39,1908,6.738839485052423
STAT,1881,53,na,1934,1932.4648333249436
SIM,1793,96,na,1889,1
STAT,1885,67,na,1952,1491.9743043951783
STAT,1845,22,30-34,1867,15.575843920910385
SIM,1917,50,na,1967,3524
STAT,1822,42,30-34,1864,1.7339054887809686
STAT,1846,29,45-49,1875,0.9334971127182207
STAT,1856,86,na,1942,164.16485476910384
STAT,1872,24,40-44,1896,1.9635030402768434
SIM,1871,38,35-39,1909,13
STAT,1895,16,35-39,1911,0.6781098840891843
SIM,1894,23,30-34,1917,28
STAT,1835,28,30-34,1863,20.33015007773606
SIM,1892,15,20-24,1907,17
SIM,1936,22,20-24,1958,74
SIM,1938,30,30-34,1968,16
STAT,1886,18,35-39,1904,0.5462449269624308
STAT,1837,36,40-44,1873,3.399611272644227
STAT,1892,37,na,1929,2787.1369807288556
STAT,1875,37,15-19,1912,0.05450013734064337
STAT,1879,53,35-39,1932,0.008364370787478525
STAT,1889,19,15-19,1908,6.884182915161065
STAT,1880,22,25-29,1902,56.90204768496126
STAT,1858,28,25-29,1886,31.88477339254954
STAT,1825,38,15-19,1863,0.06904958110496279
STAT,1853,19,35-39,1872,0.4837572871114387
STAT,1859,37,30-34,1896,4.018099506303418
STAT,1861,38,25-29,1899,2.247460016669294
SIM,1919,30,20-24,1949,2
STAT,1899,46,15-19,1945,2.929370269356104E-4
SIM,1842,16,20-24,1858,14
SIM,1877,26,35-39,1903,9
STAT,1877,48,na,1925,2177.8442073740625
STAT,1894,37,25-29,1931,3.498858750430857
STAT,1843,47,20-24,1890,0.008617103426737965
STAT,1857,29,20-24,1886,8.870488416797693
SIM,1870,53,50-100,1923,2
STAT,1871,37,30-34,1908,4.991381175635481
SIM,1919,25,25-29,1944,65
STAT,1792,70,na,1862,593.6672928418067
STAT,1881,85,na,1966,482.69967088104903
SIM,1910,28,na,1938,3332
STAT,1844,43,20-24,1887,0.11272898112824377
SIM,1897,19,15-19,1916,10
STAT,1856,53,40-44,1909,0.007664278303744002
STAT,1816,51,45-49,1867,0.03731957129580701
SIM,1827,32,30-34,1859,18
STAT,1827,46,25-29,1873,0.05114078669815187
STAT,1848,67,na,1915,1142.0282317122092
SIM,1937,21,25-29,1958,71
STAT,1873,34,na,1907,2268.662425418721
SIM,1843,28,30-34,1871,35
STAT,1833,43,45-49,1876,1.0895176714977484
STAT,1886,23,30-34,1909,17.723933285242154
STAT,1827,51,20-24,1878,6.36621721126234E-4
STAT,1859,49,25-29,1908,0.04251935056149976
STAT,1878,54,30-34,1932,0.005693067318819007
STAT,1917,22,45-49,1939,1.1296627681843936
STAT,1831,35,35-39,1866,5.717661061843936
STAT,1881,17,45-49,1898,0.05958352948222183
STAT,1871,43,na,1914,2148.9400473726664
SIM,1876,27,30-34,1903,28
SIM,1806,88,na,1894,27
STAT,1876,46,20-24,1922,0.011736292398908919
STAT,1823,100,na,1923,0.5586780650230004
STAT,1882,38,45-49,1920,1.8234235313280416
STAT,1808,46,15-19,1854,0.0015482756562509412
SIM,1821,39,35-39,1860,11
SIM,1890,30,35-39,1920,14
STAT,1867,38,na,1905,2079.38770948321
SIM,1890,38,45-49,1928,3
SIM,1902,31,50-100,1933,1
STAT,1833,26,na,1859,1742.6197780563618
SIM,1840,44,40-44,1884,6
STAT,1892,29,15-19,1921,0.5328970513317245
STAT,1894,42,20-24,1936,0.01338531712392024
STAT,1895,49,35-39,1944,0.0953235205359195
STAT,1928,22,20-24,1950,131.16682230848997
STAT,1818,108,na,1926,8.831170300622917E-4
SIM,1884,41,50-100,1925,3
STAT,1850,40,40-44,1890,1.5994734437121447
STAT,1859,41,15-19,1900,0.010458679388551639
STAT,1902,64,na,1966,2555.6864001840468
SIM,1866,28,25-29,1894,50
STAT,1877,45,25-29,1922,0.057029201798596
STAT,1882,30,35-39,1912,9.384135669111398
STAT,1830,39,35-39,1869,5.4637987977182965
STAT,1837,53,30-34,1890,0.0036973837220502584
SIM,1856,18,15-19,1874,3
SIM,1872,34,35-39,1906,10
SIM,1901,67,na,1968,2342
STAT,1873,22,50-100,1895,0.39103361892848804
STAT,1894,17,30-34,1911,1.936902445235027
SIM,1872,25,45-49,1897,2
STAT,1899,26,20-24,1925,15.23981504712725
STAT,1818,48,25-29,1866,0.12121387958571676
SIM,1830,38,na,1868,1663
SIM,1863,76,na,1939,734
STAT,1847,18,na,1865,2095.5730103220085
SIM,1938,12,na,1950,3625
STAT,1865,51,40-44,1916,0.009080646883877753
SIM,1874,42,45-49,1916,1
STAT,1835,48,25-29,1883,0.03739951078090931
SIM,1873,18,15-19,1891,5
STAT,1832,44,40-44,1876,1.6259327219603292
SIM,1855,57,na,1912,1562
SIM,1861,36,25-29,1897,1
STAT,1855,37,na,1892,1668.5897118756805
SIM,1852,26,30-34,1878,31
SIM,1877,39,40-44,1916,8
STAT,1771,105,na,1876,0.013971760337568834
SIM,1815,92,na,1907,17
STAT,1896,28,45-49,1924,1.3813696131082411
SIM,1822,43,35-39,1865,7
SIM,1881,49,50-100,1930,3
SIM,1831,55,na,1886,1293
SIM,1837,60,na,1897,1203
STAT,1805,50,30-34,1855,0.018080540778564656
STAT,1861,30,15-19,1891,0.1126134813825752
STAT,1876,33,15-19,1909,0.13829776282859385
STAT,1850,35,45-49,1885,1.4555597260317952
SIM,1895,37,50-100,1932,1
STAT,1854,15,35-39,1869,0.4782780450506302
STAT,1829,37,45-49,1866,1.778965724520294
STAT,1869,39,40-44,1908,3.962661728282248
STAT,1895,46,30-34,1941,0.06750600860086922
STAT,1865,18,15-19,1883,5.218852227835646
STAT,1872,92,na,1964,103.79399727087836
SIM,1896,71,na,1967,1971
STAT,1838,32,40-44,1870,3.6753820804584665
STAT,1864,25,45-49,1889,0.9474606949934977
STAT,1805,62,na,1867,919.2292760720596
STAT,1813,81,na,1894,228.7041420570805
STAT,1855,32,40-44,1887,3.1273414366131376
STAT,1876,29,30-34,1905,24.383257436263452
STAT,1844,108,na,1952,0.0012858867839917211
SIM,1826,28,30-34,1854,23
STAT,1849,53,50-100,1902,0.010711138156444058
STAT,1948,21,35-39,1969,10.2174635216649
SIM,1828,39,45-49,1867,1
STAT,1860,26,15-19,1886,0.354612928695227
SIM,1880,36,35-39,1916,15
SIM,1887,28,45-49,1915,1
SIM,1837,37,45-49,1874,2
STAT,1814,43,35-39,1857,5.386521686673356
STAT,1844,30,15-19,1874,0.1220578982080424
STAT,1884,18,na,1902,2351.5763241625937
SIM,1883,30,50-100,1913,6
STAT,1859,54,20-24,1913,5.410366771233849E-4
SIM,1852,38,25-29,1890,2
SIM,1879,16,na,1895,2509
SIM,1893,19,30-34,1912,1
STAT,1809,76,na,1885,410.09898436798534
STAT,1937,15,25-29,1952,40.005892768030265
STAT,1869,43,25-29,1912,0.5829701303246159
SIM,1843,88,na,1931,99
STAT,1857,52,45-49,1909,0.010750594389362697
STAT,1871,15,35-39,1886,0.5233558210884464
SIM,1888,52,na,1940,2341
STAT,1849,35,20-24,1884,0.5804777535034172
STAT,1830,31,25-29,1861,8.709415084719282
SIM,1910,45,50-100,1955,1
STAT,1839,28,15-19,1867,0.37836616073641716
STAT,1853,36,25-29,1889,2.1575223848037486
STAT,1862,16,50-100,1878,0.04548380803396415
SIM,1867,101,na,1968,4
STAT,1840,46,40-44,1886,0.12178071915429893
SIM,1850,26,na,1876,1881
STAT,1881,34,35-39,1915,9.158255834892797
STAT,1879,28,45-49,1907,1.0924897745775102
STAT,1829,54,35-39,1883,0.00586950299144124
STAT,1821,33,25-29,1854,32.18674452382109
SIM,1835,26,30-34,1861,24
SIM,1945,15,25-29,1960,51
SIM,1877,43,25-29,1920,1
STAT,1864,47,40-44,1911,0.14387212173877653
SIM,1906,22,35-39,1928,8
STAT,1844,38,25-29,1882,2.113813269943976
STAT,1932,29,50-100,1961,1.230405252693131
SIM,1886,29,40-44,1915,3
SIM,1827,27,35-39,1854,9
STAT,1823,46,40-44,1869,0.20719019568501462
STAT,1930,28,na,1958,4498.025620850809
SIM,1776,84,na,1860,94
STAT,1867,104,na,1971,0.6886607494890107
STAT,1854,40,25-29,1894,0.4670794923716985
SIM,1874,46,50-100,1920,1
STAT,1855,27,45-49,1882,0.8196465711751285
STAT,1841,45,45-49,1886,0.16641107485784074
STAT,1891,41,40-44,1932,2.641993916021942
SIM,1877,23,30-34,1900,21
STAT,1891,36,45-49,1927,2.3422166293312054
SIM,1836,38,40-44,1874,9
STAT,1818,40,15-19,1858,0.03584420069884991
STAT,1777,81,na,1858,179.65526102661443
SIM,1846,32,40-44,1878,6
SIM,1863,27,45-49,1890,5
STAT,1801,80,na,1881,268.4119152671502
STAT,1892,69,na,1961,1888.3494816396042
SIM,1864,40,35-39,1904,2
STAT,1881,51,25-29,1932,0.0032462839972356348
STAT,1885,31,15-19,1916,0.13457889945297508
SIM,1883,40,45-49,1923,2
STAT,1853,41,20-24,1894,0.11830990132948249
STAT,1860,91,na,1951,44.48999689346985
STAT,1890,37,40-44,1927,5.056134001635513
SIM,1861,16,30-34,1877,1
SIM,1884,29,30-34,1913,26
SIM,1893,39,25-29,1932,3
STAT,1845,25,35-39,1870,8.392669926799396
STAT,1819,52,25-29,1871,0.006049431938172916
STAT,1848,18,15-19,1866,5.268762210191578
STAT,1890,24,35-39,1914,6.697942688924299
STAT,1851,36,15-19,1887,0.04205446568193012
STAT,1918,15,15-19,1933,9.4056547283524
SIM,1817,38,30-34,1855,6
SIM,1827,27,50-100,1854,1
STAT,1856,54,na,1910,1549.3061987016933
STAT,1892,40,45-49,1932,1.7884008306293875
STAT,1895,29,40-44,1924,3.6665364730112158
STAT,1797,58,na,1855,1002.9389699999999
STAT,1834,36,15-19,1870,0.0436871354339321
STAT,1875,40,45-49,1915,1.4672029145419487
SIM,1851,75,na,1926,717
STAT,1880,36,na,1916,2353.108982737073
STAT,1929,31,na,1960,4541.252632459385
STAT,1885,39,25-29,1924,2.6825676125089335
SIM,1916,33,na,1949,3566
STAT,1881,47,40-44,1928,0.15543102731706449
STAT,1947,1,na,1948,4379.3247371675925
STAT,1828,38,40-44,1866,4.065809276251727
STAT,1838,27,45-49,1865,0.9632828305391632
STAT,1851,23,na,1874,1858.9634777378458
STAT,1840,33,35-39,1873,8.501352803357813
SIM,1901,7,na,1908,3510
STAT,1844,26,30-34,1870,21.797268626536738
STAT,1939,31,35-39,1970,8.812488486418058
SIM,1882,41,40-44,1923,3
STAT,1805,94,na,1899,6.691907822745752
STAT,1854,4,na,1858,2295.9982887428987
STAT,1829,42,40-44,1871,1.892373456250427
SIM,1908,14,na,1922,3540
STAT,1874,41,40-44,1915,2.181573385987548
STAT,1942,29,na,1971,3710.4759368055034
STAT,1871,2,na,1873,3102.094615906831
STAT,1937,20,20-24,1957,102.34961598319991
SIM,1855,89,na,1944,69
SIM,1873,0,na,1873,3384
STAT,1891,26,50-100,1917,0.750563539350018
STAT,1824,45,45-49,1869,0.2852950929845648
STAT,1835,40,15-19,1875,0.010592195457404951
SIM,1856,2,na,1858,2691
STAT,1807,50,40-44,1857,0.03880183592816626
SIM,1919,47,50-100,1966,1
SIM,1878,44,50-100,1922,1
SIM,1883,17,20-24,1900,22
STAT,1818,53,20-24,1871,0.0014821577020732246
STAT,1946,17,50-100,1963,0.3925736799466985
STAT,1868,87,na,1955,158.91102065828127
SIM,1829,41,na,1870,1498
SIM,1842,39,na,1881,1663
STAT,1954,15,25-29,1969,50.63464372443925
SIM,1831,48,50-100,1879,4
STAT,1864,73,na,1937,1002.8323540637994
STAT,1886,43,25-29,1929,0.63632234722322
SIM,1845,36,50-100,1881,3
SIM,1846,27,45-49,1873,1
STAT,1940,3,na,1943,3874.183441585493
SIM,1868,33,30-34,1901,17
SIM,1942,1,na,1943,3856
STAT,1854,45,30-34,1899,0.0704000513479814
SIM,1928,19,40-44,1947,2
STAT,1840,30,30-34,1870,15.120647599607384
SIM,1894,26,50-100,1920,5
STAT,1813,47,35-39,1860,0.42347908867592604
SIM,1830,25,40-44,1855,2
STAT,1888,43,35-39,1931,2.0062881345367445
STAT,1909,20,45-49,1929,0.9935464356464561
SIM,1871,20,na,1891,2280
SIM,1943,15,15-19,1958,39
STAT,1896,33,40-44,1929,5.391680915319997
SIM,1875,18,25-29,1893,4
STAT,1886,35,25-29,1921,2.901089032030217
STAT,1849,27,20-24,1876,10.023702772635055
SIM,1905,49,na,1954,2981
STAT,1825,41,45-49,1866,1.7095185590452426
STAT,1834,109,na,1943,4.4036256327145977E-4
STAT,1834,75,na,1909,637.1921252058614
SIM,1894,35,25-29,1929,4
SIM,1901,35,na,1936,3234
SIM,1945,23,25-29,1968,103
STAT,1830,44,30-34,1874,0.8505867124118905
STAT,1870,28,25-29,1898,39.019301640098604
STAT,1882,46,45-49,1928,0.21755895815080595
STAT,1869,51,25-29,1920,0.0032544440380467363
SIM,1893,27,30-34,1920,31
STAT,1876,41,15-19,1917,0.013529050880286605
STAT,1937,23,25-29,1960,84.93513755625588
SIM,1810,93,na,1903,10
STAT,1867,43,15-19,1910,0.012160839117221184
STAT,1868,55,na,1923,1865.0301482768896
SIM,1792,79,na,1871,227
SIM,1857,27,20-24,1884,9
STAT,1873,15,45-49,1888,0.0633827437889626
STAT,1864,17,45-49,1881,0.05705403196096498
SIM,1880,20,25-29,1900,60
STAT,1864,41,na,1905,1960.2342515109424
SIM,1871,35,30-34,1906,5
STAT,1873,48,45-49,1921,0.22345886818158026
SIM,1844,73,na,1917,772
SIM,1848,87,na,1935,95
SIM,1867,90,na,1957,58
STAT,1761,98,na,1859,0.34391860973360655
SIM,1870,22,30-34,1892,17
STAT,1833,58,na,1891,1200.579738248344
STAT,1910,27,50-100,1937,0.9077329374538579
SIM,1870,34,25-29,1904,12
SIM,1771,85,na,1856,65
SIM,1775,99,na,1874,1
STAT,1892,32,45-49,1924,2.0629534887188115
SIM,1873,30,35-39,1903,8
STAT,1928,30,20-24,1958,2.8847744432811644
SIM,1886,29,na,1915,2304
STAT,1819,44,25-29,1863,1.1790508550397365
STAT,1893,25,15-19,1918,0.5475045508476424
SIM,1882,36,45-49,1918,2
STAT,1844,51,20-24,1895,5.205047418481928E-4
SIM,1917,20,45-49,1937,1
STAT,1862,47,30-34,1909,0.07764143842627907
SIM,1868,28,35-39,1896,7
STAT,1793,76,na,1869,367.58890354585384
SIM,1859,35,30-34,1894,4
SIM,1880,24,na,1904,2397
SIM,1884,38,na,1922,2307
STAT,1863,24,na,1887,1974.4468908331046
SIM,1922,29,na,1951,3993
STAT,1841,50,40-44,1891,0.007306438245101973
SIM,1891,19,20-24,1910,26
STAT,1935,15,15-19,1950,58.87973471331557
STAT,1909,0,na,1909,4158.889139594767
STAT,1873,40,35-39,1913,1.7539253604123843
STAT,1853,16,30-34,1869,1.4303250368243492
STAT,1878,29,40-44,1907,2.9249393042331002
STAT,1861,35,20-24,1896,0.6104559927303834
SIM,1841,40,40-44,1881,3
STAT,1836,41,20-24,1877,0.12084404668547358
SIM,1867,37,30-34,1904,4
STAT,1835,53,20-24,1888,4.600108580097961E-4
STAT,1917,30,na,1947,3771.2812430963904
STAT,1838,89,na,1927,71.64905656245354
STAT,1883,19,20-24,1902,16.326237830267548
STAT,1943,20,45-49,1963,1.1316317144185128
SIM,1846,21,na,1867,1872
SIM,1817,40,na,1857,1509
STAT,1826,34,15-19,1860,0.16824687926138285
SIM,1935,9,na,1944,5131
STAT,1876,49,25-29,1925,0.055001825352152374
SIM,1833,41,45-49,1874,1
SIM,1819,38,40-44,1857,8
STAT,1910,51,na,1961,3195.8861324507684
SIM,1935,29,50-100,1964,1
STAT,1867,18,25-29,1885,5.108213762933872
STAT,1919,32,20-24,1951,2.4860300117378626
SIM,1864,103,na,1967,1
SIM,1928,20,20-24,1948,142
SIM,1919,22,20-24,1941,125
SIM,1927,32,20-24,1959,2
SIM,1868,49,50-100,1917,2
SIM,1936,30,20-24,1966,1
STAT,1894,45,25-29,1939,0.039877598613275445
STAT,1852,24,15-19,1876,2.935008285404571
SIM,1814,75,na,1889,399
STAT,1821,46,30-34,1867,0.14999573865045193
SIM,1810,61,na,1871,965
SIM,1867,38,50-100,1905,2
SIM,1842,19,25-29,1861,6
STAT,1804,54,30-34,1858,0.017005414416766226
STAT,1815,40,na,1855,1397.262157547432
STAT,1814,40,30-34,1854,3.875689349060338
STAT,1923,38,30-34,1961,1.9931539645710978
STAT,1878,65,na,1943,1661.9979019456339
SIM,1835,69,na,1904,896
SIM,1863,32,40-44,1895,5
STAT,1875,17,20-24,1892,17.206213813138138
SIM,1931,38,30-34,1969,5
STAT,1812,64,na,1876,897.1702967488724
STAT,1885,27,30-34,1912,23.70068427939672
SIM,1849,28,25-29,1877,50
SIM,1863,44,35-39,1907,1
SIM,1919,33,25-29,1952,11
STAT,1840,16,45-49,1856,0.05924831608792156
STAT,1877,42,20-24,1919,0.15549543512147762
STAT,1872,27,45-49,1899,1.0527919802846692
SIM,1861,10,na,1871,2391
SIM,1873,38,45-49,1911,2
STAT,1833,40,40-44,1873,1.7017475089517178
SIM,1843,56,na,1899,1449
SIM,1850,58,na,1908,1459
STAT,1945,22,20-24,1967,115.12745098061696
SIM,1924,33,50-100,1957,6
STAT,1877,50,20-24,1927,7.337903913626299E-4
STAT,1890,45,40-44,1935,0.19971201378369224
STAT,1818,36,30-34,1854,19.867330835169863
SIM,1824,45,50-100,1869,3
STAT,1832,31,35-39,1863,8.105211266248183
STAT,1800,63,na,1863,873.3574603394048
STAT,1871,45,30-34,1916,0.09156122169687149
STAT,1816,45,50-100,1861,0.667680248559265
STAT,1920,22,50-100,1942,0.6910855113283696
STAT,1823,54,40-44,1877,0.011609638007935602
STAT,1804,77,na,1881,355.6230264340166
STAT,1827,54,25-29,1881,0.002620116022621786
SIM,1860,24,15-19,1884,4
STAT,1871,75,na,1946,964.13596728062
SIM,1890,35,40-44,1925,6
SIM,1918,21,15-19,1939,4
STAT,1845,17,35-39,1862,0.48850287316960067
STAT,1847,25,45-49,1872,0.9961842390539574
STAT,1881,31,30-34,1912,15.990858871142201
SIM,1876,51,na,1927,2151
SIM,1938,33,35-39,1971,11
STAT,1817,95,na,1912,5.896082163499319
STAT,1875,89,na,1964,227.9465504803222
STAT,1895,41,25-29,1936,0.05522261706582855
SIM,1838,34,na,1872,1635
STAT,1870,20,15-19,1890,3.0720266408980836
STAT,1934,10,na,1944,5078.174028745848
STAT,1840,49,45-49,1889,0.16154540094646927
SIM,1826,36,30-34,1862,7
STAT,1893,33,15-19,1926,0.16997179786299538
STAT,1854,48,35-39,1902,0.09954647061082197
SIM,1836,22,30-34,1858,24
STAT,1836,32,30-34,1868,13.936493164379142
STAT,1860,34,15-19,1894,0.10839878770010776
SIM,1844,32,30-34,1876,21
STAT,1871,41,15-19,1912,0.012992026538946898
SIM,1865,35,na,1900,2034
SIM,1873,86,na,1959,258
STAT,1769,111,na,1880,0.001036611717926098
STAT,1819,54,na,1873,1198.181850977188
STAT,1849,52,na,1901,1543.7215203901844
STAT,1938,24,na,1962,3411.5791970985183
STAT,1870,33,20-24,1903,2.491579987020966
SIM,1869,49,na,1918,2025
STAT,1820,37,25-29,1857,6.572084566463872
SIM,1878,38,45-49,1916,3
STAT,1866,42,45-49,1908,1.3019522917214412
SIM,1855,25,45-49,1880,1
STAT,1835,45,20-24,1880,0.008897648399894565
STAT,1846,76,na,1922,667.9882221211627
STAT,1880,27,30-34,1907,25.030768633092627
STAT,1880,18,40-44,1898,0.18132902151305758
STAT,1865,90,na,1955,67.68027751450205
STAT,1842,62,na,1904,1301.5503468747418
STAT,1826,42,15-19,1868,0.013605039480747014
STAT,1832,47,45-49,1879,0.16916902925331756
SIM,1856,74,na,1930,808
SIM,1850,18,20-24,1868,14
STAT,1773,99,na,1872,0.23919370055989486
STAT,1828,50,25-29,1878,0.0029974349087627957
SIM,1925,30,45-49,1955,2
SIM,1861,33,20-24,1894,2
SIM,1852,60,na,1912,1453
STAT,1924,20,35-39,1944,10.5597942187599
STAT,1872,53,25-29,1925,0.0033046197473300945
STAT,1913,16,na,1929,3738.827210237297
STAT,1827,29,35-39,1856,13.961728456993345
STAT,1863,43,30-34,1906,0.9478035765806518
STAT,1882,35,40-44,1917,4.062236371942358
STAT,1891,20,35-39,1911,6.864178773858387
STAT,1813,101,na,1914,0.24133236886661635
SIM,1822,94,na,1916,10
STAT,1840,41,35-39,1881,1.3324534393117218
SIM,1899,9,na,1908,3361
SIM,1930,16,na,1946,4473
SIM,1898,28,20-24,1926,17
STAT,1815,44,40-44,1859,5.755699251726825
SIM,1797,78,na,1875,313
SIM,1837,34,40-44,1871,4
STAT,1867,35,15-19,1902,0.05028216662305409
STAT,1799,92,na,1891,13.924658144508845
STAT,1839,74,na,1913,739.9760630210194
SIM,1835,29,35-39,1864,10
SIM,1899,68,na,1967,2259
SIM,1909,19,30-34,1928,3
SIM,1871,43,30-34,1914,4
STAT,1830,40,15-19,1870,0.010798470715892914
STAT,1819,86,na,1905,110.80207944729713
SIM,1823,44,40-44,1867,7
STAT,1849,38,25-29,1887,2.1016430464908917
STAT,1890,15,50-100,1905,0.05684985455791594
SIM,1857,38,25-29,1895,3
STAT,1831,27,35-39,1858,8.464102283762317
STAT,1887,47,35-39,1934,0.1472199517116265
STAT,1836,24,30-34,1860,14.632469328564873
SIM,1848,102,na,1950,1
SIM,1845,36,40-44,1881,3
SIM,1891,40,na,1931,2855
STAT,1851,28,15-19,1879,0.386757288884372
STAT,1818,69,na,1887,763.9178048220307
STAT,1918,23,15-19,1941,5.406782510740407
STAT,1834,44,15-19,1878,0.010044487770099385
SIM,1879,91,na,1970,172
SIM,1895,54,na,1949,2606
SIM,1840,31,35-39,1871,8
STAT,1869,40,20-24,1909,0.146689847069346
STAT,1814,55,na,1869,1106.5791091321762
SIM,1839,19,na,1858,2065
STAT,1884,18,50-100,1902,0.045616036744241126
STAT,1876,38,20-24,1914,0.7480457368806883
STAT,1884,48,20-24,1932,0.011061717547985093
SIM,1820,35,25-29,1855,2
STAT,1856,24,50-100,1880,0.3454075131368286
STAT,1829,34,40-44,1863,4.018585163367971
STAT,1946,11,na,1957,4116.628827426239
SIM,1832,37,45-49,1869,1
STAT,1848,54,45-49,1902,0.010167576669895474
SIM,1926,23,15-19,1949,5
STAT,1896,25,40-44,1921,3.7654317970736173
SIM,1926,43,na,1969,4186
STAT,1833,51,45-49,1884,0.00928271637133917
SIM,1844,24,30-34,1868,21
STAT,1868,27,30-34,1895,22.713495225350734
STAT,1888,32,na,1920,2663.147367047271
STAT,1838,57,na,1895,1370.6172118183576
SIM,1858,22,na,1880,1995
SIM,1873,35,50-100,1908,2
STAT,1875,45,15-19,1920,3.9208521807929466E-4
STAT,1880,30,25-29,1910,10.262969940277598
SIM,1858,39,30-34,1897,3
STAT,1851,31,45-49,1882,1.344866464707109
STAT,1872,28,35-39,1900,9.116931235863172
SIM,1886,37,40-44,1923,5
STAT,1846,46,35-39,1892,0.09899040048781586
STAT,1962,7,na,1969,4756.383054413877
SIM,1964,5,na,1969,4484
STAT,1872,19,45-49,1891,0.06160678389730713
SIM,1821,77,na,1898,471
STAT,1896,42,30-34,1938,0.09955425064419657
SIM,1872,37,na,1909,2194
STAT,1775,102,na,1877,0.07511258599418934
STAT,1857,37,20-24,1894,0.5740903072128405
STAT,1874,44,45-49,1918,1.4255477769124223
STAT,1863,88,na,1951,114.00215816959175
STAT,1891,28,45-49,1919,1.2937149448559255
STAT,1888,26,45-49,1914,1.2433618573383411
STAT,1834,43,na,1877,1548.8134464382404
SIM,1851,43,na,1894,1705
STAT,1882,47,50-100,1929,0.2247152757772415
STAT,1914,25,50-100,1939,0.9541806938099971
STAT,1807,53,45-49,1860,0.05036827754592138
STAT,1931,18,50-100,1949,0.46206230382240143
STAT,1862,22,30-34,1884,14.693837012319497
SIM,1951,20,45-49,1971,3
SIM,1951,6,na,1957,4353
SIM,1882,44,45-49,1926,2
STAT,1851,87,na,1938,129.1962645462568
SIM,1888,41,35-39,1929,3
STAT,1917,30,45-49,1947,1.569092997744872
SIM,1829,35,45-49,1864,1
SIM,1896,26,45-49,1922,2
SIM,1818,48,50-100,1866,1
STAT,1829,51,30-34,1880,0.004732932402463882
STAT,1791,103,na,1894,0.02634227448085789
SIM,1880,88,na,1968,323
STAT,1852,32,15-19,1884,0.11202550133829664
STAT,1901,15,na,1916,3355.0921938817146
STAT,1905,29,na,1934,3234.6897795640452
STAT,1869,33,50-100,1902,0.8343129244113209
STAT,1877,15,50-100,1892,0.04825071357380325
STAT,1878,37,40-44,1915,4.305066192958724
SIM,1814,41,35-39,1855,4
SIM,1949,16,20-24,1965,139
STAT,1841,42,40-44,1883,1.5991466731563364
STAT,1855,24,40-44,1879,1.6994660448246672
SIM,1880,28,35-39,1908,11
STAT,1822,42,na,1864,1423.7040021683922
STAT,1826,56,na,1882,1192.2420449634453
STAT,1859,16,25-29,1875,4.988611412865737
STAT,1856,45,40-44,1901,0.12793269493227255
STAT,1845,34,25-29,1879,8.401996618457527
STAT,1848,51,40-44,1899,0.0076206547605922464
SIM,1793,64,na,1857,741
SIM,1878,27,40-44,1905,4
STAT,1897,68,na,1965,2166.543740088071
STAT,1863,34,40-44,1897,3.570435667214798
SIM,1906,30,35-39,1936,8
STAT,1842,18,20-24,1860,16.116299700093844
STAT,1893,54,na,1947,2509.919180250786
STAT,1895,30,20-24,1925,3.3591159881077717
SIM,1867,16,25-29,1883,6
SIM,1881,32,35-39,1913,8
STAT,1868,47,25-29,1915,0.051711665033432046
STAT,1873,32,35-39,1905,9.710927928383887
STAT,1880,38,35-39,1918,6.995601641794241
STAT,1814,51,35-39,1865,0.022791366110582214
SIM,1930,3,na,1933,4897
STAT,1881,42,35-39,1923,1.6496893427608552
STAT,1853,44,25-29,1897,0.46980049281322417
STAT,1850,110,na,1960,4.6087786133196804E-4
SIM,1898,39,25-29,1937,1
STAT,1831,52,25-29,1883,0.002290916334822907
STAT,1889,17,na,1906,2945.543725251471
STAT,1900,45,25-29,1945,0.04300715244512843
STAT,1842,19,na,1861,2074.404266901685
SIM,1853,34,25-29,1887,11
SIM,1891,31,40-44,1922,6
SIM,1894,32,20-24,1926,5
STAT,1877,16,na,1893,2481.9754088928403
STAT,1924,32,na,1956,4168.797306706316
STAT,1835,37,20-24,1872,0.5946071613780409
STAT,1830,47,35-39,1877,0.10260937930893752
SIM,1850,26,20-24,1876,8
SIM,1837,71,na,1908,800
STAT,1809,46,30-34,1855,0.3596788065902596
SIM,1848,9,na,1857,2237
STAT,1896,17,40-44,1913,0.22836035951421368
SIM,1861,28,25-29,1889,43
STAT,1833,48,15-19,1881,2.5614157109110614E-4
STAT,1847,106,na,1953,0.0089337182152874
STAT,1899,18,20-24,1917,22.891462399907777
STAT,1916,13,na,1929,3952.086569191422
STAT,1901,49,35-39,1950,0.10224291804436374
SIM,1852,34,30-34,1886,12
STAT,1919,35,25-29,1954,1.0048437565321549
STAT,1853,28,25-29,1881,32.83374839608781
SIM,1866,73,na,1939,963
STAT,1839,53,40-44,1892,0.006906836720180931
SIM,1858,18,25-29,1876,5
STAT,1863,51,30-34,1914,0.004966728705050534
STAT,1846,30,25-29,1876,8.713430492499562
STAT,1896,36,45-49,1932,2.5009117286151903
STAT,1893,49,25-29,1942,0.03813133780911471
STAT,1844,22,15-19,1866,2.8916084602893326
SIM,1879,43,35-39,1922,2
STAT,1814,52,25-29,1866,0.009191127849662261
SIM,1923,46,na,1969,3989
SIM,1857,3,na,1860,2551
SIM,1835,37,35-39,1872,10
STAT,1883,50,45-49,1933,0.013629655984479594
SIM,1858,54,na,1912,1691
STAT,1895,38,30-34,1933,6.537713656819538
STAT,1952,15,15-19,1967,51.407238316514174
STAT,1869,72,na,1941,1154.8375677517497
SIM,1824,40,40-44,1864,5
STAT,1850,27,45-49,1877,0.9198528448763326
SIM,1852,22,15-19,1874,3
SIM,1895,38,45-49,1933,4
STAT,1869,47,40-44,1916,0.15582172743057845
SIM,1874,17,na,1891,2417
SIM,1963,4,na,1967,4682
STAT,1829,45,45-49,1874,0.1954711690848639
SIM,1854,38,35-39,1892,10
SIM,1865,7,na,1872,2429
STAT,1907,49,50-100,1956,0.18921637499499847
STAT,1946,17,40-44,1963,1.4656087615337372
STAT,1842,26,20-24,1868,10.405825113628133
STAT,1922,20,na,1942,3980.0549183873754
STAT,1864,34,35-39,1898,8.477185804766917
SIM,1847,40,35-39,1887,1
STAT,1841,77,na,1918,591.4098268973967
STAT,1883,31,40-44,1914,4.0316319207590325
STAT,1836,35,35-39,1871,5.597375299693349
STAT,1875,32,45-49,1907,1.6924457422375034
STAT,1893,41,15-19,1934,0.016627579900568047
SIM,1845,32,25-29,1877,10
STAT,1894,71,na,1965,1880.4988144991573
SIM,1927,15,30-34,1942,22
STAT,1887,38,45-49,1925,2.0956654594238393
STAT,1851,24,20-24,1875,59.484756194585636
STAT,1859,51,na,1910,1631.0929707472835
SIM,1831,30,30-34,1861,20
STAT,1827,41,na,1868,1506.8904929956957
STAT,1890,21,30-34,1911,20.635781898831386
SIM,1882,33,40-44,1915,4
SIM,1854,30,25-29,1884,14
SIM,1919,16,35-39,1935,4
STAT,1870,40,50-100,1910,0.9877929008429227
STAT,1910,27,40-44,1937,4.250749371400259
SIM,1798,63,na,1861,858
STAT,1827,37,35-39,1864,7.068722146753312
STAT,1816,89,na,1905,48.95458356874506
STAT,1844,34,30-34,1878,14.355929841205338
STAT,1834,27,25-29,1861,34.33480447650029
SIM,1877,36,na,1913,2334
STAT,1849,39,15-19,1888,0.04056607556867606
SIM,1842,27,25-29,1869,34
SIM,1843,36,30-34,1879,5
STAT,1870,41,20-24,1911,0.14767355657363504
STAT,1894,28,35-39,1922,11.684299339081537
STAT,1847,17,45-49,1864,0.05998805812661017
STAT,1839,40,35-39,1879,1.4346978276528861
STAT,1880,26,40-44,1906,2.9878040833196717
STAT,1837,32,25-29,1869,8.106875859777382
STAT,1844,10,na,1854,2157.0
SIM,1861,20,15-19,1881,3
SIM,1895,39,35-39,1934,17
STAT,1821,42,15-19,1863,0.023049095267483916
STAT,1841,88,na,1929,93.92827631386481
SIM,1954,17,40-44,1971,1
SIM,1844,35,35-39,1879,17
STAT,1809,47,20-24,1856,0.0437736044188002
SIM,1821,35,40-44,1856,8
SIM,1863,35,45-49,1898,2
STAT,1874,52,45-49,1926,0.01393759925518728
SIM,1838,42,35-39,1880,3
STAT,1899,16,na,1915,3277.7141185394935
SIM,1861,27,35-39,1888,6
STAT,1857,40,50-100,1897,0.7947323923068154
SIM,1815,42,40-44,1857,6
STAT,1853,27,35-39,1880,8.289583117590283
STAT,1812,52,50-100,1864,0.04752867760802417
STAT,1855,52,35-39,1907,0.006064793656267586
STAT,1847,22,40-44,1869,1.8796064226009503
STAT,1835,28,50-100,1863,0.5164440489989088
SIM,1883,32,45-49,1915,2
STAT,1884,50,na,1934,2038.9530794151444
SIM,1884,37,30-34,1921,4
STAT,1885,23,15-19,1908,3.0953789558240126
STAT,1826,40,50-100,1866,1.0804200806834356
STAT,1939,20,30-34,1959,27.283724272906046
SIM,1794,81,na,1875,176
STAT,1888,64,na,1952,1940.02564243681
STAT,1860,59,na,1919,1492.113400468145
STAT,1871,51,50-100,1922,0.014212056644492427
STAT,1870,36,25-29,1906,2.6780126685580266
STAT,1853,42,50-100,1895,0.7825084109969727
STAT,1862,39,na,1901,1879.4276185519584
SIM,1798,95,na,1893,3
SIM,1819,74,na,1893,511
STAT,1853,20,15-19,1873,2.9327021246192015
STAT,1887,39,35-39,1926,7.397309381987027
SIM,1862,37,30-34,1899,5
STAT,1783,77,na,1860,266.70900157243875
STAT,1937,31,25-29,1968,8.642303350687243
STAT,1886,32,20-24,1918,2.6979882163448843
STAT,1870,24,30-34,1894,16.38506752985001
STAT,1825,34,20-24,1859,3.9666900444524327
SIM,1850,30,40-44,1880,2
STAT,1926,42,50-100,1968,0.13683429123156074
STAT,1898,38,20-24,1936,0.21171710174491934
STAT,1781,86,na,1867,61.792819476060814
STAT,1844,21,na,1865,1887.6311980790842
STAT,1853,33,20-24,1886,2.0430080817287455
SIM,1815,60,na,1875,983
SIM,1893,23,15-19,1916,4
SIM,1898,8,na,1906,3287
STAT,1870,69,na,1939,1358.4601402146038
SIM,1859,27,30-34,1886,21
SIM,1895,31,25-29,1926,18
STAT,1890,40,35-39,1930,2.1126432151664867
STAT,1890,48,45-49,1938,0.15182939890856603
STAT,1831,26,45-49,1857,1.0031269761957995
SIM,1896,28,na,1924,3021
STAT,1920,41,35-39,1961,0.2104103188579907
STAT,1834,54,50-100,1888,0.009213233995538613
STAT,1876,37,30-34,1913,5.197699503279408
STAT,1799,81,na,1880,212.49451582478213
STAT,1829,26,40-44,1855,5.490112405880165
SIM,1894,16,na,1910,3221
STAT,1855,53,25-29,1908,0.002468305839981305
STAT,1841,21,35-39,1862,5.094389618451381
STAT,1906,38,30-34,1944,1.5745728116965318
SIM,1882,20,35-39,1902,8
STAT,1855,35,45-49,1890,1.4252692406777137
STAT,1885,29,50-100,1914,0.5977621996218554
STAT,1838,44,35-39,1882,1.2811126850033727
SIM,1847,70,na,1917,1006
SIM,1892,19,15-19,1911,8
STAT,1862,53,50-100,1915,0.011974958622454873
STAT,1876,41,50-100,1917,1.0349723167128446
STAT,1909,43,na,1952,3261.1078474006595
STAT,1819,41,20-24,1860,0.32268819977134006
STAT,1848,35,na,1883,1785.806675818751
SIM,1927,28,na,1955,4188
SIM,1914,38,30-34,1952,8
SIM,1815,81,na,1896,201
STAT,1887,31,25-29,1918,10.86549843982095
STAT,1903,19,50-100,1922,0.06549358202574679
STAT,1822,50,30-34,1872,0.008315597136238074
STAT,1892,25,20-24,1917,13.972542031323668
STAT,1855,41,30-34,1896,0.8179215721403185
SIM,1923,14,na,1937,4286
SIM,1928,27,40-44,1955,6
STAT,1821,45,50-100,1866,0.3861847997544846
STAT,1863,18,40-44,1881,0.15678795262402292
STAT,1866,19,20-24,1885,15.663143341722302
STAT,1882,51,40-44,1933,0.009723845905892883
STAT,1846,37,45-49,1883,1.4677917097815534
STAT,1875,28,25-29,1903,40.91062327657788
STAT,1911,43,35-39,1954,0.1804335491072923
STAT,1906,14,na,1920,3541.0220800460384
STAT,1911,38,50-100,1949,0.38111135601709956
STAT,1845,31,20-24,1876,2.287475089542424
STAT,1920,49,45-49,1969,0.22564244402373743
SIM,1947,20,30-34,1967,35
SIM,1880,24,40-44,1904,2
STAT,1879,71,na,1950,1318.0249485887182
SIM,1904,32,na,1936,3197
STAT,1846,18,40-44,1864,0.1610455120613428
STAT,1863,46,35-39,1909,0.1165879796254899
STAT,1832,51,50-100,1883,0.009714953764663109
STAT,1862,31,20-24,1893,2.1871286116117767
SIM,1864,18,na,1882,2297
SIM,1908,46,na,1954,3081
STAT,1875,7,na,1882,2620.9011078796
STAT,1894,21,15-19,1915,4.021144491675136
SIM,1862,91,na,1953,50
STAT,1861,26,30-34,1887,20.042035913158724
STAT,1845,50,25-29,1895,0.0025307809691991856
STAT,1887,44,30-34,1931,1.1982253947983281
STAT,1941,20,35-39,1961,9.198049906420827
STAT,1795,100,na,1895,0.20508837587990134
STAT,1919,40,20-24,1959,0.018129929949361096
SIM,1939,20,45-49,1959,2
SIM,1905,17,na,1922,3448
SIM,1846,44,35-39,1890,3
STAT,1898,53,na,1951,2709.39222911046
STAT,1831,78,na,1909,476.50750756336276
STAT,1892,42,50-100,1934,1.2482510570493233
SIM,1885,21,15-19,1906,2
SIM,1841,22,na,1863,1911
STAT,1892,5,na,1897,3100.2331514617185
SIM,1876,38,35-39,1914,13
SIM,1855,22,40-44,1877,5
STAT,1884,1,na,1885,3103.2253003062633
SIM,1864,32,35-39,1896,11
STAT,1811,44,20-24,1855,0.5601191537244609
SIM,1845,36,na,1881,1747
SIM,1804,97,na,1901,7
STAT,1880,68,na,1948,1519.0259514459026
SIM,1872,31,30-34,1903,17
STAT,1865,30,35-39,1895,8.763407312939902
STAT,1867,3,na,1870,2815.3304890257414
SIM,1885,17,30-34,1902,4
SIM,1874,19,20-24,1893,19
STAT,1830,93,na,1923,17.457832037358568
STAT,1838,20,50-100,1858,0.3660817980376002
SIM,1853,31,20-24,1884,1
STAT,1828,49,45-49,1877,0.1935993253679798
SIM,1780,78,na,1858,297
SIM,1955,16,45-49,1971,1
SIM,1860,16,15-19,1876,8
STAT,1855,50,50-100,1905,0.010850033512671426
STAT,1827,43,20-24,1870,0.14355776004822293
STAT,1872,20,25-29,1892,54.60428883072541
STAT,1867,30,50-100,1897,0.8192429273654899
STAT,1873,41,25-29,1914,0.6185559391641162
STAT,1842,33,45-49,1875,1.4846261531209024
STAT,1899,27,na,1926,3089.6251351635074
STAT,1897,33,35-39,1930,12.74069721876717
STAT,1901,29,40-44,1930,3.932685091876103
STAT,1868,39,25-29,1907,2.57083238357678
STAT,1771,97,na,1868,0.6301140932616531
STAT,1855,16,40-44,1871,0.1549862017070302
SIM,1861,21,na,1882,2114
STAT,1894,34,20-24,1928,3.2566885100260006
SIM,1876,39,25-29,1915,2
STAT,1900,37,25-29,1937,0.8144650959768281
STAT,1886,20,na,1906,2374.696890614442
STAT,1807,96,na,1903,3.0801613006356723
STAT,1947,16,45-49,1963,0.5317722758869706
SIM,1839,18,15-19,1857,4
STAT,1936,27,50-100,1963,0.8997246747225929
SIM,1881,73,na,1954,948
STAT,1766,97,na,1863,0.8441760590964711
STAT,1871,21,20-24,1892,64.73439546754597
STAT,1806,50,25-29,1856,0.010410865271044628
STAT,1888,18,45-49,1906,0.07270957936511378
STAT,1835,36,30-34,1871,4.153969322853023
STAT,1892,37,15-19,1929,0.06643122769412654
STAT,1895,34,na,1929,2916.656864309658
STAT,1945,25,25-29,1970,68.27671447034426
STAT,1852,40,15-19,1892,0.010598198016182923
STAT,1936,15,30-34,1951,11.07335770089163
SIM,1896,23,40-44,1919,3
STAT,1899,48,na,1947,2876.6110621309995
SIM,1939,21,35-39,1960,11
STAT,1827,38,25-29,1865,2.8070157102152336
SIM,1829,32,40-44,1861,10
STAT,1924,20,50-100,1944,0.7379311987919833
STAT,1941,12,na,1953,3832.9755181670694
SIM,1844,20,15-19,1864,2
STAT,1852,36,30-34,1888,4.113732199000034
SIM,1830,29,35-39,1859,13
STAT,1837,47,45-49,1884,0.15465068611209215
STAT,1955,15,40-44,1970,1.7549149553101915
SIM,1844,16,30-34,1860,1
SIM,1865,41,40-44,1906,4
STAT,1816,40,40-44,1856,7.280646727511411
STAT,1945,26,na,1971,3884.3277256935694
STAT,1842,46,15-19,1888,2.885658328474648E-4
STAT,1894,29,25-29,1923,51.03813873597556
SIM,1751,104,na,1855,1
SIM,1899,16,20-24,1915,27
STAT,1909,25,15-19,1934,0.6469626029586999
SIM,1818,38,25-29,1856,1
STAT,1802,97,na,1899,1.8326736602002385
STAT,1968,4,na,1972,4639.280908282801
STAT,1868,38,35-39,1906,6.3479698453717575
SIM,1914,6,na,1920,4203
STAT,1774,103,na,1877,0.048461378297773985
STAT,1856,32,35-39,1888,7.584694003075611
SIM,1855,42,35-39,1897,2
STAT,1900,42,20-24,1942,0.014435783349381138
STAT,1817,48,30-34,1865,0.2131819757378728
SIM,1860,36,30-34,1896,5
STAT,1879,45,35-39,1924,0.13961868995964952
SIM,1779,81,na,1860,154
STAT,1846,38,35-39,1884,5.153951511880426
STAT,1919,15,30-34,1934,2.5648001885512652
STAT,1837,28,40-44,1865,2.409700286404767
STAT,1888,21,50-100,1909,0.45647221898386153
STAT,1970,0,na,1970,4683.400890437924
SIM,1849,18,na,1867,2052
SIM,1891,27,20-24,1918,17
SIM,1827,93,na,1920,7
STAT,1901,48,50-100,1949,0.18088635306025636
STAT,1915,36,50-100,1951,0.40257218444251225
SIM,1828,28,40-44,1856,6
SIM,1854,37,45-49,1891,1
STAT,1864,50,35-39,1914,0.00737317592060149
SIM,1826,44,na,1870,1465
STAT,1874,49,15-19,1923,3.7814846958254567E-4
STAT,1836,48,40-44,1884,0.11169988297050414
STAT,1827,30,15-19,1857,0.18125473258453698
SIM,1835,38,25-29,1873,2
SIM,1885,29,25-29,1914,38
STAT,1866,21,na,1887,2091.769863793689
SIM,1845,28,40-44,1873,2
STAT,1898,45,45-49,1943,0.17193935495500962
SIM,1875,30,45-49,1905,1
STAT,1826,88,na,1914,74.93173649085037
STAT,1862,25,35-39,1887,7.91742162424523
SIM,1908,15,20-24,1923,23
STAT,1888,23,40-44,1911,2.3183658698282517
STAT,1861,27,20-24,1888,9.269911855571602
SIM,1912,51,na,1963,3159
STAT,1846,43,30-34,1889,0.8099687371576595
STAT,1847,42,35-39,1889,1.3398072761687891
STAT,1877,29,25-29,1906,41.172415783782796
SIM,1886,33,25-29,1919,11
SIM,1870,25,35-39,1895,10
SIM,1932,28,na,1960,4497
STAT,1926,25,15-19,1951,0.8049858641550643
STAT,1893,17,15-19,1910,7.113247602348423
STAT,1878,33,25-29,1911,10.030606540853254
STAT,1883,27,20-24,1910,10.861764922852602
STAT,1887,19,40-44,1906,0.19220015774992907
SIM,1944,15,30-34,1959,16
SIM,1886,38,30-34,1924,5
STAT,1893,20,45-49,1913,0.8408077878183235
STAT,1936,12,na,1948,3583.02181669091
SIM,1835,34,30-34,1869,16
STAT,1847,38,15-19,1885,0.04242631294845825
STAT,1821,37,40-44,1858,9.157275082096598
STAT,1860,109,na,1969,0.007035542988984642
STAT,1896,21,25-29,1917,71.6887731758583
STAT,1880,51,30-34,1931,0.005945134567862761
STAT,1850,48,15-19,1898,2.7806236743385405E-4
STAT,1928,16,35-39,1944,5.007604471263175
SIM,1880,38,50-100,1918,3
SIM,1908,22,45-49,1930,4
STAT,1849,73,na,1922,856.1212230289243
STAT,1922,20,25-29,1942,100.6724341501571
SIM,1879,40,30-34,1919,1
SIM,1841,27,45-49,1868,1
STAT,1829,29,45-49,1858,1.215393047512743
SIM,1886,72,na,1958,1353
STAT,1776,96,na,1872,1.2701582915387009
STAT,1772,82,na,1854,131.0
SIM,1949,20,40-44,1969,3
STAT,1861,22,15-19,1883,2.658760684591441
SIM,1891,34,45-49,1925,2
STAT,1844,18,30-34,1862,1.4139502338780192
STAT,1865,43,40-44,1908,1.9169309853593606
STAT,1794,101,na,1895,0.10252785741599756
STAT,1834,24,20-24,1858,56.232647338867636
SIM,1933,13,na,1946,5023
STAT,1772,104,na,1876,0.027484928253037628
SIM,1852,37,35-39,1889,12
STAT,1825,43,50-100,1868,1.1541862999086439
SIM,1853,25,35-39,1878,9
STAT,1833,27,45-49,1860,0.8938829691574659
SIM,1923,30,35-39,1953,12
STAT,1863,27,50-100,1890,0.531209248737348
STAT,1878,30,20-24,1908,2.6796979802099394
STAT,1902,32,na,1934,3181.3061683844744
STAT,1879,50,na,1929,2156.659904824874
SIM,1897,31,35-39,1928,18
STAT,1889,48,20-24,1937,0.007795300143499089
SIM,1860,36,na,1896,1985
SIM,1858,15,20-24,1873,12
STAT,1823,33,35-39,1856,23.180759107555684
SIM,1837,30,25-29,1867,12
STAT,1820,50,20-24,1870,0.0012171023640951584
STAT,1868,44,20-24,1912,0.1413121592385705
STAT,1894,25,30-34,1919,30.809165816540933
STAT,1905,16,40-44,1921,0.2503043472063418
SIM,1852,18,30-34,1870,1
STAT,1828,42,25-29,1870,0.566466857917579
STAT,1906,46,na,1952,3104.265410961372
STAT,1844,37,35-39,1881,5.24691033495733
STAT,1883,34,45-49,1917,1.6007245040713391
STAT,1934,2,na,1936,5225.861551987706
SIM,1833,78,na,1911,444
STAT,1857,17,na,1874,2009.2898118490423
STAT,1895,33,25-29,1928,12.573794155399122
STAT,1895,42,15-19,1937,0.0011807783900450754
STAT,1878,86,na,1964,411.3462965660682
STAT,1857,41,40-44,1898,1.6827295844836352
STAT,1922,38,15-19,1960,0.02062306585768936
SIM,1930,20,25-29,1950,123
SIM,1939,17,15-19,1956,39
SIM,1831,33,35-39,1864,13
STAT,1876,8,na,1884,2606.0022306164105
STAT,1816,43,45-49,1859,4.290817782308464
STAT,1810,103,na,1913,0.0649903219743589
STAT,1829,30,25-29,1859,10.545906317596732
SIM,1837,38,35-39,1875,14
STAT,1851,20,50-100,1871,0.36229526397592127
STAT,1885,47,25-29,1932,0.05395919185310533
STAT,1904,16,50-100,1920,0.06653834851651984
STAT,1874,72,na,1946,1219.3648517354418
STAT,1831,23,40-44,1854,4.203810979714701
SIM,1937,27,na,1964,3320
STAT,1836,77,na,1913,545.8541577191784
STAT,1864,31,30-34,1895,14.801670129371807
SIM,1871,8,na,1879,2603
STAT,1833,110,na,1943,1.6776210080887008E-4
STAT,1915,30,35-39,1945,8.862179776872164
SIM,1824,43,45-49,1867,7
STAT,1858,49,30-34,1907,0.07029083164768439
STAT,1825,46,15-19,1871,4.25235443294098E-4
STAT,1917,15,20-24,1932,27.688038398260932
SIM,1801,57,na,1858,1039
STAT,1893,46,20-24,1939,0.008136466875854845
STAT,1872,38,50-100,1910,1.1583743423685717
STAT,1897,32,50-100,1929,1.1575987110899097
SIM,1846,35,45-49,1881,3
STAT,1896,29,35-39,1925,11.960895798205732
SIM,1852,92,na,1944,25
STAT,1866,50,45-49,1916,0.012821797816916048
STAT,1877,49,40-44,1926,0.16432609855376132
SIM,1836,22,na,1858,1768
STAT,1844,46,25-29,1890,0.04055053298833646
STAT,1829,38,35-39,1867,6.198928060014284
STAT,1835,32,15-19,1867,0.11312124394081263
SIM,1830,26,30-34,1856,27
SIM,1827,35,35-39,1862,12
STAT,1852,16,15-19,1868,5.485663380408267
STAT,1925,38,40-44,1963,1.695842022802345
STAT,1938,15,40-44,1953,1.3093440579917186
STAT,1886,26,35-39,1912,9.663878984851412
STAT,1858,45,15-19,1903,2.996090854049275E-4
STAT,1854,36,40-44,1890,3.167386282220638
STAT,1875,29,15-19,1904,0.4371884051236745
SIM,1857,42,45-49,1899,1
SIM,1868,32,na,1900,2163
STAT,1831,32,30-34,1863,14.32564029422287
STAT,1885,19,30-34,1904,1.4920722035127234
SIM,1850,33,45-49,1883,2
STAT,1812,51,25-29,1863,0.01137228027326368
SIM,1842,24,20-24,1866,63
SIM,1897,13,na,1910,3306
SIM,1806,56,na,1862,1082
STAT,1902,45,50-100,1947,0.18653412418636506
STAT,1838,41,30-34,1879,0.9288312522622469
STAT,1859,83,na,1942,299.2982397075615
STAT,1948,20,45-49,1968,1.2213945588744417
STAT,1931,13,na,1944,4891.9059899150325
STAT,1935,27,na,1962,4823.8268158709
STAT,1874,28,45-49,1902,1.0682591188558195
SIM,1861,24,30-34,1885,17
STAT,1822,45,35-39,1867,0.2009687269555042
SIM,1878,39,35-39,1917,11
SIM,1869,17,na,1886,2348
SIM,1873,54,na,1927,2011
STAT,1838,16,40-44,1854,0.16575308364421437
STAT,1928,25,25-29,1953,77.13244462923146
SIM,1838,33,50-100,1871,3
STAT,1915,50,na,1965,3465.3518385317107
SIM,1833,89,na,1922,47
SIM,1837,29,45-49,1866,3
SIM,1877,68,na,1945,1454
SIM,1862,32,25-29,1894,12
STAT,1804,56,na,1860,1085.1132546464287
SIM,1862,36,40-44,1898,5
STAT,1819,35,35-39,1854,21.48845279937813
SIM,1840,40,25-29,1880,3
SIM,1835,37,na,1872,1652
STAT,1903,41,35-39,1944,0.16977233841881165
SIM,1936,16,35-39,1952,2
STAT,1888,39,15-19,1927,0.0620383249775753
SIM,1831,23,na,1854,1716
STAT,1850,92,na,1942,29.32128384670139
SIM,1828,44,40-44,1872,8
STAT,1853,24,30-34,1877,15.384526489800816
SIM,1860,25,na,1885,2054
SIM,1848,29,20-24,1877,15
STAT,1843,33,50-100,1876,0.786476240130536
SIM,1857,91,na,1948,35
SIM,1901,27,40-44,1928,3
SIM,1936,25,25-29,1961,46
STAT,1849,42,45-49,1891,1.0774363787331764
STAT,1864,22,40-44,1886,1.7876745538331678
STAT,1885,28,20-24,1913,11.002534091057768
STAT,1887,35,40-44,1922,4.668738944316758
STAT,1840,17,35-39,1857,0.4947545771180198
STAT,1931,31,30-34,1962,19.51439880828465
SIM,1893,28,20-24,1921,15
SIM,1895,35,40-44,1930,10
STAT,1861,51,20-24,1912,5.816502586128273E-4
STAT,1808,59,na,1867,1057.9882342194437
STAT,1818,37,20-24,1855,2.6124991347556072
STAT,1860,47,20-24,1907,0.009170164410722794
STAT,1854,32,25-29,1886,7.553100901335099
STAT,1854,53,50-100,1907,0.010700786466279321
SIM,1873,43,40-44,1916,5
STAT,1832,40,25-29,1872,0.48888706827592615
SIM,1851,33,50-100,1884,4
SIM,1863,104,na,1967,1
SIM,1872,22,40-44,1894,1
SIM,1894,26,35-39,1920,17
SIM,1848,55,na,1903,1513
STAT,1921,35,na,1956,3975.6840040219568
SIM,1818,89,na,1907,40
STAT,1859,38,50-100,1897,0.9210343026426305
STAT,1852,45,20-24,1897,0.009208163767929075
STAT,1837,37,30-34,1874,4.096246067543343
STAT,1903,49,45-49,1952,0.17518682402557845
STAT,1842,30,40-44,1872,3.8089451776689596
STAT,1860,21,45-49,1881,0.5558868013265682
SIM,1805,82,na,1887,152
SIM,1909,23,15-19,1932,5
STAT,1875,25,20-24,1900,11.46306467812546
SIM,1870,38,40-44,1908,3
STAT,1922,44,50-100,1966,0.12697072265174464
STAT,1848,105,na,1953,0.021123301419906378
SIM,1947,23,35-39,1970,12
STAT,1909,16,25-29,1925,8.045800296830004
STAT,1866,47,15-19,1913,3.4677108377535347E-4
STAT,1871,40,25-29,1911,0.6074763886139342
STAT,1860,38,30-34,1898,4.071539398040572
STAT,1825,37,25-29,1862,3.6870160185847665
STAT,1920,50,na,1970,3802.0609050633775
SIM,1861,40,45-49,1901,3
SIM,1877,18,35-39,1895,2
STAT,1855,44,35-39,1899,1.2651738034931606
SIM,1856,30,35-39,1886,11
STAT,1791,96,na,1887,1.5151931017791358
STAT,1869,18,35-39,1887,0.5057116687447015
STAT,1884,35,15-19,1919,0.05292037681827496
STAT,1847,31,50-100,1878,0.7998155010137076
SIM,1854,34,40-44,1888,4
STAT,1834,28,15-19,1862,0.36561276573830864
STAT,1932,28,30-34,1960,48.460404000590366
STAT,1892,28,25-29,1920,49.866717087485746
STAT,1916,42,45-49,1958,0.16111526395372555
STAT,1846,34,40-44,1880,3.539170047213357
SIM,1940,28,30-34,1968,43
STAT,1919,29,50-100,1948,1.0087250281494105
SIM,1917,16,25-29,1933,10
SIM,1904,30,25-29,1934,16
STAT,1924,6,na,1930,4509.397124586768
SIM,1774,82,na,1856,115
STAT,1822,74,na,1896,573.2423587487814
SIM,1778,96,na,1874,2
SIM,1878,31,25-29,1909,12
SIM,1845,37,30-34,1882,4
STAT,1872,17,na,1889,2402.662901916196
STAT,1889,39,45-49,1928,2.3015481724287077
SIM,1868,36,35-39,1904,9
STAT,1850,32,40-44,1882,3.193805152575954
STAT,1890,15,45-49,1905,0.07579980607722127
STAT,1852,40,na,1892,1773.7348942401518
SIM,1890,22,35-39,1912,13
STAT,1944,17,30-34,1961,12.391274004944423
STAT,1862,34,25-29,1896,8.183211657289531
STAT,1908,40,45-49,1948,0.14707805590616482
STAT,1832,27,15-19,1859,0.3724985875754329
SIM,1876,35,30-34,1911,6
SIM,1952,17,30-34,1969,17
STAT,1838,35,45-49,1873,1.6750358242082835
SIM,1837,92,na,1929,16
SIM,1898,43,45-49,1941,1
STAT,1897,30,30-34,1927,22.2361876287363
STAT,1838,47,50-100,1885,0.17233224459637334
STAT,1859,29,30-34,1888,19.036618090321497
STAT,1870,27,35-39,1897,8.931718687489202
SIM,1867,29,30-34,1896,27
STAT,1842,36,50-100,1878,1.0363145225841779
STAT,1828,46,40-44,1874,0.14612180699294694
SIM,1846,41,30-34,1887,6
STAT,1870,58,na,1928,1830.6016553998215
STAT,1811,47,25-29,1858,0.1917816502376719
STAT,1907,22,50-100,1929,0.5657957526662146
STAT,1791,85,na,1876,82.91735887383011
SIM,1883,25,20-24,1908,9
SIM,1817,42,50-100,1859,2
SIM,1877,27,25-29,1904,43
STAT,1848,47,20-24,1895,0.008604778909063929
STAT,1875,44,50-100,1919,1.0114867400074536
STAT,1901,47,na,1948,2961.6163455069895
STAT,1939,23,35-39,1962,8.929303744670042
SIM,1853,55,na,1908,1647
SIM,1857,69,na,1926,1168
STAT,1895,37,40-44,1932,5.396584535059042
SIM,1885,26,20-24,1911,13
STAT,1871,48,35-39,1919,0.1294686053520884
STAT,1880,31,15-19,1911,0.14213147837389783
STAT,1882,22,35-39,1904,5.364265464486246
SIM,1947,7,na,1954,4013
STAT,1821,89,na,1910,56.728763321120276
SIM,1899,19,25-29,1918,4
STAT,1868,35,30-34,1903,4.852810908590731
SIM,1840,59,na,1899,1334
SIM,1825,59,na,1884,1080
STAT,1885,35,na,1920,2238.455972543806
STAT,1851,55,na,1906,1516.2883444167771
SIM,1855,25,na,1880,2010
SIM,1821,45,na,1866,1403
STAT,1881,21,na,1902,2163.7778140238484
STAT,1857,44,45-49,1901,1.0995786040080984
SIM,1832,42,40-44,1874,4
STAT,1855,69,na,1924,1039.3682196227987
STAT,1837,40,na,1877,1606.7284447352642
SIM,1851,11,na,1862,2186
SIM,1897,39,45-49,1936,4
STAT,1898,42,40-44,1940,0.19949959511900484
STAT,1766,113,na,1879,4.452215758310961E-4
STAT,1855,19,45-49,1874,0.05437987757758436
STAT,1900,18,50-100,1918,0.06404001752945596
STAT,1911,48,40-44,1959,0.14058100686607014
SIM,1854,40,na,1894,1816
SIM,1872,69,na,1941,1349
STAT,1877,17,30-34,1894,1.562497277190683
STAT,1877,26,20-24,1903,11.540007705095151
STAT,1806,54,40-44,1860,0.02855462650980413
STAT,1872,52,35-39,1924,0.008119673241196055
SIM,1880,33,30-34,1913,22
STAT,1840,42,25-29,1882,0.4665040683726195
STAT,1881,22,50-100,1903,0.3719635656336839
STAT,1936,18,35-39,1954,3.7845680073149723
SIM,1846,47,50-100,1893,3
STAT,1940,27,na,1967,3608.413527156738
SIM,1823,31,35-39,1854,8
SIM,1850,36,50-100,1886,3
STAT,1890,57,na,1947,2321.1780923136153
STAT,1888,48,50-100,1936,0.15266807736507565
STAT,1847,51,25-29,1898,0.0026186426083508567
SIM,1900,29,na,1929,3067
STAT,1836,19,35-39,1855,0.6521956420317327
STAT,1889,49,na,1938,2569.618403427145
STAT,1867,27,15-19,1894,0.4024343713921154
STAT,1891,33,40-44,1924,5.049552351415004
STAT,1858,17,20-24,1875,15.35861550240544
SIM,1883,21,na,1904,2262
STAT,1905,41,30-34,1946,0.10948076396803313
STAT,1831,51,35-39,1882,0.005679591428621049
STAT,1889,31,35-39,1920,11.859180444433994
STAT,1872,33,30-34,1905,16.48548073840997
STAT,1896,35,50-100,1931,1.5474342980647047
STAT,1881,43,25-29,1924,0.581508418278107
SIM,1928,26,50-100,1954,1
STAT,1824,42,40-44,1866,2.8452797055967363
STAT,1878,38,30-34,1916,5.215389448709974
STAT,1934,30,45-49,1964,2.031889674787285
SIM,1896,27,35-39,1923,13
STAT,1862,43,15-19,1905,0.011048093470424044
STAT,1851,27,25-29,1878,36.320492986317134
STAT,1860,18,15-19,1878,5.223933133824225
STAT,1817,44,15-19,1861,0.03220434064477931
STAT,1862,38,40-44,1900,3.5100606915614976
SIM,1887,35,na,1922,2465
STAT,1852,48,25-29,1900,0.04321300463021059
SIM,1887,36,45-49,1923,1
SIM,1905,1,na,1906,3639
SIM,1860,39,35-39,1899,10
STAT,1823,59,na,1882,1104.6529789386784
SIM,1842,31,45-49,1873,1
STAT,1827,34,30-34,1861,18.658649593970203
SIM,1891,72,na,1963,1670
SIM,1907,4,na,1911,3708
STAT,1852,39,35-39,1891,5.319725137546672
SIM,1887,42,30-34,1929,1
STAT,1803,82,na,1885,167.65683014201332
STAT,1883,0,na,1883,3279.436594144962
STAT,1846,34,50-100,1880,0.7477428643526638
STAT,1911,40,30-34,1951,0.11655338518000903
STAT,1879,42,50-100,1921,1.0418901673612448
SIM,1790,67,na,1857,649
SIM,1865,44,45-49,1909,1
SIM,1820,60,na,1880,1038
SIM,1824,74,na,1898,626
STAT,1835,92,na,1927,25.986309253702085
STAT,1853,52,25-29,1905,0.002612800778604618
SIM,1913,5,na,1918,3747
SIM,1829,36,35-39,1865,11
STAT,1868,31,15-19,1899,0.12897337284119595
SIM,1903,47,na,1950,3028
STAT,1879,42,30-34,1921,1.1338216552047078
STAT,1834,31,45-49,1865,1.397077894055619
STAT,1879,36,45-49,1915,1.9779069010250263
STAT,1923,41,50-100,1964,0.12991422048406825
STAT,1918,5,na,1923,4134.235192510803
STAT,1913,43,45-49,1956,0.15304623221019686
SIM,1845,58,na,1903,1393
STAT,1888,27,35-39,1915,10.768302129619798
STAT,1820,40,na,1860,1487.3057756849023
STAT,1883,18,45-49,1901,0.06032150147491783
STAT,1903,17,na,1920,3394.498122801205
STAT,1886,19,25-29,1905,5.625766028665872
STAT,1841,38,20-24,1879,0.6149717180005948
STAT,1911,35,35-39,1946,2.227449610000835
STAT,1882,9,na,1891,2385.116655222202
STAT,1892,23,50-100,1915,0.48092814726623634
STAT,1858,88,na,1946,101.81357620545221
SIM,1830,41,40-44,1871,6
STAT,1858,51,50-100,1909,0.011254237133224288
STAT,1914,36,15-19,1950,0.01819695031713289
STAT,1788,76,na,1864,359.0220717745255
STAT,1916,44,25-29,1960,0.06889903226143022
SIM,1827,28,25-29,1855,43
STAT,1796,95,na,1891,3.097494437511948
SIM,1940,30,35-39,1970,15
SIM,1813,44,45-49,1857,1
STAT,1861,37,35-39,1898,5.548541810213644
STAT,1873,28,15-19,1901,0.43352773538056194
STAT,1859,53,30-34,1912,0.00441571715781845
STAT,1859,38,20-24,1897,0.578279333800705
STAT,1931,9,na,1940,4922.501642250407
SIM,1921,18,40-44,1939,2
SIM,1944,18,35-39,1962,10
SIM,1880,35,45-49,1915,2
STAT,1887,40,15-19,1927,0.01473725570216613
STAT,1845,54,40-44,1899,0.007211559123017295
STAT,1857,45,20-24,1902,0.009026107805719922
SIM,1832,93,na,1925,10
SIM,1928,13,na,1941,4710
STAT,1828,26,25-29,1854,100.65244344796204
SIM,1924,19,20-24,1943,120
STAT,1872,35,45-49,1907,1.9081804214511024
SIM,1879,70,na,1949,1312
SIM,1894,19,25-29,1913,7
STAT,1798,96,na,1894,2.381611238831
SIM,1844,25,20-24,1869,11
STAT,1845,38,na,1883,1725.6164752179
STAT,1770,106,na,1876,0.009183429588940355
STAT,1804,52,50-100,1856,0.04491161347909304
SIM,1910,49,na,1959,3139
SIM,1871,37,45-49,1908,1
STAT,1862,18,na,1880,2106.0466643761906
STAT,1901,31,45-49,1932,2.3152564283737744
STAT,1834,48,30-34,1882,0.06273600303056989
STAT,1836,25,20-24,1861,9.725183411220124
STAT,1843,25,na,1868,1948.6054120007861
SIM,1859,19,30-34,1878,1
SIM,1870,57,na,1927,1853
STAT,1818,40,50-100,1858,2.74208115308847
SIM,1876,28,20-24,1904,14
STAT,1826,49,35-39,1875,0.1274364862917078
STAT,1933,26,50-100,1959,1.249100139875431
SIM,1851,47,50-100,1898,3
STAT,1853,18,50-100,1871,0.04344851869320387
STAT,1920,33,35-39,1953,9.416632581507292
STAT,1866,38,25-29,1904,2.4953107344383296
STAT,1922,41,45-49,1963,0.18073593567171184
SIM,1828,88,na,1916,75
STAT,1881,74,na,1955,1012.2869639664959
STAT,1848,56,na,1904,1469.4003444597492
SIM,1874,38,25-29,1912,3
STAT,1850,60,na,1910,1342.6589091867158
STAT,1904,45,45-49,1949,0.1821571049013057
STAT,1843,46,30-34,1889,0.07040758698544183
SIM,1869,38,30-34,1907,6
STAT,1894,49,40-44,1943,0.11490482056814898
STAT,1938,31,40-44,1969,3.7189619922019412
SIM,1839,40,na,1879,1721
SIM,1891,35,20-24,1926,3
STAT,1935,31,15-19,1966,0.16804136800316236
STAT,1864,24,50-100,1888,0.34483284429607447
SIM,1853,18,25-29,1871,7
STAT,1863,27,30-34,1890,20.911391602722343
SIM,1868,21,na,1889,2144
SIM,1855,26,35-39,1881,10
STAT,1883,35,20-24,1918,0.7204817626400741
STAT,1865,36,na,1901,2032.2107198305544
STAT,1900,34,20-24,1934,3.5122701488439025
SIM,1802,95,na,1897,3
STAT,1879,17,40-44,1896,0.18060434754081545
STAT,1850,36,20-24,1886,0.5570271226743962
STAT,1921,42,40-44,1963,0.2661625808327911
SIM,1836,26,25-29,1862,37
STAT,1803,60,na,1863,958.9025482107611
STAT,1940,26,15-19,1966,0.6803029302579078
STAT,1883,87,na,1970,407.45770624334335
STAT,1838,48,15-19,1886,2.770982283378366E-4
STAT,1894,18,20-24,1912,21.48762512748265
SIM,1893,29,50-100,1922,4
STAT,1929,20,35-39,1949,11.316433815781462
STAT,1871,54,na,1925,1961.0817179016433
STAT,1923,34,15-19,1957,0.13900300829807125
STAT,1895,48,45-49,1943,0.16205270387458848
SIM,1802,63,na,1865,888
STAT,1913,30,25-29,1943,8.754977208711363
STAT,1827,27,20-24,1854,31.54645042557531
STAT,1879,29,35-39,1908,9.459565514058367
SIM,1871,27,30-34,1898,28
STAT,1873,55,na,1928,1982.747756940992
STAT,1909,41,15-19,1950,0.0013644041453368312
STAT,1875,36,na,1911,2297.570786829247
STAT,1924,43,20-24,1967,0.019815163374423406
STAT,1907,46,25-29,1953,0.045208456267289136
STAT,1923,47,na,1970,4060.363179833293
STAT,1812,43,na,1855,1357.8265389323526
STAT,1822,41,40-44,1863,3.4846411128631773
SIM,1804,76,na,1880,330
SIM,1815,47,50-100,1862,1
SIM,1862,38,na,1900,2031
SIM,1835,27,20-24,1862,12
STAT,1895,17,25-29,1912,6.985941623399184
STAT,1932,30,35-39,1962,11.48950651503655
STAT,1917,18,25-29,1935,8.786165141123815
SIM,1787,79,na,1866,253
STAT,1845,18,25-29,1863,5.015240564041723
STAT,1847,26,35-39,1873,8.595036161596592
STAT,1934,37,50-100,1971,0.5473310532827317
SIM,1807,94,na,1901,9
STAT,1920,49,50-100,1969,0.2348211193271838
STAT,1870,32,30-34,1902,16.16192773051428
SIM,1862,44,40-44,1906,7
SIM,1856,38,45-49,1894,1
STAT,1843,109,na,1952,5.132864792957464E-4
STAT,1777,101,na,1878,0.12395272479994715
STAT,1916,19,20-24,1935,27.026868241846845
SIM,1887,29,35-39,1916,12
SIM,1936,32,na,1968,2873
STAT,1860,42,15-19,1902,0.010589576694015468
SIM,1921,30,25-29,1951,11
STAT,1939,19,15-19,1958,42.88157515632137
SIM,1947,19,15-19,1966,42
STAT,1862,15,20-24,1877,16.55659565829427
SIM,1833,37,25-29,1870,1
STAT,1911,24,50-100,1935,0.5857054881039402
STAT,1839,105,na,1944,0.019550205527342816
STAT,1905,19,45-49,1924,0.08869714248989621
STAT,1871,36,40-44,1907,4.119453779267008
SIM,1777,79,na,1856,212
SIM,1910,17,na,1927,3557
STAT,1815,48,20-24,1863,0.028723781950638624
STAT,1881,18,35-39,1899,0.49919042582192047
SIM,1870,15,20-24,1885,20
STAT,1848,38,45-49,1886,1.4646974495063814
STAT,1880,54,35-39,1934,0.008322068641842031
STAT,1920,46,40-44,1966,0.16506082357131296
STAT,1882,39,20-24,1921,0.7014711210570066
STAT,1894,36,35-39,1930,8.636526447807498
STAT,1895,9,na,1904,3198.663126939839
STAT,1902,42,30-34,1944,0.10630127462069387
STAT,1837,19,na,1856,1908.034541072752
STAT,1845,49,45-49,1894,0.16276315876168795
SIM,1937,20,35-39,1957,8
STAT,1926,18,50-100,1944,0.4328547088031965
STAT,1920,20,15-19,1940,5.624239523923251
STAT,1861,54,25-29,1915,0.0027022160450429853
SIM,1869,70,na,1939,1225
SIM,1900,32,20-24,1932,3
STAT,1854,29,50-100,1883,0.4759900852353847
STAT,1851,40,35-39,1891,1.3412984943043582
STAT,1868,17,50-100,1885,0.04498963826414003
STAT,1855,28,35-39,1883,7.071876509177846
STAT,1929,42,na,1971,4543.922324958277
SIM,1920,31,35-39,1951,10
STAT,1835,38,na,1873,1634.9727820344342
STAT,1900,52,na,1952,2806.9734276932645
SIM,1916,12,na,1928,3866
STAT,1824,46,20-24,1870,0.014302741147103313
SIM,1907,61,na,1968,2871
STAT,1937,24,50-100,1961,0.6048256099673651
SIM,1850,34,20-24,1884,1
SIM,1846,28,35-39,1874,11
STAT,1896,21,50-100,1917,0.5106765968398153
STAT,1838,28,35-39,1866,8.311164178015849
STAT,1844,45,35-39,1889,0.09983117508899834
STAT,1851,47,50-100,1898,0.17926286938574362
STAT,1923,47,20-24,1970,0.01221396994365451
STAT,1842,22,50-100,1864,0.36627072660623056
STAT,1848,88,na,1936,98.90232919814426
STAT,1885,15,50-100,1900,0.04632437949740633
STAT,1828,36,na,1864,1591.6712204848625
STAT,1878,53,40-44,1931,0.010187207838482225
SIM,1864,6,na,1870,2521
STAT,1903,46,40-44,1949,0.13016320442158727
STAT,1786,95,na,1881,2.475333559771659
STAT,1842,34,20-24,1876,2.2775126412736295
SIM,1936,0,na,1936,3131
SIM,1820,92,na,1912,11
STAT,1818,91,na,1909,27.938005397312427
STAT,1883,55,na,1938,1914.4279868606993
STAT,1859,48,35-39,1907,0.1042232041476549
STAT,1840,60,na,1900,1328.19178865505
SIM,1948,8,na,1956,4016
STAT,1832,41,na,1873,1565.8472903739348
STAT,1891,74,na,1965,1584.3156375624537
STAT,1939,30,45-49,1969,1.51829460822544
STAT,1870,17,20-24,1887,16.56708965446786
STAT,1912,44,40-44,1956,0.22607888739837806
STAT,1874,37,20-24,1911,0.7442789066748757
STAT,1825,93,na,1918,16.523865866424845
SIM,1810,82,na,1892,188
STAT,1915,48,25-29,1963,0.05035047651903687
SIM,1863,87,na,1950,126
STAT,1838,68,na,1906,1042.26788948789
STAT,1928,41,25-29,1969,0.08613159128470559
STAT,1852,18,na,1870,2096.894448796001
SIM,1924,31,na,1955,4113
SIM,1908,32,50-100,1940,3
SIM,1902,18,30-34,1920,2
STAT,1903,49,na,1952,2961.274949671371
STAT,1873,16,35-39,1889,0.5292792212584229
SIM,1920,44,40-44,1964,4
SIM,1872,18,35-39,1890,2
SIM,1882,37,20-24,1919,3
STAT,1844,50,45-49,1894,0.010334251544966129
STAT,1778,76,na,1854,306.0
STAT,1891,49,15-19,1940,2.5832566725279463E-4
STAT,1915,28,na,1943,3596.62404569313
SIM,1856,42,na,1898,1844
STAT,1885,43,30-34,1928,1.0742275671647135
SIM,1882,36,na,1918,2138
STAT,1820,62,na,1882,1007.2522893882425
STAT,1818,47,35-39,1865,0.2992233997878074
SIM,1821,43,40-44,1864,8
SIM,1884,17,15-19,1901,5
SIM,1911,33,35-39,1944,9
STAT,1835,47,35-39,1882,0.0920736876648635
STAT,1844,27,20-24,1871,10.081748168485667
STAT,1875,49,30-34,1924,0.09198651642459198
SIM,1861,35,35-39,1896,10
STAT,1825,50,35-39,1875,0.009054369689634594
STAT,1830,38,45-49,1868,1.5608197236254484
STAT,1940,32,35-39,1972,8.933858869544183
STAT,1880,34,40-44,1914,4.27378296018141
SIM,1852,27,20-24,1879,11
SIM,1944,3,na,1947,4028
SIM,1841,36,20-24,1877,4
SIM,1795,66,na,1861,729
SIM,1811,46,na,1857,1335
STAT,1870,44,25-29,1914,0.5864015511310944
STAT,1856,49,20-24,1905,0.008693347138544298
STAT,1828,58,na,1886,1163.0602107755283
STAT,1911,46,na,1957,3293.0596234539166
SIM,1869,92,na,1961,57
SIM,1850,90,na,1940,47
STAT,1833,36,20-24,1869,0.5928671883441118
STAT,1922,30,50-100,1952,0.8896669773253334
STAT,1813,43,40-44,1856,7.587763195962564
STAT,1876,85,na,1961,413.86190503869415
STAT,1903,33,35-39,1936,7.782519251760053
STAT,1876,48,35-39,1924,0.13482017943523456
STAT,1898,46,20-24,1944,0.00868095608075119
SIM,1843,16,15-19,1859,4
STAT,1818,52,30-34,1870,0.01219731507005937
STAT,1853,35,35-39,1888,5.355405162646465
STAT,1892,41,35-39,1933,2.1518979619898304
SIM,1896,50,na,1946,2757
STAT,1820,53,25-29,1873,0.005503138860684033
SIM,1919,30,na,1949,3896
STAT,1833,80,na,1913,375.5436480521389
STAT,1913,18,40-44,1931,0.26939285149036923
SIM,1856,20,na,1876,1993
SIM,1820,82,na,1902,201
STAT,1833,90,na,1923,47.86332316875463
STAT,1938,7,na,1945,3724.6110107308214
SIM,1862,16,25-29,1878,5
STAT,1885,38,35-39,1923,6.6238695378053
STAT,1940,29,50-100,1969,0.9578042942499326
STAT,1798,109,na,1907,1.9733179804486123E-4
STAT,1854,16,25-29,1870,4.910266825791446
STAT,1883,33,na,1916,2200.083223204267
STAT,1891,52,na,1943,2504.3790137151796
SIM,1855,68,na,1923,1145
STAT,1830,43,40-44,1873,1.6872667684110816
STAT,1868,66,na,1934,1478.3495083301927
STAT,1778,98,na,1876,0.4979599763971703
STAT,1891,42,na,1933,2699.2209166549083
STAT,1828,68,na,1896,867.5218360445352
SIM,1923,36,50-100,1959,1
STAT,1837,52,40-44,1889,0.006669972668598451
STAT,1929,10,na,1939,4791.753463057294
SIM,1893,38,35-39,1931,17
SIM,1863,28,35-39,1891,7
STAT,1853,17,20-24,1870,15.815728432809516
STAT,1882,33,50-100,1915,0.8387044570718916
STAT,1903,27,na,1930,3207.5661204450867
SIM,1795,76,na,1871,357
SIM,1861,17,20-24,1878,21
SIM,1882,58,na,1940,1797
STAT,1891,37,20-24,1928,0.9013587880603655
SIM,1870,35,na,1905,2198
STAT,1832,63,na,1895,1078.8947705697399
STAT,1933,36,25-29,1969,1.268098121978421
STAT,1861,46,25-29,1907,0.04531414625696704
SIM,1914,31,na,1945,3876
SIM,1920,7,na,1927,4150
STAT,1793,65,na,1858,782.1902828959903
STAT,1863,35,na,1898,1975.0159478732046
STAT,1857,28,45-49,1885,0.8456036230263518
STAT,1883,44,50-100,1927,0.9649310841554221
SIM,1830,44,45-49,1874,6
STAT,1813,92,na,1905,17.614679524084586
STAT,1807,54,20-24,1861,0.0025102971764568893
STAT,1863,54,35-39,1917,0.006952484714521245
STAT,1924,47,50-100,1971,0.2544023161925166
SIM,1876,40,na,1916,2315
SIM,1880,32,40-44,1912,4
STAT,1897,0,na,1897,3709.8126545764017
SIM,1880,17,30-34,1897,1
SIM,1931,20,40-44,1951,4
SIM,1940,24,15-19,1964,3
STAT,1846,20,50-100,1866,0.35991194518827985
STAT,1826,46,30-34,1872,0.09173084999969872
STAT,1912,40,50-100,1952,0.10822723238781824
SIM,1875,88,na,1963,293
STAT,1931,34,na,1965,4675.714859377509
STAT,1861,76,na,1937,743.2160546344553
SIM,1909,27,30-34,1936,38
SIM,1873,75,na,1948,942
STAT,1913,40,40-44,1953,0.23298605756601015
SIM,1813,41,40-44,1854,6
SIM,1891,38,25-29,1929,6
STAT,1872,17,30-34,1889,1.5162819487719654
SIM,1879,27,35-39,1906,13
STAT,1840,82,na,1922,324.93579997028144
STAT,1874,45,20-24,1919,0.011701890041979324
STAT,1931,36,15-19,1967,0.024048174077174293
STAT,1803,53,25-29,1856,0.009951012848599795
STAT,1932,24,15-19,1956,6.5756447283662505
STAT,1821,79,na,1900,377.51591427921073
SIM,1869,29,40-44,1898,2
STAT,1820,49,40-44,1869,0.2741215293252999
STAT,1901,46,30-34,1947,0.07240617285300525
SIM,1819,45,50-100,1864,1
STAT,1898,2,na,1900,3408.9177261203586
STAT,1915,22,50-100,1937,0.6424852364038088
SIM,1812,63,na,1875,874
STAT,1843,49,35-39,1892,0.09889487299447845
SIM,1865,28,45-49,1893,4
STAT,1920,30,30-34,1950,16.434737072696
STAT,1843,18,15-19,1861,5.43925280564643
STAT,1881,40,20-24,1921,0.14632204380566521
STAT,1885,46,35-39,1931,0.1321392161924195
STAT,1908,58,na,1966,2976.775809246757
SIM,1916,17,20-24,1933,26
STAT,1883,23,na,1906,2182.9544845923365
SIM,1843,51,50-100,1894,1
STAT,1802,65,na,1867,791.1837619273981
STAT,1925,28,na,1953,4165.730441117264
STAT,1927,29,50-100,1956,1.1386563837058248
STAT,1866,53,na,1919,1845.2741246564713
STAT,1830,35,40-44,1865,3.5690300370235852
STAT,1901,68,na,1969,2338.663633357024
STAT,1840,100,na,1940,0.7393473426070984
STAT,1946,20,35-39,1966,9.905669447877566
SIM,1844,28,25-29,1872,35
SIM,1848,33,na,1881,1866
STAT,1891,20,na,1911,2781.967593015835
STAT,1836,28,25-29,1864,34.317256896130395
SIM,1939,29,na,1968,3493
STAT,1914,42,35-39,1956,0.18846255208802787
STAT,1925,7,na,1932,4562.259257453578
STAT,1919,32,na,1951,3854.724287727482
SIM,1850,80,na,1930,423
SIM,1851,6,na,1857,2255
STAT,1872,32,40-44,1904,4.112084583159313
STAT,1795,78,na,1873,299.57412089793723
STAT,1870,16,50-100,1886,0.046053549965600356
STAT,1908,17,20-24,1925,24.838220161685893
SIM,1845,16,25-29,1861,6
STAT,1811,43,30-34,1854,4.256538231700201
SIM,1854,19,na,1873,2121
SIM,1880,2,na,1882,3114
SIM,1933,34,25-29,1967,17
STAT,1879,26,30-34,1905,24.95074722826816
STAT,1922,41,30-34,1963,0.1388352169279864
STAT,1816,47,25-29,1863,0.1516607381027014
SIM,1890,55,na,1945,2445
SIM,1837,39,na,1876,1636
SIM,1838,23,na,1861,1744
STAT,1871,86,na,1957,249.60515562439087
SIM,1869,16,20-24,1885,7
STAT,1850,39,25-29,1889,2.016739094668134
STAT,1849,20,na,1869,1890.3358230743274
SIM,1920,27,na,1947,3795
STAT,1846,27,30-34,1873,21.479238183095525
SIM,1886,17,25-29,1903,7
SIM,1928,30,35-39,1958,14
SIM,1799,80,na,1879,203
STAT,1821,101,na,1922,0.3081359876266364
STAT,1920,29,na,1949,3854.605732859027
STAT,1925,34,25-29,1959,10.356478768991234
SIM,1875,66,na,1941,1541
STAT,1928,29,40-44,1957,5.419936824843848
SIM,1878,21,na,1899,2431
STAT,1859,40,na,1899,1760.082843657654
STAT,1833,44,20-24,1877,0.11413639990263544
SIM,1897,34,na,1931,2988
STAT,1765,114,na,1879,2.7580082038905024E-4
STAT,1842,41,na,1883,1724.7802051934138
STAT,1883,38,25-29,1921,2.6525318344907287
SIM,1817,94,na,1911,9
STAT,1881,25,45-49,1906,1.0196271775093464
SIM,1876,15,15-19,1891,3
STAT,1898,29,45-49,1927,1.409737349569965
STAT,1862,18,25-29,1880,5.199169911451606
SIM,1789,80,na,1869,194
STAT,1910,29,na,1939,3391.9733317743007
STAT,1912,31,35-39,1943,8.527507297352846
SIM,1870,18,25-29,1888,6
STAT,1832,48,20-24,1880,0.008492184374002966
SIM,1936,29,40-44,1965,3
STAT,1864,38,15-19,1902,0.04717673791026989
SIM,1903,44,40-44,1947,1
STAT,1923,20,40-44,1943,3.7182522321622096
STAT,1836,87,na,1923,111.25623214611132
STAT,1861,54,na,1915,1642.6603938104317
STAT,1866,51,35-39,1917,0.007534273128539345
STAT,1811,52,20-24,1863,0.002343137616489671
STAT,1817,42,na,1859,1350.8764210205622
STAT,1871,39,45-49,1910,1.8481965284004098
STAT,1844,42,30-34,1886,0.8265821754960605
STAT,1860,37,na,1897,1808.8242621879376
STAT,1893,37,30-34,1930,6.38811728588091
STAT,1931,31,45-49,1962,1.9490373718356848
SIM,1887,26,30-34,1913,32
STAT,1926,46,35-39,1972,0.1506766995352521
SIM,1854,27,30-34,1881,27
STAT,1878,54,na,1932,2059.30729888983
STAT,1907,31,na,1938,3352.7371910049415
SIM,1863,22,na,1885,2064
STAT,1883,47,15-19,1930,3.6861995834840166E-4
STAT,1926,41,15-19,1967,0.0017912630950729226
SIM,1876,19,30-34,1895,1
STAT,1851,48,30-34,1899,0.07009310176589316
STAT,1846,87,na,1933,124.2202179790126
SIM,1935,17,30-34,1952,23
STAT,1927,17,30-34,1944,14.318713766024606
STAT,1859,45,30-34,1904,0.07370747429440658
SIM,1867,37,na,1904,2040
STAT,1869,27,25-29,1896,38.6819756644371
SIM,1835,58,na,1893,1255
STAT,1812,75,na,1887,446.5759977997045
SIM,1849,72,na,1921,881
STAT,1903,41,20-24,1944,0.01488947128905834
STAT,1906,34,15-19,1940,0.11152118338299667
STAT,1907,43,20-24,1950,0.015190872643477106
STAT,1821,50,50-100,1871,0.023071323220106407
STAT,1884,19,15-19,1903,5.510428237246406
STAT,1822,44,45-49,1866,2.14010206350073
STAT,1868,19,30-34,1887,1.44647202087485
SIM,1873,22,na,1895,2255
STAT,1878,48,45-49,1926,0.22917851669335446
SIM,1822,34,45-49,1856,2
SIM,1860,89,na,1949,97
STAT,1812,96,na,1908,3.6931070708170743
STAT,1914,44,15-19,1958,0.0014324919428975373
STAT,1933,33,20-24,1966,3.1033912210803445
STAT,1861,108,na,1969,0.018690281044108192
SIM,1833,34,20-24,1867,2
SIM,1846,25,30-34,1871,28
STAT,1919,10,na,1929,4148.987198265943
SIM,1883,75,na,1958,1090
STAT,1858,29,15-19,1887,0.3395237096214712
SIM,1844,19,na,1863,2090
SIM,1830,36,45-49,1866,1
SIM,1811,44,35-39,1855,1
STAT,1866,75,na,1941,896.6501805568879
SIM,1901,34,50-100,1935,5
STAT,1826,54,30-34,1880,0.005162033194296124
SIM,1920,49,na,1969,3732
SIM,1842,93,na,1935,13
SIM,1943,19,30-34,1962,13
STAT,1845,15,20-24,1860,15.970878344449241
STAT,1887,28,30-34,1915,26.51094137025764
STAT,1893,45,30-34,1938,0.06610083560216823
STAT,1842,17,45-49,1859,0.05973391255224275
STAT,1932,30,na,1962,4755.105665131082
STAT,1901,30,20-24,1931,3.6029493953089853
STAT,1930,35,45-49,1965,0.8415312621964174
SIM,1824,64,na,1888,920
SIM,1935,20,25-29,1955,128
STAT,1845,46,40-44,1891,0.12093246409391832
SIM,1907,29,na,1936,3336
STAT,1877,36,35-39,1913,6.967077300295878
STAT,1910,40,15-19,1950,0.001386209679738809
STAT,1855,50,20-24,1905,5.301319515758623E-4
SIM,1926,32,na,1958,4161
SIM,1839,38,45-49,1877,2
STAT,1915,45,20-24,1960,0.010568433741700535
STAT,1908,16,na,1924,3547.142708157888
STAT,1862,42,25-29,1904,0.5168373360799653
STAT,1838,25,30-34,1863,22.164590626947827
SIM,1908,18,25-29,1926,9
SIM,1865,88,na,1953,80
STAT,1879,49,15-19,1928,3.8672577560915197E-4
SIM,1898,27,45-49,1925,2
SIM,1853,15,20-24,1868,17
SIM,1859,39,25-29,1898,5
SIM,1899,15,na,1914,3278
STAT,1823,69,na,1892,772.277238754496
STAT,1811,79,na,1890,302.8168435031927
STAT,1910,23,25-29,1933,81.66876533094442
STAT,1938,18,45-49,1956,0.4653112210613509
STAT,1925,40,45-49,1965,0.19090323183328736
SIM,1885,36,35-39,1921,11
SIM,1826,44,30-34,1870,4
STAT,1870,40,45-49,1910,1.3993732802042245
STAT,1842,37,25-29,1879,2.405171310064084
SIM,1936,10,na,1946,2997
STAT,1830,52,30-34,1882,0.0038372204202213665
STAT,1853,48,40-44,1901,0.12536796306431044
STAT,1838,19,45-49,1857,0.05815764434125503
SIM,1868,17,30-34,1885,1
SIM,1892,36,na,1928,2843
STAT,1870,37,na,1907,2180.8561885583763
STAT,1897,17,35-39,1914,0.6932475631600162
STAT,1899,41,45-49,1940,0.13515767478374405
STAT,1841,100,na,1941,0.7263685947290519
STAT,1916,3,na,1919,4051.919777927177
SIM,1857,29,50-100,1886,1
SIM,1850,37,25-29,1887,2
STAT,1918,44,35-39,1962,0.2015779617743639
SIM,1886,40,na,1926,2277
STAT,1832,110,na,1942,1.6709017942638635E-4
STAT,1867,47,30-34,1914,0.0854613553061635
STAT,1870,35,35-39,1905,6.609367055756717
STAT,1935,19,30-34,1954,15.656054247449484
SIM,1946,18,45-49,1964,3
STAT,1820,45,25-29,1865,0.09780381576740822
STAT,1822,36,45-49,1858,3.7973686214369375
STAT,1858,66,na,1924,1215.538462629065
STAT,1852,53,20-24,1905,5.516488949226172E-4
STAT,1866,35,20-24,1901,0.6777773042742751
SIM,1824,42,na,1866,1426
STAT,1818,58,na,1876,1111.7038481552183
STAT,1830,46,45-49,1876,0.1752185432034179
SIM,1857,26,45-49,1883,1
STAT,1852,44,30-34,1896,0.8616957090745931
SIM,1825,81,na,1906,240
SIM,1905,30,40-44,1935,5
STAT,1927,20,25-29,1947,108.16345380135733
SIM,1866,20,na,1886,2155
STAT,1819,51,50-100,1870,0.02631357868902791
STAT,1913,27,na,1940,3525.4468008522595
SIM,1838,26,35-39,1864,9
SIM,1849,17,20-24,1866,15
SIM,1880,35,na,1915,2435
SIM,1883,53,na,1936,2005
STAT,1858,40,45-49,1898,1.1211525022105167
SIM,1790,77,na,1867,289
STAT,1871,27,50-100,1898,0.5990997179537063
SIM,1855,1,na,1856,2860
STAT,1863,37,45-49,1900,1.655418438967828
SIM,1851,18,15-19,1869,9
SIM,1872,15,30-34,1887,1
STAT,1885,35,30-34,1920,5.063727007710905
STAT,1909,29,30-34,1938,35.113486572498424
SIM,1917,29,30-34,1946,39
STAT,1840,24,45-49,1864,0.6087357820669097
STAT,1865,35,50-100,1900,1.0639589187560148
SIM,1895,28,30-34,1923,39
SIM,1914,53,na,1967,3640
SIM,1853,87,na,1940,118
STAT,1812,47,40-44,1859,0.5633373334252445
STAT,1803,92,na,1895,13.760027717253596
STAT,1818,44,30-34,1862,2.5532768572922953
STAT,1871,53,30-34,1924,0.00548531151702177
SIM,1893,35,30-34,1928,13
STAT,1876,17,15-19,1893,5.787702679026722
SIM,1906,44,na,1950,3194
STAT,1912,47,45-49,1959,0.19727459095973993
STAT,1906,40,35-39,1946,0.17472360741026763
STAT,1851,76,na,1927,694.7466721844785
STAT,1941,4,na,1945,3904.4825138365354
STAT,1849,26,45-49,1875,0.9555369425463289
STAT,1869,40,na,1909,2134.808479651413
SIM,1927,18,35-39,1945,4
STAT,1877,91,na,1968,181.07551263904972
STAT,1916,45,na,1961,3576.3686182373526
STAT,1845,107,na,1952,0.003321829862168561
STAT,1824,49,25-29,1873,0.06580170534484403
SIM,1942,28,na,1970,3550
STAT,1905,41,45-49,1946,0.14252225589188836
SIM,1869,46,50-100,1915,2
SIM,1828,37,30-34,1865,6
STAT,1823,37,15-19,1860,0.08975947953569487
STAT,1886,16,20-24,1902,17.738735275045205
STAT,1853,35,na,1888,1783.8756373374654
SIM,1894,16,20-24,1910,25
STAT,1898,49,25-29,1947,0.04068307213337417
STAT,1886,47,40-44,1933,0.17008220865757065
STAT,1940,17,na,1957,3530.1686334012647
STAT,1928,32,35-39,1960,10.795658228449541
SIM,1929,30,na,1959,4638
STAT,1919,18,35-39,1937,4.369144368979286
SIM,1868,86,na,1954,154
STAT,1890,28,15-19,1918,0.522194073596662
SIM,1851,21,na,1872,1891
STAT,1821,41,25-29,1862,1.1049960562183476
SIM,1839,72,na,1911,885
STAT,1907,63,na,1970,2777.4797981468564
SIM,1917,29,na,1946,3627
SIM,1945,19,40-44,1964,2
STAT,1879,17,na,1896,2493.864517710782
SIM,1877,5,na,1882,2664
SIM,1922,31,45-49,1953,1
SIM,1780,99,na,1879,1
SIM,1921,33,na,1954,3864
STAT,1836,107,na,1943,0.0029780730651083735
STAT,1862,49,45-49,1911,0.18620696249385718
STAT,1858,34,na,1892,1754.606976486038
STAT,1918,26,na,1944,3779.0758910859304
SIM,1863,17,30-34,1880,3
STAT,1864,15,30-34,1879,1.5479822653378663
SIM,1889,69,na,1958,1733
STAT,1855,17,30-34,1872,1.3426389910071013
SIM,1881,41,na,1922,1932
STAT,1884,43,15-19,1927,0.012798895348608478
STAT,1929,24,50-100,1953,0.7811944548967232
SIM,1915,16,na,1931,3775
STAT,1846,54,35-39,1900,0.005903089224863857
SIM,1904,40,40-44,1944,1
STAT,1896,73,na,1969,1848.4082295702237
STAT,1937,19,40-44,1956,1.2814687959216768
SIM,1854,42,40-44,1896,8
SIM,1926,4,na,1930,4559
STAT,1840,37,15-19,1877,0.04625398354630809
SIM,1807,62,na,1869,876
SIM,1868,26,20-24,1894,8
STAT,1820,34,50-100,1854,2.8236320886390764
SIM,1869,33,50-100,1902,4
STAT,1820,94,na,1914,10.647271553305757
STAT,1875,16,45-49,1891,0.06355368129295902
SIM,1838,47,50-100,1885,1
SIM,1864,61,na,1925,1693
STAT,1910,47,35-39,1957,0.11360518378227998
SIM,1840,69,na,1909,955
SIM,1864,71,na,1935,1205
STAT,1932,21,45-49,1953,1.3989147138466824
SIM,1940,15,na,1955,3385
STAT,1882,47,20-24,1929,0.01097957416975443
SIM,1911,13,na,1924,3763
STAT,1839,52,na,1891,1428.0293337388466
STAT,1949,18,20-24,1967,148.92258950108726
STAT,1831,40,50-100,1871,0.8262779771760269
STAT,1940,20,40-44,1960,3.2376837586223775
STAT,1843,47,50-100,1890,0.17636337648454944
SIM,1828,35,na,1863,1559
STAT,1874,48,25-29,1922,0.05491581615082357
STAT,1851,34,50-100,1885,0.6849518778657947
STAT,1853,32,30-34,1885,13.334029293737204
STAT,1878,45,40-44,1923,0.17004561955631875
STAT,1922,30,na,1952,4069.6590667275323
SIM,1876,19,na,1895,2513
STAT,1846,42,40-44,1888,1.605101509589591
STAT,1913,48,15-19,1961,3.386390420178058E-4
STAT,1917,31,20-24,1948,2.4226807480966084
STAT,1882,20,50-100,1902,0.37709799851881004
SIM,1859,43,30-34,1902,1
STAT,1909,30,50-100,1939,0.7511446512413933
STAT,1921,21,35-39,1942,10.07813569583546
STAT,1830,39,na,1869,1576.7681138356397
SIM,1836,54,na,1890,1302
STAT,1883,51,35-39,1934,0.008008982227096091
STAT,1920,36,50-100,1956,0.43468629539646053
STAT,1918,18,50-100,1936,0.3842188630353607
STAT,1865,22,50-100,1887,0.35432091325588366
STAT,1861,43,20-24,1904,0.12368514171385604
SIM,1900,50,na,1950,2832
SIM,1832,61,na,1893,1157
SIM,1930,30,40-44,1960,6
STAT,1840,28,50-100,1868,0.551475840117899
STAT,1856,22,na,1878,1837.3309637675134
STAT,1814,47,15-19,1861,0.001085127618592025
STAT,1878,17,25-29,1895,5.572958398686505
STAT,1866,46,50-100,1912,0.21452225073302364
STAT,1914,31,45-49,1945,1.5022095591227083
STAT,1837,44,40-44,1881,1.4861338430075341
STAT,1821,54,30-34,1875,0.008396770008514099
STAT,1899,17,50-100,1916,0.06342554614668557
STAT,1854,53,30-34,1907,0.004217573829852046
STAT,1833,47,25-29,1880,0.04105508320505969
STAT,1849,16,50-100,1865,0.043724909886588385
STAT,1873,49,20-24,1922,0.011266645063749877
SIM,1861,32,30-34,1893,23
STAT,1823,50,25-29,1873,0.004229797123526983
STAT,1910,20,20-24,1930,99.20632299663824
STAT,1807,47,50-100,1854,0.9094642911009796
STAT,1829,27,30-34,1856,36.287074487409846
SIM,1817,72,na,1889,584
STAT,1877,52,50-100,1929,0.014726664571868298
STAT,1811,46,35-39,1857,0.4742350368922397
STAT,1894,27,50-100,1921,0.7773671525667506
STAT,1936,31,30-34,1967,14.462634595491425
SIM,1845,44,40-44,1889,6
SIM,1918,17,30-34,1935,16
STAT,1896,18,30-34,1914,1.984783546264159
SIM,1922,30,40-44,1952,5
SIM,1826,40,50-100,1866,3
STAT,1880,39,50-100,1919,1.2080918457020426
STAT,1920,41,20-24,1961,0.018453526827374618
STAT,1827,42,30-34,1869,1.0576241109607931
STAT,1896,49,15-19,1945,2.758283255888809E-4
STAT,1805,53,35-39,1858,0.024614766842747424
STAT,1897,14,na,1911,3252.2188459452213
STAT,1937,30,35-39,1967,8.549518935477984
STAT,1799,60,na,1859,983.5818098113446
STAT,1904,40,25-29,1944,0.061024834457601464
SIM,1872,90,na,1962,134
SIM,1859,28,20-24,1887,13
STAT,1940,21,45-49,1961,1.083061898414122
STAT,1856,16,35-39,1872,0.482896904186355
SIM,1925,26,na,1951,4105
STAT,1914,30,40-44,1944,3.7505514986291297
STAT,1875,14,na,1889,2504.9346692696718
STAT,1881,22,40-44,1903,1.900733682102538
STAT,1920,42,25-29,1962,0.0745089859451083
SIM,1919,29,40-44,1948,5
STAT,1841,53,45-49,1894,0.009769846363107279
STAT,1912,17,50-100,1929,0.07155305049756883
SIM,1880,44,35-39,1924,7
STAT,1872,44,35-39,1916,1.6938412846196924
STAT,1840,54,40-44,1894,0.007130015984408504
STAT,1810,47,30-34,1857,0.34417156523057846
STAT,1888,54,na,1942,2336.941320887088
STAT,1872,50,20-24,1922,7.097518012117594E-4
STAT,1949,18,50-100,1967,0.41153986613378796
SIM,1848,28,45-49,1876,4
SIM,1885,8,na,1893,2471
SIM,1909,30,25-29,1939,14
STAT,1888,40,30-34,1928,1.2959877743561616
STAT,1873,23,na,1896,2260.857100677494
SIM,1900,41,45-49,1941,1
STAT,1801,59,na,1860,1025.593408487818
SIM,1818,42,30-34,1860,4
SIM,1914,31,45-49,1945,1
STAT,1888,19,35-39,1907,0.6090809882318287
STAT,1933,15,na,1948,4676.3867612599
STAT,1840,39,na,1879,1727.925258842475
STAT,1916,48,40-44,1964,0.1523380800958715
STAT,1877,33,30-34,1910,17.04382763409114
STAT,1886,73,na,1959,1305.5093922447304
STAT,1849,19,20-24,1868,15.544648920434424
SIM,1830,33,40-44,1863,5
SIM,1885,33,30-34,1918,24
SIM,1835,42,30-34,1877,3
STAT,1872,49,na,1921,2088.7624450737685
STAT,1831,31,40-44,1862,3.602699378139132
STAT,1953,2,na,1955,4497.199633868093
SIM,1844,17,20-24,1861,14
SIM,1874,71,na,1945,1210
STAT,1912,42,25-29,1954,0.06504783244086966
STAT,1894,33,30-34,1927,21.127864926581076
STAT,1936,32,35-39,1968,8.383818748985151
STAT,1821,57,na,1878,1176.3247999273262
SIM,1857,19,20-24,1876,19
STAT,1820,42,20-24,1862,0.28648901307049657
SIM,1928,15,25-29,1943,60
STAT,1853,67,na,1920,1175.6099607040944
STAT,1918,41,30-34,1959,0.12859232066276094
STAT,1890,29,50-100,1919,0.7335812044848882
STAT,1841,46,20-24,1887,0.008353864480162032
STAT,1914,33,na,1947,3580.659070475549
SIM,1949,19,25-29,1968,45
STAT,1904,40,50-100,1944,0.1003956947669127
SIM,1931,33,na,1964,4658
STAT,1912,8,na,1920,3796.659121856955
STAT,1937,28,na,1965,3447.6207846150496
SIM,1859,15,15-19,1874,4
STAT,1890,41,25-29,1931,0.7450647773111347
SIM,1895,43,40-44,1938,1
STAT,1831,43,35-39,1874,1.361026618650555
STAT,1901,42,15-19,1943,0.0012664893982429315
SIM,1896,34,50-100,1930,1
SIM,1826,54,na,1880,1254
STAT,1822,53,35-39,1875,0.011329716914325506
STAT,1876,54,20-24,1930,6.99869693005011E-4
STAT,1925,31,20-24,1956,2.738227903821521
STAT,1854,41,na,1895,1671.8410185191967
STAT,1868,34,na,1902,2133.9697926057524
STAT,1904,5,na,1909,3550.5016303397733
SIM,1866,52,na,1918,1857
STAT,1824,32,50-100,1856,2.122253106814601
STAT,1953,13,na,1966,4488.347925820261
SIM,1882,46,50-100,1928,2
STAT,1887,43,40-44,1930,2.3591858676335375
SIM,1930,30,50-100,1960,1
STAT,1793,97,na,1890,0.9771388190834728
SIM,1901,13,na,1914,3479
SIM,1866,40,45-49,1906,1
SIM,1834,42,na,1876,1530
STAT,1926,43,30-34,1969,0.14867263099984582
STAT,1880,46,35-39,1926,0.139554879887833
STAT,1927,42,35-39,1969,0.2386025325433106
STAT,1861,86,na,1947,174.05668757462382
SIM,1829,28,35-39,1857,8
STAT,1839,20,na,1859,1858.3738539986741
SIM,1836,18,25-29,1854,9
SIM,1837,17,na,1854,1945
STAT,1930,30,25-29,1960,11.281604447278506
SIM,1914,24,50-100,1938,1
SIM,1958,10,na,1968,4846
STAT,1821,48,45-49,1869,0.355135959074912
STAT,1840,21,40-44,1861,1.85884018911568
SIM,1896,19,35-39,1915,1
STAT,1836,39,50-100,1875,0.93208302014241
SIM,1897,66,na,1963,2265
STAT,1877,53,25-29,1930,0.0034165439433306087
STAT,1900,49,40-44,1949,0.12392243531959785
STAT,1897,46,50-100,1943,0.1755290646002799
STAT,1789,82,na,1871,147.68336731789793
STAT,1892,49,30-34,1941,0.06324731311643829
SIM,1933,31,20-24,1964,4
STAT,1910,6,na,1916,3738.4399925527305
STAT,1922,33,45-49,1955,1.6726467279251145
STAT,1929,42,45-49,1971,0.20362381391565518
SIM,1940,21,45-49,1961,1
STAT,1802,54,20-24,1856,0.00202055074667083
STAT,1911,30,15-19,1941,0.11913604056445525
SIM,1818,57,na,1875,1064
STAT,1902,20,20-24,1922,92.41871600408427
STAT,1866,18,45-49,1884,0.05805432090979518
STAT,1922,46,15-19,1968,4.00805563902364E-4
STAT,1853,89,na,1942,77.90851461958692
STAT,1898,32,na,1930,3051.6788449616597
SIM,1930,33,45-49,1963,1
STAT,1810,44,50-100,1854,3.907147731038151
SIM,1931,11,na,1942,4897
STAT,1842,50,35-39,1892,0.006218718974481587
STAT,1914,11,na,1925,3864.4115177586964
STAT,1771,87,na,1858,36.89237485997113
STAT,1847,45,50-100,1892,0.18251130283163627
SIM,1839,94,na,1933,15
STAT,1884,30,45-49,1914,1.6410127912983352
SIM,1937,17,40-44,1954,1
SIM,1889,47,na,1936,2621
SIM,1857,37,na,1894,1891
SIM,1885,34,na,1919,2245
STAT,1836,52,25-29,1888,0.0022631635698169054
SIM,1841,43,na,1884,1643
STAT,1847,18,35-39,1865,0.5009318119103926
STAT,1790,79,na,1869,263.6974695295051
STAT,1859,19,na,1878,1985.258127103629
STAT,1869,20,50-100,1889,0.37672928363453756
STAT,1906,31,45-49,1937,1.3830300830739555
SIM,1889,26,40-44,1915,4
STAT,1839,42,na,1881,1624.2204045099718
STAT,1864,51,25-29,1915,0.0030048682976030923
STAT,1822,33,40-44,1855,11.228530557956434
SIM,1892,30,45-49,1922,1
SIM,1890,33,50-100,1923,1
STAT,1808,91,na,1899,22.523464123688584
STAT,1874,33,50-100,1907,0.8809306899812124
SIM,1858,86,na,1944,147
STAT,1837,107,na,1944,0.002976982155952651
STAT,1857,48,25-29,1905,0.04235863395043381
SIM,1923,0,na,1923,4533
STAT,1812,43,25-29,1855,2.311213367343303
STAT,1821,47,na,1868,1402.729357579945
STAT,1929,41,40-44,1970,0.30646418003899606
SIM,1839,16,35-39,1855,2
STAT,1905,46,15-19,1951,3.088988174732013E-4
STAT,1916,41,20-24,1957,0.017121084030929486
SIM,1916,44,na,1960,3509
SIM,1876,43,30-34,1919,4
SIM,1835,91,na,1926,43
STAT,1863,30,25-29,1893,8.573966967373813
STAT,1921,20,30-34,1941,30.853010850496506
STAT,1853,57,na,1910,1490.3580899453957
STAT,1867,16,45-49,1883,0.05958413058156007
SIM,1878,15,25-29,1893,7
STAT,1868,43,30-34,1911,1.0294834710298466
STAT,1893,48,35-39,1941,0.09346733081339832
SIM,1820,43,25-29,1863,3
STAT,1860,45,50-100,1905,0.1904416555178763
SIM,1872,42,35-39,1914,4
STAT,1912,52,na,1964,3278.525925416889
SIM,1837,42,40-44,1879,4
STAT,1846,45,45-49,1891,0.16805600743071897
SIM,1867,15,na,1882,2266
STAT,1927,41,30-34,1968,0.15170490550563592
SIM,1825,91,na,1916,17
SIM,1837,49,na,1886,1478
SIM,1946,10,na,1956,4073
SIM,1859,17,15-19,1876,3
STAT,1872,60,na,1932,1808.3921631076007
STAT,1842,94,na,1936,14.232337479777723
SIM,1854,93,na,1947,16
SIM,1909,15,15-19,1924,5
STAT,1911,32,30-34,1943,14.490054353597507
STAT,1822,49,15-19,1871,5.422640047174576E-4
STAT,1900,20,na,1920,3118.101959621093
STAT,1871,32,25-29,1903,9.592644016334944
SIM,1895,22,na,1917,2989
SIM,1786,94,na,1880,4
SIM,1842,61,na,1903,1288
STAT,1832,52,40-44,1884,0.006639182730039082
STAT,1861,34,30-34,1895,13.57947476162268
STAT,1954,4,na,1958,4592.61203494986
STAT,1918,41,50-100,1959,0.11816591602539599
STAT,1763,99,na,1862,0.11835438325806817
STAT,1850,43,45-49,1893,1.0460269066070829
SIM,1848,25,40-44,1873,3
STAT,1820,36,35-39,1856,17.25994324766053
STAT,1824,45,50-100,1869,0.2969003166183612
SIM,1901,47,50-100,1948,1
STAT,1840,51,50-100,1891,0.010568130793138645
STAT,1844,53,na,1897,1487.274034882874
STAT,1924,46,25-29,1970,0.05981272198910699
STAT,1858,16,45-49,1874,0.0569256102465546
STAT,1848,16,35-39,1864,0.4929399996528194
STAT,1831,57,na,1888,1233.1404164442686
STAT,1864,42,35-39,1906,1.5270072523466773
STAT,1923,40,35-39,1963,0.222976326037288
SIM,1832,45,50-100,1877,5
SIM,1866,27,50-100,1893,1
STAT,1810,62,na,1872,973.9669695402974
STAT,1824,53,45-49,1877,0.01609717229222326
STAT,1854,47,45-49,1901,0.1691499580339512
STAT,1901,34,50-100,1935,1.201166823361543
STAT,1929,17,40-44,1946,1.6864244149828527
STAT,1910,44,30-34,1954,0.11270698387449161
STAT,1879,50,30-34,1929,0.0059622039064227425
STAT,1864,18,35-39,1882,0.4764311514581554
SIM,1871,34,40-44,1905,5
STAT,1862,46,40-44,1908,0.13835112919377976
STAT,1858,27,50-100,1885,0.485656320975955
SIM,1907,19,20-24,1926,21
STAT,1888,6,na,1894,2915.417274989397
SIM,1812,95,na,1907,3
STAT,1912,40,25-29,1952,0.06578518088454552
SIM,1833,24,na,1857,1729
STAT,1842,109,na,1951,5.066394518086291E-4
SIM,1903,30,30-34,1933,7
STAT,1891,44,45-49,1935,1.7264092868901173
STAT,1933,25,na,1958,4703.153607770562
SIM,1859,49,na,1908,1843
SIM,1889,15,na,1904,3001
STAT,1776,101,na,1877,0.1117926626964062
STAT,1856,40,35-39,1896,1.3533294008009218
SIM,1844,39,50-100,1883,1
SIM,1846,42,na,1888,1643
STAT,1806,58,na,1864,1005.6741173787017
STAT,1839,16,35-39,1855,0.48143886693906535
SIM,1848,23,na,1871,1910
SIM,1827,39,na,1866,1491
STAT,1867,19,15-19,1886,5.31813005438643
SIM,1875,19,15-19,1894,5
SIM,1860,57,na,1917,1664
SIM,1926,30,25-29,1956,16
STAT,1881,49,20-24,1930,0.010717189693625692
SIM,1894,48,na,1942,2869
STAT,1852,47,35-39,1899,0.10587223508263974
STAT,1872,41,30-34,1913,1.0950505951412597
STAT,1902,45,35-39,1947,0.10633052713919668
STAT,1837,40,25-29,1877,0.4907623721050825
STAT,1868,28,20-24,1896,10.544252756501438
STAT,1901,37,40-44,1938,1.2493569099276571
STAT,1877,29,50-100,1906,0.6226192987823096
STAT,1861,50,45-49,1911,0.011548252302863103
STAT,1825,61,na,1886,1109.179398337788
STAT,1864,106,na,1970,0.12944199913656734
STAT,1809,54,na,1863,1183.968623144472
STAT,1865,47,20-24,1912,0.010253313034348233
SIM,1862,16,na,1878,2296
SIM,1878,43,40-44,1921,6
STAT,1938,14,na,1952,3679.9966689117596
STAT,1931,40,35-39,1971,0.2548434818539499
STAT,1948,24,na,1972,3958.662613024788
STAT,1855,48,15-19,1903,2.797348733692458E-4
STAT,1908,48,na,1956,3129.260920774714
SIM,1870,89,na,1959,121
STAT,1921,45,45-49,1966,0.23256800919136303
STAT,1815,61,na,1876,989.9539107516359
STAT,1873,53,40-44,1926,0.009932963902387322
STAT,1840,50,25-29,1890,0.00250216471301386
STAT,1882,70,na,1952,1289.776061815168
STAT,1828,54,40-44,1882,0.0074890125955036435
SIM,1865,56,na,1921,1736
SIM,1890,23,na,1913,2821
STAT,1827,45,35-39,1872,0.12596502397517095
STAT,1847,71,na,1918,982.131209717131
STAT,1895,45,40-44,1940,0.12023968401890842
STAT,1923,15,na,1938,4102.381707963741
SIM,1885,18,20-24,1903,18
STAT,1890,49,20-24,1939,0.007655135648298747
STAT,1901,33,25-29,1934,13.486507822093536
STAT,1834,53,na,1887,1339.6883236844594
STAT,1924,34,50-100,1958,0.9101643094872134
SIM,1852,38,na,1890,1804
STAT,1845,41,50-100,1886,0.7675475264461801
STAT,1809,54,30-34,1863,0.019823369142653615
STAT,1880,43,30-34,1923,1.134513306705014
SIM,1915,48,na,1963,3456
STAT,1858,56,na,1914,1512.6529896707182
STAT,1868,52,20-24,1920,6.620430809714188E-4
STAT,1930,32,40-44,1962,4.77123286256598
SIM,1866,19,na,1885,2256
STAT,1794,61,na,1855,877.6574
SIM,1926,19,30-34,1945,18
STAT,1823,41,35-39,1864,2.4140871184370867
STAT,1821,45,40-44,1866,0.2691972221752938
SIM,1875,56,na,1931,1976
STAT,1928,14,na,1942,4701.649264300743
SIM,1840,80,na,1920,366
STAT,1797,109,na,1906,1.7322985351581028E-4
SIM,1891,42,45-49,1933,2
SIM,1945,14,na,1959,3925
STAT,1857,71,na,1928,994.0937935545415
SIM,1829,25,30-34,1854,23
SIM,1878,17,25-29,1895,6
STAT,1810,48,35-39,1858,0.48943646051078493
STAT,1916,47,50-100,1963,0.21915031523747003
STAT,1843,42,15-19,1885,0.010258216011363343
STAT,1820,47,50-100,1867,0.40495842632720236
STAT,1888,22,na,1910,2639.4182621999603
STAT,1823,80,na,1903,325.5289347366052
STAT,1884,47,30-34,1931,0.0899453510050032
STAT,1888,16,30-34,1904,1.7831431871671681
STAT,1908,41,20-24,1949,0.015520904905680019
SIM,1896,16,30-34,1912,2
SIM,1903,31,35-39,1934,14
STAT,1926,32,25-29,1958,10.55907109074739
STAT,1849,50,45-49,1899,0.010610735505861906
SIM,1934,32,25-29,1966,16
SIM,1867,17,15-19,1884,4
STAT,1844,75,na,1919,722.6918288704477
SIM,1924,47,50-100,1971,2
STAT,1883,42,45-49,1925,1.3839839075419307
STAT,1851,44,15-19,1895,0.00999027988664839
STAT,1908,26,na,1934,3355.067111805625
STAT,1886,40,20-24,1926,0.16011459755065957
STAT,1870,49,45-49,1919,0.213896763681552
STAT,1866,15,40-44,1881,0.16545860511828436
SIM,1871,30,25-29,1901,16
STAT,1798,64,na,1862,825.279040363391
STAT,1831,34,45-49,1865,1.3955486452738906
STAT,1841,49,25-29,1890,0.03858659563729415
SIM,1906,34,na,1940,3338
STAT,1924,11,na,1935,4464.525966896704
STAT,1846,51,30-34,1897,0.004217059642054132
STAT,1922,30,40-44,1952,4.2109164369900665
SIM,1884,48,na,1932,2191
STAT,1876,45,30-34,1921,0.0953458972150918
STAT,1899,40,50-100,1939,0.09593401363614626
STAT,1890,32,35-39,1922,11.697034813412639
STAT,1784,83,na,1867,106.21367647317655
STAT,1878,41,25-29,1919,0.6343884840332427
STAT,1827,51,50-100,1878,0.013029524043177301
SIM,1837,27,30-34,1864,26
STAT,1942,24,50-100,1966,0.6512711615859482
SIM,1889,29,45-49,1918,1
STAT,1831,40,30-34,1871,0.8991848594882594
STAT,1816,44,20-24,1860,0.43663185869719884
STAT,1918,30,25-29,1948,9.352735124184289
STAT,1847,93,na,1940,21.50371444892152
STAT,1862,60,na,1922,1536.8775331506881
STAT,1869,29,na,1898,2166.7271763587305
STAT,1904,42,40-44,1946,0.21135515301525667
STAT,1854,44,40-44,1898,1.5978277649614585
SIM,1883,85,na,1968,484
SIM,1777,80,na,1857,176
STAT,1879,23,50-100,1902,0.40142109635253687
SIM,1855,15,30-34,1870,1
STAT,1843,57,na,1900,1449.8591104852019
STAT,1813,46,45-49,1859,0.726088978390205
STAT,1866,85,na,1951,238.76808275360344
STAT,1892,45,15-19,1937,2.6958664726169025E-4
STAT,1844,54,25-29,1898,0.0024181477513609845
STAT,1870,1,na,1871,3259.934561975418
SIM,1911,30,30-34,1941,17
SIM,1875,34,na,1909,2254
STAT,1835,44,30-34,1879,0.8377490791322211
STAT,1944,20,25-29,1964,94.27913114772154
SIM,1843,24,na,1867,1869
STAT,1881,38,15-19,1919,0.050966988949915734
STAT,1919,42,35-39,1961,0.20614839085442052
STAT,1868,46,35-39,1914,0.12663530810699894
SIM,1850,41,45-49,1891,2
STAT,1896,51,na,1947,2701.2357330054947
SIM,1820,34,35-39,1854,9
SIM,1899,47,na,1946,2895
STAT,1878,16,20-24,1894,17.47799004674919
STAT,1880,37,45-49,1917,1.9815226420112888
STAT,1899,17,45-49,1916,0.08456739486224739
STAT,1897,36,na,1933,2990.9041892279683
STAT,1845,18,50-100,1863,0.043359419756408085
SIM,1816,76,na,1892,360
STAT,1873,47,20-24,1920,0.011453254604025838
STAT,1851,49,35-39,1900,0.10052074900075408
STAT,1845,16,na,1861,2055.686404472876
STAT,1897,41,35-39,1938,0.1595890669230419
SIM,1912,42,40-44,1954,1
STAT,1768,98,na,1866,0.3300166602046829
STAT,1887,46,45-49,1933,0.25004108269504227
SIM,1831,41,35-39,1872,4
SIM,1941,11,na,1952,3712
STAT,1903,3,na,1906,3553.1416793187686
SIM,1868,29,25-29,1897,34
STAT,1918,19,30-34,1937,12.465548097511151
STAT,1813,52,30-34,1865,0.01718522029502884
STAT,1859,17,15-19,1876,5.193612780444614
SIM,1878,28,30-34,1906,28
SIM,1893,2,na,1895,3287
STAT,1934,31,20-24,1965,3.147853262714519
SIM,1843,44,30-34,1887,4
STAT,1849,19,na,1868,2012.6791028976081
STAT,1842,41,45-49,1883,1.1168790867503708
STAT,1870,48,40-44,1918,0.1564833777905055
SIM,1906,12,na,1918,3631
STAT,1847,15,30-34,1862,1.4811049495408786
STAT,1893,33,na,1926,2848.2003016702943
SIM,1864,93,na,1957,40
STAT,1865,54,45-49,1919,0.012115517144474225
STAT,1903,30,30-34,1933,23.65506387145217
SIM,1845,68,na,1913,1119
SIM,1813,58,na,1871,1053
SIM,1787,78,na,1865,279
STAT,1891,3,na,1894,3091.227887484796
SIM,1924,38,25-29,1962,1
STAT,1918,33,30-34,1951,15.748960104474287
STAT,1896,29,na,1925,2958.355008952765
STAT,1930,18,na,1948,4483.919148830564
SIM,1910,23,25-29,1933,84
SIM,1872,59,na,1931,1846
STAT,1832,46,20-24,1878,0.008712861827420761
STAT,1812,48,45-49,1860,0.7640171888561195
SIM,1912,31,35-39,1943,9
SIM,1843,20,35-39,1863,6
STAT,1892,15,na,1907,3001.690990477047
SIM,1846,21,15-19,1867,3
SIM,1857,33,40-44,1890,3
STAT,1770,105,na,1875,0.014654330969952853
SIM,1918,27,45-49,1945,2
STAT,1854,15,20-24,1869,15.452936128086794
STAT,1900,28,20-24,1928,15.32099678564291
STAT,1873,56,na,1929,1955.8220424017336
STAT,1921,43,30-34,1964,0.13582824332085683
SIM,1944,24,35-39,1968,12
STAT,1925,36,25-29,1961,1.117543955620538
STAT,1911,16,30-34,1927,2.309338856204683
STAT,1845,9,na,1854,2169.0
STAT,1844,30,50-100,1874,0.7853158710235996
STAT,1936,24,35-39,1960,8.496906684241177
STAT,1903,16,na,1919,3402.83506871957
STAT,1792,103,na,1895,0.024168065040429516
STAT,1845,37,na,1882,1743.628154049229
STAT,1916,38,25-29,1954,0.9477735551644776
STAT,1904,46,35-39,1950,0.10729640101270967
SIM,1832,94,na,1926,4
STAT,1892,47,30-34,1939,0.06429487891420385
STAT,1838,21,15-19,1859,2.9403371070862083
SIM,1845,57,na,1902,1416
STAT,1928,26,50-100,1954,1.1625314488461718
SIM,1910,18,30-34,1928,1
STAT,1902,23,25-29,1925,76.08106218976106
STAT,1913,37,45-49,1950,0.6354072484482358
STAT,1907,45,20-24,1952,0.009485395722160549
STAT,1881,49,50-100,1930,0.21934514037842434
STAT,1867,24,45-49,1891,0.6146524996050883
STAT,1927,31,30-34,1958,18.321478868899263
STAT,1930,34,40-44,1964,4.7650799541434035
STAT,1933,35,20-24,1968,0.3397871641874235
STAT,1805,72,na,1877,564.3509219286495
STAT,1809,86,na,1895,93.20629718157554
STAT,1861,48,40-44,1909,0.1326148896991524
SIM,1837,23,15-19,1860,1
STAT,1822,64,na,1886,916.3279959783447
STAT,1812,101,na,1913,0.24542425442692828
SIM,1866,26,45-49,1892,3
SIM,1840,38,na,1878,1699
STAT,1792,80,na,1872,230.09352648939594
STAT,1796,94,na,1890,4.656205936973044
STAT,1803,81,na,1884,207.1627704707937
STAT,1922,35,45-49,1957,0.7341284327910329
STAT,1828,69,na,1897,833.0898943719275
SIM,1905,18,20-24,1923,24
SIM,1867,19,15-19,1886,5
SIM,1930,35,45-49,1965,1
STAT,1815,49,25-29,1864,0.13561888435529293
STAT,1876,22,45-49,1898,0.6800666280868466
SIM,1926,33,30-34,1959,20
SIM,1909,36,35-39,1945,9
SIM,1921,37,45-49,1958,3
STAT,1865,37,na,1902,2022.4764304825674
STAT,1904,31,35-39,1935,13.77645325061518
STAT,1837,18,na,1855,1918.449915172053
SIM,1830,28,na,1858,1783
SIM,1863,86,na,1949,152
STAT,1894,18,na,1912,3061.1265257056343
SIM,1838,20,25-29,1858,48
STAT,1843,26,na,1869,1934.6144251426201
STAT,1852,44,50-100,1896,0.7918284876823081
SIM,1920,30,30-34,1950,20
STAT,1927,26,35-39,1953,17.30379576628338
STAT,1921,45,na,1966,3931.2192771573386
STAT,1938,6,na,1944,3734.6197917727723
SIM,1939,19,30-34,1958,15
STAT,1898,19,50-100,1917,0.06231614347416461
STAT,1913,26,na,1939,3537.5452054549137
SIM,1926,26,40-44,1952,6
STAT,1851,45,na,1896,1666.2934688679263
STAT,1903,17,35-39,1920,0.7374832259503977
STAT,1944,23,30-34,1967,29.305551960166344
STAT,1869,5,na,1874,2561.8001325227883
SIM,1908,37,30-34,1945,3
SIM,1899,32,35-39,1931,17
STAT,1904,39,45-49,1943,0.5770815522035616
SIM,1855,67,na,1922,1191
STAT,1863,51,50-100,1914,0.012601534781087692
STAT,1823,81,na,1904,284.57088416804567
STAT,1938,21,50-100,1959,0.6153333886129198
STAT,1934,29,30-34,1963,49.74456894727896
SIM,1942,29,30-34,1971,43
STAT,1883,30,50-100,1913,0.8551405533993299
SIM,1804,75,na,1879,358
SIM,1808,89,na,1897,36
SIM,1900,28,na,1928,3097
SIM,1793,86,na,1879,54
SIM,1912,44,40-44,1956,2
STAT,1902,18,30-34,1920,2.11929696069045
SIM,1887,22,15-19,1909,8
SIM,1912,29,na,1941,3299
STAT,1930,41,30-34,1971,0.1591467788470444
STAT,1879,22,15-19,1901,3.257562162712873
STAT,1841,39,25-29,1880,2.2732526554627097
STAT,1842,49,50-100,1891,0.1712431796234763
STAT,1913,44,35-39,1957,0.18484953059054726
STAT,1835,20,35-39,1855,6.487721090450932
STAT,1924,39,15-19,1963,0.021348310839016876
SIM,1800,93,na,1893,4
STAT,1945,22,35-39,1967,9.748942572414968
STAT,1914,40,35-39,1954,0.18978001741851636
STAT,1942,28,25-29,1970,65.22671003380887
STAT,1818,59,na,1877,1089.9033356928946
SIM,1935,26,35-39,1961,24
STAT,1853,49,45-49,1902,0.17136517595309333
STAT,1835,52,50-100,1887,0.009603207418653547
STAT,1930,21,35-39,1951,11.430293558461
STAT,1939,32,50-100,1971,0.796846808797662
STAT,1788,75,na,1863,394.71626348112346
STAT,1904,44,40-44,1948,0.20875927211751108
SIM,1933,36,25-29,1969,1
SIM,1953,11,na,1964,4360
STAT,1846,16,25-29,1862,5.048834976217115
STAT,1910,24,15-19,1934,4.691546356411806
STAT,1814,45,na,1859,1299.90267403633
STAT,1910,42,15-19,1952,0.0013706724487664158
STAT,1817,108,na,1925,8.12302034804742E-4
STAT,1849,33,40-44,1882,3.259856378329407
STAT,1929,29,20-24,1958,21.56170765357121
SIM,1909,34,40-44,1943,4
SIM,1929,29,15-19,1958,3
STAT,1881,75,na,1956,972.4231033254953
SIM,1837,21,20-24,1858,64
SIM,1854,16,25-29,1870,4
STAT,1952,18,40-44,1970,1.5830265097901508
STAT,1833,24,50-100,1857,0.3329631010551457
SIM,1907,30,na,1937,3410
STAT,1939,25,15-19,1964,0.6709533023502466
STAT,1820,47,40-44,1867,0.2822837240954754
STAT,1907,47,15-19,1954,3.115990252644121E-4
SIM,1887,15,25-29,1902,7
STAT,1884,41,50-100,1925,0.9907023002580729
STAT,1918,26,40-44,1944,4.702010062020529
STAT,1918,42,50-100,1960,0.1179957571063194
STAT,1852,94,na,1946,15.184869185273715
STAT,1930,36,35-39,1966,2.9833175233183153
STAT,1864,49,20-24,1913,0.009920186766529808
STAT,1902,31,50-100,1933,1.2264828510214185
STAT,1877,38,na,1915,2298.1487804965354
STAT,1899,27,45-49,1926,1.4374133789795287
SIM,1906,16,15-19,1922,8
STAT,1859,30,45-49,1889,1.3338618847010995
STAT,1899,32,40-44,1931,5.614371600485039
SIM,1923,16,15-19,1939,40
SIM,1927,32,35-39,1959,11
STAT,1860,38,na,1898,1799.852493847485
STAT,1892,47,na,1939,2649.661048888392
STAT,1920,32,30-34,1952,16.303685729854312
SIM,1836,25,20-24,1861,15
STAT,1935,34,50-100,1969,1.07915123194714
STAT,1912,38,40-44,1950,1.3731102509837805
SIM,1864,5,na,1869,2541
STAT,1929,37,50-100,1966,0.5092421217894147
SIM,1783,96,na,1879,1
SIM,1858,32,45-49,1890,1
SIM,1934,27,30-34,1961,47
STAT,1895,16,20-24,1911,21.909407791330295
SIM,1776,94,na,1870,3
STAT,1925,43,15-19,1968,0.0017538548250683947
STAT,1852,19,na,1871,2084.5437404925938
STAT,1908,39,30-34,1947,1.59544474188561
STAT,1825,92,na,1917,23.548333855529226
STAT,1810,45,30-34,1855,0.3559867322983201
SIM,1920,38,40-44,1958,1
SIM,1898,34,40-44,1932,6
SIM,1860,58,na,1918,1635
STAT,1834,22,40-44,1856,1.725072706186938
SIM,1886,16,20-24,1902,18
STAT,1915,16,15-19,1931,8.994352684185056
STAT,1877,28,50-100,1905,0.6248939126242622
SIM,1869,71,na,1940,1161
STAT,1823,35,50-100,1858,2.194402004918048
STAT,1869,29,25-29,1898,38.40550834309753
STAT,1943,27,30-34,1970,39.420270800811686
SIM,1836,76,na,1912,580
SIM,1867,30,45-49,1897,1
STAT,1917,41,15-19,1958,0.001516102159572546
SIM,1887,20,20-24,1907,67
STAT,1903,22,30-34,1925,23.940297311494906
STAT,1888,34,50-100,1922,1.0137847682529992
STAT,1874,18,na,1892,2432.1633474885566
STAT,1927,19,45-49,1946,0.5836853501600155
STAT,1912,30,30-34,1942,14.759833172830444
STAT,1926,27,30-34,1953,44.37813913554089
STAT,1776,102,na,1878,0.07005710793195688
STAT,1929,41,na,1970,4550.475008971198
STAT,1935,28,35-39,1963,19.323315022259916
STAT,1947,17,20-24,1964,144.28261424681494
STAT,1874,46,50-100,1920,0.2378078127427574
SIM,1907,50,na,1957,3068
STAT,1938,29,15-19,1967,0.6599789804594218
STAT,1880,43,50-100,1923,1.0425257390087808
STAT,1875,67,na,1942,1538.5141800167914
SIM,1920,48,na,1968,3756
STAT,1918,28,35-39,1946,15.040587664408358
STAT,1884,28,na,1912,2220.0719778814273
STAT,1928,40,35-39,1968,0.24320528824636226
STAT,1868,65,na,1933,1524.3073757077825
STAT,1887,17,25-29,1904,5.986878902607667
SIM,1824,95,na,1919,4
STAT,1908,44,25-29,1952,0.06163244742541748
SIM,1902,24,30-34,1926,33
SIM,1910,18,na,1928,3534
STAT,1859,19,15-19,1878,5.132612199224918
STAT,1919,32,35-39,1951,9.313963334670426
SIM,1919,31,na,1950,3869
SIM,1943,28,35-39,1971,17
SIM,1935,31,30-34,1966,23
STAT,1908,43,15-19,1951,0.0013338590546382784
STAT,1883,86,na,1969,462.66786224504455
STAT,1841,38,50-100,1879,0.9794748218147855
STAT,1849,18,45-49,1867,0.05761512980942752
SIM,1957,2,na,1959,4701
STAT,1834,41,50-100,1875,0.7985118703763213
SIM,1795,77,na,1872,331
SIM,1877,16,20-24,1893,19
SIM,1888,30,na,1918,2623
SIM,1882,89,na,1971,277
STAT,1934,34,25-29,1968,11.905756799024875
SIM,1948,9,na,1957,4016
STAT,1917,34,25-29,1951,9.064537510258747
SIM,1901,25,25-29,1926,58
STAT,1883,22,na,1905,2189.72072162215
STAT,1895,67,na,1962,2121.4821918049147
SIM,1828,26,25-29,1854,48
SIM,1929,27,20-24,1956,21
STAT,1903,15,40-44,1918,0.24696990782354503
SIM,1866,31,40-44,1897,8
SIM,1878,22,20-24,1900,73
SIM,1925,29,30-34,1954,51
SIM,1901,45,na,1946,3051
STAT,1828,39,50-100,1867,1.1155820599121586
STAT,1944,26,35-39,1970,15.335821234292018
SIM,1870,88,na,1958,138
STAT,1927,24,40-44,1951,3.889424712483479
STAT,1839,45,50-100,1884,0.17117997787400066
SIM,1823,58,na,1881,1095
SIM,1878,24,15-19,1902,3
STAT,1858,26,45-49,1884,0.8490414757206485
SIM,1862,15,20-24,1877,14
STAT,1823,48,20-24,1871,0.014109811963522123
STAT,1907,36,50-100,1943,0.3694449240281133
SIM,1919,1,na,1920,4277
STAT,1933,37,15-19,1970,0.02470990672060541
STAT,1947,19,15-19,1966,48.26563956807897
SIM,1845,15,20-24,1860,15
STAT,1868,20,45-49,1888,0.6380982387243813
SIM,1882,69,na,1951,1295
SIM,1842,22,40-44,1864,1
STAT,1944,24,40-44,1968,3.427174058627957
SIM,1925,34,25-29,1959,16
STAT,1869,16,20-24,1885,16.533494442899514
STAT,1861,55,na,1916,1622.073032004981
SIM,1926,28,35-39,1954,23
STAT,1950,22,15-19,1972,5.96617173766511
STAT,1930,37,45-49,1967,0.8400760410634454
SIM,1935,24,40-44,1959,4
STAT,1890,39,20-24,1929,0.8813902988303394
STAT,1909,38,35-39,1947,2.151519428649355
SIM,1920,8,na,1928,4146
STAT,1944,19,45-49,1963,0.5074988000655111
SIM,1879,21,25-29,1900,56
SIM,1909,33,30-34,1942,14
SIM,1900,26,20-24,1926,14
SIM,1877,90,na,1967,164
STAT,1845,92,na,1937,29.33707020125761
SIM,1902,19,35-39,1921,1
SIM,1930,32,40-44,1962,10
STAT,1840,48,20-24,1888,0.008320087960954625
SIM,1828,89,na,1917,56
SIM,1876,20,45-49,1896,2
SIM,1899,33,45-49,1932,2
STAT,1927,15,50-100,1942,0.4421691907917567
STAT,1910,25,25-29,1935,60.94656585937111
STAT,1953,16,35-39,1969,4.796723568122427
STAT,1837,73,na,1910,749.7780188738742
STAT,1858,31,40-44,1889,3.2498079030036204
SIM,1811,77,na,1888,314
SIM,1851,7,na,1858,2235
SIM,1916,39,30-34,1955,1
STAT,1911,15,na,1926,3667.316026388826
STAT,1938,27,20-24,1965,17.082077718871002
SIM,1884,21,35-39,1905,10
STAT,1851,110,na,1961,5.94682502701989E-4
SIM,1906,24,15-19,1930,4
STAT,1922,32,40-44,1954,4.177338397303716
SIM,1951,19,30-34,1970,17
STAT,1925,33,20-24,1958,2.7349430150036893
SIM,1831,77,na,1908,470
SIM,1860,20,35-39,1880,5
SIM,1863,21,15-19,1884,1
SIM,1861,43,na,1904,1976
SIM,1869,17,25-29,1886,3
STAT,1878,39,50-100,1917,1.195274507732649
STAT,1863,50,50-100,1913,0.012721755369327842
STAT,1870,54,50-100,1924,0.0135957094285523
STAT,1896,49,50-100,1945,0.16935873417980532
STAT,1835,21,45-49,1856,0.5825243250229845
STAT,1838,35,na,1873,1799.6225904264918
STAT,1882,37,20-24,1919,0.7086028939985345
SIM,1904,37,45-49,1941,2
STAT,1798,108,na,1906,5.080502511389028E-4
STAT,1898,30,50-100,1928,1.1811379389520418
STAT,1904,33,na,1937,3246.770914492672
STAT,1922,34,35-39,1956,9.70721370993994
STAT,1874,73,na,1947,1146.812643057183
STAT,1878,24,20-24,1902,67.34790057908486
STAT,1915,49,15-19,1964,3.485753592704414E-4
STAT,1940,23,45-49,1963,1.0823471955066089
SIM,1920,20,30-34,1940,33
STAT,1862,29,50-100,1891,0.5118040360573005
STAT,1879,19,40-44,1898,0.17963580344884517
SIM,1784,81,na,1865,131
SIM,1886,24,20-24,1910,72
SIM,1842,60,na,1902,1313
SIM,1846,74,na,1920,728
STAT,1912,46,40-44,1958,0.14346345862104695
STAT,1859,22,45-49,1881,0.5454604667845135
STAT,1863,66,na,1929,1361.0562878002545
SIM,1935,26,na,1961,4814
STAT,1804,55,na,1859,1106.8179547388581
STAT,1904,21,35-39,1925,7.929912302160304
STAT,1808,69,na,1877,741.5483767637431
STAT,1901,34,15-19,1935,0.18669162723738586
SIM,1829,51,na,1880,1298
STAT,1830,36,45-49,1866,1.603674809966503
STAT,1855,21,15-19,1876,2.7493405850819914
SIM,1875,21,40-44,1896,2
STAT,1911,17,40-44,1928,0.26435684385079666
SIM,1837,24,25-29,1861,55
STAT,1934,23,50-100,1957,0.8350684719417338
SIM,1903,23,35-39,1926,9
SIM,1910,20,20-24,1930,100
STAT,1815,46,20-24,1861,0.029688551868581388
STAT,1841,54,20-24,1895,4.909944110013931E-4
STAT,1857,18,na,1875,1997.4550948572514
SIM,1869,16,na,1885,2370
STAT,1849,36,45-49,1885,1.485662221164981
STAT,1814,101,na,1915,0.23543698347879247
SIM,1799,59,na,1858,970
SIM,1921,36,35-39,1957,8
STAT,1880,58,na,1938,1965.7287778634613
STAT,1924,47,15-19,1971,4.1433567179839176E-4
SIM,1825,92,na,1917,10
STAT,1896,15,25-29,1911,7.10796490270469
SIM,1900,34,20-24,1934,2
SIM,1910,22,15-19,1932,3
SIM,1942,26,25-29,1968,64
STAT,1917,3,na,1920,4109.688265031422
STAT,1847,20,25-29,1867,52.38539342971178
STAT,1910,32,15-19,1942,0.11701847769030319
STAT,1826,30,35-39,1856,15.283624667622444
STAT,1921,46,35-39,1967,0.13765917283914267
SIM,1851,20,40-44,1871,5
STAT,1912,20,30-34,1932,26.17020941914611
SIM,1895,17,25-29,1912,8
STAT,1774,83,na,1857,117.144228058897
STAT,1852,39,na,1891,1771.990686417401
STAT,1815,62,na,1877,953.7215976181261
STAT,1859,25,50-100,1884,0.4977261066467237
STAT,1854,18,25-29,1872,4.852594230051369
STAT,1893,32,na,1925,2860.270643787077
STAT,1917,29,30-34,1946,38.53973635518169
STAT,1853,56,na,1909,1512.6085618908094
STAT,1887,24,50-100,1911,0.4281320838984698
STAT,1923,16,na,1939,4093.438515840381
STAT,1924,32,15-19,1956,0.14164515862136512
SIM,1906,13,na,1919,3626
STAT,1901,19,25-29,1920,7.452857453435893
SIM,1930,34,35-39,1964,12
STAT,1938,19,20-24,1957,126.24129086560158
SIM,1865,57,na,1922,1712
STAT,1840,93,na,1933,20.35305244688418
STAT,1948,19,30-34,1967,13.169656351998954
STAT,1902,40,15-19,1942,0.0012913664658071732
STAT,1897,46,na,1943,2851.083739137032
STAT,1930,33,30-34,1963,19.197180337057183
STAT,1824,39,25-29,1863,3.9174541586373572
STAT,1871,37,45-49,1908,1.8669869213277912
STAT,1896,22,15-19,1918,4.118937759507118
STAT,1798,65,na,1863,795.0738274860911
STAT,1913,36,35-39,1949,2.2652853997932265
STAT,1768,99,na,1867,0.20202959904410278
STAT,1850,47,25-29,1897,0.04036148445062191
SIM,1855,20,25-29,1875,45
STAT,1830,54,45-49,1884,0.008991785364175947
SIM,1847,60,na,1907,1334
SIM,1878,25,25-29,1903,48
STAT,1921,39,45-49,1960,0.7176254812471982
SIM,1867,68,na,1935,1304
SIM,1926,29,45-49,1955,4
STAT,1810,63,na,1873,938.3197784551226
STAT,1914,33,45-49,1947,1.4897820429276432
STAT,1768,111,na,1879,7.239725330553658E-4
STAT,1846,23,15-19,1869,2.849418792554331
SIM,1946,19,20-24,1965,126
STAT,1887,48,na,1935,2347.08250998374
SIM,1805,92,na,1897,12
STAT,1916,37,15-19,1953,0.018577089859794185
SIM,1925,31,50-100,1956,1
SIM,1844,95,na,1939,7
STAT,1904,47,45-49,1951,0.17951816009416202
SIM,1899,46,na,1945,2913
SIM,1916,36,25-29,1952,1
STAT,1831,54,50-100,1885,0.009388808741000919
SIM,1926,36,35-39,1962,7
STAT,1772,105,na,1877,0.01722397998833109
STAT,1764,115,na,1879,1.334765384539156E-4
SIM,1936,22,35-39,1958,15
STAT,1817,73,na,1890,526.7246109788575
STAT,1860,15,45-49,1875,0.05852875180034169
STAT,1908,46,50-100,1954,0.19464829098779374
STAT,1876,84,na,1960,459.89766089420397
STAT,1934,33,15-19,1967,0.16564223359025942
STAT,1918,29,45-49,1947,1.724422038809706
SIM,1849,26,45-49,1875,4
SIM,1956,15,15-19,1971,48
STAT,1843,20,40-44,1863,1.9144360537051195
STAT,1917,31,50-100,1948,0.8212068889816474
SIM,1854,23,15-19,1877,1
SIM,1901,24,15-19,1925,7
STAT,1784,93,na,1877,5.54095515918036
SIM,1884,16,na,1900,2470
STAT,1928,22,35-39,1950,11.10714957379642
SIM,1832,39,25-29,1871,1
STAT,1943,19,30-34,1962,12.201790721623215
SIM,1883,86,na,1969,424
STAT,1921,31,35-39,1952,9.647239144257098
STAT,1852,20,35-39,1872,5.3434084604206245
SIM,1912,21,35-39,1933,10
STAT,1891,48,25-29,1939,0.03751480170091394
STAT,1916,46,25-29,1962,0.051524597241499236
SIM,1902,21,25-29,1923,79
SIM,1925,16,na,1941,4130
SIM,1833,56,na,1889,1241
STAT,1867,32,45-49,1899,1.5467711246258118
SIM,1835,27,na,1862,1749
SIM,1857,36,45-49,1893,1
SIM,1918,26,35-39,1944,23
SIM,1846,43,na,1889,1623
SIM,1901,28,30-34,1929,32
SIM,1933,33,20-24,1966,3
SIM,1838,46,50-100,1884,5
SIM,1788,95,na,1883,3
STAT,1832,49,25-29,1881,0.036621116461159335
STAT,1907,35,50-100,1942,0.37116713955565156
STAT,1918,36,35-39,1954,2.419950825670555
STAT,1908,36,25-29,1944,0.8748604107189181
STAT,1841,36,20-24,1877,0.6278766495537657
STAT,1831,88,na,1919,83.72446336432532
SIM,1922,33,45-49,1955,2
STAT,1828,80,na,1908,351.1625776930822
STAT,1834,21,na,1855,1782.70338180387
SIM,1888,74,na,1962,1467
STAT,1829,31,15-19,1860,0.1427087527566449
STAT,1851,33,50-100,1884,0.6921012841308661
SIM,1917,32,25-29,1949,14
STAT,1901,27,25-29,1928,55.934616941303524
STAT,1932,39,20-24,1971,0.33389216336267635
STAT,1872,24,50-100,1896,0.38424719826401943
STAT,1871,54,35-39,1925,0.007841037484659077
STAT,1818,90,na,1908,38.01089169702369
STAT,1918,25,30-34,1943,39.6590284007053
STAT,1877,18,20-24,1895,17.334045830538344
SIM,1817,62,na,1879,1025
SIM,1921,28,50-100,1949,2
SIM,1896,20,15-19,1916,4
STAT,1895,19,25-29,1914,6.948477450590927
SIM,1810,83,na,1893,156
SIM,1893,1,na,1894,3313
STAT,1913,28,50-100,1941,0.9334118020270722
STAT,1855,27,50-100,1882,0.4722329087111471
SIM,1847,48,na,1895,1586
SIM,1876,29,na,1905,2356
STAT,1828,28,25-29,1856,61.53150088138529
STAT,1926,28,40-44,1954,5.260509046010671
SIM,1836,28,25-29,1864,36
SIM,1934,28,40-44,1962,10
STAT,1850,29,25-29,1879,34.54401269205347
STAT,1886,74,na,1960,1257.9888503670222
STAT,1922,42,35-39,1964,0.2183609966652448
STAT,1833,36,na,1869,1642.3329749673796
STAT,1879,15,25-29,1894,5.621507017797865
STAT,1882,60,na,1942,1753.1750488672526
STAT,1924,28,50-100,1952,1.0910753658112833
STAT,1901,26,15-19,1927,0.6019837337140911
SIM,1870,24,na,1894,2183
STAT,1849,15,40-44,1864,0.16420688180624865
STAT,1888,20,15-19,1908,3.7037117017319385
SIM,1876,40,50-100,1916,2
SIM,1903,15,35-39,1918,2
STAT,1869,51,na,1920,1978.3563697575587
STAT,1828,89,na,1917,59.63641567280648
STAT,1870,0,na,1870,3455.5168136266884
SIM,1896,35,50-100,1931,4
STAT,1875,23,40-44,1898,2.0161664445783516
STAT,1927,30,na,1957,4400.52690684312
SIM,1871,41,na,1912,2247
STAT,1904,36,40-44,1940,1.286259737338497
SIM,1918,34,35-39,1952,13
STAT,1944,16,40-44,1960,1.4223477900441075
STAT,1948,15,15-19,1963,49.09426702093113
STAT,1924,37,20-24,1961,0.293679252881622
SIM,1952,16,40-44,1968,2
SIM,1849,41,35-39,1890,3
SIM,1914,16,20-24,1930,22
STAT,1856,47,20-24,1903,0.00883733512288248
STAT,1898,1,na,1899,3480.796166968253
STAT,1826,34,na,1860,1567.9902151956812
STAT,1869,19,25-29,1888,5.191915573272598
STAT,1936,17,45-49,1953,0.45172725232067745
STAT,1909,32,25-29,1941,8.330002471121864
SIM,1862,18,25-29,1880,4
SIM,1932,28,50-100,1960,3
SIM,1845,23,20-24,1868,63
SIM,1868,101,na,1969,1
STAT,1920,44,25-29,1964,0.07426107703925722
SIM,1925,31,20-24,1956,3
STAT,1967,2,na,1969,4642.713521722186
SIM,1824,75,na,1899,569
STAT,1869,26,20-24,1895,10.764485244803424
STAT,1820,39,40-44,1859,8.728707134416931
STAT,1940,30,35-39,1970,8.943962694264599
STAT,1837,22,50-100,1859,0.33699296572410464
STAT,1837,23,20-24,1860,56.53954547706497
SIM,1876,73,na,1949,1137
STAT,1906,16,20-24,1922,24.44742460731712
STAT,1867,31,35-39,1898,9.019421474940119
STAT,1896,0,na,1896,3666.110697673788
SIM,1922,32,35-39,1954,12
STAT,1846,47,50-100,1893,0.1723584872120476
SIM,1926,18,40-44,1944,2
STAT,1902,30,15-19,1932,0.19137657277058354
SIM,1969,0,na,1969,4467
STAT,1843,108,na,1951,0.001321506859493181
STAT,1923,18,15-19,1941,50.21603204459963
SIM,1899,30,40-44,1929,8
STAT,1869,82,na,1951,426.66014161408293
SIM,1941,10,na,1951,3719
SIM,1945,24,na,1969,3665
STAT,1934,26,25-29,1960,83.6830828741605
SIM,1911,25,35-39,1936,11
SIM,1907,3,na,1910,3725
STAT,1916,45,15-19,1961,3.586019152481501E-4
STAT,1780,79,na,1859,224.74386258402637
STAT,1845,47,45-49,1892,0.16545900637724004
SIM,1869,27,25-29,1896,40
STAT,1940,28,na,1968,3606.6814886637044
SIM,1931,18,15-19,1949,56
STAT,1939,31,na,1970,3647.1813537707585
STAT,1779,82,na,1861,154.53929599706672
STAT,1869,19,na,1888,2313.9866188496385
STAT,1791,95,na,1886,2.4750777578149172
STAT,1846,54,na,1900,1476.3914061974438
STAT,1886,48,45-49,1934,0.23259751421514702
STAT,1863,21,20-24,1884,58.788421722642575
STAT,1910,22,20-24,1932,98.6179123683626
STAT,1903,25,35-39,1928,13.056461189830372
SIM,1849,34,45-49,1883,1
STAT,1914,32,35-39,1946,8.688419394746992
SIM,1825,30,40-44,1855,2
STAT,1862,92,na,1954,33.5626733482337
SIM,1852,39,na,1891,1792
STAT,1858,55,na,1913,1533.4776156918128
SIM,1926,25,30-34,1951,48
STAT,1830,53,35-39,1883,0.0054408367470893575
STAT,1888,35,50-100,1923,1.3831860949580475
SIM,1918,14,na,1932,4029
STAT,1834,25,45-49,1859,0.9142819584259474
STAT,1884,21,40-44,1905,1.9511914045600753
SIM,1782,79,na,1861,242
SIM,1839,41,na,1880,1708
SIM,1934,35,30-34,1969,8
SIM,1837,93,na,1930,13
STAT,1803,61,na,1864,923.8067149462473
STAT,1933,0,na,1933,5697.288250189494
STAT,1903,18,45-49,1921,0.08756558138313271
SIM,1841,75,na,1916,688
STAT,1926,35,30-34,1961,2.108120601188683
SIM,1892,21,40-44,1913,3
SIM,1853,56,na,1909,1625
STAT,1906,49,20-24,1955,0.009117080228049065
SIM,1827,60,na,1887,1024
STAT,1904,43,30-34,1947,0.10738139411914834
SIM,1840,58,na,1898,1364
SIM,1842,25,45-49,1867,4
SIM,1906,33,na,1939,3350
STAT,1903,43,35-39,1946,0.16778674566215387
SIM,1872,91,na,1963,108
STAT,1908,33,20-24,1941,2.165358496307614
SIM,1902,51,na,1953,2889
STAT,1808,60,na,1868,1037.2410849464009
STAT,1852,21,45-49,1873,0.6339359806458401
STAT,1838,18,40-44,1856,0.16380626264143863
STAT,1824,54,20-24,1878,8.023816358795496E-4
SIM,1920,23,35-39,1943,10
STAT,1841,78,na,1919,534.5812566308257
SIM,1828,34,na,1862,1553
SIM,1821,36,45-49,1857,1
SIM,1923,24,15-19,1947,7
STAT,1905,32,40-44,1937,3.3994318884231625
STAT,1837,31,20-24,1868,2.161763625148128
SIM,1879,24,30-34,1903,23
SIM,1934,24,25-29,1958,127
STAT,1837,33,15-19,1870,0.11154931937001215
STAT,1870,68,na,1938,1414.6058462523597
SIM,1807,63,na,1870,843
STAT,1834,30,40-44,1864,3.510662232940515
STAT,1909,39,45-49,1948,0.6032899837484665
STAT,1878,27,25-29,1905,41.60143915331718
STAT,1877,90,na,1967,217.71995892586142
SIM,1887,68,na,1955,1519
STAT,1935,17,30-34,1952,15.740467145957489
STAT,1926,24,25-29,1950,105.36001608002826
SIM,1914,7,na,1921,4195
SIM,1858,55,na,1913,1669
SIM,1913,32,40-44,1945,4
SIM,1898,42,40-44,1940,2
STAT,1935,36,35-39,1971,3.197869598423154
SIM,1904,36,35-39,1940,7
STAT,1821,53,40-44,1874,0.015149296224266286
STAT,1943,21,20-24,1964,111.79274037628625
SIM,1930,31,30-34,1961,19
STAT,1871,47,45-49,1918,0.21999382828585368
STAT,1931,18,20-24,1949,167.20497929525044
STAT,1847,49,20-24,1896,0.008645112256785032
SIM,1900,18,20-24,1918,18
SIM,1850,49,50-100,1899,2
STAT,1844,48,40-44,1892,0.11867385581965534
SIM,1871,21,20-24,1892,61
STAT,1950,19,20-24,1969,151.3497003385478
SIM,1891,50,na,1941,2652
STAT,1917,45,30-34,1962,0.08837376569789339
STAT,1915,24,15-19,1939,5.165166427694176
SIM,1895,64,na,1959,2274
STAT,1912,23,35-39,1935,8.496432320531618
STAT,1836,49,45-49,1885,0.15201866051614651
STAT,1918,18,40-44,1936,1.434417437479793
SIM,1847,17,na,1864,2039
STAT,1836,108,na,1944,0.0011567133592187435
STAT,1922,31,30-34,1953,16.886786825557436
SIM,1839,20,40-44,1859,2
STAT,1864,20,25-29,1884,49.82321495648396
STAT,1929,37,20-24,1966,0.31973206001851007
STAT,1945,27,na,1972,3882.5797782170066
STAT,1910,16,15-19,1926,8.513556345075296
SIM,1852,30,50-100,1882,3
SIM,1877,19,25-29,1896,6
STAT,1891,45,20-24,1936,0.007993946283982712
SIM,1845,26,na,1871,1862
SIM,1809,75,na,1884,435
STAT,1912,41,35-39,1953,0.18448499152888997
STAT,1854,16,50-100,1870,0.04245186600657859
STAT,1923,23,45-49,1946,1.2330664366470008
SIM,1805,61,na,1866,941
SIM,1916,33,20-24,1949,5
SIM,1923,36,na,1959,4022
SIM,1931,23,45-49,1954,1
STAT,1805,49,15-19,1854,0.0011838941122240608
STAT,1920,40,30-34,1960,0.13376539340496524
SIM,1918,1,na,1919,4177
STAT,1891,45,50-100,1936,0.16360942746778745
STAT,1783,99,na,1882,0.2921148894811131
STAT,1912,49,45-49,1961,0.19611828373899745
SIM,1815,82,na,1897,170
STAT,1944,27,45-49,1971,1.7639003091419
STAT,1826,31,45-49,1857,2.454521004402967
STAT,1903,44,25-29,1947,0.059125067899830984
SIM,1939,15,15-19,1954,36
SIM,1845,26,25-29,1871,39
SIM,1866,83,na,1949,300
STAT,1839,21,30-34,1860,15.370554591620365
SIM,1849,23,40-44,1872,1
SIM,1929,19,20-24,1948,159
STAT,1860,20,40-44,1880,1.8386506917192846
STAT,1940,16,20-24,1956,130.06509885291868
STAT,1863,23,15-19,1886,2.7740887250336814
STAT,1891,27,20-24,1918,13.717664892958245
STAT,1911,42,30-34,1953,0.11524700498902865
STAT,1829,54,na,1883,1338.8618672021623
STAT,1869,102,na,1971,2.600185427214383
SIM,1892,41,50-100,1933,2
STAT,1850,44,20-24,1894,0.11029558831849573
STAT,1944,15,30-34,1959,12.39784399441238
SIM,1943,22,25-29,1965,97
SIM,1823,89,na,1912,46
SIM,1838,55,na,1893,1317
STAT,1813,54,45-49,1867,0.04024963467711902
STAT,1934,23,20-24,1957,141.11820611718582
STAT,1924,42,na,1966,4173.668769621086
STAT,1931,22,40-44,1953,4.119810132965048
STAT,1915,42,15-19,1957,0.001460440925732804
STAT,1847,16,40-44,1863,0.1689617885342523
SIM,1796,62,na,1858,853
SIM,1946,21,50-100,1967,2
STAT,1819,35,20-24,1854,2.341938900830575
STAT,1824,36,20-24,1860,1.2157396763239272
STAT,1858,35,na,1893,1763.8564036361167
STAT,1876,18,50-100,1894,0.04765441163924539
SIM,1841,23,na,1864,1892
SIM,1932,29,20-24,1961,24
STAT,1923,30,35-39,1953,9.977272496358223
STAT,1860,48,25-29,1908,0.04366729382848997
STAT,1924,29,20-24,1953,19.936622837988537
STAT,1854,21,na,1875,1822.1215458832057
STAT,1921,47,50-100,1968,0.2408946156901641
SIM,1899,22,40-44,1921,2
STAT,1880,45,45-49,1925,0.2369223259613891
SIM,1816,45,50-100,1861,1
STAT,1886,26,20-24,1912,11.74962860242757
SIM,1952,15,30-34,1967,17
STAT,1831,39,15-19,1870,0.04331781326425629
SIM,1845,37,na,1882,1725
STAT,1870,17,50-100,1887,0.04578229455630296
STAT,1934,25,15-19,1959,0.8979173606519655
SIM,1905,33,45-49,1938,1
STAT,1927,18,35-39,1945,4.916478164698421
SIM,1870,36,40-44,1906,2
SIM,1942,23,20-24,1965,103
SIM,1904,65,na,1969,2547
STAT,1889,15,35-39,1904,0.6429173862050845
STAT,1837,26,25-29,1863,34.522191840742764
SIM,1834,31,45-49,1865,6
STAT,1872,50,35-39,1922,0.00828043737810261
STAT,1844,11,na,1855,2140.02441
STAT,1935,22,25-29,1957,118.82133871423157
STAT,1848,25,na,1873,1887.5273726322755
STAT,1959,9,na,1968,4854.872079204978
SIM,1837,70,na,1907,846
SIM,1848,8,na,1856,2256
SIM,1871,23,15-19,1894,4
STAT,1871,18,25-29,1889,5.309951949412079
SIM,1879,49,na,1928,2161
STAT,1902,27,40-44,1929,3.993530478347123
STAT,1933,29,15-19,1962,0.8846505453559652
SIM,1917,28,na,1945,3650
SIM,1877,29,25-29,1906,46
STAT,1862,54,40-44,1916,0.008250285441486531
SIM,1894,26,20-24,1920,17
SIM,1904,34,40-44,1938,7
STAT,1923,19,25-29,1942,47.81795393981578
STAT,1909,27,30-34,1936,35.36625582343157
STAT,1847,105,na,1952,0.0215738184382695
SIM,1809,74,na,1883,482
SIM,1917,27,30-34,1944,44
SIM,1820,37,40-44,1857,7
SIM,1834,41,na,1875,1553
STAT,1838,30,25-29,1868,8.862801983694112
SIM,1878,30,20-24,1908,1
SIM,1847,21,30-34,1868,17
SIM,1931,30,35-39,1961,17
SIM,1902,32,30-34,1934,28
SIM,1794,71,na,1865,571
STAT,1860,69,na,1929,1126.7206309737057
SIM,1845,31,20-24,1876,2
SIM,1837,18,na,1855,1931
SIM,1931,19,25-29,1950,70
STAT,1880,27,45-49,1907,1.1036395525640268
SIM,1930,26,35-39,1956,23
SIM,1913,28,20-24,1941,20
STAT,1942,27,15-19,1969,0.6999229603543621
SIM,1904,29,45-49,1933,1
SIM,1928,43,40-44,1971,2
SIM,1886,32,20-24,1918,3
SIM,1853,25,20-24,1878,14
SIM,1857,41,40-44,1898,6
STAT,1827,63,na,1890,990.198436549179
STAT,1888,21,25-29,1909,64.07956340728758
STAT,1936,16,35-39,1952,3.8038290035847724
SIM,1837,36,50-100,1873,4
STAT,1868,15,15-19,1883,5.514515635239448
STAT,1899,26,na,1925,3100.2279146315445
SIM,1925,27,na,1952,4057
STAT,1919,16,35-39,1935,0.8810391219300565
SIM,1927,16,35-39,1943,5
STAT,1878,32,20-24,1910,2.658329946321517
STAT,1911,24,30-34,1935,25.583612945766284
STAT,1900,36,20-24,1936,0.2191066647485177
STAT,1799,91,na,1890,19.373706965674437
SIM,1846,30,25-29,1876,12
STAT,1942,25,20-24,1967,18.113763380406642
STAT,1888,17,40-44,1905,0.20412167050628058
SIM,1910,27,40-44,1937,4
STAT,1769,101,na,1870,0.11097548907863924
STAT,1914,32,na,1946,3595.8334877940392
STAT,1926,13,na,1939,4582.68187047598
STAT,1918,46,na,1964,3702.361346058881
STAT,1878,34,15-19,1912,0.13885212406299327
SIM,1914,30,35-39,1944,11
STAT,1867,91,na,1958,73.60816581829951
STAT,1925,27,15-19,1952,0.7877948551114443
STAT,1884,72,na,1956,1209.641276436406
SIM,1902,25,40-44,1927,3
STAT,1905,28,20-24,1933,15.958880632801696
STAT,1907,39,15-19,1946,0.016647497909852073
STAT,1850,26,20-24,1876,9.789443841812936
SIM,1913,46,na,1959,3277
SIM,1896,21,25-29,1917,82
STAT,1785,78,na,1863,296.9761396150155
SIM,1908,34,25-29,1942,10
STAT,1893,22,45-49,1915,0.8358208048948058
STAT,1909,32,na,1941,3408.608880163697
STAT,1810,94,na,1904,9.05063191585146
SIM,1935,18,35-39,1953,4
STAT,1887,30,20-24,1917,2.878727267524632
SIM,1864,17,na,1881,2320
STAT,1858,24,na,1882,1805.1316223195884
SIM,1874,61,na,1935,1744
SIM,1878,75,na,1953,978
STAT,1935,29,45-49,1964,2.2224017113883874
STAT,1878,32,na,1910,2346.823628418907
STAT,1849,41,40-44,1890,1.6285932027746939
SIM,1858,17,20-24,1875,20
STAT,1897,48,20-24,1945,0.00844460121248351
STAT,1797,80,na,1877,257.33564642001846
STAT,1859,72,na,1931,952.1274669768443
SIM,1855,23,30-34,1878,16
SIM,1944,16,35-39,1960,5
STAT,1877,47,40-44,1924,0.1670478331546961
STAT,1907,53,na,1960,3025.7666836445924
STAT,1890,2,na,1892,3078.9092392429193
SIM,1890,24,na,1914,2823
STAT,1847,23,30-34,1870,15.951412710765737
SIM,1829,30,25-29,1859,11
STAT,1876,53,na,1929,2066.172453987323
STAT,1790,78,na,1868,289.9144315770145
STAT,1902,34,30-34,1936,13.250875519501948
SIM,1879,20,15-19,1899,5
STAT,1863,45,45-49,1908,0.19793141833672528
STAT,1898,31,na,1929,3064.149935197915
SIM,1869,24,20-24,1893,63
STAT,1920,48,40-44,1968,0.1641937416346699
SIM,1912,28,40-44,1940,3
STAT,1839,21,na,1860,1845.0307297269646
STAT,1920,15,40-44,1935,0.29882674304173384
STAT,1943,22,50-100,1965,0.6613164129017975
STAT,1880,52,35-39,1932,0.008511835871371911
STAT,1909,43,30-34,1952,0.11225817090437366
SIM,1943,17,30-34,1960,16
SIM,1814,42,na,1856,1375
SIM,1854,62,na,1916,1401
SIM,1881,40,na,1921,1945
STAT,1847,40,na,1887,1754.4526859676816
STAT,1818,53,50-100,1871,0.03033482643473017
SIM,1908,24,na,1932,3200
STAT,1898,52,na,1950,2738.9454505215886
SIM,1905,29,25-29,1934,62
STAT,1879,31,25-29,1910,10.155207805026533
STAT,1885,13,na,1898,2426.8368480602408
SIM,1885,54,na,1939,2006
STAT,1790,103,na,1893,0.028889956473063957
SIM,1849,42,45-49,1891,1
STAT,1904,28,40-44,1932,4.044173429103517
SIM,1869,2,na,1871,2876
STAT,1920,22,30-34,1942,30.186611861001353
STAT,1896,20,20-24,1916,86.5528287418514
STAT,1936,21,30-34,1957,25.962263877466977
STAT,1947,20,50-100,1967,0.7030535490987337
STAT,1898,44,40-44,1942,0.1970493251317856
SIM,1889,16,na,1905,3003
STAT,1811,45,25-29,1856,0.19850732085537245
SIM,1858,21,40-44,1879,6
SIM,1839,22,35-39,1861,6
STAT,1821,78,na,1899,421.91863100631525
STAT,1879,72,na,1951,1247.0229446082442
STAT,1887,24,15-19,1911,3.4635881599995146
STAT,1915,21,45-49,1936,1.1019666319509864
STAT,1845,25,20-24,1870,10.204055201563769
STAT,1826,78,na,1904,426.46478171233946
SIM,1895,24,15-19,1919,2
STAT,1827,40,na,1867,1526.2815393541714
STAT,1925,8,na,1933,4552.085419309457
SIM,1906,2,na,1908,3729
SIM,1829,26,40-44,1855,2
STAT,1926,31,15-19,1957,0.14689285576284497
SIM,1901,14,na,1915,3471
SIM,1923,21,45-49,1944,2
STAT,1891,21,na,1912,2773.8164279683006
SIM,1838,23,30-34,1861,18
SIM,1909,28,35-39,1937,14
STAT,1922,31,na,1953,4053.7060031859605
SIM,1881,51,na,1932,1801
STAT,1906,13,na,1919,3547.01653799525
SIM,1819,36,25-29,1855,5
SIM,1877,35,na,1912,2333
STAT,1832,38,20-24,1870,0.5845895214740878
STAT,1863,52,35-39,1915,0.007111021470153137
STAT,1813,59,na,1872,1051.13495402988
STAT,1916,35,20-24,1951,0.25743463385790283
SIM,1886,27,25-29,1913,53
SIM,1958,11,na,1969,4846
STAT,1914,43,na,1957,3470.4379218315003
STAT,1862,108,na,1970,0.022031958973748093
SIM,1812,94,na,1906,5
STAT,1821,35,40-44,1856,10.409011069264244
STAT,1899,24,40-44,1923,2.680838753157829
STAT,1935,33,30-34,1968,20.57778928842891
SIM,1941,19,20-24,1960,118
SIM,1920,17,na,1937,3836
STAT,1789,92,na,1881,10.18512077736542
SIM,1935,27,45-49,1962,3
STAT,1896,20,na,1916,2970.4576830655037
STAT,1890,48,50-100,1938,0.15800550979111155
STAT,1901,69,na,1970,2285.038076244147
STAT,1876,21,35-39,1897,5.708265317021654
STAT,1889,45,50-100,1934,0.2892920519929066
SIM,1850,32,40-44,1882,6
SIM,1902,16,30-34,1918,2
SIM,1934,21,20-24,1955,142
STAT,1836,46,40-44,1882,0.11459900247277308
STAT,1839,47,20-24,1886,0.008152254843086596
STAT,1849,104,na,1953,0.04807677783802218
SIM,1944,21,30-34,1965,34
SIM,1875,30,50-100,1905,5
SIM,1847,24,35-39,1871,5
STAT,1931,35,na,1966,4715.236564642101
SIM,1862,37,45-49,1899,1
STAT,1905,35,45-49,1940,0.5929729780232911
SIM,1820,38,na,1858,1482
SIM,1887,31,25-29,1918,14
SIM,1921,34,40-44,1955,7
SIM,1893,21,na,1914,2974
STAT,1903,40,30-34,1943,0.10838401889236489
SIM,1873,76,na,1949,866
STAT,1833,30,50-100,1863,0.7338303457808956
STAT,1842,40,na,1882,1747.0197668250973
SIM,1843,55,na,1898,1473
STAT,1900,46,15-19,1946,2.9655198873211727E-4
STAT,1911,20,15-19,1931,4.7966564920552734
STAT,1830,50,30-34,1880,0.004387150572433709
SIM,1849,101,na,1950,1
STAT,1876,20,na,1896,2320.2884703861164
STAT,1902,3,na,1905,3524.3658973500924
STAT,1920,43,35-39,1963,0.20977535842059702
SIM,1897,35,na,1932,3020
STAT,1952,17,30-34,1969,13.799360545042209
STAT,1836,88,na,1924,86.6930812128929
STAT,1925,45,50-100,1970,0.26016813478673434
SIM,1897,45,50-100,1942,1
SIM,1902,35,35-39,1937,3
STAT,1832,74,na,1906,671.0431197175305
STAT,1855,18,40-44,1873,0.15316584104772968
STAT,1815,93,na,1908,12.508505086954225
STAT,1889,27,na,1916,2783.335243564531
STAT,1854,37,45-49,1891,1.4354982676249861
SIM,1863,4,na,1867,2447
STAT,1793,66,na,1859,753.562118541997
STAT,1842,32,40-44,1874,3.730658818648389
STAT,1873,39,20-24,1912,0.7317339655092484
SIM,1916,43,na,1959,3515
SIM,1910,34,30-34,1944,19
SIM,1862,69,na,1931,1237
STAT,1919,42,na,1961,3802.120611366755
STAT,1834,22,na,1856,1769.9035715225186
SIM,1863,55,na,1918,1792
SIM,1867,69,na,1936,1247
STAT,1909,36,40-44,1945,1.3446758314698717
STAT,1862,39,45-49,1901,1.5902590320336256
STAT,1920,28,na,1948,3868.687756291931
STAT,1922,19,45-49,1941,0.5432613596669209
SIM,1827,38,25-29,1865,2
STAT,1881,15,30-34,1896,1.4605931602503477
STAT,1855,50,35-39,1905,0.006184872542289682
STAT,1871,15,20-24,1886,16.90937762925341
STAT,1854,31,20-24,1885,2.014095080275243
STAT,1908,9,na,1917,3635.161118250996
STAT,1914,39,50-100,1953,0.39196072809364263
STAT,1812,74,na,1886,490.97485383170556
STAT,1943,24,25-29,1967,92.7724708681062
STAT,1839,24,35-39,1863,4.927856923473275
SIM,1894,29,25-29,1923,56
STAT,1804,53,40-44,1857,0.03068491513018442
STAT,1889,71,na,1960,1702.3392601029145
STAT,1911,19,35-39,1930,0.7888174111995437
SIM,1907,39,na,1946,3291
STAT,1868,4,na,1872,2689.7470765041508
STAT,1933,38,25-29,1971,1.265664539093207
SIM,1870,39,45-49,1909,1
STAT,1768,112,na,1880,4.5369186728980615E-4
SIM,1859,21,20-24,1880,64
STAT,1930,18,40-44,1948,1.703921894701246
STAT,1931,32,35-39,1963,11.312266898803665
STAT,1921,32,25-29,1953,9.717590958533924
STAT,1907,29,20-24,1936,16.024642943306976
STAT,1927,15,30-34,1942,14.38524059842528
SIM,1917,36,40-44,1953,2
SIM,1920,48,50-100,1968,1
STAT,1871,44,40-44,1915,2.078110163555265
SIM,1918,24,40-44,1942,4
STAT,1889,16,na,1905,2952.7780314284705
SIM,1873,21,na,1894,2279
STAT,1886,29,25-29,1915,41.920300790664506
STAT,1931,25,45-49,1956,2.1089471177797314
SIM,1824,42,40-44,1866,4
SIM,1908,31,20-24,1939,3
STAT,1819,38,25-29,1857,6.8827776844222175
STAT,1815,47,50-100,1862,0.59766628570967
SIM,1823,47,50-100,1870,1
SIM,1918,31,30-34,1949,20
STAT,1903,48,40-44,1951,0.1281638183583128
SIM,1888,25,35-39,1913,11
STAT,1926,19,50-100,1945,0.4316643583539878
SIM,1882,80,na,1962,704
STAT,1817,74,na,1891,492.1504075142051
SIM,1901,22,20-24,1923,75
STAT,1806,48,20-24,1854,0.03492363778936949
STAT,1847,19,45-49,1866,0.059283479913590044
STAT,1883,33,40-44,1916,3.9982789370268303
SIM,1911,22,30-34,1933,35
SIM,1909,37,45-49,1946,4
STAT,1831,89,na,1920,64.06847110028265
STAT,1925,27,na,1952,4180.44560966328
STAT,1872,39,na,1911,2211.459340907749
STAT,1923,16,20-24,1939,150.7759160282482
SIM,1875,87,na,1962,328
STAT,1938,34,45-49,1972,1.4926243530365906
SIM,1784,82,na,1866,101
SIM,1862,31,20-24,1893,1
SIM,1878,20,na,1898,2412
SIM,1926,22,25-29,1948,101
STAT,1828,41,20-24,1869,0.1424616873634161
STAT,1838,99,na,1937,1.2916633670083404
STAT,1913,34,40-44,1947,3.645813310289707
SIM,1866,23,40-44,1889,2
STAT,1813,60,na,1873,1030.5221975813527
SIM,1816,56,na,1872,1081
SIM,1868,39,25-29,1907,1
STAT,1902,54,na,1956,2810.5554267553985
SIM,1931,16,20-24,1947,145
SIM,1841,44,na,1885,1619
SIM,1943,26,40-44,1969,8
STAT,1870,38,40-44,1908,4.032022284212936
STAT,1918,22,25-29,1940,94.11084415889528
STAT,1895,38,50-100,1933,1.5060537549117747
STAT,1789,81,na,1870,182.48284606190282
STAT,1933,19,20-24,1952,170.53192881445992
STAT,1816,42,40-44,1858,6.725947315327531
SIM,1877,26,20-24,1903,9
SIM,1938,32,45-49,1970,2
SIM,1899,18,20-24,1917,19
STAT,1893,47,25-29,1940,0.03876290748921057
SIM,1933,35,na,1968,4874
STAT,1802,75,na,1877,408.78148211891755
SIM,1856,20,40-44,1876,1
STAT,1953,17,45-49,1970,0.570878523458751
SIM,1927,39,40-44,1966,4
SIM,1846,22,na,1868,1873
STAT,1871,51,30-34,1922,0.005601494652853071
SIM,1892,35,na,1927,2848
SIM,1952,18,35-39,1970,4
STAT,1912,16,45-49,1928,0.09563838136443467
STAT,1913,41,30-34,1954,0.11842957369534073
SIM,1896,49,na,1945,2778
STAT,1944,18,35-39,1962,4.264483279528819
SIM,1891,33,40-44,1924,7
STAT,1873,87,na,1960,263.1076632148501
STAT,1915,47,20-24,1962,0.010518925710923607
SIM,1825,37,na,1862,1508
SIM,1871,10,na,1881,2563
STAT,1925,47,30-34,1972,0.1020614791947768
SIM,1886,28,na,1914,2292
STAT,1919,39,40-44,1958,1.5160475359280754
STAT,1836,33,na,1869,1712.01758546052
STAT,1848,20,40-44,1868,1.8544290353849564
STAT,1872,22,25-29,1894,54.28042092667539
SIM,1863,25,30-34,1888,29
SIM,1883,31,40-44,1914,3
STAT,1941,5,na,1946,3889.567390633679
STAT,1849,10,na,1859,2144.5811301019057
STAT,1885,20,45-49,1905,0.660220558875602
SIM,1868,54,na,1922,1882
STAT,1922,26,35-39,1948,16.105395848658365
STAT,1819,44,na,1863,1384.955876003777
STAT,1939,17,15-19,1956,42.91032026494301
STAT,1845,28,25-29,1873,36.007051890698094
STAT,1943,28,40-44,1971,4.687067303127007
SIM,1927,29,50-100,1956,1
SIM,1838,88,na,1926,75
STAT,1861,18,50-100,1879,0.04391408557357125
SIM,1868,18,20-24,1886,16
SIM,1856,73,na,1929,861
SIM,1817,93,na,1910,13
STAT,1901,24,20-24,1925,90.55165151400126
SIM,1894,39,50-100,1933,1
SIM,1832,30,na,1862,1750
STAT,1871,21,na,1892,2221.657976640957
STAT,1910,36,30-34,1946,1.6541324737754854
STAT,1870,80,na,1950,572.6157138068642
SIM,1883,44,50-100,1927,1
STAT,1857,43,40-44,1900,1.6630490187007567
STAT,1903,42,50-100,1945,0.09847980928103987
SIM,1869,39,na,1908,2137
STAT,1890,35,na,1925,2747.0610044660966
SIM,1947,17,15-19,1964,41
STAT,1839,17,45-49,1856,0.056976559921311516
SIM,1921,9,na,1930,4203
STAT,1866,33,50-100,1899,0.7946721017067204
STAT,1885,57,na,1942,1891.4232176242083
STAT,1869,48,45-49,1917,0.21309545981986197
STAT,1882,34,50-100,1916,0.8350477056390582
STAT,1935,26,40-44,1961,6.004614416795647
SIM,1865,43,40-44,1908,5
STAT,1896,19,40-44,1915,0.2271357097200126
SIM,1918,20,25-29,1938,101
STAT,1858,23,40-44,1881,1.6019765773029568
STAT,1875,31,40-44,1906,4.226148680874812
STAT,1921,36,40-44,1957,1.5806360052850559
STAT,1862,40,50-100,1902,0.8599191145911681
SIM,1935,15,30-34,1950,21
SIM,1837,28,40-44,1865,3
SIM,1925,18,25-29,1943,58
SIM,1909,25,30-34,1934,37
SIM,1802,64,na,1866,859
STAT,1899,41,50-100,1940,0.09540541722101106
STAT,1917,25,15-19,1942,0.7041140907006447
STAT,1853,36,na,1889,1765.44820200377
STAT,1940,19,25-29,1959,41.53438365599075
STAT,1887,33,25-29,1920,10.775610077036738
STAT,1893,53,na,1946,2539.45301886013
SIM,1816,40,40-44,1856,3
STAT,1841,55,na,1896,1414.7122080966042
STAT,1863,16,25-29,1879,5.401493381832009
STAT,1932,20,na,1952,4553.582221934384
STAT,1936,34,na,1970,3465.295351818766
STAT,1920,18,45-49,1938,0.5280982531132238
STAT,1818,107,na,1925,0.002273672227960897
STAT,1820,48,50-100,1868,0.3990598413985729
SIM,1871,16,25-29,1887,6
SIM,1902,28,45-49,1930,2
STAT,1829,28,40-44,1857,3.6685213394528344
STAT,1861,109,na,1970,0.008289887254303747
STAT,1843,15,45-49,1858,0.06094118536466396
SIM,1872,20,25-29,1892,60
STAT,1909,46,35-39,1955,0.11216931779582022
SIM,1875,32,45-49,1907,1
SIM,1899,25,45-49,1924,1
STAT,1849,51,na,1900,1559.4091767078642
SIM,1884,17,na,1901,2475
SIM,1914,25,50-100,1939,2
STAT,1862,36,40-44,1898,3.544535702160536
SIM,1856,84,na,1940,216
STAT,1828,47,45-49,1875,0.19878478244204686
STAT,1917,38,40-44,1955,1.4615297318055933
SIM,1895,33,25-29,1928,17
STAT,1927,34,35-39,1961,10.607048925873785
STAT,1906,18,15-19,1924,8.142233122025718
SIM,1915,29,20-24,1944,26
STAT,1863,42,40-44,1905,1.865529606873389
SIM,1819,41,na,1860,1447
STAT,1906,25,50-100,1931,0.8859366278840028
STAT,1885,49,40-44,1934,0.15776563675248068
SIM,1886,50,na,1936,2126
STAT,1852,46,25-29,1898,0.043887137785078904
STAT,1820,93,na,1913,15.569373195253075
STAT,1884,16,45-49,1900,0.061130923709462506
SIM,1789,81,na,1870,141
STAT,1840,27,50-100,1867,0.5554640721559788
STAT,1923,49,20-24,1972,0.012142378860529874
SIM,1933,17,20-24,1950,170
STAT,1821,38,45-49,1859,3.91099983791567
STAT,1910,29,40-44,1939,4.220368469902578
STAT,1857,39,na,1896,1736.9563975437654
SIM,1829,74,na,1903,568
STAT,1873,35,50-100,1908,1.1884736517762313
STAT,1846,32,25-29,1878,8.5343408191076
STAT,1912,21,na,1933,3464.6018127892917
SIM,1842,30,40-44,1872,4
SIM,1914,18,15-19,1932,11
SIM,1935,34,35-39,1969,15
SIM,1915,17,na,1932,3768
STAT,1853,25,na,1878,1885.4863409571292
STAT,1900,39,25-29,1939,0.806267867059896
STAT,1811,49,40-44,1860,0.5507425676329798
SIM,1893,20,45-49,1913,4
SIM,1855,36,na,1891,1890
STAT,1926,21,20-24,1947,128.01713329321385
SIM,1832,46,50-100,1878,3
SIM,1914,32,na,1946,3853
SIM,1854,32,25-29,1886,9
STAT,1927,27,45-49,1954,1.9843397088640395
SIM,1887,42,50-100,1929,1
SIM,1858,31,35-39,1889,7
SIM,1925,38,40-44,1963,7
STAT,1898,40,25-29,1938,0.057601764578775014
STAT,1895,38,45-49,1933,2.4453804394360197
STAT,1905,42,35-39,1947,0.17145233907831256
STAT,1855,25,30-34,1880,20.724837439739513
STAT,1891,4,na,1895,3076.08087083612
STAT,1854,73,na,1927,855.2938318110321
SIM,1913,35,45-49,1948,2
SIM,1898,20,na,1918,3005
STAT,1907,48,25-29,1955,0.04451402685611539
STAT,1862,40,na,1902,1881.2775788139948
STAT,1890,68,na,1958,1841.9586837147046
STAT,1866,54,na,1920,1823.8135865867166
STAT,1900,31,15-19,1931,0.18740072685711304
STAT,1920,25,35-39,1945,15.66498477767593
STAT,1824,46,50-100,1870,0.29272942388745715
SIM,1881,35,50-100,1916,1
SIM,1840,37,na,1877,1721
SIM,1853,28,25-29,1881,31
SIM,1904,29,50-100,1933,4
SIM,1903,20,30-34,1923,29
STAT,1919,31,na,1950,3870.477129645135
SIM,1871,42,40-44,1913,5
SIM,1905,26,20-24,1931,17
SIM,1964,6,na,1970,4484
STAT,1795,77,na,1872,329.35796134210375
STAT,1865,37,20-24,1902,0.6617312453907811
STAT,1850,23,50-100,1873,0.3421009057493011
SIM,1880,3,na,1883,2932
STAT,1867,39,na,1906,2068.720450533562
STAT,1915,20,35-39,1935,8.875173964073179
STAT,1918,21,15-19,1939,5.439915398562508
STAT,1840,47,45-49,1887,0.16573823812705474
SIM,1928,35,40-44,1963,2
STAT,1947,24,45-49,1971,1.200575325233963
SIM,1867,23,20-24,1890,62
STAT,1865,22,35-39,1887,5.0703316752432395
STAT,1922,16,40-44,1938,1.533089749868191
STAT,1819,46,40-44,1865,0.30900108556807265
SIM,1854,47,50-100,1901,4
STAT,1827,45,20-24,1872,0.010797002449711919
SIM,1847,25,45-49,1872,1
STAT,1920,1,na,1921,4426.41561334552
STAT,1880,23,15-19,1903,3.2690918777534503
SIM,1885,39,40-44,1924,3
STAT,1929,35,35-39,1964,2.9387823817360976
SIM,1850,35,45-49,1885,2
STAT,1843,48,25-29,1891,0.04103367948843522
STAT,1868,23,15-19,1891,2.966449166823358
STAT,1871,44,na,1915,2135.3587462732703
STAT,1847,31,30-34,1878,15.24105909461239
SIM,1853,36,25-29,1889,1
SIM,1806,87,na,1893,37
STAT,1812,102,na,1914,0.1260940734394672
SIM,1953,12,na,1965,4360
SIM,1917,23,15-19,1940,5
STAT,1880,49,40-44,1929,0.16661945728026029
SIM,1864,22,40-44,1886,1
SIM,1887,27,40-44,1914,9
SIM,1903,34,25-29,1937,13
SIM,1914,20,40-44,1934,3
STAT,1925,17,20-24,1942,154.7360446152646
STAT,1852,61,na,1913,1419.7376345906493
STAT,1845,36,25-29,1881,2.153098000351047
STAT,1888,25,40-44,1913,3.365760284452052
SIM,1920,31,20-24,1951,2
STAT,1848,23,45-49,1871,0.6072912108058555
STAT,1875,19,20-24,1894,17.113940415732113
SIM,1914,22,35-39,1936,9
SIM,1955,13,na,1968,4542
STAT,1841,24,na,1865,1826.6728521455518
STAT,1862,33,20-24,1895,2.169034880230271
STAT,1941,18,30-34,1959,11.855578866864878
SIM,1868,31,na,1899,2166
STAT,1794,82,na,1876,159.28143328471356
STAT,1862,8,na,1870,2266.3825158643012
STAT,1908,32,50-100,1940,0.7370938790760299
SIM,1844,38,25-29,1882,2
STAT,1909,21,20-24,1930,97.89909679443677
SIM,1827,46,40-44,1873,3
STAT,1829,75,na,1904,631.0073845781878
STAT,1878,42,15-19,1920,0.013564590970887356
STAT,1839,25,45-49,1864,0.9461741680207191
STAT,1887,79,na,1966,1064.273774312362
SIM,1876,23,15-19,1899,3
STAT,1854,34,25-29,1888,7.397859819802288
STAT,1912,31,20-24,1943,2.276113648377699
SIM,1845,37,45-49,1882,1
SIM,1864,24,35-39,1888,3
STAT,1875,41,35-39,1916,1.7654157320633925
SIM,1872,36,na,1908,2221
SIM,1878,36,30-34,1914,2
SIM,1910,37,35-39,1947,5
STAT,1905,38,15-19,1943,0.016464253949200217
SIM,1836,39,45-49,1875,3
SIM,1873,22,35-39,1895,7
STAT,1856,22,40-44,1878,1.7906537389093276
STAT,1889,38,20-24,1927,0.8945603407497602
SIM,1879,28,45-49,1907,2
STAT,1892,16,na,1908,2995.1473041178074
STAT,1811,89,na,1900,45.503843400986185
SIM,1896,25,40-44,1921,6
SIM,1899,26,20-24,1925,16
STAT,1874,20,35-39,1894,5.667957688660225
SIM,1829,34,40-44,1863,8
STAT,1929,33,40-44,1962,4.693241992885718
STAT,1881,16,40-44,1897,0.16724367011183264
SIM,1908,23,20-24,1931,90
STAT,1822,41,na,1863,1441.8761476216782
STAT,1854,3,na,1857,2433.748451073668
STAT,1897,18,45-49,1915,0.08231322933795072
SIM,1917,21,20-24,1938,106
SIM,1940,28,50-100,1968,4
STAT,1859,25,15-19,1884,0.3530127960663589
SIM,1883,41,35-39,1924,1
STAT,1837,37,45-49,1874,1.5321686654536357
STAT,1807,74,na,1881,474.43881275151
STAT,1828,39,45-49,1867,1.8113712999937
STAT,1872,18,40-44,1890,0.17297471733257608
SIM,1919,37,40-44,1956,1
SIM,1853,36,40-44,1889,9
SIM,1791,84,na,1875,97
STAT,1794,92,na,1886,10.98499218334163
SIM,1813,59,na,1872,1032
STAT,1930,40,40-44,1970,0.31177840868245715
SIM,1855,24,40-44,1879,2
SIM,1937,28,45-49,1965,1
STAT,1867,49,na,1916,1953.9430395572622
SIM,1878,29,40-44,1907,2
STAT,1864,19,45-49,1883,0.056383914788647016
STAT,1832,50,50-100,1882,0.009909283474411584
STAT,1879,34,30-34,1913,17.092680650968052
STAT,1826,57,na,1883,1168.8621784617121
SIM,1838,34,35-39,1872,10
SIM,1871,27,45-49,1898,2
STAT,1883,36,45-49,1919,1.8545872511619148
STAT,1825,42,50-100,1867,1.1800476678319638
STAT,1875,68,na,1943,1483.1738249615878
SIM,1851,74,na,1925,773
STAT,1893,29,50-100,1922,0.7612654679542734
STAT,1863,27,45-49,1890,0.9220107944031681
SIM,1806,77,na,1883,321
STAT,1869,44,15-19,1913,0.012457759092259997
STAT,1809,75,na,1884,450.87127364357383
STAT,1818,38,na,1856,1439.13118300611
SIM,1937,33,40-44,1970,9
STAT,1877,49,na,1926,2159.5067591479756
STAT,1889,31,50-100,1920,1.072958479155714
STAT,1829,35,30-34,1864,4.9267107832543395
SIM,1838,27,45-49,1865,4
STAT,1887,38,50-100,1925,1.2906723155649755
SIM,1942,15,20-24,1957,127
SIM,1922,21,30-34,1943,36
STAT,1934,15,20-24,1949,174.0383318075912
STAT,1889,7,na,1896,3038.5539774194185
STAT,1877,69,na,1946,1438.6576971634472
SIM,1800,62,na,1862,907
SIM,1894,37,40-44,1931,9
STAT,1896,26,30-34,1922,31.548308137532135
STAT,1850,51,45-49,1901,0.010265656489460727
STAT,1902,37,35-39,1939,2.035221245040689
STAT,1907,21,50-100,1928,0.5675039395241828
SIM,1861,74,na,1935,874
STAT,1892,48,20-24,1940,0.007907154537550965
STAT,1816,45,45-49,1861,0.6415819988549405
STAT,1816,57,na,1873,1164.1674285703107
STAT,1927,45,25-29,1972,0.06320587233081579
STAT,1792,102,na,1894,0.04937094508994427
SIM,1872,23,30-34,1895,15
SIM,1891,19,na,1910,3078
STAT,1872,91,na,1963,127.0381715125251
STAT,1894,17,na,1911,3069.167745198053
STAT,1929,28,45-49,1957,2.041712178206707
STAT,1842,49,20-24,1891,0.008366930931764261
STAT,1824,31,50-100,1855,2.480919751345008
SIM,1923,20,35-39,1943,10
STAT,1859,23,20-24,1882,53.51785063988823
STAT,1930,22,25-29,1952,111.7927903699355
SIM,1865,98,na,1963,5
SIM,1930,16,40-44,1946,2
STAT,1862,50,25-29,1912,0.002895305304942051
STAT,1892,36,na,1928,2800.5516230030407
SIM,1849,27,20-24,1876,16
STAT,1849,51,35-39,1900,0.006235021058465124
STAT,1854,96,na,1950,6.1832025128882755
STAT,1831,49,45-49,1880,0.16911072765285318
STAT,1850,18,20-24,1868,15.161662734968514
STAT,1886,37,40-44,1923,4.369291282017021
SIM,1823,35,na,1858,1522
STAT,1864,23,30-34,1887,15.17122641093514
STAT,1833,26,20-24,1859,9.525601269173356
STAT,1877,39,25-29,1916,2.794118408445747
STAT,1894,36,20-24,1930,0.9412598219615812
SIM,1857,44,45-49,1901,5
SIM,1881,19,na,1900,2103
SIM,1837,35,30-34,1872,10
SIM,1888,30,30-34,1918,23
SIM,1907,27,20-24,1934,18
STAT,1884,17,na,1901,2357.7536386959773
STAT,1792,81,na,1873,186.21469098786812
STAT,1848,30,35-39,1878,8.686713637360652
STAT,1828,44,25-29,1872,0.5478766258127107
STAT,1897,25,35-39,1922,12.273309527384448
STAT,1906,20,40-44,1926,2.8836095255941467
SIM,1855,31,30-34,1886,16
STAT,1909,23,15-19,1932,4.658144444595309
SIM,1841,26,20-24,1867,10
STAT,1923,15,45-49,1938,0.5567623259265471
SIM,1885,39,25-29,1924,2
SIM,1821,44,na,1865,1400
STAT,1865,15,45-49,1880,0.06425475367785494
STAT,1881,54,na,1935,1909.9902673133743
STAT,1855,26,40-44,1881,2.2273739513665243
STAT,1906,39,50-100,1945,0.36086408520370594
STAT,1834,40,35-39,1874,1.386339200487673
SIM,1860,30,50-100,1890,3
STAT,1854,29,45-49,1883,0.8261678381147755
STAT,1782,81,na,1863,177.05795462267275
STAT,1908,25,20-24,1933,16.547633738313777
SIM,1897,23,35-39,1920,9
STAT,1854,41,15-19,1895,0.009989374524558699
SIM,1850,37,na,1887,1766
STAT,1831,24,na,1855,1703.033847653715
STAT,1917,45,50-100,1962,0.22422104131543605
SIM,1816,43,45-49,1859,4
STAT,1904,66,na,1970,2543.2767850536984
STAT,1784,82,na,1866,131.2414141519542
STAT,1876,47,25-29,1923,0.055912821064294536
STAT,1777,80,na,1857,221.98846043076043
STAT,1840,29,15-19,1869,0.38832650620269354
SIM,1867,18,25-29,1885,4
SIM,1849,40,na,1889,1727
STAT,1859,18,25-29,1877,4.930018635828175
STAT,1829,36,50-100,1865,1.1153973707702127
STAT,1937,27,40-44,1964,4.291666265066134
SIM,1938,11,na,1949,3631
STAT,1946,25,40-44,1971,4.909337075417938
SIM,1879,35,35-39,1914,8
SIM,1863,26,40-44,1889,3
SIM,1943,12,na,1955,3860
STAT,1862,54,50-100,1916,0.011835689853675724
SIM,1866,27,20-24,1893,10
STAT,1865,105,na,1970,0.286769350274112
STAT,1846,77,na,1923,609.4590940989065
SIM,1830,27,na,1857,1787
STAT,1868,16,25-29,1884,5.234634540268697
STAT,1869,15,30-34,1884,1.495237550919084
STAT,1759,95,na,1854,1.0
STAT,1914,24,35-39,1938,9.029269518839204
STAT,1889,23,35-39,1912,6.784727250597496
SIM,1887,34,30-34,1921,27
SIM,1888,26,45-49,1914,1
STAT,1887,69,na,1956,1577.5140981758077
SIM,1877,37,25-29,1914,3
SIM,1925,15,20-24,1940,150
SIM,1846,26,40-44,1872,3
STAT,1847,24,40-44,1871,1.852712172594541
STAT,1830,25,40-44,1855,3.5420686646506563
STAT,1845,43,15-19,1888,0.009779479795998948
STAT,1851,24,na,1875,1845.6161199676883
SIM,1881,29,na,1910,1965
SIM,1886,35,40-44,1921,4
STAT,1857,46,45-49,1903,0.17626020184156918
SIM,1873,29,20-24,1902,15
STAT,1830,25,25-29,1855,50.018808577281774
STAT,1849,29,20-24,1878,9.880279146754832
SIM,1857,29,20-24,1886,11
SIM,1856,1,na,1857,2851
STAT,1869,47,50-100,1916,0.22353864619743685
STAT,1912,41,50-100,1953,0.10763090033736133
STAT,1838,26,40-44,1864,2.617702751401016
STAT,1881,48,45-49,1929,0.21256115422773567
SIM,1811,78,na,1889,288
STAT,1868,86,na,1954,200.12722203674988
STAT,1940,16,50-100,1956,0.35942816700899005
STAT,1857,34,50-100,1891,0.6765323680271277
STAT,1888,49,50-100,1937,0.15138261215366178
STAT,1908,20,50-100,1928,0.5747358222435218
STAT,1911,14,na,1925,3720.5161858582346
STAT,1861,44,na,1905,1788.640017935106
SIM,1942,0,na,1942,3933
STAT,1878,35,40-44,1913,4.345951928252977
STAT,1858,27,20-24,1885,8.906551924182244
STAT,1848,37,20-24,1885,0.5722864005957872
STAT,1947,0,na,1947,4724.394512349608
SIM,1922,24,35-39,1946,14
SIM,1905,22,40-44,1927,3
SIM,1927,5,na,1932,4626
STAT,1808,50,35-39,1858,0.03259280222871359
SIM,1847,69,na,1916,1055
SIM,1850,27,na,1877,1845
SIM,1862,34,25-29,1896,8
STAT,1809,55,na,1864,1160.9436582964338
STAT,1955,5,na,1960,4930.469751906817
STAT,1829,36,40-44,1865,3.976936596353598
STAT,1886,44,15-19,1930,0.013597867359540715
SIM,1957,3,na,1960,4701
STAT,1767,112,na,1879,5.46223579003464E-4
STAT,1826,53,50-100,1879,0.013359541996703575
SIM,1872,24,40-44,1896,1
SIM,1901,39,35-39,1940,5
STAT,1867,17,20-24,1884,16.07588829849544
SIM,1876,16,25-29,1892,11
SIM,1912,32,25-29,1944,15
STAT,1878,25,50-100,1903,0.6333751637615296
STAT,1938,26,45-49,1964,1.6174318437461626
STAT,1853,35,20-24,1888,0.5836637843220441
STAT,1902,31,na,1933,3194.306997865788
STAT,1914,22,40-44,1936,3.2446003213057026
STAT,1845,39,45-49,1884,1.4450302892255662
STAT,1879,27,40-44,1906,2.95791589696321
STAT,1891,19,20-24,1910,20.61891977123829
SIM,1924,21,na,1945,4050
STAT,1820,35,25-29,1855,7.676382588520464
SIM,1858,28,25-29,1886,39
STAT,1872,71,na,1943,1265.661019817982
STAT,1863,31,15-19,1894,0.11874054076873218
STAT,1864,24,40-44,1888,1.7620957061537923
SIM,1922,22,40-44,1944,5
STAT,1860,90,na,1950,60.53060801832632
STAT,1938,33,35-39,1971,8.674072313685766
STAT,1873,21,30-34,1894,17.1319136825699
SIM,1912,20,na,1932,3318
STAT,1833,59,na,1892,1179.8577319661774
SIM,1875,17,20-24,1892,19
SIM,1896,70,na,1966,2033
STAT,1869,37,25-29,1906,2.632843835197973
SIM,1862,29,45-49,1891,2
STAT,1904,32,25-29,1936,7.968126250043562
SIM,1847,32,35-39,1879,14
STAT,1847,49,na,1896,1620.8437763904858
STAT,1910,39,35-39,1949,2.1627081888839563
SIM,1882,19,20-24,1901,16
STAT,1838,33,30-34,1871,14.644315501709004
STAT,1895,34,15-19,1929,0.1740570741058599
SIM,1824,96,na,1920,1
STAT,1956,10,na,1966,4911.128077029182
SIM,1842,40,35-39,1882,2
STAT,1954,17,50-100,1971,0.43753141810033014
SIM,1837,36,40-44,1873,5
SIM,1929,31,40-44,1960,9
STAT,1837,94,na,1931,12.61636558560522
STAT,1910,50,na,1960,3207.9480169946673
SIM,1916,25,20-24,1941,19
STAT,1884,46,20-24,1930,0.011234282973895601
STAT,1829,85,na,1914,168.0303274187998
SIM,1926,21,15-19,1947,6
STAT,1896,27,40-44,1923,3.7400580154399345
SIM,1883,34,45-49,1917,1
SIM,1950,5,na,1955,4278
STAT,1937,34,30-34,1971,14.704285797935052
STAT,1810,46,20-24,1856,0.04339215626776438
STAT,1886,37,25-29,1923,2.8737962409025637
STAT,1875,34,45-49,1909,1.6779556974168066
STAT,1917,48,35-39,1965,0.12686089724915448
STAT,1909,24,25-29,1933,80.57242141844526
STAT,1839,32,35-39,1871,8.309662863260725
STAT,1852,71,na,1923,1014.1445957394026
STAT,1928,37,40-44,1965,1.7874240385776388
SIM,1846,33,30-34,1879,18
STAT,1890,38,45-49,1928,2.2911104433633365
STAT,1882,16,na,1898,2327.3656590352007
SIM,1894,37,25-29,1931,4
SIM,1816,87,na,1903,50
SIM,1867,102,na,1969,2
SIM,1865,102,na,1967,1
STAT,1914,17,45-49,1931,0.0976015584359796
SIM,1832,28,20-24,1860,11
SIM,1888,51,na,1939,2366
STAT,1819,46,25-29,1865,0.10396298125094289
STAT,1828,43,15-19,1871,0.011980179305756216
SIM,1886,39,50-100,1925,1
STAT,1848,22,35-39,1870,5.11882128926197
SIM,1845,34,40-44,1879,3
SIM,1864,25,45-49,1889,4
SIM,1868,39,40-44,1907,7
SIM,1859,40,na,1899,1944
STAT,1823,47,45-49,1870,0.2815228847127011
SIM,1903,31,20-24,1934,2
STAT,1929,32,30-34,1961,18.906819219088423
STAT,1797,79,na,1876,282.92011216291047
STAT,1895,27,25-29,1922,52.149182639325716
STAT,1932,20,35-39,1952,11.741107864099746
STAT,1830,32,15-19,1862,0.11914277509592554
SIM,1847,31,50-100,1878,1
SIM,1948,11,na,1959,4014
SIM,1829,33,30-34,1862,19
STAT,1880,35,na,1915,2364.0783060772696
SIM,1853,33,20-24,1886,3
STAT,1900,17,30-34,1917,2.088908601076936
SIM,1914,23,45-49,1937,1
STAT,1912,34,25-29,1946,8.51615201860216
SIM,1895,23,na,1918,2961
STAT,1884,39,30-34,1923,4.925297637723697
SIM,1896,24,30-34,1920,32
SIM,1871,74,na,1945,974
STAT,1794,102,na,1896,0.05267676258319123
STAT,1894,39,40-44,1933,5.2660904067465335
STAT,1879,19,50-100,1898,0.04811672136586887
SIM,1846,36,35-39,1882,13
STAT,1888,24,30-34,1912,19.754244815478735
SIM,1892,39,30-34,1931,11
SIM,1866,41,35-39,1907,2
SIM,1917,24,25-29,1941,85
STAT,1947,21,40-44,1968,3.591310037304177
SIM,1853,39,45-49,1892,2
SIM,1856,22,35-39,1878,5
STAT,1864,42,na,1906,1949.0021092497855
SIM,1843,39,35-39,1882,11
STAT,1887,36,30-34,1923,5.657781170016809
STAT,1839,31,50-100,1870,0.7596634604060729
SIM,1894,47,na,1941,2898
SIM,1867,26,25-29,1893,36
SIM,1929,26,45-49,1955,2
STAT,1942,17,20-24,1959,133.83895319117477
SIM,1786,93,na,1879,5
STAT,1854,33,15-19,1887,0.103929464228911
STAT,1861,36,25-29,1897,2.2695340531900476
STAT,1906,23,45-49,1929,0.9562778155956491
SIM,1836,36,25-29,1872,3
SIM,1918,45,na,1963,3670
SIM,1934,23,15-19,1957,7
STAT,1906,47,na,1953,3081.0455056873802
STAT,1929,36,45-49,1965,0.8276098819306112
SIM,1842,18,20-24,1860,18
STAT,1844,52,na,1896,1503.496764976975
SIM,1833,79,na,1912,386
STAT,1837,34,25-29,1871,7.940252880319816
SIM,1867,14,na,1881,2316
STAT,1845,33,20-24,1878,2.240459948143061
STAT,1787,80,na,1867,243.9797952713045
STAT,1880,90,na,1970,252.06237785555024
STAT,1802,98,na,1900,1.1081994355864815
SIM,1940,20,35-39,1960,9
STAT,1850,37,50-100,1887,0.878020955226984
STAT,1867,105,na,1972,0.3750033245267459
STAT,1832,27,50-100,1859,0.5251998618499717
STAT,1872,47,40-44,1919,0.1615754333467075
STAT,1857,20,35-39,1877,5.090012260416295
STAT,1813,51,40-44,1864,0.031009764159279005
STAT,1834,33,45-49,1867,1.3683633454097193
STAT,1885,15,15-19,1900,5.611427638624426
SIM,1902,45,50-100,1947,3
STAT,1842,95,na,1937,9.467920185047333
STAT,1859,26,25-29,1885,32.67719050808452
STAT,1840,15,40-44,1855,0.1668782382108362
SIM,1901,34,na,1935,3199
STAT,1921,14,na,1935,4253.227486452985
STAT,1856,25,45-49,1881,0.8636260793373934
STAT,1828,36,25-29,1864,2.796029281166728
SIM,1863,45,na,1908,1966
SIM,1882,27,20-24,1909,11
STAT,1776,97,na,1873,0.7775655029141617
STAT,1926,23,15-19,1949,6.091193052729861
SIM,1937,32,30-34,1969,21
STAT,1838,36,35-39,1874,5.881661111110229
STAT,1843,45,20-24,1888,0.00884075641484469
SIM,1869,39,40-44,1908,3
STAT,1826,41,50-100,1867,1.0603895767796507
SIM,1842,33,45-49,1875,1
STAT,1835,46,25-29,1881,0.03837019802065228
STAT,1819,107,na,1926,0.002355085951932546
SIM,1893,15,15-19,1908,7
STAT,1868,49,40-44,1917,0.15119432818304687
SIM,1854,35,30-34,1889,6
SIM,1869,47,50-100,1916,3
STAT,1836,20,15-19,1856,3.3422338975380077
STAT,1813,50,na,1863,1256.0511080484703
STAT,1864,105,na,1969,0.24925766716713976
SIM,1841,54,na,1895,1475
SIM,1920,34,25-29,1954,13
SIM,1909,21,15-19,1930,4
STAT,1791,64,na,1855,770.7199999999998
STAT,1831,46,40-44,1877,0.12750172096160434
SIM,1833,25,na,1858,1748
SIM,1878,37,40-44,1915,7
STAT,1927,42,20-24,1969,0.020926056570159005
SIM,1862,26,25-29,1888,32
SIM,1878,33,25-29,1911,11
SIM,1871,24,40-44,1895,1
SIM,1872,26,35-39,1898,9
SIM,1888,33,35-39,1921,12
STAT,1867,69,na,1936,1301.7116903061176
STAT,1900,24,50-100,1924,0.5311001152247128
SIM,1878,31,na,1909,2432
SIM,1895,29,40-44,1924,1
STAT,1864,16,40-44,1880,0.17659103242607224
SIM,1803,59,na,1862,957
STAT,1906,30,35-39,1936,8.063411935908245
SIM,1831,44,na,1875,1498
STAT,1961,11,na,1972,4793.794258101178
SIM,1931,26,15-19,1957,4
STAT,1814,49,45-49,1863,0.6197597313771156
STAT,1836,23,na,1859,1769.101541776432
STAT,1868,36,50-100,1904,1.1127257319675492
SIM,1830,26,45-49,1856,4
STAT,1846,28,50-100,1874,0.5417165251102172
SIM,1929,33,35-39,1962,19
STAT,1865,68,na,1933,1311.8732897098887
STAT,1860,23,45-49,1883,0.5479329241582555
SIM,1895,36,30-34,1931,9
SIM,1945,25,50-100,1970,4
STAT,1887,29,40-44,1916,3.1421834076580097
SIM,1937,25,40-44,1962,4
STAT,1923,26,15-19,1949,0.7683801385012553
STAT,1927,39,na,1966,4409.929423625261
SIM,1859,16,25-29,1875,7
SIM,1865,20,35-39,1885,8
SIM,1845,34,25-29,1879,10
SIM,1911,44,na,1955,3354
SIM,1886,18,na,1904,2459
SIM,1888,23,40-44,1911,1
STAT,1875,30,50-100,1905,0.896399074306054
SIM,1816,77,na,1893,319
SIM,1819,39,45-49,1858,1
STAT,1864,48,45-49,1912,0.19675366486257623
STAT,1901,38,30-34,1939,1.513538364721741
SIM,1901,68,na,1969,2289
STAT,1863,24,40-44,1887,1.7396555279006682
STAT,1823,60,na,1883,1082.9907340216914
SIM,1859,23,15-19,1882,2
SIM,1918,16,40-44,1934,1
STAT,1888,20,50-100,1908,0.4578136128695694
SIM,1851,38,30-34,1889,5
SIM,1854,41,na,1895,1816
SIM,1776,83,na,1859,114
STAT,1854,26,25-29,1880,35.34506120266714
STAT,1864,26,35-39,1890,8.174651450914462
STAT,1937,35,40-44,1972,1.416383665794148
STAT,1871,23,20-24,1894,64.34011774333274
SIM,1906,20,35-39,1926,9
STAT,1853,38,40-44,1891,3.2302882768699672
SIM,1818,58,na,1876,1034
STAT,1806,57,na,1863,1025.7898564639593
STAT,1843,38,30-34,1881,4.042574502626518
SIM,1908,26,25-29,1934,60
STAT,1819,49,45-49,1868,0.4073089481952029
STAT,1866,29,20-24,1895,10.144935725806787
SIM,1881,21,30-34,1902,18
SIM,1861,38,40-44,1899,3
STAT,1796,63,na,1859,921.324153633903
STAT,1809,49,35-39,1858,0.49233302939647616
SIM,1843,89,na,1932,77
SIM,1937,28,na,1965,3305
SIM,1828,38,40-44,1866,2
SIM,1876,36,50-100,1912,1
STAT,1859,33,15-19,1892,0.10691156196964322
STAT,1934,18,25-29,1952,55.22708045085785
STAT,1929,25,40-44,1954,5.532025180638905
STAT,1862,36,25-29,1898,2.3313330970947606
STAT,1901,48,na,1949,2938.1011117236644
SIM,1925,23,20-24,1948,117
SIM,1942,18,25-29,1960,54
SIM,1844,41,na,1885,1722
STAT,1917,23,20-24,1940,111.2934573037062
STAT,1860,30,35-39,1890,7.837650678232482
STAT,1888,5,na,1893,2924.6591980552516
STAT,1837,41,15-19,1878,0.010419677407909533
STAT,1880,19,45-49,1899,0.06458225811802644
SIM,1952,6,na,1958,4396
SIM,1867,15,20-24,1882,16
STAT,1840,39,45-49,1879,1.6082673832447671
STAT,1922,24,40-44,1946,3.6200568629084704
STAT,1854,52,40-44,1906,0.007540542602749346
STAT,1872,26,40-44,1898,2.8501481034028573
STAT,1862,28,25-29,1890,33.968095224906776
SIM,1896,32,30-34,1928,27
STAT,1878,35,25-29,1913,2.858445342373948
STAT,1836,25,50-100,1861,0.530294645617665
STAT,1931,28,15-19,1959,0.8606149961776962
STAT,1898,21,35-39,1919,7.485099232456368
SIM,1924,27,20-24,1951,21
STAT,1862,61,na,1923,1505.8172382057123
STAT,1926,16,25-29,1942,50.32167932245028
SIM,1796,93,na,1889,10
STAT,1854,37,30-34,1891,3.8377981917435737
STAT,1876,18,25-29,1894,5.512028058755652
SIM,1823,79,na,1902,352
STAT,1899,20,25-29,1919,74.55312804883273
SIM,1923,28,30-34,1951,49
STAT,1919,43,25-29,1962,0.07298954800340904
STAT,1888,32,30-34,1920,19.485221925208396
STAT,1906,15,45-49,1921,0.0902757240402616
STAT,1871,26,40-44,1897,2.815103410267174
STAT,1908,28,25-29,1936,58.55989997848117
SIM,1854,28,40-44,1882,1
STAT,1839,39,20-24,1878,0.6015890606965224
SIM,1904,26,40-44,1930,5
STAT,1929,40,30-34,1969,0.1568510859613523
STAT,1922,23,30-34,1945,31.042762585211566
STAT,1959,0,na,1959,4893.562824475121
SIM,1886,38,45-49,1924,1
SIM,1907,42,45-49,1949,1
SIM,1930,23,30-34,1953,43
SIM,1929,34,45-49,1963,2
STAT,1830,28,45-49,1858,1.018344585728907
STAT,1872,25,30-34,1897,24.039528433186252
SIM,1903,15,na,1918,3396
STAT,1856,46,45-49,1902,0.17511074586664402
STAT,1819,38,40-44,1857,10.464506879291621
STAT,1838,29,45-49,1867,0.9494997486344138
STAT,1844,15,25-29,1859,5.116941514017205
SIM,1891,36,45-49,1927,3
STAT,1832,95,na,1927,8.039260577044779
STAT,1849,44,45-49,1893,1.0642032189346653
SIM,1873,55,na,1928,1982
STAT,1793,102,na,1895,0.05332459846316798
STAT,1855,68,na,1923,1082.3257277574937
STAT,1859,15,20-24,1874,15.699491751842586
STAT,1878,16,35-39,1894,0.5409547313005386
STAT,1890,16,35-39,1906,0.6353304427113784
STAT,1886,29,40-44,1915,2.9685749834270054
STAT,1904,24,25-29,1928,77.07215314276148
STAT,1825,30,50-100,1855,2.0249188348321905
SIM,1930,24,40-44,1954,8
STAT,1811,48,na,1859,1287.2698687882687
STAT,1864,38,50-100,1902,1.0314549121258627
STAT,1868,46,20-24,1914,0.010854455377397435
SIM,1886,35,25-29,1921,2
STAT,1916,27,20-24,1943,17.829496470086454
SIM,1890,36,45-49,1926,2
STAT,1825,49,20-24,1874,0.012240912682986977
SIM,1887,37,35-39,1924,13
STAT,1914,21,30-34,1935,26.69455646106701
STAT,1857,70,na,1927,1044.9406033116882
STAT,1766,112,na,1878,7.104561824103532E-4
STAT,1882,15,45-49,1897,0.06032670772012568
SIM,1887,0,na,1887,3262
SIM,1883,19,20-24,1902,18
SIM,1877,14,na,1891,2516
SIM,1781,94,na,1875,3
SIM,1801,78,na,1879,295
STAT,1870,90,na,1960,125.92436851440289
SIM,1901,36,30-34,1937,1
STAT,1867,25,20-24,1892,10.476399332247755
STAT,1871,33,15-19,1904,0.1328081489858372
STAT,1937,25,50-100,1962,0.917268449835515
SIM,1934,16,25-29,1950,68
SIM,1870,28,25-29,1898,45
SIM,1864,92,na,1956,40
STAT,1861,29,35-39,1890,7.5152595299203035
STAT,1846,35,30-34,1881,4.0064809336875085
STAT,1898,47,45-49,1945,0.16944843664497167
SIM,1839,30,35-39,1869,13
STAT,1915,28,30-34,1943,37.6186222990669
SIM,1912,24,25-29,1936,76
STAT,1845,36,40-44,1881,3.2735488300685933
STAT,1854,52,na,1906,1542.2296035979296
STAT,1864,27,45-49,1891,0.9374408770924091
SIM,1887,14,na,1901,2695
STAT,1874,27,20-24,1901,11.327086132519655
SIM,1947,22,45-49,1969,1
SIM,1879,42,50-100,1921,3
SIM,1820,34,20-24,1854,1
STAT,1872,16,na,1888,2416.898433690634
STAT,1897,15,na,1912,3205.714932888385
STAT,1896,30,15-19,1926,0.1792297539329886
SIM,1909,22,25-29,1931,78
SIM,1948,21,35-39,1969,14
STAT,1933,27,50-100,1960,1.2485380448124868
SIM,1859,24,25-29,1883,56
SIM,1829,95,na,1924,5
SIM,1888,22,30-34,1910,19
STAT,1880,42,40-44,1922,2.233024030870954
STAT,1810,49,25-29,1859,0.19799725267809837
SIM,1838,78,na,1916,473
SIM,1916,28,25-29,1944,70
SIM,1884,39,25-29,1923,4
STAT,1870,52,25-29,1922,0.003261278889248435
STAT,1877,21,15-19,1898,3.2438532642103817
SIM,1933,12,na,1945,5030
SIM,1901,29,40-44,1930,5
STAT,1906,22,35-39,1928,8.02733925075627
STAT,1896,50,na,1946,2727.0059391302752
STAT,1828,47,30-34,1875,0.08153545321396441
STAT,1846,28,40-44,1874,2.536760630332904
STAT,1878,38,45-49,1916,1.9507754562809563
STAT,1835,39,35-39,1874,5.3436811072300205
SIM,1840,27,na,1867,1808
STAT,1856,24,35-39,1880,4.94278093446852
STAT,1954,3,na,1957,4593.898326481274
SIM,1941,27,50-100,1968,4
SIM,1956,1,na,1957,4778
STAT,1819,43,20-24,1862,0.3014133056635215
STAT,1939,22,45-49,1961,1.0673760362398428
SIM,1894,34,20-24,1928,3
SIM,1850,19,25-29,1869,5
STAT,1827,48,40-44,1875,0.14801156376695482
STAT,1886,34,20-24,1920,2.674889118273436
SIM,1894,29,40-44,1923,7
SIM,1922,25,50-100,1947,1
STAT,1885,34,na,1919,2226.7178087091443
SIM,1840,20,30-34,1860,17
STAT,1836,38,25-29,1874,2.2086566929443103
STAT,1842,19,25-29,1861,5.121054737814479
SIM,1839,43,50-100,1882,3
STAT,1879,37,35-39,1916,6.984029567075328
SIM,1858,26,50-100,1884,1
SIM,1837,32,25-29,1869,17
SIM,1852,91,na,1943,33
SIM,1878,28,45-49,1906,1
SIM,1902,30,na,1932,3212
SIM,1827,38,40-44,1865,3
STAT,1912,31,na,1943,3529.237587882613
STAT,1884,49,25-29,1933,0.05264917139797145
SIM,1943,2,na,1945,3953
SIM,1950,17,20-24,1967,142
STAT,1928,15,na,1943,4402.1483506951
STAT,1880,16,25-29,1896,5.646553195857017
STAT,1910,21,45-49,1931,1.0009217726842903
SIM,1852,15,25-29,1867,7
STAT,1811,102,na,1913,0.12698849656226718
STAT,1893,40,50-100,1933,1.2790573755826722
STAT,1851,48,50-100,1899,0.1778395222028208
STAT,1871,29,45-49,1900,1.032415136965286
SIM,1814,96,na,1910,4
SIM,1826,77,na,1903,427
STAT,1847,94,na,1941,14.705530163039477
SIM,1872,27,45-49,1899,1
STAT,1829,32,25-29,1861,9.995190514950917
STAT,1856,17,45-49,1873,0.05714911339028228
STAT,1896,23,25-29,1919,71.25213842959603
STAT,1816,88,na,1904,63.973685779105736
SIM,1890,18,15-19,1908,6
STAT,1851,47,20-24,1898,0.008758772466607315
STAT,1908,35,15-19,1943,0.017142423289639656
SIM,1866,102,na,1968,3
STAT,1842,35,45-49,1877,1.7002279034769365
SIM,1847,22,40-44,1869,5
STAT,1865,29,20-24,1894,9.99882584199478
SIM,1864,72,na,1936,1126
STAT,1882,18,15-19,1900,5.441043236856308
SIM,1904,33,30-34,1937,17
STAT,1839,22,40-44,1861,1.7852471193478978
STAT,1919,47,40-44,1966,0.16154903533422854
STAT,1893,36,20-24,1929,0.9283988522718706
STAT,1875,26,45-49,1901,1.0812894064127536
SIM,1828,34,40-44,1862,3
STAT,1855,22,25-29,1877,47.36480803006774
SIM,1852,36,25-29,1888,4
SIM,1938,21,40-44,1959,4
STAT,1837,45,30-34,1882,0.06507936774895436
SIM,1876,18,na,1894,2509
SIM,1874,92,na,1966,99
STAT,1936,32,20-24,1968,2.237761119948106
SIM,1863,36,35-39,1899,10
STAT,1857,53,50-100,1910,0.011067189171999406
SIM,1875,39,30-34,1914,4
STAT,1822,95,na,1917,6.867583558149169
STAT,1932,28,50-100,1960,1.231033079563709
STAT,1887,25,40-44,1912,3.1862739077279594
STAT,1916,20,35-39,1936,9.376220475312364
SIM,1913,15,na,1928,3626
STAT,1905,34,35-39,1939,7.870361630915423
STAT,1897,29,15-19,1926,0.5691178874061253
STAT,1908,47,30-34,1955,0.07614420519447092
STAT,1899,42,35-39,1941,0.16259284798043722
SIM,1902,20,15-19,1922,3
SIM,1913,34,35-39,1947,12
STAT,1895,24,20-24,1919,84.42347282098298
STAT,1901,16,20-24,1917,23.4997802495705
SIM,1813,80,na,1893,240
STAT,1867,70,na,1937,1244.5274957509698
SIM,1886,39,40-44,1925,4
STAT,1774,102,na,1876,0.07733157530721749
STAT,1910,28,30-34,1938,35.60770539166713
STAT,1914,12,na,1926,3858.6535445972363
SIM,1894,3,na,1897,3367
STAT,1855,36,35-39,1891,5.03341326005518
STAT,1878,39,40-44,1917,4.261737616620038
SIM,1833,32,40-44,1865,6
SIM,1892,38,20-24,1930,3
SIM,1951,7,na,1958,4352
STAT,1919,21,15-19,1940,5.523212533639664
SIM,1856,53,na,1909,1685
STAT,1818,80,na,1898,298.23982098538545
SIM,1895,25,40-44,1920,5
SIM,1904,22,25-29,1926,69
STAT,1826,45,20-24,1871,0.011525160145412957
STAT,1926,38,35-39,1964,2.790043464434916
SIM,1837,39,45-49,1876,1
STAT,1851,18,20-24,1869,15.713278805182057
STAT,1905,20,25-29,1925,78.61543941413247
STAT,1877,15,na,1892,2487.397936394179
STAT,1919,21,30-34,1940,29.82125155483674
STAT,1858,48,20-24,1906,0.008787732490516877
STAT,1943,23,15-19,1966,5.34828364823687
SIM,1929,23,40-44,1952,3
STAT,1860,16,20-24,1876,15.791145511550761
STAT,1811,58,na,1869,1073.4719804821202
STAT,1817,42,50-100,1859,2.6711023720689884
STAT,1880,16,40-44,1896,0.18225186861217663
SIM,1854,24,25-29,1878,70
STAT,1825,32,40-44,1857,7.61794032070433
STAT,1884,38,20-24,1922,0.7160487486077952
SIM,1863,22,25-29,1885,48
SIM,1887,45,na,1932,2376
STAT,1884,24,45-49,1908,0.6469021539036495
SIM,1826,39,35-39,1865,14
STAT,1830,51,40-44,1881,0.00692227550366832
STAT,1859,41,na,1900,1750.3847871891005
SIM,1883,26,45-49,1909,1
SIM,1934,8,na,1942,5049
STAT,1829,39,45-49,1868,1.7161062508902423
STAT,1881,23,30-34,1904,16.197162421442243
SIM,1921,34,na,1955,3831
STAT,1907,18,30-34,1925,2.205647348200292
SIM,1915,18,30-34,1933,3
STAT,1846,31,15-19,1877,0.1198954144146629
STAT,1873,38,45-49,1911,1.9020896104333183
STAT,1815,45,45-49,1860,0.5936143159378799
STAT,1843,19,25-29,1862,5.163191564412694
SIM,1880,25,30-34,1905,29
SIM,1891,30,50-100,1921,1
SIM,1832,40,na,1872,1591
SIM,1881,24,35-39,1905,3
SIM,1927,21,30-34,1948,45
STAT,1858,37,15-19,1895,0.04164588602208104
STAT,1867,60,na,1927,1691.6692887827228
SIM,1918,23,30-34,1941,38
STAT,1859,0,na,1859,2944.846457461193
SIM,1884,18,25-29,1902,10
SIM,1822,32,30-34,1854,18
SIM,1922,25,45-49,1947,5
STAT,1882,36,45-49,1918,1.8413327788006562
SIM,1815,39,25-29,1854,1
STAT,1926,44,na,1970,4311.392339210653
SIM,1885,9,na,1894,2471
SIM,1915,27,na,1942,3543
STAT,1869,48,30-34,1917,0.08740525648293017
SIM,1901,21,45-49,1922,4
STAT,1818,39,35-39,1857,19.628454163107353
STAT,1892,23,40-44,1915,2.457542653734915
SIM,1881,38,45-49,1919,1
STAT,1799,61,na,1860,947.5827155722494
SIM,1868,85,na,1953,192
STAT,1867,28,25-29,1895,37.38930542671138
STAT,1846,23,na,1869,1846.7344948540776
SIM,1849,19,na,1868,2048
STAT,1951,11,na,1962,4419.868207086716
SIM,1848,20,35-39,1868,5
STAT,1917,26,25-29,1943,65.43018772132108
STAT,1835,24,15-19,1859,2.6969816710046115
STAT,1885,37,25-29,1922,2.7098409563978207
STAT,1889,20,30-34,1909,20.897916478526643
STAT,1940,18,15-19,1958,43.512621430615155
STAT,1817,47,20-24,1864,0.026848775818714022
STAT,1869,34,20-24,1903,2.4506140082751737
STAT,1814,46,40-44,1860,0.4720491206066175
SIM,1828,34,25-29,1862,11
STAT,1879,30,15-19,1909,0.14174821250863168
SIM,1807,73,na,1880,442
STAT,1854,42,na,1896,1662.2613694830818
SIM,1845,38,40-44,1883,6
SIM,1897,31,50-100,1928,2
SIM,1796,83,na,1879,117
STAT,1925,31,50-100,1956,0.9281667095372238
STAT,1849,37,20-24,1886,0.5685470252585874
SIM,1891,71,na,1962,1717
SIM,1901,17,25-29,1918,13
SIM,1929,30,30-34,1959,21
STAT,1914,25,45-49,1939,1.6561550868985604
SIM,1862,23,20-24,1885,51
SIM,1819,36,40-44,1855,4
SIM,1874,33,40-44,1907,4
STAT,1881,37,40-44,1918,3.9929128271063887
STAT,1927,16,40-44,1943,1.647166711851516
STAT,1843,30,35-39,1873,8.967804892098739
STAT,1899,38,15-19,1937,0.015613493253369332
STAT,1877,18,40-44,1895,0.17883319959260197
SIM,1912,21,20-24,1933,91
STAT,1841,17,15-19,1858,5.2368105441648805
SIM,1927,21,15-19,1948,5
SIM,1836,43,na,1879,1528
SIM,1833,28,20-24,1861,11
STAT,1869,23,30-34,1892,16.237876513769198
SIM,1877,4,na,1881,2679
SIM,1925,26,25-29,1951,74
SIM,1869,35,40-44,1904,8
SIM,1893,37,25-29,1930,4
STAT,1940,22,35-39,1962,9.060526315812437
STAT,1852,30,na,1882,1916.592325632124
STAT,1841,35,45-49,1876,1.6406956264865
SIM,1843,24,15-19,1867,4
SIM,1831,25,35-39,1856,9
SIM,1886,27,40-44,1913,4
STAT,1930,26,40-44,1956,5.601751684693257
SIM,1950,14,na,1964,4274
STAT,1821,49,35-39,1870,0.20761232490912004
STAT,1917,33,15-19,1950,0.12658035539630816
SIM,1913,20,25-29,1933,84
STAT,1818,46,25-29,1864,0.12503494401256912
SIM,1939,31,35-39,1970,8
SIM,1896,18,na,1914,3204
STAT,1887,25,25-29,1912,44.99450455491126
STAT,1925,32,45-49,1957,1.7654862688949353
STAT,1939,29,30-34,1968,37.1707734717728
SIM,1863,29,45-49,1892,3
STAT,1848,42,50-100,1890,0.7601557717115476
SIM,1895,25,25-29,1920,52
STAT,1855,29,45-49,1884,0.8079187011609502
SIM,1798,64,na,1862,827
SIM,1861,20,na,1881,2112
SIM,1836,53,na,1889,1325
SIM,1878,44,30-34,1922,2
STAT,1843,23,45-49,1866,0.6269423994559165
STAT,1878,27,40-44,1905,2.9459948811388412
STAT,1892,19,20-24,1911,20.86049922030883
SIM,1940,14,na,1954,3606
STAT,1856,23,na,1879,1824.1389274476624
STAT,1929,39,15-19,1968,0.02324215733831805
STAT,1852,35,20-24,1887,0.6012042683896783
STAT,1913,29,45-49,1942,1.6142096881306995
SIM,1933,32,45-49,1965,3
STAT,1911,27,35-39,1938,13.828585199988026
SIM,1815,61,na,1876,949
STAT,1912,9,na,1921,3789.483436116646
SIM,1885,23,na,1908,2224
SIM,1843,17,25-29,1860,4
SIM,1910,15,25-29,1925,15
STAT,1888,35,35-39,1923,7.968417259002481
SIM,1869,32,20-24,1901,2
STAT,1937,29,na,1966,3445.8624980148943
STAT,1925,39,30-34,1964,2.0623628719534435
STAT,1801,58,na,1859,1046.1075780942456
SIM,1928,31,25-29,1959,16
STAT,1835,108,na,1943,0.0011428668877895714
SIM,1821,36,30-34,1857,8
SIM,1848,42,50-100,1890,1
SIM,1857,90,na,1947,48
SIM,1831,35,50-100,1866,3
STAT,1857,27,20-24,1884,8.999253767772972
SIM,1921,29,45-49,1950,3
STAT,1904,4,na,1908,3564.116555582097
STAT,1925,25,20-24,1950,20.50832155684865
STAT,1929,43,35-39,1972,0.2459791126737061
SIM,1870,25,20-24,1895,9
STAT,1843,26,15-19,1869,0.40574652761818875
SIM,1903,38,40-44,1941,1
SIM,1914,19,25-29,1933,12
STAT,1840,36,40-44,1876,3.6433435687219506
STAT,1940,15,45-49,1955,0.47935739536082694
SIM,1885,35,25-29,1920,5
STAT,1877,35,25-29,1912,2.849331746186325
SIM,1868,48,50-100,1916,2
STAT,1804,76,na,1880,390.9792829952796
STAT,1848,15,45-49,1863,0.059031015098306716
STAT,1862,25,20-24,1887,9.626234322629058
STAT,1931,14,na,1945,4883.638668792076
STAT,1882,29,20-24,1911,10.707061178652248
STAT,1900,38,15-19,1938,0.01580617009661918
SIM,1825,29,25-29,1854,33
STAT,1840,22,30-34,1862,15.775178603035188
STAT,1873,49,50-100,1922,0.23059065984172653
STAT,1868,49,25-29,1917,0.05086911936650858
STAT,1888,49,45-49,1937,0.1454653767383497
STAT,1961,6,na,1967,4796.7675177493575
STAT,1897,47,45-49,1944,0.16740635735355475
SIM,1933,25,20-24,1958,20
STAT,1846,24,40-44,1870,1.7868956782234875
STAT,1921,21,20-24,1942,119.0149664622432
SIM,1822,40,na,1862,1539
SIM,1803,80,na,1883,206
SIM,1848,43,40-44,1891,4
STAT,1878,46,30-34,1924,0.09546848987480568
SIM,1896,35,35-39,1931,12
STAT,1852,17,25-29,1869,5.207246639010643
STAT,1904,21,20-24,1925,93.64611423917731
SIM,1877,47,50-100,1924,1
SIM,1896,49,50-100,1945,3
SIM,1916,20,50-100,1936,3
STAT,1893,29,30-34,1922,29.967701714268475
SIM,1875,31,35-39,1906,16
STAT,1872,17,45-49,1889,0.062142690184275
STAT,1934,37,30-34,1971,2.375940228015004
SIM,1878,85,na,1963,461
STAT,1905,27,45-49,1932,1.5157363261030583
SIM,1913,27,45-49,1940,1
SIM,1851,30,35-39,1881,11
SIM,1905,27,na,1932,3242
STAT,1867,46,20-24,1913,0.010674226495471345
STAT,1934,32,na,1966,4878.086180376933
SIM,1851,19,25-29,1870,9
SIM,1865,27,20-24,1892,11
STAT,1826,38,30-34,1864,5.613884366295165
STAT,1941,11,na,1952,3838.695173976294
SIM,1909,26,40-44,1935,5
STAT,1833,38,50-100,1871,0.9246910144778797
STAT,1906,26,15-19,1932,0.6262591304476348
STAT,1951,18,25-29,1969,48.73692214328744
SIM,1932,29,na,1961,4491
SIM,1860,17,25-29,1877,5
STAT,1836,35,20-24,1871,0.6100351234817343
STAT,1909,31,15-19,1940,0.11628918101855172
SIM,1834,38,30-34,1872,3
SIM,1849,71,na,1920,946
SIM,1859,37,50-100,1896,1
SIM,1866,34,45-49,1900,2
STAT,1895,24,50-100,1919,0.49957679015625656
SIM,1893,52,na,1945,2662
STAT,1857,39,20-24,1896,0.568312343626112
SIM,1829,44,35-39,1873,5
STAT,1859,47,25-29,1906,0.04322359893501455
SIM,1854,24,40-44,1878,2
STAT,1797,89,na,1886,38.32532204298961
STAT,1893,21,35-39,1914,7.015616874552567
STAT,1931,17,45-49,1948,0.617701449561052
SIM,1892,24,45-49,1916,1
STAT,1832,23,35-39,1855,5.506521199896668
SIM,1830,34,30-34,1864,20
SIM,1822,36,50-100,1858,3
STAT,1919,15,50-100,1934,0.0788360553412226
SIM,1820,37,25-29,1857,3
STAT,1932,16,50-100,1948,0.4698235959743118
SIM,1840,37,45-49,1877,1
SIM,1919,22,35-39,1941,15
STAT,1808,90,na,1898,30.64416887576678
STAT,1856,28,15-19,1884,0.3453559555893294
SIM,1858,85,na,1943,178
SIM,1881,20,na,1901,1980
STAT,1831,24,30-34,1855,18.48567083708769
STAT,1918,25,na,1943,3791.702259610436
STAT,1821,58,na,1879,1153.2570706007516
STAT,1867,21,40-44,1888,1.869375942033116
SIM,1830,27,40-44,1857,2
STAT,1846,24,25-29,1870,49.08892511859475
STAT,1896,48,40-44,1944,0.11905708324991157
SIM,1899,29,25-29,1928,58
STAT,1866,52,50-100,1918,0.013084301963961544
SIM,1889,44,40-44,1933,2
STAT,1829,43,30-34,1872,0.9525277561672032
STAT,1859,82,na,1941,351.76794662634734
STAT,1887,15,na,1902,2680.6913791688266
SIM,1840,19,15-19,1859,4
STAT,1902,22,15-19,1924,4.398087787168086
STAT,1880,89,na,1969,298.04119264487514
SIM,1845,15,35-39,1860,2
SIM,1857,38,na,1895,1863
SIM,1885,33,na,1918,2246
SIM,1922,18,20-24,1940,126
STAT,1832,37,45-49,1869,1.5282233629273214
SIM,1825,33,45-49,1858,1
SIM,1890,29,20-24,1919,15
STAT,1896,34,30-34,1930,21.612385037600426
SIM,1834,30,35-39,1864,14
STAT,1840,38,na,1878,1745.9610363479505
STAT,1902,15,25-29,1917,7.5896882777723045
STAT,1830,83,na,1913,237.14076722696757
SIM,1849,38,25-29,1887,2
STAT,1921,28,40-44,1949,4.890589966979637
SIM,1885,28,35-39,1913,9
STAT,1822,34,30-34,1856,38.57951842678279
SIM,1840,23,35-39,1863,4
SIM,1943,21,15-19,1964,5
STAT,1902,29,35-39,1931,12.771513629274546
SIM,1854,72,na,1926,892
SIM,1872,15,na,1887,2384
SIM,1910,29,35-39,1939,18
SIM,1930,27,45-49,1957,1
STAT,1927,23,15-19,1950,6.17726495320118
SIM,1908,45,na,1953,3111
SIM,1825,40,35-39,1865,2
STAT,1851,22,40-44,1873,1.8248390250433204
STAT,1837,36,50-100,1873,0.9534769748717914
STAT,1857,49,15-19,1906,2.91680133788262E-4
STAT,1914,18,20-24,1932,26.419666926585666
SIM,1859,28,40-44,1887,3
STAT,1898,28,20-24,1926,14.949687100521476
SIM,1818,37,35-39,1855,15
STAT,1863,24,25-29,1887,47.79116149979553
SIM,1938,17,20-24,1955,113
STAT,1872,21,15-19,1893,3.1375863247058793
SIM,1871,24,25-29,1895,49
STAT,1884,31,35-39,1915,9.49265346330219
SIM,1892,31,35-39,1923,19
STAT,1889,16,45-49,1905,0.07637091755304132
STAT,1771,98,na,1869,0.3857432456129188
STAT,1918,15,na,1933,4002.826859657896
SIM,1862,60,na,1922,1640
STAT,1822,48,40-44,1870,0.23543134566271412
STAT,1867,39,30-34,1906,4.679759506221718
STAT,1916,49,30-34,1965,0.08586892542468655
STAT,1931,24,35-39,1955,11.464856183585809
STAT,1817,40,35-39,1857,4.957279333646202
STAT,1876,36,20-24,1912,0.7553928704415206
SIM,1868,25,30-34,1893,26
STAT,1922,27,45-49,1949,1.8469113332774336
SIM,1924,20,35-39,1944,10
SIM,1913,31,30-34,1944,22
STAT,1898,21,na,1919,3033.6190506146195
STAT,1925,35,15-19,1960,0.021813960179507225
SIM,1771,84,na,1855,73
SIM,1942,22,45-49,1964,1
STAT,1816,48,15-19,1864,0.0010365017612530166
SIM,1814,44,40-44,1858,8
STAT,1826,48,25-29,1874,0.053138896938222636
SIM,1835,22,15-19,1857,3
STAT,1873,35,40-44,1908,4.2374892423200965
SIM,1883,23,40-44,1906,1
STAT,1877,28,35-39,1905,9.42571266204401
STAT,1838,22,25-29,1860,50.65523834205855
STAT,1834,76,na,1910,586.4015409057022
STAT,1884,27,15-19,1911,0.4235493418243398
SIM,1859,71,na,1930,1096
SIM,1814,65,na,1879,828
STAT,1909,11,na,1920,3663.2028320421623
SIM,1917,38,35-39,1955,8
SIM,1863,33,30-34,1896,16
STAT,1865,49,50-100,1914,0.20643199683372726
SIM,1833,35,45-49,1868,1
STAT,1827,48,25-29,1875,0.049798282748870035
SIM,1927,24,35-39,1951,15
STAT,1850,38,na,1888,1667.4736555151635
STAT,1825,35,45-49,1860,2.7604380354160996
STAT,1936,35,25-29,1971,0.9145700549330145
SIM,1846,22,25-29,1868,51
STAT,1863,49,40-44,1912,0.1391984709256649
STAT,1828,90,na,1918,44.75593723412782
STAT,1848,19,50-100,1867,0.04323936274811515
STAT,1830,29,40-44,1859,2.628216059391167
STAT,1866,33,40-44,1899,3.761292596421274
STAT,1877,36,20-24,1913,0.7593133627158482
STAT,1882,0,na,1882,3274.5084291085705
STAT,1887,28,45-49,1915,1.1689023178153728
SIM,1881,35,40-44,1916,3
STAT,1935,21,15-19,1956,6.849849992788417
STAT,1892,26,45-49,1918,1.3180037017463528
SIM,1822,35,35-39,1857,8
SIM,1873,49,50-100,1922,2
SIM,1832,35,45-49,1867,4
SIM,1837,38,na,1875,1644
SIM,1828,31,20-24,1859,2
SIM,1838,31,30-34,1869,15
SIM,1879,25,40-44,1904,4
STAT,1855,33,30-34,1888,12.460683998768873
SIM,1907,20,35-39,1927,8
STAT,1813,91,na,1904,24.50772118441242
STAT,1928,44,30-34,1972,0.15346894745267234
SIM,1838,24,na,1862,1725
STAT,1916,20,50-100,1936,0.6552216333149088
STAT,1938,30,30-34,1968,14.9808634426453
STAT,1894,39,25-29,1933,3.463644293400142
STAT,1847,34,35-39,1881,7.797837525219655
SIM,1855,27,45-49,1882,1
STAT,1883,39,15-19,1922,0.05146838895662456
STAT,1893,39,25-29,1932,3.4163185463173398
SIM,1844,34,25-29,1878,15
SIM,1938,24,45-49,1962,5
STAT,1843,16,20-24,1859,16.442023725750772
STAT,1913,22,25-29,1935,84.53696354606338
SIM,1864,21,30-34,1885,15
STAT,1869,26,35-39,1895,8.853614549016992
STAT,1923,22,35-39,1945,10.350802292240983
SIM,1854,21,20-24,1875,69
STAT,1814,76,na,1890,390.8949116823218
STAT,1923,17,50-100,1940,0.4156406175188175
STAT,1841,28,20-24,1869,9.897794627004112
STAT,1837,48,35-39,1885,0.09057405776569204
STAT,1842,16,20-24,1858,16.307840305667938
SIM,1878,25,40-44,1903,5
SIM,1921,22,25-29,1943,98
STAT,1910,17,25-29,1927,8.10942831661939
SIM,1850,16,20-24,1866,12
SIM,1877,37,40-44,1914,7
SIM,1931,22,35-39,1953,16
STAT,1920,17,35-39,1937,4.447679067197177
STAT,1869,37,40-44,1906,4.002949635855131
STAT,1836,34,25-29,1870,8.007694639130195
STAT,1764,105,na,1869,0.014289462369846666
STAT,1897,69,na,1966,2116.864892127851
STAT,1845,47,30-34,1892,0.06786623657791081
STAT,1876,74,na,1950,1082.3272974542845
STAT,1938,25,na,1963,3508.7103481652052
STAT,1857,49,na,1906,1640.5860260721754
STAT,1934,22,45-49,1956,1.4284384172884377
STAT,1945,9,na,1954,4061.5214660124298
SIM,1823,80,na,1903,295
STAT,1856,21,30-34,1877,15.417104304668175
STAT,1849,47,15-19,1896,2.869719444621817E-4
STAT,1846,21,20-24,1867,60.38481470670088
STAT,1852,38,25-29,1890,2.1766842270112488
SIM,1838,24,40-44,1862,2
STAT,1842,38,15-19,1880,0.04642480143456369
SIM,1849,31,40-44,1880,3
SIM,1916,32,45-49,1948,1
SIM,1925,37,30-34,1962,5
STAT,1886,84,na,1970,666.5855557745442
STAT,1897,15,40-44,1912,0.23215617758883364
STAT,1951,15,20-24,1966,152.604612917276
STAT,1765,115,na,1880,1.7283610011320613E-4
SIM,1943,18,40-44,1961,1
SIM,1868,36,50-100,1904,1
STAT,1941,29,20-24,1970,17.819682382639577
STAT,1895,27,40-44,1922,3.692930538889253
SIM,1793,65,na,1858,705
STAT,1908,32,45-49,1940,1.4028561010948146
STAT,1913,26,40-44,1939,4.4014922246300205
STAT,1849,41,na,1890,1673.458318358136
STAT,1846,27,45-49,1873,0.9470478979405935
STAT,1836,27,35-39,1863,7.884355153546194
STAT,1861,75,na,1936,807.5889715572865
STAT,1906,19,25-29,1925,7.753398915519041
SIM,1860,38,25-29,1898,2
STAT,1909,1,na,1910,3855.1238768387648
SIM,1890,34,na,1924,2810
STAT,1852,28,30-34,1880,22.124421371928452
STAT,1923,26,na,1949,4077.4211150384203
STAT,1862,28,40-44,1890,2.4054416551748736
SIM,1844,27,35-39,1871,8
SIM,1854,27,45-49,1881,6
SIM,1895,22,20-24,1917,70
SIM,1855,34,35-39,1889,11
STAT,1828,36,40-44,1864,4.251055168277783
STAT,1862,24,25-29,1886,46.547768197359574
SIM,1860,28,30-34,1888,28
STAT,1935,18,40-44,1953,1.8015507251666611
SIM,1870,28,40-44,1898,2
SIM,1865,67,na,1932,1336
STAT,1921,33,50-100,1954,0.8656124561784588
STAT,1899,47,na,1946,2899.6341573402815
STAT,1905,31,30-34,1936,13.742119064344115
STAT,1907,37,20-24,1944,0.23084809871556586
STAT,1932,16,15-19,1948,56.911309775358724
SIM,1810,62,na,1872,923
STAT,1917,37,30-34,1954,1.7882716282866264
STAT,1871,85,na,1956,280.367025682247
STAT,1876,15,20-24,1891,17.370177101360213
SIM,1836,36,40-44,1872,5
STAT,1830,43,50-100,1873,0.7924844656002955
SIM,1874,36,45-49,1910,5
STAT,1887,22,20-24,1909,72.8058102156688
SIM,1846,53,na,1899,1484
STAT,1946,21,25-29,1967,97.13887447593727
STAT,1897,22,30-34,1919,22.50431221826379
STAT,1834,42,na,1876,1568.78406761903
STAT,1899,28,20-24,1927,15.13423419368965
SIM,1870,24,25-29,1894,55
STAT,1824,35,45-49,1859,3.2878925016707066
SIM,1841,98,na,1939,1
STAT,1860,19,25-29,1879,4.958800124461524
STAT,1819,75,na,1894,514.0999672815637
STAT,1870,19,35-39,1889,0.5067392488828709
STAT,1870,38,na,1908,2170.039141863125
SIM,1937,29,20-24,1966,15
STAT,1881,26,35-39,1907,8.831415409870297
STAT,1927,29,na,1956,4285.50641560386
SIM,1850,68,na,1918,1116
STAT,1855,46,50-100,1901,0.1744368121638578
STAT,1888,28,45-49,1916,1.2347478941357966
SIM,1935,23,30-34,1958,41
STAT,1891,26,45-49,1917,1.3027402794869842
SIM,1786,83,na,1869,102
STAT,1881,23,50-100,1904,0.37081419821587586
STAT,1927,23,30-34,1950,33.35264956188402
STAT,1875,48,20-24,1923,0.01150011858055005
STAT,1844,42,na,1886,1661.7225169812546
SIM,1808,58,na,1866,1052
STAT,1866,36,45-49,1902,1.7446619925921854
SIM,1894,37,na,1931,3005
STAT,1844,29,35-39,1873,8.173427663816392
SIM,1881,74,na,1955,878
STAT,1884,17,20-24,1901,16.55028823729488
STAT,1877,70,na,1947,1375.4574645270566
SIM,1940,16,15-19,1956,42
STAT,1848,89,na,1937,75.6830293722959
SIM,1920,15,35-39,1935,4
SIM,1906,28,30-34,1934,37
STAT,1907,30,na,1937,3365.931643045681
STAT,1855,5,na,1860,2118.1992436690853
STAT,1915,39,20-24,1954,0.24901599087519624
SIM,1887,23,25-29,1910,71
SIM,1917,28,40-44,1945,5
SIM,1862,26,40-44,1888,1
SIM,1938,31,35-39,1969,15
SIM,1832,39,na,1871,1603
STAT,1878,55,na,1933,2033.4981270180301
STAT,1905,24,40-44,1929,2.826914471514755
STAT,1873,17,45-49,1890,0.06263829394761444
STAT,1935,25,30-34,1960,50.4983826512618
STAT,1858,41,35-39,1899,1.3490296712384924
STAT,1860,37,20-24,1897,0.5918266901261682
STAT,1827,94,na,1921,11.091260330430043
SIM,1841,29,25-29,1870,48
SIM,1801,88,na,1889,38
SIM,1855,2,na,1857,2698
STAT,1854,23,20-24,1877,57.88721945804604
SIM,1831,54,na,1885,1318
STAT,1833,29,25-29,1862,33.505991603208884
STAT,1881,19,45-49,1900,0.05926399522823221
SIM,1941,27,20-24,1968,17
SIM,1884,7,na,1891,2552
STAT,1830,36,30-34,1866,4.287417424764184
STAT,1883,17,20-24,1900,16.41426416405523
SIM,1921,26,40-44,1947,5
STAT,1914,28,15-19,1942,0.6698272200267654
SIM,1908,30,45-49,1938,2
SIM,1913,24,40-44,1937,2
SIM,1891,17,20-24,1908,23
SIM,1902,27,35-39,1929,19
STAT,1798,75,na,1873,410.7913650830831
SIM,1884,15,20-24,1899,17
STAT,1919,17,45-49,1936,0.5215024745166681
STAT,1878,49,35-39,1927,0.13480863027942502
STAT,1887,32,15-19,1919,0.15045321232193923
SIM,1935,16,40-44,1951,1
STAT,1863,45,25-29,1908,0.0483086847332325
STAT,1850,49,50-100,1899,0.16929288674515536
SIM,1869,35,25-29,1904,2
STAT,1888,46,40-44,1934,0.19160339590650868
STAT,1904,12,na,1916,3498.843048477808
SIM,1943,25,30-34,1968,44
STAT,1933,27,20-24,1960,22.897197967263665
STAT,1851,25,45-49,1876,0.9671577271177948
SIM,1897,20,30-34,1917,28
STAT,1931,21,30-34,1952,35.32222992847696
STAT,1879,23,25-29,1902,56.351487619566846
SIM,1877,34,20-24,1911,2
STAT,1837,38,40-44,1875,3.329738072530728
SIM,1859,25,50-100,1884,1
STAT,1838,90,na,1928,53.771183968990144
STAT,1925,28,25-29,1953,73.19231294648495
STAT,1870,26,25-29,1896,39.291511724532114
STAT,1863,56,na,1919,1693.7397919916348
SIM,1902,20,na,1922,3193
STAT,1928,25,na,1953,4389.9824948107835
STAT,1862,17,35-39,1879,0.5064182679592633
STAT,1870,89,na,1959,148.89429074811457
SIM,1781,84,na,1865,82
STAT,1930,29,45-49,1959,2.073295913225123
SIM,1869,38,45-49,1907,1
STAT,1856,39,20-24,1895,0.5646061750629336
SIM,1880,34,na,1914,2441
SIM,1892,17,20-24,1909,23
STAT,1799,108,na,1907,6.124005745402789E-4
SIM,1883,52,na,1935,2024
STAT,1869,41,na,1910,2123.0456849285342
SIM,1847,38,na,1885,1702
SIM,1871,19,na,1890,2420
STAT,1844,44,50-100,1888,0.7403466382073551
SIM,1876,34,20-24,1910,2
STAT,1836,38,40-44,1874,3.3580197148630444
SIM,1933,31,50-100,1964,1
SIM,1878,6,na,1884,2703
STAT,1823,91,na,1914,30.49434882841584
SIM,1880,21,15-19,1901,2
STAT,1840,25,35-39,1865,8.500076639432864
STAT,1783,76,na,1859,293.22537195866045
STAT,1876,30,na,1906,2345.969603313891
SIM,1933,28,25-29,1961,81
STAT,1871,26,25-29,1897,39.753074244057444
STAT,1899,35,45-49,1934,2.6053048642704884
STAT,1928,40,15-19,1968,0.0018547592391909378
STAT,1861,6,na,1867,2249.4388317575626
STAT,1866,3,na,1869,2775.648331616014
SIM,1923,15,na,1938,4022
SIM,1844,38,40-44,1882,2
SIM,1911,34,na,1945,3449
STAT,1919,11,na,1930,4142.639247852596
STAT,1902,26,30-34,1928,33.68641062983654
STAT,1865,36,45-49,1901,1.7195349372890736
SIM,1840,34,40-44,1874,7
SIM,1868,21,15-19,1889,4
STAT,1847,27,45-49,1874,0.981930389069508
STAT,1866,105,na,1971,0.327888089753554
SIM,1905,32,35-39,1937,8
STAT,1820,102,na,1922,0.15618440818426238
SIM,1830,37,35-39,1867,15
STAT,1834,47,20-24,1881,0.007877470951375006
STAT,1862,71,na,1933,1075.6328332015141
STAT,1913,33,30-34,1946,14.74240261750196
STAT,1916,44,na,1960,3583.369635495496
STAT,1938,23,40-44,1961,3.142278456233012
STAT,1863,35,30-34,1898,4.467785705224353
STAT,1911,30,50-100,1941,0.7665167501631894
SIM,1895,33,na,1928,2955
SIM,1928,7,na,1935,4755
SIM,1948,21,na,1969,3725
SIM,1805,51,na,1856,1196
SIM,1850,5,na,1855,2231
STAT,1858,34,45-49,1892,1.282197717924079
STAT,1909,35,30-34,1944,1.6447647370295653
STAT,1886,15,30-34,1901,1.5982710462227419
STAT,1886,48,30-34,1934,0.0954044042254719
SIM,1834,20,40-44,1854,5
SIM,1921,33,30-34,1954,13
STAT,1839,75,na,1914,686.416595579558
SIM,1844,72,na,1916,833
STAT,1821,44,50-100,1865,1.660187177836094
STAT,1928,33,25-29,1961,10.91205475254692
SIM,1874,29,20-24,1903,11
STAT,1893,22,na,1915,2834.7851363615673
STAT,1840,83,na,1923,276.46837604671424
SIM,1932,18,30-34,1950,15
SIM,1936,33,25-29,1969,13
SIM,1894,15,30-34,1909,2
SIM,1851,16,20-24,1867,15
SIM,1926,33,na,1959,4167
STAT,1822,37,35-39,1859,12.826603123931445
STAT,1939,8,na,1947,3762.8930190081987
STAT,1832,34,40-44,1866,3.358087681119285
STAT,1855,47,40-44,1902,0.12068486428715594
STAT,1828,33,20-24,1861,2.8087720575953186
SIM,1861,38,25-29,1899,2
SIM,1852,29,35-39,1881,10
STAT,1912,15,35-39,1927,0.8051177089106318
STAT,1812,95,na,1907,5.718388849723729
STAT,1902,19,40-44,1921,0.2425292270182014
SIM,1859,38,35-39,1897,13
STAT,1876,25,15-19,1901,0.44547775261949973
STAT,1941,27,50-100,1968,0.9726340257484044
SIM,1889,21,35-39,1910,14
SIM,1910,26,30-34,1936,45
SIM,1946,23,40-44,1969,3
SIM,1898,51,na,1949,2729
STAT,1844,36,25-29,1880,2.3716162326249806
SIM,1895,28,45-49,1923,1
STAT,1863,28,40-44,1891,2.4788007526591764
SIM,1900,6,na,1906,3406
SIM,1900,29,25-29,1929,59
STAT,1867,49,25-29,1916,0.05002448145615506
SIM,1871,28,40-44,1899,5
STAT,1924,18,30-34,1942,13.677451430662067
SIM,1873,36,45-49,1909,5
SIM,1898,30,25-29,1928,15
STAT,1822,44,25-29,1866,0.9182444871340328
SIM,1828,37,45-49,1865,2
STAT,1873,24,35-39,1897,5.560660437293603
STAT,1911,7,na,1918,3765.6217649641844
STAT,1946,10,na,1956,4117.1228821721
STAT,1919,24,35-39,1943,9.679353794566055
STAT,1943,16,25-29,1959,43.422605004904945
STAT,1854,26,40-44,1880,2.5029511357251613
SIM,1836,33,20-24,1869,1
STAT,1824,76,na,1900,500.1700912400619
STAT,1896,37,35-39,1933,8.830770269440983
SIM,1951,16,25-29,1967,56
STAT,1853,38,25-29,1891,2.124644412083023
STAT,1840,18,45-49,1858,0.0585524263729124
STAT,1871,52,40-44,1923,0.009807113485647107
STAT,1921,24,25-29,1945,97.95109808860776
SIM,1879,32,30-34,1911,27
STAT,1909,28,40-44,1937,4.192255743632405
STAT,1877,39,40-44,1916,4.2481498963583615
SIM,1864,102,na,1966,3
SIM,1934,20,45-49,1954,2
STAT,1879,20,20-24,1899,68.4524108999795
STAT,1962,8,na,1970,4755.7647246168035
SIM,1858,25,20-24,1883,10
STAT,1829,46,35-39,1875,0.11445157316842763
STAT,1843,29,20-24,1872,10.267078795075607
STAT,1881,27,45-49,1908,1.0127563061872318
STAT,1820,47,25-29,1867,0.09497396250771141
STAT,1894,16,na,1910,3076.7056740995977
SIM,1807,93,na,1900,12
STAT,1883,64,na,1947,1609.4888826681795
SIM,1823,56,na,1879,1133
SIM,1870,58,na,1928,1823
SIM,1856,11,na,1867,2259
SIM,1948,20,45-49,1968,2
STAT,1911,49,45-49,1960,0.19319275909527067
SIM,1862,33,35-39,1895,10
SIM,1871,28,35-39,1899,11
SIM,1822,36,45-49,1858,1
SIM,1862,38,40-44,1900,3
STAT,1853,51,20-24,1904,5.498651644890344E-4
STAT,1863,28,35-39,1891,7.984396888190911
STAT,1871,31,15-19,1902,0.13391601266978567
SIM,1844,39,30-34,1883,7
SIM,1920,34,50-100,1954,5
STAT,1854,22,25-29,1876,48.43467665334668
STAT,1856,30,35-39,1886,7.743855724007544
SIM,1811,47,na,1858,1310
STAT,1963,7,na,1970,4716.113482814098
STAT,1879,59,na,1938,1919.038849321794
STAT,1946,9,na,1955,4117.5758155118065
STAT,1824,52,35-39,1876,0.009740999106439076
STAT,1827,50,50-100,1877,0.013290558943551514
STAT,1831,33,40-44,1864,3.514194645786919
SIM,1817,38,50-100,1855,4
STAT,1950,20,35-39,1970,10.560550964638843
STAT,1844,19,40-44,1863,0.16130089936470152
STAT,1903,18,na,1921,3385.604537719467
SIM,1862,22,25-29,1884,61
SIM,1885,38,35-39,1923,11
STAT,1845,40,30-34,1885,0.8460424301602935
STAT,1883,49,15-19,1932,3.626139798434132E-4
STAT,1794,81,na,1875,196.8138308225794
STAT,1862,19,na,1881,2096.2499464577913
SIM,1845,59,na,1904,1365
STAT,1858,65,na,1923,1253.3262490375478
STAT,1927,20,na,1947,4276.210165433714
SIM,1824,33,45-49,1857,2
STAT,1884,17,15-19,1901,5.540138866257679
STAT,1849,17,20-24,1866,15.729395513825178
STAT,1852,38,30-34,1890,4.029181463606544
SIM,1851,29,20-24,1880,8
STAT,1875,69,na,1944,1424.3066558488622
STAT,1868,45,30-34,1913,0.08818183388438328
STAT,1790,91,na,1881,17.697691932820604
SIM,1851,32,50-100,1883,6
SIM,1857,40,45-49,1897,5
STAT,1843,32,20-24,1875,2.3444382884414185
STAT,1826,35,25-29,1861,3.303273301318909
STAT,1862,70,na,1932,1130.6502756128348
SIM,1830,24,30-34,1854,19
STAT,1923,48,25-29,1971,0.05846406978742705
STAT,1796,96,na,1892,2.000454832578342
STAT,1840,20,30-34,1860,16.00417348066459
SIM,1816,39,25-29,1855,2
STAT,1812,103,na,1915,0.061725570830088
SIM,1841,30,40-44,1871,2
STAT,1845,48,40-44,1893,0.11907486782175157
STAT,1877,38,35-39,1915,6.899313823227322
STAT,1850,42,35-39,1892,1.2732475886489916
STAT,1803,83,na,1886,135.68467263393143
STAT,1874,26,45-49,1900,1.0757116075657085
SIM,1864,30,35-39,1894,8
SIM,1909,16,25-29,1925,9
STAT,1879,48,40-44,1927,0.16692427350703343
STAT,1828,67,na,1895,899.8909121547416
STAT,1864,18,na,1882,2192.9239776058307
STAT,1960,6,na,1966,4835.718837882286
STAT,1894,35,30-34,1929,6.538120072653211
SIM,1840,36,na,1876,1732
SIM,1860,38,30-34,1898,11
STAT,1816,44,50-100,1860,2.9045510046607275
SIM,1891,24,45-49,1915,4
STAT,1883,24,45-49,1907,0.6415853724252949
STAT,1944,23,15-19,1967,5.4276994912162495
SIM,1870,34,na,1904,2194
STAT,1833,30,40-44,1863,3.4733201790863926
STAT,1885,46,15-19,1931,3.775402993967629E-4
SIM,1874,48,na,1922,2125
STAT,1893,26,25-29,1919,50.87716041102372
SIM,1882,26,45-49,1908,1
STAT,1859,39,25-29,1898,2.148850318492544
SIM,1869,61,na,1930,1675
STAT,1938,25,40-44,1963,4.365615255492423
SIM,1857,17,20-24,1874,12
STAT,1827,44,30-34,1871,1.021239349495888
STAT,1922,49,20-24,1971,0.011924053688959818
STAT,1837,95,na,1932,8.392911042168016
STAT,1849,40,45-49,1889,1.0976183500087962
STAT,1872,34,40-44,1906,4.076878556502469
SIM,1865,87,na,1952,108
SIM,1891,43,50-100,1934,1
STAT,1811,54,20-24,1865,0.0022508864023784783
STAT,1923,46,na,1969,4070.457915463643
SIM,1834,35,25-29,1869,2
STAT,1845,24,25-29,1869,49.341827577161936
STAT,1828,32,25-29,1860,11.029736864313575
STAT,1867,26,50-100,1893,0.5693546497586867
SIM,1881,30,40-44,1911,3
SIM,1853,40,30-34,1893,3
STAT,1891,32,50-100,1923,1.0713720870493115
STAT,1843,16,15-19,1859,5.503897779719359
SIM,1836,43,35-39,1879,7
STAT,1864,52,35-39,1916,0.0072300262041058
SIM,1835,44,30-34,1879,4
STAT,1880,53,30-34,1933,0.005821823841022816
STAT,1889,6,na,1895,3046.7191848347757
STAT,1911,45,na,1956,3300.353404477812
STAT,1813,51,20-24,1864,0.002173581684419855
SIM,1840,28,na,1868,1787
SIM,1851,32,20-24,1883,2
STAT,1895,34,35-39,1929,12.37775627636559
STAT,1841,19,15-19,1860,5.175302591909698
SIM,1874,37,20-24,1911,1
STAT,1846,47,45-49,1893,0.16562134791876143
SIM,1832,92,na,1924,15
STAT,1886,49,40-44,1935,0.1673110345359762
STAT,1845,39,na,1884,1707.7908570288998
STAT,1895,23,25-29,1918,70.35430917957791
STAT,1812,44,na,1856,1341.4668475316832
SIM,1855,43,45-49,1898,1
SIM,1922,20,25-29,1942,109
STAT,1864,41,25-29,1905,0.5446333320464057
STAT,1877,16,50-100,1893,0.04814552701821236
STAT,1817,42,20-24,1859,0.40153827273665366
SIM,1910,48,na,1958,3155
STAT,1817,39,20-24,1856,2.248163151508285
STAT,1792,101,na,1893,0.09609355188980549
STAT,1847,43,45-49,1890,1.0932560302435124
SIM,1880,34,40-44,1914,8
STAT,1866,106,na,1972,0.1702755638899181
SIM,1870,29,30-34,1899,24
STAT,1896,32,30-34,1928,21.79901954073964
STAT,1947,18,45-49,1965,0.5314532601682342
SIM,1853,24,25-29,1877,57
STAT,1854,75,na,1929,741.3096979822246
STAT,1858,89,na,1947,77.9108029196982
SIM,1881,10,na,1891,2161
SIM,1886,36,30-34,1922,6
STAT,1838,17,45-49,1855,0.05884884211141208
STAT,1874,31,40-44,1905,4.204348220147252
STAT,1828,43,35-39,1871,1.5709009017097564
SIM,1841,25,45-49,1866,2
STAT,1845,90,na,1935,55.53382478531992
STAT,1880,40,25-29,1920,0.6447437873157
STAT,1840,15,50-100,1855,0.04469951722238099
SIM,1838,40,35-39,1878,5
STAT,1767,111,na,1878,8.716287344271529E-4
SIM,1869,39,35-39,1908,8
SIM,1844,18,na,1862,2102
STAT,1866,37,20-24,1903,0.6714009283022228
SIM,1886,41,na,1927,2266
SIM,1863,37,45-49,1900,2
STAT,1865,53,35-39,1918,0.0072717415516654095
SIM,1887,35,35-39,1922,15
STAT,1837,18,40-44,1855,0.16092804920823608
SIM,1836,32,25-29,1868,12
STAT,1823,36,40-44,1859,7.418355951450187
STAT,1879,35,35-39,1914,7.050357742152794
STAT,1889,37,15-19,1926,0.06549149334537173
STAT,1949,15,45-49,1964,0.5491864984626275
STAT,1862,29,30-34,1891,20.147493002592306
STAT,1848,44,45-49,1892,1.0636609298052007
STAT,1882,50,30-34,1932,0.005550514779588515
STAT,1862,44,25-29,1906,0.5104894985712438
SIM,1853,54,na,1907,1673
SIM,1860,42,45-49,1902,1
STAT,1807,73,na,1880,521.6078067125237
STAT,1821,80,na,1901,334.0411815908168
SIM,1841,77,na,1918,577
STAT,1829,41,30-34,1870,0.9822305773190532
SIM,1813,43,40-44,1856,5
SIM,1791,85,na,1876,79
STAT,1911,13,na,1924,3726.814502367235
STAT,1897,31,35-39,1928,12.846978014521364
SIM,1828,87,na,1915,93
STAT,1812,50,20-24,1862,0.0024171524919557484
SIM,1851,16,15-19,1867,9
SIM,1849,41,na,1890,1703
STAT,1938,8,na,1946,3716.3051281768917
STAT,1834,29,25-29,1863,33.843526725792046
STAT,1914,26,50-100,1940,0.9510032720996091
SIM,1843,22,15-19,1865,1
SIM,1932,30,35-39,1962,15
SIM,1774,81,na,1855,133
STAT,1900,38,50-100,1938,0.34558031161594366
STAT,1890,27,40-44,1917,3.459957227030046
STAT,1867,36,25-29,1903,2.5661410992148515
STAT,1911,44,50-100,1955,0.10460194814440094
STAT,1894,19,25-29,1913,6.849393292786905
STAT,1925,32,50-100,1957,0.9276283728456918
SIM,1870,66,na,1936,1504
STAT,1853,43,50-100,1896,0.7778133605309909
SIM,1906,20,40-44,1926,3
STAT,1914,20,25-29,1934,86.04381742746094
SIM,1915,30,35-39,1945,9
SIM,1868,35,25-29,1903,1
STAT,1883,32,na,1915,2209.40692040839
SIM,1856,41,40-44,1897,5
STAT,1884,20,45-49,1904,0.6548614872911975
STAT,1939,24,45-49,1963,1.0666503438171315
STAT,1800,54,45-49,1854,0.04068886238995369
STAT,1899,28,15-19,1927,0.5853018795870346
STAT,1850,93,na,1943,20.57474487523037
STAT,1886,41,30-34,1927,1.1527038483242782
STAT,1887,46,na,1933,2383.6975556333405
STAT,1879,18,45-49,1897,0.06433254298102298
STAT,1828,59,na,1887,1140.2526000422208
STAT,1870,23,20-24,1893,63.59308150986187
STAT,1866,45,50-100,1911,0.21604754641068313
SIM,1831,40,25-29,1871,2
STAT,1844,28,25-29,1872,36.091885893589655
STAT,1861,40,15-19,1901,0.010942802816566672
SIM,1852,28,25-29,1880,38
SIM,1877,41,30-34,1918,4
SIM,1919,18,35-39,1937,6
STAT,1767,103,na,1870,0.03664547049353274
STAT,1894,48,na,1942,2700.200583991069
STAT,1870,41,50-100,1911,0.9823501619592783
STAT,1880,42,20-24,1922,0.15766555183577396
STAT,1830,37,40-44,1867,3.474136381134048
STAT,1838,34,35-39,1872,8.406319908202287
STAT,1890,34,na,1924,2732.6557838453846
SIM,1804,77,na,1881,294
STAT,1840,40,25-29,1880,0.5259471712449812
STAT,1869,41,30-34,1910,1.0560558113599583
SIM,1936,9,na,1945,3002
STAT,1835,22,15-19,1857,2.736131464693895
STAT,1833,25,45-49,1858,0.9095892241032761
STAT,1824,45,na,1869,1405.3927070933046
STAT,1878,36,30-34,1914,5.266613807010859
STAT,1865,50,30-34,1915,0.005183367283375279
STAT,1904,48,15-19,1952,3.018519254327716E-4
STAT,1830,30,15-19,1860,0.12305549124115832
STAT,1843,52,45-49,1895,0.010414321788551471
STAT,1819,50,30-34,1869,0.01058001700341512
SIM,1875,36,25-29,1911,3
STAT,1903,26,na,1929,3218.5736423017584
SIM,1933,8,na,1941,5063
SIM,1894,30,20-24,1924,3
STAT,1835,35,20-24,1870,0.607084750987457
SIM,1890,78,na,1968,1253
SIM,1872,24,35-39,1896,7
SIM,1897,37,45-49,1934,7
STAT,1900,53,na,1953,2776.686184408454
STAT,1946,23,50-100,1969,0.6915143434784854
SIM,1888,31,35-39,1919,12
SIM,1907,60,na,1967,2898
STAT,1928,18,35-39,1946,4.982248060406974
STAT,1835,37,na,1872,1652.0383380666615
STAT,1823,40,25-29,1863,0.881113106239482
STAT,1879,51,40-44,1930,0.010445076600600525
STAT,1895,36,30-34,1931,6.601925580036192
STAT,1930,38,15-19,1968,0.023640215889201482
STAT,1815,60,na,1875,1027.5627057833049
SIM,1950,6,na,1956,4278
SIM,1826,29,40-44,1855,3
STAT,1869,29,40-44,1898,2.71967588835875
SIM,1815,69,na,1884,697
STAT,1887,48,45-49,1935,0.24620029943983518
STAT,1850,25,45-49,1875,0.9332055678438544
STAT,1890,42,35-39,1932,2.0889638064333984
STAT,1841,57,na,1898,1374.972605186723
STAT,1830,30,50-100,1860,0.7917343466259996
STAT,1864,24,35-39,1888,4.9345574243198405
STAT,1861,48,25-29,1909,0.04461809338320779
STAT,1886,30,20-24,1916,2.7196750290436613
SIM,1882,59,na,1941,1763
STAT,1890,31,25-29,1921,11.878831535767128
STAT,1840,26,45-49,1866,0.971081843607802
STAT,1823,51,35-39,1874,0.01007812051014375
SIM,1867,39,50-100,1906,3
SIM,1795,75,na,1870,390
SIM,1936,18,35-39,1954,3
SIM,1873,23,na,1896,2276
STAT,1851,29,25-29,1880,35.80080311561625
STAT,1828,45,30-34,1873,0.08371959200855492
SIM,1824,97,na,1921,1
STAT,1870,30,15-19,1900,0.13288204658972178
STAT,1928,23,30-34,1951,33.798822657706886
STAT,1844,44,30-34,1888,0.8056713433465581
STAT,1869,49,40-44,1918,0.15328290140023718
STAT,1860,28,na,1888,1838.611860197711
SIM,1787,88,na,1875,38
SIM,1861,41,na,1902,2002
SIM,1862,35,30-34,1897,9
SIM,1837,24,40-44,1861,1
SIM,1894,25,25-29,1919,50
STAT,1885,26,20-24,1911,11.079290993616771
SIM,1946,25,40-44,1971,5
SIM,1846,34,35-39,1880,9
SIM,1879,41,35-39,1920,4
SIM,1887,15,40-44,1902,1
SIM,1880,37,50-100,1917,1
STAT,1937,30,na,1967,3538.347436509329
SIM,1802,62,na,1864,911
SIM,1878,42,30-34,1920,1
SIM,1861,18,25-29,1879,7
STAT,1838,47,40-44,1885,0.12012736277054434
STAT,1880,20,30-34,1900,17.81102173149451
STAT,1896,15,40-44,1911,0.2294213550486315
STAT,1868,17,30-34,1885,1.4636631957710795
STAT,1948,22,na,1970,3961.355877484873
SIM,1876,17,30-34,1893,1
SIM,1893,26,20-24,1919,17
STAT,1848,36,15-19,1884,0.04212489318355889
SIM,1941,20,35-39,1961,13
STAT,1825,39,25-29,1864,3.403876754328162
SIM,1936,23,30-34,1959,31
STAT,1862,9,na,1871,2248.546085464449
STAT,1918,33,15-19,1951,0.12845412804288947
SIM,1947,24,45-49,1971,1
STAT,1854,35,30-34,1889,3.8965207834128477
SIM,1877,25,25-29,1902,44
STAT,1848,87,na,1935,126.92478272906786
STAT,1907,30,35-39,1937,8.132919910808106
SIM,1791,93,na,1884,6
SIM,1845,35,30-34,1880,3
STAT,1889,37,45-49,1926,2.324947737267553
SIM,1869,18,na,1887,2333
SIM,1828,79,na,1907,348
STAT,1839,51,40-44,1890,0.007053128858072327
STAT,1837,63,na,1900,1126.3558067899737
STAT,1891,43,35-39,1934,2.102101129845575
STAT,1924,30,35-39,1954,10.11835068069775
SIM,1821,37,40-44,1858,5
STAT,1858,27,15-19,1885,0.3444522871224631
STAT,1870,14,na,1884,2429.267294436859
SIM,1842,29,25-29,1871,40
SIM,1877,30,20-24,1907,1
SIM,1935,28,50-100,1963,1
STAT,1870,18,25-29,1888,5.264296057134994
STAT,1886,25,25-29,1911,42.50851821312256
STAT,1844,45,15-19,1889,2.852316883531906E-4
STAT,1840,51,35-39,1891,0.006024178809169054
STAT,1854,33,35-39,1887,7.390757225853004
STAT,1817,75,na,1892,456.5285610183272
STAT,1899,44,20-24,1943,0.014084671342995096
STAT,1821,40,15-19,1861,0.02447760854957059
STAT,1855,34,35-39,1889,7.152843433101688
STAT,1849,37,15-19,1886,0.0414173381768112
STAT,1837,35,30-34,1872,4.182204126392711
STAT,1913,38,15-19,1951,0.017810019822157443
STAT,1838,50,40-44,1888,0.00743061300808152
SIM,1773,88,na,1861,38
SIM,1897,42,40-44,1939,1
SIM,1861,34,30-34,1895,26
SIM,1846,84,na,1930,205
STAT,1809,45,20-24,1854,0.045423628402083784
STAT,1853,34,30-34,1887,13.059971108127092
STAT,1879,52,25-29,1931,0.0034788781848793305
SIM,1924,32,na,1956,4109
STAT,1870,38,25-29,1908,2.65196567033577
STAT,1877,51,50-100,1928,0.014876320354635928
SIM,1929,25,40-44,1954,5
STAT,1831,36,45-49,1867,1.5928177474973289
SIM,1842,70,na,1912,966
STAT,1851,21,50-100,1872,0.359693983980574
STAT,1880,28,40-44,1908,2.9671046913621115
SIM,1832,84,na,1916,186
STAT,1910,45,35-39,1955,0.11413987421452351
SIM,1827,34,25-29,1861,11
STAT,1881,21,30-34,1902,16.2964190060154
STAT,1786,86,na,1872,67.11195391265905
STAT,1839,46,45-49,1885,0.16239496034136824
STAT,1865,59,na,1924,1668.35675921538
STAT,1865,104,na,1969,0.5266267864144267
STAT,1889,42,40-44,1931,2.6200377718459182
SIM,1898,18,20-24,1916,16
SIM,1863,34,35-39,1897,10
STAT,1852,92,na,1944,31.644072906708452
STAT,1853,54,25-29,1907,0.0025545496595085694
SIM,1837,44,35-39,1881,1
STAT,1810,85,na,1895,124.14090735621625
STAT,1850,30,40-44,1880,3.5833251574159566
STAT,1868,46,15-19,1914,3.6181486098190157E-4
STAT,1832,29,15-19,1861,0.36393569690953326
STAT,1870,51,20-24,1921,6.863376907897695E-4
STAT,1822,41,20-24,1863,0.24603759584034152
SIM,1937,31,25-29,1968,13
STAT,1918,16,25-29,1934,8.96160480859715
STAT,1832,32,na,1864,1692.774650951438
SIM,1863,56,na,1919,1777
STAT,1859,27,30-34,1886,19.31295651664093
SIM,1872,40,40-44,1912,2
SIM,1830,58,na,1888,1273
STAT,1871,22,25-29,1893,53.61300273448391
STAT,1896,35,35-39,1931,8.914637164744756
STAT,1862,52,50-100,1914,0.012105577806992321
SIM,1822,33,40-44,1855,4
STAT,1850,69,na,1919,1033.1539443147565
STAT,1807,52,35-39,1859,0.030484165697298143
STAT,1895,39,40-44,1934,5.342270312114477
STAT,1816,46,20-24,1862,0.03210518704496694
STAT,1895,57,na,1952,2477.4726682571268
SIM,1890,20,35-39,1910,7
STAT,1820,44,20-24,1864,0.26956173946771556
SIM,1867,46,na,1913,1961
STAT,1834,26,15-19,1860,0.3709200559222615
STAT,1822,52,30-34,1874,0.00799113978133273
STAT,1872,46,35-39,1918,0.13312522010847125
SIM,1899,48,na,1947,2872
STAT,1887,14,na,1901,2719.5790037514516
SIM,1867,27,30-34,1894,27
STAT,1779,84,na,1863,101.21806026626983
STAT,1814,75,na,1889,429.75792042648897
STAT,1861,77,na,1938,678.0954639273843
STAT,1882,20,35-39,1902,5.396271727206612
SIM,1882,23,40-44,1905,2
SIM,1847,30,35-39,1877,13
STAT,1833,33,45-49,1866,1.3532608828066226
STAT,1864,40,40-44,1904,1.918250283965535
SIM,1872,37,40-44,1909,8
SIM,1811,87,na,1898,57
STAT,1832,47,50-100,1879,0.17605048100160703
STAT,1845,41,15-19,1886,0.010033301732465192
STAT,1867,53,45-49,1920,0.012665836157579607
STAT,1883,21,40-44,1904,1.9351548861192436
STAT,1911,46,40-44,1957,0.14132339357627668
SIM,1833,34,na,1867,1625
SIM,1897,8,na,1905,3333
STAT,1901,39,35-39,1940,1.9983235200939524
SIM,1836,23,na,1859,1751
STAT,1829,44,35-39,1873,1.477547914863847
STAT,1894,38,35-39,1932,8.552525504991333
STAT,1874,43,35-39,1917,1.7357677668048717
STAT,1849,72,na,1921,910.2830654215037
SIM,1825,90,na,1915,20
STAT,1848,41,50-100,1889,0.7699573285033959
STAT,1853,18,25-29,1871,5.025546343144432
SIM,1841,33,45-49,1874,1
STAT,1842,108,na,1950,0.0013043934291306323
STAT,1882,53,40-44,1935,0.009522159216946111
STAT,1855,51,25-29,1906,0.0025205864646622995
STAT,1839,30,35-39,1869,8.484037761067338
STAT,1871,30,30-34,1901,16.48322196986335
SIM,1852,44,30-34,1896,4
STAT,1871,38,40-44,1909,4.079386976549826
STAT,1936,13,na,1949,3577.4681328750385
SIM,1849,100,na,1949,1
STAT,1903,22,15-19,1925,4.43399734336309
STAT,1835,29,50-100,1864,0.5127359807270966
STAT,1844,33,20-24,1877,2.2457385581857863
STAT,1845,54,50-100,1899,0.010345554435277748
SIM,1911,22,15-19,1933,5
SIM,1969,2,na,1971,4466
STAT,1846,28,35-39,1874,8.171089855119211
STAT,1861,19,40-44,1880,0.16298031764169732
SIM,1854,28,35-39,1882,7
STAT,1933,20,35-39,1953,11.869486123264263
SIM,1808,59,na,1867,1033
SIM,1929,22,30-34,1951,39
STAT,1866,49,15-19,1915,3.411210921562401E-4
STAT,1881,24,40-44,1905,1.8888347589050616
SIM,1862,30,30-34,1892,21
SIM,1884,23,15-19,1907,3
SIM,1852,33,20-24,1885,2
STAT,1862,17,50-100,1879,0.04521590840464412
STAT,1878,85,na,1963,462.0414887070002
STAT,1875,30,45-49,1905,1.7060498616300148
STAT,1860,16,15-19,1876,5.286019055192732
STAT,1915,51,na,1966,3452.3221156188315
STAT,1895,20,20-24,1915,85.4621995617458
SIM,1939,30,45-49,1969,1
SIM,1882,43,35-39,1925,1
STAT,1881,52,35-39,1933,0.0078108975307519994
SIM,1906,35,na,1941,3361
STAT,1905,49,20-24,1954,0.009047796979971778
STAT,1824,40,40-44,1864,2.9938001677966253
STAT,1840,23,35-39,1863,5.130997494010805
SIM,1893,34,20-24,1927,3
SIM,1857,92,na,1949,25
SIM,1881,33,45-49,1914,1
STAT,1822,43,40-44,1865,3.302843728999853
STAT,1838,51,25-29,1889,0.002450993931683229
SIM,1896,25,35-39,1921,15
SIM,1830,43,40-44,1873,4
SIM,1927,25,30-34,1952,55
STAT,1900,21,na,1921,3108.9659208794055
STAT,1853,26,na,1879,1871.948549029058
SIM,1842,62,na,1904,1262
STAT,1938,28,45-49,1966,1.615927981496757
SIM,1829,34,35-39,1863,10
SIM,1814,42,45-49,1856,2
STAT,1862,41,20-24,1903,0.12855661739314556
STAT,1848,41,40-44,1889,1.639304579294546
STAT,1861,45,20-24,1906,0.009507571028701403
STAT,1872,18,35-39,1890,0.5189241219526388
STAT,1857,16,na,1873,2021.1946483276918
STAT,1847,40,35-39,1887,1.3745813627687595
SIM,1795,67,na,1862,707
STAT,1875,27,20-24,1902,11.385819539806501
SIM,1931,34,na,1965,4647
STAT,1858,57,na,1915,1490.4018641926618
STAT,1818,43,20-24,1861,0.3664419272643663
STAT,1821,88,na,1909,74.1329578311361
STAT,1855,17,45-49,1872,0.055026176968640934
STAT,1845,24,50-100,1869,0.3514876245287388
STAT,1883,37,20-24,1920,0.7137036327578421
STAT,1891,31,40-44,1922,5.091674884655989
STAT,1874,34,45-49,1908,1.669300013472307
STAT,1823,36,na,1859,1524.1058662605283
STAT,1882,48,50-100,1930,0.2229310364875702
STAT,1885,41,15-19,1926,0.013056337314841564
SIM,1881,31,25-29,1912,14
STAT,1828,48,40-44,1876,0.14230988869994193
STAT,1863,42,20-24,1905,0.13171813239239835
SIM,1818,44,30-34,1862,3
SIM,1811,79,na,1890,253
SIM,1926,16,25-29,1942,57
STAT,1836,50,30-34,1886,0.0039570457927659754
STAT,1886,42,15-19,1928,0.01376695419228672
SIM,1918,12,na,1930,4044
SIM,1855,40,35-39,1895,1
SIM,1841,22,40-44,1863,1
SIM,1883,27,20-24,1910,9
STAT,1864,39,50-100,1903,1.0261635484266571
STAT,1923,45,20-24,1968,0.012271455814027277
SIM,1891,21,40-44,1912,2
STAT,1942,4,na,1946,3955.63786937599
STAT,1877,35,30-34,1912,5.274294963382521
SIM,1881,18,na,1899,2102
SIM,1885,35,30-34,1920,5
STAT,1881,41,25-29,1922,0.5883900041787805
STAT,1919,25,30-34,1944,40.26629583111337
STAT,1863,53,30-34,1916,0.004863711537037669
STAT,1893,43,45-49,1936,0.12367200058990814
SIM,1868,38,35-39,1906,15
STAT,1818,54,30-34,1872,0.011719600123039351
STAT,1868,3,na,1871,2851.1204966124133
SIM,1824,30,40-44,1854,7
SIM,1831,36,40-44,1867,5
STAT,1771,96,na,1867,1.0292954576458773
STAT,1828,40,30-34,1868,1.0487583150584014
STAT,1861,85,na,1946,215.05206218988081
STAT,1906,37,50-100,1943,0.3645329471727447
STAT,1861,28,30-34,1889,19.75526549249797
STAT,1868,48,35-39,1916,0.12469011267889986
SIM,1827,62,na,1889,942
STAT,1826,52,45-49,1878,0.013094622579283772
STAT,1814,50,25-29,1864,0.009566670463143776
STAT,1885,34,20-24,1919,2.5222818456480725
STAT,1885,45,30-34,1930,0.09201445146757252
STAT,1873,33,45-49,1906,1.6651090826275818
STAT,1890,30,40-44,1920,5.049287960878801
SIM,1832,40,40-44,1872,7
SIM,1778,95,na,1873,2
SIM,1911,33,na,1944,3487
STAT,1827,28,25-29,1855,76.28236287968508
STAT,1895,31,30-34,1926,21.612297944619886
SIM,1812,72,na,1884,533
STAT,1836,54,na,1890,1322.3108735241492
STAT,1859,23,15-19,1882,2.5620415866012785
STAT,1859,44,20-24,1903,0.11811687153411109
SIM,1882,34,45-49,1916,2
STAT,1920,23,50-100,1943,0.6889500570983647
STAT,1787,71,na,1858,572.5701628868217
STAT,1883,56,na,1939,1888.430054799131
STAT,1828,48,35-39,1876,0.11637490925197128
STAT,1886,21,na,1907,2367.7390287249427
STAT,1832,40,na,1872,1586.0366065548094
STAT,1855,31,30-34,1886,12.722166387963314
SIM,1819,51,na,1870,1269
STAT,1853,37,35-39,1890,5.245333961380152
SIM,1906,23,45-49,1929,4
STAT,1825,48,15-19,1873,4.136854072459542E-4
SIM,1781,83,na,1864,98
STAT,1898,48,20-24,1946,0.00854761131038479
SIM,1835,28,25-29,1863,37
SIM,1842,26,20-24,1868,7
STAT,1824,33,50-100,1857,1.8547041830305617
SIM,1850,4,na,1854,2248
STAT,1886,28,35-39,1914,9.596928002337318
STAT,1900,27,25-29,1927,55.439799154715836
SIM,1852,69,na,1921,1094
SIM,1812,43,25-29,1855,1
STAT,1848,53,35-39,1901,0.006102586366603779
SIM,1907,20,na,1927,3332
SIM,1863,39,50-100,1902,4
STAT,1884,33,20-24,1917,2.5127639002933995
SIM,1892,33,20-24,1925,2
STAT,1764,113,na,1877,3.398811867696439E-4
STAT,1829,52,na,1881,1392.9580143894632
SIM,1938,15,35-39,1953,6
STAT,1819,37,35-39,1856,18.387955629316455
SIM,1827,28,50-100,1855,1
STAT,1881,24,35-39,1905,5.289476360630131
STAT,1855,4,na,1859,2245.2822171603616
SIM,1855,26,na,1881,2015
SIM,1863,105,na,1968,1
STAT,1813,54,25-29,1867,0.009823639564573113
SIM,1914,22,na,1936,3772
SIM,1953,15,30-34,1968,16
SIM,1897,34,40-44,1931,6
STAT,1844,16,30-34,1860,1.4307548905975178
STAT,1865,41,40-44,1906,1.9396159970062672
SIM,1867,23,15-19,1890,2
SIM,1861,37,35-39,1898,11
SIM,1877,44,35-39,1921,7
SIM,1863,31,30-34,1894,21
STAT,1812,53,25-29,1865,0.010925772428834872
STAT,1869,33,25-29,1902,9.326688836001269
STAT,1869,49,na,1918,2014.3815531975833
SIM,1788,73,na,1861,435
STAT,1891,46,45-49,1937,0.15610433819907957
SIM,1908,17,20-24,1925,20
SIM,1827,37,35-39,1864,8
STAT,1896,35,40-44,1931,5.5173593301342665
STAT,1797,108,na,1905,4.4599740870680533E-4
STAT,1861,25,20-24,1886,9.40447529757241
STAT,1900,38,35-39,1938,1.9908587351259213
STAT,1810,96,na,1906,3.8884406314989945
SIM,1872,0,na,1872,3344
STAT,1832,32,45-49,1864,1.3804028109288395
STAT,1935,17,50-100,1952,0.48382573603768175
SIM,1884,39,30-34,1923,10
STAT,1833,25,15-19,1858,0.3716849326456653
STAT,1820,44,15-19,1864,0.023440152524085153
STAT,1876,39,30-34,1915,5.14538696971564
STAT,1934,30,na,1964,4883.603094003769
STAT,1824,77,na,1901,456.34518784560765
STAT,1880,45,25-29,1925,0.057825109562251106
SIM,1770,91,na,1861,14
STAT,1874,95,na,1969,58.954638026130894
STAT,1837,54,40-44,1891,0.006463123905079122
STAT,1871,34,25-29,1905,9.510515627650575
STAT,1869,44,35-39,1913,1.633523546839672
STAT,1829,27,45-49,1856,1.59994490134019
STAT,1809,48,30-34,1857,0.3466885613116019
SIM,1837,44,40-44,1881,1
SIM,1840,32,45-49,1872,1
SIM,1845,67,na,1912,1165
SIM,1869,34,35-39,1903,13
STAT,1854,38,35-39,1892,5.0679077921598275
SIM,1873,41,40-44,1914,3
SIM,1837,27,45-49,1864,3
SIM,1872,81,na,1953,418
STAT,1844,40,15-19,1884,0.010186616202546576
STAT,1850,45,45-49,1895,0.16780093670475837
STAT,1904,11,na,1915,3504.0641039927573
SIM,1811,43,30-34,1854,3
SIM,1873,20,35-39,1893,6
SIM,1832,49,na,1881,1428
SIM,1877,33,25-29,1910,10
STAT,1832,29,45-49,1861,0.8906252556947388
STAT,1838,37,na,1875,1762.634423455321
STAT,1845,27,35-39,1872,8.27258384892769
STAT,1866,52,45-49,1918,0.012572863471361077
SIM,1840,29,45-49,1869,3
STAT,1831,45,35-39,1876,0.10561479673484603
STAT,1842,36,20-24,1878,0.650659014554097
SIM,1831,99,na,1930,1
STAT,1870,34,30-34,1904,16.023555757127166
STAT,1945,15,30-34,1960,12.585006163303108
STAT,1854,30,30-34,1884,13.145323819784972
SIM,1893,3,na,1896,3278
STAT,1827,47,35-39,1874,0.12265811061887504
STAT,1836,39,30-34,1875,4.046131733479595
SIM,1828,38,35-39,1866,10
STAT,1866,44,na,1910,1985.891897384612
SIM,1894,28,35-39,1922,15
STAT,1860,44,15-19,1904,0.010459514665893434
STAT,1874,26,15-19,1900,0.4395674286911119
SIM,1860,56,na,1916,1686
STAT,1864,37,40-44,1901,3.695972742828953
STAT,1849,29,na,1878,1821.915763130604
STAT,1919,41,na,1960,3807.603560493869
STAT,1889,45,45-49,1934,0.277984219798261
STAT,1910,42,30-34,1952,0.11410847327189493
SIM,1874,16,na,1890,2421
STAT,1854,38,40-44,1892,3.1365795179992357
SIM,1876,29,25-29,1905,42
STAT,1831,47,na,1878,1471.3107058256335
SIM,1833,30,50-100,1863,3
STAT,1811,70,na,1881,710.6485568474797
STAT,1892,39,15-19,1931,0.06576262693599524
STAT,1920,39,45-49,1959,0.7036569466879982
STAT,1854,50,25-29,1904,0.0025872359813231046
SIM,1838,89,na,1927,56
SIM,1884,18,na,1902,2470
STAT,1865,20,35-39,1885,5.143933376417602
SIM,1883,84,na,1967,547
SIM,1895,29,35-39,1924,10
STAT,1858,97,na,1955,3.9842139759600887
STAT,1835,38,30-34,1873,4.068591582139953
STAT,1840,23,40-44,1863,1.8322430716729432
SIM,1879,71,na,1950,1255
SIM,1892,69,na,1961,1884
STAT,1843,48,30-34,1891,0.06895937869379641
STAT,1880,23,35-39,1903,5.78253457117725
SIM,1822,33,35-39,1855,8
STAT,1895,39,35-39,1934,8.631738231798167
SIM,1834,75,na,1909,593
STAT,1852,25,25-29,1877,37.977540370955296
STAT,1768,113,na,1881,2.8431508247450286E-4
STAT,1888,44,45-49,1932,1.6477201874184508
SIM,1948,22,40-44,1970,4
STAT,1830,33,25-29,1863,8.431267511743451
STAT,1834,26,20-24,1860,9.59093279766108
STAT,1929,31,25-29,1960,11.097971923536909
STAT,1857,20,50-100,1877,0.35569621636395754
SIM,1843,38,30-34,1881,7
STAT,1887,29,35-39,1916,10.121200502023276
SIM,1860,25,25-29,1885,41
STAT,1826,29,50-100,1855,1.2055872800240741
STAT,1861,45,15-19,1906,3.1691875551751125E-4
STAT,1939,21,40-44,1960,3.1906969979563002
STAT,1858,43,20-24,1901,0.11692962799426264
STAT,1849,54,50-100,1903,0.010586567619684616
SIM,1947,21,40-44,1968,4
STAT,1875,27,15-19,1902,0.44033556584357625
SIM,1893,16,25-29,1909,11
STAT,1898,27,45-49,1925,1.4198855373076762
SIM,1963,5,na,1968,4682
STAT,1870,35,20-24,1905,0.7203279809048264
SIM,1895,24,35-39,1919,7
STAT,1759,100,na,1859,0.08597965243340167
STAT,1838,37,45-49,1875,1.6406083253104025
STAT,1872,69,na,1941,1391.5280220456134
STAT,1921,35,45-49,1956,0.72040222931324
STAT,1843,67,na,1910,1143.6639445265337
STAT,1885,17,30-34,1902,1.5001170235862267
SIM,1916,27,20-24,1943,18
STAT,1864,43,45-49,1907,1.2545012350925553
SIM,1828,33,35-39,1861,9
SIM,1854,44,35-39,1898,2
STAT,1849,53,20-24,1902,5.233455332504584E-4
STAT,1855,34,40-44,1889,3.0630642776973356
STAT,1890,35,40-44,1925,5.104152718918244
STAT,1894,72,na,1966,1825.4942241750568
STAT,1943,15,na,1958,3689.1058521931136
STAT,1855,46,35-39,1901,0.09943466521617723
STAT,1876,39,25-29,1915,2.779691795966957
STAT,1763,114,na,1877,1.0437780227037772E-4
SIM,1796,60,na,1856,909
STAT,1887,24,35-39,1911,6.126569403513073
SIM,1886,15,25-29,1901,4
STAT,1797,70,na,1867,663.9550399037819
STAT,1844,48,25-29,1892,0.03992765211447114
STAT,1835,54,30-34,1889,0.003637986229039841
SIM,1923,47,na,1970,3969
STAT,1906,45,20-24,1951,0.009404328816915981
STAT,1809,48,25-29,1857,0.20629401796577906
STAT,1939,21,35-39,1960,8.935200003629152
STAT,1893,35,15-19,1928,0.0679469869989467
STAT,1871,18,40-44,1889,0.171387505165324
SIM,1863,34,40-44,1897,3
SIM,1889,46,na,1935,2644
SIM,1857,36,na,1893,1907
STAT,1901,36,30-34,1937,1.5284039912025817
SIM,1854,25,30-34,1879,24
SIM,1792,70,na,1862,575
STAT,1824,85,na,1909,144.72589618610974
SIM,1824,44,50-100,1868,1
SIM,1843,22,20-24,1865,48
STAT,1846,25,30-34,1871,21.791034051978073
STAT,1908,27,20-24,1935,16.43612566496175
STAT,1927,28,50-100,1955,1.1392373947771612
STAT,1916,21,40-44,1937,3.338372128499465
STAT,1826,44,15-19,1870,0.013108303523820154
STAT,1816,49,25-29,1865,0.14689115267378305
STAT,1859,113,na,1972,1.2642873603679013E-4
SIM,1847,15,na,1862,2052
STAT,1846,44,35-39,1890,1.25952112597957
SIM,1868,35,30-34,1903,6
SIM,1889,28,20-24,1917,19
SIM,1838,54,na,1892,1337
SIM,1861,15,20-24,1876,16
SIM,1921,32,na,1953,3867
SIM,1894,17,na,1911,3222
STAT,1919,33,30-34,1952,15.990111512360857
STAT,1886,45,25-29,1931,0.05806512073042617
SIM,1880,31,30-34,1911,24
SIM,1812,42,35-39,1854,1
SIM,1843,19,20-24,1862,15
STAT,1840,50,50-100,1890,0.010668952393254902
STAT,1842,100,na,1942,0.7560107933932636
STAT,1872,31,30-34,1903,16.622999900916057
STAT,1837,50,25-29,1887,0.002334774968081992
STAT,1869,25,25-29,1894,38.944406888663295
STAT,1823,44,40-44,1867,2.7545861210886615
SIM,1831,44,40-44,1875,5
STAT,1926,46,na,1972,4293.4593844303745
SIM,1872,43,45-49,1915,1
SIM,1809,52,na,1861,1217
SIM,1938,15,40-44,1953,2
STAT,1853,15,20-24,1868,16.003696779017314
STAT,1885,16,25-29,1901,5.346506794237864
STAT,1835,22,20-24,1857,57.154370883119924
STAT,1862,24,30-34,1886,14.483591015385786
SIM,1868,87,na,1955,120
STAT,1932,35,20-24,1967,0.3351841108242865
STAT,1862,109,na,1971,0.009772055083216232
SIM,1884,23,20-24,1907,73
SIM,1927,28,35-39,1955,20
STAT,1816,100,na,1916,0.4947229744079497
STAT,1815,49,na,1864,1266.5128594902683
SIM,1946,22,30-34,1968,37
STAT,1883,43,50-100,1926,0.9710682354031703
STAT,1896,18,45-49,1914,0.08134357142366103
SIM,1817,39,40-44,1856,5
SIM,1865,26,45-49,1891,4
SIM,1879,25,35-39,1904,10
SIM,1943,1,na,1944,3985
STAT,1864,45,40-44,1909,0.1459870642513119
SIM,1924,21,40-44,1945,4
SIM,1908,17,15-19,1925,10
STAT,1836,109,na,1945,4.4927903585415224E-4
STAT,1835,38,25-29,1873,2.197974750699783
STAT,1815,49,50-100,1864,0.5782638582054638
STAT,1896,20,50-100,1916,0.5121772762592551
STAT,1829,44,40-44,1873,1.8353145220138394
STAT,1871,52,20-24,1923,6.874145233720196E-4
SIM,1917,27,na,1944,3656
STAT,1926,23,20-24,1949,127.23741945468029
SIM,1858,77,na,1935,668
STAT,1919,17,25-29,1936,45.24034879510101
SIM,1927,33,30-34,1960,20
SIM,1921,43,na,1964,3842
STAT,1904,6,na,1910,3539.2820451878993
STAT,1890,33,45-49,1923,2.005661977028572
STAT,1774,104,na,1878,0.030369291937866028
STAT,1914,10,na,1924,3870.3331274436855
SIM,1843,38,25-29,1881,2
SIM,1894,33,25-29,1927,18
STAT,1875,80,na,1955,600.37122052762
SIM,1852,16,30-34,1868,1
SIM,1856,51,na,1907,1719
STAT,1910,45,40-44,1955,0.13957676014616588
SIM,1900,41,na,1941,3026
STAT,1917,46,35-39,1963,0.12753083016727884
SIM,1820,38,30-34,1858,3
SIM,1894,27,50-100,1921,5
SIM,1794,82,na,1876,143
SIM,1947,21,35-39,1968,10
STAT,1869,48,50-100,1917,0.2217637493466292
STAT,1924,31,na,1955,4171.216612341473
STAT,1896,74,na,1970,1781.1261700138675
STAT,1835,43,20-24,1878,0.11721727589245678
STAT,1919,28,35-39,1947,15.27089232367807
STAT,1857,26,45-49,1883,0.857878533063861
STAT,1874,46,45-49,1920,0.22851239372745483
STAT,1920,22,15-19,1942,5.590881143006781
SIM,1883,76,na,1959,1036
STAT,1892,60,na,1952,2256.206497193974
SIM,1917,38,na,1955,3616
STAT,1883,16,15-19,1899,5.508100229617587
STAT,1838,80,na,1918,421.89771313203755
STAT,1874,40,30-34,1914,1.1212416432996704
SIM,1858,36,25-29,1894,1
STAT,1867,33,15-19,1900,0.12578262317208694
SIM,1879,39,na,1918,2282
SIM,1866,72,na,1938,1027
STAT,1874,23,40-44,1897,2.005766110677615
STAT,1901,28,50-100,1929,0.8428794836459248
SIM,1831,39,45-49,1870,3
SIM,1919,15,30-34,1934,4
SIM,1843,25,na,1868,1899
SIM,1850,89,na,1939,61
SIM,1853,28,40-44,1881,1
STAT,1811,59,na,1870,1052.421194944866
STAT,1938,34,50-100,1972,0.7842602484491963
SIM,1880,15,30-34,1895,4
STAT,1878,32,50-100,1910,0.9010840024301832
STAT,1841,101,na,1942,0.3904158559809181
STAT,1885,49,25-29,1934,0.05308002690536804
STAT,1910,26,50-100,1936,0.9108480377429388
STAT,1872,15,30-34,1887,1.5343028076597636
SIM,1946,19,na,1965,3831
STAT,1858,30,45-49,1888,1.3204089300501907
STAT,1938,22,30-34,1960,26.868889839009835
SIM,1832,60,na,1892,1183
SIM,1935,0,na,1935,5374
STAT,1870,54,25-29,1924,0.003188570266938356
STAT,1919,40,50-100,1959,0.12060344475542313
SIM,1882,40,30-34,1922,4
STAT,1825,30,na,1855,1664.5213445721622
SIM,1850,19,30-34,1869,1
STAT,1867,45,15-19,1912,3.583370967720871E-4
SIM,1927,17,25-29,1944,57
STAT,1813,53,40-44,1866,0.029789868405616298
STAT,1887,45,35-39,1932,0.14938410784420694
SIM,1868,84,na,1952,246
STAT,1845,28,40-44,1873,2.5498298307412988
STAT,1842,19,30-34,1861,1.4403888851625957
SIM,1893,54,na,1947,2593
STAT,1872,40,na,1912,2213.6361270001753
STAT,1876,54,na,1930,2042.142868347449
STAT,1897,13,na,1910,3257.724400181528
SIM,1887,38,45-49,1925,2
STAT,1825,62,na,1887,1068.5834323586248
STAT,1846,21,na,1867,1873.5419719866509
SIM,1923,20,40-44,1943,4
STAT,1886,25,30-34,1911,25.305184125542695
STAT,1867,2,na,1869,2984.23838141376
STAT,1847,37,40-44,1884,3.3418448006882633
STAT,1836,42,25-29,1878,0.48241000615455987
STAT,1899,44,15-19,1943,0.0012247540959756894
SIM,1844,34,30-34,1878,21
SIM,1933,32,50-100,1965,1
STAT,1882,53,35-39,1935,0.007786812461721623
SIM,1892,13,na,1905,3115
SIM,1863,21,na,1884,2105
SIM,1919,23,25-29,1942,82
STAT,1902,35,35-39,1937,2.0545499878196183
STAT,1909,43,15-19,1952,0.0013484465929265474
STAT,1931,17,50-100,1948,0.4632760871707889
SIM,1878,86,na,1964,409
SIM,1860,29,40-44,1889,2
STAT,1836,53,35-39,1889,0.005392875236881331
SIM,1827,34,30-34,1861,17
STAT,1836,34,30-34,1870,13.650052363458501
SIM,1866,30,45-49,1896,1
STAT,1878,51,25-29,1929,0.0035000682695519526
STAT,1831,30,30-34,1861,14.684515417714497
STAT,1910,28,na,1938,3404.365221179392
SIM,1953,18,35-39,1971,4
STAT,1845,44,25-29,1889,0.4489568663613415
SIM,1843,29,40-44,1872,3
SIM,1889,49,na,1938,2573
SIM,1826,104,na,1930,1
SIM,1925,45,50-100,1970,3
SIM,1848,27,20-24,1875,13
SIM,1907,16,15-19,1923,10
STAT,1894,16,20-24,1910,21.596983201277954
STAT,1926,43,15-19,1969,0.001785857556007597
STAT,1863,44,40-44,1907,1.8426170229994019
STAT,1846,32,na,1878,1805.7977833508799
STAT,1927,22,25-29,1949,107.52191681172536
STAT,1915,20,40-44,1935,3.169262121945393
STAT,1847,40,40-44,1887,1.707416126001941
SIM,1908,20,15-19,1928,4
STAT,1893,40,40-44,1933,2.7232218401618726
STAT,1879,38,45-49,1917,1.9586693006433498
SIM,1838,24,35-39,1862,7
SIM,1855,37,40-44,1892,5
STAT,1861,28,25-29,1889,33.18557410318436
SIM,1894,25,30-34,1919,45
STAT,1857,72,na,1929,940.5419608957584
STAT,1851,42,20-24,1893,0.11631682504175314
STAT,1852,34,15-19,1886,0.1097230085986672
SIM,1853,32,25-29,1885,10
STAT,1934,17,20-24,1951,173.23346387005225
SIM,1871,44,40-44,1915,4
STAT,1904,3,na,1907,3581.6667225224573
SIM,1942,17,20-24,1959,131
STAT,1851,39,20-24,1890,0.5595869062171193
STAT,1853,35,15-19,1888,0.04251855917428944
SIM,1958,12,na,1970,4845
SIM,1889,78,na,1967,1233
SIM,1835,25,20-24,1860,9
STAT,1835,19,20-24,1854,27.90482922100843
STAT,1769,112,na,1881,6.496134652727478E-4
STAT,1852,22,15-19,1874,2.9776133094154047
STAT,1877,36,15-19,1913,0.05531422543539019
STAT,1830,51,20-24,1881,4.852062457488719E-4
STAT,1888,25,35-39,1913,10.841357827064735
STAT,1904,41,50-100,1945,0.09984251448874704
SIM,1873,36,50-100,1909,1
STAT,1848,36,na,1884,1767.3592928575426
SIM,1828,35,30-34,1863,4
SIM,1858,33,20-24,1891,2
SIM,1895,26,30-34,1921,33
STAT,1823,39,15-19,1862,0.07951614386372143
SIM,1934,23,20-24,1957,140
SIM,1889,38,na,1927,2752
STAT,1826,39,40-44,1865,4.484368932738254
STAT,1862,41,15-19,1903,0.011178836898834792
SIM,1918,22,25-29,1940,100
SIM,1937,22,35-39,1959,12
STAT,1842,15,45-49,1857,0.06044384411199775
STAT,1945,23,30-34,1968,29.747958774437972
SIM,1853,24,30-34,1877,16
SIM,1855,40,40-44,1895,8
STAT,1879,19,na,1898,2480.4904335445267
SIM,1831,26,45-49,1857,1
SIM,1835,89,na,1924,60
STAT,1893,23,15-19,1916,3.94204436277811
STAT,1894,36,15-19,1930,0.0685686049288481
SIM,1939,30,na,1969,3572
STAT,1843,32,15-19,1875,0.12351415001051623
SIM,1925,17,na,1942,4102
SIM,1932,27,na,1959,4500
STAT,1887,26,30-34,1913,26.695889467365376
STAT,1935,33,15-19,1968,0.16783977878923456
STAT,1810,93,na,1903,13.234626847383181
SIM,1935,22,25-29,1957,115
SIM,1870,24,30-34,1894,17
STAT,1847,24,35-39,1871,5.18831898544233
STAT,1826,32,15-19,1858,0.18843768300100328
SIM,1856,44,45-49,1900,1
SIM,1907,21,40-44,1928,3
STAT,1786,110,na,1896,1.3598771589569083E-4
STAT,1797,100,na,1897,0.25849475110626585
SIM,1935,24,na,1959,4677
STAT,1836,35,15-19,1871,0.04443965034815587
STAT,1916,48,50-100,1964,0.21854107736110984
STAT,1929,22,35-39,1951,11.249314001940467
SIM,1931,10,na,1941,4902
STAT,1890,17,45-49,1907,0.07544925782184796
STAT,1926,35,na,1961,4351.638410766257
STAT,1899,31,45-49,1930,2.266801583837496
SIM,1908,33,20-24,1941,2
SIM,1893,43,na,1936,2868
STAT,1862,32,25-29,1894,8.253878066345457
SIM,1908,45,50-100,1953,1
STAT,1814,86,na,1900,91.54521500570098
STAT,1888,38,40-44,1926,4.8611063188298775
SIM,1855,24,35-39,1879,10
STAT,1845,24,30-34,1869,15.352977774342266
STAT,1852,29,40-44,1881,2.3777923468001703
STAT,1872,61,na,1933,1771.844557491196
STAT,1827,45,15-19,1872,3.5989976507696766E-4
STAT,1857,26,15-19,1883,0.3505544220737154
STAT,1861,33,20-24,1894,2.1115380420644834
STAT,1835,29,40-44,1864,2.401049976090341
SIM,1850,39,25-29,1889,2
SIM,1854,23,35-39,1877,10
STAT,1945,18,35-39,1963,4.3288614036731925
STAT,1920,36,40-44,1956,1.549869025513146
SIM,1899,34,20-24,1933,4
STAT,1842,39,25-29,1881,2.1437207933404854
STAT,1897,15,35-39,1912,0.6964684924418035
SIM,1908,20,45-49,1928,4
SIM,1876,26,20-24,1902,9
STAT,1900,35,30-34,1935,7.051225160171572
SIM,1921,35,na,1956,3873
SIM,1900,70,na,1970,2129
STAT,1797,81,na,1878,208.2617386477209
STAT,1801,57,na,1858,1067.0320771267004
STAT,1946,22,35-39,1968,9.898835712752062
SIM,1839,36,45-49,1875,6
STAT,1846,23,35-39,1869,5.040195654283844
STAT,1859,50,na,1909,1646.653849626252
STAT,1843,53,50-100,1896,0.01072101366283682
STAT,1793,96,na,1889,1.5961625977383656
SIM,1825,41,50-100,1866,1
STAT,1867,50,40-44,1917,0.00947222159576543
STAT,1841,52,35-39,1893,0.005858888991634258
STAT,1900,24,20-24,1924,89.75059895971216
SIM,1833,23,na,1856,1729
SIM,1910,35,35-39,1945,4
SIM,1861,39,30-34,1900,5
SIM,1846,44,na,1890,1598
SIM,1812,64,na,1876,838
SIM,1896,38,40-44,1934,7
SIM,1880,34,35-39,1914,6
STAT,1844,45,20-24,1889,0.008556958177581064
STAT,1838,53,45-49,1891,0.00973910683961391
STAT,1825,70,na,1895,793.2899113168633
STAT,1860,29,20-24,1889,8.97318555512689
SIM,1871,25,30-34,1896,34
SIM,1839,33,40-44,1872,8
STAT,1842,15,15-19,1857,5.491324348776661
STAT,1876,35,15-19,1911,0.055285149719203425
STAT,1904,35,45-49,1939,0.5884850054535606
SIM,1880,25,na,1905,2466
STAT,1888,41,40-44,1929,2.5215728063580296
STAT,1883,24,na,1907,2176.012689331334
STAT,1855,37,45-49,1892,1.4118606292021583
STAT,1921,48,20-24,1969,0.011737374829137415
SIM,1822,71,na,1893,713
SIM,1878,24,35-39,1902,8
STAT,1840,44,40-44,1884,1.5926809699539928
STAT,1854,18,40-44,1872,0.1566255262931774
SIM,1955,15,40-44,1970,1
STAT,1836,22,na,1858,1781.8955518386351
SIM,1843,25,25-29,1868,39
SIM,1826,29,35-39,1855,8
STAT,1870,15,20-24,1885,16.763987853438355
STAT,1884,50,40-44,1934,0.00996921115018694
STAT,1903,58,na,1961,2777.452958846483
SIM,1856,36,45-49,1892,2
STAT,1898,24,40-44,1922,2.6481485626390264
SIM,1900,49,50-100,1949,2
SIM,1913,30,25-29,1943,14
SIM,1833,39,25-29,1872,4
SIM,1845,99,na,1944,2
SIM,1854,41,30-34,1895,1
SIM,1813,43,35-39,1856,3
STAT,1917,43,50-100,1960,0.11563180555757546
STAT,1910,46,25-29,1956,0.046856622422372214
STAT,1931,24,40-44,1955,4.094019405509685
SIM,1844,74,na,1918,720
SIM,1881,23,25-29,1904,44
SIM,1836,24,25-29,1860,45
STAT,1832,26,40-44,1858,2.4934318413173058
STAT,1860,32,20-24,1892,2.0752994988929028
STAT,1863,25,30-34,1888,21.214944524792227
STAT,1932,38,25-29,1970,1.2485187430558295
STAT,1848,98,na,1946,2.340325519899831
SIM,1893,29,25-29,1922,61
STAT,1876,23,20-24,1899,66.99961118334797
SIM,1821,33,25-29,1854,18
STAT,1868,24,na,1892,2119.8652007229075
STAT,1891,40,30-34,1931,1.3578794181371083
STAT,1900,41,50-100,1941,0.09658275878838342
STAT,1854,54,40-44,1908,0.007372429882943675
STAT,1895,15,25-29,1910,7.0183993270124425
STAT,1853,39,30-34,1892,3.912676910917808
SIM,1879,40,50-100,1919,1
STAT,1833,29,30-34,1862,19.94600899935264
SIM,1938,31,40-44,1969,6
STAT,1848,36,45-49,1884,1.495433530172721
STAT,1863,40,25-29,1903,0.5386366682386261
SIM,1846,102,na,1948,1
STAT,1846,41,30-34,1887,0.8309911062029522
STAT,1910,48,45-49,1958,0.19097349461692403
STAT,1905,30,25-29,1935,14.095142128643513
SIM,1878,54,na,1932,2132
SIM,1829,29,na,1858,1641
STAT,1845,43,35-39,1888,1.2823341986547476
STAT,1861,44,30-34,1905,0.8897141021413926
SIM,1826,38,25-29,1864,1
SIM,1841,29,30-34,1870,27
STAT,1912,48,50-100,1960,0.20472858763746096
STAT,1874,28,na,1902,2296.152430992202
STAT,1859,28,na,1887,1817.1737612392235
STAT,1867,49,30-34,1916,0.08406892103517141
SIM,1854,95,na,1949,5
SIM,1840,22,25-29,1862,49
STAT,1845,32,25-29,1877,8.57830910258881
STAT,1898,27,15-19,1925,0.5802070278691386
STAT,1860,36,na,1896,1817.5302319992136
SIM,1906,23,50-100,1929,1
STAT,1928,15,30-34,1943,14.577678303263315
STAT,1943,23,20-24,1966,111.71896934186732
SIM,1840,26,40-44,1866,2
SIM,1853,43,35-39,1896,1
STAT,1828,28,40-44,1856,4.357336917054639
STAT,1876,26,25-29,1902,41.39626427666293
SIM,1874,17,20-24,1891,20
STAT,1814,54,40-44,1868,0.02624569997309023
STAT,1885,29,25-29,1914,39.52867164701331
SIM,1852,19,35-39,1871,2
SIM,1924,24,45-49,1948,1
STAT,1912,54,na,1966,3247.616912782013
STAT,1882,90,na,1972,248.9545564625777
STAT,1837,108,na,1945,0.0011562896391935694
SIM,1870,27,35-39,1897,9
STAT,1865,44,45-49,1909,1.2674408710502287
SIM,1879,22,30-34,1901,22
STAT,1862,27,35-39,1889,7.8041356118076095
STAT,1774,93,na,1867,6.111180183044219
STAT,1887,42,30-34,1929,1.2131250942559872
SIM,1873,44,45-49,1917,3
SIM,1792,78,na,1870,248
SIM,1910,40,na,1950,3267
SIM,1907,28,na,1935,3479
STAT,1896,47,35-39,1943,0.09813898813015723
STAT,1906,17,45-49,1923,0.08985822960059726
STAT,1832,22,25-29,1854,86.04956885524112
STAT,1791,102,na,1893,0.053812458083138365
STAT,1912,7,na,1919,3805.144594302249
STAT,1881,45,40-44,1926,0.1577158875350626
STAT,1895,19,40-44,1914,0.22427363303845807
STAT,1929,3,na,1932,4890.380096596568
SIM,1890,34,50-100,1924,1
SIM,1850,15,15-19,1865,4
SIM,1869,36,30-34,1905,9
STAT,1837,35,50-100,1872,0.9634291984922161
STAT,1861,21,na,1882,1919.8324270271548
SIM,1890,54,na,1944,2475
STAT,1906,48,25-29,1954,0.044133587863067564
STAT,1834,42,20-24,1876,0.11850965407693859
SIM,1825,82,na,1907,200
SIM,1936,15,30-34,1951,12
SIM,1894,68,na,1962,2153
STAT,1859,9,na,1868,2132.143071616444
STAT,1874,32,50-100,1906,0.8846639719428111
SIM,1859,62,na,1921,1539
STAT,1863,87,na,1950,146.30291595389204
STAT,1842,51,45-49,1893,0.010383919206386474
SIM,1948,17,15-19,1965,40
SIM,1846,34,40-44,1880,5
STAT,1917,17,20-24,1934,27.55999066229008
SIM,1925,17,20-24,1942,155
STAT,1916,24,45-49,1940,1.1068110055277367
STAT,1947,15,40-44,1962,1.4893350683290978
STAT,1896,42,na,1938,2892.0580604723978
SIM,1852,25,20-24,1877,9
STAT,1829,47,45-49,1876,0.19042722348272573
STAT,1838,88,na,1926,93.6307470465789
STAT,1834,39,20-24,1873,0.5813116053800338
STAT,1880,44,40-44,1924,2.2055978510818735
STAT,1844,25,20-24,1869,10.228096349145162
SIM,1830,27,35-39,1857,8
SIM,1944,20,na,1964,3672
STAT,1896,38,45-49,1934,2.476587256922404
STAT,1838,34,40-44,1872,3.59984088265508
STAT,1866,17,20-24,1883,15.849298229425836
STAT,1844,19,35-39,1863,0.48390267007671545
STAT,1893,31,na,1924,2871.959519029528
SIM,1856,43,na,1899,1830
SIM,1884,26,25-29,1910,49
SIM,1905,21,30-34,1926,30
STAT,1836,37,35-39,1873,5.4823308157628
SIM,1949,21,15-19,1970,4
STAT,1895,35,25-29,1930,3.5831834488856362
SIM,1891,16,15-19,1907,5
SIM,1866,10,na,1876,2411
STAT,1851,45,25-29,1896,0.04266013135817059
STAT,1893,39,30-34,1932,6.323823726833087
STAT,1942,23,50-100,1965,0.6514991863011534
SIM,1896,34,25-29,1930,20
STAT,1899,18,50-100,1917,0.06325937121578123
STAT,1931,20,25-29,1951,113.85315607432217
SIM,1876,28,na,1904,2365
SIM,1930,17,na,1947,4441
SIM,1879,6,na,1885,2669
STAT,1800,86,na,1886,73.25833570643188
STAT,1851,26,20-24,1877,10.145606265156017
SIM,1923,23,45-49,1946,2
STAT,1886,44,35-39,1930,1.7830202329416485
SIM,1832,43,45-49,1875,3
STAT,1915,23,45-49,1938,1.095254884777532
STAT,1819,42,25-29,1861,1.2606724587771707
STAT,1886,33,25-29,1919,10.180248049141484
SIM,1808,67,na,1875,763
STAT,1873,27,40-44,1900,2.8724711692276332
STAT,1888,34,25-29,1922,11.332984068111942
STAT,1830,54,25-29,1884,0.0021946052223396446
STAT,1819,53,35-39,1872,0.014413210341480296
STAT,1895,23,50-100,1918,0.5011705123856428
STAT,1821,44,30-34,1865,1.8066742857273754
STAT,1823,42,45-49,1865,1.9389828318900875
STAT,1823,39,45-49,1862,2.822822771459447
STAT,1885,46,20-24,1931,0.011326218944822214
SIM,1882,31,40-44,1913,4
SIM,1887,35,40-44,1922,9
STAT,1840,35,35-39,1875,5.948152904167863
SIM,1833,26,na,1859,1731
SIM,1939,32,40-44,1971,3
STAT,1879,15,40-44,1894,0.1814434616788597
STAT,1879,54,45-49,1933,0.01393595701365739
SIM,1881,27,40-44,1908,2
SIM,1949,18,15-19,1967,41
SIM,1836,28,40-44,1864,2
SIM,1836,74,na,1910,692
STAT,1873,30,40-44,1903,4.191940287424426
SIM,1815,40,40-44,1855,6
STAT,1948,1,na,1949,4439.821769240449
SIM,1866,21,na,1887,2123
STAT,1859,105,na,1964,0.11177697237991827
STAT,1862,62,na,1924,1472.8548988613895
STAT,1824,43,45-49,1867,1.8458113078631875
STAT,1879,35,40-44,1914,4.363537892858803
SIM,1858,21,na,1879,2011
SIM,1822,93,na,1915,12
STAT,1880,13,na,1893,2563.0311318423187
SIM,1843,33,na,1876,1812
STAT,1808,49,20-24,1857,0.04418874044543779
STAT,1905,34,40-44,1939,3.3703273096476924
STAT,1818,38,25-29,1856,8.810011469095404
STAT,1889,24,45-49,1913,0.8081754382686207
SIM,1777,78,na,1855,242
SIM,1913,34,40-44,1947,9
STAT,1842,48,15-19,1890,2.8126570967322215E-4
STAT,1793,99,na,1892,0.344469011613529
SIM,1886,39,35-39,1925,17
STAT,1809,53,20-24,1862,0.002507453020735707
STAT,1850,29,na,1879,1766.561046095689
SIM,1865,23,40-44,1888,1
STAT,1854,52,20-24,1906,5.285427263405759E-4
STAT,1878,39,35-39,1917,6.885874613243142
STAT,1882,79,na,1961,826.4856309459199
STAT,1873,65,na,1938,1620.519128264789
SIM,1865,36,na,1901,2020
STAT,1857,23,40-44,1880,1.7787367004241623
STAT,1938,23,na,1961,3412.7736678822785
STAT,1839,54,45-49,1893,0.009410376231442018
STAT,1852,95,na,1947,10.101582376811487
STAT,1891,34,45-49,1925,2.0216053734138986
STAT,1831,33,35-39,1864,8.20631949442944
STAT,1861,15,25-29,1876,5.170217628005443
SIM,1838,21,30-34,1859,20
STAT,1825,36,20-24,1861,1.0278838819341924
STAT,1876,44,20-24,1920,0.152792633317978
STAT,1882,39,na,1921,2143.935047474099
STAT,1815,101,na,1916,0.2442276117814214
STAT,1901,14,na,1915,3403.7630579318025
STAT,1905,28,na,1933,3246.5070652816685
STAT,1862,45,30-34,1907,0.07878277961787063
STAT,1883,52,45-49,1935,0.013365037126727873
STAT,1875,43,20-24,1918,0.15302065566569517
SIM,1876,5,na,1881,2725
SIM,1949,21,45-49,1970,1
STAT,1837,38,35-39,1875,5.380002460257673
STAT,1904,43,na,1947,3119.437135004434
STAT,1833,45,45-49,1878,0.17257893109845068
STAT,1892,27,20-24,1919,13.878386500304412
STAT,1873,23,50-100,1896,0.389825325045999
STAT,1918,17,50-100,1935,0.07728801503639018
SIM,1892,17,15-19,1909,4
SIM,1929,28,45-49,1957,1
STAT,1881,36,35-39,1917,6.482574252726517
SIM,1906,43,na,1949,3219
STAT,1780,78,na,1858,247.08803344880147
SIM,1834,96,na,1930,5
STAT,1873,54,na,1927,2007.9128047752663
STAT,1830,32,35-39,1862,8.472624510109224
SIM,1830,82,na,1912,276
STAT,1904,22,30-34,1926,24.132492860322667
STAT,1869,45,25-29,1914,0.05319667169830911
STAT,1847,62,na,1909,1344.8239203065848
STAT,1859,36,20-24,1895,0.5839590607096764
SIM,1880,87,na,1967,386
SIM,1912,22,30-34,1934,33
STAT,1871,33,35-39,1904,9.44441303581926
SIM,1864,30,50-100,1894,3
STAT,1835,25,25-29,1860,34.89759494024241
STAT,1808,52,20-24,1860,0.0026838720360732185
SIM,1868,76,na,1944,767
STAT,1849,21,na,1870,1876.763211864654
STAT,1921,32,50-100,1953,0.8692808212441091
SIM,1831,23,40-44,1854,2
SIM,1844,37,35-39,1881,15
STAT,1872,34,35-39,1906,9.520294504676151
SIM,1879,79,na,1958,785
STAT,1826,48,30-34,1874,0.0893028693263123
STAT,1880,24,25-29,1904,56.54583097687752
STAT,1827,49,30-34,1876,0.0825831145692526
STAT,1897,16,na,1913,3198.72647433469
STAT,1911,22,30-34,1933,25.74477974139011
SIM,1919,20,20-24,1939,109
SIM,1845,38,35-39,1883,15
SIM,1871,51,na,1922,2078
SIM,1867,39,25-29,1906,2
SIM,1891,28,na,1919,2922
STAT,1847,73,na,1920,873.934985263414
STAT,1856,30,50-100,1886,0.7006247775184232
STAT,1908,34,50-100,1942,0.7307831755312573
STAT,1813,102,na,1915,0.12399174447629013
STAT,1834,44,na,1878,1529.0970512650813
STAT,1850,33,45-49,1883,1.2709837291431627
STAT,1886,39,50-100,1925,1.2131061991091485
SIM,1848,101,na,1949,1
STAT,1820,43,30-34,1863,2.011341893973311
STAT,1875,19,50-100,1894,0.047293488323748197
STAT,1913,17,na,1930,3729.6670835722157
STAT,1814,45,35-39,1859,0.3923544693697289
SIM,1877,13,na,1890,2522
STAT,1832,45,15-19,1877,2.941778082658236E-4
SIM,1877,29,40-44,1906,4
STAT,1845,47,na,1892,1577.3577078130613
SIM,1808,56,na,1864,1095
STAT,1822,65,na,1887,882.7903913255371
STAT,1834,42,15-19,1876,0.010305187867630258
STAT,1873,57,na,1930,1927.0519001580037
STAT,1910,43,20-24,1953,0.01566815591559819
STAT,1865,20,40-44,1885,1.8368623841835212
SIM,1891,17,na,1908,3108
SIM,1887,16,30-34,1903,4
STAT,1826,55,na,1881,1216.089561259749
STAT,1845,25,15-19,1870,0.3946319722854162
STAT,1847,33,25-29,1880,8.757278159367658
STAT,1829,53,30-34,1882,0.004139580126621515
STAT,1875,58,na,1933,1919.3335489269598
SIM,1768,96,na,1864,1
STAT,1873,51,40-44,1924,0.010143351751955637
SIM,1866,42,45-49,1908,5
SIM,1802,73,na,1875,495
STAT,1830,60,na,1890,1139.2565916218837
STAT,1836,30,15-19,1866,0.11605634189791907
STAT,1766,104,na,1870,0.029869369883241736
STAT,1865,17,40-44,1882,0.1617981959356589
STAT,1858,42,45-49,1900,1.1085861454488157
SIM,1830,80,na,1910,385
SIM,1903,32,30-34,1935,15
SIM,1813,49,na,1862,1272
STAT,1860,92,na,1952,31.97674036721251
STAT,1856,54,45-49,1910,0.010442369684224996
STAT,1894,43,25-29,1937,0.053798498685213386
STAT,1861,47,35-39,1908,0.10931471467974911
SIM,1817,39,na,1856,1510
STAT,1864,82,na,1946,393.9405681581402
SIM,1910,35,40-44,1945,2
SIM,1858,23,na,1881,1965
STAT,1922,21,35-39,1943,10.232237431196626
SIM,1901,46,50-100,1947,1
SIM,1926,12,na,1938,4485
STAT,1934,19,na,1953,4677.919947479713
SIM,1926,10,na,1936,4497
SIM,1896,40,na,1936,2960
SIM,1914,33,45-49,1947,1
SIM,1900,28,35-39,1928,12
STAT,1833,42,40-44,1875,1.658587326363714
STAT,1827,74,na,1901,615.8764192086068
STAT,1896,28,na,1924,2969.1627614042764
SIM,1821,78,na,1899,409
STAT,1896,31,25-29,1927,12.840482174845315
STAT,1902,35,40-44,1937,1.2715818193199986
SIM,1822,85,na,1907,118
SIM,1855,33,25-29,1888,12
STAT,1813,50,30-34,1863,0.01788895842212611
SIM,1887,12,na,1899,2703
STAT,1880,21,20-24,1901,68.70571446993773
STAT,1911,8,na,1919,3757.2244284283142
SIM,1889,24,40-44,1913,2
STAT,1863,44,35-39,1907,1.483426904527521
STAT,1848,58,na,1906,1424.707765074386
STAT,1940,2,na,1942,3906.450724570445
STAT,1880,41,30-34,1921,1.1479391669851888
STAT,1918,4,na,1922,4150.08853069807
STAT,1856,42,35-39,1898,1.33816070605776
STAT,1866,103,na,1969,1.0572166602412514
STAT,1805,61,na,1866,954.1512103716622
STAT,1831,54,40-44,1885,0.006544641928474078
STAT,1829,40,25-29,1869,0.5571435537145718
STAT,1873,23,25-29,1896,54.72367341359437
SIM,1850,35,na,1885,1792
SIM,1910,22,20-24,1932,90
SIM,1892,32,45-49,1924,3
SIM,1905,24,35-39,1929,9
STAT,1865,48,50-100,1913,0.20818491380799053
STAT,1859,39,50-100,1898,0.9163093966700742
STAT,1886,27,50-100,1913,0.6384924228714173
STAT,1882,44,45-49,1926,1.3572160532752853
STAT,1805,93,na,1898,9.785493847784267
STAT,1839,30,40-44,1869,3.6331220219777465
STAT,1839,27,40-44,1866,2.5162231216336246
STAT,1871,15,15-19,1886,5.6603425188059955
STAT,1921,22,30-34,1943,30.670016068003147
SIM,1950,3,na,1953,4309
SIM,1871,44,35-39,1915,3
STAT,1836,26,50-100,1862,0.5264871300621301
STAT,1827,96,na,1923,4.765159794847292
STAT,1844,50,50-100,1894,0.010754627861335953
STAT,1930,40,25-29,1970,0.08901118062597976
STAT,1852,63,na,1915,1355.6650262016572
STAT,1827,52,25-29,1879,0.0029957666164282786
SIM,1928,17,40-44,1945,1
STAT,1879,36,50-100,1915,1.2181475189364255
SIM,1841,42,40-44,1883,5
SIM,1873,32,35-39,1905,12
STAT,1871,15,50-100,1886,0.046728189653845724
STAT,1917,49,45-49,1966,0.21319042620343928
SIM,1842,48,na,1890,1512
STAT,1944,22,25-29,1966,94.21408974759042
SIM,1869,72,na,1941,1088
SIM,1825,41,45-49,1866,2
STAT,1894,27,na,1921,2900.1513983269456
STAT,1877,16,20-24,1893,17.422264879961485
SIM,1825,68,na,1893,773
SIM,1909,17,30-34,1926,3
STAT,1815,53,45-49,1868,0.033084213751069125
STAT,1875,43,15-19,1918,0.013306144689606414
SIM,1873,20,40-44,1893,5
SIM,1935,27,25-29,1962,95
STAT,1938,5,na,1943,3746.45860095178
STAT,1809,110,na,1919,1.1608478841466986E-4
STAT,1869,20,na,1889,2184.904420557555
STAT,1896,44,30-34,1940,0.09833151737344452
STAT,1884,32,45-49,1916,1.6279272804703386
SIM,1872,40,35-39,1912,6
STAT,1913,25,na,1938,3549.3645895380755
SIM,1863,30,25-29,1893,9
STAT,1850,82,na,1932,328.47511215650087
STAT,1866,16,45-49,1882,0.058744290691331975
STAT,1922,34,40-44,1956,4.156923023547488
SIM,1870,32,25-29,1902,8
STAT,1811,104,na,1915,0.02889106589115894
SIM,1855,66,na,1921,1235
STAT,1850,29,30-34,1879,20.56393961381712
STAT,1946,12,na,1958,4116.011333102125
STAT,1955,3,na,1958,4932.886576275461
STAT,1817,49,40-44,1866,0.3711194999152929
STAT,1847,44,50-100,1891,0.7668329287195113
SIM,1827,49,na,1876,1321
STAT,1904,32,40-44,1936,3.373702963778452
STAT,1904,17,50-100,1921,0.06637532956265435
SIM,1880,79,na,1959,863
SIM,1890,44,45-49,1934,8
SIM,1923,48,50-100,1971,3
STAT,1885,68,na,1953,1438.3079886660835
STAT,1927,27,25-29,1954,75.60132678331702
STAT,1902,22,20-24,1924,91.87056389940207
STAT,1930,29,na,1959,4495.731627784176
SIM,1912,32,40-44,1944,4
STAT,1864,40,35-39,1904,1.5443166134544912
STAT,1845,41,20-24,1886,0.11538296369141557
STAT,1832,50,40-44,1882,0.006907448420432468
SIM,1940,23,45-49,1963,5
STAT,1877,31,15-19,1908,0.1401751734407308
STAT,1856,87,na,1943,130.35510292940694
STAT,1822,38,50-100,1860,2.112143853384096
STAT,1788,96,na,1884,1.5589632799063873
STAT,1928,22,40-44,1950,3.966284894190346
STAT,1908,27,15-19,1935,0.6356512739073376
STAT,1940,17,50-100,1957,0.35932752712222743
STAT,1850,21,35-39,1871,4.966526674974076
SIM,1880,33,na,1913,2435
STAT,1937,32,35-39,1969,8.539860706377434
STAT,1797,59,na,1856,983.2713367983001
STAT,1880,27,na,1907,2372.200336818335
SIM,1851,84,na,1935,191
STAT,1924,39,35-39,1963,2.6889164708616473
SIM,1886,32,50-100,1918,1
SIM,1928,5,na,1933,4778
STAT,1778,101,na,1879,0.11694768151953928
STAT,1853,42,25-29,1895,0.475642370458586
STAT,1881,20,25-29,1901,52.52779171364236
STAT,1932,23,45-49,1955,1.3903943452580798
STAT,1872,18,na,1890,2388.511217423908
STAT,1843,53,20-24,1896,5.23828049868557E-4
STAT,1881,40,35-39,1921,1.6683893643263559
STAT,1815,71,na,1886,643.7405714338859
STAT,1834,41,45-49,1875,1.1312251529414594
STAT,1917,33,20-24,1950,2.402638335205807
SIM,1815,91,na,1906,21
STAT,1920,19,na,1939,3880.476006160272
STAT,1855,15,30-34,1870,1.3585961207571398
STAT,1869,15,15-19,1884,5.567308662760367
SIM,1900,27,na,1927,3089
STAT,1922,28,20-24,1950,19.44575517492687
SIM,1932,39,35-39,1971,9
STAT,1889,21,40-44,1910,2.437625163265682
STAT,1897,43,35-39,1940,0.1577225738401554
STAT,1923,49,na,1972,4036.5637272994604
SIM,1930,28,20-24,1958,20
SIM,1881,34,50-100,1915,4
SIM,1897,21,40-44,1918,2
STAT,1814,42,30-34,1856,3.5807736347233
STAT,1895,32,20-24,1927,3.3323302440429114
SIM,1809,97,na,1906,3
STAT,1880,47,45-49,1927,0.23348998692563772
SIM,1870,55,na,1925,1913
SIM,1925,20,15-19,1945,4
STAT,1840,32,30-34,1872,14.809868527872142
STAT,1831,49,15-19,1880,2.866281107037629E-4
STAT,1814,78,na,1892,322.3747103437709
SIM,1863,15,30-34,1878,6
SIM,1919,22,40-44,1941,5
STAT,1926,41,50-100,1967,0.13703161675969466
STAT,1921,12,na,1933,4267.04152347377
SIM,1883,45,50-100,1928,3
SIM,1888,43,35-39,1931,2
STAT,1855,38,na,1893,1660.3135069047773
STAT,1927,43,30-34,1970,0.15124710185001
STAT,1907,39,35-39,1946,2.0968277849235926
SIM,1915,39,35-39,1954,6
STAT,1879,19,35-39,1898,0.5389073791444394
SIM,1847,27,40-44,1874,2
STAT,1767,114,na,1881,2.145103506323374E-4
SIM,1873,85,na,1958,303
STAT,1923,30,40-44,1953,4.2725703782383535
STAT,1908,30,15-19,1938,0.11548385766809305
SIM,1877,15,15-19,1892,6
STAT,1817,107,na,1924,0.0020913520115464126
SIM,1825,36,na,1861,1528
SIM,1842,22,35-39,1864,4
SIM,1804,66,na,1870,742
STAT,1934,33,20-24,1967,3.144076970767296
SIM,1851,31,45-49,1882,1
STAT,1871,50,50-100,1921,0.014347641860070095
STAT,1877,39,na,1916,2286.3592772525894
SIM,1847,30,40-44,1877,5
STAT,1953,17,25-29,1970,49.52372190533238
SIM,1832,39,30-34,1871,4
STAT,1860,32,15-19,1892,0.10933486920375052
STAT,1841,31,35-39,1872,8.49451557697637
STAT,1917,20,15-19,1937,5.3763154367919475
STAT,1833,44,50-100,1877,0.7592551674875863
STAT,1843,31,45-49,1874,1.5282525042107817
SIM,1829,40,na,1869,1515
STAT,1845,93,na,1938,20.585822160222467
STAT,1886,42,20-24,1928,0.15831996466029843
SIM,1920,47,na,1967,3770
STAT,1929,32,na,1961,4538.618705932554
STAT,1934,17,15-19,1951,57.98916806537682
STAT,1820,46,35-39,1866,0.2342527325089042
SIM,1848,26,45-49,1874,5
SIM,1888,31,40-44,1919,6
STAT,1889,18,40-44,1907,0.21275583196960549
SIM,1822,42,30-34,1864,3
STAT,1934,20,15-19,1954,6.78002961920072
SIM,1838,86,na,1924,139
SIM,1843,87,na,1930,99
SIM,1942,17,15-19,1959,40
STAT,1860,31,45-49,1891,1.344307689447042
STAT,1793,100,na,1893,0.1930989938401959
STAT,1771,106,na,1877,0.008755683050744261
SIM,1925,17,15-19,1942,41
SIM,1781,86,na,1867,59
STAT,1917,17,15-19,1934,9.225590106508516
STAT,1897,33,50-100,1930,1.1527136445291104
STAT,1933,29,35-39,1962,18.81393437216458
SIM,1941,29,35-39,1970,17
SIM,1876,20,na,1896,2384
SIM,1931,30,40-44,1961,9
STAT,1843,39,40-44,1882,3.286109772333658
SIM,1851,39,40-44,1890,6
STAT,1881,33,30-34,1914,15.858569300497885
SIM,1916,34,na,1950,3549
STAT,1915,23,50-100,1938,0.6404999570233211
STAT,1908,43,20-24,1951,0.015339378299847049
SIM,1815,39,30-34,1854,6
SIM,1818,80,na,1898,226
STAT,1819,51,20-24,1870,0.0012856797914096738
STAT,1890,30,35-39,1920,11.791057241528799
SIM,1832,95,na,1927,3
SIM,1846,15,30-34,1861,3
STAT,1856,53,na,1909,1567.5366499405015
STAT,1843,35,na,1878,1841.7583983799198
SIM,1925,33,20-24,1958,2
STAT,1860,108,na,1968,0.015862251406828343
STAT,1860,39,na,1899,1790.6192505540478
STAT,1824,39,30-34,1863,7.251457737709072
SIM,1883,23,35-39,1906,6
SIM,1810,60,na,1870,1009
SIM,1900,25,30-34,1925,40
SIM,1909,34,20-24,1943,2
STAT,1886,26,15-19,1912,0.45440552970416537
SIM,1951,19,na,1970,4066
STAT,1796,93,na,1889,7.605942593637567
STAT,1860,39,40-44,1899,3.327044467306654
SIM,1830,37,na,1867,1671
SIM,1783,95,na,1878,2
SIM,1889,60,na,1949,2185
STAT,1817,41,50-100,1858,2.7807038008376925
STAT,1879,48,na,1927,2193.650917759545
STAT,1839,107,na,1946,0.003144466415687231
STAT,1850,49,25-29,1899,0.03970386892398039
SIM,1888,28,40-44,1916,3
STAT,1814,49,15-19,1863,0.0010504393385353478
SIM,1855,58,na,1913,1527
SIM,1832,31,35-39,1863,10
SIM,1889,30,50-100,1919,1
STAT,1819,35,15-19,1854,0.17060484205508464
STAT,1896,16,30-34,1912,1.9948848070704293
STAT,1860,48,30-34,1908,0.07338531394682271
STAT,1891,22,35-39,1913,6.82346608919353
SIM,1936,22,40-44,1958,2
STAT,1899,43,45-49,1942,0.13357692197938975
STAT,1849,15,50-100,1864,0.04398397550229691
STAT,1885,50,20-24,1935,7.044949606608154E-4
SIM,1875,26,50-100,1901,1
SIM,1926,32,25-29,1958,17
STAT,1829,25,30-34,1854,72.25082131549429
STAT,1869,42,20-24,1911,0.1450456845241452
SIM,1942,20,15-19,1962,4
STAT,1824,31,35-39,1855,27.421075065749044
STAT,1856,85,na,1941,202.83041719992565
STAT,1860,100,na,1960,1.8032411726278164
STAT,1847,32,50-100,1879,0.7915534068882364
STAT,1918,32,25-29,1950,9.278155987819323
STAT,1914,40,40-44,1954,0.23573247165276395
STAT,1846,53,30-34,1899,0.0041295916993770955
SIM,1884,71,na,1955,1227
STAT,1858,19,20-24,1877,15.178223834411982
STAT,1882,36,15-19,1918,0.051868535148736766
STAT,1884,49,na,1933,2056.4627357844597
STAT,1871,84,na,1955,311.5535344841061
STAT,1942,30,na,1972,3810.0629455727485
STAT,1950,17,na,1967,4111.770700111954
STAT,1926,39,45-49,1965,0.7854866245860418
SIM,1837,25,30-34,1862,29
STAT,1857,47,50-100,1904,0.1820580508476467
STAT,1834,49,40-44,1883,0.10954213181657899
STAT,1882,46,50-100,1928,0.2264088137037455
SIM,1892,58,na,1950,2380
STAT,1921,32,40-44,1953,4.114425950192914
SIM,1900,59,na,1959,2571
SIM,1933,14,na,1947,5016
STAT,1815,45,15-19,1860,0.0010061251123775798
STAT,1831,29,50-100,1860,0.5369916298845201
STAT,1902,33,na,1935,3167.8810563538914
STAT,1868,56,na,1924,1839.7030388632895
STAT,1877,43,25-29,1920,0.6249699491235858
SIM,1858,17,15-19,1875,7
STAT,1936,33,30-34,1969,14.445284634740235
SIM,1935,24,20-24,1959,134
STAT,1768,102,na,1870,0.048570429981456956
SIM,1919,27,40-44,1946,4
STAT,1850,46,20-24,1896,0.008472013648207984
SIM,1889,27,45-49,1916,1
STAT,1927,24,20-24,1951,128.62502158930565
STAT,1850,15,na,1865,1998.191576433504
SIM,1890,46,50-100,1936,3
STAT,1889,26,na,1915,2792.8869168200536
STAT,1885,36,na,1921,2228.069536831205
STAT,1868,50,20-24,1918,6.751510942307863E-4
STAT,1922,19,50-100,1941,0.40744601975019074
STAT,1772,83,na,1855,106.01830000000001
SIM,1926,17,30-34,1943,20
SIM,1905,48,na,1953,3011
STAT,1895,16,15-19,1911,7.3340814311568385
SIM,1818,66,na,1884,745
STAT,1883,40,45-49,1923,1.399672030297229
STAT,1865,23,45-49,1888,0.6015384574384506
SIM,1910,25,50-100,1935,5
SIM,1830,69,na,1899,932
STAT,1875,46,25-29,1921,0.056061708585935247
SIM,1896,48,na,1944,2801
STAT,1933,24,15-19,1957,6.665947468276164
SIM,1868,34,50-100,1902,3
SIM,1909,32,25-29,1941,11
STAT,1884,33,15-19,1917,0.1323821995451956
STAT,1951,17,15-19,1968,51.05667680002072
SIM,1941,24,15-19,1965,4
STAT,1834,22,35-39,1856,4.830878538593589
STAT,1817,64,na,1881,875.458121456816
SIM,1860,67,na,1927,1296
STAT,1832,43,na,1875,1526.2363901663898
STAT,1911,32,15-19,1943,0.11818604434439085
SIM,1899,70,na,1969,2172
STAT,1918,17,30-34,1935,2.5144372670614197
STAT,1817,42,15-19,1859,0.034916373428181255
STAT,1852,43,20-24,1895,0.11979011643694883
STAT,1876,51,na,1927,2109.9355828684415
SIM,1891,40,45-49,1931,2
STAT,1849,83,na,1932,286.14458522168127
STAT,1954,15,45-49,1969,0.5836845360799785
SIM,1948,13,na,1961,4013
STAT,1840,39,15-19,1879,0.04530331195794621
SIM,1868,16,20-24,1884,20
STAT,1854,19,30-34,1873,1.3568403914158844
SIM,1922,1,na,1923,4461
STAT,1863,33,na,1896,1973.262653474685
STAT,1863,55,na,1918,1717.057431917068
SIM,1879,15,25-29,1894,8
SIM,1814,98,na,1912,1
STAT,1860,50,na,1910,1676.8712865707814
SIM,1834,39,40-44,1873,5
STAT,1921,1,na,1922,4497.299617793666
STAT,1856,23,25-29,1879,48.838965400700786
SIM,1937,23,50-100,1960,2
STAT,1850,37,na,1887,1684.8784499026576
STAT,1877,19,25-29,1896,5.52539876064282
STAT,1928,42,35-39,1970,0.24253207538468782
STAT,1886,83,na,1969,733.5756875627769
STAT,1915,46,30-34,1961,0.08506362204377564
SIM,1878,26,30-34,1904,34
STAT,1938,25,35-39,1963,14.061963158434262
STAT,1949,16,20-24,1965,149.01198333961733
STAT,1940,30,40-44,1970,3.8300758133580195
SIM,1864,23,25-29,1887,54
STAT,1837,54,35-39,1891,0.0052852648878372425
SIM,1866,19,20-24,1885,17
SIM,1828,30,30-34,1858,16
STAT,1839,33,45-49,1872,1.4160949343483673
STAT,1789,91,na,1880,16.63746084054595
STAT,1910,42,na,1952,3314.8592627513312
SIM,1928,32,35-39,1960,14
STAT,1826,53,20-24,1879,6.527463774744034E-4
SIM,1878,22,15-19,1900,3
STAT,1891,47,20-24,1938,0.007878136455724124
SIM,1936,25,50-100,1961,1
STAT,1887,21,30-34,1908,18.87543024338025
SIM,1814,44,na,1858,1340
STAT,1937,17,40-44,1954,1.2852849135085311
SIM,1908,47,na,1955,3051
SIM,1946,25,35-39,1971,19
STAT,1849,16,45-49,1865,0.05829987984878451
STAT,1909,12,na,1921,3657.7446598224196
SIM,1862,15,15-19,1877,8
STAT,1882,21,50-100,1903,0.37599310138314995
STAT,1865,14,na,1879,2299.6119104543895
STAT,1929,23,50-100,1952,0.7836865782154483
STAT,1856,46,15-19,1902,2.9679762454050423E-4
STAT,1917,43,30-34,1960,0.12583461220643416
STAT,1854,15,15-19,1869,5.172804897022395
STAT,1892,78,na,1970,1350.0552449089712
SIM,1898,34,35-39,1932,13
SIM,1862,19,30-34,1881,1
STAT,1844,52,25-29,1896,0.0024732885125249198
STAT,1862,25,15-19,1887,0.3722853082800358
SIM,1895,21,30-34,1916,23
STAT,1863,47,45-49,1910,0.1950639480347939
SIM,1863,43,30-34,1906,5
SIM,1945,17,40-44,1962,1
STAT,1893,44,20-24,1937,0.01304027265210015
SIM,1879,34,25-29,1913,9
SIM,1847,33,45-49,1880,2
STAT,1860,32,50-100,1892,0.7034563867030209
STAT,1874,43,40-44,1917,2.156058532662924
SIM,1915,36,30-34,1951,1
SIM,1835,60,na,1895,1198
SIM,1910,32,30-34,1942,16
STAT,1828,29,30-34,1857,31.819901054540367
STAT,1878,15,25-29,1893,5.59885117616803
SIM,1888,40,30-34,1928,1
SIM,1846,52,na,1898,1499
STAT,1817,41,45-49,1858,3.9393303958087245
STAT,1780,92,na,1872,9.233740099700324
STAT,1807,52,40-44,1859,0.037277779681014894
STAT,1834,45,25-29,1879,0.04262991864544216
STAT,1834,84,na,1918,205.90400678988922
SIM,1837,21,15-19,1858,2
STAT,1854,51,30-34,1905,0.00430690530202672
STAT,1818,60,na,1878,1068.5303312799563
STAT,1822,33,na,1855,1461.621288962131
SIM,1883,22,na,1905,2229
STAT,1819,45,na,1864,1381.1160451989479
STAT,1849,33,35-39,1882,7.612390787344798
STAT,1860,44,50-100,1904,0.8001528134708572
SIM,1839,50,na,1889,1519
SIM,1956,3,na,1959,4773
STAT,1902,32,30-34,1934,23.276389985032925
SIM,1909,37,25-29,1946,1
STAT,1855,30,25-29,1885,7.541258917126319
STAT,1846,20,30-34,1866,15.720952060843185
SIM,1930,34,40-44,1964,6
STAT,1893,23,na,1916,2826.02565029021
STAT,1858,43,15-19,1901,0.01016779428780291
SIM,1820,59,na,1879,1070
STAT,1901,39,40-44,1940,1.2367826883431887
STAT,1939,7,na,1946,3771.303024753399
STAT,1897,45,50-100,1942,0.17677711100396787
SIM,1872,39,50-100,1911,4
STAT,1869,21,50-100,1890,0.37402436737804173
SIM,1818,88,na,1906,51
STAT,1787,82,na,1869,159.79859013976494
STAT,1841,35,15-19,1876,0.04621678370719253
STAT,1881,20,na,1901,2170.1363134221765
SIM,1812,61,na,1873,946
SIM,1836,29,30-34,1865,22
SIM,1882,43,40-44,1925,5
STAT,1841,43,45-49,1884,1.0505069277676418
STAT,1852,48,40-44,1900,0.12843865365078794
STAT,1884,17,50-100,1901,0.04573586470978074
STAT,1838,18,35-39,1856,0.4914187594717543
STAT,1907,36,30-34,1943,1.60374430021772
STAT,1911,42,25-29,1953,0.06437220124824136
STAT,1869,101,na,1970,4.20476629184557
SIM,1854,20,30-34,1874,18
STAT,1862,20,15-19,1882,2.7609597325661617
STAT,1902,33,50-100,1935,1.21633637352001
STAT,1868,26,20-24,1894,10.617812554152604
SIM,1832,38,na,1870,1633
SIM,1892,40,50-100,1932,1
STAT,1928,25,45-49,1953,2.024527600662638
SIM,1849,94,na,1943,8
STAT,1913,29,50-100,1942,0.9300141830676937
STAT,1850,46,15-19,1896,2.824002065314224E-4
SIM,1857,33,35-39,1890,9
STAT,1890,80,na,1970,1139.004792580182
SIM,1898,21,na,1919,3026
STAT,1883,16,45-49,1899,0.06062849878944659
STAT,1819,54,25-29,1873,0.005812938846664974
SIM,1913,4,na,1917,3759
STAT,1951,13,na,1964,4418.453961967088
STAT,1788,98,na,1886,0.5842438640094969
STAT,1875,23,35-39,1898,5.646054900998843
STAT,1907,34,15-19,1941,0.11248251484875844
SIM,1920,16,25-29,1936,46
STAT,1842,23,50-100,1865,0.36364090278919803
SIM,1876,42,na,1918,2297
STAT,1906,33,45-49,1939,1.3715885177801614
SIM,1840,90,na,1930,35
STAT,1901,46,na,1947,2983.936188194686
SIM,1904,44,40-44,1948,3
STAT,1799,109,na,1908,2.3786250715718973E-4
STAT,1917,24,30-34,1941,28.675301939392785
STAT,1812,54,30-34,1866,0.0179972992082559
STAT,1935,20,50-100,1955,0.8470108301243802
STAT,1854,72,na,1926,909.4033299426179
STAT,1830,62,na,1892,1091.7978926990409
SIM,1901,16,15-19,1917,9
STAT,1909,34,na,1943,3379.425731648399
SIM,1870,20,15-19,1890,6
STAT,1798,74,na,1872,451.6324912684929
STAT,1879,16,30-34,1895,1.5777031958018766
STAT,1856,31,na,1887,1805.889073830783
STAT,1943,13,na,1956,3934.3001858256594
SIM,1821,46,na,1867,1385
SIM,1925,24,30-34,1949,38
STAT,1912,16,25-29,1928,8.29663125785921
SIM,1888,34,45-49,1922,1
STAT,1908,46,25-29,1954,0.04565041319952162
SIM,1807,96,na,1903,4
STAT,1913,31,35-39,1944,8.622287197074208
STAT,1857,50,45-49,1907,0.0109634490174861
STAT,1835,69,na,1904,915.6440094510301
STAT,1897,24,25-29,1921,71.87221841098074
STAT,1905,21,35-39,1926,7.990388318647819
STAT,1868,40,50-100,1908,0.96251039738237
SIM,1847,37,na,1884,1728
SIM,1912,29,50-100,1941,4
STAT,1822,43,35-39,1865,2.6590046590761225
SIM,1863,24,na,1887,2051
SIM,1899,37,na,1936,3065
SIM,1909,40,na,1949,3299
STAT,1853,41,50-100,1894,0.7870180242760747
STAT,1867,54,20-24,1921,6.365355741431595E-4
SIM,1830,43,35-39,1873,4
SIM,1941,26,30-34,1967,43
SIM,1859,70,na,1929,1162
SIM,1878,7,na,1885,2680
STAT,1763,106,na,1869,0.004388306078267084
STAT,1841,54,na,1895,1432.6677449337299
STAT,1860,35,25-29,1895,2.2315251704740526
STAT,1933,26,30-34,1959,49.17162537745163
STAT,1848,53,40-44,1901,0.007462591311094458
STAT,1889,72,na,1961,1652.5458367449044
SIM,1913,21,35-39,1934,10
STAT,1843,80,na,1923,446.28962616472825
STAT,1911,28,45-49,1939,1.5856554031480838
STAT,1783,75,na,1858,322.37801594012603
SIM,1848,23,40-44,1871,1
SIM,1921,31,35-39,1952,5
SIM,1838,33,25-29,1871,9
STAT,1904,29,50-100,1933,0.8604757796049718
STAT,1865,36,15-19,1901,0.04843760962771353
STAT,1904,48,20-24,1952,0.009055565728560299
STAT,1872,43,30-34,1915,1.082243299499713
STAT,1896,19,35-39,1915,0.6814070897073778
STAT,1877,52,20-24,1929,7.195439000782809E-4
STAT,1844,12,na,1856,2130.3086991786
STAT,1901,35,25-29,1936,0.8295385669066894
SIM,1853,46,na,1899,1818
SIM,1898,7,na,1905,3294
SIM,1900,23,15-19,1923,3
STAT,1891,47,15-19,1938,2.6260431752843225E-4
SIM,1895,63,na,1958,2308
STAT,1774,101,na,1875,0.12340079357112592
SIM,1837,28,35-39,1865,12
STAT,1892,42,45-49,1934,1.7683556692206575
SIM,1891,73,na,1964,1606
SIM,1834,64,na,1898,1067
SIM,1930,30,25-29,1960,12
SIM,1902,31,25-29,1933,19
STAT,1916,14,na,1930,3945.4075428894885
STAT,1914,43,45-49,1957,0.15551846071826048
STAT,1899,40,40-44,1939,0.2042516669976034
SIM,1887,69,na,1956,1472
SIM,1918,24,20-24,1942,114
STAT,1866,40,45-49,1906,1.316710546685797
STAT,1869,71,na,1940,1220.5907938145385
SIM,1885,56,na,1941,1945
SIM,1845,30,30-34,1875,19
STAT,1829,28,35-39,1857,11.816573129392035
STAT,1867,71,na,1938,1183.9687878077277
SIM,1934,36,40-44,1970,2
SIM,1902,50,na,1952,2909
STAT,1865,81,na,1946,464.2164960870946
SIM,1927,32,40-44,1959,5
SIM,1849,19,20-24,1868,16
STAT,1872,51,25-29,1923,0.0033746141466971013
STAT,1878,31,30-34,1909,17.240973921390893
STAT,1849,28,50-100,1877,0.54264791543899
SIM,1920,35,35-39,1955,6
STAT,1836,18,25-29,1854,9.293953511479737
STAT,1867,17,15-19,1884,5.38133549670847
SIM,1949,8,na,1957,4296
STAT,1805,52,30-34,1857,0.017365973635499292
SIM,1879,41,40-44,1920,3
SIM,1847,23,25-29,1870,54
STAT,1820,84,na,1904,177.22113325294043
STAT,1799,82,na,1881,171.97181165699618
STAT,1909,63,na,1972,2864.4097226460103
STAT,1921,47,45-49,1968,0.23147853988700037
STAT,1831,110,na,1941,1.6852894057385771E-4
STAT,1878,34,na,1912,2326.7310613643776
SIM,1887,36,50-100,1923,1
STAT,1853,46,40-44,1899,0.127323733119718
SIM,1819,40,30-34,1859,4
STAT,1846,24,na,1870,1833.4749411810262
STAT,1912,35,35-39,1947,2.2508282487197553
SIM,1875,17,15-19,1892,6
STAT,1915,49,35-39,1964,0.12200147860131219
STAT,1833,46,20-24,1879,0.008663460042447906
SIM,1879,38,40-44,1917,5
STAT,1852,41,na,1893,1763.9616149728893
SIM,1886,31,30-34,1917,21
SIM,1849,27,na,1876,1858
STAT,1808,50,na,1858,1264.195511301622
SIM,1843,18,15-19,1861,3
SIM,1830,38,50-100,1868,3
STAT,1926,43,na,1969,4318.950502590183
STAT,1831,50,25-29,1881,0.0023834928209151454
STAT,1873,30,35-39,1903,9.788985747109082
STAT,1884,49,30-34,1933,0.0884798583410137
STAT,1867,93,na,1960,48.19505708483177
STAT,1871,19,30-34,1890,1.4847227977195923
STAT,1879,81,na,1960,698.6548167602999
STAT,1837,30,30-34,1867,14.10910693973839
SIM,1887,34,na,1921,2470
STAT,1915,48,50-100,1963,0.21468883889432727
STAT,1916,36,na,1952,3657.02612093524
STAT,1831,52,50-100,1883,0.009768212774336343
STAT,1859,42,na,1901,1740.355082358507
STAT,1821,40,20-24,1861,0.2814924831164081
STAT,1851,46,50-100,1897,0.18061386106652122
STAT,1862,48,40-44,1910,0.13622597162119587
SIM,1883,44,na,1927,2152
STAT,1885,48,35-39,1933,0.13010947738534917
SIM,1874,19,na,1893,2394
SIM,1929,41,40-44,1970,1
STAT,1907,19,20-24,1926,24.465840330394975
STAT,1796,101,na,1897,0.1329395889114213
SIM,1929,25,35-39,1954,28
SIM,1829,75,na,1904,533
STAT,1806,51,35-39,1857,0.02480101397828623
SIM,1844,18,25-29,1862,6
SIM,1870,26,na,1896,2211
STAT,1918,48,na,1966,3682.9124509386756
STAT,1922,30,25-29,1952,9.945485467618614
SIM,1902,53,na,1955,2839
STAT,1825,51,45-49,1876,0.014962860182033008
SIM,1892,36,25-29,1928,3
STAT,1951,10,na,1961,4420.398654925308
STAT,1855,18,35-39,1873,0.45949749653883043
STAT,1837,51,30-34,1888,0.003846774950212252
STAT,1856,33,45-49,1889,1.2925490399646808
STAT,1908,0,na,1908,4113.898144119863
STAT,1862,106,na,1968,0.09516282525237942
STAT,1897,47,15-19,1944,2.837393499160362E-4
STAT,1920,21,25-29,1941,97.30746942924374
STAT,1932,20,40-44,1952,4.192666935205517
STAT,1871,28,50-100,1899,0.5969908869465091
STAT,1920,52,na,1972,3772.0838083142494
SIM,1920,42,40-44,1962,1
SIM,1779,90,na,1869,26
SIM,1862,93,na,1955,21
STAT,1859,1,na,1860,2778.1681479688896
STAT,1926,36,40-44,1962,1.7301064035975122
SIM,1880,30,25-29,1910,18
SIM,1890,20,40-44,1910,2
STAT,1949,19,25-29,1968,47.584793614516066
STAT,1827,42,na,1869,1487.745621904057
STAT,1860,52,45-49,1912,0.01108273143512006
STAT,1882,20,40-44,1902,1.9269706322366948
STAT,1892,36,50-100,1928,1.4594186371922966
STAT,1892,30,45-49,1922,2.0795358020310397
SIM,1915,26,na,1941,3570
STAT,1891,43,40-44,1934,2.611094159137837
SIM,1893,51,na,1944,2688
STAT,1884,36,25-29,1920,2.7007816699181015
STAT,1912,42,40-44,1954,0.22784227266768964
STAT,1872,30,25-29,1902,9.79012796517191
STAT,1830,94,na,1924,11.938713017068029
SIM,1803,81,na,1884,163
STAT,1945,22,40-44,1967,3.481278738743254
SIM,1873,31,na,1904,2282
SIM,1885,16,20-24,1901,23
SIM,1865,34,na,1899,2024
SIM,1836,20,na,1856,1784
STAT,1841,86,na,1927,151.80581635606694
STAT,1878,52,30-34,1930,0.00582288571603668
STAT,1831,79,na,1910,426.3598574673944
SIM,1849,49,na,1898,1644
STAT,1865,99,na,1964,5.894475957332449
STAT,1868,29,25-29,1897,37.88220981870097
SIM,1864,33,45-49,1897,2
SIM,1820,36,35-39,1856,9
SIM,1838,57,na,1895,1290
STAT,1838,50,35-39,1888,0.006076435885107659
SIM,1864,30,40-44,1894,4
STAT,1863,23,35-39,1886,4.906948032015541
STAT,1894,47,40-44,1941,0.11680799011155667
STAT,1874,47,20-24,1921,0.011532362523539792
SIM,1904,31,na,1935,3222
SIM,1880,37,45-49,1917,2
STAT,1898,54,na,1952,2677.881997485906
STAT,1815,49,30-34,1864,0.22791507173814637
STAT,1897,28,40-44,1925,3.7713195250950604
SIM,1841,21,na,1862,1914
SIM,1940,20,40-44,1960,3
STAT,1891,11,na,1902,3024.2514217426383
SIM,1886,19,na,1905,2469
STAT,1873,42,35-39,1915,1.734266614819006
SIM,1798,94,na,1892,4
STAT,1841,52,40-44,1893,0.0071645842361046826
STAT,1911,25,40-44,1936,4.322287979667274
STAT,1910,20,na,1930,3404.7204307205943
SIM,1940,25,na,1965,3448
STAT,1790,69,na,1859,642.3536120611295
SIM,1881,30,35-39,1911,8
STAT,1892,43,15-19,1935,0.01621910642318762
STAT,1836,51,20-24,1887,4.809233390511261E-4
STAT,1875,45,50-100,1920,0.24074052613253102
STAT,1888,41,35-39,1929,2.0300306010348192
STAT,1852,49,na,1901,1673.676531303477
STAT,1941,30,35-39,1971,9.073453118540812
STAT,1915,40,35-39,1955,0.1920318634891885
STAT,1945,25,na,1970,3885.959828821671
STAT,1868,41,15-19,1909,0.01251251026195143
SIM,1913,48,na,1961,3250
SIM,1938,19,15-19,1957,41
SIM,1859,29,25-29,1888,43
STAT,1858,15,50-100,1873,0.04294716649557485
STAT,1841,40,40-44,1881,1.6406517954881155
SIM,1784,72,na,1856,413
SIM,1903,42,40-44,1945,3
STAT,1872,37,45-49,1909,1.8902286905315944
STAT,1766,95,na,1861,2.2525516466290014
SIM,1865,5,na,1870,2464
STAT,1857,47,20-24,1904,0.008895344856146646
STAT,1851,41,45-49,1892,1.1024768191059011
SIM,1863,103,na,1966,1
SIM,1876,71,na,1947,1306
STAT,1935,18,na,1953,4740.832205563467
STAT,1930,40,na,1970,4629.382320850033
SIM,1819,65,na,1884,859
STAT,1845,61,na,1906,1316.2320405513735
SIM,1890,32,35-39,1922,11
STAT,1822,40,30-34,1862,1.8293868276981151
SIM,1869,31,30-34,1900,20
STAT,1822,46,45-49,1868,0.33396193944979574
SIM,1860,19,20-24,1879,15
SIM,1899,18,15-19,1917,7
STAT,1881,53,50-100,1934,0.013554695441946867
STAT,1870,37,35-39,1907,6.547187621569363
SIM,1859,17,30-34,1876,3
STAT,1852,19,20-24,1871,16.099685517972517
SIM,1838,40,40-44,1878,5
STAT,1894,70,na,1964,1932.145051731953
STAT,1847,104,na,1951,0.04907713650963283
STAT,1909,42,25-29,1951,0.06308124988261095
STAT,1858,46,25-29,1904,0.04283914940214021
STAT,1850,42,40-44,1892,1.5815458612602271
STAT,1830,103,na,1933,0.08572890933502589
SIM,1840,41,35-39,1881,4
STAT,1930,38,20-24,1968,0.32451565001348703
SIM,1871,23,35-39,1894,6
STAT,1897,31,40-44,1928,5.501465228574088
STAT,1852,22,20-24,1874,62.19862518626512
STAT,1853,17,50-100,1870,0.043705946719381036
STAT,1917,19,50-100,1936,0.3775730366263264
STAT,1919,32,40-44,1951,3.9885212980036644
STAT,1925,38,50-100,1963,0.47562682674139223
STAT,1841,16,40-44,1857,0.16235495114873313
SIM,1798,72,na,1870,535
SIM,1847,45,50-100,1892,1
SIM,1841,44,50-100,1885,3
STAT,1867,4,na,1871,2655.9827833468844
STAT,1906,23,na,1929,3243.3293380679015
STAT,1887,41,25-29,1928,0.6815064386647918
SIM,1904,63,na,1967,2627
STAT,1831,42,30-34,1873,0.8756393598990689
STAT,1902,47,35-39,1949,0.1047900964621343
SIM,1874,93,na,1967,78
STAT,1821,47,40-44,1868,0.2614242751954325
STAT,1925,43,20-24,1968,0.020169329398923536
STAT,1899,29,50-100,1928,0.8222354092558405
STAT,1921,48,15-19,1969,3.912454834850558E-4
STAT,1899,17,na,1916,3269.6837189490707
SIM,1838,37,40-44,1875,4
STAT,1906,30,40-44,1936,3.452997299359137
STAT,1877,40,20-24,1917,0.15725805061200526
STAT,1832,41,35-39,1873,1.360862974355527
STAT,1934,33,na,1967,4875.061766945102
STAT,1852,46,50-100,1898,0.18712988048706106
STAT,1932,40,35-39,1972,0.25854394491171084
STAT,1843,44,15-19,1887,0.009998704205367501
SIM,1914,30,40-44,1944,10
SIM,1927,26,na,1953,4208
SIM,1952,18,na,1970,4141
SIM,1775,98,na,1873,1
STAT,1912,32,30-34,1944,14.642137590061905
STAT,1830,30,20-24,1860,2.335732426156648
STAT,1839,46,15-19,1885,2.7524546382420823E-4
STAT,1880,59,na,1939,1931.800299157538
STAT,1931,0,na,1931,5570.776565805763
SIM,1810,51,na,1861,1238
STAT,1873,54,45-49,1927,0.013533391797388347
STAT,1851,42,15-19,1893,0.010114507071663123
STAT,1815,41,35-39,1856,5.358448616963558
STAT,1826,29,20-24,1855,22.109514990127515
STAT,1921,15,na,1936,3982.291598564131
STAT,1812,45,40-44,1857,0.5819955556450455
STAT,1935,32,25-29,1967,12.07928555624583
STAT,1802,53,25-29,1855,0.00989523926037274
STAT,1901,32,20-24,1933,3.574219312536298
STAT,1868,53,50-100,1921,0.013403612022063615
STAT,1879,51,35-39,1930,0.008541534622992583
STAT,1870,60,na,1930,1765.4180386872692
SIM,1896,47,50-100,1943,1
SIM,1861,12,na,1873,2367
SIM,1816,54,na,1870,1127
STAT,1899,47,25-29,1946,0.041867438423269975
SIM,1860,22,20-24,1882,62
STAT,1882,17,40-44,1899,0.16813364923721522
SIM,1827,91,na,1918,19
STAT,1813,53,35-39,1866,0.02436087375236054
STAT,1865,67,na,1932,1360.8220591785407
STAT,1833,57,na,1890,1220.0269681201798
SIM,1869,15,na,1884,2355
SIM,1799,57,na,1856,1017
STAT,1917,5,na,1922,4073.928708505292
SIM,1848,64,na,1912,1253
SIM,1830,40,30-34,1870,4
STAT,1833,49,25-29,1882,0.036414756523561555
STAT,1914,46,15-19,1960,3.4592642741927617E-4
STAT,1882,32,35-39,1914,9.309306143369318
STAT,1878,88,na,1966,315.46355188850754
STAT,1894,40,20-24,1934,0.19494018147086656
STAT,1933,25,50-100,1958,1.2496249823680254
STAT,1837,33,35-39,1870,7.9326295414843635
SIM,1944,17,25-29,1961,62
STAT,1890,4,na,1894,3038.5154094270306
SIM,1896,22,50-100,1918,1
STAT,1913,40,25-29,1953,0.06651635737375527
SIM,1948,10,na,1958,4015
STAT,1838,34,na,1872,1798.9634434018783
STAT,1822,41,50-100,1863,1.6366848454774876
STAT,1925,46,25-29,1971,0.06088178377583726
SIM,1810,101,na,1911,1
SIM,1918,27,25-29,1945,76
STAT,1932,8,na,1940,4989.270800282223
STAT,1875,42,45-49,1917,1.4507578767530762
SIM,1845,33,35-39,1878,10
STAT,1888,22,50-100,1910,0.4550982376047202
STAT,1882,37,na,1919,2165.732178533365
STAT,1902,38,45-49,1940,0.570777276125947
SIM,1883,42,45-49,1925,2
STAT,1834,48,50-100,1882,0.1591731643027411
SIM,1842,48,50-100,1890,3
STAT,1791,87,na,1878,54.308091501662865
STAT,1868,6,na,1874,2517.53720879918
STAT,1908,34,30-34,1942,13.925598528040412
STAT,1808,51,45-49,1859,0.05385166041642548
SIM,1823,41,35-39,1864,3
SIM,1878,52,na,1930,2188
STAT,1841,39,30-34,1880,4.2079357895936855
STAT,1828,27,na,1855,1589.5275328353116
STAT,1922,40,35-39,1962,0.2189671162113292
SIM,1885,85,na,1970,502
STAT,1883,9,na,1892,2402.285449016016
SIM,1774,84,na,1858,76
STAT,1917,46,40-44,1963,0.15595198624491496
STAT,1897,34,45-49,1931,2.1843090770094453
SIM,1827,94,na,1921,5
STAT,1884,45,15-19,1929,3.771383665963775E-4
STAT,1923,33,45-49,1956,1.7032722931377615
STAT,1836,54,25-29,1890,0.002175272598912104
SIM,1949,18,20-24,1967,136
SIM,1871,41,30-34,1912,1
STAT,1915,24,20-24,1939,107.89387918335983
STAT,1856,27,40-44,1883,2.29669756660167
STAT,1936,17,25-29,1953,39.18734704793212
SIM,1913,45,na,1958,3286
SIM,1904,34,na,1938,3162
STAT,1846,40,25-29,1886,0.47014210535598133
STAT,1878,34,35-39,1912,9.874219470460154
SIM,1890,41,40-44,1931,8
STAT,1846,44,40-44,1890,1.5644957365098633
STAT,1913,38,20-24,1951,0.2444829686170745
STAT,1876,19,15-19,1895,5.75666441603815
SIM,1916,34,30-34,1950,17
SIM,1797,79,na,1876,292
SIM,1911,21,25-29,1932,84
SIM,1862,90,na,1952,61
SIM,1912,5,na,1917,3673
STAT,1832,72,na,1904,763.6201678694911
STAT,1912,45,45-49,1957,0.1982030770798194
SIM,1956,0,na,1956,4778
STAT,1864,23,50-100,1887,0.3473266496404933
STAT,1858,50,50-100,1908,0.011361604293800703
STAT,1894,31,15-19,1925,0.17376390996773666
SIM,1850,57,na,1907,1477
SIM,1886,34,35-39,1920,10
STAT,1857,19,na,1876,1985.6900843485416
STAT,1802,52,20-24,1854,0.0021032960891435807
STAT,1882,41,40-44,1923,2.0770025872253317
STAT,1820,39,na,1859,1472.1776607901386
STAT,1915,35,50-100,1950,0.4044488269997912
SIM,1903,38,na,1941,3179
SIM,1819,43,35-39,1862,4
STAT,1827,40,15-19,1867,0.013159249281413
STAT,1917,2,na,1919,4143.917019613429
STAT,1921,44,40-44,1965,0.2652769953781539
SIM,1941,25,50-100,1966,5
SIM,1852,83,na,1935,272
SIM,1844,15,20-24,1859,13
STAT,1863,41,30-34,1904,0.959019909008854
STAT,1893,23,20-24,1916,82.34438602647268
SIM,1864,27,40-44,1891,2
STAT,1842,35,50-100,1877,1.0471313898412375
SIM,1887,37,na,1924,2451
SIM,1814,76,na,1890,370
STAT,1850,25,15-19,1875,0.38133526589494865
STAT,1871,31,20-24,1902,2.5418774084728
STAT,1847,52,35-39,1899,0.006300726954544702
STAT,1826,32,20-24,1858,3.5767603871712246
STAT,1903,21,25-29,1924,77.17228284817583
SIM,1854,44,40-44,1898,8
STAT,1873,34,50-100,1907,0.8710733067897894
STAT,1890,66,na,1956,1918.1445422423599
SIM,1834,32,20-24,1866,2
SIM,1852,16,na,1868,2191
STAT,1856,30,40-44,1886,3.3161536473843762
STAT,1888,47,50-100,1935,0.2728142622730704
STAT,1817,45,25-29,1862,0.13301813197821635
SIM,1825,50,na,1875,1271
STAT,1824,52,40-44,1876,0.011911850308403969
SIM,1842,41,45-49,1883,1
STAT,1819,108,na,1927,9.147389345901204E-4
SIM,1834,29,20-24,1863,11
SIM,1850,35,50-100,1885,1
SIM,1897,44,na,1941,2925
SIM,1915,6,na,1921,3889
STAT,1766,98,na,1864,0.5167876998576777
STAT,1878,19,40-44,1897,0.17891183382626902
STAT,1893,77,na,1970,1457.4203911630905
STAT,1791,65,na,1856,742.5116479999999
STAT,1863,20,30-34,1883,15.3053373455452
SIM,1932,34,50-100,1966,1
SIM,1864,42,35-39,1906,2
SIM,1904,31,35-39,1935,5
SIM,1859,26,20-24,1885,11
STAT,1818,68,na,1886,792.9393863629134
SIM,1932,36,30-34,1968,2
STAT,1874,41,na,1915,2241.672213582639
STAT,1854,54,35-39,1908,0.006028856226590819
STAT,1833,101,na,1934,0.3464199004995886
STAT,1867,33,20-24,1900,2.387496475182251
SIM,1875,33,20-24,1908,2
SIM,1915,19,20-24,1934,23
STAT,1947,15,35-39,1962,4.468004946295123
SIM,1885,19,25-29,1904,8
STAT,1902,42,15-19,1944,0.0012768922781409688
SIM,1829,72,na,1901,659
STAT,1815,50,40-44,1865,0.025487120717581642
STAT,1945,25,45-49,1970,1.7920875397146272
STAT,1832,94,na,1926,12.084752235350816
STAT,1835,83,na,1918,247.69200511576634
SIM,1823,32,45-49,1855,1
SIM,1903,16,na,1919,3382
STAT,1838,21,50-100,1859,0.3634533307276904
SIM,1861,75,na,1936,801
STAT,1845,29,30-34,1874,21.280979687817386
STAT,1851,46,30-34,1897,0.07118657083226104
STAT,1885,33,na,1918,2236.4688127326576
STAT,1793,103,na,1896,0.026103457439689982
STAT,1910,35,25-29,1945,0.897777478773713
SIM,1869,15,25-29,1884,9
SIM,1863,6,na,1869,2420
SIM,1872,38,na,1910,2197
SIM,1878,29,35-39,1907,13
SIM,1898,29,na,1927,2990
SIM,1923,24,20-24,1947,101
SIM,1852,61,na,1913,1413
STAT,1821,43,25-29,1864,1.039838927647127
STAT,1899,24,35-39,1923,7.507397428301052
STAT,1832,53,45-49,1885,0.008972662875848506
STAT,1895,39,50-100,1934,1.4983276991490768
STAT,1924,36,30-34,1960,2.032320554934933
STAT,1902,44,30-34,1946,0.10499567386170056
SIM,1853,29,30-34,1882,34
SIM,1863,53,na,1916,1831
STAT,1882,23,45-49,1905,0.6390321749726482
STAT,1842,31,na,1873,1883.8383103579388
SIM,1955,15,35-39,1970,4
SIM,1901,32,20-24,1933,3
STAT,1916,43,20-24,1959,0.01706941731104648
STAT,1889,58,na,1947,2306.416579492878
STAT,1897,40,30-34,1937,0.10188293691126582
SIM,1903,16,25-29,1919,10
STAT,1839,23,25-29,1862,48.691503219734265
STAT,1935,36,40-44,1971,1.9791939188719514
SIM,1928,22,na,1950,4328
SIM,1927,29,na,1956,4181
STAT,1807,76,na,1883,392.51157274840256
SIM,1783,98,na,1881,1
SIM,1947,9,na,1956,4004
STAT,1816,87,na,1903,82.09964551616451
STAT,1913,44,40-44,1957,0.22960813958546622
SIM,1800,92,na,1892,4
SIM,1918,29,40-44,1947,6
STAT,1849,52,45-49,1901,0.010404728786934879
SIM,1877,59,na,1936,1889
SIM,1918,15,na,1933,3978
STAT,1803,69,na,1872,685.5422894640271
STAT,1858,23,35-39,1881,4.4861612144617835
STAT,1924,34,15-19,1958,0.14146249520614246
STAT,1889,40,na,1929,2722.73314355174
SIM,1930,21,35-39,1951,18
STAT,1880,26,50-100,1906,0.6380353062770633
STAT,1912,33,35-39,1945,8.456960725206626
SIM,1851,35,25-29,1886,1
SIM,1887,66,na,1953,1631
STAT,1891,26,15-19,1917,0.5323380271058892
SIM,1920,33,35-39,1953,15
STAT,1771,103,na,1874,0.0355773272201953
SIM,1930,15,na,1945,4473
SIM,1874,40,45-49,1914,1
SIM,1838,43,45-49,1881,2
SIM,1861,97,na,1958,5
STAT,1880,44,35-39,1924,1.775650149772875
STAT,1865,53,40-44,1918,0.008892301076958467
STAT,1857,30,na,1887,1825.7032955551667
STAT,1876,22,na,1898,2306.526420192129
SIM,1879,44,45-49,1923,3
STAT,1887,45,40-44,1932,0.18267542288535973
STAT,1934,24,30-34,1958,36.463020373100136
STAT,1890,37,na,1927,2721.2172742730427
STAT,1844,97,na,1941,3.7713634028571374
STAT,1843,35,25-29,1878,2.475848259802294
STAT,1909,46,40-44,1955,0.13716705115970865
SIM,1888,24,25-29,1912,67
STAT,1861,23,na,1884,1892.3626053442563
SIM,1871,20,30-34,1891,26
SIM,1900,21,15-19,1921,3
STAT,1863,89,na,1952,87.23787149611668
SIM,1929,19,15-19,1948,45
STAT,1804,51,50-100,1855,0.04582132156544572
STAT,1805,95,na,1900,4.451724760003383
STAT,1939,10,na,1949,3749.5465544912777
SIM,1827,39,30-34,1866,7
SIM,1886,81,na,1967,798
STAT,1824,35,15-19,1859,0.09261670120229677
SIM,1942,24,30-34,1966,30
SIM,1920,32,30-34,1952,21
SIM,1785,76,na,1861,285
SIM,1910,46,50-100,1956,2
SIM,1838,34,50-100,1872,5
STAT,1856,51,40-44,1907,0.007826613639567609
SIM,1801,77,na,1878,332
STAT,1841,19,45-49,1860,0.05696534446512809
STAT,1844,47,35-39,1891,0.0978230930048741
SIM,1805,62,na,1867,912
STAT,1853,30,15-19,1883,0.11103931558235529
SIM,1876,74,na,1950,1053
STAT,1868,53,25-29,1921,0.0031435181067767494
SIM,1866,23,35-39,1889,6
STAT,1819,39,30-34,1858,11.764871023086007
STAT,1881,52,na,1933,1953.543568428285
STAT,1932,29,na,1961,4630.817233069127
STAT,1841,22,45-49,1863,0.6043926648105699
STAT,1902,46,50-100,1948,0.18521719326960928
STAT,1953,19,50-100,1972,0.4278720740898213
SIM,1825,39,na,1864,1473
STAT,1919,35,45-49,1954,0.6957295894178388
STAT,1854,109,na,1963,0.00249712950213411
STAT,1956,11,na,1967,4910.538741659939
SIM,1821,55,na,1876,1199
SIM,1889,23,35-39,1912,10
STAT,1916,25,20-24,1941,17.950457628497066
SIM,1944,19,40-44,1963,1
SIM,1898,52,na,1950,2702
SIM,1901,38,30-34,1939,2
SIM,1918,16,35-39,1934,2
STAT,1941,17,25-29,1958,42.163962352228516
SIM,1889,21,40-44,1910,3
STAT,1829,74,na,1903,680.2434020161144
STAT,1916,27,15-19,1943,0.6895385430458867
STAT,1825,84,na,1909,188.08581423561898
SIM,1919,43,40-44,1962,1
SIM,1936,31,na,1967,2866
SIM,1928,36,na,1964,4493
STAT,1848,17,45-49,1865,0.05833767765032756
SIM,1829,28,40-44,1857,4
SIM,1857,78,na,1935,562
SIM,1910,26,na,1936,3346
STAT,1911,47,na,1958,3284.8928355877492
STAT,1861,38,40-44,1899,3.4170159031285046
SIM,1843,31,45-49,1874,1
SIM,1903,35,30-34,1938,2
STAT,1920,27,35-39,1947,15.559424532672253
SIM,1873,16,35-39,1889,2
STAT,1841,23,na,1864,1839.8832136193391
STAT,1856,76,na,1932,700.9782696158804
SIM,1853,88,na,1941,89
STAT,1931,15,45-49,1946,0.6205713805813998
SIM,1924,25,20-24,1949,23
STAT,1865,16,35-39,1881,0.48827047278792984
STAT,1922,24,35-39,1946,10.137575619156463
SIM,1933,18,25-29,1951,65
STAT,1830,42,50-100,1872,0.8035163199802864
STAT,1850,21,50-100,1871,0.3470668942189274
STAT,1876,16,50-100,1892,0.0478969416831101
SIM,1826,28,50-100,1854,2
STAT,1920,2,na,1922,4335.010130929934
STAT,1860,81,na,1941,415.17718000296213
STAT,1872,15,na,1887,2431.2183095337873
SIM,1802,96,na,1898,3
SIM,1893,29,na,1922,2947
SIM,1907,28,25-29,1935,2
SIM,1912,28,35-39,1940,18
STAT,1844,106,na,1950,0.008523577755868669
STAT,1883,78,na,1961,907.2714546271183
SIM,1855,30,25-29,1885,16
STAT,1926,8,na,1934,4620.075472103887
SIM,1950,15,20-24,1965,152
STAT,1900,33,15-19,1933,0.1858503935139116
STAT,1911,21,25-29,1932,82.9890873206739
STAT,1877,15,15-19,1892,5.844770953630359
SIM,1837,30,na,1867,1764
SIM,1793,94,na,1887,1
STAT,1807,54,50-100,1861,0.05137741351065144
SIM,1823,46,50-100,1869,2
STAT,1862,51,30-34,1913,0.004819740394327689
SIM,1866,101,na,1967,5
STAT,1816,48,na,1864,1369.505035196879
SIM,1903,33,35-39,1936,10
STAT,1904,28,35-39,1932,13.02657573748053
SIM,1861,83,na,1944,278
STAT,1908,47,50-100,1955,0.19319232177120502
STAT,1847,30,25-29,1877,9.034371136069936
STAT,1911,36,25-29,1947,0.9025279158858748
SIM,1868,16,25-29,1884,9
STAT,1903,4,na,1907,3535.7312850901067
STAT,1931,33,45-49,1964,1.9466992278633213
STAT,1925,18,25-29,1943,49.33007626647166
SIM,1895,25,50-100,1920,5
STAT,1870,53,50-100,1923,0.01375568808093356
SIM,1906,29,20-24,1935,21
SIM,1930,22,40-44,1952,4
STAT,1859,17,20-24,1876,15.515096387343686
STAT,1813,50,50-100,1863,0.04538768778021268
STAT,1921,25,30-34,1946,41.53737189985672
STAT,1835,31,45-49,1866,1.3996600739046212
SIM,1831,36,50-100,1867,3
SIM,1950,17,15-19,1967,44
STAT,1902,29,40-44,1931,3.964987968429472
SIM,1826,78,na,1904,392
SIM,1826,86,na,1912,108
STAT,1928,42,30-34,1970,0.15398127935468603
SIM,1822,96,na,1918,6
STAT,1777,100,na,1877,0.19779584917093068
SIM,1920,32,25-29,1952,17
STAT,1896,25,25-29,1921,53.17299863446072
SIM,1888,22,na,1910,2563
SIM,1910,29,40-44,1939,8
STAT,1848,18,50-100,1866,0.043495551546725346
STAT,1904,26,40-44,1930,4.07238676825433
STAT,1923,16,50-100,1939,0.4166614380420205
STAT,1850,51,na,1901,1523.087739068505
SIM,1907,26,30-34,1933,40
STAT,1926,45,30-34,1971,0.10441292763008107
STAT,1929,41,35-39,1970,0.24672365677149208
SIM,1851,53,na,1904,1582
STAT,1798,97,na,1895,1.4900550715746153
STAT,1839,24,40-44,1863,1.759703004487657
STAT,1889,18,45-49,1907,0.07598420722596724
STAT,1909,48,35-39,1957,0.11158008052435876
STAT,1862,17,na,1879,2118.524775302723
SIM,1800,61,na,1861,941
STAT,1873,20,25-29,1893,55.220818343094656
SIM,1852,47,na,1899,1739
SIM,1899,43,45-49,1942,1
STAT,1843,54,25-29,1897,0.0024851323463886904
SIM,1911,28,45-49,1939,7
STAT,1870,46,40-44,1916,0.15892455571962844
STAT,1811,43,25-29,1854,2.3775258688754928
STAT,1903,28,45-49,1931,1.487031257169899
SIM,1905,30,35-39,1935,9
STAT,1867,48,na,1915,1970.5349437839234
STAT,1856,37,50-100,1893,0.908399491290604
STAT,1892,49,25-29,1941,0.03763476446689774
STAT,1907,32,15-19,1939,0.11345386152031388
STAT,1912,32,25-29,1944,8.589693545735084
SIM,1912,26,40-44,1938,4
SIM,1867,60,na,1927,1673
STAT,1936,19,40-44,1955,1.2580535546047522
STAT,1871,0,na,1871,3485.4856264921364
SIM,1842,37,na,1879,1712
STAT,1915,27,25-29,1942,63.416280263925756
SIM,1851,73,na,1924,835
SIM,1797,76,na,1873,375
SIM,1869,31,50-100,1900,3
SIM,1834,73,na,1907,706
STAT,1888,19,40-44,1907,0.20302700783229785
STAT,1900,15,15-19,1915,7.8138966989528615
STAT,1826,58,na,1884,1145.940791142079
STAT,1855,35,na,1890,1684.4365105581335
STAT,1898,20,30-34,1918,22.914738876898497
STAT,1911,5,na,1916,3787.7099135013164
SIM,1830,91,na,1921,23
SIM,1922,28,20-24,1950,20
STAT,1854,2,na,1856,2579.7630390859317
SIM,1913,25,45-49,1938,1
STAT,1835,48,40-44,1883,0.1111596579086269
STAT,1914,28,20-24,1942,17.319817978964362
SIM,1865,21,25-29,1886,56
STAT,1927,44,35-39,1971,0.23780864584594386
SIM,1867,17,20-24,1884,13
STAT,1922,22,40-44,1944,3.642861810974553
STAT,1942,17,15-19,1959,44.80202252446479
STAT,1905,25,45-49,1930,1.5260195790349669
SIM,1909,23,30-34,1932,41
STAT,1925,44,50-100,1969,0.1339350870159166
STAT,1940,5,na,1945,3840.4730789405266
STAT,1864,71,na,1935,1126.9865260552465
SIM,1888,24,30-34,1912,23
STAT,1835,94,na,1929,12.469908908024301
STAT,1918,39,45-49,1957,0.6773454821209303
STAT,1912,21,50-100,1933,0.597379430756956
STAT,1940,20,35-39,1960,9.066781317788088
SIM,1893,39,40-44,1932,11
STAT,1937,35,35-39,1972,2.2885126219101366
SIM,1820,81,na,1901,229
STAT,1930,26,na,1956,4502.211705258972
STAT,1906,24,50-100,1930,0.5574484727854435
SIM,1904,31,30-34,1935,11
SIM,1814,73,na,1887,487
SIM,1854,42,na,1896,1812
SIM,1942,21,20-24,1963,94
SIM,1921,31,30-34,1952,18
STAT,1796,62,na,1858,956.325673275797
STAT,1874,81,na,1955,522.1251808415184
STAT,1874,21,25-29,1895,55.43931539972009
STAT,1913,19,45-49,1932,0.09594712707832792
SIM,1925,21,20-24,1946,120
SIM,1923,27,25-29,1950,73
STAT,1874,10,na,1884,2555.8069649225113
SIM,1858,42,45-49,1900,1
STAT,1930,19,45-49,1949,0.6068698915282476
SIM,1916,11,na,1927,3875
STAT,1937,33,40-44,1970,3.6547597417038507
SIM,1925,23,15-19,1948,8
STAT,1864,18,40-44,1882,0.1588103930143174
STAT,1816,56,na,1872,1187.453389539173
STAT,1810,47,25-29,1857,0.2047963013039025
STAT,1782,82,na,1864,143.29300267612905
STAT,1905,43,45-49,1948,0.14085536974543403
SIM,1865,65,na,1930,1430
SIM,1943,13,na,1956,3859
STAT,1837,23,50-100,1860,0.3345733562302056
SIM,1888,27,35-39,1915,8
STAT,1799,106,na,1905,0.004059333978555238
STAT,1908,33,15-19,1941,0.1140795283279932
STAT,1934,21,20-24,1955,141.211390256835
STAT,1829,34,25-29,1863,9.491230932911106
STAT,1920,45,35-39,1965,0.13527861148649442
SIM,1842,17,na,1859,2021
SIM,1881,3,na,1884,2361
STAT,1885,39,40-44,1924,4.078549173366358
SIM,1879,14,na,1893,2546
STAT,1917,21,20-24,1938,111.97546617475892
STAT,1805,64,na,1869,853.1730558326402
STAT,1871,53,na,1924,1984.157469269244
SIM,1843,78,na,1921,521
SIM,1847,24,40-44,1871,5
STAT,1864,51,na,1915,1826.6408232398242
STAT,1942,15,20-24,1957,133.90991607299935
STAT,1821,53,35-39,1874,0.012388443202618707
STAT,1807,51,na,1858,1202.5480654977875
STAT,1873,88,na,1961,229.11941528075582
STAT,1841,15,na,1856,2049.6349035944686
SIM,1865,103,na,1968,1
SIM,1906,27,25-29,1933,72
SIM,1929,30,50-100,1959,4
STAT,1847,18,40-44,1865,0.16697728030458292
STAT,1890,12,na,1902,2982.867802489738
SIM,1837,34,25-29,1871,17
SIM,1916,31,20-24,1947,3
STAT,1889,15,40-44,1904,0.21430580780974554
STAT,1869,21,15-19,1890,3.025856783742257
STAT,1887,68,na,1955,1614.5353947780688
SIM,1892,1,na,1893,3227
SIM,1847,26,35-39,1873,10
STAT,1847,48,na,1895,1634.6071687513722
SIM,1905,59,na,1964,2782
STAT,1842,96,na,1938,6.114666893109121
STAT,1859,24,50-100,1883,0.3144185934291696
SIM,1884,32,45-49,1916,1
STAT,1914,30,35-39,1944,8.75825814456835
STAT,1891,73,na,1964,1644.1631772130074
STAT,1891,53,na,1944,2477.356764157192
SIM,1863,78,na,1941,609
STAT,1824,43,na,1867,1432.4803614007142
SIM,1811,45,na,1856,1353
SIM,1848,22,na,1870,1937
STAT,1876,49,40-44,1925,0.16347764884711277
STAT,1903,41,15-19,1944,0.0012947367037610105
STAT,1875,35,na,1910,2308.28121165131
STAT,1889,17,35-39,1906,0.6399441125287152
STAT,1860,54,30-34,1914,0.0044444519651360365
STAT,1902,30,na,1932,3206.8779594668995
SIM,1941,22,15-19,1963,8
SIM,1786,92,na,1878,7
SIM,1874,30,na,1904,2292
SIM,1812,86,na,1898,113
STAT,1876,32,45-49,1908,1.7006720065851584
STAT,1928,43,40-44,1971,0.300781681436986
STAT,1891,39,50-100,1930,1.4211591155682375
STAT,1917,23,15-19,1940,5.327913257342366
SIM,1866,20,30-34,1886,15
STAT,1913,31,30-34,1944,14.865381309689136
SIM,1901,23,30-34,1924,21
STAT,1908,31,20-24,1939,2.183421559900529
SIM,1882,37,na,1919,2132
STAT,1820,61,na,1881,1045.5182576170264
SIM,1878,35,25-29,1913,4
STAT,1839,26,35-39,1865,8.163551349727957
SIM,1927,6,na,1933,4615
STAT,1831,33,na,1864,1692.8926459244917
STAT,1897,1,na,1898,3438.847938286142
STAT,1903,45,35-39,1948,0.10719869581256633
STAT,1933,22,15-19,1955,6.670482626021117
STAT,1904,57,na,1961,2838.6636018391127
SIM,1939,18,20-24,1957,111
SIM,1888,25,40-44,1913,4
STAT,1834,49,35-39,1883,0.08957884631826751
STAT,1858,20,30-34,1878,15.376763459852736
SIM,1806,86,na,1892,56
STAT,1922,21,30-34,1943,31.23299334969687
SIM,1803,58,na,1861,977
SIM,1931,20,35-39,1951,17
SIM,1916,19,35-39,1935,6
SIM,1942,23,15-19,1965,5
STAT,1908,19,35-39,1927,0.7646357660492914
STAT,1934,23,15-19,1957,6.755703160270941
SIM,1817,41,45-49,1858,1
STAT,1915,29,na,1944,3583.5323341668045
SIM,1868,22,na,1890,2136
SIM,1930,21,30-34,1951,41
SIM,1902,37,35-39,1939,7
STAT,1909,49,45-49,1958,0.1875109307802146
STAT,1934,22,50-100,1956,0.8353441355064508
STAT,1938,32,45-49,1970,1.494551703897841
STAT,1920,41,15-19,1961,0.001604654593397012
STAT,1778,77,na,1855,278.32842000000005
STAT,1859,49,40-44,1908,0.12637695959718068
STAT,1852,43,50-100,1895,0.7968646724119517
STAT,1923,20,35-39,1943,10.4125610735178
STAT,1836,56,na,1892,1288.006505299696
STAT,1912,35,30-34,1947,1.6960409189425838
STAT,1933,25,20-24,1958,22.917131540365926
STAT,1927,43,25-29,1970,0.08448036354115204
SIM,1862,37,na,1899,2040
STAT,1907,22,na,1929,3281.4269950204935
SIM,1912,29,45-49,1941,3
STAT,1818,82,na,1900,224.950363678263
STAT,1878,63,na,1941,1754.7785170510988
SIM,1900,5,na,1905,3415
SIM,1905,31,45-49,1936,2
STAT,1908,47,na,1955,3137.984517734014
SIM,1905,28,20-24,1933,18
STAT,1779,100,na,1879,0.21023577636172705
STAT,1937,6,na,1943,3683.0290565525097
STAT,1841,37,50-100,1878,0.9896984063524058
STAT,1941,16,15-19,1957,44.16909336021646
STAT,1823,38,na,1861,1496.488114633545
SIM,1902,18,25-29,1920,9
STAT,1920,26,25-29,1946,68.44744363800847
STAT,1862,54,35-39,1916,0.006746728764437902
SIM,1794,100,na,1894,1
STAT,1838,33,50-100,1871,0.7684997786106983
STAT,1856,43,50-100,1899,0.7760158468886745
SIM,1839,30,40-44,1869,3
SIM,1849,63,na,1912,1311
STAT,1887,35,25-29,1922,3.070750737803668
SIM,1924,45,50-100,1969,4
STAT,1902,25,50-100,1927,0.858590433032922
STAT,1837,41,20-24,1878,0.11982628371903793
SIM,1879,34,30-34,1913,24
SIM,1920,16,na,1936,3854
SIM,1858,27,20-24,1885,2
STAT,1936,11,na,1947,3588.3684857346543
SIM,1881,20,25-29,1901,51
STAT,1913,31,50-100,1944,0.7801008004864768
STAT,1904,29,45-49,1933,1.493513072304469
STAT,1849,74,na,1923,799.9254259493056
STAT,1914,15,45-49,1929,0.09805502951070155
STAT,1826,54,25-29,1880,0.003071623028159122
SIM,1907,25,20-24,1932,13
STAT,1903,42,25-29,1945,0.059860276605927104
STAT,1916,40,15-19,1956,0.0014907727238665795
STAT,1885,22,45-49,1907,0.6563046714390558
STAT,1919,37,40-44,1956,1.5192818877372847
SIM,1923,9,na,1932,4317
STAT,1919,19,40-44,1938,1.452376491412397
SIM,1867,103,na,1970,1
SIM,1877,21,15-19,1898,2
SIM,1878,32,20-24,1910,3
STAT,1879,29,40-44,1908,2.936775118325757
STAT,1778,97,na,1875,0.8134208507255551
SIM,1856,31,25-29,1887,12
STAT,1893,45,25-29,1938,0.03933272824369463
SIM,1790,66,na,1856,678
STAT,1855,15,na,1870,1956.608815109366
STAT,1882,17,na,1899,2321.663613170565
SIM,1908,27,30-34,1935,33
STAT,1876,76,na,1952,923.9605285012025
STAT,1931,28,20-24,1959,22.25304472274088
STAT,1826,41,45-49,1867,1.502218571409305
STAT,1830,31,na,1861,1692.7084550688855
STAT,1915,44,45-49,1959,0.15774865518211806
SIM,1864,101,na,1965,4
STAT,1910,38,30-34,1948,1.6380439816971397
SIM,1886,27,na,1913,2301
STAT,1893,32,45-49,1925,2.0901732075942228
STAT,1835,51,50-100,1886,0.009795293116671476
SIM,1926,41,na,1967,4204
SIM,1927,19,40-44,1946,1
STAT,1819,76,na,1895,473.1210588895502
SIM,1913,22,40-44,1935,5
SIM,1833,88,na,1921,64
SIM,1854,34,25-29,1888,10
STAT,1888,30,15-19,1918,0.1602058993735037
STAT,1921,28,35-39,1949,15.75294475438579
STAT,1876,17,20-24,1893,17.28984595549681
STAT,1908,18,25-29,1926,7.9184607435577945
SIM,1933,15,20-24,1948,154
STAT,1905,38,20-24,1943,0.2260092757762163
STAT,1910,23,30-34,1933,25.411680121153797
STAT,1922,25,45-49,1947,1.8594413862001133
SIM,1808,81,na,1889,169
STAT,1868,33,na,1901,2143.314644455576
STAT,1860,53,20-24,1913,5.574482633384596E-4
STAT,1936,34,35-39,1970,8.373007105437273
STAT,1822,100,na,1922,0.5483746369863309
STAT,1911,33,20-24,1944,2.233838069335355
SIM,1793,66,na,1859,680
STAT,1909,2,na,1911,3775.5155687820443
STAT,1852,31,45-49,1883,1.3861023448822953
STAT,1868,10,na,1878,2439.215809198375
STAT,1931,30,40-44,1961,4.849734081994634
SIM,1931,21,45-49,1952,2
STAT,1750,107,na,1857,0.24610289009496306
STAT,1839,76,na,1915,631.7023287459115
STAT,1925,15,20-24,1940,155.45497084527904
SIM,1810,91,na,1901,23
STAT,1848,31,25-29,1879,8.69506165879261
SIM,1892,67,na,1959,1993
STAT,1902,31,25-29,1933,13.710711628061716
STAT,1913,47,45-49,1960,0.20035418759794674
SIM,1930,25,45-49,1955,1
STAT,1795,69,na,1864,663.7562593627171
STAT,1858,21,40-44,1879,1.7859682621056419
STAT,1905,22,40-44,1927,2.8447229314786573
STAT,1884,71,na,1955,1246.0893911268672
STAT,1815,94,na,1909,8.554066288764515
STAT,1860,61,na,1921,1434.6630367306882
SIM,1823,81,na,1904,295
STAT,1790,77,na,1867,318.737899861489
STAT,1895,43,na,1938,2838.482309831237
SIM,1884,60,na,1944,1852
STAT,1875,47,30-34,1922,0.09351008989694796
SIM,1941,25,20-24,1966,16
STAT,1921,40,25-29,1961,0.07619901462649706
SIM,1840,81,na,1921,315
SIM,1916,18,25-29,1934,6
STAT,1852,44,25-29,1896,0.481307515146067
SIM,1911,25,40-44,1936,7
SIM,1901,39,40-44,1940,1
STAT,1867,43,50-100,1910,0.9303041244868147
STAT,1923,21,45-49,1944,1.2406226961861009
STAT,1899,21,30-34,1920,23.12964191444116
STAT,1838,28,40-44,1866,2.5802474887502203
STAT,1846,34,25-29,1880,8.358932027905869
SIM,1852,21,45-49,1873,1
SIM,1860,31,45-49,1891,6
SIM,1895,32,na,1927,2976
STAT,1916,28,25-29,1944,64.06353190024109
SIM,1924,28,25-29,1952,79
SIM,1868,2,na,1870,2882
STAT,1901,16,15-19,1917,7.866451873374732
STAT,1842,17,na,1859,2099.0583535643646
SIM,1864,24,40-44,1888,2
SIM,1908,16,na,1924,3488
STAT,1902,22,na,1924,3152.960178765175
STAT,1880,47,40-44,1927,0.1693791768017476
SIM,1903,24,na,1927,3167
STAT,1818,54,50-100,1872,0.02973485312792366
STAT,1863,31,20-24,1894,2.2538297850469204
STAT,1856,24,40-44,1880,1.7650322637163995
STAT,1801,54,20-24,1855,0.002557874037121001
STAT,1928,25,50-100,1953,1.1664156128369183
STAT,1945,27,40-44,1972,4.830791894609952
STAT,1903,25,40-44,1928,4.053451535241746
STAT,1951,21,20-24,1972,125.54992077481717
SIM,1943,21,na,1964,3601
SIM,1846,28,40-44,1874,2
SIM,1899,40,40-44,1939,1
STAT,1917,52,na,1969,3563.9223739528775
STAT,1887,22,50-100,1909,0.43082914925088633
SIM,1859,23,20-24,1882,54
STAT,1930,16,40-44,1946,1.7125937518840044
STAT,1918,43,50-100,1961,0.11780932381009139
STAT,1938,22,50-100,1960,0.6151303285946774
STAT,1844,21,45-49,1865,0.6156254874066298
STAT,1908,27,na,1935,3343.592782283252
STAT,1924,47,20-24,1971,0.01243008108786498
SIM,1848,21,25-29,1869,59
SIM,1904,2,na,1906,3530
SIM,1925,24,25-29,1949,112
STAT,1897,24,30-34,1921,22.363431312527993
STAT,1895,0,na,1895,3619.9150116112833
STAT,1917,30,50-100,1947,0.8244386886411204
STAT,1919,19,na,1938,3821.9702331468843
SIM,1910,31,25-29,1941,12
STAT,1834,46,30-34,1880,0.07072994531378737
STAT,1857,20,40-44,1877,1.8176075333819788
SIM,1841,20,25-29,1861,61
STAT,1823,58,na,1881,1126.7485173641903
STAT,1913,32,40-44,1945,3.677296858011091
SIM,1950,15,na,1965,3997
STAT,1851,48,25-29,1899,0.04170829155789181
SIM,1904,34,35-39,1938,9
STAT,1884,40,50-100,1924,0.9961913144004193
SIM,1860,46,50-100,1906,2
STAT,1812,66,na,1878,832.6992444695678
STAT,1937,32,30-34,1969,14.723272703675304
STAT,1821,50,30-34,1871,0.009093257709590727
STAT,1918,36,40-44,1954,1.49773210280307
STAT,1773,103,na,1876,0.03603674765916323
STAT,1799,59,na,1858,1003.2556531700087
SIM,1836,45,na,1881,1514
STAT,1900,33,45-49,1933,2.275790565620474
STAT,1924,7,na,1931,4497.311940292875
STAT,1915,44,15-19,1959,0.0014555816955692732
STAT,1921,23,35-39,1944,10.016752803823154
STAT,1829,31,20-24,1860,2.708773561813865
STAT,1968,2,na,1970,4642.344361616027
STAT,1874,22,35-39,1896,5.634340007408827
SIM,1838,33,30-34,1871,22
STAT,1843,20,50-100,1863,0.37464504755139066
STAT,1926,17,30-34,1943,14.11920169790328
STAT,1909,47,25-29,1956,0.04603521055210541
SIM,1896,31,25-29,1927,15
SIM,1881,75,na,1956,843
SIM,1827,40,na,1867,1499
SIM,1866,21,40-44,1887,1
STAT,1923,18,20-24,1941,150.0124499645899
SIM,1848,22,35-39,1870,8
STAT,1896,22,20-24,1918,86.0394682744873
SIM,1891,42,na,1933,2818
SIM,1901,20,20-24,1921,84
STAT,1831,25,na,1856,1763.642610477145
STAT,1843,58,na,1901,1426.7483562640678
STAT,1924,19,20-24,1943,151.71525180684648
SIM,1917,29,25-29,1946,70
STAT,1901,37,na,1938,3139.859705794389
SIM,1921,8,na,1929,4211
SIM,1884,40,na,1924,2294
STAT,1872,24,25-29,1896,53.94061605773724
SIM,1875,55,na,1930,2003
SIM,1796,82,na,1878,143
STAT,1866,86,na,1952,193.251723138284
SIM,1913,40,40-44,1953,3
SIM,1839,17,na,1856,2081
STAT,1917,24,25-29,1941,92.15748402769967
SIM,1903,32,25-29,1935,7
STAT,1917,42,25-29,1959,0.0703972275178541
SIM,1921,32,40-44,1953,6
SIM,1931,18,20-24,1949,166
STAT,1932,29,20-24,1961,22.564656934508456
SIM,1786,84,na,1870,83
SIM,1820,61,na,1881,996
SIM,1932,19,20-24,1951,160
SIM,1937,26,45-49,1963,2
STAT,1881,12,na,1893,2355.6201450102544
STAT,1905,40,40-44,1945,0.2153810976458024
STAT,1917,32,na,1949,3741.208874493516
STAT,1909,29,25-29,1938,58.984841844586754
SIM,1865,20,40-44,1885,4
SIM,1882,14,na,1896,2362
SIM,1964,7,na,1971,4484
STAT,1843,89,na,1932,75.79142923276653
SIM,1819,73,na,1892,547
SIM,1778,97,na,1875,2
SIM,1940,29,20-24,1969,19
SIM,1930,24,35-39,1954,11
STAT,1854,15,50-100,1869,0.04270338896759775
STAT,1938,19,15-19,1957,42.25873725117519
STAT,1878,42,20-24,1920,0.15599278773989864
STAT,1901,44,15-19,1945,0.00125093427413456
STAT,1903,42,30-34,1945,0.10716920445277436
STAT,1850,91,na,1941,40.79539728789463
SIM,1887,29,40-44,1916,2
STAT,1907,35,20-24,1942,0.23304049108172797
STAT,1896,48,50-100,1944,0.17079684360294206
SIM,1836,20,15-19,1856,2
STAT,1855,53,40-44,1908,0.007336353525946225
STAT,1925,19,na,1944,4178.423807555068
SIM,1866,44,50-100,1910,1
STAT,1806,66,na,1872,772.8493935302484
STAT,1905,5,na,1910,3577.578877471103
STAT,1904,25,30-34,1929,34.34848083490765
STAT,1949,17,50-100,1966,0.41167160104612255
SIM,1892,27,na,1919,2840
SIM,1912,25,30-34,1937,44
STAT,1819,84,na,1903,166.12767008008083
SIM,1844,32,na,1876,1869
SIM,1844,71,na,1915,891
SIM,1927,37,40-44,1964,5
SIM,1789,89,na,1878,28
STAT,1942,18,25-29,1960,42.76644741664352
SIM,1915,18,na,1933,3752
SIM,1933,34,30-34,1967,21
SIM,1837,31,20-24,1868,2
SIM,1950,18,25-29,1968,55
SIM,1906,24,20-24,1930,93
STAT,1864,20,na,1884,2058.39926829483
STAT,1883,15,40-44,1898,0.17013072286764874
SIM,1920,35,30-34,1955,6
SIM,1933,16,30-34,1949,16
STAT,1868,25,15-19,1893,0.4120056166870196
SIM,1946,19,15-19,1965,42
SIM,1888,21,25-29,1909,66
SIM,1915,49,na,1964,3440
STAT,1889,32,25-29,1921,11.945662685376343
STAT,1898,21,40-44,1919,2.672876224449733
SIM,1838,32,na,1870,1685
STAT,1848,33,na,1881,1805.5583204854063
SIM,1889,22,25-29,1911,72
STAT,1788,67,na,1855,709.0624
STAT,1888,31,25-29,1919,11.477564132457958
STAT,1931,41,50-100,1972,0.1484811992326267
STAT,1878,15,30-34,1893,1.574777739492327
SIM,1934,17,30-34,1951,21
SIM,1831,53,na,1884,1340
SIM,1846,98,na,1944,2
STAT,1856,23,30-34,1879,15.1965094755811
STAT,1925,34,30-34,1959,17.653829706115264
STAT,1958,9,na,1967,4874.825223990338
SIM,1897,32,25-29,1929,19
SIM,1926,36,40-44,1962,2
STAT,1929,38,50-100,1967,0.5087277872464073
STAT,1943,24,na,1967,3667.732205807399
STAT,1818,106,na,1924,0.00585379425854354
STAT,1925,16,30-34,1941,13.945587090351676
STAT,1877,78,na,1955,765.9537162387913
STAT,1899,22,40-44,1921,2.697726992998953
STAT,1923,36,15-19,1959,0.02104104631056062
STAT,1911,34,30-34,1945,14.365996292651696
SIM,1864,23,30-34,1887,26
SIM,1911,24,30-34,1935,38
SIM,1868,15,15-19,1883,7
STAT,1858,44,50-100,1902,0.7729202813546424
STAT,1861,7,na,1868,2231.7357481516306
STAT,1901,21,50-100,1922,0.5408438777142945
STAT,1921,41,35-39,1962,0.2145872460160527
STAT,1862,48,na,1910,1790.2263187440542
STAT,1808,92,na,1900,16.188514604259936
STAT,1915,26,15-19,1941,0.6825034524076175
STAT,1781,97,na,1878,0.85414210786506
SIM,1940,16,na,1956,3355
STAT,1867,29,15-19,1896,0.3995580976040616
STAT,1898,24,45-49,1922,0.886171076129887
SIM,1900,24,20-24,1924,92
STAT,1820,100,na,1920,0.5655748555657442
SIM,1911,26,25-29,1937,61
STAT,1944,16,35-39,1960,4.2670431230756
STAT,1814,109,na,1923,2.9354541772235647E-4
SIM,1936,27,40-44,1963,4
SIM,1952,16,35-39,1968,4
STAT,1779,109,na,1888,0.003133695287638369
STAT,1857,25,40-44,1882,2.331268579875138
SIM,1898,31,30-34,1929,23
SIM,1850,7,na,1857,2197
SIM,1879,25,na,1904,2366
SIM,1950,19,35-39,1969,9
STAT,1905,21,30-34,1926,24.389948620322155
STAT,1905,40,35-39,1945,0.17339583374431689
SIM,1839,96,na,1935,6
STAT,1901,33,30-34,1934,22.989330421291605
STAT,1935,19,25-29,1954,55.66240589973115
STAT,1955,16,45-49,1971,0.6265984999737951
SIM,1925,27,30-34,1952,51
STAT,1848,50,35-39,1898,0.006291296613649036
SIM,1839,73,na,1912,822
STAT,1814,52,40-44,1866,0.027318074654720647
STAT,1928,27,40-44,1955,5.425306550213515
STAT,1811,56,na,1867,1116.8451626069077
STAT,1949,18,na,1967,4043.1222691310095
STAT,1888,53,na,1941,2364.439755240535
SIM,1877,22,25-29,1899,58
SIM,1920,15,40-44,1935,2
STAT,1907,34,50-100,1941,0.7237082189701128
STAT,1918,40,50-100,1958,0.11832328599577036
STAT,1912,38,35-39,1950,2.2185938856395127
STAT,1942,19,35-39,1961,4.139624426517041
SIM,1828,33,na,1861,1574
SIM,1916,47,50-100,1963,1
SIM,1955,1,na,1956,4549
SIM,1821,86,na,1907,92
STAT,1762,107,na,1869,0.0014973917094469123
SIM,1906,3,na,1909,3705
STAT,1869,22,25-29,1891,52.34749354689465
SIM,1920,38,35-39,1958,6
STAT,1822,96,na,1918,4.4352914893594795
STAT,1829,43,na,1872,1578.1577791468956
STAT,1881,43,40-44,1924,2.036842652924931
STAT,1953,19,45-49,1972,0.5704960987864283
SIM,1856,32,35-39,1888,8
STAT,1925,45,15-19,1970,4.2372624793958957E-4
STAT,1903,26,25-29,1929,57.04961760807706
SIM,1879,35,40-44,1914,4
STAT,1864,46,45-49,1910,0.19982306885243395
STAT,1837,44,25-29,1881,0.4242837998094132
STAT,1848,32,35-39,1880,8.508173083269638
STAT,1912,15,40-44,1927,0.2683725851753299
STAT,1893,16,50-100,1909,0.05886667378782818
STAT,1811,47,40-44,1858,0.5700176870883982
STAT,1803,51,25-29,1854,0.010357932486536688
STAT,1857,61,na,1918,1391.6677926912064
SIM,1896,17,na,1913,3209
STAT,1929,26,45-49,1955,2.043612296221936
STAT,1893,49,40-44,1942,0.11333481048161521
STAT,1928,24,na,1952,4280.745617118159
STAT,1919,34,35-39,1953,9.234220898733133
SIM,1934,7,na,1941,5057
SIM,1904,54,na,1958,2846
STAT,1892,30,50-100,1922,1.0926374485596253
STAT,1889,33,35-39,1922,11.761071524717442
STAT,1860,36,30-34,1896,4.111529123642559
STAT,1924,34,na,1958,4163.421289899063
SIM,1897,33,35-39,1930,14
SIM,1935,29,45-49,1964,2
STAT,1927,29,45-49,1956,1.9763463821239633
STAT,1873,24,40-44,1897,1.9856726829529006
SIM,1889,5,na,1894,3092
STAT,1802,96,na,1898,2.9292314556065495
SIM,1894,2,na,1896,3384
SIM,1951,5,na,1956,4353
STAT,1841,15,35-39,1856,0.48995063448282916
STAT,1863,34,25-29,1897,8.432776231184027
SIM,1907,22,15-19,1929,5
STAT,1924,35,20-24,1959,0.29418797856146384
STAT,1890,36,45-49,1926,2.313613204357871
STAT,1961,8,na,1969,4795.472477820734
STAT,1942,30,45-49,1972,1.5852286540043126
SIM,1916,15,20-24,1931,24
STAT,1823,45,45-49,1868,0.28976317677749486
STAT,1857,23,45-49,1880,0.5952328499258246
STAT,1934,36,25-29,1970,1.2847230071746045
STAT,1812,97,na,1909,2.3105924388567023
STAT,1869,24,20-24,1893,62.6216281040211
SIM,1857,39,na,1896,1876
STAT,1858,47,30-34,1905,0.07145505930420241
SIM,1875,35,na,1910,2270
STAT,1912,36,40-44,1948,1.38659662475792
SIM,1943,4,na,1947,3914
STAT,1905,15,50-100,1920,0.06719227013243816
STAT,1858,106,na,1964,0.04900586809914134
SIM,1943,19,25-29,1962,54
STAT,1944,26,40-44,1970,4.761091632911408
STAT,1835,44,25-29,1879,0.4679319199883942
STAT,1870,42,25-29,1912,0.5936933402312822
STAT,1908,15,20-24,1923,24.953622154967462
SIM,1915,17,25-29,1932,9
SIM,1913,14,na,1927,3681
STAT,1896,40,15-19,1936,0.0012094024391448872
SIM,1901,23,25-29,1924,84
STAT,1875,91,na,1966,160.33422628338272
SIM,1847,91,na,1938,30
SIM,1865,25,40-44,1890,3
STAT,1918,17,na,1935,3984.315150395938
STAT,1859,73,na,1932,895.4758826917221
STAT,1902,46,25-29,1948,0.04343855967861304
SIM,1879,37,35-39,1916,12
STAT,1905,50,na,1955,2981.7307974940204
STAT,1868,26,25-29,1894,38.28584770295617
SIM,1860,81,na,1941,412
STAT,1922,43,45-49,1965,0.18019052435638414
STAT,1858,24,45-49,1882,0.5322331298253951
STAT,1935,37,25-29,1972,1.300582584049654
SIM,1927,34,35-39,1961,11
STAT,1823,36,50-100,1859,2.080600110967773
STAT,1900,30,40-44,1930,5.729341252952976
SIM,1920,36,40-44,1956,1
STAT,1907,17,25-29,1924,7.862398959569515
SIM,1880,24,25-29,1904,67
SIM,1843,47,na,1890,1576
STAT,1866,30,30-34,1896,15.329460218275916
SIM,1920,21,50-100,1941,3
STAT,1913,35,45-49,1948,0.6414417880812369
STAT,1785,70,na,1855,633.9172
STAT,1847,34,40-44,1881,3.3392702902250924
STAT,1930,31,50-100,1961,1.0086335837140241
STAT,1844,27,50-100,1871,0.5497374030031691
SIM,1854,73,na,1927,830
STAT,1826,89,na,1915,57.34001271489343
STAT,1775,100,na,1875,0.1912647358461152
STAT,1895,12,na,1907,3183.7166989313714
SIM,1896,15,25-29,1911,6
STAT,1945,24,35-39,1969,9.7423144174686
STAT,1833,21,35-39,1854,6.150177403467498
SIM,1910,16,30-34,1926,4
STAT,1867,17,na,1884,2290.1706355564274
SIM,1928,32,30-34,1960,23
STAT,1802,53,30-34,1855,0.016629499472843586
SIM,1899,45,na,1944,2932
STAT,1822,33,25-29,1855,26.519924856711356
STAT,1851,45,20-24,1896,0.008887527780864008
SIM,1841,21,35-39,1862,9
STAT,1817,49,35-39,1866,0.3034855730605092
SIM,1908,23,15-19,1931,4
STAT,1887,17,na,1904,2668.2940956559323
STAT,1897,25,40-44,1922,3.8103177134262944
STAT,1916,47,35-39,1963,0.12492281851142722
STAT,1800,61,na,1861,940.9764414517625
STAT,1840,42,40-44,1882,1.6340182779089671
STAT,1925,30,15-19,1955,0.14433990928632756
STAT,1888,15,25-29,1903,6.353509308386711
STAT,1897,27,35-39,1924,12.19060446388749
SIM,1879,43,50-100,1922,4
STAT,1926,12,na,1938,4589.7960543602385
STAT,1902,16,30-34,1918,2.1300828075230496
SIM,1885,15,15-19,1900,6
STAT,1793,74,na,1867,444.3141427850651
STAT,1789,69,na,1858,603.8715730287325
STAT,1884,2,na,1886,2927.582748308929
SIM,1835,22,20-24,1857,71
STAT,1935,35,30-34,1970,2.411631715509202
SIM,1851,39,35-39,1890,11
STAT,1846,106,na,1952,0.008560771103720324
STAT,1954,17,40-44,1971,1.6334510247890026
STAT,1808,81,na,1889,224.087147546509
STAT,1911,37,35-39,1948,2.2064942665825784
SIM,1857,30,30-34,1887,17
STAT,1936,15,50-100,1951,0.3403695322612057
STAT,1904,41,30-34,1945,0.10865214835853333
STAT,1916,22,15-19,1938,5.269302742241558
STAT,1854,10,na,1864,2082.141987518376
SIM,1924,22,15-19,1946,6
SIM,1838,36,35-39,1874,13
SIM,1919,39,na,1958,3807
SIM,1912,20,30-34,1932,31
STAT,1951,20,15-19,1971,6.012572537152458
STAT,1901,15,30-34,1916,2.117344770251094
STAT,1877,19,30-34,1896,1.5541179246050507
STAT,1861,34,25-29,1895,7.966290850425596
STAT,1849,30,30-34,1879,14.878599030304478
STAT,1941,26,50-100,1967,0.9730719081070521
SIM,1844,40,na,1884,1756
STAT,1843,39,35-39,1882,5.3095103202501885
STAT,1800,72,na,1872,556.5584537062947
SIM,1855,34,40-44,1889,9
STAT,1844,43,na,1887,1640.5687893400839
STAT,1947,22,45-49,1969,1.2013921331236956
SIM,1923,13,na,1936,4295
STAT,1854,36,50-100,1890,0.8883456514347762
STAT,1898,26,40-44,1924,3.8439541210338297
SIM,1830,60,na,1890,1189
STAT,1820,46,50-100,1866,0.4109462209249555
STAT,1900,18,20-24,1918,23.1739523360811
SIM,1924,40,45-49,1964,2
SIM,1870,80,na,1950,506
STAT,1921,21,15-19,1942,5.6975623994316
STAT,1881,24,50-100,1905,0.3696350090655492
STAT,1813,90,na,1903,33.343838346139364
STAT,1901,48,30-34,1949,0.07129396995710506
SIM,1826,55,na,1881,1239
SIM,1824,32,50-100,1856,1
STAT,1899,25,45-49,1924,1.447165263320625
SIM,1924,29,35-39,1953,20
STAT,1878,45,25-29,1923,0.05721160987262616
STAT,1921,41,30-34,1962,0.13623937626534927
STAT,1853,88,na,1941,101.81058586253403
STAT,1875,20,30-34,1895,17.390645105720196
STAT,1904,20,30-34,1924,24.27648105622729
SIM,1905,18,15-19,1923,7
SIM,1834,33,na,1867,1635
SIM,1839,35,40-44,1874,5
SIM,1865,25,na,1890,2041
STAT,1939,25,20-24,1964,17.348935250238046
SIM,1913,21,30-34,1934,35
STAT,1915,41,40-44,1956,0.23821232497181724
SIM,1779,82,na,1861,127
SIM,1864,26,35-39,1890,8
STAT,1831,23,25-29,1854,115.4855120591612
STAT,1876,42,20-24,1918,0.1546925799604588
SIM,1860,44,30-34,1904,2
STAT,1942,30,15-19,1972,0.12945627493446685
SIM,1897,67,na,1964,2224
STAT,1836,25,na,1861,1793.282460856763
STAT,1888,35,40-44,1923,4.931734236389313
STAT,1896,8,na,1904,3245.6172072311942
STAT,1930,31,30-34,1961,19.220237710712546
STAT,1916,40,45-49,1956,0.16156248260607778
STAT,1922,39,na,1961,4035.818789942671
STAT,1892,19,50-100,1911,0.05764690961506016
STAT,1840,30,na,1870,1876.9068152939503
SIM,1923,41,40-44,1964,1
SIM,1838,34,40-44,1872,4
STAT,1898,63,na,1961,2414.9369622708105
SIM,1792,92,na,1884,3
SIM,1895,35,25-29,1930,4
SIM,1871,65,na,1936,1565
SIM,1905,28,na,1933,3230
STAT,1931,30,35-39,1961,11.32506060459252
SIM,1903,38,35-39,1941,8
STAT,1833,88,na,1921,83.34350061934275
STAT,1895,35,na,1930,2932.0320483535706
SIM,1885,65,na,1950,1597
SIM,1894,39,na,1933,2981
STAT,1946,25,35-39,1971,15.81333054945897
SIM,1839,33,45-49,1872,1
STAT,1827,27,50-100,1854,1.7201643446256505
STAT,1916,29,35-39,1945,14.559661985875138
SIM,1881,72,na,1953,1020
STAT,1933,27,15-19,1960,0.8855270003092616
STAT,1886,21,15-19,1907,3.302776919153718
STAT,1870,54,20-24,1924,6.642855032658965E-4
STAT,1938,16,45-49,1954,0.46660334651417157
SIM,1869,15,30-34,1884,1
STAT,1920,24,30-34,1944,29.99763842431833
SIM,1860,0,na,1860,3124
STAT,1918,19,25-29,1937,44.31911048592104
STAT,1878,18,35-39,1896,0.538215563201265
STAT,1881,46,45-49,1927,0.21587715881311947
SIM,1855,38,50-100,1893,1
STAT,1893,19,15-19,1912,7.075100713672789
STAT,1853,15,25-29,1868,5.115404188070367
STAT,1849,43,na,1892,1653.8861857807792
STAT,1929,29,15-19,1958,0.8338782032330018
STAT,1864,43,40-44,1907,1.8853692160611197
SIM,1872,43,40-44,1915,6
STAT,1944,27,25-29,1971,67.20280962425053
STAT,1833,99,na,1932,1.149747812806492
STAT,1807,48,50-100,1855,0.8947630365331647
STAT,1820,37,40-44,1857,9.992132146401117
STAT,1916,43,15-19,1959,0.001484297237650482
STAT,1899,48,30-34,1947,0.06980189409530857
STAT,1916,26,30-34,1942,38.402868017427835
STAT,1924,17,25-29,1941,48.7555637512705
SIM,1853,37,50-100,1890,1
SIM,1890,32,na,1922,2858
SIM,1908,39,30-34,1947,2
STAT,1839,19,50-100,1858,0.04223051451146467
SIM,1918,46,na,1964,3670
STAT,1877,29,40-44,1906,2.915613705000214
STAT,1855,91,na,1946,41.04077585073414
STAT,1897,21,25-29,1918,72.5433408455472
SIM,1932,17,25-29,1949,64
STAT,1936,36,30-34,1972,1.6915393571887343
SIM,1859,29,30-34,1888,29
STAT,1847,38,50-100,1885,0.9275933613152609
STAT,1839,23,30-34,1862,15.150625816663222
STAT,1874,40,35-39,1914,1.7660397672811725
STAT,1908,24,na,1932,3292.763032935187
SIM,1894,21,15-19,1915,4
SIM,1902,22,na,1924,3159
STAT,1761,97,na,1858,0.5617932793191653
STAT,1927,26,40-44,1953,5.3720603534580125
STAT,1912,18,45-49,1930,0.09515410867368693
SIM,1950,16,30-34,1966,16
STAT,1889,30,30-34,1919,20.526458532691695
SIM,1878,4,na,1882,2751
STAT,1845,37,50-100,1882,0.9086364998421188
SIM,1818,38,40-44,1856,3
SIM,1831,45,na,1876,1494
STAT,1856,26,35-39,1882,7.451329875537945
SIM,1882,22,35-39,1904,4
SIM,1929,32,45-49,1961,2
STAT,1821,43,50-100,1864,1.7107027411822995
STAT,1826,28,15-19,1854,1.382087364448604
STAT,1901,36,35-39,1937,2.0283560617155447
SIM,1924,26,30-34,1950,52
STAT,1942,16,30-34,1958,12.036054196883931
SIM,1888,50,na,1938,2391
SIM,1922,30,35-39,1952,12
SIM,1897,30,30-34,1927,26
STAT,1798,66,na,1864,765.9741254001002
STAT,1874,25,40-44,1899,2.911933790553386
STAT,1874,47,15-19,1921,3.8441174597632344E-4
SIM,1841,52,na,1893,1515
STAT,1901,18,35-39,1919,0.7236499979859523
SIM,1882,40,35-39,1922,4
SIM,1859,73,na,1932,968
STAT,1817,41,na,1858,1367.6845700201336
STAT,1851,49,40-44,1900,0.1229225156374487
STAT,1860,39,35-39,1899,5.375650285276697
STAT,1835,41,20-24,1876,0.12025959681084486
SIM,1869,34,50-100,1903,1
STAT,1865,21,50-100,1886,0.3568833356055314
STAT,1836,28,40-44,1864,2.4301674463265646
STAT,1777,109,na,1886,0.0029482704189933203
SIM,1847,42,35-39,1889,1
STAT,1851,25,na,1876,1884.371665233062
SIM,1901,69,na,1970,2231
SIM,1788,96,na,1884,3
SIM,1923,29,20-24,1952,23
STAT,1820,51,25-29,1871,0.005726848537011076
SIM,1871,73,na,1944,1049
SIM,1831,42,40-44,1873,3
SIM,1909,26,35-39,1935,13
STAT,1872,21,20-24,1893,65.5402617871313
SIM,1885,29,40-44,1914,2
SIM,1910,25,25-29,1935,65
STAT,1918,37,25-29,1955,0.9803786479643424
SIM,1864,20,25-29,1884,64
SIM,1875,24,na,1899,2278
STAT,1902,25,25-29,1927,56.77665688478653
STAT,1864,43,na,1907,1937.3080965942859
SIM,1880,21,20-24,1901,69
STAT,1953,16,40-44,1969,1.598907948615672
STAT,1864,40,na,1904,1971.0949848776188
STAT,1892,46,20-24,1938,0.00803050802986295
SIM,1878,21,30-34,1899,18
SIM,1912,21,na,1933,3338
STAT,1919,31,30-34,1950,16.123498386450343
SIM,1844,28,40-44,1872,2
STAT,1852,18,15-19,1870,5.421232574969618
SIM,1927,31,30-34,1958,22
STAT,1915,29,20-24,1944,17.461535116686225
SIM,1867,91,na,1958,58
SIM,1860,18,15-19,1878,7
STAT,1961,5,na,1966,4797.535123369097
SIM,1940,27,50-100,1967,2
STAT,1861,52,25-29,1913,0.0027638343847284767
STAT,1848,35,40-44,1883,3.3181025048310375
SIM,1921,35,45-49,1956,3
SIM,1836,23,20-24,1859,56
STAT,1877,61,na,1938,1831.8551767750994
SIM,1928,35,35-39,1963,5
STAT,1922,37,45-49,1959,0.7328589384089411
SIM,1938,21,35-39,1959,11
STAT,1874,50,na,1924,2108.826703198073
SIM,1926,19,25-29,1945,64
STAT,1806,89,na,1895,34.95640343416836
STAT,1909,45,30-34,1954,0.07810851725837857
SIM,1900,8,na,1908,3389
STAT,1909,18,40-44,1927,0.2583765785088329
STAT,1882,16,35-39,1898,0.5056397358602904
STAT,1920,35,50-100,1955,0.4350430306816194
STAT,1839,42,35-39,1881,1.2725467691006567
STAT,1798,107,na,1905,0.0013080256716843097
STAT,1856,20,25-29,1876,49.90624605301456
STAT,1816,49,20-24,1865,0.030602324901218173
STAT,1823,42,40-44,1865,2.914065318912877
STAT,1911,18,30-34,1929,2.297645331849843
SIM,1863,33,50-100,1896,3
SIM,1854,70,na,1924,1014
STAT,1857,21,25-29,1878,49.574113356479884
STAT,1894,16,25-29,1910,6.903236161181902
STAT,1883,46,50-100,1929,0.22803857308137215
STAT,1933,37,20-24,1970,0.3391995859425611
SIM,1817,41,na,1858,1480
STAT,1934,24,25-29,1958,117.18587043086671
SIM,1844,63,na,1907,1247
STAT,1848,17,40-44,1865,0.16334553714246647
STAT,1890,33,40-44,1923,4.987886624161642
SIM,1819,96,na,1915,3
STAT,1840,92,na,1932,29.005347651252933
STAT,1898,23,na,1921,3015.142189793299
SIM,1857,47,na,1904,1779
STAT,1861,31,20-24,1892,2.129152144300999
SIM,1858,32,na,1890,1910
STAT,1902,43,20-24,1945,0.014596154843078416
STAT,1817,46,30-34,1863,0.22003393560118034
SIM,1835,25,25-29,1860,42
SIM,1930,37,45-49,1967,3
STAT,1902,19,35-39,1921,0.727587638928145
SIM,1876,23,20-24,1899,58
STAT,1912,32,na,1944,3514.8735908999306
SIM,1765,90,na,1855,20
SIM,1868,37,50-100,1905,1
STAT,1871,76,na,1947,887.2846893286818
STAT,1836,18,30-34,1854,2.6140918272758893
SIM,1870,18,40-44,1888,1
SIM,1854,21,15-19,1875,2
SIM,1942,24,25-29,1966,86
SIM,1864,40,na,1904,2092
STAT,1913,16,40-44,1929,0.27076388636083215
STAT,1863,58,na,1921,1642.223811069794
SIM,1875,32,na,1907,2292
STAT,1862,18,40-44,1880,0.1678118311697659
STAT,1906,36,15-19,1942,0.016753274904930334
SIM,1879,31,25-29,1910,12
STAT,1945,26,50-100,1971,1.0320634558292432
SIM,1793,63,na,1856,771
SIM,1898,60,na,1958,2492
STAT,1847,37,45-49,1884,1.5218546894966098
STAT,1839,73,na,1912,791.960339720257
STAT,1881,83,na,1964,590.2986384862671
STAT,1874,47,50-100,1921,0.23602901030344162
SIM,1891,31,50-100,1922,1
STAT,1846,31,20-24,1877,2.2757505932587843
STAT,1910,34,15-19,1944,0.11601661219809506
STAT,1891,50,na,1941,2553.964054722015
SIM,1848,25,na,1873,1925
STAT,1863,52,50-100,1915,0.01247476334118995
STAT,1855,33,50-100,1888,0.6539078520449946
STAT,1952,19,30-34,1971,13.790116519005414
SIM,1837,20,30-34,1857,22
STAT,1904,65,na,1969,2588.1027242374926
STAT,1889,9,na,1898,3026.0479416258995
SIM,1909,36,40-44,1945,1
STAT,1882,68,na,1950,1404.7957023683189
STAT,1881,43,na,1924,2092.954382295453
STAT,1874,20,50-100,1894,0.3960837422820973
STAT,1923,24,na,1947,3989.245958359986
SIM,1849,21,40-44,1870,4
STAT,1901,15,50-100,1916,0.06508230552581583
SIM,1904,32,40-44,1936,2
STAT,1922,40,40-44,1962,0.27198679933379766
STAT,1907,47,20-24,1954,0.009347978980725948
STAT,1927,16,50-100,1943,0.44120526195583065
SIM,1902,34,30-34,1936,15
STAT,1916,21,50-100,1937,0.653301833929296
SIM,1951,17,30-34,1968,16
STAT,1823,89,na,1912,55.283165401654664
STAT,1921,46,na,1967,3922.531282554823
SIM,1889,24,na,1913,2746
SIM,1882,47,50-100,1929,2
STAT,1884,37,30-34,1921,4.975372549387576
STAT,1868,23,20-24,1891,61.965420183314244
STAT,1810,44,20-24,1854,0.5873490165158948
STAT,1936,32,15-19,1968,0.11789398083952916
SIM,1930,40,40-44,1970,3
STAT,1916,44,30-34,1960,0.12335149273754598
SIM,1806,78,na,1884,291
SIM,1859,17,na,1876,2238
STAT,1930,31,35-39,1961,11.148211141397578
STAT,1897,67,na,1964,2213.062309840928
SIM,1854,31,20-24,1885,5
SIM,1915,22,50-100,1937,1
SIM,1892,37,30-34,1929,5
STAT,1906,21,45-49,1927,0.9621379080865078
STAT,1839,84,na,1923,221.81053683179732
STAT,1879,40,15-19,1919,0.013773863662141903
SIM,1816,45,na,1861,1341
STAT,1933,1,na,1934,5281.158316395653
STAT,1945,21,30-34,1966,29.767602150165214
STAT,1828,81,na,1909,306.9793021677387
STAT,1943,17,30-34,1960,12.20997003402937
STAT,1840,45,45-49,1885,0.1700398984837869
SIM,1921,16,40-44,1937,2
STAT,1861,21,45-49,1882,0.5660520311886944
SIM,1914,21,45-49,1935,1
SIM,1844,18,30-34,1862,1
STAT,1917,36,25-29,1953,0.9707275558903854
SIM,1807,71,na,1878,534
SIM,1911,36,na,1947,3486
STAT,1939,28,25-29,1967,62.472604129666955
STAT,1907,37,50-100,1944,0.3676752828420187
STAT,1894,26,50-100,1920,0.7800348718284038
STAT,1950,7,na,1957,4390.8937691074025
SIM,1883,20,30-34,1903,18
SIM,1842,42,50-100,1884,3
SIM,1853,20,15-19,1873,3
STAT,1885,27,50-100,1912,0.6020652728334146
STAT,1921,44,35-39,1965,0.21356528632065291
SIM,1935,26,40-44,1961,6
STAT,1907,37,15-19,1944,0.016816751028866758
SIM,1873,48,50-100,1921,2
STAT,1834,42,50-100,1876,0.7883468142664306
SIM,1847,23,30-34,1870,20
SIM,1925,36,25-29,1961,1
STAT,1876,45,25-29,1921,0.05673474820928637
STAT,1971,1,na,1972,4710.741911942131
SIM,1922,28,na,1950,3991
STAT,1887,22,15-19,1909,3.4854074161886643
STAT,1928,16,na,1944,4392.551667290586
STAT,1810,71,na,1881,657.4057409368298
STAT,1855,43,30-34,1898,0.8083554722427629
STAT,1932,26,15-19,1958,0.8739241448769669
STAT,1898,22,25-29,1920,73.2072299904103
SIM,1851,36,30-34,1887,5
STAT,1917,27,30-34,1944,38.81716993528335
SIM,1895,24,na,1919,2932
STAT,1920,42,30-34,1962,0.13339511945271487
SIM,1878,83,na,1961,579
STAT,1904,41,35-39,1945,0.1711352909057263
STAT,1775,103,na,1878,0.04707080426497864
STAT,1843,36,30-34,1879,4.535611280498306
SIM,1884,9,na,1893,2545
STAT,1939,19,na,1958,3477.858728132334
SIM,1876,26,25-29,1902,38
STAT,1842,39,20-24,1881,0.573939430506968
STAT,1908,34,25-29,1942,8.169341604739078
STAT,1800,64,na,1864,841.3925772909829
STAT,1929,39,20-24,1968,0.3190513924115769
SIM,1862,14,na,1876,2365
STAT,1844,51,na,1895,1518.775647995814
STAT,1939,31,50-100,1970,0.7973092481615957
STAT,1833,46,15-19,1879,2.887817473926656E-4
STAT,1946,22,30-34,1968,30.215314301006266
STAT,1845,36,na,1881,1761.827835590883
STAT,1904,23,35-39,1927,7.881613592438455
SIM,1848,20,40-44,1868,1
STAT,1874,50,45-49,1924,0.014213554462773885
SIM,1851,22,na,1873,1901
STAT,1845,20,15-19,1865,2.926688095853634
STAT,1809,54,25-29,1863,0.011795723673678649
STAT,1846,21,15-19,1867,2.8907813865467906
STAT,1940,18,20-24,1958,129.98707144743983
STAT,1843,107,na,1950,0.003402350247143948
SIM,1929,38,na,1967,4658
STAT,1854,53,25-29,1907,0.002509630684484832
STAT,1941,19,20-24,1960,131.822866221394
SIM,1839,31,25-29,1870,15
STAT,1905,24,35-39,1929,7.916466594075472
STAT,1886,75,na,1961,1208.4492494395693
STAT,1870,91,na,1961,104.73003804974375
STAT,1810,48,40-44,1858,0.5985108703300961
STAT,1865,32,35-39,1897,8.693527503415151
SIM,1805,93,na,1898,6
SIM,1916,34,25-29,1950,15
STAT,1927,40,20-24,1967,0.020984142455932307
SIM,1934,29,30-34,1963,63
STAT,1901,32,15-19,1933,0.18830380928157395
STAT,1815,63,na,1878,918.8153871453027
SIM,1885,19,30-34,1904,3
STAT,1887,32,20-24,1919,2.8557721650234287
STAT,1926,29,30-34,1955,44.060960267551536
STAT,1927,16,35-39,1943,4.941499849447586
SIM,1895,32,20-24,1927,2
STAT,1866,33,35-39,1899,8.783340671032533
SIM,1838,30,25-29,1868,12
STAT,1883,31,50-100,1914,0.8517884024300048
SIM,1844,38,50-100,1882,4
SIM,1813,71,na,1884,597
STAT,1843,54,30-34,1897,0.0041764030112658975
SIM,1919,25,45-49,1944,1
SIM,1913,24,35-39,1937,12
STAT,1967,3,na,1970,4640.9492905839315
SIM,1935,16,35-39,1951,5
SIM,1853,77,na,1930,642
STAT,1867,30,45-49,1897,1.559204290739887
STAT,1862,93,na,1955,23.550927888455586
STAT,1826,29,25-29,1855,79.7227789981272
SIM,1848,43,35-39,1891,5
SIM,1944,16,40-44,1960,1
SIM,1848,41,40-44,1889,4
STAT,1853,54,20-24,1907,5.321978705565032E-4
STAT,1813,52,25-29,1865,0.010225916110056297
SIM,1851,76,na,1927,643
SIM,1877,81,na,1958,549
STAT,1834,100,na,1934,0.6571119750960484
STAT,1948,15,20-24,1963,146.66135445517887
SIM,1860,26,30-34,1886,22
SIM,1839,42,na,1881,1670
STAT,1944,24,20-24,1968,113.33818491626133
STAT,1835,29,35-39,1864,7.733956001473952
SIM,1876,35,25-29,1911,4
SIM,1896,38,45-49,1934,1
STAT,1843,28,15-19,1871,0.39994092468888176
SIM,1860,9,na,1869,2369
STAT,1831,52,45-49,1883,0.009386393397921201
STAT,1927,25,30-34,1952,45.31055682950688
SIM,1804,74,na,1878,403
STAT,1836,38,50-100,1874,0.9418119374563337
SIM,1893,32,20-24,1925,3
STAT,1878,19,45-49,1897,0.0638970679712091
STAT,1815,40,25-29,1855,1.9894854206274357
STAT,1845,23,20-24,1868,59.82744845379432
STAT,1846,55,na,1901,1457.887883399686
STAT,1911,15,25-29,1926,8.228394682327915
STAT,1852,26,30-34,1878,22.445582817524443
STAT,1857,47,15-19,1904,2.9651123438350355E-4
STAT,1816,59,na,1875,1118.9564650511904
STAT,1792,104,na,1896,0.011232349908190022
STAT,1868,35,25-29,1903,2.6216334649625193
STAT,1888,38,45-49,1926,2.213716641158569
STAT,1820,48,30-34,1868,0.15728417242333156
STAT,1831,36,40-44,1867,3.4976727703737835
STAT,1877,47,na,1924,2195.27468839996
SIM,1884,20,45-49,1904,1
SIM,1800,84,na,1884,83
STAT,1882,31,25-29,1913,9.453992499463467
SIM,1904,28,50-100,1932,4
STAT,1942,27,20-24,1969,18.098007829766964
STAT,1871,54,40-44,1925,0.009588468673413852
SIM,1834,29,25-29,1863,29
STAT,1865,107,na,1972,0.07356458405385362
STAT,1843,35,20-24,1878,0.6628600817172285
STAT,1859,42,20-24,1901,0.11958563183111133
STAT,1902,24,15-19,1926,4.370554993232759
SIM,1830,29,na,1859,1755
SIM,1890,31,25-29,1921,11
STAT,1931,27,45-49,1958,2.1071127323782686
STAT,1939,30,na,1969,3649.1884073948254
SIM,1882,32,45-49,1914,1
STAT,1833,24,40-44,1857,1.7014413226054834
STAT,1850,36,50-100,1886,0.8871855822920609
STAT,1916,37,20-24,1953,0.2550127468998211
SIM,1939,18,25-29,1957,49
SIM,1851,26,20-24,1877,12
SIM,1884,69,na,1953,1363
SIM,1797,87,na,1884,63
SIM,1935,25,30-34,1960,64
SIM,1864,36,45-49,1900,1
STAT,1942,28,na,1970,3712.3692451205147
STAT,1801,71,na,1872,629.9072998007039
STAT,1843,26,20-24,1869,10.491445844292587
STAT,1900,36,15-19,1936,0.015961414671996795
STAT,1850,48,50-100,1898,0.17073043702490506
STAT,1835,91,na,1926,36.155368079837075
SIM,1837,49,50-100,1886,2
SIM,1895,22,15-19,1917,3
SIM,1956,15,20-24,1971,146
STAT,1820,64,na,1884,934.8706966817963
STAT,1851,20,40-44,1871,1.8513286642257725
SIM,1857,67,na,1924,1271
SIM,1857,34,45-49,1891,1
SIM,1918,28,35-39,1946,17
STAT,1874,32,45-49,1906,1.683715311833069
SIM,1843,29,35-39,1872,8
SIM,1909,19,25-29,1928,8
STAT,1837,17,35-39,1854,0.6029460339486612
SIM,1791,82,na,1873,142
SIM,1922,18,15-19,1940,44
STAT,1915,26,na,1941,3621.7151491727304
STAT,1834,23,45-49,1857,0.5731300061427831
SIM,1881,33,40-44,1914,4
SIM,1837,37,50-100,1874,1
STAT,1839,30,50-100,1869,0.7675926929239775
SIM,1836,85,na,1921,158
STAT,1816,47,50-100,1863,0.6466645406387597
STAT,1937,15,45-49,1952,0.46116293595056224
STAT,1927,31,na,1958,4398.106617044356
SIM,1905,50,na,1955,2947
SIM,1799,88,na,1887,36
SIM,1860,43,50-100,1903,1
SIM,1886,38,50-100,1924,1
SIM,1880,28,40-44,1908,4
STAT,1876,54,50-100,1930,0.014323999149711282
SIM,1907,51,na,1958,3059
STAT,1914,18,15-19,1932,8.843871567368156
SIM,1872,33,30-34,1905,26
SIM,1909,32,na,1941,3394
STAT,1893,29,25-29,1922,50.340775542532654
SIM,1879,17,na,1896,2501
SIM,1938,19,20-24,1957,128
STAT,1857,40,30-34,1897,0.8648558405846684
STAT,1872,37,40-44,1909,4.150758259091243
SIM,1882,25,40-44,1907,4
STAT,1770,104,na,1874,0.023384446311380556
STAT,1833,31,45-49,1864,1.3820384516783095
STAT,1851,22,35-39,1873,5.110263266500561
STAT,1861,19,35-39,1880,0.48894092461599403
STAT,1796,85,na,1881,95.49220685748759
STAT,1841,46,na,1887,1566.2386848537653
SIM,1941,24,45-49,1965,1
STAT,1826,38,25-29,1864,3.0327880892815
STAT,1864,29,na,1893,2000.5659110067363
STAT,1801,53,45-49,1854,0.05132644818453333
STAT,1861,24,15-19,1885,2.620717946655025
STAT,1933,24,45-49,1957,1.4089951852519795
SIM,1839,18,20-24,1857,14
STAT,1950,21,40-44,1971,3.769740784692368
SIM,1942,20,45-49,1962,4
STAT,1847,46,45-49,1893,0.17413914701213548
SIM,1834,38,25-29,1872,2
STAT,1914,49,20-24,1963,0.010291387307144073
SIM,1855,37,45-49,1892,1
STAT,1943,26,25-29,1969,66.24933824830364
SIM,1783,87,na,1870,46
STAT,1898,41,30-34,1939,0.10255751656441874
STAT,1945,23,25-29,1968,95.60481843944586
SIM,1820,84,na,1904,132
SIM,1889,42,40-44,1931,7
SIM,1835,34,25-29,1869,13
SIM,1917,36,35-39,1953,10
STAT,1872,28,40-44,1900,2.8304023867881694
STAT,1862,6,na,1868,2302.480957604168
STAT,1879,47,35-39,1926,0.13759600730311058
STAT,1833,82,na,1915,283.25754732306495
STAT,1905,37,45-49,1942,0.587394422020752
STAT,1919,19,45-49,1938,0.5187057636538425
STAT,1936,16,40-44,1952,1.2679430746073157
STAT,1884,27,20-24,1911,10.951775750789277
SIM,1853,23,20-24,1876,60
SIM,1852,31,20-24,1883,1
SIM,1872,9,na,1881,2485
STAT,1920,15,35-39,1935,0.8964801772200653
SIM,1893,0,na,1893,3381
SIM,1874,30,30-34,1904,26
STAT,1880,43,25-29,1923,0.6336921198514047
SIM,1793,97,na,1890,1
STAT,1845,16,50-100,1861,0.043874742111541236
STAT,1813,110,na,1923,1.1687095670848388E-4
STAT,1910,41,25-29,1951,0.06410357811343399
SIM,1826,75,na,1901,524
STAT,1898,0,na,1898,3755.066202390883
SIM,1841,31,45-49,1872,1
SIM,1942,28,40-44,1970,4
STAT,1865,50,35-39,1915,0.007496605578526816
STAT,1934,28,40-44,1962,5.9204854257451895
SIM,1844,49,na,1893,1562
SIM,1888,53,na,1941,2312
STAT,1866,83,na,1949,345.77131963103034
SIM,1919,24,35-39,1943,15
STAT,1842,52,20-24,1894,5.226842730141621E-4
SIM,1900,20,40-44,1920,2
STAT,1862,47,25-29,1909,0.04619986374227033
SIM,1880,37,40-44,1917,5
STAT,1812,53,20-24,1865,0.002276202695519128
STAT,1892,46,25-29,1938,0.03854643674525793
STAT,1894,25,25-29,1919,51.75429586863186
STAT,1899,70,na,1969,2149.791459965522
SIM,1932,38,25-29,1970,1
STAT,1934,35,15-19,1969,0.02507722079230633
STAT,1874,19,na,1893,2425.4748982829624
STAT,1825,30,40-44,1855,9.584219963744454
STAT,1902,17,40-44,1919,0.24383687418791183
SIM,1894,24,20-24,1918,95
STAT,1813,82,na,1895,197.33050784969004
STAT,1833,37,na,1870,1625.3692938092745
SIM,1799,82,na,1881,140
STAT,1871,38,35-39,1909,6.591242762077238
STAT,1943,21,50-100,1964,0.6615347193591858
SIM,1915,31,40-44,1946,6
STAT,1868,23,50-100,1891,0.36668102698767197
STAT,1917,35,15-19,1952,0.019020888884794623
SIM,1802,93,na,1895,5
STAT,1839,45,40-44,1884,0.11932415404491621
STAT,1825,32,35-39,1857,17.78935388116419
STAT,1926,33,30-34,1959,17.988012533952467
STAT,1861,30,50-100,1891,0.7245508526635425
STAT,1934,20,45-49,1954,1.4331089668472996
SIM,1837,61,na,1898,1173
STAT,1809,77,na,1886,373.01373321158854
STAT,1837,72,na,1909,797.212141280036
SIM,1877,24,20-24,1901,58
SIM,1827,33,20-24,1860,4
STAT,1875,66,na,1941,1590.7216650641988
STAT,1889,43,45-49,1932,1.732880514444189
STAT,1947,2,na,1949,4288.891681345081
STAT,1876,42,50-100,1918,1.0290419253380798
SIM,1891,46,50-100,1937,3
SIM,1919,2,na,1921,4244
SIM,1934,33,30-34,1967,28
SIM,1806,55,na,1861,1095
STAT,1892,21,40-44,1913,2.4726025317497005
STAT,1850,24,50-100,1874,0.33964462124602096
STAT,1910,19,25-29,1929,8.065939114990165
SIM,1860,59,na,1919,1608
STAT,1867,39,25-29,1906,2.52814592626486
SIM,1837,22,25-29,1859,54
STAT,1844,74,na,1918,779.0817671788532
STAT,1890,23,30-34,1913,20.51009556059238
SIM,1965,6,na,1971,4560
SIM,1926,34,20-24,1960,2
STAT,1892,23,35-39,1915,6.8820809818782305
SIM,1864,37,50-100,1901,1
SIM,1874,39,na,1913,2228
STAT,1810,44,25-29,1854,2.3749329494811793
STAT,1844,34,25-29,1878,8.421792046519478
STAT,1902,53,na,1955,2824.480113716019
SIM,1942,2,na,1944,3835
SIM,1877,48,50-100,1925,2
SIM,1833,30,40-44,1863,4
SIM,1861,52,na,1913,1843
STAT,1865,39,20-24,1904,0.6550712147439813
STAT,1928,23,25-29,1951,108.6235976107959
STAT,1907,31,40-44,1938,3.469110290327871
STAT,1920,48,35-39,1968,0.13427058342210713
STAT,1849,49,15-19,1898,2.822962689027331E-4
SIM,1936,24,35-39,1960,6
STAT,1835,110,na,1945,1.7241555940033626E-4
STAT,1851,49,50-100,1900,0.17634211342587308
SIM,1875,39,25-29,1914,5
STAT,1849,34,45-49,1883,1.2972689999133264
STAT,1879,54,40-44,1933,0.010109473892212744
SIM,1852,24,15-19,1876,2
STAT,1924,31,40-44,1955,4.315999032636092
SIM,1856,35,40-44,1891,4
SIM,1944,27,50-100,1971,5
SIM,1949,15,na,1964,4026
STAT,1879,28,na,1907,2348.234625337974
STAT,1903,22,50-100,1925,0.5480837890999675
STAT,1768,110,na,1878,0.0011552691736565748
SIM,1863,37,40-44,1900,5
STAT,1818,109,na,1927,3.430114856464949E-4
SIM,1898,17,15-19,1915,9
STAT,1816,109,na,1925,3.315378282182755E-4
SIM,1883,21,40-44,1904,2
STAT,1851,22,na,1873,1872.4073626013221
STAT,1821,47,35-39,1868,0.2137815339472137
STAT,1854,5,na,1859,2166.0447856000505
SIM,1889,44,35-39,1933,1
STAT,1886,24,20-24,1910,68.35262959339258
SIM,1886,15,30-34,1901,2
STAT,1948,13,na,1961,4246.375193200888
STAT,1824,74,na,1898,585.8992093498445
SIM,1836,99,na,1935,2
SIM,1861,24,25-29,1885,51
SIM,1936,23,25-29,1959,84
STAT,1928,24,35-39,1952,11.037616887041855
SIM,1837,23,35-39,1860,6
STAT,1915,20,na,1935,3596.999315411307
SIM,1821,38,45-49,1859,1
STAT,1864,74,na,1938,937.0064383430515
STAT,1844,24,15-19,1868,2.8502340321555666
STAT,1865,36,50-100,1901,1.0590221493729872
STAT,1872,53,45-49,1925,0.01353976158250974
STAT,1911,16,na,1927,3659.3212774512995
SIM,1932,31,40-44,1963,4
STAT,1861,46,na,1907,1769.9585901731773
SIM,1836,24,30-34,1860,14
STAT,1953,15,30-34,1968,13.936824345716676
STAT,1870,24,25-29,1894,52.65878637882997
SIM,1902,25,35-39,1927,18
SIM,1837,47,na,1884,1512
STAT,1834,21,50-100,1855,0.3400290468523929
STAT,1838,46,35-39,1884,0.09950164913993012
STAT,1855,53,45-49,1908,0.010113197626766162
STAT,1895,15,30-34,1910,1.9740512257394265
STAT,1827,53,50-100,1880,0.012522734354767605
STAT,1853,24,25-29,1877,49.44321971758685
SIM,1919,28,50-100,1947,4
STAT,1918,34,20-24,1952,2.4275740873642087
STAT,1808,51,50-100,1859,0.056042236341324714
STAT,1904,68,na,1972,2442.261600287561
STAT,1880,29,45-49,1909,1.0957516340805276
STAT,1908,38,40-44,1946,1.3171919285556315
STAT,1871,16,25-29,1887,5.37306019577671
STAT,1908,30,45-49,1938,1.4141324577977334
SIM,1906,41,40-44,1947,2
SIM,1916,38,40-44,1954,6
SIM,1955,15,na,1970,4273
SIM,1892,44,na,1936,2755
STAT,1840,50,30-34,1890,0.004205026849897957
STAT,1943,25,15-19,1968,0.710853722183128
STAT,1885,32,20-24,1917,2.544063098305777
STAT,1923,32,35-39,1955,9.89771327050864
SIM,1861,15,25-29,1876,4
SIM,1901,19,25-29,1920,10
STAT,1919,33,25-29,1952,9.380471724738763
SIM,1871,96,na,1967,29
STAT,1891,40,35-39,1931,2.138762028625287
SIM,1882,68,na,1950,1366
SIM,1931,32,35-39,1963,19
STAT,1885,25,15-19,1910,0.4299124791475777
SIM,1901,26,30-34,1927,39
STAT,1794,84,na,1878,104.32400128065801
SIM,1847,8,na,1855,2175
STAT,1818,41,20-24,1859,0.3962628699619362
SIM,1868,34,20-24,1902,2
SIM,1828,32,25-29,1860,12
SIM,1780,90,na,1870,20
SIM,1912,38,na,1950,3300
STAT,1899,47,20-24,1946,0.008722383411722852
SIM,1787,77,na,1864,306
SIM,1898,35,45-49,1933,2
SIM,1939,15,20-24,1954,120
STAT,1850,24,40-44,1874,1.7355838882968548
SIM,1776,85,na,1861,82
SIM,1901,66,na,1967,2387
STAT,1903,48,35-39,1951,0.10480686104872813
SIM,1817,39,35-39,1856,13
STAT,1889,36,40-44,1925,5.129931352745429
SIM,1911,20,15-19,1931,7
STAT,1810,54,na,1864,1181.5905142418976
STAT,1870,20,50-100,1890,0.37973139611364665
STAT,1868,29,30-34,1897,22.551157623008848
STAT,1849,16,15-19,1865,5.296545156049029
STAT,1823,32,30-34,1855,46.61732910524194
STAT,1925,36,na,1961,4270.1522535000595
STAT,1862,48,35-39,1910,0.11139974340507475
STAT,1892,38,na,1930,2773.312781304439
STAT,1895,66,na,1961,2162.7915096390193
STAT,1847,17,na,1864,2107.9890659202783
STAT,1861,49,30-34,1910,0.07435182701475139
SIM,1878,23,25-29,1901,61
STAT,1774,84,na,1858,94.80482376806535
STAT,1835,34,15-19,1869,0.110796230084503
STAT,1858,39,15-19,1897,0.04122673870335892
SIM,1857,16,15-19,1873,5
SIM,1831,32,30-34,1863,17
STAT,1911,36,na,1947,3448.572733523322
SIM,1811,56,na,1867,1125
SIM,1833,32,35-39,1865,9
SIM,1815,48,50-100,1863,3
STAT,1899,38,20-24,1937,0.21433065314825636
SIM,1927,33,25-29,1960,15
STAT,1838,53,40-44,1891,0.007064979192462939
SIM,1874,31,40-44,1905,12
STAT,1856,22,50-100,1878,0.3504215008192136
STAT,1903,20,15-19,1923,4.460453096683392
SIM,1862,68,na,1930,1306
STAT,1869,28,35-39,1897,8.792277047400205
STAT,1824,54,na,1878,1218.7323856170499
STAT,1888,7,na,1895,2907.603956692425
STAT,1948,17,15-19,1965,49.06825049600872
SIM,1897,36,40-44,1933,6
SIM,1893,35,25-29,1928,2
STAT,1831,56,na,1887,1257.805991946336
STAT,1895,32,na,1927,2941.8437561659225
STAT,1905,28,15-19,1933,0.6171942835653138
STAT,1831,39,45-49,1870,1.537782188001188
SIM,1911,23,20-24,1934,86
STAT,1881,43,45-49,1924,1.355289776674007
STAT,1916,45,50-100,1961,0.22018176092400837
STAT,1837,18,45-49,1855,0.05747428931234266
STAT,1856,41,25-29,1897,0.4772779716886029
SIM,1933,30,45-49,1963,2
STAT,1952,16,25-29,1968,49.07499204319477
STAT,1839,15,45-49,1854,0.057653720621592686
STAT,1849,97,na,1946,3.8722629684485392
SIM,1820,39,na,1859,1471
SIM,1859,38,50-100,1897,1
SIM,1860,25,20-24,1885,16
STAT,1824,38,20-24,1862,1.101874661421412
STAT,1888,44,40-44,1932,2.476331494254774
STAT,1929,16,35-39,1945,5.071698613626056
SIM,1909,16,20-24,1925,28
STAT,1848,42,45-49,1890,1.0768873463439848
STAT,1843,29,25-29,1872,37.021167316499756
STAT,1893,17,20-24,1910,21.249701670679666
STAT,1891,29,20-24,1920,13.619622174021403
STAT,1851,56,na,1907,1495.697148699597
STAT,1860,35,20-24,1895,0.5974473399159773
STAT,1889,19,20-24,1908,20.565407163004725
SIM,1855,80,na,1935,445
SIM,1872,36,35-39,1908,6
SIM,1896,44,40-44,1940,2
SIM,1937,16,35-39,1953,5
STAT,1894,19,30-34,1913,1.9265152344862322
SIM,1851,29,25-29,1880,40
SIM,1819,42,na,1861,1435
STAT,1953,18,35-39,1971,4.793845963767985
STAT,1863,43,25-29,1906,0.5294038016975882
STAT,1879,44,30-34,1923,1.119895966929751
STAT,1842,93,na,1935,20.811770654487354
STAT,1887,37,na,1924,2489.081687790611
SIM,1820,39,40-44,1859,5
STAT,1839,22,na,1861,1831.783409087525
SIM,1874,33,35-39,1907,7
SIM,1887,44,30-34,1931,1
SIM,1853,26,25-29,1879,51
SIM,1908,13,na,1921,3547
STAT,1866,55,na,1921,1800.955842944611
STAT,1885,35,25-29,1920,2.735576644321506
SIM,1901,29,35-39,1930,16
SIM,1935,15,na,1950,4759
STAT,1903,15,35-39,1918,0.7409096805728458
SIM,1900,27,25-29,1927,63
STAT,1847,31,na,1878,1891.853341500968
STAT,1911,25,35-39,1936,13.922402862633563
STAT,1897,37,45-49,1934,2.5186017369021476
STAT,1925,30,45-49,1955,1.7674829608135902
SIM,1811,76,na,1887,340
SIM,1897,19,20-24,1916,21
STAT,1881,51,30-34,1932,0.00545556065904535
STAT,1908,37,30-34,1945,1.6116654376467379
STAT,1818,44,25-29,1862,1.4261546468452149
STAT,1901,26,20-24,1927,15.565579275516436
SIM,1876,29,30-34,1905,31
STAT,1845,26,25-29,1871,36.52973569980055
STAT,1870,39,30-34,1909,4.883774803848905
SIM,1880,4,na,1884,2760
STAT,1848,18,20-24,1866,15.739593417689916
STAT,1883,22,45-49,1905,0.645627110346053
SIM,1941,21,40-44,1962,4
STAT,1898,44,35-39,1942,0.15863756101833035
STAT,1935,34,20-24,1969,3.1836543860039423
SIM,1914,32,35-39,1946,12
SIM,1918,43,na,1961,3684
SIM,1854,38,40-44,1892,3
SIM,1918,23,na,1941,3668
STAT,1876,7,na,1883,2626.6741562259085
SIM,1920,39,45-49,1959,1
SIM,1835,38,na,1873,1640
STAT,1803,52,na,1855,1123.357803267478
STAT,1868,103,na,1971,1.3740843789009625
SIM,1916,37,30-34,1953,3
SIM,1916,42,na,1958,3521
STAT,1926,26,25-29,1952,74.8037525456491
SIM,1849,9,na,1858,2176
STAT,1825,52,20-24,1877,7.458582713165689E-4
STAT,1921,20,50-100,1941,0.7063419001051088
STAT,1934,0,na,1934,5756.50621951976
STAT,1908,45,15-19,1953,3.192705443022264E-4
STAT,1912,39,45-49,1951,0.6220977841934437
SIM,1893,20,na,1913,2969
STAT,1916,33,50-100,1949,0.8029652598417016
SIM,1839,20,35-39,1859,4
STAT,1893,26,20-24,1919,14.10976078479498
STAT,1918,31,15-19,1949,0.1295256712019404
STAT,1910,47,50-100,1957,0.19929595037290945
SIM,1875,37,30-34,1912,5
STAT,1858,37,20-24,1895,0.5716843634671106
SIM,1824,31,45-49,1855,2
STAT,1838,43,30-34,1881,0.8238537665033747
STAT,1832,32,40-44,1864,3.432927779180314
SIM,1900,23,45-49,1923,5
STAT,1805,49,45-49,1854,0.6984981141262184
STAT,1892,43,20-24,1935,0.18651971379256585
SIM,1918,25,30-34,1943,44
STAT,1763,98,na,1861,0.19333265258268514
STAT,1822,42,25-29,1864,0.9684877544528337
SIM,1943,10,na,1953,3867
SIM,1846,43,30-34,1889,3
SIM,1914,33,na,1947,3834
STAT,1918,35,30-34,1953,1.8319783032873114
STAT,1903,23,20-24,1926,92.33447183432588
STAT,1842,73,na,1915,845.8136162214124
SIM,1883,28,25-29,1911,36
SIM,1848,40,30-34,1888,4
SIM,1856,18,20-24,1874,8
STAT,1826,35,20-24,1861,0.8843869981843883
STAT,1819,36,25-29,1855,8.383945661594854
SIM,1877,25,30-34,1902,28
SIM,1840,32,40-44,1872,3
SIM,1826,54,50-100,1880,1
SIM,1917,33,30-34,1950,14
STAT,1814,52,45-49,1866,0.03765809360043192
STAT,1948,18,25-29,1966,46.83883977600225
SIM,1929,32,na,1961,4627
STAT,1855,46,na,1901,1597.9440277363808
STAT,1857,92,na,1949,31.018433280129234
STAT,1898,48,15-19,1946,2.849201263873752E-4
SIM,1840,47,50-100,1887,2
STAT,1909,44,50-100,1953,0.10250420990978831
SIM,1871,7,na,1878,2622
STAT,1846,47,40-44,1893,0.12014565566878022
STAT,1878,32,15-19,1910,0.1400511864126245
STAT,1817,39,25-29,1856,8.39711272399096
SIM,1825,39,25-29,1864,5
STAT,1868,64,na,1932,1567.9593644130414
STAT,1876,20,45-49,1896,0.6841242928892324
STAT,1887,49,50-100,1936,0.1433098100946425
SIM,1834,26,20-24,1860,15
STAT,1941,31,40-44,1972,3.883390496239516
STAT,1842,54,45-49,1896,0.010050281499110792
SIM,1861,18,30-34,1879,4
SIM,1901,12,na,1913,3487
SIM,1888,20,15-19,1908,7
STAT,1863,8,na,1871,2326.9225793327664
SIM,1867,100,na,1967,6
STAT,1834,45,20-24,1879,0.008881233465418643
STAT,1817,48,25-29,1865,0.1268520835140034
STAT,1844,31,20-24,1875,2.2928644690714584
STAT,1848,50,30-34,1898,0.004349982228037455
STAT,1882,14,na,1896,2366.2862449951485
SIM,1948,23,15-19,1971,5
STAT,1846,38,40-44,1884,3.189832848564091
STAT,1846,22,50-100,1868,0.3547621639799391
STAT,1931,18,15-19,1949,55.97115839577886
STAT,1933,21,40-44,1954,4.226091073460654
STAT,1878,16,40-44,1894,0.18031825420705802
STAT,1924,38,25-29,1962,1.0958132959000655
SIM,1909,38,35-39,1947,7
SIM,1936,21,30-34,1957,26
STAT,1822,73,na,1895,613.5133768020692
STAT,1887,39,40-44,1926,4.578269780625947
STAT,1932,15,50-100,1947,0.4708500490813089
STAT,1853,18,30-34,1871,1.4135254288697683
STAT,1892,20,30-34,1912,21.19777969631458
SIM,1831,35,35-39,1866,11
SIM,1909,18,na,1927,3543
SIM,1871,21,15-19,1892,3
STAT,1907,34,45-49,1941,1.3773801671875812
SIM,1922,42,na,1964,4042
STAT,1830,53,40-44,1883,0.006653366063954417
SIM,1827,36,25-29,1863,1
STAT,1811,81,na,1892,234.2316843759338
STAT,1779,93,na,1872,6.524581550604219
STAT,1863,22,25-29,1885,48.48490522560709
STAT,1876,19,50-100,1895,0.04752336200723746
SIM,1899,31,45-49,1930,3
STAT,1867,36,20-24,1903,0.6870342283655648
STAT,1886,27,25-29,1913,42.2220698276945
STAT,1930,34,35-39,1964,11.12737695593569
SIM,1817,92,na,1909,15
SIM,1812,44,30-34,1856,3
SIM,1878,30,50-100,1908,4
SIM,1802,65,na,1867,825
STAT,1926,36,35-39,1962,2.795408078686428
SIM,1820,50,na,1870,1274
STAT,1867,37,30-34,1904,4.727338061086585
STAT,1951,20,45-49,1971,1.270889966676695
SIM,1885,16,25-29,1901,6
STAT,1839,48,45-49,1887,0.15828670122534572
STAT,1866,31,40-44,1897,3.792668679169961
STAT,1917,21,na,1938,3677.4400972889716
SIM,1823,35,45-49,1858,1
SIM,1871,22,25-29,1893,49
SIM,1875,36,20-24,1911,5
SIM,1934,26,25-29,1960,93
SIM,1890,26,45-49,1916,2
STAT,1928,21,30-34,1949,34.005942621828304
SIM,1936,20,20-24,1956,71
SIM,1894,27,25-29,1921,58
STAT,1823,35,35-39,1858,12.641763008548008
STAT,1837,41,na,1878,1586.2747916337862
STAT,1936,30,20-24,1966,2.2402919351817325
STAT,1873,33,40-44,1906,4.140964637178173
SIM,1864,63,na,1927,1626
STAT,1840,42,45-49,1882,1.0872554459561916
SIM,1895,39,40-44,1934,6
SIM,1899,30,35-39,1929,20
STAT,1821,46,25-29,1867,0.08925366180782356
SIM,1871,11,na,1882,2551
STAT,1891,76,na,1967,1457.4413133130547
STAT,1839,20,25-29,1859,49.755561372730085
SIM,1926,26,35-39,1952,24
SIM,1949,15,15-19,1964,45
SIM,1859,48,na,1907,1856
SIM,1899,17,na,1916,3249
STAT,1854,39,45-49,1893,1.4210506160709702
SIM,1902,28,na,1930,3189
STAT,1882,26,45-49,1908,1.02414881221651
STAT,1841,30,25-29,1871,8.681104154853394
STAT,1842,36,15-19,1878,0.047399007023774274
STAT,1875,24,45-49,1899,0.6725403580079938
STAT,1877,25,25-29,1902,41.750139030799716
STAT,1897,28,45-49,1925,1.397836261356736
STAT,1958,0,na,1958,4913.674985199445
STAT,1874,64,na,1938,1678.4398606306215
STAT,1899,40,35-39,1939,0.16443591605684366
SIM,1875,27,20-24,1902,12
STAT,1916,47,30-34,1963,0.08637520590304369
STAT,1947,21,35-39,1968,10.057073259826092
SIM,1857,61,na,1918,1507
SIM,1897,32,50-100,1929,2
SIM,1813,57,na,1870,1082
SIM,1838,37,45-49,1875,1
SIM,1885,25,25-29,1910,45
STAT,1890,35,50-100,1925,1.4315436982100807
SIM,1864,94,na,1958,33
STAT,1889,32,50-100,1921,1.0685915381455504
SIM,1901,16,20-24,1917,26
SIM,1934,36,35-39,1970,10
STAT,1839,49,20-24,1888,0.007946019531320476
STAT,1857,17,50-100,1874,0.04288449450772592
STAT,1863,107,na,1970,0.05532360959264536
STAT,1863,21,15-19,1884,2.8143578163769627
SIM,1814,42,40-44,1856,4
STAT,1890,26,35-39,1916,11.183018931262861
STAT,1852,111,na,1963,2.9767408213130663E-4
STAT,1910,22,15-19,1932,4.721101270895009
SIM,1915,34,45-49,1949,1
SIM,1828,56,na,1884,1152
STAT,1831,27,40-44,1858,2.627727980632496
STAT,1883,37,15-19,1920,0.0519916619078357
STAT,1887,20,20-24,1907,73.24021114246086
STAT,1853,28,40-44,1881,2.325113185315429
SIM,1848,43,50-100,1891,1
SIM,1935,28,35-39,1963,18
STAT,1872,50,40-44,1922,0.010125791970442815
STAT,1898,31,50-100,1929,1.1765078782313503
SIM,1929,21,25-29,1950,114
STAT,1904,44,35-39,1948,0.16806483222683133
STAT,1817,38,15-19,1855,0.17907094888922984
SIM,1851,38,25-29,1889,5
STAT,1850,28,20-24,1878,9.649372097569211
SIM,1839,28,na,1867,1887
SIM,1925,25,na,1950,4103
SIM,1884,49,na,1933,2171
STAT,1924,37,15-19,1961,0.021393855550610272
STAT,1943,29,30-34,1972,39.381254382801174
STAT,1847,21,30-34,1868,16.18296582934755
STAT,1870,21,20-24,1891,63.98278137882135
STAT,1928,20,20-24,1948,131.94943827013358
STAT,1843,38,25-29,1881,2.1839195469018637
STAT,1835,19,25-29,1854,8.919469184875416
SIM,1918,26,40-44,1944,5
STAT,1814,44,na,1858,1295.0037634089272
STAT,1884,29,15-19,1913,0.42052215538988463
SIM,1809,66,na,1875,836
SIM,1855,21,30-34,1876,19
SIM,1902,22,30-34,1924,29
STAT,1933,17,na,1950,4654.760067136961
STAT,1859,45,25-29,1904,0.04385899254586585
SIM,1875,86,na,1961,367
SIM,1834,36,30-34,1870,5
STAT,1796,65,na,1861,855.1173945711432
STAT,1875,46,20-24,1921,0.011679523166887137
STAT,1874,6,na,1880,2637.872019538569
SIM,1861,28,40-44,1889,2
SIM,1827,71,na,1898,709
SIM,1889,41,30-34,1930,2
STAT,1864,36,35-39,1900,6.0004860558914475
STAT,1918,26,35-39,1944,15.145515212210762
SIM,1886,18,35-39,1904,1
STAT,1827,28,30-34,1855,45.41064519172046
STAT,1844,49,30-34,1893,0.06653565085409077
SIM,1873,77,na,1950,790
SIM,1843,19,25-29,1862,5
STAT,1887,48,40-44,1935,0.17859953909177326
STAT,1935,26,na,1961,4825.998515202745
SIM,1872,92,na,1964,108
STAT,1897,42,25-29,1939,0.05626974204554266
STAT,1927,28,35-39,1955,17.183915733680326
SIM,1868,37,25-29,1905,5
SIM,1886,10,na,1896,2533
SIM,1895,20,20-24,1915,69
STAT,1837,31,15-19,1868,0.11389013649889262
SIM,1867,77,na,1944,706
STAT,1816,46,15-19,1862,0.0010701719601391782
STAT,1934,27,30-34,1961,49.793852671889
SIM,1858,30,45-49,1888,1
STAT,1838,26,na,1864,1890.352947557863
STAT,1764,94,na,1858,2.808966396595827
STAT,1853,3,na,1856,2520.4900819199997
SIM,1835,28,30-34,1863,28
SIM,1942,27,30-34,1969,37
STAT,1853,19,40-44,1872,0.1612524383734701
STAT,1841,16,45-49,1857,0.05798389702431054
STAT,1875,12,na,1887,2527.835311164748
STAT,1920,45,30-34,1965,0.09353549704255952
STAT,1944,21,15-19,1965,5.43128354689042
STAT,1893,46,50-100,1939,0.1665263487992819
SIM,1908,36,25-29,1944,3
SIM,1873,20,na,1893,2285
STAT,1907,16,15-19,1923,8.25421644243114
STAT,1920,27,na,1947,3882.353641108633
SIM,1900,19,na,1919,3263
STAT,1826,36,30-34,1862,5.944591860780775
STAT,1841,25,45-49,1866,0.9572308914921062
STAT,1864,33,30-34,1897,14.679218508604457
STAT,1871,35,30-34,1906,5.03878492748336
SIM,1915,16,15-19,1931,7
SIM,1893,17,30-34,1910,1
STAT,1893,27,30-34,1920,30.183428326858326
SIM,1844,43,na,1887,1669
SIM,1860,87,na,1947,159
SIM,1865,11,na,1876,2348
STAT,1866,53,20-24,1919,6.324001396525646E-4
STAT,1894,19,na,1913,3052.7084277599456
STAT,1828,98,na,1926,1.8441204940127964
SIM,1908,28,40-44,1936,4
STAT,1917,39,30-34,1956,1.777408870993193
SIM,1855,35,na,1890,1909
SIM,1893,74,na,1967,1692
SIM,1874,34,45-49,1908,1
SIM,1929,31,35-39,1960,11
STAT,1884,40,na,1924,2179.405425685604
STAT,1841,22,40-44,1863,1.8061090117920884
SIM,1867,32,45-49,1899,1
SIM,1782,88,na,1870,42
SIM,1851,45,na,1896,1700
SIM,1932,16,15-19,1948,54
STAT,1892,45,45-49,1937,0.1590562557593517
STAT,1897,20,15-19,1917,4.192906538152624
STAT,1938,29,20-24,1967,17.065170643621954
SIM,1875,15,20-24,1890,14
STAT,1924,16,15-19,1940,51.185265215512686
STAT,1903,24,30-34,1927,23.790426889501262
STAT,1818,38,30-34,1856,16.30789365997311
STAT,1906,39,20-24,1945,0.22657162950983992
STAT,1878,23,na,1901,2318.725951694481
SIM,1869,1,na,1870,3062
STAT,1866,34,45-49,1900,1.5058462205617857
SIM,1857,4,na,1861,2411
STAT,1839,41,25-29,1880,0.50230075869004
SIM,1845,90,na,1935,50
SIM,1863,28,40-44,1891,5
SIM,1891,33,35-39,1924,18
SIM,1927,37,na,1964,4334
SIM,1943,16,25-29,1959,51
STAT,1825,54,45-49,1879,0.014097169788800035
STAT,1921,29,45-49,1950,1.806094663102592
STAT,1820,95,na,1915,7.082990928121125
STAT,1935,16,25-29,1951,56.099966347393604
SIM,1824,42,35-39,1866,6
STAT,1837,53,25-29,1890,0.00220009607786702
STAT,1927,42,15-19,1969,0.0018196571913385651
STAT,1829,38,40-44,1867,3.8365794296161
SIM,1925,39,30-34,1964,2
STAT,1901,29,25-29,1930,55.53484176306374
STAT,1830,34,30-34,1864,14.141791183404088
SIM,1840,22,30-34,1862,17
STAT,1949,17,30-34,1966,13.393052143645244
SIM,1780,76,na,1856,349
STAT,1863,26,50-100,1889,0.5350509143020363
STAT,1803,54,50-100,1857,0.041588215586297037
STAT,1860,17,25-29,1877,5.017734966604896
STAT,1829,49,50-100,1878,0.19306024215726064
SIM,1941,28,25-29,1969,58
STAT,1855,28,40-44,1883,2.195503687897792
STAT,1833,49,20-24,1882,0.007586407962960166
STAT,1859,32,45-49,1891,1.3147103532500088
STAT,1933,28,25-29,1961,82.52338635531777
STAT,1785,76,na,1861,358.96268257239063
SIM,1865,32,45-49,1897,1
STAT,1827,110,na,1937,1.533536346119816E-4
SIM,1844,15,25-29,1859,5
SIM,1879,44,40-44,1923,7
STAT,1800,95,na,1895,5.299701356736446
SIM,1862,82,na,1944,347
STAT,1881,40,40-44,1921,2.0723654359484898
STAT,1888,30,na,1918,2684.5541240480975
STAT,1923,17,45-49,1940,0.5541874900250898
STAT,1828,41,15-19,1869,0.01238797348329528
STAT,1856,15,45-49,1871,0.05782832487123618
SIM,1852,28,30-34,1880,30
STAT,1920,41,na,1961,3880.7259511386205
STAT,1844,28,30-34,1872,21.48538355057081
SIM,1847,20,25-29,1867,63
STAT,1920,23,20-24,1943,116.42565780981575
STAT,1824,37,45-49,1861,2.9958923802179656
STAT,1832,22,30-34,1854,26.77479094304435
STAT,1841,34,40-44,1875,3.526039925152718
STAT,1922,28,15-19,1950,0.7520457862757052
SIM,1845,28,na,1873,1851
SIM,1798,86,na,1884,74
STAT,1895,32,15-19,1927,0.17556015002677733
STAT,1857,32,45-49,1889,1.3067308929027317
SIM,1847,30,50-100,1877,5
STAT,1887,25,50-100,1912,0.6804178560265769
STAT,1852,4,na,1856,2449.28979712
SIM,1848,7,na,1855,2273
STAT,1909,26,25-29,1935,60.11935440482372
SIM,1821,37,35-39,1858,10
STAT,1946,23,40-44,1969,3.5336380380894843
SIM,1866,75,na,1941,815
STAT,1869,50,50-100,1919,0.014008972662896389
STAT,1877,92,na,1969,147.9441260914828
SIM,1919,49,50-100,1968,2
STAT,1851,38,15-19,1889,0.04119010800671448
SIM,1837,38,40-44,1875,8
SIM,1906,0,na,1906,3760
SIM,1829,43,30-34,1872,4
SIM,1874,70,na,1944,1275
SIM,1884,15,na,1899,2478
STAT,1820,92,na,1912,22.188076379154992
STAT,1921,22,25-29,1943,98.5681518503357
SIM,1896,22,30-34,1918,26
STAT,1801,54,25-29,1855,0.012277794805455787
SIM,1905,27,45-49,1932,1
STAT,1853,21,20-24,1874,60.820636303120786
SIM,1920,17,35-39,1937,4
STAT,1912,17,35-39,1929,0.801394314052059
STAT,1880,28,35-39,1908,9.557259267100775
STAT,1869,42,15-19,1911,0.012612668900712056
STAT,1813,68,na,1881,764.7341540643899
SIM,1882,21,25-29,1903,48
STAT,1896,29,40-44,1925,3.7133271206647245
SIM,1876,82,na,1958,491
SIM,1861,21,20-24,1882,55
STAT,1856,27,45-49,1883,0.8512689308352012
STAT,1867,15,20-24,1882,16.266948618614542
STAT,1873,26,35-39,1899,9.284189762239636
SIM,1857,1,na,1858,2852
STAT,1878,38,50-100,1916,1.2014378840779687
SIM,1819,39,50-100,1858,3
SIM,1848,56,na,1904,1490
SIM,1864,27,45-49,1891,4
STAT,1869,49,35-39,1918,0.1253481673219715
SIM,1835,38,40-44,1873,3
STAT,1888,33,na,1921,2651.9088851583315
STAT,1886,46,30-34,1932,0.09689273563309367
STAT,1894,29,40-44,1923,3.6142522595170585
STAT,1869,27,50-100,1896,0.5849582567655065
STAT,1906,15,na,1921,3490.3885308468184
STAT,1871,17,35-39,1888,0.5172088458285053
STAT,1888,22,30-34,1910,19.878688862675208
SIM,1868,53,na,1921,1903
STAT,1808,61,na,1869,999.2780612373624
STAT,1874,29,20-24,1903,11.246129327500016
SIM,1863,21,20-24,1884,54
SIM,1884,17,20-24,1901,16
STAT,1916,22,na,1938,3614.834075139851
STAT,1906,18,20-24,1924,24.323633092576593
SIM,1880,33,25-29,1913,16
SIM,1921,12,na,1933,4182
SIM,1896,34,30-34,1930,31
STAT,1926,18,40-44,1944,1.6159913058339368
STAT,1826,86,na,1912,121.103823847049
SIM,1892,39,25-29,1931,6
STAT,1836,36,25-29,1872,2.2550044559594418
STAT,1970,2,na,1972,4652.975115200643
SIM,1823,32,40-44,1855,6
SIM,1922,24,40-44,1946,6
STAT,1886,52,na,1938,2137.7463460465456
STAT,1892,24,45-49,1916,0.819771909510403
STAT,1907,62,na,1969,2814.1196358050383
STAT,1851,26,15-19,1877,0.39237151616312443
STAT,1825,33,45-49,1858,2.7902908385726475
STAT,1910,29,35-39,1939,13.594112734539092
SIM,1869,100,na,1969,3
SIM,1922,26,50-100,1948,3
STAT,1867,27,20-24,1894,10.405802948276516
SIM,1858,63,na,1921,1451
STAT,1882,23,40-44,1905,1.9096223982217568
SIM,1883,30,na,1913,2279
SIM,1890,23,40-44,1913,3
STAT,1875,21,40-44,1896,2.028521559012157
SIM,1858,46,na,1904,1819
SIM,1897,21,35-39,1918,8
STAT,1832,26,50-100,1858,0.5324638109431399
STAT,1857,43,35-39,1900,1.3388629471538296
STAT,1888,34,30-34,1922,19.31839723358535
SIM,1934,18,40-44,1952,2
STAT,1855,21,20-24,1876,57.430292919558156
SIM,1882,29,20-24,1911,13
STAT,1909,33,30-34,1942,14.139542034009736
SIM,1833,33,45-49,1866,1
STAT,1872,33,25-29,1905,9.67107614076596
SIM,1914,18,20-24,1932,31
STAT,1783,98,na,1881,0.47717156633851665
STAT,1901,36,50-100,1937,0.35208923039504875
STAT,1838,24,25-29,1862,49.93044051857569
SIM,1865,43,35-39,1908,4
STAT,1889,21,35-39,1910,6.826304215539411
STAT,1914,24,40-44,1938,3.2242885593827935
STAT,1827,38,40-44,1865,4.267758825961964
STAT,1865,31,25-29,1896,8.828643353802052
STAT,1900,19,30-34,1919,2.0777062124756247
SIM,1829,31,30-34,1860,19
STAT,1884,39,25-29,1923,2.6607929620952535
STAT,1845,45,30-34,1890,0.06886388078562622
SIM,1876,39,40-44,1915,6
SIM,1899,28,20-24,1927,15
SIM,1881,23,30-34,1904,21
STAT,1842,32,35-39,1874,8.711804915883901
STAT,1880,67,na,1947,1575.7040252335541
STAT,1870,18,30-34,1888,1.4806780862761437
STAT,1878,54,25-29,1932,0.003387610272763663
STAT,1917,20,45-49,1937,1.136402979604446
SIM,1824,40,na,1864,1488
SIM,1850,21,45-49,1871,1
STAT,1912,31,15-19,1943,0.11991454157388079
SIM,1915,38,25-29,1953,4
SIM,1846,24,25-29,1870,55
STAT,1953,14,na,1967,4487.450256235096
SIM,1940,22,35-39,1962,11
SIM,1926,35,30-34,1961,2
STAT,1851,53,na,1904,1553.6014713696293
STAT,1882,50,35-39,1932,0.00802760402370395
SIM,1871,29,45-49,1900,4
STAT,1827,31,20-24,1858,3.2883606543096118
SIM,1844,33,20-24,1877,2
STAT,1826,106,na,1932,0.006627142428153823
SIM,1809,83,na,1892,171
STAT,1871,22,na,1893,2214.9707861312672
SIM,1838,22,40-44,1860,1
SIM,1866,41,na,1907,2054
STAT,1951,17,20-24,1968,152.52374315475274
SIM,1864,33,40-44,1897,2
SIM,1928,26,35-39,1954,17
STAT,1911,19,40-44,1930,0.262939152290378
STAT,1881,18,40-44,1899,0.16639681824148408
STAT,1906,20,35-39,1926,8.075234928311037
SIM,1835,21,45-49,1856,1
SIM,1878,20,20-24,1898,73
SIM,1923,22,35-39,1945,12
SIM,1865,40,50-100,1905,2
STAT,1865,38,45-49,1903,1.7028103250493598
STAT,1898,43,50-100,1941,0.09313982292983769
STAT,1894,22,20-24,1916,83.7438589474566
STAT,1926,44,20-24,1970,0.020501420403473185
SIM,1888,33,50-100,1921,1
STAT,1935,29,na,1964,4819.052408195995
SIM,1857,16,na,1873,2197
SIM,1902,32,50-100,1934,1
SIM,1919,21,30-34,1940,30
STAT,1879,70,na,1949,1385.4404824654891
SIM,1885,22,20-24,1907,63
STAT,1868,39,40-44,1907,3.9086680402787497
SIM,1905,20,25-29,1925,83
STAT,1933,14,na,1947,4994.545531885955
STAT,1925,33,15-19,1958,0.1440874615855005
STAT,1851,44,45-49,1895,1.082696506701671
SIM,1858,37,30-34,1895,4
SIM,1925,20,45-49,1945,1
STAT,1907,38,25-29,1945,0.857963869972986
STAT,1922,22,na,1944,3956.4484934704988
SIM,1817,61,na,1878,1052
STAT,1881,36,50-100,1917,1.1252682025121326
STAT,1840,16,na,1856,2081.994423355487
STAT,1863,47,40-44,1910,0.14150401641143964
SIM,1850,32,35-39,1882,16
SIM,1918,3,na,1921,4123
STAT,1799,90,na,1889,31.64707596732079
STAT,1821,43,20-24,1864,0.25716446926297654
STAT,1861,42,50-100,1903,0.8277415064946864
SIM,1835,31,20-24,1866,1
SIM,1912,52,na,1964,3146
STAT,1831,32,25-29,1863,8.404022924721636
STAT,1939,27,15-19,1966,0.6703696997873757
STAT,1822,49,45-49,1871,0.3199360320680349
STAT,1936,33,25-29,1969,8.474211325370407
SIM,1914,20,35-39,1934,14
STAT,1847,43,40-44,1890,1.6430364570683198
SIM,1918,29,45-49,1947,1
SIM,1928,27,50-100,1955,1
STAT,1891,22,na,1913,2765.4672405201154
STAT,1906,12,na,1918,3552.522948565527
STAT,1842,21,45-49,1863,0.6308524391450192
SIM,1910,28,30-34,1938,51
STAT,1833,68,na,1901,927.7535129548979
STAT,1906,32,35-39,1938,7.999113921439727
STAT,1932,36,50-100,1968,0.5334150791284412
STAT,1836,54,20-24,1890,4.531818125796936E-4
SIM,1859,26,25-29,1885,46
STAT,1902,28,30-34,1930,33.45303247055121
SIM,1855,43,40-44,1898,5
SIM,1849,25,20-24,1874,9
STAT,1880,81,na,1961,731.8366581311197
STAT,1816,42,35-39,1858,5.414826348315326
SIM,1843,16,20-24,1859,10
SIM,1877,67,na,1944,1518
SIM,1907,29,35-39,1936,17
STAT,1897,34,40-44,1931,5.432164618482506
SIM,1860,16,20-24,1876,16
SIM,1835,80,na,1915,376
STAT,1839,53,na,1892,1412.6208972278037
SIM,1913,37,na,1950,3382
SIM,1943,23,30-34,1966,40
STAT,1833,42,35-39,1875,1.335270993769116
SIM,1879,23,40-44,1902,5
SIM,1874,16,15-19,1890,9
STAT,1802,76,na,1878,371.81537269090387
STAT,1877,34,20-24,1911,2.6271673837224943
SIM,1880,16,40-44,1896,1
STAT,1841,25,50-100,1866,0.5515010299492825
SIM,1869,33,25-29,1902,11
SIM,1889,33,45-49,1922,1
SIM,1885,34,20-24,1919,1
STAT,1834,98,na,1932,2.010705308214353
STAT,1931,36,na,1967,4711.370070659098
SIM,1784,83,na,1867,84
STAT,1884,74,na,1958,1127.4832199498276
SIM,1839,42,45-49,1881,2
STAT,1866,52,40-44,1918,0.0091206534929403
SIM,1887,25,25-29,1912,47
STAT,1880,21,15-19,1901,3.2891249481147193
STAT,1858,49,25-29,1907,0.04182594900707989
STAT,1835,60,na,1895,1189.94617762242
STAT,1879,25,25-29,1904,42.053159951202986
SIM,1923,44,na,1967,4011
STAT,1872,37,50-100,1909,1.164148519022926
STAT,1851,23,45-49,1874,0.6062758965936198
STAT,1872,25,50-100,1897,0.6106728849805731
STAT,1935,23,30-34,1958,36.95970448788949
SIM,1870,26,25-29,1896,48
STAT,1859,39,30-34,1898,3.977659122023136
STAT,1790,104,na,1894,0.0134268961704212
STAT,1929,23,40-44,1952,4.004638123328324
SIM,1928,33,40-44,1961,4
SIM,1853,23,na,1876,1985
STAT,1826,39,35-39,1865,7.245589702645379
STAT,1894,15,15-19,1909,7.245293362865655
STAT,1909,23,20-24,1932,97.30282285370006
SIM,1819,76,na,1895,431
SIM,1869,30,20-24,1899,3
STAT,1932,22,35-39,1954,11.671469231739577
STAT,1789,83,na,1872,119.52014917037482
SIM,1835,24,15-19,1859,2
STAT,1852,16,20-24,1868,16.387551343069077
SIM,1855,36,35-39,1891,14
SIM,1917,23,20-24,1940,102
STAT,1868,32,20-24,1900,2.4380969070412895
STAT,1915,22,35-39,1937,9.193962656846587
STAT,1883,33,35-39,1916,9.336749296009078
STAT,1929,35,40-44,1964,1.818842213481171
SIM,1937,23,40-44,1960,4
STAT,1887,37,50-100,1924,1.2971059611321907
SIM,1870,8,na,1878,2517
SIM,1862,38,35-39,1900,11
SIM,1876,32,20-24,1908,1
SIM,1933,37,na,1970,4857
STAT,1862,26,25-29,1888,34.461181230781506
SIM,1822,62,na,1884,1005
STAT,1872,38,na,1910,2222.8626261800505
SIM,1834,39,35-39,1873,17
STAT,1875,8,na,1883,2600.274616160588
SIM,1848,44,45-49,1892,2
STAT,1887,44,25-29,1931,0.6692790520851656
STAT,1823,48,50-100,1871,0.2887808067531649
STAT,1905,27,50-100,1932,0.873279532040961
STAT,1909,44,20-24,1953,0.015409129888020899
STAT,1946,16,35-39,1962,4.398057486126329
STAT,1826,80,na,1906,337.64045747467225
STAT,1882,17,45-49,1899,0.06004771726832742
STAT,1872,16,40-44,1888,0.17503050449981875
STAT,1901,17,25-29,1918,7.493041096764421
STAT,1897,46,40-44,1943,0.12235576498987864
STAT,1898,33,45-49,1931,2.2206359898349923
SIM,1841,42,35-39,1883,2
STAT,1847,36,35-39,1883,5.455923516832947
STAT,1860,67,na,1927,1217.0663252552113
SIM,1838,43,40-44,1881,7
SIM,1938,22,45-49,1960,1
STAT,1944,25,30-34,1969,40.04044396988688
SIM,1908,21,20-24,1929,96
SIM,1954,16,35-39,1970,5
SIM,1815,83,na,1898,141
STAT,1814,100,na,1914,0.43803044424787907
SIM,1933,27,20-24,1960,25
STAT,1852,37,20-24,1889,0.588847542050903
SIM,1843,26,30-34,1869,26
STAT,1946,0,na,1946,4659.8450397865545
SIM,1902,15,25-29,1917,10
STAT,1852,29,35-39,1881,7.659041491813614
STAT,1897,49,45-49,1946,0.1646787812657902
SIM,1925,28,40-44,1953,11
STAT,1865,17,45-49,1882,0.0577850559251372
STAT,1873,85,na,1958,335.5781518792138
STAT,1923,39,20-24,1962,0.28795896923702935
STAT,1860,28,15-19,1888,0.3495389681867088
STAT,1850,49,20-24,1899,0.008271639745011586
SIM,1896,37,35-39,1933,17
STAT,1903,27,35-39,1930,12.968478771612924
SIM,1784,80,na,1864,168
STAT,1832,25,35-39,1857,8.160201881367827
SIM,1846,75,na,1921,671
SIM,1913,15,35-39,1928,1
STAT,1844,38,40-44,1882,3.2138207158616874
STAT,1863,29,45-49,1892,0.9154210106551476
SIM,1875,89,na,1964,242
STAT,1861,54,50-100,1915,0.011521949051118863
STAT,1846,26,40-44,1872,2.573584631172197
SIM,1933,19,35-39,1952,6
STAT,1804,54,na,1858,1128.7882190713226
STAT,1854,17,35-39,1871,0.47266052214970056
STAT,1905,15,35-39,1920,0.7525535649135677
STAT,1879,32,30-34,1911,17.240285089583242
STAT,1917,28,40-44,1945,4.60132122623313
SIM,1897,36,na,1933,3022
SIM,1887,32,30-34,1919,26
SIM,1929,29,20-24,1958,22
STAT,1882,48,na,1930,2042.1797092792935
STAT,1898,23,35-39,1921,7.439509745297834
STAT,1936,19,45-49,1955,0.4493047316705684
SIM,1919,22,na,1941,3726
STAT,1838,48,50-100,1886,0.17013845512266143
SIM,1873,31,25-29,1904,18
SIM,1916,16,30-34,1932,3
SIM,1880,30,20-24,1910,3
SIM,1860,37,20-24,1897,5
STAT,1809,46,na,1855,1345.6241268692083
STAT,1866,16,15-19,1882,5.336919889264529
STAT,1873,23,30-34,1896,17.02756835132219
SIM,1905,24,40-44,1929,2
SIM,1911,27,35-39,1938,13
STAT,1837,51,35-39,1888,0.005563517492497651
STAT,1887,23,25-29,1910,60.29290710416864
STAT,1925,19,35-39,1944,4.763494052296838
STAT,1835,26,30-34,1861,20.625265609952148
SIM,1891,30,30-34,1921,31
SIM,1831,76,na,1907,537
SIM,1895,23,25-29,1918,68
STAT,1838,106,na,1944,0.008280927753594621
STAT,1875,49,25-29,1924,0.054735777840816714
SIM,1885,37,25-29,1922,2
SIM,1846,48,50-100,1894,1
SIM,1889,20,30-34,1909,28
STAT,1884,15,20-24,1899,16.627183290142284
STAT,1919,16,40-44,1935,0.2936797243137246
SIM,1870,97,na,1967,17
SIM,1927,16,40-44,1943,1
STAT,1862,23,20-24,1885,56.439624132521345
SIM,1789,72,na,1861,528
STAT,1925,9,na,1934,4543.481977866963
SIM,1898,32,40-44,1930,6
SIM,1870,23,20-24,1893,65
STAT,1892,42,40-44,1934,2.6576325702459838
STAT,1918,23,30-34,1941,29.192615778055202
STAT,1831,87,na,1918,107.44650209738623
STAT,1880,25,30-34,1905,25.200585586411897
STAT,1819,53,na,1872,1222.1481634647032
STAT,1825,39,na,1864,1583.9410724232764
STAT,1812,53,50-100,1865,0.04658627999048543
STAT,1825,51,40-44,1876,0.010854413817066847
STAT,1877,37,25-29,1914,2.8225258759274467
STAT,1886,49,35-39,1935,0.13681977154821293
STAT,1883,30,30-34,1913,16.295317722699846
STAT,1921,26,40-44,1947,4.924708155975443
SIM,1822,49,50-100,1871,2
STAT,1838,21,20-24,1859,61.41997185014865
STAT,1846,86,na,1932,156.43878594422594
STAT,1885,1,na,1886,3113.838088478489
SIM,1832,34,40-44,1866,8
SIM,1859,93,na,1952,34
STAT,1814,49,50-100,1863,0.644970295662013
STAT,1910,26,30-34,1936,35.85611518076467
SIM,1899,38,30-34,1937,3
STAT,1856,45,na,1901,1681.2394492033334
SIM,1920,9,na,1929,4143
STAT,1839,27,45-49,1866,0.9326358845171211
SIM,1868,56,na,1924,1819
STAT,1872,30,20-24,1902,2.583648665244382
SIM,1848,53,na,1901,1560
STAT,1879,73,na,1952,1172.825079404054
SIM,1899,14,na,1913,3336
SIM,1860,31,50-100,1891,1
STAT,1875,5,na,1880,2662.6462437013274
STAT,1891,21,25-29,1912,67.1397693679593
STAT,1822,46,40-44,1868,0.24226391517652873
STAT,1866,52,na,1918,1865.401810188404
STAT,1889,80,na,1969,1135.078019505738
SIM,1926,23,30-34,1949,33
STAT,1826,47,20-24,1873,0.011220083665054795
STAT,1946,26,45-49,1972,1.8188772149525974
STAT,1818,48,40-44,1866,0.36027458935114365
SIM,1903,36,40-44,1939,2
SIM,1922,27,45-49,1949,6
SIM,1881,36,45-49,1917,5
SIM,1840,25,35-39,1865,9
SIM,1865,40,30-34,1905,1
STAT,1834,20,40-44,1854,3.1100431984013377
STAT,1945,20,20-24,1965,115.20693007578598
STAT,1861,19,50-100,1880,0.04365543160954292
SIM,1897,33,na,1930,3016
STAT,1888,37,35-39,1925,7.893452187104723
STAT,1908,49,30-34,1957,0.07569789280393083
SIM,1817,95,na,1912,6
SIM,1892,18,25-29,1910,9
STAT,1877,16,25-29,1893,5.568833749054488
SIM,1866,25,20-24,1891,15
STAT,1938,31,35-39,1969,8.684490579438275
SIM,1907,2,na,1909,3748
STAT,1891,25,40-44,1916,3.526496705504213
STAT,1884,18,25-29,1902,5.276255981648025
STAT,1923,37,50-100,1960,0.45961509640863935
SIM,1852,38,40-44,1890,6
SIM,1883,24,45-49,1907,1
SIM,1833,57,na,1890,1215
STAT,1929,40,na,1969,4556.5352007882475
STAT,1862,44,20-24,1906,0.12625009265756892
STAT,1815,110,na,1925,1.1827304715721169E-4
SIM,1914,30,na,1944,3868
STAT,1824,34,40-44,1858,7.790391224494201
STAT,1893,38,20-24,1931,0.919369020733512
STAT,1854,19,na,1873,1954.0802671078204
STAT,1914,27,45-49,1941,1.6449949013498173
SIM,1964,4,na,1968,4485
STAT,1848,39,20-24,1887,0.5605240316117709
STAT,1824,30,25-29,1854,33.66507777850785
STAT,1861,16,30-34,1877,1.4456514963984426
STAT,1896,11,na,1907,3229.1572676080636
SIM,1847,27,45-49,1874,4
STAT,1858,25,20-24,1883,9.03584077848311
STAT,1836,33,20-24,1869,2.135316155271765
STAT,1869,46,30-34,1915,0.0887687992823521
STAT,1904,34,na,1938,3232.614993305487
SIM,1790,69,na,1859,595
SIM,1856,82,na,1938,317
SIM,1854,22,25-29,1876,52
STAT,1837,39,45-49,1876,1.5006775568582686
SIM,1845,39,45-49,1884,1
SIM,1842,20,40-44,1862,1
SIM,1936,11,na,1947,2991
SIM,1839,32,35-39,1871,13
SIM,1858,3,na,1861,2512
SIM,1860,29,35-39,1889,9
STAT,1873,36,45-49,1909,1.920771498082058
STAT,1852,31,50-100,1883,0.7282910580695542
SIM,1904,23,na,1927,3135
SIM,1854,26,40-44,1880,5
STAT,1904,22,25-29,1926,77.55767768459138
STAT,1925,6,na,1931,4574.518968288592
STAT,1947,19,20-24,1966,144.1859610549224
STAT,1830,37,35-39,1867,5.613313080679076
SIM,1912,22,25-29,1934,84
STAT,1896,36,50-100,1932,1.5402542029216848
STAT,1919,33,na,1952,3838.45735123327
SIM,1832,30,25-29,1862,10
STAT,1914,41,na,1955,3480.942448184762
SIM,1880,1,na,1881,3270
STAT,1925,27,20-24,1952,20.370123947410793
SIM,1844,36,25-29,1880,2
SIM,1928,23,30-34,1951,39
STAT,1905,39,50-100,1944,0.3581217778737307
STAT,1838,31,30-34,1869,14.951620510477579
STAT,1857,22,35-39,1879,5.01718208670477
SIM,1855,33,30-34,1888,21
SIM,1882,34,na,1916,2142
SIM,1895,55,na,1950,2575
STAT,1844,20,na,1864,1901.2824057523865
STAT,1808,48,15-19,1856,0.0014976328507547755
STAT,1840,61,na,1901,1301.3490326063318
SIM,1908,24,25-29,1932,96
STAT,1857,41,na,1898,1729.086070053455
STAT,1959,8,na,1967,4855.454733773031
STAT,1884,36,20-24,1920,0.7230816150927055
STAT,1909,36,35-39,1945,2.1726511587316986
SIM,1926,38,35-39,1964,8
STAT,1815,47,45-49,1862,0.5743047380257823
SIM,1871,42,na,1913,2231
SIM,1838,25,45-49,1863,1
STAT,1876,23,15-19,1899,3.2074492545093753
STAT,1924,34,45-49,1958,1.7322482126203953
STAT,1929,38,45-49,1967,0.8260216316135474
STAT,1785,79,na,1864,270.1205873096296
STAT,1845,48,35-39,1893,0.09737430802271765
STAT,1846,22,25-29,1868,49.8015073773039
STAT,1878,52,35-39,1930,0.008421528931968658
STAT,1910,16,20-24,1926,25.432902466328418
SIM,1867,39,30-34,1906,3
STAT,1827,34,25-29,1861,10.94594836332096
STAT,1792,72,na,1864,491.1513909480046
STAT,1816,79,na,1895,325.7806673749971
STAT,1851,41,40-44,1892,1.6568942285735544
SIM,1844,94,na,1938,11
STAT,1897,16,45-49,1913,0.08273215028220886
SIM,1864,49,na,1913,1979
SIM,1949,22,20-24,1971,112
STAT,1840,17,40-44,1857,0.1649182019212404
STAT,1847,33,30-34,1880,14.927805170368522
STAT,1869,18,na,1887,2327.696752723179
SIM,1909,35,30-34,1944,2
STAT,1878,26,50-100,1904,0.6312660244662038
STAT,1806,80,na,1886,258.0374348037645
SIM,1932,34,45-49,1966,3
STAT,1807,65,na,1872,835.2230852630319
STAT,1849,31,40-44,1880,3.657432063633956
STAT,1868,22,45-49,1890,0.6289680435119412
STAT,1915,47,15-19,1962,3.5063054860420964E-4
STAT,1795,86,na,1881,69.63599595744867
SIM,1813,88,na,1901,58
STAT,1837,27,na,1864,1752.7083190716235
STAT,1848,20,35-39,1868,5.193126873004507
STAT,1912,42,50-100,1954,0.10701417527842828
SIM,1863,24,25-29,1887,47
STAT,1834,48,25-29,1882,0.037330513840222415
SIM,1877,27,50-100,1904,2
STAT,1877,22,50-100,1899,0.39976386133542424
SIM,1846,31,30-34,1877,20
STAT,1870,35,15-19,1905,0.052474230376608894
STAT,1943,18,40-44,1961,1.4006957919913319
STAT,1861,107,na,1968,0.03987855475827472
SIM,1884,27,30-34,1911,21
SIM,1917,26,25-29,1943,71
STAT,1938,21,25-29,1959,86.38049207028908
SIM,1877,28,35-39,1905,11
STAT,1892,27,15-19,1919,0.536733183873319
SIM,1892,36,20-24,1928,1
STAT,1843,27,na,1870,1920.7238935700964
STAT,1832,35,45-49,1867,1.5615390355592376
STAT,1855,24,25-29,1879,46.687091156285476
STAT,1859,20,45-49,1879,0.6081081931613284
STAT,1817,72,na,1889,579.0918906503708
STAT,1899,25,na,1924,3110.586166566209
STAT,1817,45,20-24,1862,0.027712112121488046
SIM,1846,21,20-24,1867,62
SIM,1851,42,na,1893,1708
SIM,1828,36,40-44,1864,9
STAT,1859,35,15-19,1894,0.0427383754394584
STAT,1954,16,50-100,1970,0.43765396120946864
SIM,1831,23,35-39,1854,5
STAT,1903,43,50-100,1946,0.0978889304253537
STAT,1858,26,na,1884,1824.958583622721
STAT,1853,34,na,1887,1784.9746748496475
SIM,1894,70,na,1964,2030
STAT,1855,60,na,1915,1350.7348132205689
STAT,1887,27,40-44,1914,3.16480284604982
SIM,1853,57,na,1910,1593
STAT,1927,21,15-19,1948,6.215119375186015
STAT,1836,19,40-44,1855,0.21739855993102822
SIM,1895,27,40-44,1922,4
SIM,1930,2,na,1932,4924
SIM,1951,18,40-44,1969,1
STAT,1865,35,40-44,1900,3.7935333827224027
SIM,1935,21,15-19,1956,9
STAT,1918,38,35-39,1956,2.4059268183617655
SIM,1888,42,25-29,1930,3
SIM,1873,35,40-44,1908,6
STAT,1850,111,na,1961,1.8169648805151513E-4
STAT,1871,50,25-29,1921,0.003364919239861324
STAT,1889,18,na,1907,2937.826400691313
STAT,1899,29,25-29,1928,54.37258081822912
SIM,1840,35,45-49,1875,2
STAT,1836,79,na,1915,441.47729664741956
STAT,1889,44,50-100,1933,1.2154790856412896
STAT,1834,38,15-19,1872,0.0427892210220334
STAT,1935,26,35-39,1961,19.341298251913756
SIM,1933,37,30-34,1970,2
STAT,1829,37,50-100,1866,1.0956242088413226
SIM,1910,24,15-19,1934,7
STAT,1864,21,30-34,1885,15.391454227233307
STAT,1833,28,20-24,1861,9.367195240610755
STAT,1852,19,25-29,1871,5.146085923924224
STAT,1876,27,30-34,1903,24.558783660489265
SIM,1893,29,30-34,1922,36
SIM,1920,19,na,1939,3807
STAT,1866,37,15-19,1903,0.0489100075531494
STAT,1841,37,45-49,1878,1.6069739316688267
SIM,1927,30,20-24,1957,2
STAT,1855,50,40-44,1905,0.007563215548558309
STAT,1895,18,35-39,1913,0.6746762197641983
SIM,1879,48,na,1927,2186
STAT,1870,28,40-44,1898,2.7631414979108255
SIM,1856,20,35-39,1876,6
STAT,1848,103,na,1951,0.10339159827547517
STAT,1822,40,35-39,1862,2.8814215978881066
SIM,1841,28,20-24,1869,15
SIM,1860,19,25-29,1879,7
SIM,1834,50,na,1884,1393
STAT,1842,42,na,1884,1702.8237531813015
STAT,1903,45,30-34,1948,0.0741202410710992
SIM,1946,21,25-29,1967,100
STAT,1867,48,20-24,1915,0.010510263878031818
STAT,1869,25,30-34,1894,23.183480121249005
SIM,1888,28,45-49,1916,1
SIM,1857,31,40-44,1888,7
STAT,1815,91,na,1906,24.801738130628227
STAT,1908,16,30-34,1924,2.2385447637321163
STAT,1952,20,50-100,1972,0.7479169576797009
STAT,1888,84,na,1972,770.0820115554337
SIM,1821,34,30-34,1855,24
SIM,1869,37,40-44,1906,5
STAT,1786,72,na,1858,509.8631430082874
SIM,1826,38,30-34,1864,7
STAT,1770,107,na,1877,0.005754979820501253
STAT,1825,36,15-19,1861,0.07487896770755095
STAT,1944,28,35-39,1972,15.321562233081515
SIM,1824,43,na,1867,1412
STAT,1850,20,25-29,1870,49.073593925480736
STAT,1925,37,30-34,1962,2.066762738664789
STAT,1843,32,50-100,1875,0.7946853396895289
STAT,1843,17,25-29,1860,5.224555578320732
STAT,1887,41,20-24,1928,0.1685446052641022
STAT,1914,38,50-100,1952,0.3939818550098432
STAT,1885,29,30-34,1914,23.53129105208377
SIM,1813,100,na,1913,4
SIM,1901,22,15-19,1923,4
STAT,1913,48,na,1961,3377.2771178435264
SIM,1835,35,na,1870,1682
SIM,1945,25,na,1970,3769
STAT,1875,39,15-19,1914,0.05395161769997087
STAT,1888,47,45-49,1935,0.2621505130382121
SIM,1872,21,30-34,1893,21
STAT,1802,73,na,1875,494.10466981470955
SIM,1865,22,35-39,1887,7
STAT,1854,31,15-19,1885,0.10611038179466897
STAT,1860,38,25-29,1898,2.1995672489362046
SIM,1880,56,na,1936,2111
SIM,1881,26,35-39,1907,8
STAT,1828,27,35-39,1855,17.08150645895667
SIM,1851,17,25-29,1868,10
STAT,1870,18,50-100,1888,0.045512636841366354
STAT,1913,34,35-39,1947,8.513674356982344
SIM,1840,50,na,1890,1506
SIM,1921,34,35-39,1955,9
SIM,1930,26,na,1956,4419
SIM,1928,36,45-49,1964,2
STAT,1919,30,20-24,1949,2.5060130742662587
SIM,1878,39,40-44,1917,4
STAT,1890,26,na,1916,2765.958388792078
STAT,1879,22,20-24,1901,68.04640728158108
SIM,1766,95,na,1861,4
SIM,1830,40,35-39,1870,2
STAT,1940,17,45-49,1957,0.47910336949630333
SIM,1879,26,45-49,1905,4
SIM,1836,27,35-39,1863,10
SIM,1943,26,35-39,1969,22
SIM,1887,22,20-24,1909,79
STAT,1897,47,na,1944,2829.757632768288
STAT,1858,46,20-24,1904,0.008924823208430742
STAT,1815,41,30-34,1856,3.4020274311662817
STAT,1925,16,15-19,1941,51.9244502438232
STAT,1857,44,15-19,1901,0.01014605472855552
STAT,1921,43,na,1964,3945.8201271568605
SIM,1867,98,na,1965,13
SIM,1878,24,30-34,1902,22
STAT,1843,45,25-29,1888,0.0424356288117503
SIM,1883,28,30-34,1911,22
STAT,1927,24,25-29,1951,106.84881092517486
SIM,1863,84,na,1947,240
STAT,1924,23,45-49,1947,1.2505019406001765
STAT,1847,26,na,1873,1926.989920104783
STAT,1856,51,45-49,1907,0.01078902348494472
STAT,1922,15,35-39,1937,4.6093172950155035
SIM,1871,28,na,1899,2287
STAT,1833,32,35-39,1865,7.942060855011719
STAT,1944,21,20-24,1965,113.45273361895659
SIM,1822,86,na,1908,100
STAT,1863,49,45-49,1912,0.19188574280617773
STAT,1878,43,20-24,1921,0.1550568310134592
SIM,1781,87,na,1868,46
STAT,1870,27,40-44,1897,2.7729021133498155
STAT,1904,42,50-100,1946,0.09927041688072649
STAT,1814,47,na,1861,1267.0358572231091
SIM,1928,34,35-39,1962,15
STAT,1851,31,na,1882,1840.365217025703
STAT,1889,29,50-100,1918,0.7407231275542344
SIM,1841,32,35-39,1873,9
SIM,1789,67,na,1856,736
SIM,1933,16,15-19,1949,51
STAT,1880,46,40-44,1926,0.17065568129785566
SIM,1888,44,na,1932,2484
STAT,1750,121,na,1871,3.545368473109518E-4
STAT,1799,100,na,1899,0.35494003104666044
STAT,1823,83,na,1906,208.90968083442556
SIM,1926,35,na,1961,4209
STAT,1861,29,40-44,1890,2.3331544310814403
SIM,1932,23,45-49,1955,2
STAT,1868,95,na,1963,32.972654616729315
SIM,1804,73,na,1877,451
STAT,1888,28,40-44,1916,3.3313120931664963
STAT,1864,81,na,1945,456.573292411094
STAT,1845,53,35-39,1898,0.0059666957058175174
STAT,1911,36,40-44,1947,1.372194485653113
SIM,1827,29,30-34,1856,30
STAT,1820,45,30-34,1865,0.16436474752657357
STAT,1843,54,50-100,1897,0.010596328273938025
SIM,1834,42,45-49,1876,2
SIM,1883,13,na,1896,2451
SIM,1887,22,30-34,1909,25
STAT,1820,41,50-100,1861,1.965783458623156
STAT,1887,35,50-100,1922,1.309424733619866
STAT,1894,26,15-19,1920,0.5532406025245036
SIM,1922,21,na,1943,3991
STAT,1882,32,30-34,1914,16.04984644872129
STAT,1906,36,50-100,1942,0.3662874641259079
SIM,1884,30,na,1914,2356
STAT,1877,17,25-29,1894,5.555190106369306
SIM,1896,28,40-44,1924,3
STAT,1879,22,30-34,1901,17.58841980425524
SIM,1895,36,25-29,1931,4
STAT,1871,40,30-34,1911,1.087578691294479
STAT,1847,53,45-49,1900,0.010506622400541505
STAT,1941,20,40-44,1961,3.2845588472053215
SIM,1842,90,na,1932,31
SIM,1829,37,40-44,1866,3
SIM,1853,19,30-34,1872,1
STAT,1918,31,20-24,1949,2.4585437609864806
STAT,1829,43,25-29,1872,0.5320425326486203
STAT,1909,33,20-24,1942,2.1890395965429623
STAT,1860,101,na,1961,1.1576988652387845
STAT,1832,48,50-100,1880,0.17380669997313195
SIM,1862,43,35-39,1905,5
SIM,1949,19,30-34,1968,14
STAT,1896,34,25-29,1930,12.678733765718764
SIM,1930,15,35-39,1945,4
SIM,1938,20,na,1958,3355
STAT,1876,29,50-100,1905,0.6194045862926039
STAT,1917,42,50-100,1959,0.1158147929304055
STAT,1864,50,40-44,1914,0.009016340819257106
SIM,1889,25,45-49,1914,2
STAT,1802,100,na,1902,0.3621670052511384
SIM,1875,43,45-49,1918,1
SIM,1919,36,35-39,1955,7
STAT,1877,22,20-24,1899,67.55608776722056
STAT,1934,18,na,1952,4690.819701659276
STAT,1874,49,20-24,1923,0.01134446406644472
SIM,1872,45,na,1917,2129
SIM,1927,18,40-44,1945,1
SIM,1821,42,35-39,1863,4
STAT,1871,53,50-100,1924,0.013917277945252177
STAT,1909,20,15-19,1929,4.70046201479949
STAT,1805,86,na,1891,74.2904631079
STAT,1847,47,50-100,1894,0.1798672266913532
STAT,1826,32,na,1858,1595.3167684818193
STAT,1889,44,35-39,1933,2.0833947139271287
STAT,1860,47,50-100,1907,0.18768269084194433
SIM,1939,6,na,1945,3718
STAT,1852,48,30-34,1900,0.07262185570346733
STAT,1827,35,15-19,1862,0.05898303003869841
STAT,1847,27,40-44,1874,2.6492181888225854
STAT,1915,38,50-100,1953,0.39865667011518463
SIM,1880,64,na,1944,1835
STAT,1766,105,na,1871,0.0187182380247311
STAT,1861,27,15-19,1888,0.35850488126676977
STAT,1880,33,35-39,1913,10.023807910594746
STAT,1893,62,na,1955,2190.7478152144345
SIM,1968,2,na,1970,4481
STAT,1901,29,35-39,1930,12.66746372257848
SIM,1917,33,20-24,1950,1
STAT,1933,21,45-49,1954,1.414210564780171
SIM,1818,81,na,1899,196
SIM,1941,21,45-49,1962,1
STAT,1792,105,na,1897,0.004937628696141253
STAT,1836,18,50-100,1854,0.0803511668792286
STAT,1871,48,40-44,1919,0.15832160846544602
STAT,1919,18,40-44,1937,1.456381540649183
SIM,1873,35,35-39,1908,21
SIM,1890,32,30-34,1922,19
SIM,1855,27,40-44,1882,3
STAT,1865,35,35-39,1900,6.129376691964351
SIM,1884,44,25-29,1928,3
SIM,1837,23,30-34,1860,17
SIM,1952,16,25-29,1968,59
STAT,1847,52,30-34,1899,0.0043565026351680735
STAT,1815,50,45-49,1865,0.03513411503992435
SIM,1869,41,na,1910,2126
STAT,1909,18,50-100,1927,0.0692079952709226
STAT,1870,39,35-39,1909,6.481293090347324
SIM,1918,16,na,1934,3964
STAT,1898,22,40-44,1920,2.66483086701414
STAT,1922,20,30-34,1942,31.32477494027186
STAT,1834,101,na,1935,0.353191115494375
STAT,1884,40,40-44,1924,2.1209759594396242
SIM,1842,47,na,1889,1534
STAT,1826,64,na,1890,948.8258155721496
SIM,1851,67,na,1918,1148
STAT,1822,40,50-100,1862,1.681058162303949
STAT,1880,28,na,1908,2363.850191632737
SIM,1839,43,na,1882,1654
SIM,1956,4,na,1960,4773
STAT,1843,50,20-24,1893,5.400263819791672E-4
SIM,1863,33,25-29,1896,11
SIM,1793,72,na,1865,456
STAT,1845,53,50-100,1898,0.010467289006422437
STAT,1831,24,25-29,1855,59.40976379292828
STAT,1910,44,25-29,1954,0.06295345070999243
SIM,1890,41,45-49,1931,6
SIM,1797,86,na,1883,73
STAT,1882,41,45-49,1923,1.382011697638826
SIM,1843,39,40-44,1882,7
STAT,1868,38,40-44,1906,3.928822901764803
STAT,1913,44,50-100,1957,0.10784357708189843
STAT,1920,29,45-49,1949,1.7776279757538977
STAT,1835,39,40-44,1874,3.307258418865994
STAT,1801,72,na,1873,572.944782679726
STAT,1858,30,50-100,1888,0.6937741793030457
STAT,1889,57,na,1946,2343.776374908926
SIM,1876,38,40-44,1914,7
STAT,1858,17,15-19,1875,5.141231467198407
STAT,1867,43,45-49,1910,1.317930846799688
SIM,1917,20,15-19,1937,5
SIM,1876,59,na,1935,1890
SIM,1834,28,na,1862,1705
SIM,1840,19,20-24,1859,16
SIM,1935,24,25-29,1959,136
STAT,1928,33,30-34,1961,18.6008739690617
SIM,1892,40,40-44,1932,6
STAT,1885,43,na,1928,2159.5773410530132
SIM,1839,31,40-44,1870,4
STAT,1866,102,na,1968,1.7792269610253302
STAT,1874,36,15-19,1910,0.05447995902682414
SIM,1936,33,30-34,1969,12
STAT,1856,62,na,1918,1352.3272841561527
STAT,1916,49,50-100,1965,0.21786578543206403
SIM,1821,69,na,1890,795
STAT,1903,15,25-29,1918,7.6516566492332805
STAT,1838,22,50-100,1860,0.3608437358130656
STAT,1903,6,na,1909,3511.0945612396663
STAT,1848,31,40-44,1879,3.681487261618707
STAT,1818,100,na,1918,0.5118440430978531
STAT,1850,24,35-39,1874,4.860313961163273
SIM,1912,59,na,1971,2999
STAT,1870,25,15-19,1895,0.4228278721743221
STAT,1890,40,40-44,1930,2.624188856160615
SIM,1822,32,25-29,1854,15
STAT,1838,29,40-44,1867,2.561721311780994
STAT,1776,88,na,1864,36.84375999700331
STAT,1921,11,na,1932,4273.408902738851
SIM,1835,37,40-44,1872,3
STAT,1814,79,na,1893,288.44799582719247
SIM,1945,26,35-39,1971,16
SIM,1859,63,na,1922,1491
STAT,1891,36,15-19,1927,0.06597794106698715
STAT,1837,42,20-24,1879,0.11830089512729455
STAT,1853,25,15-19,1878,0.3954428984775512
STAT,1809,49,40-44,1858,0.6020529602735731
STAT,1881,23,25-29,1904,52.054891707959094
STAT,1880,12,na,1892,2567.009997338193
STAT,1829,26,35-39,1855,17.6840499835668
STAT,1831,70,na,1901,855.6859171590988
STAT,1824,45,15-19,1869,4.835505980618997E-4
STAT,1913,56,na,1969,3260.4926178018973
SIM,1877,60,na,1937,1846
STAT,1798,99,na,1897,0.5252864667033426
STAT,1794,85,na,1879,84.42941423643651
STAT,1862,15,na,1877,2143.7032297827454
STAT,1876,44,25-29,1920,0.6178136833485989
STAT,1866,29,na,1895,2063.779175274029
SIM,1880,25,25-29,1905,42
SIM,1913,23,35-39,1936,13
STAT,1944,16,25-29,1960,44.06738060164465
STAT,1905,23,35-39,1928,7.941721267706778
SIM,1892,65,na,1957,2083
STAT,1834,27,30-34,1861,20.43939863620394
STAT,1858,53,20-24,1911,5.384759776963671E-4
STAT,1897,46,35-39,1943,0.1000572846850836
STAT,1818,37,15-19,1855,0.19031453044994237
STAT,1835,84,na,1919,207.5584695268587
STAT,1813,42,35-39,1855,6.442802358849477
SIM,1842,27,30-34,1869,22
STAT,1809,53,25-29,1862,0.012035773938095969
STAT,1839,98,na,1937,2.166036643865205
SIM,1868,25,25-29,1893,45
STAT,1894,28,40-44,1922,3.6274562000853683
STAT,1849,22,45-49,1871,0.6076862982350032
STAT,1855,29,40-44,1884,2.179739971418685
STAT,1896,37,50-100,1933,1.5328763852896894
STAT,1933,37,30-34,1970,2.3451945082737393
STAT,1855,109,na,1964,0.0029336049163710756
STAT,1830,42,35-39,1872,1.3772689907847155
SIM,1856,31,40-44,1887,3
STAT,1869,54,35-39,1923,0.007655953559660311
STAT,1818,47,40-44,1865,0.3659074708966944
SIM,1846,29,40-44,1875,5
STAT,1896,17,35-39,1913,0.6850810388772637
SIM,1867,41,45-49,1908,3
STAT,1871,51,na,1922,2026.1834574100183
STAT,1822,34,na,1856,1463.3413677892968
STAT,1826,48,na,1874,1376.6391703149322
STAT,1928,36,35-39,1964,2.8906491623573465
SIM,1906,33,45-49,1939,1
STAT,1875,53,20-24,1928,7.046798025507052E-4
SIM,1863,29,40-44,1892,3
STAT,1839,53,35-39,1892,0.005648114153360072
STAT,1844,27,15-19,1871,0.38990186599585075
STAT,1847,10,na,1857,2219.7557097622444
STAT,1875,65,na,1940,1640.1728773152533
STAT,1823,51,50-100,1874,0.017679902784111304
SIM,1873,40,30-34,1913,1
STAT,1865,40,30-34,1905,0.9968852030476907
STAT,1900,42,15-19,1942,0.0012552855764408984
SIM,1864,42,30-34,1906,1
SIM,1867,82,na,1949,359
STAT,1850,48,20-24,1898,0.008341878360809603
SIM,1904,22,30-34,1926,26
STAT,1893,78,na,1971,1382.917060766833
STAT,1926,44,50-100,1970,0.13637901138857492
SIM,1837,26,35-39,1863,9
STAT,1874,30,30-34,1904,16.993413935285194
STAT,1937,31,30-34,1968,14.731817157626727
STAT,1824,34,35-39,1858,18.192059865392896
STAT,1874,21,40-44,1895,2.018057491625608
STAT,1796,92,na,1888,12.424356551402472
STAT,1862,51,50-100,1913,0.012228597497820395
STAT,1867,30,na,1897,2133.6730584176275
STAT,1929,15,45-49,1944,0.6050926345577458
SIM,1783,94,na,1877,4
SIM,1878,44,25-29,1922,2
SIM,1854,32,na,1886,1904
STAT,1864,27,40-44,1891,2.529186844794971
STAT,1900,39,50-100,1939,0.3438074846173537
STAT,1857,21,40-44,1878,1.804557111292296
STAT,1858,1,na,1859,2750.1483278241667
STAT,1913,22,30-34,1935,26.30413558158979
SIM,1872,27,40-44,1899,3
STAT,1821,52,50-100,1873,0.022170161956062348
STAT,1885,28,15-19,1913,0.42551237157421995
STAT,1918,26,25-29,1944,66.3987526746192
STAT,1770,103,na,1873,0.037315407329823594
SIM,1779,89,na,1868,35
SIM,1921,22,30-34,1943,41
STAT,1859,41,45-49,1900,1.1334592991564856
SIM,1846,13,na,1859,2127
SIM,1865,21,40-44,1886,1
SIM,1926,31,20-24,1957,3
STAT,1838,21,30-34,1859,15.875639764428325
STAT,1855,16,35-39,1871,0.4649585782005419
STAT,1841,34,35-39,1875,8.233980496956162
SIM,1846,21,30-34,1867,24
SIM,1902,22,20-24,1924,94
STAT,1827,37,40-44,1864,4.374903809069697
STAT,1891,30,30-34,1921,20.579869793902134
STAT,1834,52,20-24,1886,4.683464757941175E-4
STAT,1863,32,20-24,1895,2.2446566978217795
STAT,1869,26,50-100,1895,0.5869656793890167
STAT,1881,50,40-44,1931,0.009740727385131789
STAT,1937,26,35-39,1963,13.829991596655013
STAT,1833,35,15-19,1868,0.04364340749635771
STAT,1891,49,20-24,1940,0.007749776834545598
STAT,1850,7,na,1857,2129.3011599174574
SIM,1852,5,na,1857,2383
STAT,1834,47,50-100,1881,0.1612255657547997
SIM,1882,30,30-34,1912,23
SIM,1900,28,30-34,1928,33
STAT,1835,37,15-19,1872,0.0433157589276756
SIM,1832,34,35-39,1866,8
STAT,1873,58,na,1931,1896.3346928694855
SIM,1840,83,na,1923,222
STAT,1875,28,30-34,1903,24.353962410878154
SIM,1909,55,na,1964,3040
SIM,1833,54,na,1887,1290
SIM,1909,31,20-24,1940,2
STAT,1907,47,30-34,1954,0.07540702765375631
STAT,1849,19,15-19,1868,5.203505365686933
STAT,1794,109,na,1903,1.2783285908888744E-4
STAT,1833,48,20-24,1881,0.007684253892058782
STAT,1788,73,na,1861,477.10367902893523
STAT,1859,11,na,1870,2098.7151980014137
SIM,1834,71,na,1905,793
STAT,1897,30,50-100,1927,1.166903654038015
STAT,1924,47,30-34,1971,0.10026931706454031
SIM,1909,23,na,1932,3283
STAT,1784,91,na,1875,14.785171331520592
STAT,1867,46,na,1913,2001.2757578004184
SIM,1838,85,na,1923,139
STAT,1861,46,30-34,1907,0.076152940971354
SIM,1926,26,25-29,1952,75
SIM,1915,23,45-49,1938,1
STAT,1854,42,20-24,1896,0.11421955102903208
SIM,1852,37,40-44,1889,2
STAT,1868,24,20-24,1892,61.76837014713129
SIM,1829,49,na,1878,1347
STAT,1817,52,20-24,1869,0.0015813764000685375
STAT,1838,33,na,1871,1817.7407048833243
STAT,1849,18,50-100,1867,0.043211347357070655
STAT,1829,39,40-44,1868,3.768402326153202
SIM,1837,39,40-44,1876,9
STAT,1873,17,40-44,1890,0.175387265703117
STAT,1881,77,na,1958,888.0966670851691
STAT,1848,43,35-39,1891,1.295129063134157
SIM,1857,19,15-19,1876,6
STAT,1939,20,25-29,1959,87.68519296539078
STAT,1884,43,20-24,1927,0.14718728855928412
STAT,1902,38,50-100,1940,0.35152863990604777
SIM,1825,35,na,1860,1544
STAT,1850,35,15-19,1885,0.041001687299533615
STAT,1891,25,35-39,1916,11.359101489475302
SIM,1856,43,35-39,1899,3
STAT,1838,16,35-39,1854,0.4972592221419255
STAT,1867,27,50-100,1894,0.5674074568565122
STAT,1840,22,25-29,1862,50.69870835941094
SIM,1898,23,45-49,1921,4
STAT,1844,37,40-44,1881,3.2473660067110113
STAT,1859,48,40-44,1907,0.12745008934950353
SIM,1848,63,na,1911,1288
STAT,1941,23,45-49,1964,1.0980173858183588
STAT,1861,9,na,1870,2196.7464542695834
STAT,1873,51,45-49,1924,0.013982657801663318
SIM,1857,38,30-34,1895,9
STAT,1826,45,25-29,1871,0.05532076611742209
SIM,1818,97,na,1915,4
STAT,1947,20,na,1967,3901.8636847358644
STAT,1885,31,45-49,1916,1.6479566382179405
STAT,1855,20,50-100,1875,0.34230209263384787
STAT,1870,17,15-19,1887,5.545763069471161
SIM,1887,34,25-29,1921,12
STAT,1944,24,25-29,1968,94.1500350482894
STAT,1908,16,15-19,1924,8.334909491433107
SIM,1805,90,na,1895,19
STAT,1869,40,15-19,1909,0.012755639564538441
STAT,1836,29,30-34,1865,20.282272738269526
SIM,1904,24,na,1928,3100
STAT,1876,38,15-19,1914,0.054493404907040174
SIM,1908,38,na,1946,3241
STAT,1928,41,30-34,1969,0.1542033321529863
STAT,1855,29,na,1884,1736.5678953452084
SIM,1901,59,na,1960,2666
STAT,1942,16,15-19,1958,44.81457060423394
SIM,1878,27,35-39,1905,10
STAT,1874,44,15-19,1918,0.013153844309085483
STAT,1827,105,na,1932,0.016271486574600435
STAT,1865,33,50-100,1898,0.7832270367415823
STAT,1851,15,na,1866,2070.8903697118876
SIM,1868,17,25-29,1885,8
STAT,1926,33,20-24,1959,2.7848477415478605
SIM,1826,40,45-49,1866,4
STAT,1856,42,30-34,1898,0.8495853473158909
STAT,1893,36,25-29,1929,3.4676619488761338
STAT,1840,39,50-100,1879,0.9904950135270308
SIM,1880,31,35-39,1911,13
SIM,1881,81,na,1962,607
STAT,1906,22,na,1928,3253.382289341969
SIM,1889,61,na,1950,2136
SIM,1888,60,na,1948,2077
STAT,1926,21,50-100,1947,0.7575427354338111
SIM,1836,78,na,1914,473
SIM,1893,31,45-49,1924,3
SIM,1931,27,20-24,1958,22
SIM,1913,44,na,1957,3296
STAT,1856,46,na,1902,1669.3698986919594
SIM,1838,26,na,1864,1739
SIM,1879,28,40-44,1907,2
STAT,1809,47,15-19,1856,0.0014591188638026708
STAT,1866,19,15-19,1885,5.243170871169332
STAT,1867,54,25-29,1921,0.003055370613362613
SIM,1861,27,40-44,1888,3
SIM,1928,31,30-34,1959,29
STAT,1921,40,50-100,1961,0.12535966843623933
SIM,1943,26,25-29,1969,73
STAT,1863,46,40-44,1909,0.14257044332752955
STAT,1853,27,40-44,1880,2.5735475276166246
STAT,1882,35,35-39,1917,6.563531785125544
SIM,1918,24,25-29,1942,98
SIM,1934,21,50-100,1955,4
STAT,1919,43,30-34,1962,0.1306748354069318
STAT,1811,50,na,1861,1257.5706003627356
SIM,1862,67,na,1929,1347
STAT,1812,72,na,1884,593.4539078980793
SIM,1831,29,20-24,1860,11
SIM,1882,25,35-39,1907,8
SIM,1863,21,30-34,1884,17
STAT,1896,43,na,1939,2874.7057121095636
STAT,1818,40,45-49,1858,3.8846149780071975
SIM,1831,47,na,1878,1467
STAT,1844,49,35-39,1893,0.09622924714663261
STAT,1815,44,35-39,1859,4.633713364094577
STAT,1935,26,25-29,1961,84.79329101987075
STAT,1935,35,na,1970,4978.154096077098
SIM,1876,75,na,1951,967
STAT,1884,51,20-24,1935,6.92173071629651E-4
SIM,1823,44,35-39,1867,4
SIM,1859,24,20-24,1883,54
STAT,1928,15,50-100,1943,0.4480842829755725
STAT,1815,64,na,1879,885.186743975785
SIM,1950,16,15-19,1966,41
STAT,1819,78,na,1897,390.1873873482678
STAT,1885,27,na,1912,2246.1464150197567
STAT,1897,18,40-44,1915,0.23047709819252807
SIM,1924,21,45-49,1945,2
SIM,1840,42,45-49,1882,6
SIM,1844,21,20-24,1865,71
STAT,1878,89,na,1967,271.1062218574645
STAT,1871,52,25-29,1923,0.0032995895582690047
STAT,1837,32,na,1869,1715.2912439709305
STAT,1966,4,na,1970,4639.0996496003245
STAT,1859,106,na,1965,0.058046899526615334
STAT,1916,26,15-19,1942,0.6919048576590804
STAT,1885,38,40-44,1923,4.099580018863126
SIM,1836,19,30-34,1855,1
STAT,1798,106,na,1904,0.003367641594408768
STAT,1857,49,20-24,1906,0.008750411710801376
SIM,1824,39,30-34,1863,7
STAT,1855,21,30-34,1876,14.844400192513232
STAT,1904,2,na,1906,3611.497693470524
SIM,1843,32,na,1875,1836
STAT,1875,17,15-19,1892,5.759707173709441
STAT,1761,114,na,1875,1.8567721574359948E-4
STAT,1800,87,na,1887,59.28797108721531
SIM,1813,66,na,1879,791
SIM,1906,30,40-44,1936,4
STAT,1895,30,15-19,1925,0.17697132746185062
STAT,1918,34,25-29,1952,9.198720120091485
STAT,1865,41,45-49,1906,1.2905963686694453
SIM,1873,41,45-49,1914,4
SIM,1860,35,25-29,1895,5
STAT,1884,30,50-100,1914,0.8622270545122157
STAT,1773,101,na,1874,0.0917630371868194
STAT,1846,43,25-29,1889,0.4524149721553318
STAT,1852,35,25-29,1887,2.24555767157099
STAT,1825,45,50-100,1870,0.26471548560560826
STAT,1923,27,20-24,1950,19.80016589772655
SIM,1897,37,na,1934,2995
STAT,1872,16,35-39,1888,0.5250914830972839
SIM,1928,22,40-44,1950,5
SIM,1769,90,na,1859,10
SIM,1898,39,30-34,1937,2
SIM,1893,38,40-44,1931,6
SIM,1820,38,35-39,1858,11
STAT,1910,41,20-24,1951,0.015853573284374388
SIM,1847,78,na,1925,514
STAT,1832,42,45-49,1874,1.1102760322610934
SIM,1873,30,na,1903,2307
SIM,1890,58,na,1948,2327
SIM,1916,16,15-19,1932,8
STAT,1889,41,30-34,1930,1.346892794570354
STAT,1839,45,35-39,1884,0.09757816357951402
STAT,1765,111,na,1876,0.0011206728221786737
STAT,1844,30,45-49,1874,1.4946334411744695
SIM,1843,64,na,1907,1230
SIM,1822,70,na,1892,765
SIM,1846,37,40-44,1883,8
STAT,1830,53,na,1883,1308.6305788737668
SIM,1874,22,45-49,1896,2
SIM,1892,30,50-100,1922,2
STAT,1924,31,45-49,1955,1.7354915628430645
STAT,1820,48,35-39,1868,0.22747710897980628
STAT,1881,20,20-24,1901,63.233163614120414
SIM,1838,27,40-44,1865,2
SIM,1844,29,30-34,1873,22
STAT,1842,43,50-100,1885,0.7684407074661677
STAT,1872,25,25-29,1897,40.382426271520366
SIM,1852,30,45-49,1882,1
SIM,1859,49,50-100,1908,1
STAT,1836,21,20-24,1857,57.84748044336699
STAT,1838,37,40-44,1875,3.6026162285690817
STAT,1880,30,30-34,1910,17.494432967614582
SIM,1840,99,na,1939,1
STAT,1916,21,45-49,1937,1.1171460934526318
STAT,1821,49,na,1870,1367.2484004370206
STAT,1873,43,45-49,1916,1.4247735935286114
STAT,1852,32,45-49,1884,1.3717839076596605
SIM,1913,20,30-34,1933,25
STAT,1888,40,25-29,1928,0.7238850661156642
STAT,1831,30,35-39,1861,8.517380526180823
STAT,1897,43,30-34,1940,0.100136543442758
STAT,1876,82,na,1958,551.7816400311622
SIM,1895,20,15-19,1915,3
STAT,1906,40,40-44,1946,0.2170303722761223
SIM,1911,15,25-29,1926,11
STAT,1929,24,35-39,1953,11.178891341157547
STAT,1861,49,35-39,1910,0.1075336341609754
SIM,1863,52,na,1915,1851
STAT,1866,22,45-49,1888,0.6123185963862244
STAT,1922,23,35-39,1945,10.169915951883452
STAT,1876,41,20-24,1917,0.15558407672006477
STAT,1856,45,35-39,1901,0.10461785824662385
SIM,1901,43,na,1944,3097
STAT,1817,71,na,1888,636.6655569668861
STAT,1851,22,50-100,1873,0.35711138117559343
SIM,1863,30,20-24,1893,1
STAT,1826,53,25-29,1879,0.00313318246572288
STAT,1898,49,30-34,1947,0.06837016354975112
STAT,1845,25,50-100,1870,0.5564065589481222
SIM,1850,29,30-34,1879,18
STAT,1780,77,na,1857,271.6536753067949
STAT,1862,31,na,1893,1930.8382359473896
SIM,1932,31,45-49,1963,2
STAT,1831,103,na,1934,0.08752479493836314
STAT,1918,23,na,1941,3709.147606952709
STAT,1939,33,na,1972,3642.806047672647
SIM,1854,35,25-29,1889,5
STAT,1880,38,40-44,1918,4.329648787154105
SIM,1832,40,45-49,1872,1
STAT,1820,37,30-34,1857,12.165348094064187
STAT,1848,34,45-49,1882,1.3058012329362383
STAT,1893,44,25-29,1937,0.052728058310884875
STAT,1876,23,na,1899,2299.3992535537373
SIM,1887,38,40-44,1925,5
STAT,1825,47,na,1872,1457.467514785656
STAT,1840,52,45-49,1892,0.010052884518859072
STAT,1821,33,na,1854,1501.939470821225
SIM,1853,25,50-100,1878,1
STAT,1905,20,30-34,1925,24.46162117035128
STAT,1809,50,20-24,1859,0.002663677350133467
SIM,1848,24,45-49,1872,4
STAT,1832,50,45-49,1882,0.00952194993404675
STAT,1884,58,na,1942,1846.1657981953065
STAT,1819,48,50-100,1867,0.4302480107108742
STAT,1858,50,40-44,1908,0.0079198153767069
STAT,1866,16,50-100,1882,0.04405821801849896
STAT,1823,99,na,1922,0.9966249799721714
SIM,1900,36,30-34,1936,3
STAT,1931,29,20-24,1960,22.24169566993229
STAT,1794,69,na,1863,651.2956158757235
STAT,1908,40,50-100,1948,0.10381980387154854
SIM,1856,40,30-34,1896,1
STAT,1879,38,40-44,1917,4.30104717868156
STAT,1849,27,15-19,1876,0.3876570164145681
SIM,1909,22,30-34,1931,29
STAT,1892,24,15-19,1916,3.8783358111954986
SIM,1860,32,45-49,1892,1
SIM,1849,17,15-19,1866,3
SIM,1871,32,20-24,1903,3
SIM,1945,23,30-34,1968,34
SIM,1872,23,25-29,1895,57
STAT,1824,40,45-49,1864,1.9920374089736954
STAT,1859,38,15-19,1897,0.04212631438497377
SIM,1825,29,20-24,1854,9
STAT,1848,11,na,1859,2141.697336560756
STAT,1924,39,30-34,1963,2.0261485365638183
STAT,1937,23,30-34,1960,26.42802958854051
SIM,1932,39,30-34,1971,5
STAT,1869,51,30-34,1920,0.005469274061096174
SIM,1782,72,na,1854,473
SIM,1786,86,na,1872,54
SIM,1825,51,na,1876,1256
SIM,1829,65,na,1894,923
SIM,1833,86,na,1919,118
SIM,1926,34,25-29,1960,14
STAT,1913,30,30-34,1943,14.923882930777783
SIM,1950,17,na,1967,4003
STAT,1887,36,25-29,1923,3.056502454380258
STAT,1925,41,na,1966,4254.393101658244
STAT,1864,97,na,1961,10.523731994560091
STAT,1874,24,45-49,1898,0.6690710788203494
STAT,1891,31,45-49,1922,2.047395918358972
STAT,1905,53,na,1958,2944.8503776517873
STAT,1816,39,30-34,1855,18.439343077645518
SIM,1865,59,na,1924,1651
STAT,1848,40,30-34,1888,0.8486986758238447
SIM,1908,18,30-34,1926,3
SIM,1861,45,na,1906,1966
STAT,1826,42,45-49,1868,1.474446050208196
SIM,1861,39,35-39,1900,6
SIM,1883,29,na,1912,2230
STAT,1918,23,20-24,1941,112.9409375575436
STAT,1862,5,na,1867,2320.745222505285
STAT,1847,24,50-100,1871,0.3625660092732643
SIM,1831,79,na,1910,372
SIM,1872,61,na,1933,1786
STAT,1860,17,30-34,1877,1.411328338519945
SIM,1870,19,30-34,1889,3
SIM,1851,19,20-24,1870,14
STAT,1862,19,30-34,1881,1.3229096563621938
SIM,1810,85,na,1895,96
SIM,1960,8,na,1968,4667
SIM,1856,34,45-49,1890,2
STAT,1866,34,15-19,1900,0.12297357977074763
STAT,1795,103,na,1898,0.02772420293182152
STAT,1888,15,35-39,1903,0.6152101130498447
SIM,1830,31,20-24,1861,2
STAT,1825,33,15-19,1858,0.22786659642628562
STAT,1833,34,na,1867,1658.8055859849958
STAT,1852,43,25-29,1895,0.48436872549117116
SIM,1921,30,30-34,1951,25
STAT,1837,48,na,1885,1455.5029791799432
STAT,1878,33,50-100,1911,0.8972814279399278
STAT,1943,20,15-19,1963,5.353742610837998
SIM,1926,23,20-24,1949,111
SIM,1898,20,40-44,1918,3
STAT,1829,40,20-24,1869,0.13778819246409105
SIM,1934,33,20-24,1967,3
STAT,1843,19,20-24,1862,16.153201031805573
STAT,1846,35,25-29,1881,2.1644207224096648
SIM,1937,24,35-39,1961,8
SIM,1904,25,35-39,1929,18
STAT,1896,31,20-24,1927,3.388647702068196
SIM,1831,26,40-44,1857,2
STAT,1833,43,15-19,1876,0.010053220281342527
STAT,1874,33,35-39,1907,9.736738386882902
SIM,1948,15,20-24,1963,141
STAT,1868,27,25-29,1895,38.15491010381208
STAT,1937,34,35-39,1971,8.52884783352435
SIM,1881,43,45-49,1924,2
STAT,1854,45,25-29,1899,0.04189093924134102
STAT,1870,20,45-49,1890,0.6493406626125975
SIM,1949,20,na,1969,3989
STAT,1830,51,25-29,1881,0.002328989870953676
STAT,1901,27,50-100,1928,0.8458568999336914
STAT,1842,29,30-34,1871,21.858724839363514
STAT,1879,17,35-39,1896,0.5418130112521173
STAT,1830,69,na,1899,876.639206850898
STAT,1867,46,25-29,1913,0.05123628478823207
STAT,1900,34,15-19,1934,0.18504008579819098
SIM,1815,42,35-39,1857,2
STAT,1898,41,50-100,1939,0.09424204204158002
SIM,1842,19,30-34,1861,1
STAT,1924,20,40-44,1944,3.77082815148498
STAT,1893,33,45-49,1926,2.081352676658175
SIM,1871,23,30-34,1894,20
SIM,1940,30,40-44,1970,5
STAT,1872,31,35-39,1903,9.641749258676208
SIM,1882,33,35-39,1915,7
STAT,1806,52,45-49,1858,0.04097608715633768
STAT,1862,18,50-100,1880,0.04494958670414076
STAT,1867,14,na,1881,2357.2414037140998
STAT,1872,39,45-49,1911,1.8712043795351145
STAT,1948,24,45-49,1972,1.219722107383864
STAT,1890,17,40-44,1907,0.21125797327382986
STAT,1881,53,45-49,1934,0.013024870234336879
SIM,1859,32,20-24,1891,2
STAT,1868,36,15-19,1904,0.05089390685517494
SIM,1932,20,40-44,1952,5
STAT,1880,49,45-49,1929,0.2296857006659122
STAT,1895,26,50-100,1921,0.7913189513123897
STAT,1852,96,na,1948,6.523904946416163
STAT,1841,31,30-34,1872,14.64509476507536
SIM,1873,46,na,1919,2184
STAT,1883,8,na,1891,2406.834365967695
SIM,1880,39,45-49,1919,3
SIM,1813,50,na,1863,1248
STAT,1849,38,30-34,1887,3.890275447838272
STAT,1906,38,na,1944,3250.274924529131
STAT,1863,23,30-34,1886,14.978021794528122
STAT,1932,30,40-44,1962,4.920154803293168
SIM,1888,76,na,1964,1324
STAT,1905,39,20-24,1944,0.22484984819148424
SIM,1792,71,na,1863,510
SIM,1796,85,na,1881,83
SIM,1885,31,na,1916,2256
SIM,1918,21,20-24,1939,108
STAT,1901,38,25-29,1939,0.817658652315275
STAT,1855,37,40-44,1892,3.100308548220435
STAT,1844,23,20-24,1867,59.96840422963874
STAT,1893,38,15-19,1931,0.06697391059901334
STAT,1872,22,20-24,1894,65.34298559915204
SIM,1915,20,40-44,1935,4
STAT,1886,40,15-19,1926,0.013923009234659833
STAT,1895,41,30-34,1936,0.09886629789076273
SIM,1852,33,25-29,1885,12
SIM,1863,47,50-100,1910,3
SIM,1939,25,20-24,1964,17
SIM,1788,66,na,1854,735
STAT,1762,108,na,1870,9.383704625590967E-4
SIM,1852,52,na,1904,1643
SIM,1951,20,15-19,1971,4
SIM,1948,19,na,1967,3747
SIM,1904,40,na,1944,3128
STAT,1883,20,30-34,1903,16.59020664561665
STAT,1850,30,45-49,1880,1.440878584678551
SIM,1828,36,35-39,1864,8
SIM,1908,54,na,1962,2978
STAT,1910,11,na,1921,3701.2403124655507
SIM,1854,41,35-39,1895,2
STAT,1854,44,na,1898,1641.845342362181
STAT,1808,52,50-100,1860,0.05492991216347957
STAT,1893,33,20-24,1926,3.2262569983382754
SIM,1895,27,35-39,1922,18
STAT,1918,17,35-39,1935,0.8656259287874474
STAT,1887,27,35-39,1914,10.194059352543817
STAT,1830,104,na,1934,0.03984336790254662
STAT,1829,34,35-39,1863,9.38416823487786
STAT,1949,17,15-19,1966,49.86716336429979
SIM,1812,49,na,1861,1274
STAT,1860,24,50-100,1884,0.3181279453162046
STAT,1791,93,na,1884,6.604357490152037
STAT,1834,52,45-49,1886,0.009210813674398
SIM,1850,37,30-34,1887,5
STAT,1853,17,15-19,1870,5.294248083929817
STAT,1867,6,na,1873,2485.9346595874904
SIM,1901,19,35-39,1920,3
STAT,1835,40,20-24,1875,0.12181024118108001
STAT,1839,42,30-34,1881,0.8079276905291451
STAT,1901,15,15-19,1916,7.883638204660891
SIM,1833,70,na,1903,872
SIM,1891,20,30-34,1911,23
SIM,1861,17,15-19,1878,6
SIM,1828,59,na,1887,1082
STAT,1850,30,na,1880,1790.7489933937632
STAT,1899,29,30-34,1928,32.3678224229771
SIM,1881,65,na,1946,1409
SIM,1889,45,na,1934,2659
SIM,1865,33,35-39,1898,10
STAT,1894,17,25-29,1911,6.886323232587007
STAT,1835,45,15-19,1880,2.965880191075585E-4
STAT,1842,38,20-24,1880,0.6372858304211275
SIM,1840,67,na,1907,1041
SIM,1882,22,30-34,1904,23
SIM,1803,72,na,1875,500
SIM,1840,48,50-100,1888,1
STAT,1826,42,20-24,1868,0.156457945578161
SIM,1852,23,20-24,1875,59
STAT,1774,100,na,1874,0.19691511253311297
STAT,1863,80,na,1943,513.6907622870982
STAT,1826,47,15-19,1873,3.7400245984985304E-4
STAT,1835,48,30-34,1883,0.0628519562236751
STAT,1891,28,na,1919,2780.754840476867
STAT,1806,71,na,1877,605.5605379625706
SIM,1928,25,45-49,1953,3
STAT,1870,52,30-34,1922,0.005480760408365288
STAT,1864,23,25-29,1887,48.757709983366176
STAT,1795,70,na,1865,639.4627802700417
STAT,1857,33,35-39,1890,7.5103124401971595
STAT,1865,32,30-34,1897,14.988204209712286
SIM,1836,36,50-100,1872,1
STAT,1799,84,na,1883,112.6357738599239
STAT,1882,33,45-49,1915,1.5962439765387808
STAT,1910,16,30-34,1926,2.2865247662971084
STAT,1862,105,na,1967,0.18324858996048496
SIM,1893,50,na,1943,2719
STAT,1945,1,na,1946,4260.6868635856845
SIM,1897,64,na,1961,2314
STAT,1815,42,45-49,1857,4.223499965765363
SIM,1902,25,25-29,1927,63
SIM,1835,30,45-49,1865,1
SIM,1860,32,20-24,1892,2
STAT,1927,15,35-39,1942,4.952295854410201
SIM,1824,34,na,1858,1554
SIM,1871,30,30-34,1901,19
STAT,1843,17,30-34,1860,1.4695003608063457
STAT,1874,43,na,1917,2215.4544672080174
STAT,1855,24,35-39,1879,4.759169867778515
STAT,1940,19,20-24,1959,129.9415759724332
STAT,1829,47,40-44,1876,0.13814042640046456
STAT,1894,21,45-49,1915,0.8499576774249575
STAT,1887,42,35-39,1929,1.9107631008405168
SIM,1907,21,45-49,1928,1
STAT,1797,107,na,1904,0.0011482644852264497
STAT,1853,16,25-29,1869,5.085274457402632
STAT,1878,57,na,1935,1976.37668025084
STAT,1862,17,40-44,1879,0.1688060990934262
STAT,1920,49,15-19,1969,3.824444984818932E-4
STAT,1861,22,45-49,1883,0.5619877776047596
STAT,1854,52,25-29,1906,0.0025370049680905277
SIM,1851,17,30-34,1868,2
STAT,1939,31,40-44,1970,3.7737745741012474
STAT,1842,37,30-34,1879,4.452125640940929
SIM,1844,24,25-29,1868,55
SIM,1875,27,50-100,1902,3
SIM,1906,31,50-100,1937,4
SIM,1879,24,na,1903,2306
STAT,1847,19,40-44,1866,0.1659937841235889
STAT,1879,50,25-29,1929,0.0035477576621910033
SIM,1894,16,15-19,1910,8
STAT,1909,24,30-34,1933,25.070546755242024
SIM,1893,34,25-29,1927,13
STAT,1946,20,40-44,1966,3.537244802271151
SIM,1855,33,na,1888,1931
STAT,1870,66,na,1936,1517.1816878701875
SIM,1824,66,na,1890,864
STAT,1885,34,25-29,1919,9.557592859007746
STAT,1823,51,30-34,1874,0.006968300463855807
STAT,1861,35,15-19,1896,0.04447030970125264
SIM,1845,43,35-39,1888,4
STAT,1933,26,15-19,1959,0.8859256668593485
STAT,1924,9,na,1933,4478.801969919504
STAT,1876,49,30-34,1925,0.09243362405211802
SIM,1862,6,na,1868,2484
STAT,1910,48,40-44,1958,0.13853670444321656
STAT,1837,43,35-39,1880,1.3317160228400424
STAT,1831,38,45-49,1869,1.5558986845184766
STAT,1868,31,na,1899,2161.1938218705163
SIM,1847,42,30-34,1889,4
STAT,1836,24,25-29,1860,47.0262374667633
STAT,1876,30,40-44,1906,4.263402744453478
STAT,1853,39,35-39,1892,5.192542008183407
SIM,1914,27,20-24,1941,17
SIM,1914,40,40-44,1954,1
STAT,1887,20,15-19,1907,3.506203341779703
STAT,1827,30,45-49,1857,2.2195153994068573
STAT,1842,51,40-44,1893,0.0075327413835255775
STAT,1858,10,na,1868,2094.028150159935
STAT,1815,48,na,1863,1282.835017322382
SIM,1870,81,na,1951,431
STAT,1854,40,30-34,1894,0.8362229587279294
SIM,1863,24,35-39,1887,9
STAT,1816,70,na,1886,755.5765703725152
STAT,1841,32,45-49,1873,1.4475966926989527
STAT,1853,65,na,1918,1253.2894378831545
SIM,1846,49,50-100,1895,3
SIM,1903,27,45-49,1930,1
STAT,1856,50,30-34,1906,0.004467546596375238
SIM,1874,95,na,1969,41
SIM,1866,76,na,1942,742
STAT,1827,29,40-44,1856,4.334496830788132
STAT,1818,43,25-29,1861,1.4816999478332786
SIM,1884,30,40-44,1914,4
STAT,1924,35,na,1959,4198.612809070023
SIM,1891,64,na,1955,2017
STAT,1899,19,na,1918,3252.14907544951
STAT,1821,53,25-29,1874,0.005096959437643835
SIM,1933,21,na,1954,4596
SIM,1917,24,30-34,1941,35
STAT,1855,30,20-24,1885,1.990164337464162
STAT,1949,16,25-29,1965,47.63002787253231
STAT,1920,42,na,1962,3875.1377057689797
SIM,1867,33,45-49,1900,1
STAT,1875,53,45-49,1928,0.013858702257555536
STAT,1919,46,35-39,1965,0.1324362983221115
STAT,1867,48,15-19,1915,3.5034182109512435E-4
SIM,1835,29,40-44,1864,3
STAT,1876,48,40-44,1924,0.1648658190434587
SIM,1830,40,50-100,1870,3
STAT,1816,86,na,1902,103.39354639652987
STAT,1852,32,20-24,1884,2.1263707404939964
SIM,1861,16,25-29,1877,7
STAT,1882,46,15-19,1928,3.68743686500201E-4
STAT,1906,27,20-24,1933,16.137890682619304
STAT,1917,30,15-19,1947,0.12813857105137483
STAT,1843,49,40-44,1892,0.12093430155435954
STAT,1838,33,25-29,1871,8.590971200278569
STAT,1853,16,50-100,1869,0.04396489998026479
STAT,1936,20,na,1956,3299.8943767865717
STAT,1912,19,45-49,1931,0.09489243487483433
SIM,1872,49,50-100,1921,4
STAT,1836,26,na,1862,1780.4066927878125
STAT,1862,51,20-24,1913,5.974885007483342E-4
STAT,1841,45,15-19,1886,2.820524318516267E-4
STAT,1864,22,50-100,1886,0.3498384899986837
STAT,1883,39,20-24,1922,0.7065205231495104
STAT,1916,21,na,1937,3625.7475753416297
SIM,1873,8,na,1881,2577
STAT,1926,41,20-24,1967,0.020599524480740393
STAT,1946,21,30-34,1967,30.225288646259532
SIM,1885,28,40-44,1913,2
SIM,1876,27,25-29,1903,41
STAT,1857,48,30-34,1905,0.07118603829722647
STAT,1806,48,50-100,1854,0.7147704251227973
SIM,1818,37,40-44,1855,4
SIM,1838,58,na,1896,1259
STAT,1836,85,na,1921,173.11288530459842
STAT,1863,38,40-44,1901,3.617107513459725
STAT,1937,20,15-19,1957,4.899747829674364
SIM,1846,33,25-29,1879,12
STAT,1920,15,25-29,1935,9.258292459653338
STAT,1863,26,35-39,1889,8.07054777761508
STAT,1880,27,50-100,1907,0.6358532255295961
STAT,1898,34,35-39,1932,12.839885496130291
SIM,1923,43,na,1966,4013
STAT,1916,49,25-29,1965,0.05109555843794038
SIM,1948,15,45-49,1963,1
SIM,1891,39,20-24,1930,1
STAT,1935,18,50-100,1953,0.4825581126092629
SIM,1903,39,na,1942,3166
STAT,1920,38,35-39,1958,2.4993849721447754
STAT,1856,17,40-44,1873,0.16001755640505802
SIM,1852,84,na,1936,218
STAT,1941,31,45-49,1972,1.5615368285502758
SIM,1856,98,na,1954,1
SIM,1885,18,15-19,1903,6
SIM,1871,38,40-44,1909,5
STAT,1897,12,na,1909,3262.7817118348717
STAT,1845,62,na,1907,1287.419721183704
STAT,1859,34,20-24,1893,2.0204546279001825
STAT,1849,76,na,1925,682.879865508417
SIM,1868,83,na,1951,303
SIM,1935,15,35-39,1950,5
STAT,1885,0,na,1885,3300.655171166514
SIM,1948,22,45-49,1970,1
SIM,1830,34,25-29,1864,15
SIM,1938,30,25-29,1968,13
STAT,1839,17,40-44,1856,0.15953440657445
STAT,1853,81,na,1934,401.03519269269935
STAT,1897,44,45-49,1941,0.12953407063239625
STAT,1921,42,35-39,1963,0.2142782403817896
STAT,1953,18,50-100,1971,0.42802188174843314
SIM,1904,27,50-100,1931,4
STAT,1845,99,na,1944,1.3340046063784803
SIM,1880,16,35-39,1896,1
STAT,1861,37,40-44,1898,3.434048785102614
STAT,1852,37,15-19,1889,0.04289618395701547
STAT,1835,47,40-44,1882,0.11259296637052366
SIM,1891,80,na,1971,1150
STAT,1891,33,50-100,1924,1.0668508968419637
STAT,1822,32,35-39,1854,30.7972410559521
SIM,1919,33,30-34,1952,20
STAT,1866,39,20-24,1905,0.6646435765979937
SIM,1921,36,na,1957,3872
STAT,1867,43,20-24,1910,0.13984964229464295
STAT,1925,27,30-34,1952,43.725060621788856
SIM,1864,40,40-44,1904,3
STAT,1801,56,na,1857,1088.3751130944834
SIM,1892,18,30-34,1910,1
STAT,1864,52,30-34,1916,0.004999046687430562
SIM,1945,20,15-19,1965,3
STAT,1817,54,50-100,1871,0.031096670762935485
STAT,1877,28,40-44,1905,2.926265310731279
STAT,1884,18,30-34,1902,1.4840420304669273
STAT,1865,50,na,1915,1874.9376182847834
STAT,1907,36,15-19,1943,0.016897690968606372
SIM,1935,1,na,1936,5265
STAT,1901,18,30-34,1919,2.102030984438768
SIM,1933,27,30-34,1960,60
SIM,1848,21,40-44,1869,2
STAT,1859,44,25-29,1903,0.4776029961878802
SIM,1830,32,35-39,1862,10
STAT,1937,17,50-100,1954,0.34427266097126397
STAT,1804,85,na,1889,92.90646989391522
STAT,1846,32,20-24,1878,2.2522420896304207
STAT,1873,52,35-39,1925,0.008211351354604164
SIM,1815,45,50-100,1860,2
SIM,1890,35,35-39,1925,13
SIM,1958,1,na,1959,4854
STAT,1862,50,30-34,1912,0.004865721462144958
SIM,1934,36,25-29,1970,1
SIM,1865,46,50-100,1911,1
SIM,1869,34,30-34,1903,25
SIM,1859,35,25-29,1894,2
SIM,1890,30,40-44,1920,5
STAT,1883,38,30-34,1921,4.910005763137764
STAT,1883,52,40-44,1935,0.009695315059360247
SIM,1871,44,na,1915,2187
STAT,1856,43,45-49,1899,1.099355786242634
STAT,1930,20,na,1950,4446.065330468389
STAT,1946,15,45-49,1961,0.5237091024269139
STAT,1846,49,45-49,1895,0.1629228552489014
SIM,1871,26,35-39,1897,11
SIM,1907,37,30-34,1944,2
STAT,1892,29,20-24,1921,13.779195073952785
STAT,1900,22,na,1922,3099.607933457556
SIM,1830,101,na,1931,1
SIM,1854,26,35-39,1880,10
STAT,1920,47,50-100,1967,0.23620561724692998
STAT,1904,36,na,1940,3232.603180374354
STAT,1882,30,40-44,1912,4.018571217720078
SIM,1939,17,45-49,1956,1
STAT,1893,32,50-100,1925,1.0982265938210343
SIM,1835,26,25-29,1861,42
STAT,1808,67,na,1875,798.9621482826819
STAT,1827,49,35-39,1876,0.11943838889395476
STAT,1846,41,35-39,1887,1.3088733803112553
STAT,1902,42,25-29,1944,0.05937548696800674
SIM,1890,40,30-34,1930,1
STAT,1867,20,35-39,1887,5.272843073091628
SIM,1899,41,40-44,1940,2
SIM,1771,93,na,1864,3
SIM,1819,66,na,1885,822
STAT,1825,63,na,1888,1029.4732787342991
SIM,1854,48,na,1902,1756
STAT,1816,47,30-34,1863,0.25487429843459264
SIM,1843,48,na,1891,1563
SIM,1902,44,na,1946,3069
STAT,1816,48,20-24,1864,0.03109508018985848
SIM,1842,47,50-100,1889,1
SIM,1876,31,45-49,1907,2
STAT,1886,18,40-44,1904,0.1820816528631207
STAT,1926,36,25-29,1962,1.1379358706258522
STAT,1879,34,25-29,1913,10.027285139471935
SIM,1815,52,na,1867,1163
SIM,1823,71,na,1894,703
SIM,1899,23,na,1922,3056
SIM,1928,30,40-44,1958,7
STAT,1825,38,20-24,1863,0.9478623122757309
SIM,1918,16,25-29,1934,12
STAT,1894,18,15-19,1912,7.192891471465961
STAT,1882,40,30-34,1922,1.0674964266599694
STAT,1861,38,30-34,1899,4.160191968586345
STAT,1924,48,20-24,1972,0.012395525462440719
SIM,1854,32,20-24,1886,2
SIM,1919,38,na,1957,3808
STAT,1878,44,35-39,1922,1.7568112608539472
STAT,1911,32,25-29,1943,8.50047512481549
SIM,1867,39,na,1906,2018
STAT,1817,44,na,1861,1317.8378845475688
SIM,1915,24,na,1939,3486
STAT,1902,49,45-49,1951,0.17376804078896085
STAT,1827,27,15-19,1854,1.2200284792795961
STAT,1861,30,20-24,1891,2.1375312668671187
STAT,1836,27,40-44,1863,2.4477422355780134
SIM,1891,38,30-34,1929,5
STAT,1843,47,15-19,1890,2.872365282282285E-4
STAT,1846,26,35-39,1872,8.289702630832052
SIM,1871,35,25-29,1906,4
STAT,1852,47,40-44,1899,0.1294666186024917
STAT,1884,42,na,1926,2154.9777175428208
STAT,1935,19,na,1954,4727.794916998167
SIM,1829,29,40-44,1858,3
SIM,1909,25,35-39,1934,15
SIM,1919,17,na,1936,3774
SIM,1844,27,40-44,1871,7
SIM,1939,32,45-49,1971,1
STAT,1800,71,na,1871,611.8918320814175
STAT,1863,104,na,1967,0.3960451228989851
STAT,1921,17,45-49,1938,0.5379646124279583
STAT,1929,21,30-34,1950,34.44119699147655
STAT,1907,23,45-49,1930,0.9645210921306995
SIM,1836,51,na,1887,1382
SIM,1886,44,35-39,1930,3
SIM,1937,21,30-34,1958,36
SIM,1852,29,40-44,1881,4
STAT,1828,53,35-39,1881,0.00624683707626236
SIM,1873,51,na,1924,2079
SIM,1901,16,30-34,1917,4
STAT,1846,84,na,1930,234.5516541630637
STAT,1883,23,35-39,1906,5.386184179519451
STAT,1904,40,30-34,1944,0.10925413866256406
SIM,1822,36,40-44,1858,5
STAT,1851,45,50-100,1896,0.18189806137986306
STAT,1878,46,25-29,1924,0.056807695906925436
STAT,1948,21,40-44,1969,3.648584270308771
STAT,1833,30,45-49,1863,1.3966448602689587
STAT,1950,17,50-100,1967,0.4185274277793737
STAT,1878,41,30-34,1919,1.1357600232190104
SIM,1939,28,25-29,1967,63
STAT,1885,39,30-34,1924,4.965603905731979
STAT,1951,17,30-34,1968,13.712525207589012
SIM,1863,25,na,1888,2081
STAT,1840,28,45-49,1868,0.9571871699332284
STAT,1844,26,25-29,1870,36.61580116590401
STAT,1905,21,na,1926,3238.4065290880353
SIM,1912,43,na,1955,3211
STAT,1927,21,20-24,1948,129.82608563802563
SIM,1837,41,35-39,1878,1
SIM,1864,49,50-100,1913,1
SIM,1828,33,30-34,1861,21
SIM,1847,62,na,1909,1273
STAT,1857,30,30-34,1887,13.357966713993456
STAT,1818,45,15-19,1863,8.818886189896321E-4
STAT,1866,24,na,1890,2047.035873937017
SIM,1935,21,20-24,1956,138
STAT,1836,47,na,1883,1486.8150905045384
STAT,1864,65,na,1929,1426.8535415963709
STAT,1909,36,25-29,1945,0.8844281830362969
STAT,1850,14,na,1864,2035.0864367822564
STAT,1910,19,35-39,1929,0.7810246391291243
STAT,1827,70,na,1897,778.6350821159201
SIM,1846,24,35-39,1870,5
STAT,1829,41,35-39,1870,1.5470869018743505
SIM,1891,23,35-39,1914,5
STAT,1844,29,40-44,1873,2.5374864161423143
SIM,1827,27,40-44,1854,2
STAT,1832,33,na,1865,1675.3119024141372
STAT,1934,30,15-19,1964,0.16593244621923897
SIM,1877,76,na,1953,856
SIM,1909,39,na,1948,3307
STAT,1821,50,20-24,1871,0.001127263394147906
STAT,1864,20,20-24,1884,59.97738340686061
STAT,1930,32,35-39,1962,11.141745178935563
SIM,1841,30,45-49,1871,2
SIM,1875,10,na,1885,2549
STAT,1833,47,30-34,1880,0.06899534882902589
STAT,1912,33,50-100,1945,0.765142900094424
SIM,1830,37,40-44,1867,7
SIM,1832,48,na,1880,1450
STAT,1795,108,na,1903,3.5385199818127394E-4
STAT,1923,42,45-49,1965,0.18378012120262144
SIM,1890,26,50-100,1916,2
SIM,1875,20,35-39,1895,8
STAT,1843,42,20-24,1885,0.11796947775904448
STAT,1865,46,15-19,1911,3.443525576375511E-4
STAT,1941,28,15-19,1969,0.6895106431275888
SIM,1817,42,45-49,1859,5
SIM,1852,26,25-29,1878,45
SIM,1900,58,na,1958,2592
STAT,1856,49,50-100,1905,0.17792383105773657
SIM,1884,33,45-49,1917,4
STAT,1851,19,30-34,1870,1.4043690277311878
STAT,1903,29,45-49,1932,1.4816184633938008
SIM,1911,29,45-49,1940,2
SIM,1829,81,na,1910,241
STAT,1876,33,45-49,1909,1.693495170717368
SIM,1905,25,na,1930,3261
STAT,1856,41,40-44,1897,1.671755901514597
SIM,1832,31,30-34,1863,20
SIM,1920,33,50-100,1953,1
STAT,1881,27,40-44,1908,2.732385571382971
SIM,1782,93,na,1875,3
STAT,1835,43,25-29,1878,0.47396550081375344
SIM,1824,32,35-39,1856,8
STAT,1822,37,40-44,1859,7.938514727175521
STAT,1882,26,50-100,1908,0.5900552622975997
STAT,1895,44,35-39,1939,0.15292792658889
SIM,1861,66,na,1927,1373
SIM,1852,30,20-24,1882,1
SIM,1952,19,na,1971,4092
STAT,1857,47,na,1904,1667.7590667046109
STAT,1934,34,na,1968,4871.795475561251
STAT,1896,32,35-39,1928,12.643968101402201
SIM,1858,43,45-49,1901,1
STAT,1838,24,35-39,1862,5.089789106917219
STAT,1939,21,50-100,1960,0.6244025890590238
STAT,1861,31,50-100,1892,0.721710613321101
STAT,1915,41,45-49,1956,0.15850351928188378
SIM,1872,29,na,1901,2203
STAT,1948,17,45-49,1965,0.5401017123473929
SIM,1891,43,na,1934,2808
STAT,1870,16,25-29,1886,5.326861687798906
SIM,1850,22,35-39,1872,3
SIM,1906,10,na,1916,3647
STAT,1848,32,na,1880,1820.7998327706096
STAT,1822,34,25-29,1856,22.632367602734902
SIM,1872,20,20-24,1892,64
STAT,1860,50,20-24,1910,5.746862331384832E-4
SIM,1871,33,35-39,1904,10
SIM,1890,79,na,1969,1175
STAT,1864,19,40-44,1883,0.15787499979946315
STAT,1818,51,50-100,1869,0.03157133840834277
SIM,1826,39,40-44,1865,5
SIM,1895,57,na,1952,2500
SIM,1893,31,20-24,1924,2
STAT,1854,43,35-39,1897,1.294537057463005
SIM,1839,34,45-49,1873,2
STAT,1911,30,20-24,1941,2.2613368185656304
STAT,1897,42,40-44,1939,0.19709535935321762
SIM,1882,28,na,1910,2135
SIM,1889,22,40-44,1911,2
STAT,1908,15,25-29,1923,7.976148576271893
STAT,1868,31,45-49,1899,1.579315381467163
SIM,1895,33,20-24,1928,7
STAT,1930,30,30-34,1960,19.230814658774882
STAT,1818,39,40-44,1857,12.148249301858586
STAT,1842,22,35-39,1864,5.241333484272086
SIM,1811,86,na,1897,80
STAT,1785,92,na,1877,11.098070799877789
STAT,1887,33,20-24,1920,2.8437208064870294
SIM,1808,82,na,1890,135
STAT,1834,99,na,1933,1.1722210876358858
STAT,1904,42,35-39,1946,0.1701546856888365
STAT,1874,31,45-49,1905,1.690596037706535
SIM,1894,15,25-29,1909,5
STAT,1860,51,na,1911,1661.0248529126882
SIM,1858,40,40-44,1898,2
STAT,1866,27,15-19,1893,0.395169937219013
SIM,1819,82,na,1901,181
SIM,1911,38,35-39,1949,6
SIM,1849,30,35-39,1879,17
STAT,1818,48,30-34,1866,0.2037066607115139
STAT,1910,34,50-100,1944,0.7464464667928467
STAT,1898,45,15-19,1943,2.9142239023147284E-4
STAT,1832,51,35-39,1883,0.005537840110678576
SIM,1893,4,na,1897,3267
STAT,1936,28,45-49,1964,1.5608871216797644
SIM,1868,24,na,1892,2121
SIM,1873,32,30-34,1905,28
STAT,1886,24,50-100,1910,0.4044774059865432
SIM,1864,10,na,1874,2437
SIM,1950,7,na,1957,4278
SIM,1887,75,na,1962,1166
STAT,1840,20,35-39,1860,5.24312547025884
SIM,1911,58,na,1969,3151
SIM,1916,15,25-29,1931,10
STAT,1818,40,20-24,1858,0.4122082857730464
SIM,1841,45,50-100,1886,1
STAT,1844,35,15-19,1879,0.04673773298289234
SIM,1815,40,45-49,1855,2
STAT,1885,31,20-24,1916,2.5544597494861865
SIM,1895,24,30-34,1919,26
STAT,1886,15,25-29,1901,5.682377584194387
STAT,1887,24,30-34,1911,18.700807396530692
SIM,1893,39,30-34,1932,12
STAT,1846,23,30-34,1869,15.384748292828519
STAT,1942,3,na,1945,3975.115937469591
STAT,1855,33,25-29,1888,7.3099611488637075
SIM,1856,41,45-49,1897,2
STAT,1861,14,na,1875,2132.988624174491
SIM,1799,66,na,1865,742
STAT,1897,41,40-44,1938,0.19823122426827483
SIM,1899,60,na,1959,2529
SIM,1859,38,40-44,1897,10
SIM,1882,31,45-49,1913,1
STAT,1840,15,na,1855,2094.3300272157876
STAT,1810,49,na,1859,1292.406843964367
STAT,1835,32,45-49,1867,1.3852015853411859
SIM,1859,47,na,1906,1881
SIM,1917,27,35-39,1944,18
STAT,1954,15,50-100,1969,0.4377634020599837
STAT,1820,41,15-19,1861,0.025696517676730608
STAT,1946,24,35-39,1970,9.892105647782918
SIM,1878,61,na,1939,1866
STAT,1923,40,40-44,1963,0.2769667806537678
SIM,1920,16,40-44,1936,2
STAT,1763,107,na,1870,0.0027500197700676336
STAT,1881,21,35-39,1902,5.338867993881645
STAT,1850,21,30-34,1871,15.159880295351654
SIM,1940,17,20-24,1957,112
STAT,1837,48,40-44,1885,0.11075913324090872
STAT,1903,38,35-39,1941,2.0416613234779826
STAT,1909,3,na,1912,3744.3298101839046
STAT,1932,17,20-24,1949,169.59699962467332
STAT,1780,93,na,1873,5.652711014234543
STAT,1915,38,15-19,1953,0.01823377931609485
SIM,1915,47,50-100,1962,1
STAT,1892,17,15-19,1909,7.020613843900257
STAT,1957,15,20-24,1972,168.92752495875706
STAT,1859,41,20-24,1900,0.12027480647219703
SIM,1876,24,20-24,1900,76
STAT,1910,43,na,1953,3294.9701071748227
STAT,1914,57,na,1971,3290.3000940250263
SIM,1844,70,na,1914,950
STAT,1841,30,40-44,1871,3.67557765741202
STAT,1907,39,30-34,1946,1.579998707244294
STAT,1912,16,40-44,1928,0.2677875329396477
STAT,1875,50,40-44,1925,0.010364313668682915
SIM,1822,38,45-49,1860,1
SIM,1833,29,30-34,1862,26
SIM,1909,34,25-29,1943,12
STAT,1870,19,40-44,1889,0.16891309274082358
SIM,1837,63,na,1900,1125
SIM,1848,84,na,1932,205
SIM,1864,43,45-49,1907,2
STAT,1862,54,25-29,1916,0.0027757969493580827
STAT,1896,38,40-44,1934,5.438344610111599
SIM,1827,85,na,1912,139
STAT,1946,19,na,1965,3854.207711801221
STAT,1968,1,na,1969,4645.084961743455
SIM,1854,23,30-34,1877,19
STAT,1909,27,35-39,1936,13.551260040952112
SIM,1868,22,20-24,1890,58
SIM,1839,40,30-34,1879,4
SIM,1929,16,na,1945,4529
STAT,1900,30,45-49,1930,2.30380575388488
SIM,1878,42,35-39,1920,2
STAT,1852,19,50-100,1871,0.04449064742333212
STAT,1914,29,20-24,1943,17.256773841520932
SIM,1908,2,na,1910,3610
STAT,1829,77,na,1906,529.8279945082189
STAT,1838,30,20-24,1868,2.3389241281581623
STAT,1842,33,15-19,1875,0.12124066201291143
STAT,1881,29,45-49,1910,1.0055179472789315
STAT,1915,4,na,1919,3977.278820330375
STAT,1858,28,30-34,1886,18.980903014647843
SIM,1768,89,na,1857,25
SIM,1908,17,na,1925,3485
STAT,1898,31,30-34,1929,22.41920302204011
STAT,1830,37,na,1867,1609.7391104592566
STAT,1832,52,35-39,1884,0.00542923822633745
STAT,1859,46,15-19,1905,3.0242577626728964E-4
STAT,1863,35,25-29,1898,2.4136313447454696
STAT,1883,57,na,1940,1860.651248693036
SIM,1890,33,45-49,1923,2
STAT,1916,17,25-29,1933,8.685416804634583
SIM,1924,17,25-29,1941,39
STAT,1845,19,30-34,1864,1.4023181513545087
SIM,1858,62,na,1920,1489
STAT,1880,42,25-29,1922,0.6375172231905478
STAT,1898,25,45-49,1923,1.4295185070155625
SIM,1846,30,20-24,1876,1
SIM,1931,40,40-44,1971,2
SIM,1807,97,na,1904,2
STAT,1820,36,40-44,1856,10.682353881061667
STAT,1860,41,45-49,1901,1.1542591988495674
SIM,1829,44,na,1873,1431
STAT,1926,42,na,1968,4325.785243274559
SIM,1957,0,na,1957,4706
STAT,1944,28,40-44,1972,4.756664846088594
STAT,1837,40,30-34,1877,0.8786229529158308
STAT,1853,20,45-49,1873,0.6198913497341582
SIM,1869,37,35-39,1906,11
SIM,1894,13,na,1907,3298
STAT,1840,51,30-34,1891,0.004165289346166423
STAT,1813,51,25-29,1864,0.010433191598535889
STAT,1935,23,20-24,1958,142.9903955318004
SIM,1941,29,30-34,1970,44
STAT,1815,40,40-44,1855,6.968547031709966
STAT,1859,49,30-34,1908,0.07145613149342656
STAT,1895,42,na,1937,2855.616005866437
STAT,1903,49,15-19,1952,2.969265704640646E-4
SIM,1865,32,na,1897,2032
STAT,1811,71,na,1882,646.3846078517624
STAT,1899,56,na,1955,2640.537672983249
SIM,1887,25,35-39,1912,10
STAT,1889,42,45-49,1931,1.7433405577909344
STAT,1913,25,35-39,1938,14.224894374662563
STAT,1922,30,35-39,1952,9.833298701229714
SIM,1898,38,na,1936,2993
STAT,1851,16,15-19,1867,5.322467525014827
SIM,1863,39,45-49,1902,1
SIM,1956,9,na,1965,4767
STAT,1896,27,na,1923,2979.6511333938215
STAT,1857,24,45-49,1881,0.5377727587160005
SIM,1823,42,45-49,1865,3
SIM,1885,37,30-34,1922,6
STAT,1827,33,na,1860,1597.0239619534457
STAT,1892,13,na,1905,3050.39037662386
SIM,1880,80,na,1960,802
STAT,1885,36,15-19,1921,0.05310589172437239
SIM,1839,70,na,1909,985
SIM,1846,77,na,1923,564
SIM,1809,45,na,1854,1340
STAT,1824,31,30-34,1855,47.27570857443571
SIM,1842,63,na,1905,1223
STAT,1922,49,25-29,1971,0.05723545503713212
STAT,1877,37,30-34,1914,5.22467558624796
STAT,1844,77,na,1921,606.8112223343729
SIM,1866,28,30-34,1894,28
SIM,1922,29,20-24,1951,19
SIM,1844,33,na,1877,1845
STAT,1891,22,30-34,1913,20.82802245537223
SIM,1848,47,na,1895,1672
SIM,1865,24,45-49,1889,2
SIM,1921,25,35-39,1946,20
STAT,1861,33,25-29,1894,8.001175977688318
STAT,1884,46,25-29,1930,0.053924555759268154
SIM,1880,22,20-24,1902,64
STAT,1840,26,40-44,1866,2.6199491446221557
SIM,1885,79,na,1964,882
SIM,1943,23,20-24,1966,109
STAT,1933,29,30-34,1962,49.10085217466433
STAT,1879,25,35-39,1904,9.5923002783445
STAT,1907,20,40-44,1927,2.908466727498147
SIM,1844,51,50-100,1895,1
SIM,1904,3,na,1907,3520
SIM,1930,30,35-39,1960,12
STAT,1816,43,15-19,1859,0.03959232372371644
STAT,1836,51,50-100,1887,0.009842897282873655
STAT,1809,52,na,1861,1231.8062357382712
STAT,1837,45,25-29,1882,0.038724912667475
SIM,1819,38,50-100,1857,4
STAT,1856,40,40-44,1896,1.68101831241601
STAT,1920,20,50-100,1940,0.6952089210634488
STAT,1935,17,35-39,1952,5.418849247605797
SIM,1887,31,20-24,1918,2
STAT,1765,106,na,1871,0.011595362138102791
STAT,1859,37,25-29,1896,2.1706974225240345
STAT,1825,29,30-34,1854,82.96321363458235
SIM,1829,25,25-29,1854,37
STAT,1902,46,40-44,1948,0.12910905338320314
SIM,1817,39,50-100,1856,3
STAT,1879,31,20-24,1910,2.679994498956013
STAT,1883,34,15-19,1917,0.13072172961922351
STAT,1876,50,na,1926,2130.064694228904
STAT,1821,51,20-24,1872,0.0011050287595543182
STAT,1888,16,25-29,1904,6.339658658094429
SIM,1865,30,30-34,1895,20
SIM,1888,43,30-34,1931,1
STAT,1846,25,na,1871,1871.975537435634
STAT,1907,47,50-100,1954,0.19132196223058723
SIM,1843,32,45-49,1875,1
SIM,1896,16,25-29,1912,10
STAT,1924,43,15-19,1967,0.0017230577777963124
SIM,1943,17,35-39,1960,4
STAT,1881,13,na,1894,2351.9689337854884
STAT,1861,42,15-19,1903,0.010820151202361827
STAT,1911,37,30-34,1948,1.662634439417951
SIM,1835,23,20-24,1858,53
STAT,1878,49,40-44,1927,0.16485169607581573
STAT,1868,28,15-19,1896,0.40778878390783424
SIM,1885,24,25-29,1909,61
SIM,1889,26,35-39,1915,14
STAT,1934,17,30-34,1951,15.5744160940626
STAT,1790,92,na,1882,10.834173047434117
SIM,1887,32,35-39,1919,12
SIM,1875,80,na,1955,581
SIM,1946,15,35-39,1961,9
STAT,1929,34,na,1963,4532.765773144112
STAT,1810,51,45-49,1861,0.05025481491912766
STAT,1882,42,35-39,1924,1.6625413112567238
STAT,1866,53,50-100,1919,0.012943122345770403
STAT,1858,30,35-39,1888,7.668137528041177
STAT,1913,21,40-44,1934,3.086537217417536
STAT,1912,39,15-19,1951,0.017523883328903787
STAT,1916,22,20-24,1938,110.06915680464485
STAT,1918,16,20-24,1934,28.036651794718242
STAT,1927,18,50-100,1945,0.43897118337429114
SIM,1935,27,40-44,1962,6
STAT,1828,36,50-100,1864,1.1922784391492907
SIM,1928,37,na,1965,4488
SIM,1924,22,20-24,1946,117
STAT,1866,26,15-19,1892,0.39652605633166726
STAT,1873,53,35-39,1926,0.008122750873487981
STAT,1784,86,na,1870,56.30008660519319
STAT,1904,43,35-39,1947,0.16913375757470347
STAT,1877,24,25-29,1901,55.76753126905988
SIM,1914,39,na,1953,3799
SIM,1928,24,30-34,1952,41
STAT,1840,25,40-44,1865,2.6388964209243935
SIM,1926,38,40-44,1964,2
STAT,1900,27,15-19,1927,0.594617796962481
STAT,1865,33,45-49,1898,1.4906579178389925
STAT,1919,28,45-49,1947,1.7572230456542692
STAT,1915,40,45-49,1955,0.1587146097128017
SIM,1841,68,na,1909,1060
STAT,1825,85,na,1910,154.99399607900415
STAT,1889,5,na,1894,3056.377337220392
SIM,1890,42,35-39,1932,2
STAT,1804,50,20-24,1854,0.002284174543078554
SIM,1848,30,30-34,1878,24
SIM,1839,32,30-34,1871,30
STAT,1933,38,20-24,1971,0.3388569943607593
STAT,1963,6,na,1969,4716.773831150459
SIM,1854,11,na,1865,2238
SIM,1917,32,30-34,1949,19
SIM,1823,40,40-44,1863,3
SIM,1907,25,25-29,1932,72
STAT,1836,63,na,1899,1126.7685576221445
STAT,1883,33,50-100,1916,0.8447417063803867
STAT,1922,38,45-49,1960,0.7321187508811481
SIM,1822,39,45-49,1861,1
SIM,1823,55,na,1878,1151
STAT,1907,48,20-24,1955,0.009273756027618981
SIM,1857,23,35-39,1880,6
SIM,1927,28,45-49,1955,1
SIM,1867,33,20-24,1900,1
SIM,1910,35,25-29,1945,4
STAT,1875,24,15-19,1899,3.1817842556894105
SIM,1824,30,45-49,1854,6
STAT,1891,20,40-44,1911,2.4511499013217066
STAT,1894,21,20-24,1915,83.99668898129035
STAT,1929,22,30-34,1951,34.3375289885322
SIM,1869,41,30-34,1910,1
SIM,1953,18,45-49,1971,1
STAT,1796,71,na,1867,645.4982637794438
SIM,1926,16,20-24,1942,144
SIM,1938,28,20-24,1966,20
STAT,1878,53,25-29,1931,0.0034274717694422773
SIM,1849,58,na,1907,1480
SIM,1930,38,45-49,1968,1
SIM,1933,15,25-29,1948,62
SIM,1890,31,40-44,1921,3
STAT,1912,42,30-34,1954,0.11645660276443023
STAT,1952,17,35-39,1969,4.750599446227201
STAT,1882,31,40-44,1913,4.002818418546616
STAT,1883,21,45-49,1904,0.6475763150543667
SIM,1930,0,na,1930,5102
STAT,1885,43,15-19,1928,0.012903635355015352
STAT,1876,45,15-19,1921,3.939909788196441E-4
SIM,1878,39,na,1917,2363
STAT,1935,0,na,1935,5817.8808423125265
STAT,1890,27,na,1917,2756.498811102408
STAT,1902,35,25-29,1937,0.8363523547633371
STAT,1865,20,25-29,1885,50.4615916470255
STAT,1911,12,na,1923,3732.6000324174825
SIM,1874,20,30-34,1894,18
STAT,1918,2,na,1920,4205.259542604012
STAT,1945,18,45-49,1963,0.5153405478140749
STAT,1853,53,50-100,1906,0.011020484217584985
SIM,1859,39,40-44,1898,4
STAT,1825,39,20-24,1864,0.9113216105212826
STAT,1905,49,25-29,1954,0.04342942347800256
SIM,1853,53,na,1906,1702
SIM,1876,31,20-24,1907,3
STAT,1902,48,45-49,1950,0.17524359183218788
STAT,1883,15,35-39,1898,0.5103921390518483
STAT,1859,36,25-29,1895,2.1811451075893866
STAT,1862,95,na,1957,14.178148127857725
STAT,1911,33,25-29,1944,8.46460311978877
STAT,1827,30,20-24,1857,3.440419862794817
SIM,1918,17,25-29,1935,51
STAT,1868,52,50-100,1920,0.013549814520742425
STAT,1886,19,40-44,1905,0.18158092831774708
SIM,1893,28,na,1921,2963
SIM,1835,50,na,1885,1437
SIM,1937,22,30-34,1959,33
STAT,1822,109,na,1931,3.674924060561518E-4
STAT,1908,44,50-100,1952,0.10139531609477813
SIM,1908,34,30-34,1942,19
SIM,1855,20,20-24,1875,59
STAT,1929,17,35-39,1946,5.059272952022671
STAT,1881,52,30-34,1933,0.005400677718815354
STAT,1817,40,50-100,1857,2.892140078617624
STAT,1879,23,20-24,1902,67.83614388308101
SIM,1838,23,25-29,1861,49
SIM,1939,25,45-49,1964,1
SIM,1919,4,na,1923,4200
STAT,1836,20,45-49,1856,0.7064549326301282
STAT,1896,37,40-44,1933,5.465453258272631
STAT,1907,16,45-49,1923,0.09085541851559786
STAT,1918,38,40-44,1956,1.4890525024849526
SIM,1864,41,40-44,1905,6
STAT,1791,106,na,1897,0.0022286149963532337
STAT,1863,30,30-34,1893,14.615329797332103
STAT,1828,34,na,1862,1600.7293924569406
SIM,1789,88,na,1877,33
SIM,1830,38,40-44,1868,6
STAT,1862,52,20-24,1914,5.914777664308057E-4
SIM,1862,30,na,1892,2078
STAT,1877,45,na,1922,2227.5455669348557
STAT,1840,68,na,1908,1064.262303886338
SIM,1791,92,na,1883,8
STAT,1822,38,40-44,1860,7.530824805052365
SIM,1907,29,30-34,1936,38
STAT,1813,42,50-100,1855,3.7588131849199926
SIM,1866,30,35-39,1896,11
STAT,1847,51,40-44,1898,0.007783187813189848
STAT,1848,41,45-49,1889,1.0907728851722274
STAT,1900,49,35-39,1949,0.10133844033150005
STAT,1924,36,15-19,1960,0.021413341691549584
STAT,1843,33,na,1876,1860.301158224954
STAT,1846,33,35-39,1879,8.350906720385856
SIM,1898,43,na,1941,2919
STAT,1813,43,25-29,1856,2.166268547065646
STAT,1815,51,35-39,1866,0.020428773254990353
SIM,1835,30,20-24,1865,3
SIM,1888,41,40-44,1929,7
STAT,1885,64,na,1949,1636.107058388816
STAT,1925,39,25-29,1964,1.1141500511462321
STAT,1898,23,30-34,1921,22.70844084319873
SIM,1826,79,na,1905,335
SIM,1827,28,40-44,1855,3
SIM,1880,20,30-34,1900,26
STAT,1948,22,40-44,1970,3.6473802374995694
STAT,1879,32,35-39,1911,9.999789867814128
SIM,1878,20,15-19,1898,3
SIM,1906,17,20-24,1923,23
STAT,1920,43,50-100,1963,0.12238562339563441
STAT,1880,34,25-29,1914,10.093965757397562
SIM,1793,93,na,1886,4
SIM,1942,17,30-34,1959,13
SIM,1889,31,30-34,1920,22
SIM,1909,37,40-44,1946,1
STAT,1905,22,45-49,1927,0.9519523251246825
SIM,1913,22,45-49,1935,1
STAT,1830,40,20-24,1870,0.12418240652556882
STAT,1916,22,50-100,1938,0.6513353954091686
STAT,1930,33,35-39,1963,11.134837296924626
SIM,1937,17,35-39,1954,4
STAT,1847,20,20-24,1867,63.06174399619249
SIM,1837,33,35-39,1870,10
STAT,1839,30,25-29,1869,8.580830993049236
STAT,1853,20,20-24,1873,61.26048659688643
STAT,1874,22,30-34,1896,17.198321008932147
STAT,1861,30,na,1891,1887.0527680393636
SIM,1936,35,45-49,1971,1
SIM,1906,23,40-44,1929,4
SIM,1902,21,30-34,1923,30
SIM,1911,27,40-44,1938,6
STAT,1870,20,20-24,1890,64.17080182817791
STAT,1896,24,35-39,1920,7.240174544634938
STAT,1899,25,15-19,1924,0.5913543269542955
STAT,1838,31,35-39,1869,8.672308057040944
STAT,1913,48,20-24,1961,0.010159180196887357
STAT,1815,85,na,1900,117.32987934384978
STAT,1857,22,30-34,1879,15.314501427665036
SIM,1883,9,na,1892,2460
STAT,1918,25,35-39,1943,15.196118286103488
STAT,1885,20,40-44,1905,1.9729397303810239
STAT,1855,31,35-39,1886,7.3791697690584055
SIM,1869,78,na,1947,675
SIM,1887,23,20-24,1910,68
STAT,1859,33,45-49,1892,1.3091622755592942
STAT,1957,15,45-49,1972,0.6224299594462032
SIM,1855,3,na,1858,2558
STAT,1917,46,25-29,1963,0.05246982673934861
SIM,1838,64,na,1902,1093
STAT,1939,27,45-49,1966,1.6405320784774526
STAT,1854,66,na,1920,1180.2417426832403
STAT,1935,25,35-39,1960,19.349425010418138
SIM,1878,45,na,1923,2323
SIM,1941,2,na,1943,3806
STAT,1844,42,15-19,1886,0.009928915724726551
SIM,1852,25,25-29,1877,41
STAT,1833,22,45-49,1855,0.6063308286883949
STAT,1906,43,na,1949,3167.2961190791348
SIM,1783,73,na,1856,429
STAT,1828,50,na,1878,1362.6844541329103
SIM,1847,30,25-29,1877,11
SIM,1872,21,35-39,1893,11
STAT,1851,52,45-49,1903,0.010585537903249195
SIM,1846,83,na,1929,234
STAT,1839,28,na,1867,1804.063824879647
STAT,1835,32,20-24,1867,2.1471691746118373
STAT,1928,35,45-49,1963,0.8153914624078858
SIM,1873,20,25-29,1893,55
STAT,1842,97,na,1939,3.825641341673721
SIM,1897,34,45-49,1931,2
STAT,1821,109,na,1930,3.84187334830084E-4
SIM,1943,25,35-39,1968,18
STAT,1844,25,25-29,1869,36.88060390191979
STAT,1866,51,na,1917,1884.3584562583626
SIM,1823,49,na,1872,1290
STAT,1834,51,45-49,1885,0.009395050616997316
STAT,1818,49,30-34,1867,0.20057247304040032
STAT,1892,35,50-100,1927,1.4662219068400346
STAT,1850,22,45-49,1872,0.5892231487494356
STAT,1903,27,40-44,1930,4.026136900517016
STAT,1904,17,45-49,1921,0.08850043941687248
STAT,1886,28,na,1914,2373.661680969801
STAT,1953,17,40-44,1970,1.5984602543900592
SIM,1841,78,na,1919,512
STAT,1828,51,30-34,1879,0.004938445697448403
STAT,1840,29,45-49,1869,0.9503145660531083
SIM,1865,22,30-34,1887,22
SIM,1934,24,30-34,1958,42
SIM,1832,85,na,1917,156
SIM,1893,20,40-44,1913,3
STAT,1885,23,20-24,1908,64.65860253712714
STAT,1926,24,30-34,1950,32.783341530092116
SIM,1814,48,50-100,1862,1
STAT,1848,44,50-100,1892,0.7508194777109245
STAT,1851,15,15-19,1866,5.354002600330775
STAT,1864,21,35-39,1885,5.042392584698408
STAT,1865,103,na,1968,0.9246366191105728
STAT,1883,3,na,1886,2753.511243796477
STAT,1895,42,30-34,1937,0.0982997940038487
SIM,1778,94,na,1872,3
STAT,1849,23,35-39,1872,5.048861421839242
STAT,1929,28,15-19,1957,0.8343036981190427
SIM,1873,30,40-44,1903,4
SIM,1833,33,na,1866,1657
STAT,1845,54,25-29,1899,0.0024263189383881556
STAT,1828,54,25-29,1882,0.002519667769526009
SIM,1886,74,na,1960,1230
STAT,1868,23,45-49,1891,0.6270245322574892
STAT,1861,20,na,1881,1933.716511580302
STAT,1899,72,na,1971,2031.1269538641043
STAT,1949,18,15-19,1967,49.8512058720232
SIM,1945,25,45-49,1970,2
STAT,1856,52,35-39,1908,0.006335881480087311
SIM,1893,23,20-24,1916,77
STAT,1848,39,15-19,1887,0.04083288161244965
SIM,1901,28,25-29,1929,59
SIM,1866,24,15-19,1890,5
STAT,1844,30,20-24,1874,2.316796981894428
STAT,1907,24,20-24,1931,95.01525501553893
STAT,1854,41,30-34,1895,0.8316153702253382
SIM,1826,32,20-24,1858,2
STAT,1871,41,20-24,1912,0.14940829712821743
STAT,1943,24,30-34,1967,28.866658436626476
SIM,1828,43,35-39,1871,3
STAT,1886,12,na,1898,2577.664729734592
STAT,1833,98,na,1931,1.9721570057916809
SIM,1928,15,na,1943,4405
SIM,1931,19,na,1950,4488
SIM,1896,58,na,1954,2502
STAT,1879,58,na,1937,1952.7431969002932
STAT,1881,26,40-44,1907,2.7417623987868227
STAT,1873,79,na,1952,670.3778470451454
STAT,1889,34,45-49,1923,2.016358669049625
STAT,1924,24,20-24,1948,123.18731207948707
SIM,1930,27,50-100,1957,1
STAT,1944,17,na,1961,3741.900821865862
SIM,1853,63,na,1916,1411
STAT,1908,27,30-34,1935,35.280619447538555
STAT,1894,47,na,1941,2721.8117694404255
SIM,1846,31,35-39,1877,13
SIM,1926,25,35-39,1951,19
SIM,1936,8,na,1944,3010
STAT,1875,52,45-49,1927,0.014009868741273879
SIM,1878,23,na,1901,2381
SIM,1898,24,35-39,1922,9
STAT,1859,27,50-100,1886,0.49060441873061694
SIM,1861,20,20-24,1881,63
SIM,1915,24,20-24,1939,110
STAT,1824,38,50-100,1862,1.7549725557573046
STAT,1837,49,40-44,1886,0.10934916947475193
STAT,1890,36,50-100,1926,1.424901335450386
SIM,1916,27,30-34,1943,44
SIM,1878,34,35-39,1912,12
STAT,1938,15,35-39,1953,3.928031946546778
SIM,1879,24,25-29,1903,64
STAT,1849,34,15-19,1883,0.10594030829087167
STAT,1923,43,45-49,1966,0.18348974861112127
SIM,1932,24,20-24,1956,125
SIM,1847,43,45-49,1890,6
STAT,1870,15,25-29,1885,5.3584227980795935
STAT,1895,45,25-29,1940,0.040454472812922325
STAT,1806,49,na,1855,1190.776732679836
SIM,1910,32,20-24,1942,1
SIM,1850,47,50-100,1897,2
STAT,1874,80,na,1954,597.2742236627679
STAT,1892,16,15-19,1908,7.03785659255201
STAT,1927,27,40-44,1954,5.353687907049183
SIM,1863,31,35-39,1894,12
SIM,1921,21,40-44,1942,3
SIM,1894,28,50-100,1922,5
STAT,1910,28,25-29,1938,59.81504760683988
SIM,1878,55,na,1933,2101
STAT,1876,33,20-24,1909,2.6250479831949622
STAT,1918,49,35-39,1967,0.12885049382187586
STAT,1945,27,50-100,1972,1.0315990272741191
STAT,1839,43,45-49,1882,1.0383727972163406
STAT,1825,79,na,1904,395.2700012199604
STAT,1894,57,na,1951,2442.14431113684
STAT,1820,48,na,1868,1355.704933517043
SIM,1846,22,20-24,1868,57
STAT,1937,25,45-49,1962,1.592087137270403
SIM,1861,82,na,1943,337
STAT,1841,16,na,1857,2037.5625540122983
SIM,1822,35,40-44,1857,3
STAT,1838,22,20-24,1860,60.97897645226458
STAT,1909,35,35-39,1944,2.182779254472452
SIM,1873,24,na,1897,2259
STAT,1913,24,45-49,1937,1.0663988066037973
STAT,1848,31,50-100,1879,0.7778111233304821
STAT,1887,47,40-44,1934,0.18002896910647867
SIM,1900,38,35-39,1938,7
STAT,1868,25,na,1893,2167.1930235377745
STAT,1870,29,30-34,1899,23.143514570210424
STAT,1920,27,30-34,1947,40.60718979821169
SIM,1878,37,50-100,1915,1
STAT,1931,10,na,1941,4914.330289524271
STAT,1838,25,25-29,1863,37.23284128966246
STAT,1792,89,na,1881,34.26811879890132
SIM,1871,50,na,1921,2102
STAT,1935,16,20-24,1951,175.51044213290862
STAT,1901,44,na,1945,3025.282276184949
STAT,1845,83,na,1928,279.6302341909627
SIM,1880,50,50-100,1930,1
STAT,1824,49,30-34,1873,0.11058342254809454
STAT,1872,20,30-34,1892,16.99042118962617
SIM,1943,16,20-24,1959,122
SIM,1871,34,25-29,1905,9
STAT,1764,106,na,1870,0.008954777383311812
SIM,1929,15,35-39,1944,7
STAT,1806,50,40-44,1856,0.030943405352052256
STAT,1911,16,35-39,1927,0.7950182804215851
STAT,1904,58,na,1962,2816.493639108749
SIM,1917,35,35-39,1952,4
STAT,1854,44,25-29,1898,0.45617185743302713
STAT,1842,18,15-19,1860,5.394863042176272
SIM,1945,24,30-34,1969,29
SIM,1832,32,45-49,1864,3
STAT,1859,81,na,1940,407.6956336505267
SIM,1817,96,na,1913,5
STAT,1822,39,50-100,1861,2.004218835461896
STAT,1882,1,na,1883,3089.1712520210253
SIM,1830,39,50-100,1869,4
STAT,1914,17,15-19,1931,8.86710337821909
SIM,1904,21,40-44,1925,3
SIM,1841,84,na,1925,181
STAT,1830,43,25-29,1873,0.48170624682421276
SIM,1922,17,15-19,1939,47
STAT,1869,52,30-34,1921,0.005414253164041546
STAT,1861,52,na,1913,1680.117800785493
STAT,1898,26,35-39,1924,12.381654834260534
STAT,1937,24,30-34,1961,26.41877977818453
STAT,1873,50,30-34,1923,0.005789974908968388
SIM,1921,24,45-49,1945,2
SIM,1942,4,na,1946,3799
STAT,1912,45,35-39,1957,0.11757809673668888
SIM,1840,40,40-44,1880,6
STAT,1916,29,30-34,1945,37.997996417975436
STAT,1916,35,50-100,1951,0.41002006229932053
SIM,1954,17,35-39,1971,6
SIM,1869,44,35-39,1913,6
STAT,1835,31,50-100,1866,0.7354146105627352
SIM,1916,19,30-34,1935,17
STAT,1804,53,25-29,1857,0.010323896598943703
SIM,1861,36,30-34,1897,5
STAT,1819,51,na,1870,1271.528516385916
SIM,1892,20,35-39,1912,8
SIM,1893,26,25-29,1919,61
SIM,1950,19,30-34,1969,15
STAT,1877,36,50-100,1913,1.2093699578018182
STAT,1942,19,30-34,1961,12.024623551021277
SIM,1928,27,35-39,1955,23
STAT,1944,16,50-100,1960,0.3809859225441154
SIM,1885,21,45-49,1906,2
SIM,1863,23,35-39,1886,4
STAT,1855,23,35-39,1878,4.793587828386331
SIM,1858,2,na,1860,2671
STAT,1868,101,na,1969,3.7395409812465767
STAT,1900,46,30-34,1946,0.07176564174462197
STAT,1845,15,15-19,1860,5.346183859503488
STAT,1857,31,45-49,1888,1.3203703182906732
STAT,1848,33,45-49,1881,1.3194309546982712
STAT,1909,48,40-44,1957,0.13644649815512605
STAT,1844,22,45-49,1866,0.6112052964070503
SIM,1918,27,40-44,1945,7
STAT,1889,33,30-34,1922,20.27684868636452
SIM,1869,46,na,1915,2072
STAT,1844,82,na,1926,327.54514957955956
SIM,1880,29,40-44,1909,3
SIM,1833,49,na,1882,1409
STAT,1865,30,40-44,1895,3.752756528537344
SIM,1880,0,na,1880,3460
SIM,1889,23,30-34,1912,21
STAT,1932,40,45-49,1972,0.21368694009773326
STAT,1831,39,20-24,1870,0.5946353618130095
STAT,1884,20,35-39,1904,5.48015622419926
SIM,1826,35,25-29,1861,1
STAT,1872,29,40-44,1901,2.820099722100261
SIM,1881,41,40-44,1922,5
SIM,1901,25,20-24,1926,18
STAT,1871,44,25-29,1915,0.5932900867336746
STAT,1911,25,25-29,1936,61.036562398822404
STAT,1933,20,50-100,1953,0.8294540539838111
STAT,1944,15,35-39,1959,4.268110150613253
STAT,1946,23,45-49,1969,1.1824894822919751
STAT,1953,16,na,1969,4207.571949342335
STAT,1931,28,45-49,1959,2.106101318266727
SIM,1805,68,na,1873,726
STAT,1832,97,na,1929,3.2483720837235257
STAT,1885,26,25-29,1911,39.9498527097702
STAT,1861,106,na,1967,0.08072908773285298
STAT,1946,17,35-39,1963,4.396826030030215
SIM,1835,34,na,1869,1677
STAT,1858,52,45-49,1910,0.010705539935370009
SIM,1803,67,na,1870,720
SIM,1906,34,20-24,1940,3
SIM,1853,15,15-19,1868,9
STAT,1767,104,na,1871,0.02296461699418216
STAT,1774,92,na,1866,9.982652460133
STAT,1845,30,na,1875,1853.190277255355
STAT,1916,43,na,1959,3589.6515256654106
SIM,1888,44,45-49,1932,6
STAT,1864,44,na,1908,1925.06430942381
STAT,1820,39,45-49,1859,3.974997247932963
STAT,1872,95,na,1967,50.07514596701854
SIM,1883,17,15-19,1900,7
SIM,1787,71,na,1858,534
STAT,1879,74,na,1953,1095.8408411919718
STAT,1848,32,30-34,1880,14.6686411900724
STAT,1894,41,na,1935,2821.373935274862
STAT,1928,32,40-44,1960,4.62302794449031
STAT,1941,2,na,1943,3956.3884550385133
SIM,1845,34,na,1879,1769
STAT,1807,66,na,1873,804.6539203424051
SIM,1920,28,35-39,1948,19
STAT,1923,19,20-24,1942,149.59991572718735
STAT,1822,54,50-100,1876,0.01948395164567876
STAT,1853,36,30-34,1889,3.99371167038944
SIM,1830,33,25-29,1863,12
STAT,1857,36,15-19,1893,0.04202244096152377
STAT,1912,28,35-39,1940,13.924538340877369
STAT,1873,41,40-44,1914,2.1666085657713783
SIM,1830,35,na,1865,1701
STAT,1829,33,35-39,1862,9.627607195801302
SIM,1821,48,na,1869,1345
STAT,1903,45,50-100,1948,0.18805714008302335
SIM,1833,45,50-100,1878,2
SIM,1856,32,30-34,1888,19
SIM,1850,18,15-19,1868,9
SIM,1952,15,35-39,1967,7
STAT,1774,86,na,1860,62.09398265843834
STAT,1917,34,30-34,1951,15.451564681418159
SIM,1876,6,na,1882,2698
STAT,1874,23,45-49,1897,0.671205512349621
SIM,1868,29,40-44,1897,4
STAT,1837,52,25-29,1889,0.00224410293645082
SIM,1848,22,30-34,1870,15
SIM,1941,17,25-29,1958,50
STAT,1909,48,30-34,1957,0.07714965564188002
STAT,1824,32,45-49,1856,4.039126905645077
STAT,1933,17,25-29,1950,54.80253453704064
STAT,1940,19,na,1959,3527.803815795773
STAT,1847,96,na,1943,6.317965587966043
SIM,1872,15,25-29,1887,8
STAT,1844,22,20-24,1866,60.40209124477622
STAT,1846,30,30-34,1876,14.853061692284294
SIM,1852,39,30-34,1891,5
STAT,1864,15,25-29,1879,5.503584480288743
STAT,1877,21,45-49,1898,0.6856600134771703
STAT,1844,39,30-34,1883,3.8723840502206297
SIM,1839,35,35-39,1874,10
SIM,1908,60,na,1968,2828
SIM,1908,37,35-39,1945,5
STAT,1891,23,45-49,1914,0.8128632717186121
SIM,1888,31,25-29,1919,9
STAT,1811,54,30-34,1865,0.018157149640535115
SIM,1925,34,30-34,1959,28
SIM,1859,34,25-29,1893,11
STAT,1897,34,50-100,1931,1.1476878130389638
SIM,1852,22,20-24,1874,61
STAT,1874,27,na,1901,2304.263438294998
STAT,1830,40,50-100,1870,0.826082949401011
STAT,1879,30,50-100,1909,0.9120026037358038
SIM,1887,30,50-100,1917,4
SIM,1839,41,45-49,1880,2
SIM,1934,27,35-39,1961,18
STAT,1935,22,30-34,1957,36.971905216610956
SIM,1921,1,na,1922,4323
SIM,1887,26,25-29,1913,50
STAT,1931,39,25-29,1970,1.229270736398482
STAT,1898,32,45-49,1930,2.2300467872773027
SIM,1841,21,30-34,1862,17
STAT,1885,23,45-49,1908,0.6542766900043093
STAT,1797,87,na,1884,58.51493569234299
SIM,1829,30,20-24,1859,1
STAT,1851,29,20-24,1880,9.928635241903896
STAT,1888,21,20-24,1909,77.13923211057164
SIM,1891,19,15-19,1910,8
STAT,1915,17,20-24,1932,26.80337589883374
STAT,1875,38,na,1913,2275.2240582634445
STAT,1932,38,15-19,1970,0.024350545850341476
STAT,1857,25,35-39,1882,7.509185066498003
SIM,1845,38,50-100,1883,1
SIM,1921,42,na,1963,3853
STAT,1886,16,15-19,1902,5.9379664768664435
STAT,1899,31,35-39,1930,13.164214432408272
SIM,1854,30,30-34,1884,20
STAT,1905,16,50-100,1921,0.06704579098354946
STAT,1868,47,30-34,1915,0.08690432679653358
STAT,1883,19,15-19,1902,5.46513894177444
STAT,1845,18,40-44,1863,0.16187520645459197
STAT,1927,37,na,1964,4419.337613587495
STAT,1919,4,na,1923,4213.635563987422
STAT,1901,27,20-24,1928,15.51234499439417
STAT,1904,35,35-39,1939,2.087953843460272
STAT,1805,49,20-24,1854,0.035516854608529796
SIM,1896,21,20-24,1917,98
STAT,1835,44,15-19,1879,0.010063052714848607
SIM,1878,29,na,1907,2404
SIM,1912,22,na,1934,3310
SIM,1923,17,20-24,1940,132
SIM,1936,32,40-44,1968,2
STAT,1837,38,50-100,1875,0.9338798850501039
STAT,1926,27,35-39,1953,17.004336183103387
SIM,1826,32,45-49,1858,1
STAT,1863,42,25-29,1905,0.5325993980861048
SIM,1902,24,35-39,1926,8
STAT,1786,71,na,1857,560.5540453272287
SIM,1845,12,na,1857,2137
STAT,1843,98,na,1941,2.3436775389973366
STAT,1926,44,25-29,1970,0.0828970466592355
SIM,1791,86,na,1877,68
STAT,1879,26,25-29,1905,41.913122928565464
STAT,1846,46,40-44,1892,0.12105111803165705
STAT,1795,91,na,1886,18.287363184570744
STAT,1866,20,30-34,1886,15.868026004902708
SIM,1867,30,40-44,1897,3
SIM,1931,19,20-24,1950,169
SIM,1838,80,na,1918,377
STAT,1907,24,45-49,1931,0.9614539150577238
SIM,1902,37,30-34,1939,1
SIM,1943,22,30-34,1965,35
STAT,1879,35,50-100,1914,1.223826071910088
STAT,1870,32,15-19,1902,0.13182243909079397
STAT,1870,23,25-29,1893,52.82677552499946
STAT,1904,42,na,1946,3138.266735416933
SIM,1888,23,na,1911,2568
SIM,1842,16,15-19,1858,5
SIM,1798,65,na,1863,794
STAT,1925,5,na,1930,4589.020272349216
STAT,1924,19,na,1943,4118.940687252829
STAT,1887,23,na,1910,2490.9447528623937
SIM,1903,61,na,1964,2683
SIM,1852,22,45-49,1874,1
STAT,1906,48,15-19,1954,3.064829937527888E-4
STAT,1841,41,35-39,1882,1.304017533596871
STAT,1859,30,40-44,1889,3.3171850139156707
SIM,1862,41,30-34,1903,4
SIM,1925,46,50-100,1971,3
SIM,1828,86,na,1914,115
STAT,1855,83,na,1938,281.16079580570187
STAT,1841,32,na,1873,1799.0983750161784
STAT,1863,33,35-39,1896,8.37416443903323
STAT,1870,50,na,1920,2021.763639055925
STAT,1925,15,25-29,1940,49.68945737343107
STAT,1930,25,35-39,1955,18.05122970873426
SIM,1886,58,na,1944,1895
SIM,1891,27,na,1918,2920
STAT,1832,40,40-44,1872,1.7124189467049016
SIM,1924,29,30-34,1953,47
STAT,1902,23,30-34,1925,23.67303592517111
SIM,1847,40,40-44,1887,5
SIM,1897,33,30-34,1930,30
STAT,1859,50,50-100,1909,0.011549959950158709
SIM,1895,31,30-34,1926,36
SIM,1916,17,15-19,1933,11
SIM,1828,40,30-34,1868,3
SIM,1873,33,45-49,1906,1
STAT,1917,46,50-100,1963,0.2237255128141289
STAT,1940,18,50-100,1958,0.3592125423135485
STAT,1907,60,na,1967,2878.8723449847075
STAT,1880,31,30-34,1911,17.425854790381536
STAT,1927,17,25-29,1944,50.9077220230232
SIM,1935,17,25-29,1952,54
STAT,1895,49,40-44,1944,0.11656704770082171
SIM,1912,35,35-39,1947,4
SIM,1894,45,na,1939,2926
STAT,1845,51,20-24,1896,5.222635845788641E-4
SIM,1896,74,na,1970,1773
SIM,1805,52,na,1857,1169
STAT,1909,32,30-34,1941,14.199463771123883
STAT,1786,93,na,1879,6.605040057624381
STAT,1908,19,30-34,1927,2.221084884293586
STAT,1842,20,45-49,1862,0.6354147168117275
STAT,1840,84,na,1924,231.67220507586518
STAT,1859,33,20-24,1892,2.02930238630447
STAT,1887,31,30-34,1918,18.521513287217797
SIM,1865,25,35-39,1890,8
STAT,1911,22,na,1933,3418.2959588108383
STAT,1908,17,15-19,1925,8.314488963179096
SIM,1808,66,na,1874,798
STAT,1839,40,40-44,1879,1.7820889131948634
SIM,1910,23,30-34,1933,26
SIM,1827,48,50-100,1875,2
SIM,1846,25,25-29,1871,43
SIM,1859,31,45-49,1890,2
SIM,1919,34,30-34,1953,23
STAT,1844,33,25-29,1877,8.509697218789574
STAT,1850,39,30-34,1889,3.7331128127504423
SIM,1893,23,45-49,1916,3
SIM,1938,15,na,1953,3368
SIM,1821,40,30-34,1861,1
STAT,1907,27,25-29,1934,58.69182730535488
STAT,1841,36,50-100,1877,1.000028702852876
SIM,1844,23,25-29,1867,53
STAT,1894,63,na,1957,2214.6568630304855
STAT,1905,38,45-49,1943,0.5844809456875294
SIM,1867,36,25-29,1903,2
STAT,1854,110,na,1964,0.0010455231512485304
SIM,1928,33,45-49,1961,1
STAT,1822,41,25-29,1863,0.9948476574260984
STAT,1950,6,na,1956,4391.508580308646
SIM,1905,29,20-24,1934,17
STAT,1894,37,30-34,1931,6.476610914009576
STAT,1855,61,na,1916,1323.4364626453812
STAT,1913,40,35-39,1953,0.1875689749194993
SIM,1833,27,na,1860,1713
SIM,1915,27,25-29,1942,67
SIM,1941,19,na,1960,3468
STAT,1833,21,30-34,1854,18.772868713572468
STAT,1827,46,30-34,1873,0.08594493402938566
STAT,1836,23,25-29,1859,47.36632769964675
SIM,1829,47,50-100,1876,2
SIM,1869,25,na,1894,2189
STAT,1861,34,15-19,1895,0.11075903286396017
SIM,1923,16,na,1939,4015
STAT,1873,38,50-100,1911,1.1714533876914672
STAT,1816,49,na,1865,1352.0789860614427
SIM,1798,87,na,1885,58
STAT,1884,80,na,1964,830.8618096030323
SIM,1842,69,na,1911,1006
STAT,1933,39,35-39,1972,3.1056989712448275
SIM,1859,31,20-24,1890,2
STAT,1824,84,na,1908,175.6254352669826
STAT,1853,29,30-34,1882,19.40548575909819
SIM,1925,23,na,1948,4009
STAT,1855,20,30-34,1875,14.95175378468729
STAT,1931,17,15-19,1948,56.118188048465846
SIM,1871,31,20-24,1902,3
STAT,1908,36,20-24,1944,0.23422681137438464
SIM,1911,23,25-29,1934,75
STAT,1901,60,na,1961,2647.516725026307
STAT,1855,25,25-29,1880,34.81429439123979
SIM,1870,9,na,1879,2499
STAT,1869,96,na,1965,27.75225600938021
SIM,1823,87,na,1910,93
SIM,1856,35,35-39,1891,19
SIM,1854,39,40-44,1893,2
STAT,1826,52,50-100,1878,0.013627285170297801
STAT,1876,36,25-29,1912,2.821467418741816
STAT,1921,18,35-39,1939,4.507064054256205
STAT,1952,16,20-24,1968,153.53259746777468
STAT,1879,4,na,1883,2838.5027228073204
STAT,1839,52,35-39,1891,0.0057097220543262505
STAT,1900,22,45-49,1922,0.913902349977041
STAT,1809,45,25-29,1854,0.21803340615934944
SIM,1927,36,na,1963,4335
SIM,1876,81,na,1957,540
SIM,1891,30,35-39,1921,18
SIM,1908,17,30-34,1925,2
STAT,1843,41,45-49,1884,1.1260689397824166
STAT,1937,22,40-44,1959,3.092761362588715
SIM,1861,29,30-34,1890,26
SIM,1945,22,40-44,1967,2
STAT,1924,27,25-29,1951,72.40522972129149
STAT,1920,20,20-24,1940,117.48334311917773
STAT,1830,91,na,1921,34.61521384922659
STAT,1844,46,30-34,1890,0.06814742415108273
SIM,1880,27,50-100,1907,1
STAT,1854,41,20-24,1895,0.11487780082777521
SIM,1863,25,25-29,1888,36
STAT,1897,31,25-29,1928,12.99354743797824
STAT,1887,7,na,1894,2752.5497475301927
SIM,1913,38,na,1951,3355
STAT,1940,29,25-29,1969,63.3374466860829
SIM,1922,28,45-49,1950,6
SIM,1851,46,na,1897,1680
STAT,1860,19,20-24,1879,15.513756227652346
SIM,1861,53,50-100,1914,1
STAT,1829,34,50-100,1863,0.8490319313896294
STAT,1894,73,na,1967,1765.7823081022912
SIM,1932,27,25-29,1959,83
SIM,1946,18,na,1964,3820
STAT,1823,50,40-44,1873,0.012571897103909714
STAT,1889,31,40-44,1920,5.078460380386208
STAT,1903,23,25-29,1926,76.70224969448749
SIM,1864,96,na,1960,16
STAT,1914,28,45-49,1942,1.6392045192970668
STAT,1837,30,15-19,1867,0.11507890155192398
STAT,1815,46,50-100,1861,0.6076256708528088
STAT,1926,21,na,1947,4204.272196355204
STAT,1883,26,15-19,1909,0.4215098236499037
SIM,1939,21,na,1960,3390
STAT,1846,42,25-29,1888,0.4582484752452033
STAT,1848,35,35-39,1883,5.361202368032026
STAT,1941,16,45-49,1957,0.4861759430087124
STAT,1890,41,40-44,1931,2.6097295755631698
SIM,1940,18,na,1958,3380
STAT,1830,40,30-34,1870,0.8989726233796882
STAT,1934,26,20-24,1960,23.207825899669142
SIM,1848,57,na,1905,1459
STAT,1922,38,20-24,1960,0.28309841388276225
STAT,1926,26,20-24,1952,20.74532158825862
STAT,1929,23,45-49,1952,1.3401039976866176
STAT,1906,16,na,1922,3482.7794838495724
SIM,1882,32,35-39,1914,12
STAT,1869,74,na,1943,1014.8315050311554
STAT,1875,9,na,1884,2579.810454931404
SIM,1807,65,na,1872,785
STAT,1863,53,40-44,1916,0.008601936090888091
STAT,1829,30,30-34,1859,17.976731124572378
STAT,1889,36,35-39,1925,8.288652950334638
SIM,1843,35,25-29,1878,2
SIM,1908,44,na,1952,3138
SIM,1851,41,45-49,1892,4
SIM,1878,33,20-24,1911,2
SIM,1821,42,50-100,1863,1
SIM,1833,22,35-39,1855,4
SIM,1884,40,45-49,1924,2
STAT,1881,15,25-29,1896,5.192887559997468
STAT,1945,18,na,1963,3797.1743745523995
SIM,1936,15,40-44,1951,1
SIM,1820,35,30-34,1855,5
SIM,1825,40,50-100,1865,1
STAT,1860,8,na,1868,2174.4096232777856
STAT,1933,33,50-100,1966,1.051944731867213
SIM,1866,30,50-100,1896,3
SIM,1902,37,40-44,1939,2
STAT,1863,20,15-19,1883,2.834711041656053
STAT,1874,59,na,1933,1876.4759157763074
STAT,1895,26,na,1921,2952.2018721702807
SIM,1884,14,na,1898,2520
STAT,1875,18,50-100,1893,0.047423904059912945
STAT,1917,29,25-29,1946,64.74037401409532
STAT,1910,17,20-24,1927,25.370591855285916
SIM,1902,30,20-24,1932,4
STAT,1827,39,30-34,1866,5.070608178751733
STAT,1907,49,35-39,1956,0.10785949747449348
STAT,1947,21,50-100,1968,0.7028004498210584
STAT,1926,36,na,1962,4348.070067269428
SIM,1897,36,35-39,1933,16
STAT,1876,40,45-49,1916,1.4743343685823684
SIM,1942,26,20-24,1968,18
SIM,1925,37,35-39,1962,5
SIM,1868,77,na,1945,692
SIM,1914,4,na,1918,4217
STAT,1787,72,na,1859,520.7926430569664
STAT,1813,47,40-44,1860,0.5178544272437579
SIM,1903,28,35-39,1931,13
SIM,1943,0,na,1943,4079
SIM,1830,30,20-24,1860,2
SIM,1895,35,50-100,1930,1
STAT,1874,32,35-39,1906,9.778001553438411
SIM,1863,20,30-34,1883,18
SIM,1891,70,na,1961,1769
SIM,1925,29,25-29,1954,81
STAT,1905,27,15-19,1932,0.6193744817410421
SIM,1877,8,na,1885,2593
STAT,1875,30,35-39,1905,9.907707128410063
SIM,1862,83,na,1945,298
SIM,1899,20,45-49,1919,3
STAT,1874,20,40-44,1894,2.0239877758087275
STAT,1928,15,40-44,1943,1.6728483965703627
STAT,1840,29,20-24,1869,10.041013865589207
STAT,1845,67,na,1912,1116.5978712517299
SIM,1926,24,20-24,1950,119
SIM,1958,13,na,1971,4843
STAT,1807,49,30-34,1856,0.34694416071981765
SIM,1909,27,25-29,1936,47
STAT,1935,34,25-29,1969,12.063708295613495
STAT,1941,10,na,1951,3844.5773773636606
SIM,1871,20,15-19,1891,3
STAT,1949,20,50-100,1969,0.7258952891784238
STAT,1835,35,25-29,1870,2.2675218582946655
STAT,1882,78,na,1960,875.839168066465
SIM,1900,16,25-29,1916,11
SIM,1865,40,35-39,1905,2
STAT,1894,19,50-100,1913,0.05921664475837952
STAT,1937,27,35-39,1964,13.823768100436515
STAT,1851,23,15-19,1874,2.868287500395079
STAT,1910,26,35-39,1936,13.738959060261816
SIM,1832,64,na,1896,1070
STAT,1870,34,na,1904,2190.0233155733977
SIM,1883,30,35-39,1913,13
SIM,1902,15,20-24,1917,15
SIM,1930,23,35-39,1953,16
STAT,1816,102,na,1918,0.13661854697513462
SIM,1910,18,25-29,1928,15
STAT,1855,67,na,1922,1122.7095917735899
SIM,1889,34,35-39,1923,15
STAT,1836,25,15-19,1861,0.3761120686429701
STAT,1919,17,40-44,1936,1.4602072837325621
STAT,1826,49,40-44,1875,0.15583661716305433
STAT,1840,31,na,1871,1857.5183678919636
STAT,1948,0,na,1948,4789.6584202559425
STAT,1856,30,25-29,1886,7.832204319881066
STAT,1848,46,15-19,1894,2.8898733661165103E-4
STAT,1761,109,na,1870,0.0019211624612757985
STAT,1869,19,40-44,1888,0.16757768537447995
STAT,1833,24,35-39,1857,4.764701418422662
SIM,1926,38,30-34,1964,5
SIM,1899,44,na,1943,2952
STAT,1884,42,45-49,1926,1.3954529034421084
SIM,1919,32,40-44,1951,5
STAT,1950,17,25-29,1967,48.409682250255294
SIM,1921,26,na,1947,3830
SIM,1888,81,na,1969,971
STAT,1863,86,na,1949,184.24899685648518
STAT,1820,91,na,1911,30.870796642951568
STAT,1918,24,20-24,1942,112.58178537611062
STAT,1925,28,20-24,1953,20.298421111115914
STAT,1864,51,40-44,1915,0.008931136398515123
SIM,1951,3,na,1954,4376
STAT,1886,28,50-100,1914,0.6362449295429101
STAT,1900,49,25-29,1949,0.04169352931565787
STAT,1867,42,45-49,1909,1.325886163782381
STAT,1921,32,30-34,1953,16.56477068724328
STAT,1940,18,45-49,1958,0.4789500564180647
STAT,1872,36,40-44,1908,4.170736084938096
STAT,1836,20,20-24,1856,69.81509412940191
SIM,1877,44,na,1921,2250
STAT,1831,28,40-44,1859,2.5654274161761226
STAT,1845,51,30-34,1896,0.004212926093018445
STAT,1911,38,45-49,1949,0.618810751084875
SIM,1928,20,15-19,1948,10
SIM,1919,37,35-39,1956,5
STAT,1842,47,50-100,1889,0.1749240742776691
STAT,1936,17,40-44,1953,1.264836614074528
STAT,1900,35,15-19,1935,0.07429452668387712
SIM,1880,23,35-39,1903,9
SIM,1841,24,35-39,1865,6
SIM,1912,32,30-34,1944,14
SIM,1818,39,30-34,1857,6
STAT,1927,39,35-39,1966,2.835177940216748
SIM,1847,94,na,1941,8
SIM,1934,26,20-24,1960,23
STAT,1861,25,25-29,1886,33.910780316822674
STAT,1857,107,na,1964,0.020747613809052677
SIM,1767,88,na,1855,40
STAT,1811,43,15-19,1854,0.051129591992791865
STAT,1864,59,na,1923,1640.887699795046
SIM,1910,39,40-44,1949,2
SIM,1844,20,20-24,1864,60
STAT,1898,37,15-19,1935,0.07181196604979129
STAT,1942,28,20-24,1970,18.08932078600867
SIM,1829,33,25-29,1862,9
SIM,1831,84,na,1915,167
SIM,1835,39,30-34,1874,9
STAT,1914,36,20-24,1950,0.2497944683798305
SIM,1856,45,na,1901,1811
SIM,1867,12,na,1879,2339
STAT,1806,50,na,1856,1178.154810150759
STAT,1922,27,50-100,1949,1.0640834009648206
STAT,1906,43,45-49,1949,0.14193396573368317
STAT,1863,96,na,1959,12.490336507956968
SIM,1937,25,35-39,1962,16
STAT,1888,24,25-29,1912,63.48674217657781
STAT,1911,22,20-24,1933,99.60188505583655
STAT,1850,46,na,1896,1588.3900853243244
STAT,1853,32,15-19,1885,0.1087570922056464
SIM,1887,59,na,1946,2003
SIM,1896,24,25-29,1920,78
STAT,1902,39,40-44,1941,1.2469415588277393
STAT,1887,40,20-24,1927,0.16947843142123314
STAT,1840,16,50-100,1856,0.044436237065941166
SIM,1890,26,na,1916,2878
SIM,1942,25,na,1967,3543
SIM,1896,22,35-39,1918,10
STAT,1905,16,35-39,1921,0.750912998142056
SIM,1914,43,45-49,1957,1
STAT,1913,7,na,1920,3847.437284357785
STAT,1888,22,35-39,1910,6.512455017884184
STAT,1904,32,30-34,1936,13.582603415001985
SIM,1828,64,na,1892,901
SIM,1930,16,35-39,1946,4
STAT,1846,31,na,1877,1824.646380461043
STAT,1831,54,na,1885,1308.5904283384732
STAT,1854,48,40-44,1902,0.12173111235193637
STAT,1874,21,50-100,1895,0.394923216917211
STAT,1829,32,20-24,1861,2.6377653820955747
STAT,1847,21,35-39,1868,5.30169961146017
STAT,1876,44,na,1920,2223.6236232579163
STAT,1923,18,na,1941,4072.711058346903
STAT,1930,22,30-34,1952,34.78493420612058
SIM,1874,19,15-19,1893,7
STAT,1831,35,40-44,1866,3.5387184047005786
SIM,1880,36,40-44,1916,6
STAT,1855,45,na,1900,1609.3057261630915
SIM,1863,31,na,1894,2049
STAT,1911,37,40-44,1948,1.365621674066835
STAT,1824,107,na,1931,0.0024897297072783244
SIM,1863,46,na,1909,1967
STAT,1950,21,45-49,1971,1.2614984276306733
STAT,1862,15,15-19,1877,5.5422502487135965
STAT,1866,38,30-34,1904,4.618979469953859
STAT,1846,39,40-44,1885,3.1568818752384256
SIM,1933,28,20-24,1961,26
SIM,1874,38,30-34,1912,11
STAT,1929,25,35-39,1954,17.81905406890934
STAT,1890,49,50-100,1939,0.15667510339867036
SIM,1763,95,na,1858,1
SIM,1870,15,15-19,1885,6
STAT,1763,113,na,1876,1.6655943681742816E-4
STAT,1847,40,25-29,1887,0.4874587879177307
STAT,1932,33,45-49,1965,1.9749663372469872
SIM,1904,33,35-39,1937,6
STAT,1866,21,45-49,1887,0.6167468386880042
STAT,1956,3,na,1959,4916.779642083491
SIM,1822,39,50-100,1861,3
SIM,1948,23,20-24,1971,110
SIM,1821,91,na,1912,20
STAT,1909,26,20-24,1935,16.672898061436918
STAT,1794,103,na,1897,0.025786328819723765
STAT,1902,26,35-39,1928,12.907595097719193
STAT,1896,23,20-24,1919,85.77360631751915
STAT,1929,39,45-49,1968,0.8250964873861402
SIM,1868,93,na,1961,38
SIM,1937,20,40-44,1957,3
STAT,1892,48,50-100,1940,0.16183308979448088
SIM,1816,79,na,1895,259
STAT,1922,16,35-39,1938,4.59926898331237
SIM,1923,33,45-49,1956,1
SIM,1927,17,40-44,1944,2
STAT,1916,38,20-24,1954,0.253747883675198
STAT,1944,28,30-34,1972,39.98641365542838
STAT,1817,51,45-49,1868,0.031728551130179826
STAT,1842,25,15-19,1867,0.40534561009615583
SIM,1881,49,na,1930,1836
SIM,1910,26,35-39,1936,21
SIM,1933,15,15-19,1948,50
STAT,1878,31,15-19,1909,0.1406235241559392
SIM,1947,20,25-29,1967,108
SIM,1917,26,20-24,1943,20
SIM,1944,17,40-44,1961,1
STAT,1883,30,35-39,1913,9.451685526634467
STAT,1925,37,35-39,1962,2.742815874093657
SIM,1855,21,35-39,1876,5
SIM,1788,87,na,1875,47
SIM,1928,15,40-44,1943,1
STAT,1827,42,15-19,1869,0.012704194425516728
STAT,1909,41,20-24,1950,0.015690646823908094
STAT,1902,18,25-29,1920,7.534795535550475
STAT,1925,15,15-19,1940,52.037892850236744
SIM,1831,29,45-49,1860,4
SIM,1884,33,20-24,1917,3
STAT,1901,28,35-39,1929,12.713741742521256
STAT,1857,29,15-19,1886,0.34305756583121483
SIM,1881,59,na,1940,1637
SIM,1892,42,45-49,1934,2
STAT,1962,4,na,1966,4758.809640950804
SIM,1848,79,na,1927,473
SIM,1885,17,25-29,1902,11
SIM,1918,39,35-39,1957,7
STAT,1813,51,na,1864,1231.419991397423
STAT,1822,45,40-44,1867,0.24575604268170342
SIM,1864,30,25-29,1894,9
SIM,1895,1,na,1896,3355
STAT,1894,33,15-19,1927,0.17232639161876337
SIM,1848,33,35-39,1881,4
STAT,1812,99,na,1911,0.8145490467784487
STAT,1915,33,45-49,1948,1.5074591402593729
STAT,1872,50,50-100,1922,0.014526252956334975
SIM,1933,37,35-39,1970,6
STAT,1920,27,40-44,1947,4.830510529802892
STAT,1862,100,na,1962,2.5046214762430914
STAT,1869,15,25-29,1884,5.3160597274588985
STAT,1790,76,na,1866,350.4270148108325
STAT,1902,32,20-24,1934,3.6035777692980737
STAT,1854,30,15-19,1884,0.10721794314738146
STAT,1917,17,30-34,1934,2.47775893025475
STAT,1868,43,15-19,1911,0.012366168696681544
STAT,1801,66,na,1867,803.9220591704747
STAT,1831,32,na,1863,1710.4815644381995
STAT,1916,25,25-29,1941,64.7259954400141
SIM,1911,20,20-24,1931,91
STAT,1855,22,20-24,1877,57.017943416395724
STAT,1920,23,25-29,1943,96.71479891276775
SIM,1863,22,20-24,1885,61
STAT,1906,26,45-49,1932,1.532584472813442
STAT,1872,0,na,1872,3517.7645559847742
SIM,1934,20,15-19,1954,7
SIM,1833,37,30-34,1870,6
STAT,1894,24,25-29,1918,69.13053178177212
STAT,1837,64,na,1901,1097.352144765131
STAT,1861,44,50-100,1905,0.8175751190925982
STAT,1880,31,20-24,1911,2.697816241007031
STAT,1889,47,15-19,1936,2.619227763943548E-4
SIM,1882,20,40-44,1902,1
STAT,1834,23,15-19,1857,2.711474498585565
STAT,1823,53,45-49,1876,0.01632572377775255
STAT,1912,5,na,1917,3827.4645733788025
STAT,1840,18,40-44,1858,0.16394683371192437
STAT,1920,28,45-49,1948,1.7841221804908847
STAT,1921,15,30-34,1936,13.187326098287805
STAT,1872,32,25-29,1904,9.712061038347786
STAT,1905,29,50-100,1934,0.8670380397475358
SIM,1913,29,50-100,1942,4
SIM,1918,22,na,1940,3684
STAT,1827,33,25-29,1860,11.41282065619064
SIM,1901,26,35-39,1927,15
SIM,1925,17,30-34,1942,18
STAT,1872,27,50-100,1899,0.6065577977161719
STAT,1903,16,25-29,1919,7.634976037737952
SIM,1839,27,na,1866,1858
STAT,1929,20,40-44,1949,4.041018823184661
STAT,1955,15,35-39,1970,5.264744561108126
SIM,1844,16,25-29,1860,7
STAT,1888,42,50-100,1930,1.177559479279883
STAT,1940,26,20-24,1966,17.590689912769186
SIM,1921,33,35-39,1954,5
STAT,1877,26,15-19,1903,0.4462986441069713
SIM,1842,23,15-19,1865,2
STAT,1915,46,15-19,1961,3.515022742443355E-4
STAT,1818,50,na,1868,1302.4353240326216
STAT,1926,20,15-19,1946,6.146529355135679
SIM,1835,33,25-29,1868,10
STAT,1865,42,35-39,1907,1.5525699114824802
SIM,1874,30,35-39,1904,13
STAT,1920,26,na,1946,3895.676855956003
STAT,1825,37,30-34,1862,6.824902029312753
STAT,1952,19,25-29,1971,49.028385502082365
SIM,1873,42,35-39,1915,4
SIM,1933,17,15-19,1950,53
SIM,1942,29,25-29,1971,57
SIM,1838,20,20-24,1858,47
STAT,1934,29,25-29,1963,83.5626369920353
SIM,1868,3,na,1871,2708
SIM,1895,34,35-39,1929,12
SIM,1939,22,40-44,1961,4
SIM,1903,23,na,1926,3150
SIM,1909,15,30-34,1924,4
STAT,1905,59,na,1964,2829.357408681492
SIM,1907,22,20-24,1929,105
SIM,1828,80,na,1908,308
STAT,1800,55,na,1855,1078.394699398011
STAT,1892,28,30-34,1920,29.68549624121274
SIM,1898,21,30-34,1919,20
STAT,1887,34,35-39,1921,10.607607665140433
STAT,1870,36,30-34,1906,4.957172413691462
SIM,1952,5,na,1957,4396
STAT,1816,65,na,1881,910.4273012364922
STAT,1913,33,35-39,1946,8.55095652744199
STAT,1880,53,40-44,1933,0.010296448757606286
STAT,1871,30,50-100,1901,0.8650013333264156
STAT,1928,18,45-49,1946,0.5931246592041688
SIM,1860,39,40-44,1899,7
SIM,1913,7,na,1920,3723
STAT,1809,79,na,1888,308.60082089514424
STAT,1868,34,25-29,1902,9.159496713672285
SIM,1843,32,20-24,1875,1
SIM,1878,36,25-29,1914,2
STAT,1852,39,40-44,1891,3.292431826330344
SIM,1903,25,30-34,1928,34
STAT,1866,23,35-39,1889,5.0873481073183875
STAT,1911,45,50-100,1956,0.2031886815480505
SIM,1856,44,50-100,1900,3
SIM,1933,11,na,1944,5043
STAT,1926,29,25-29,1955,74.01511574580238
SIM,1829,31,35-39,1860,10
STAT,1797,101,na,1898,0.13893834377210684
SIM,1832,32,na,1864,1712
SIM,1855,23,25-29,1878,49
SIM,1876,34,25-29,1910,15
STAT,1891,32,35-39,1923,11.841646391988403
STAT,1847,23,25-29,1870,51.265094443248536
STAT,1868,31,20-24,1899,2.4480605133305446
STAT,1903,20,20-24,1923,93.17329736680772
SIM,1874,23,35-39,1897,6
STAT,1812,52,30-34,1864,0.018732801320609515
SIM,1893,44,na,1937,2850
SIM,1916,39,25-29,1955,4
STAT,1935,31,20-24,1966,3.1896152558645765
STAT,1905,37,na,1942,3241.653777093197
SIM,1877,15,25-29,1892,2
STAT,1897,8,na,1905,3284.3066618084395
STAT,1918,38,30-34,1956,1.8129105738049378
STAT,1831,52,40-44,1883,0.006809112492620906
SIM,1924,25,25-29,1949,80
STAT,1860,20,50-100,1880,0.35981425156322866
STAT,1880,34,na,1914,2351.681395521476
SIM,1925,26,20-24,1951,22
SIM,1776,87,na,1863,54
SIM,1947,18,20-24,1965,132
STAT,1813,104,na,1917,0.028209276876254144
STAT,1856,31,50-100,1887,0.6933873235666583
STAT,1895,58,na,1953,2437.981753925109
STAT,1908,39,25-29,1947,0.8619069247930913
STAT,1893,49,30-34,1942,0.06408183221348478
STAT,1924,16,45-49,1940,0.5634040160470475
SIM,1814,51,na,1865,1227
SIM,1832,69,na,1901,906
SIM,1914,26,45-49,1940,1
SIM,1902,33,25-29,1935,4
SIM,1885,21,20-24,1906,68
SIM,1832,41,35-39,1873,2
SIM,1903,45,na,1948,3080
STAT,1834,46,na,1880,1495.7939243460976
STAT,1898,41,35-39,1939,0.16153578826536108
STAT,1872,63,na,1935,1691.8814011358797
STAT,1888,9,na,1897,2895.636883069249
STAT,1893,45,15-19,1938,2.731437186116532E-4
STAT,1917,26,20-24,1943,18.14575124463975
STAT,1849,40,35-39,1889,1.328029584255193
SIM,1864,31,50-100,1895,4
SIM,1918,37,na,1955,3692
STAT,1921,29,15-19,1950,0.7380234455490448
STAT,1939,18,20-24,1957,128.14677192469225
STAT,1918,22,30-34,1940,29.28310055878184
SIM,1872,67,na,1939,1480
STAT,1939,24,40-44,1963,3.1874754783846613
SIM,1855,27,na,1882,1991
STAT,1918,27,25-29,1945,66.17166894047199
SIM,1771,88,na,1859,31
SIM,1920,41,na,1961,3822
SIM,1930,20,30-34,1950,36
SIM,1934,22,na,1956,4567
STAT,1851,27,30-34,1878,21.621472617351976
SIM,1899,1,na,1900,3438
STAT,1854,82,na,1936,335.98331434005075
STAT,1766,111,na,1877,0.0011337006437365012
STAT,1804,50,30-34,1854,0.018425673965577823
STAT,1881,19,40-44,1900,0.16593922699132005
STAT,1914,39,25-29,1953,0.9191927295097451
STAT,1838,27,na,1865,1876.7802133943956
SIM,1854,33,35-39,1887,9
STAT,1884,44,50-100,1928,0.9729274131501631
STAT,1885,47,30-34,1932,0.0906814205159987
SIM,1857,40,35-39,1897,4
SIM,1792,87,na,1879,40
SIM,1913,23,na,1936,3352
STAT,1834,29,20-24,1863,9.385823861963699
SIM,1934,29,25-29,1963,93
SIM,1834,98,na,1932,4
SIM,1837,35,25-29,1872,2
STAT,1796,86,na,1882,77.28184300976473
STAT,1831,37,50-100,1868,0.9695494058678814
STAT,1875,81,na,1956,559.720085185695
STAT,1869,52,20-24,1921,6.711884336057387E-4
SIM,1889,32,45-49,1921,3
SIM,1910,15,20-24,1925,24
SIM,1906,26,45-49,1932,1
STAT,1917,22,na,1939,3666.3710025961323
STAT,1824,41,35-39,1865,2.3497136784972183
SIM,1790,91,na,1881,13
STAT,1853,23,25-29,1876,49.800789385373825
SIM,1855,97,na,1952,5
STAT,1928,29,50-100,1957,1.1574089048701472
STAT,1901,25,30-34,1926,33.52360001458209
SIM,1909,24,20-24,1933,90
STAT,1930,40,35-39,1970,0.2510019574971028
STAT,1882,20,25-29,1902,52.93701150233996
STAT,1909,44,25-29,1953,0.062306480925052726
SIM,1922,39,25-29,1961,3
STAT,1887,43,25-29,1930,0.6735357983306152
SIM,1841,46,na,1887,1595
SIM,1842,29,20-24,1871,9
STAT,1874,25,35-39,1899,9.379549796800147
STAT,1896,21,30-34,1917,22.30635133077743
STAT,1830,47,40-44,1877,0.1254766121227087
SIM,1922,37,na,1959,4055
STAT,1822,48,45-49,1870,0.3245432104385173
STAT,1849,20,30-34,1869,15.747981590181597
SIM,1902,60,na,1962,2719
STAT,1917,43,20-24,1960,0.017382559336744968
SIM,1937,23,45-49,1960,3
SIM,1944,26,30-34,1970,44
STAT,1895,1,na,1896,3355.516419163195
STAT,1886,22,na,1908,2360.6121342484803
SIM,1901,38,na,1939,3178
STAT,1861,22,20-24,1883,55.53819186593709
STAT,1899,18,15-19,1917,7.662820050554854
STAT,1930,42,50-100,1972,0.14603239574730745
SIM,1926,27,25-29,1953,87
SIM,1923,30,40-44,1953,5
STAT,1793,68,na,1861,699.410813136237
SIM,1802,66,na,1868,794
STAT,1806,65,na,1871,802.2102901497285
SIM,1914,19,20-24,1933,32
STAT,1907,31,45-49,1938,1.3949520363443764
SIM,1878,20,25-29,1898,60
STAT,1917,37,35-39,1954,2.373228294421754
STAT,1867,101,na,1968,3.2906248210619977
STAT,1852,44,15-19,1896,0.010350699941751768
STAT,1925,17,15-19,1942,51.79723534072583
STAT,1930,19,50-100,1949,0.4551524186461856
SIM,1897,31,40-44,1928,9
STAT,1836,53,na,1889,1348.760058266763
SIM,1837,30,30-34,1867,16
STAT,1841,23,50-100,1864,0.35090827388360935
SIM,1819,50,na,1869,1296
STAT,1906,19,20-24,1925,24.256743101572006
STAT,1938,21,na,1959,3415.0272139470176
SIM,1915,31,45-49,1946,2
SIM,1853,31,na,1884,1986
SIM,1857,20,30-34,1877,24
STAT,1923,48,15-19,1971,4.0600014644214287E-4
SIM,1863,106,na,1969,1
SIM,1880,32,25-29,1912,15
STAT,1831,31,25-29,1862,8.508977759504726
SIM,1867,40,45-49,1907,5
STAT,1858,107,na,1965,0.024207918723613837
SIM,1906,37,25-29,1943,3
SIM,1773,95,na,1868,2
SIM,1788,72,na,1860,486
STAT,1872,53,40-44,1925,0.009822064325472852
STAT,1895,42,20-24,1937,0.013578950752107438
SIM,1841,39,30-34,1880,6
SIM,1859,27,25-29,1886,38
SIM,1929,5,na,1934,4928
STAT,1954,17,na,1971,4298.47304122617
STAT,1944,17,25-29,1961,44.05504173507617
SIM,1878,31,30-34,1909,22
SIM,1872,35,50-100,1907,1
STAT,1850,31,35-39,1881,7.535995319933738
STAT,1942,15,25-29,1957,42.80281955867161
SIM,1952,17,25-29,1969,45
STAT,1821,54,na,1875,1248.2502882098977
STAT,1811,47,30-34,1858,0.32229972086681
STAT,1857,40,35-39,1897,1.3622128794138055
SIM,1861,23,25-29,1884,61
SIM,1884,36,25-29,1920,4
STAT,1902,15,20-24,1917,23.744569417993226
SIM,1855,37,50-100,1892,4
STAT,1848,30,40-44,1878,3.719913972959379
SIM,1918,36,30-34,1954,1
STAT,1856,21,35-39,1877,5.050795803675968
STAT,1915,30,40-44,1945,3.7950538902398145
SIM,1950,15,25-29,1965,55
STAT,1833,39,30-34,1872,3.972197965900928
STAT,1865,45,na,1910,1950.619063176858
STAT,1824,68,na,1892,806.7930734162617
SIM,1791,76,na,1867,341
STAT,1912,26,45-49,1938,1.613476063819335
SIM,1876,20,40-44,1896,2
STAT,1800,101,na,1901,0.2274548458216972
SIM,1947,24,40-44,1971,4
STAT,1871,41,30-34,1912,1.081586132705446
STAT,1932,16,45-49,1948,0.6264314612990823
SIM,1823,65,na,1888,868
STAT,1806,87,na,1893,58.62389425568606
STAT,1862,32,15-19,1894,0.11475749118005604
SIM,1920,26,45-49,1946,3
SIM,1935,6,na,1941,5154
STAT,1872,23,35-39,1895,5.516118018886495
STAT,1868,20,40-44,1888,1.9068315128046374
STAT,1921,35,35-39,1956,2.555998181079617
SIM,1838,79,na,1917,420
SIM,1879,21,20-24,1900,59
SIM,1885,49,50-100,1934,3
STAT,1915,15,50-100,1930,0.07441388046628276
STAT,1928,44,35-39,1972,0.24172511417484527
SIM,1890,20,25-29,1910,72
STAT,1871,45,na,1916,2128.080265870353
SIM,1837,47,50-100,1884,3
STAT,1828,51,20-24,1879,6.122040347376627E-4
SIM,1871,82,na,1953,416
STAT,1936,14,na,1950,3571.42221173048
STAT,1886,44,na,1930,2275.765350490531
STAT,1829,35,25-29,1864,2.661556385538649
SIM,1856,30,40-44,1886,2
SIM,1926,22,30-34,1948,33
SIM,1933,19,30-34,1952,14
STAT,1943,27,35-39,1970,15.10463372695012
STAT,1925,19,30-34,1944,13.836816306205678
SIM,1911,27,30-34,1938,40
STAT,1811,48,50-100,1859,0.8037839917946943
STAT,1896,26,25-29,1922,52.995932549007954
SIM,1908,39,25-29,1947,1
STAT,1775,87,na,1862,48.810686231600165
STAT,1877,49,50-100,1926,0.23573884214561633
SIM,1904,24,45-49,1928,1
STAT,1861,100,na,1961,2.124735224673888
STAT,1903,27,30-34,1930,33.84530563885335
SIM,1883,24,15-19,1907,6
SIM,1854,16,na,1870,2170
SIM,1904,30,30-34,1934,33
STAT,1829,47,50-100,1876,0.19817341529892893
SIM,1854,10,na,1864,2246
STAT,1900,39,30-34,1939,1.4924532940268922
SIM,1820,85,na,1905,106
STAT,1925,47,35-39,1972,0.1476095774147108
SIM,1865,97,na,1962,9
STAT,1842,21,35-39,1863,5.279238416099679
STAT,1875,39,25-29,1914,2.766246240662883
STAT,1880,20,15-19,1900,3.2987904039984364
STAT,1845,22,15-19,1867,2.884811732592567
STAT,1872,38,45-49,1910,1.8808531562265567
SIM,1937,23,35-39,1960,7
STAT,1921,17,50-100,1938,0.4034734593209686
SIM,1872,35,na,1907,2220
STAT,1874,25,45-49,1899,1.0793056955318296
STAT,1932,23,50-100,1955,0.8130961393193482
SIM,1830,44,40-44,1874,5
STAT,1856,34,40-44,1890,3.181238773458837
STAT,1859,35,20-24,1894,0.5866812617642626
STAT,1796,70,na,1866,709.6740919109509
SIM,1860,8,na,1868,2390
STAT,1831,42,40-44,1873,1.7131502813992552
STAT,1915,34,45-49,1949,1.500886618407842
SIM,1912,20,25-29,1932,89
STAT,1889,40,30-34,1929,1.354355292230544
SIM,1924,22,na,1946,4023
STAT,1849,27,na,1876,1848.3629678011669
STAT,1839,37,45-49,1876,1.588412196411313
STAT,1941,31,35-39,1972,9.068462719325614
STAT,1871,51,25-29,1922,0.003333120753044632
STAT,1911,18,25-29,1929,8.16888246895819
STAT,1841,47,na,1888,1546.300466395578
STAT,1920,25,40-44,1945,4.863282299346688
STAT,1857,48,20-24,1905,0.00882471581798884
STAT,1918,44,40-44,1962,0.25038711559924703
SIM,1940,31,40-44,1971,11
SIM,1914,36,45-49,1950,3
SIM,1848,40,35-39,1888,4
STAT,1869,21,45-49,1890,0.6395816438465594
SIM,1924,36,30-34,1960,6
SIM,1907,39,35-39,1946,10
SIM,1783,88,na,1871,35
STAT,1784,85,na,1869,69.56639886963201
STAT,1934,27,35-39,1961,19.079470820051114
STAT,1822,44,40-44,1866,3.2163240950938317
STAT,1858,63,na,1921,1323.2928718457947
SIM,1853,38,50-100,1891,4
STAT,1935,34,15-19,1969,0.16772732613744573
SIM,1864,21,35-39,1885,7
SIM,1883,39,25-29,1922,5
SIM,1885,18,25-29,1903,8
SIM,1877,82,na,1959,515
STAT,1825,45,20-24,1870,0.01293398189347168
SIM,1799,87,na,1886,43
SIM,1853,22,15-19,1875,2
STAT,1930,29,15-19,1959,0.8472097419814156
STAT,1932,31,40-44,1963,4.917448718151356
SIM,1888,46,50-100,1934,2
SIM,1910,34,35-39,1944,8
SIM,1844,24,15-19,1868,6
SIM,1876,25,20-24,1901,12
SIM,1838,95,na,1933,11
STAT,1814,45,45-49,1859,0.6613975331583514
STAT,1833,21,40-44,1854,2.196185040085518
STAT,1920,16,25-29,1936,46.045688778666666
STAT,1808,48,25-29,1856,0.215659310149899
SIM,1928,23,40-44,1951,6
STAT,1861,16,20-24,1877,16.079910460688115
STAT,1902,41,25-29,1943,0.0597176692125949
SIM,1841,21,40-44,1862,3
SIM,1912,37,na,1949,3322
STAT,1948,18,20-24,1966,146.5367274406673
SIM,1781,77,na,1858,274
SIM,1908,26,20-24,1934,15
STAT,1904,20,25-29,1924,78.02043095890049
SIM,1942,27,35-39,1969,20
STAT,1936,19,na,1955,3310.603872917347
SIM,1933,29,35-39,1962,24
STAT,1862,28,50-100,1890,0.5136738087210452
STAT,1868,28,25-29,1896,38.020604820246646
SIM,1926,44,40-44,1970,3
SIM,1795,73,na,1868,455
STAT,1892,36,20-24,1928,0.9163085835461602
STAT,1836,42,15-19,1878,0.010374409427388877
STAT,1853,32,na,1885,1822.4316429163603
STAT,1883,38,20-24,1921,0.7101636627393629
STAT,1885,65,na,1950,1590.5578378832718
STAT,1844,19,25-29,1863,4.997447300474562
SIM,1881,37,50-100,1918,1
SIM,1832,23,40-44,1855,5
SIM,1835,24,20-24,1859,56
SIM,1901,65,na,1966,2440
STAT,1848,35,45-49,1883,1.511042600233131
SIM,1907,15,20-24,1922,29
STAT,1926,34,20-24,1960,2.782981893561025
STAT,1909,37,25-29,1946,0.880191772039553
STAT,1946,20,30-34,1966,30.23617366878029
STAT,1853,53,30-34,1906,0.004343578481343623
STAT,1954,15,40-44,1969,1.6343170984489837
SIM,1910,25,20-24,1935,19
SIM,1882,22,40-44,1904,2
SIM,1874,40,35-39,1914,5
STAT,1912,21,15-19,1933,4.832799038456829
STAT,1909,44,15-19,1953,0.0013399244104592516
STAT,1906,41,40-44,1947,0.21583453492488078
SIM,1920,21,15-19,1941,5
STAT,1865,27,45-49,1892,0.9531339797703786
STAT,1883,22,35-39,1905,5.402879075863871
STAT,1902,34,35-39,1936,7.685834084010787
SIM,1896,73,na,1969,1835
STAT,1937,18,45-49,1955,0.45782755546602577
STAT,1944,18,na,1962,3740.7034136028637
SIM,1845,16,30-34,1861,1
SIM,1909,18,35-39,1927,4
STAT,1866,46,20-24,1912,0.010481543610416337
STAT,1850,54,45-49,1904,0.009935818590421905
STAT,1866,40,35-39,1906,1.5931134532194673
STAT,1934,18,20-24,1952,172.77959219471285
SIM,1868,30,na,1898,2173
STAT,1907,29,15-19,1936,0.6197375773621532
SIM,1843,30,50-100,1873,4
STAT,1923,7,na,1930,4434.60679960672
SIM,1824,31,35-39,1855,11
STAT,1897,22,35-39,1919,7.372635189489104
STAT,1841,46,15-19,1887,2.784619043941554E-4
SIM,1922,43,na,1965,4042
SIM,1856,35,45-49,1891,1
SIM,1886,59,na,1945,1866
SIM,1924,38,na,1962,4148
SIM,1851,77,na,1928,566
STAT,1822,108,na,1930,9.461455834199734E-4
STAT,1854,6,na,1860,2148.998013137378
STAT,1943,29,25-29,1972,66.15398492584627
STAT,1805,92,na,1897,13.945409502329015
SIM,1847,68,na,1915,1101
STAT,1826,54,na,1880,1240.362909009144
SIM,1793,62,na,1855,800
SIM,1924,29,40-44,1953,8
SIM,1839,33,na,1872,1790
STAT,1905,27,na,1932,3257.9751377666116
SIM,1768,95,na,1863,3
STAT,1916,36,30-34,1952,1.7716205660734579
STAT,1851,21,na,1872,1885.9484726348421
STAT,1877,25,15-19,1902,0.4477897840879842
SIM,1921,19,15-19,1940,45
SIM,1859,41,na,1900,1928
SIM,1882,48,50-100,1930,2
STAT,1913,19,15-19,1932,8.716798258961312
SIM,1910,16,35-39,1926,2
STAT,1805,52,40-44,1857,0.03071337480256808
STAT,1822,40,na,1862,1460.278971054507
STAT,1915,41,35-39,1956,0.19177646111074784
SIM,1917,37,25-29,1954,1
STAT,1900,46,20-24,1946,0.008896567487680524
SIM,1829,43,na,1872,1460
SIM,1934,34,20-24,1968,3
STAT,1876,13,na,1889,2521.901712582432
STAT,1835,90,na,1925,49.19097697937016
STAT,1902,25,20-24,1927,15.745867896965855
SIM,1838,31,35-39,1869,8
STAT,1929,23,35-39,1952,11.214553621674472
STAT,1883,2,na,1885,2918.7102435832912
STAT,1872,43,40-44,1915,2.117361893478725
STAT,1891,38,50-100,1929,1.4284872551873484
SIM,1783,72,na,1855,466
SIM,1809,98,na,1907,3
STAT,1881,54,45-49,1935,0.012873390993511537
STAT,1903,23,15-19,1926,4.420296291572097
SIM,1902,26,25-29,1928,59
STAT,1933,19,15-19,1952,57.08484065153045
SIM,1931,15,40-44,1946,1
STAT,1882,47,15-19,1929,3.659854837251795E-4
SIM,1833,35,50-100,1868,3
SIM,1861,51,na,1912,1857
SIM,1863,43,40-44,1906,3
SIM,1898,44,na,1942,2895
STAT,1865,47,15-19,1912,3.417768005064223E-4
STAT,1928,25,40-44,1953,5.462113611262466
STAT,1919,35,na,1954,3839.5230986585084
STAT,1932,26,45-49,1958,2.138671533455905
SIM,1888,38,45-49,1926,1
SIM,1874,40,50-100,1914,1
SIM,1872,39,na,1911,2181
STAT,1904,39,15-19,1943,0.016255820305145666
SIM,1880,43,40-44,1923,6
SIM,1951,16,20-24,1967,138
STAT,1941,25,50-100,1966,0.9734807700304651
SIM,1879,32,35-39,1911,12
STAT,1917,36,20-24,1953,0.25989336966638205
SIM,1929,31,50-100,1960,2
STAT,1869,27,30-34,1896,23.02725565781229
STAT,1926,16,20-24,1942,157.43289634190717
STAT,1804,53,35-39,1857,0.025092804486756024
SIM,1843,26,20-24,1869,15
SIM,1897,20,35-39,1917,9
STAT,1858,43,50-100,1901,0.7778362061776856
STAT,1896,47,45-49,1943,0.16543429404592017
SIM,1836,29,na,1865,1735
STAT,1850,16,45-49,1866,0.056528572185990236
STAT,1892,20,35-39,1912,6.944602217225364
STAT,1842,37,20-24,1879,0.6439377069337534
STAT,1923,40,na,1963,4112.488492194444
SIM,1934,16,20-24,1950,166
STAT,1877,43,15-19,1920,0.013440214857287101
STAT,1943,16,20-24,1959,135.84893359437103
STAT,1920,23,15-19,1943,5.573605320274889
STAT,1835,26,20-24,1861,9.608659449488172
STAT,1916,29,40-44,1945,4.520128645211651
SIM,1852,19,25-29,1871,9
STAT,1839,20,20-24,1859,59.895941754907824
SIM,1919,25,40-44,1944,9
STAT,1942,26,30-34,1968,38.86538703800341
STAT,1923,15,40-44,1938,1.5589348916883077
STAT,1851,38,25-29,1889,2.111928914897645
SIM,1925,18,20-24,1943,127
STAT,1815,86,na,1901,94.96328444453174
SIM,1945,15,40-44,1960,2
SIM,1893,17,20-24,1910,22
SIM,1942,18,20-24,1960,129
STAT,1869,41,15-19,1910,0.012685355990537833
STAT,1918,42,15-19,1960,0.0015424283101789001
STAT,1946,13,na,1959,4115.311611175497
SIM,1852,15,na,1867,2205
STAT,1845,40,15-19,1885,0.01016267255407861
SIM,1840,34,na,1874,1731
STAT,1903,33,40-44,1936,3.332710541410663
STAT,1937,20,na,1957,3361.312925202099
SIM,1832,48,50-100,1880,1
SIM,1844,48,na,1892,1573
STAT,1910,18,35-39,1928,0.7831783796732252
SIM,1889,41,35-39,1930,4
STAT,1878,20,50-100,1898,0.40343535524486074
SIM,1877,23,15-19,1900,5
SIM,1911,33,40-44,1944,4
STAT,1934,36,20-24,1970,0.3439595274662612
STAT,1830,50,25-29,1880,0.0026105358526518248
SIM,1918,38,na,1956,3690
STAT,1794,75,na,1869,390.629857768035
SIM,1917,52,na,1969,3496
STAT,1894,15,20-24,1909,21.644167486398317
STAT,1885,17,20-24,1902,16.685727839603878
STAT,1846,78,na,1924,550.8961697469426
SIM,1897,28,45-49,1925,2
STAT,1917,16,na,1933,3935.838368380352
STAT,1942,19,40-44,1961,1.379874888732124
SIM,1904,18,na,1922,3388
SIM,1847,20,20-24,1867,50
SIM,1916,37,35-39,1953,10
STAT,1917,18,20-24,1935,27.487783486754875
STAT,1912,23,40-44,1935,3.0340161482057693
STAT,1828,40,15-19,1868,0.012597698371092819
STAT,1923,33,40-44,1956,4.2358728367745995
STAT,1921,21,na,1942,3908.6277092402324
STAT,1810,55,na,1865,1158.6081545958093
STAT,1850,83,na,1933,279.4797644272373
SIM,1823,50,na,1873,1269
SIM,1852,24,20-24,1876,56
STAT,1925,35,na,1960,4273.6566519546595
STAT,1814,69,na,1883,716.5336798905203
STAT,1840,35,45-49,1875,1.6764732636267388
SIM,1892,43,na,1935,2780
STAT,1889,20,35-39,1909,6.84636406224178
STAT,1881,36,45-49,1917,1.827098695891963
SIM,1905,25,40-44,1930,4
SIM,1931,33,40-44,1964,7
STAT,1887,60,na,1947,2014.9286938064774
STAT,1914,48,15-19,1962,3.44109239366212E-4
STAT,1898,49,20-24,1947,0.00847564042315135
SIM,1871,97,na,1968,23
STAT,1870,47,25-29,1917,0.05306998838631666
STAT,1886,41,15-19,1927,0.013846293453776859
SIM,1911,16,25-29,1927,8
STAT,1871,44,35-39,1915,1.6730142448005418
STAT,1906,44,na,1950,3147.2788076065544
SIM,1901,36,35-39,1937,3
STAT,1908,46,20-24,1954,0.009510503193538878
SIM,1890,39,50-100,1929,1
SIM,1868,38,50-100,1906,1
SIM,1878,24,na,1902,2364
STAT,1844,24,20-24,1868,59.53783108726993
SIM,1883,20,35-39,1903,3
SIM,1941,19,15-19,1960,36
SIM,1857,41,50-100,1898,2
SIM,1946,21,35-39,1967,11
STAT,1889,28,45-49,1917,1.29035734602058
STAT,1895,31,15-19,1926,0.17627759985820018
STAT,1910,36,35-39,1946,2.1952112460941122
SIM,1911,23,15-19,1934,4
SIM,1920,23,40-44,1943,5
SIM,1936,25,40-44,1961,8
STAT,1840,53,45-49,1893,0.009944413894900576
STAT,1908,37,35-39,1945,2.1388529333373776
SIM,1836,18,30-34,1854,1
STAT,1821,86,na,1907,119.81284682410725
STAT,1835,47,na,1882,1479.5808334336646
SIM,1916,28,20-24,1944,20
STAT,1900,43,na,1943,3017.590711816616
SIM,1884,24,na,1908,2300
STAT,1876,27,20-24,1903,11.441161202473523
STAT,1899,41,na,1940,3016.08129240569
STAT,1858,59,na,1917,1441.33056822011
STAT,1938,29,45-49,1967,1.6151038582261934
STAT,1889,33,40-44,1922,5.0364471684212235
STAT,1900,23,45-49,1923,0.911078391715612
STAT,1770,113,na,1883,3.48559747908568E-4
SIM,1897,33,40-44,1930,7
SIM,1886,43,na,1929,2242
SIM,1847,37,45-49,1884,1
STAT,1917,45,35-39,1962,0.1278132975548751
STAT,1927,32,15-19,1959,0.14934983418548115
SIM,1950,19,40-44,1969,2
SIM,1918,25,50-100,1943,1
STAT,1886,23,15-19,1909,3.2826606987447273
SIM,1894,23,15-19,1917,4
SIM,1881,12,na,1893,2158
STAT,1834,38,25-29,1872,2.193919790344989
STAT,1882,36,50-100,1918,1.134034647874436
SIM,1842,38,25-29,1880,3
STAT,1908,28,20-24,1936,16.240414630114852
STAT,1810,52,20-24,1862,0.0025045662091552736
STAT,1844,83,na,1927,278.68851506827247
STAT,1915,21,na,1936,3576.4819546165118
STAT,1937,27,50-100,1964,0.9164705996478953
STAT,1820,69,na,1889,775.8624920202283
STAT,1938,21,35-39,1959,8.805419760435312
SIM,1884,27,20-24,1911,10
SIM,1902,23,na,1925,3152
STAT,1846,48,45-49,1894,0.16430631441628657
SIM,1906,37,na,1943,3329
SIM,1907,36,30-34,1943,1
SIM,1841,24,45-49,1865,1
SIM,1964,3,na,1967,4486
STAT,1916,39,35-39,1955,2.316318896210936
STAT,1875,36,20-24,1911,0.7517389845572793
STAT,1814,42,40-44,1856,7.005627705749021
STAT,1907,17,20-24,1924,24.597753037395147
SIM,1894,15,15-19,1909,5
STAT,1910,41,30-34,1951,0.114766082927067
SIM,1810,102,na,1912,1
STAT,1882,24,40-44,1906,1.9035497989954118
SIM,1814,41,na,1855,1394
STAT,1869,19,30-34,1888,1.4603197714766079
STAT,1839,46,50-100,1885,0.16900085675566462
STAT,1827,71,na,1898,740.7466990201596
STAT,1840,50,40-44,1890,0.007436989621576428
STAT,1892,49,50-100,1941,0.16047045517841144
SIM,1825,29,na,1854,1608
SIM,1883,42,50-100,1925,1
STAT,1921,20,25-29,1941,99.15626557902206
STAT,1820,53,20-24,1873,0.001146487316122953
SIM,1823,33,40-44,1856,4
STAT,1902,4,na,1906,3507.0965044530767
STAT,1853,28,na,1881,1852.3846713856697
STAT,1804,79,na,1883,294.21318336421945
SIM,1873,52,na,1925,2060
STAT,1842,45,20-24,1887,0.008768606967085098
SIM,1795,69,na,1864,661
SIM,1938,27,45-49,1965,1
SIM,1890,24,40-44,1914,3
STAT,1827,34,15-19,1861,0.15218659188617337
STAT,1881,33,40-44,1914,3.9390167419069764
STAT,1922,45,45-49,1967,0.23699925008248163
STAT,1911,15,20-24,1926,25.742781729966996
STAT,1809,54,50-100,1863,0.05029565546341805
STAT,1950,18,na,1968,4110.454933487918
STAT,1886,15,15-19,1901,5.950939525031013
STAT,1829,33,50-100,1862,0.8710570534883703
STAT,1850,36,15-19,1886,0.04057813986972944
SIM,1910,31,30-34,1941,20
STAT,1824,46,15-19,1870,4.7675761886453125E-4
STAT,1900,15,45-49,1915,0.08600875198420545
STAT,1875,75,na,1950,999.1320883309982
SIM,1802,56,na,1858,1074
SIM,1806,48,50-100,1854,3
SIM,1847,46,50-100,1893,1
SIM,1833,21,35-39,1854,7
STAT,1969,3,na,1972,4641.405431918621
STAT,1847,31,35-39,1878,8.840189562825008
SIM,1935,7,na,1942,5139
SIM,1835,27,25-29,1862,40
STAT,1894,25,15-19,1919,0.5550890490578666
SIM,1915,17,20-24,1932,24
STAT,1874,22,40-44,1896,2.0119831385758156
SIM,1903,21,15-19,1924,3
STAT,1854,51,25-29,1905,0.002562786601299602
STAT,1937,15,40-44,1952,1.291256534662869
SIM,1895,2,na,1897,3326
SIM,1888,21,20-24,1909,76
STAT,1903,31,15-19,1934,0.19218280497015225
STAT,1951,18,20-24,1969,152.47493555694322
STAT,1868,25,20-24,1893,10.653288003203276
STAT,1883,46,20-24,1929,0.011141950265961693
STAT,1943,26,20-24,1969,18.372926226283557
SIM,1901,17,20-24,1918,30
SIM,1859,20,40-44,1879,2
SIM,1863,15,na,1878,2264
STAT,1931,29,50-100,1960,1.2127948260199377
SIM,1830,99,na,1929,1
SIM,1916,29,35-39,1945,15
STAT,1835,78,na,1913,487.49673614064943
SIM,1901,37,na,1938,3198
SIM,1870,96,na,1966,28
SIM,1855,31,35-39,1886,9
STAT,1830,43,35-39,1873,1.358359815487832
STAT,1891,37,15-19,1928,0.0656619067292763
STAT,1922,27,15-19,1949,0.7547023385072512
SIM,1834,34,na,1868,1621
SIM,1882,29,na,1911,2124
STAT,1848,42,35-39,1890,1.3029467435957311
STAT,1876,52,50-100,1928,0.014650627750292909
SIM,1849,16,15-19,1865,5
STAT,1851,53,20-24,1904,5.324400176269159E-4
STAT,1863,15,50-100,1878,0.04697546611493941
STAT,1848,32,40-44,1880,3.643457498206186
STAT,1908,29,35-39,1937,13.308856448018187
SIM,1910,28,25-29,1938,56
STAT,1923,36,45-49,1959,0.7469570551934409
SIM,1822,42,40-44,1864,4
STAT,1822,52,40-44,1874,0.014133090165590808
SIM,1856,32,40-44,1888,4
SIM,1933,26,30-34,1959,56
STAT,1902,28,25-29,1930,56.19555396252659
STAT,1876,29,na,1905,2310.834810983821
STAT,1899,57,na,1956,2622.3179630396653
SIM,1907,29,40-44,1936,5
SIM,1882,25,45-49,1907,3
SIM,1924,39,35-39,1963,8
STAT,1911,35,40-44,1946,1.3785911485825362
SIM,1883,82,na,1965,669
SIM,1948,16,20-24,1964,138
SIM,1846,20,30-34,1866,20
SIM,1826,34,20-24,1860,4
STAT,1866,23,na,1889,2061.839884306337
SIM,1838,48,na,1886,1449
SIM,1856,4,na,1860,2361
STAT,1867,102,na,1969,2.0348894830965287
SIM,1876,28,25-29,1904,45
SIM,1912,53,na,1965,3122
STAT,1893,56,na,1949,2444.737996742027
SIM,1789,73,na,1862,474
STAT,1885,25,20-24,1910,11.11630830025663
STAT,1867,40,na,1907,2070.756735724315
SIM,1883,36,20-24,1919,3
STAT,1902,16,35-39,1918,0.7333071828080225
STAT,1861,54,20-24,1915,5.629617023112205E-4
STAT,1925,44,30-34,1969,0.14575288913127887
SIM,1835,19,25-29,1854,4
SIM,1885,15,20-24,1900,18
STAT,1841,23,40-44,1864,1.7931411490874214
STAT,1868,89,na,1957,118.9248761423384
STAT,1816,64,na,1880,945.014844546909
SIM,1907,38,na,1945,3313
STAT,1864,75,na,1939,869.1859123357815
SIM,1861,67,na,1928,1327
STAT,1918,47,45-49,1965,0.218485752384258
STAT,1908,47,35-39,1955,0.11012591665348002
SIM,1927,27,50-100,1954,1
STAT,1838,20,30-34,1858,15.990451204073574
SIM,1828,65,na,1893,880
SIM,1893,25,20-24,1918,12
STAT,1943,19,25-29,1962,43.38136653820102
SIM,1942,19,35-39,1961,7
STAT,1894,43,15-19,1937,0.001156957038242749
STAT,1855,46,45-49,1901,0.16761843541645183
STAT,1923,18,45-49,1941,0.5527355188012243
STAT,1866,30,35-39,1896,8.891464391293367
STAT,1819,38,50-100,1857,2.93494331045425
SIM,1861,17,25-29,1878,7
STAT,1829,78,na,1907,478.91682251592397
STAT,1922,28,50-100,1950,1.060337827393424
STAT,1882,84,na,1966,557.4880736923494
STAT,1909,19,25-29,1928,7.98304582104506
STAT,1881,51,40-44,1932,0.009648677511342293
STAT,1853,17,25-29,1870,5.055322190848531
STAT,1929,16,45-49,1945,0.6037735326144098
SIM,1870,43,30-34,1913,5
SIM,1838,44,40-44,1882,5
STAT,1910,33,30-34,1943,14.2863623379825
SIM,1923,26,45-49,1949,2
STAT,1834,35,20-24,1869,0.6059647633276939
STAT,1765,105,na,1870,0.018503139033467036
STAT,1927,36,30-34,1963,2.142867012508642
SIM,1904,19,15-19,1923,9
SIM,1865,81,na,1946,394
SIM,1887,21,30-34,1908,22
SIM,1827,38,50-100,1865,3
STAT,1791,105,na,1896,0.005381828052048379
SIM,1901,49,50-100,1950,2
STAT,1879,21,30-34,1900,17.641520781808484
SIM,1813,87,na,1900,58
SIM,1887,35,50-100,1922,4
STAT,1915,26,45-49,1941,1.6702258585097693
SIM,1917,19,25-29,1936,60
STAT,1935,27,25-29,1962,84.75513403891178
STAT,1837,26,na,1863,1765.3837745730568
STAT,1889,36,45-49,1925,2.336137837509222
SIM,1890,64,na,1954,2022
STAT,1904,29,15-19,1933,0.6102934060505957
SIM,1771,87,na,1858,39
SIM,1943,27,25-29,1970,80
STAT,1900,59,na,1959,2630.8292372853066
STAT,1831,37,45-49,1868,1.574257986770877
SIM,1841,47,na,1888,1576
SIM,1841,31,35-39,1872,11
STAT,1917,39,25-29,1956,0.9602093848058456
STAT,1892,30,35-39,1922,12.076687881725618
STAT,1873,49,15-19,1922,3.7555450510779056E-4
STAT,1920,36,na,1956,3895.1009625818815
STAT,1812,105,na,1917,0.012610771665273758
SIM,1889,26,45-49,1915,1
SIM,1871,81,na,1952,478
STAT,1828,65,na,1893,959.3520071700486
STAT,1829,53,40-44,1882,0.007321240871533394
STAT,1860,25,20-24,1885,9.235588608955185
SIM,1914,41,40-44,1955,2
SIM,1804,83,na,1887,107
SIM,1895,48,50-100,1943,2
STAT,1816,47,20-24,1863,0.031595988578594504
SIM,1888,54,na,1942,2285
STAT,1897,35,40-44,1932,5.5831291389441216
STAT,1915,16,45-49,1931,0.09900221094248833
STAT,1896,44,40-44,1940,0.1923813322851881
STAT,1824,90,na,1914,41.62290636900301
STAT,1886,43,na,1929,2290.2396651744343
SIM,1852,28,50-100,1880,1
SIM,1925,39,25-29,1964,1
SIM,1859,57,na,1916,1672
STAT,1926,46,40-44,1972,0.18425607786390685
STAT,1805,96,na,1901,2.8750574017529846
SIM,1897,36,45-49,1933,2
STAT,1833,31,35-39,1864,8.026044564926977
STAT,1795,109,na,1904,1.3743965461358865E-4
STAT,1827,27,25-29,1854,113.75060450564003
STAT,1863,45,40-44,1908,0.14358414740823172
STAT,1938,26,40-44,1964,4.363781697085115
STAT,1910,15,30-34,1925,2.2915202805086174
STAT,1833,23,50-100,1856,0.33962271174613223
STAT,1802,72,na,1874,543.2288551894957
SIM,1899,7,na,1906,3368
STAT,1942,29,35-39,1971,14.87058512849323
SIM,1877,19,30-34,1896,2
STAT,1768,90,na,1858,16.730263017893886
STAT,1894,18,25-29,1912,6.868281065717628
SIM,1928,30,30-34,1958,25
STAT,1820,54,50-100,1874,0.023001902277154363
STAT,1887,48,50-100,1935,0.2562152264538849
SIM,1777,88,na,1865,28
SIM,1921,29,50-100,1950,1
SIM,1907,22,na,1929,3297
STAT,1934,37,35-39,1971,3.153127570660263
STAT,1871,36,35-39,1907,6.655980435881495
SIM,1881,44,na,1925,1886
SIM,1919,23,na,1942,3776
STAT,1912,20,50-100,1932,0.5991348960022425
STAT,1876,60,na,1936,1859.987271567787
SIM,1848,85,na,1933,160
SIM,1911,36,45-49,1947,3
SIM,1832,70,na,1902,856
STAT,1887,49,45-49,1936,0.13770812393274112
STAT,1920,37,35-39,1957,2.501911903166974
SIM,1836,84,na,1920,204
SIM,1864,34,40-44,1898,4
SIM,1905,28,45-49,1933,2
SIM,1936,21,25-29,1957,76
STAT,1870,99,na,1969,10.9671264644471
STAT,1934,19,35-39,1953,5.332930519553737
SIM,1951,19,25-29,1970,60
STAT,1852,5,na,1857,2310.6599946030083
STAT,1853,42,15-19,1895,0.010228868865066987
STAT,1833,24,45-49,1857,0.5693668811097912
STAT,1911,23,20-24,1934,99.29411523101396
SIM,1907,47,50-100,1954,3
STAT,1903,36,45-49,1939,0.5810893804990712
SIM,1886,17,30-34,1903,1
STAT,1847,63,na,1910,1312.8709039601001
SIM,1842,84,na,1926,201
SIM,1913,22,na,1935,3339
SIM,1935,36,30-34,1971,5
STAT,1853,24,15-19,1877,2.8493777122777253
STAT,1873,21,35-39,1894,5.612584310703693
SIM,1861,24,15-19,1885,2
SIM,1889,33,35-39,1922,12
STAT,1846,46,na,1892,1590.8045641712765
STAT,1932,21,na,1953,4540.240226024121
STAT,1936,31,25-29,1967,8.484389541834128
SIM,1919,28,45-49,1947,1
STAT,1845,54,35-39,1899,0.005897303034758862
STAT,1889,43,35-39,1932,2.0966455135729087
STAT,1849,11,na,1860,2127.7032766080038
STAT,1941,24,45-49,1965,1.0976330797333225
STAT,1832,48,15-19,1880,2.830725634664937E-4
STAT,1840,32,40-44,1872,3.6785361258848313
SIM,1894,14,na,1908,3289
SIM,1905,20,35-39,1925,9
STAT,1857,46,na,1903,1680.3279195427906
STAT,1928,21,25-29,1949,109.28924552012502
STAT,1924,17,20-24,1941,152.53325639155685
SIM,1824,44,na,1868,1385
SIM,1818,36,50-100,1854,3
STAT,1818,37,25-29,1855,9.757943817891478
SIM,1869,29,45-49,1898,3
STAT,1907,31,35-39,1938,8.10103886475774
SIM,1868,62,na,1930,1614
STAT,1897,21,20-24,1918,87.3279608975078
STAT,1859,112,na,1971,3.6434794246913583E-4
STAT,1883,23,50-100,1906,0.37639306847912873
STAT,1900,28,na,1928,3116.7426748911853
SIM,1879,40,35-39,1919,2
STAT,1826,85,na,1911,149.6272704042021
SIM,1856,21,25-29,1877,55
SIM,1906,31,40-44,1937,4
STAT,1821,42,30-34,1863,1.9188370450125376
SIM,1865,22,40-44,1887,1
SIM,1908,27,35-39,1935,16
STAT,1835,62,na,1897,1140.3758720446629
SIM,1898,17,20-24,1915,25
STAT,1896,39,45-49,1935,2.463882364294394
STAT,1874,58,na,1932,1909.432724602955
STAT,1908,44,30-34,1952,0.1103419618746871
STAT,1882,27,45-49,1909,1.0206462232787297
SIM,1823,86,na,1909,116
STAT,1864,31,35-39,1895,8.585333143699032
STAT,1838,23,35-39,1861,5.126598081139802
STAT,1853,87,na,1940,130.65704918063454
SIM,1838,30,20-24,1868,2
SIM,1934,35,35-39,1969,7
STAT,1829,48,45-49,1877,0.18795445294874674
STAT,1906,38,15-19,1944,0.01659032850561377
SIM,1828,58,na,1886,1109
STAT,1896,23,50-100,1919,0.5075662193510522
STAT,1848,21,25-29,1869,50.578396888940276
SIM,1891,33,50-100,1924,2
STAT,1926,35,35-39,1961,2.797702194485907
STAT,1893,27,20-24,1920,14.061505402910985
STAT,1923,38,50-100,1961,0.45915088516126656
SIM,1929,26,40-44,1955,7
SIM,1856,77,na,1933,599
STAT,1903,37,35-39,1940,2.051838442151049
STAT,1844,34,15-19,1878,0.1170920770491395
STAT,1867,32,15-19,1899,0.12631567532194554
STAT,1863,39,50-100,1902,1.00927310894207
STAT,1914,36,na,1950,3565.034369190835
STAT,1885,28,25-29,1913,39.67308166427125
STAT,1889,25,40-44,1914,3.5173443328905005
STAT,1851,27,20-24,1878,10.072760812172202
SIM,1941,21,35-39,1962,8
STAT,1779,108,na,1887,0.005000550987981503
STAT,1870,24,15-19,1894,3.0346885401166825
SIM,1913,22,35-39,1935,11
SIM,1850,88,na,1938,82
STAT,1800,93,na,1893,11.649461235199778
STAT,1888,78,na,1966,1209.8339321889555
STAT,1871,14,na,1885,2450.335707896761
STAT,1922,42,40-44,1964,0.27123391680876124
STAT,1904,47,15-19,1951,3.042678118589316E-4
SIM,1881,21,35-39,1902,12
SIM,1890,27,45-49,1917,3
STAT,1843,66,na,1909,1182.4726984910083
SIM,1919,16,na,1935,3835
STAT,1861,46,20-24,1907,0.009440447577238777
SIM,1864,20,20-24,1884,62
STAT,1847,34,50-100,1881,0.7055087770158609
STAT,1875,20,35-39,1895,5.697347283081776
SIM,1832,63,na,1895,1097
SIM,1897,25,40-44,1922,4
SIM,1911,37,35-39,1948,11
SIM,1892,26,20-24,1918,17
STAT,1848,45,50-100,1893,0.17869999570468742
STAT,1868,24,50-100,1892,0.36551498132185134
STAT,1961,9,na,1970,4794.8970211233955
STAT,1905,22,35-39,1927,7.96633724980869
STAT,1880,65,na,1945,1679.8200747401227
STAT,1884,79,na,1963,885.7046409720199
SIM,1856,76,na,1932,660
SIM,1892,28,na,1920,2828
SIM,1915,24,45-49,1939,2
STAT,1855,38,45-49,1893,1.4048578004813164
STAT,1913,17,45-49,1930,0.09646444612769932
SIM,1879,22,35-39,1901,9
SIM,1920,25,30-34,1945,54
SIM,1916,26,30-34,1942,44
STAT,1795,92,na,1887,11.195157994330513
SIM,1942,19,na,1961,3478
SIM,1921,17,45-49,1938,1
STAT,1764,93,na,1857,4.588464825044639
STAT,1858,31,na,1889,1788.2313762109895
STAT,1939,17,45-49,1956,0.4723204356828642
STAT,1853,47,25-29,1900,0.042517463757373045
SIM,1788,88,na,1876,38
SIM,1877,7,na,1884,2616
STAT,1830,54,40-44,1884,0.006522854461622714
SIM,1958,2,na,1960,4853
SIM,1872,28,45-49,1900,4
STAT,1858,32,na,1890,1769.7589460947302
STAT,1821,55,na,1876,1223.8537067947777
STAT,1826,105,na,1931,0.016003724772165717
STAT,1852,42,50-100,1894,0.8016747207363695
STAT,1841,26,45-49,1867,0.9503579736911927
STAT,1873,37,50-100,1910,1.177292759779976
STAT,1759,114,na,1873,1.2386264498912328E-4
STAT,1806,81,na,1887,208.82969598668663
STAT,1895,27,na,1922,2942.105341767456
SIM,1822,34,40-44,1856,6
SIM,1846,23,35-39,1869,7
SIM,1932,21,40-44,1953,5
STAT,1874,45,50-100,1919,0.2394986733767976
STAT,1880,48,45-49,1928,0.23163607642944822
SIM,1893,28,25-29,1921,55
STAT,1870,39,25-29,1909,2.6383610864469493
SIM,1881,43,na,1924,1900
STAT,1855,98,na,1953,2.300736388210571
STAT,1889,22,25-29,1911,66.76395424720431
STAT,1857,18,20-24,1875,15.427068398130345
STAT,1791,71,na,1862,560.4961174487464
STAT,1795,85,na,1880,86.04472501847111
STAT,1913,30,50-100,1943,0.7831708301406277
SIM,1897,22,25-29,1919,74
STAT,1845,40,50-100,1885,0.7774443935764074
STAT,1914,35,na,1949,3581.653240225481
STAT,1923,44,45-49,1967,0.18316864155105175
STAT,1845,20,45-49,1865,0.6186201519614514
STAT,1838,41,35-39,1879,1.462978955866597
STAT,1857,22,40-44,1879,1.7916003912332172
STAT,1881,25,40-44,1906,2.7509229722845294
STAT,1932,28,15-19,1960,0.8731115841898467
STAT,1820,45,20-24,1865,0.020375795902017622
STAT,1930,37,15-19,1967,0.023664116647014972
STAT,1785,71,na,1856,576.5920676040002
STAT,1789,85,na,1874,78.28169258639682
SIM,1915,31,35-39,1946,14
STAT,1861,39,30-34,1900,4.138850183787497
STAT,1825,37,20-24,1862,0.9871266260748098
STAT,1818,44,15-19,1862,0.030669994453649697
STAT,1928,28,50-100,1956,1.157999484607298
SIM,1822,64,na,1886,933
SIM,1879,31,20-24,1910,3
STAT,1866,39,na,1905,2031.377508171393
SIM,1902,43,40-44,1945,1
SIM,1932,17,20-24,1949,157
STAT,1909,16,20-24,1925,25.171529670183645
SIM,1860,26,20-24,1886,7
STAT,1908,26,30-34,1934,35.40169323841392
SIM,1801,71,na,1872,579
STAT,1849,46,20-24,1895,0.008674047784200275
STAT,1852,112,na,1964,1.1023168935404415E-4
STAT,1912,25,30-34,1937,36.71622903633989
SIM,1939,29,25-29,1968,59
STAT,1824,99,na,1923,0.9998437716429
STAT,1862,43,30-34,1905,0.9197537162214592
SIM,1853,32,na,1885,1953
SIM,1829,41,35-39,1870,4
STAT,1832,25,45-49,1857,0.9389952138485893
STAT,1885,35,15-19,1920,0.05335345174044809
STAT,1878,79,na,1957,761.1783883356547
SIM,1846,41,35-39,1887,3
SIM,1867,38,25-29,1905,2
SIM,1831,85,na,1916,139
STAT,1911,24,35-39,1935,8.381444553775284
STAT,1866,16,20-24,1882,15.943203699214212
STAT,1921,39,15-19,1960,0.02021480469268783
SIM,1936,19,na,1955,2772
STAT,1888,32,35-39,1920,11.301908510639299
STAT,1896,47,50-100,1943,0.17216382436842734
STAT,1916,19,15-19,1935,9.047129635027712
STAT,1868,35,15-19,1903,0.0511311554163066
STAT,1849,16,20-24,1865,15.822590572296008
STAT,1876,5,na,1881,2668.5112438906863
SIM,1869,22,25-29,1891,60
SIM,1923,23,40-44,1946,2
STAT,1874,65,na,1939,1631.7120949106652
STAT,1836,84,na,1920,210.07315645049923
STAT,1825,35,50-100,1860,1.7000905059167457
SIM,1878,18,30-34,1896,1
STAT,1911,21,30-34,1932,25.82250548289362
STAT,1920,33,40-44,1953,4.0324873802121415
SIM,1907,19,15-19,1926,9
STAT,1860,7,na,1867,2191.6579715135977
SIM,1896,32,35-39,1928,15
SIM,1857,16,20-24,1873,18
STAT,1932,23,40-44,1955,4.154920969635605
SIM,1794,88,na,1882,41
STAT,1846,15,40-44,1861,0.16392504030777252
SIM,1940,23,40-44,1963,2
SIM,1871,34,35-39,1905,11
STAT,1897,38,45-49,1935,2.506109472287113
SIM,1950,15,15-19,1965,43
STAT,1872,46,45-49,1918,0.22441108501285903
SIM,1853,25,na,1878,2008
STAT,1866,40,50-100,1906,0.9294427361735952
STAT,1911,26,25-29,1937,60.833310646034356
SIM,1840,89,na,1929,54
STAT,1897,30,35-39,1927,12.897536357040963
STAT,1916,25,15-19,1941,0.6942165989335294
STAT,1934,34,30-34,1968,20.294755364315954
STAT,1925,26,30-34,1951,43.87511350999302
STAT,1886,19,30-34,1905,1.5823480265461676
SIM,1869,17,30-34,1886,1
STAT,1843,28,25-29,1871,37.28890163020462
STAT,1887,21,50-100,1908,0.43212986012987725
STAT,1822,40,25-29,1862,1.0218196737058445
SIM,1821,43,35-39,1864,6
STAT,1906,15,40-44,1921,0.2527720887805826
STAT,1852,10,na,1862,2221.155456076641
STAT,1856,20,20-24,1876,60.07733656957115
SIM,1865,18,20-24,1883,20
STAT,1924,21,40-44,1945,3.7597796250011295
SIM,1860,29,25-29,1889,44
SIM,1827,28,30-34,1855,23
SIM,1866,43,50-100,1909,1
SIM,1874,16,20-24,1890,20
STAT,1934,16,30-34,1950,15.612667128527493
STAT,1851,52,na,1903,1570.5476808459573
STAT,1852,29,25-29,1881,33.57764952951683
STAT,1880,34,35-39,1914,9.980104108104552
SIM,1843,70,na,1913,962
SIM,1862,77,na,1939,714
SIM,1942,16,30-34,1958,13
STAT,1838,35,50-100,1873,1.0316161657212062
STAT,1930,19,15-19,1949,55.13414080205783
STAT,1879,24,35-39,1903,5.726068230480365
SIM,1851,28,25-29,1879,40
STAT,1838,32,50-100,1870,0.7765212430514191
SIM,1887,24,35-39,1911,10
SIM,1934,17,35-39,1951,6
STAT,1935,24,20-24,1959,142.94034889336427
STAT,1877,33,15-19,1910,0.13901552881758103
STAT,1902,45,40-44,1947,0.13002704431607465
STAT,1873,80,na,1953,593.1771341794264
STAT,1926,17,35-39,1943,4.8607086935871004
STAT,1877,94,na,1971,93.04072478594198
SIM,1943,24,20-24,1967,104
STAT,1818,99,na,1917,0.9130778370192003
STAT,1863,105,na,1968,0.21566241122341337
STAT,1824,48,50-100,1872,0.28456572360210675
SIM,1868,18,25-29,1886,5
STAT,1813,43,35-39,1856,6.108644351799335
STAT,1898,23,40-44,1921,2.656596539635066
STAT,1947,19,45-49,1966,0.5312672515271758
SIM,1924,19,15-19,1943,39
SIM,1894,19,30-34,1913,2
SIM,1924,25,15-19,1949,3
STAT,1840,24,40-44,1864,1.8190875664183328
STAT,1804,86,na,1890,75.18920608514557
SIM,1928,33,35-39,1961,12
STAT,1915,23,40-44,1938,3.2729545422693094
SIM,1825,38,25-29,1863,1
SIM,1862,44,35-39,1906,1
SIM,1889,30,30-34,1919,36
STAT,1820,38,na,1858,1484.745014499256
STAT,1879,42,35-39,1921,1.7858542304969567
STAT,1863,41,25-29,1904,0.5356687801966313
STAT,1884,29,25-29,1913,39.20781374862623
STAT,1912,30,25-29,1942,8.658738723151979
SIM,1792,93,na,1885,1
STAT,1878,50,20-24,1928,7.361374221435095E-4
STAT,1916,18,25-29,1934,8.662661012606439
STAT,1925,19,40-44,1944,1.5878314426991589
STAT,1796,108,na,1904,4.2674117568504514E-4
SIM,1875,37,20-24,1912,3
STAT,1826,36,20-24,1862,0.859802072135415
STAT,1813,50,25-29,1863,0.010644669371731183
STAT,1882,39,50-100,1921,1.117243738524029
STAT,1942,15,15-19,1957,44.825777048496086
SIM,1809,82,na,1891,171
SIM,1839,32,40-44,1871,5
SIM,1849,24,15-19,1873,7
SIM,1838,21,35-39,1859,8
SIM,1900,20,35-39,1920,9
STAT,1912,49,15-19,1961,3.324035909653599E-4
SIM,1887,42,35-39,1929,2
STAT,1836,32,15-19,1868,0.11367100211888999
STAT,1859,45,15-19,1904,3.04576083416208E-4
STAT,1883,15,45-49,1898,0.06076095767718283
SIM,1892,29,25-29,1921,56
SIM,1924,18,25-29,1942,67
STAT,1867,37,20-24,1904,0.6837433344116938
SIM,1939,31,na,1970,3569
SIM,1888,82,na,1970,887
SIM,1902,54,na,1956,2820
STAT,1898,30,30-34,1928,22.507432156091987
SIM,1857,0,na,1857,3022
STAT,1880,41,25-29,1921,0.6411912490475903
STAT,1817,38,25-29,1855,9.181454797731387
STAT,1886,50,na,1936,2180.0723037591856
SIM,1853,18,30-34,1871,1
SIM,1889,23,40-44,1912,2
STAT,1905,15,45-49,1920,0.08958969350991758
STAT,1869,75,na,1944,941.3780006970004
SIM,1920,30,25-29,1950,16
SIM,1837,33,50-100,1870,4
STAT,1927,41,50-100,1968,0.1394045074560265
SIM,1858,52,50-100,1910,1
STAT,1831,45,45-49,1876,0.1780363713905414
STAT,1907,54,na,1961,3010.8496538942245
STAT,1917,27,35-39,1944,14.873544049249972
STAT,1939,28,20-24,1967,17.325524709940442
SIM,1868,31,45-49,1899,1
STAT,1898,19,20-24,1917,22.5501396525141
SIM,1840,20,35-39,1860,11
STAT,1867,42,50-100,1909,0.9359196423408592
STAT,1812,46,25-29,1858,0.1926469852129238
STAT,1881,1,na,1882,3083.766829286614
SIM,1903,30,25-29,1933,4
STAT,1911,33,15-19,1944,0.11768729923725749
SIM,1903,35,35-39,1938,4
SIM,1868,61,na,1929,1661
SIM,1874,62,na,1936,1701
STAT,1877,54,30-34,1931,0.005674916082605558
STAT,1865,46,50-100,1911,0.21143264800148956
STAT,1906,33,40-44,1939,3.411007487824505
SIM,1839,28,20-24,1867,6
STAT,1951,16,30-34,1967,13.716365790010213
STAT,1887,16,40-44,1903,0.19371103723324404
STAT,1894,78,na,1972,1416.4519332503173
STAT,1871,13,na,1884,2461.510967690074
STAT,1834,34,50-100,1868,0.7115436009229288
SIM,1817,86,na,1903,111
STAT,1880,50,50-100,1930,0.015227839509972816
SIM,1869,47,na,1916,2056
STAT,1896,36,40-44,1932,5.491758782842446
SIM,1822,49,na,1871,1361
STAT,1931,36,20-24,1967,0.3301158026165263
STAT,1833,67,na,1900,962.3699604316233
STAT,1926,42,25-29,1968,0.08317378538906449
SIM,1914,33,40-44,1947,9
SIM,1890,57,na,1947,2370
STAT,1845,18,30-34,1863,1.4106267428700128
STAT,1770,93,na,1863,4.705627157259696
STAT,1826,31,15-19,1857,0.20044625434681906
STAT,1939,32,40-44,1971,3.7715857848482695
SIM,1855,36,45-49,1891,1
SIM,1873,21,25-29,1894,55
SIM,1925,27,35-39,1952,27
STAT,1767,89,na,1856,24.888726619999996
SIM,1887,28,na,1915,2481
STAT,1839,34,40-44,1873,3.4853115609221064
STAT,1924,31,35-39,1955,10.078686746029417
STAT,1867,50,45-49,1917,0.013057501744389122
SIM,1869,26,40-44,1895,2
STAT,1833,45,50-100,1878,0.17959909071257846
STAT,1861,49,25-29,1910,0.04424240903692117
SIM,1906,34,45-49,1940,4
SIM,1929,29,45-49,1958,2
STAT,1857,50,35-39,1907,0.006503740951643312
STAT,1847,30,20-24,1877,2.384201821474313
SIM,1890,36,50-100,1926,4
STAT,1941,1,na,1942,4039.810542746223
STAT,1790,106,na,1896,0.0024441545579767148
STAT,1865,21,25-29,1886,50.09927741899989
STAT,1867,79,na,1946,620.1066945968901
STAT,1899,37,20-24,1936,0.215399032348706
SIM,1863,38,45-49,1901,2
STAT,1849,49,25-29,1898,0.04065069658345947
STAT,1858,24,15-19,1882,2.517991630793123
STAT,1893,42,50-100,1935,1.2647211534643026
SIM,1870,37,25-29,1907,4
SIM,1934,37,25-29,1971,1
SIM,1937,20,30-34,1957,28
STAT,1887,19,45-49,1906,0.06864289678987771
SIM,1908,24,30-34,1932,33
STAT,1847,36,45-49,1883,1.5377395389337956
STAT,1826,39,25-29,1865,2.9494857975626347
STAT,1879,64,na,1943,1716.510865777822
STAT,1946,23,35-39,1969,9.895569096966856
SIM,1917,34,20-24,1951,2
STAT,1893,22,15-19,1915,3.954263035557984
SIM,1865,25,45-49,1890,5
STAT,1916,15,20-24,1931,27.298837080301716
STAT,1921,43,35-39,1964,0.21393968076198638
STAT,1871,33,30-34,1904,16.28277947773441
SIM,1815,67,na,1882,760
STAT,1964,6,na,1970,4676.136756622184
STAT,1835,99,na,1934,1.1816400209496134
STAT,1863,7,na,1870,2345.3807256435816
STAT,1923,38,15-19,1961,0.021000666840469993
STAT,1831,85,na,1916,167.1850073939003
STAT,1857,25,45-49,1882,0.8640826464654833
SIM,1834,39,25-29,1873,3
SIM,1841,74,na,1915,746
STAT,1856,37,45-49,1893,1.4749688315911431
STAT,1860,66,na,1926,1258.3658938927722
SIM,1929,21,35-39,1950,12
SIM,1873,24,40-44,1897,2
STAT,1865,13,na,1878,2310.0997633801353
SIM,1919,21,25-29,1940,93
STAT,1837,33,na,1870,1697.5722854207102
STAT,1879,17,45-49,1896,0.06450153700798392
STAT,1852,21,15-19,1873,2.9991471862124084
STAT,1921,25,35-39,1946,15.915841666783463
STAT,1784,92,na,1876,9.051186185730275
STAT,1888,37,45-49,1925,2.224751408142958
STAT,1929,20,30-34,1949,34.54240624176492
SIM,1863,35,40-44,1898,6
STAT,1818,66,na,1884,854.3320644181077
STAT,1946,2,na,1948,4230.292490446182
STAT,1935,34,na,1969,4936.428694551709
STAT,1891,17,45-49,1908,0.07638204433142355
STAT,1840,47,15-19,1887,2.8091203157286273E-4
STAT,1924,35,50-100,1959,0.4685576741941538
SIM,1767,89,na,1856,35
SIM,1891,40,35-39,1931,8
STAT,1837,19,35-39,1856,0.4646673939404619
SIM,1832,26,45-49,1858,4
STAT,1865,24,40-44,1889,1.784673149746994
STAT,1926,37,25-29,1963,1.1369003489835825
STAT,1894,48,25-29,1942,0.038987843136880584
STAT,1872,94,na,1966,65.27510749930724
STAT,1881,28,45-49,1909,1.0091914039894525
STAT,1908,19,40-44,1927,0.25487860344026425
SIM,1916,19,40-44,1935,1
STAT,1898,26,45-49,1924,1.4247582103872003
STAT,1905,46,20-24,1951,0.00926697267573378
SIM,1888,30,35-39,1918,14
SIM,1845,33,na,1878,1788
STAT,1825,48,na,1873,1438.9149022242566
SIM,1871,29,na,1900,2295
STAT,1909,34,20-24,1943,2.1794953839020357
SIM,1932,31,35-39,1963,10
STAT,1918,48,35-39,1966,0.12924987593852583
STAT,1878,17,30-34,1895,1.5674949294463847
SIM,1860,11,na,1871,2344
SIM,1870,22,15-19,1892,2
STAT,1850,51,40-44,1901,0.007446950802511923
SIM,1908,29,25-29,1937,65
STAT,1911,31,25-29,1942,8.53521344353066
SIM,1896,37,45-49,1933,4
SIM,1901,38,25-29,1939,1
STAT,1859,38,25-29,1897,2.159930763308314
STAT,1881,48,15-19,1929,3.602728395230766E-4
STAT,1913,37,15-19,1950,0.01789879785954076
STAT,1849,98,na,1947,2.341518694391147
SIM,1951,17,35-39,1968,8
STAT,1836,53,30-34,1889,0.0037287880192395807
STAT,1857,32,35-39,1889,7.588703749933976
STAT,1860,28,25-29,1888,32.589623606978044
STAT,1846,53,40-44,1899,0.007303575388671039
STAT,1943,17,35-39,1960,4.203432230992065
SIM,1864,47,na,1911,2011
SIM,1899,6,na,1905,3375
SIM,1928,26,45-49,1954,1
STAT,1873,20,20-24,1893,66.47503973192252
SIM,1860,21,15-19,1881,3
STAT,1761,108,na,1869,0.0030656684718844023
STAT,1907,21,40-44,1928,2.899944919986578
STAT,1874,18,20-24,1892,17.072608342312936
STAT,1847,32,na,1879,1872.3104964832646
SIM,1813,56,na,1869,1113
SIM,1865,32,35-39,1897,11
STAT,1893,40,45-49,1933,1.8119979539346325
STAT,1864,36,50-100,1900,1.0415856255672167
STAT,1923,41,40-44,1964,0.27659841483549824
STAT,1954,18,45-49,1972,0.5831885440620507
SIM,1880,58,na,1938,2050
STAT,1870,36,20-24,1906,0.7169856590734277
SIM,1897,27,na,1924,3051
STAT,1839,31,25-29,1870,8.49219100889104
STAT,1883,40,35-39,1923,1.6934901502643027
SIM,1845,19,35-39,1864,1
SIM,1898,31,35-39,1929,18
SIM,1866,39,25-29,1905,2
STAT,1911,29,40-44,1940,4.26247772983042
STAT,1862,22,15-19,1884,2.721454684907027
SIM,1822,37,45-49,1859,3
SIM,1847,31,25-29,1878,17
SIM,1915,21,40-44,1936,4
STAT,1926,44,15-19,1970,0.0017827323052845834
STAT,1831,48,na,1879,1452.5809531265934
STAT,1892,28,20-24,1920,13.82953457982334
SIM,1940,24,na,1964,3367
STAT,1846,18,45-49,1864,0.057516240321107866
STAT,1849,30,35-39,1879,8.629953800497415
SIM,1888,35,40-44,1923,8
STAT,1947,16,40-44,1963,1.4889627345620156
SIM,1868,29,30-34,1897,19
SIM,1837,17,30-34,1854,1
SIM,1917,16,20-24,1933,29
SIM,1835,44,na,1879,1537
STAT,1946,16,45-49,1962,0.5235781751513069
STAT,1836,41,50-100,1877,0.8038755995837087
STAT,1913,57,na,1970,3237.995218739064
STAT,1926,19,25-29,1945,49.92918752673139
STAT,1852,26,20-24,1878,10.456687710960155
STAT,1958,1,na,1959,4884.635166036916
SIM,1814,45,na,1859,1344
STAT,1906,18,45-49,1924,0.08962280103904374
STAT,1860,14,na,1874,2094.684160161701
SIM,1879,46,na,1925,2224
STAT,1822,49,20-24,1871,0.016267934451340556
SIM,1828,96,na,1924,3
SIM,1809,67,na,1876,810
STAT,1830,63,na,1893,1065.856774768511
SIM,1844,11,na,1855,2211
STAT,1873,26,45-49,1899,1.0683326072006203
SIM,1891,22,35-39,1913,7
STAT,1864,28,na,1892,2007.8745744577634
STAT,1828,104,na,1932,0.03786404589020398
STAT,1862,46,35-39,1908,0.1131376059100273
STAT,1951,19,35-39,1970,4.717542970358939
SIM,1931,2,na,1933,5011
STAT,1852,47,na,1899,1701.3976502621372
STAT,1870,17,25-29,1887,5.29548647245777
SIM,1914,3,na,1917,4238
STAT,1927,41,25-29,1968,0.08473607369218757
SIM,1896,42,na,1938,2917
SIM,1812,71,na,1883,585
SIM,1857,30,35-39,1887,11
SIM,1797,92,na,1889,11
STAT,1827,29,50-100,1856,0.925616919940789
STAT,1833,28,15-19,1861,0.3622672221548041
STAT,1854,44,35-39,1898,1.2863555832598395
STAT,1892,46,na,1938,2669.6298803937398
SIM,1859,17,20-24,1876,8
SIM,1939,26,20-24,1965,15
SIM,1901,33,30-34,1934,33
SIM,1938,22,35-39,1960,11
SIM,1839,35,45-49,1874,1
SIM,1879,61,na,1940,1806
STAT,1918,40,25-29,1958,0.07192199782207216
STAT,1928,28,45-49,1956,2.0099198710471686
STAT,1846,47,na,1893,1578.905346031276
STAT,1838,16,45-49,1854,0.05919751547757496
SIM,1827,48,na,1875,1348
STAT,1835,54,50-100,1889,0.009230262557273538
SIM,1858,47,na,1905,1808
STAT,1925,29,35-39,1954,16.634351944951117
STAT,1871,30,15-19,1901,0.13444302934481736
STAT,1820,48,25-29,1868,0.09359058103583763
SIM,1844,41,50-100,1885,1
SIM,1934,19,25-29,1953,55
STAT,1882,13,na,1895,2370.2920385402817
STAT,1933,34,50-100,1967,1.0512399288968617
SIM,1865,10,na,1875,2359
STAT,1884,26,20-24,1910,10.98935935979979
SIM,1902,23,20-24,1925,91
SIM,1910,58,na,1968,2994
STAT,1880,45,40-44,1925,0.171869076981344
STAT,1844,27,25-29,1871,36.35289971353282
STAT,1898,33,35-39,1931,12.89611254683449
SIM,1827,30,45-49,1857,1
STAT,1884,43,50-100,1927,0.9791154226211285
STAT,1866,38,20-24,1904,0.6680707796978441
SIM,1924,15,20-24,1939,144
STAT,1906,36,45-49,1942,0.5947411883957546
STAT,1883,79,na,1962,856.1467081588801
STAT,1910,24,50-100,1934,0.579919270274079
SIM,1867,76,na,1943,774
SIM,1859,10,na,1869,2316
SIM,1927,42,na,1969,4325
STAT,1817,81,na,1898,239.8091653645131
STAT,1836,36,30-34,1872,4.174157207349022
STAT,1908,23,15-19,1931,4.607752489293359
SIM,1863,62,na,1925,1554
SIM,1932,24,45-49,1956,1
STAT,1886,21,45-49,1907,0.6981148290165554
STAT,1919,43,40-44,1962,0.255659625756191
STAT,1836,28,50-100,1864,0.5189539165495622
STAT,1878,24,na,1902,2311.3524031680936
SIM,1901,15,30-34,1916,2
STAT,1890,49,15-19,1939,2.5517096381955085E-4
STAT,1828,54,35-39,1882,0.006124192557175139
STAT,1919,3,na,1922,4234.3840458119
STAT,1840,27,45-49,1867,0.964109475970698
STAT,1813,54,40-44,1867,0.029198040044229934
STAT,1894,42,na,1936,2814.8953862825156
STAT,1874,29,15-19,1903,0.43493318189890384
SIM,1871,39,50-100,1910,3
STAT,1843,25,20-24,1868,10.56731919612073
STAT,1930,22,40-44,1952,4.069391486694274
STAT,1861,51,na,1912,1697.1915477559176
SIM,1839,42,35-39,1881,2
SIM,1847,34,40-44,1881,2
STAT,1924,24,45-49,1948,1.2465253444290685
STAT,1895,45,35-39,1940,0.09832684463473886
STAT,1918,46,30-34,1964,0.0898389907423631
SIM,1936,28,45-49,1964,1
STAT,1874,47,45-49,1921,0.22680312102237343
SIM,1916,23,15-19,1939,5
STAT,1920,36,45-49,1956,0.7058004142193992
SIM,1906,27,20-24,1933,16
STAT,1821,45,35-39,1866,0.2201379158379271
SIM,1874,38,20-24,1912,1
STAT,1936,36,35-39,1972,2.244854193350125
SIM,1909,61,na,1970,2881
SIM,1871,31,30-34,1902,23
SIM,1874,19,25-29,1893,5
STAT,1870,28,na,1898,2201.3556105249468
SIM,1828,28,45-49,1856,1
SIM,1849,95,na,1944,5
SIM,1850,21,35-39,1871,6
STAT,1855,51,na,1906,1532.2488970749769
SIM,1909,17,na,1926,3564
STAT,1885,17,50-100,1902,0.04611014503884425
SIM,1851,25,20-24,1876,12
SIM,1868,102,na,1970,1
STAT,1829,99,na,1928,1.1608432267074023
STAT,1925,42,na,1967,4248.266775591857
SIM,1826,30,na,1856,1724
SIM,1927,43,40-44,1970,1
SIM,1942,20,na,1962,3496
STAT,1819,35,50-100,1854,3.730041757123414
STAT,1926,32,30-34,1958,17.999172020605236
SIM,1852,27,25-29,1879,55
SIM,1857,62,na,1919,1467
STAT,1908,49,25-29,1957,0.045043373796316635
SIM,1934,32,30-34,1966,17
STAT,1950,21,35-39,1971,10.556749166291576
STAT,1866,19,25-29,1885,5.006550058711661
STAT,1926,20,na,1946,4216.626913210917
SIM,1833,48,na,1881,1430
SIM,1894,21,45-49,1915,4
STAT,1896,40,25-29,1936,0.056237209664287045
SIM,1802,97,na,1899,2
SIM,1909,54,na,1963,3059
SIM,1862,36,35-39,1898,15
SIM,1844,27,na,1871,1913
STAT,1921,40,30-34,1961,0.13642081595056352
SIM,1882,66,na,1948,1481
STAT,1843,31,15-19,1874,0.1248033688103269
SIM,1859,41,45-49,1900,3
STAT,1884,50,45-49,1934,0.013742604168165095
STAT,1809,85,na,1894,115.15907085952716
STAT,1840,30,35-39,1870,8.770347930771779
STAT,1936,30,50-100,1966,0.7593832459958535
STAT,1927,38,35-39,1965,2.8383568999446847
SIM,1884,39,50-100,1923,2
STAT,1914,18,50-100,1932,0.073009381764658
STAT,1938,24,50-100,1962,0.6147121110187862
SIM,1881,20,20-24,1901,58
STAT,1863,34,35-39,1897,8.337653082079042
SIM,1876,39,30-34,1915,6
STAT,1823,84,na,1907,175.0600452488236
STAT,1946,8,na,1954,4125.372770047195
SIM,1880,65,na,1945,1779
STAT,1868,39,30-34,1907,4.758774863807314
STAT,1940,25,na,1965,3611.554897333544
SIM,1926,36,na,1962,4209
SIM,1869,20,20-24,1889,58
STAT,1811,53,30-34,1864,0.01852549267719824
STAT,1868,96,na,1964,24.68168061335273
STAT,1911,46,45-49,1957,0.19481495861226275
SIM,1852,46,na,1898,1756
SIM,1855,33,40-44,1888,7
STAT,1877,7,na,1884,2632.7689940972405
SIM,1827,39,35-39,1866,20
SIM,1844,36,30-34,1880,5
STAT,1921,42,na,1963,3952.064388891309
STAT,1824,53,40-44,1877,0.011677270736928976
STAT,1883,63,na,1946,1652.0286196234842
SIM,1863,83,na,1946,292
STAT,1853,44,20-24,1897,0.11618722013722961
STAT,1884,11,na,1895,2414.4724079047264
STAT,1875,44,na,1919,2212.867806931324
SIM,1880,24,35-39,1904,8
STAT,1857,37,15-19,1894,0.04182115346931808
STAT,1927,45,40-44,1972,0.18786189977908066
STAT,1820,51,30-34,1871,0.00962428721745666
STAT,1913,32,35-39,1945,8.587194488182115
STAT,1819,39,35-39,1858,15.613245969216461
STAT,1847,25,na,1872,1940.925767112654
STAT,1888,34,40-44,1922,4.798383050072057
STAT,1856,31,25-29,1887,7.751297649256696
STAT,1887,42,25-29,1929,0.6776014067712426
STAT,1854,76,na,1930,682.2199019560616
STAT,1859,10,na,1869,2115.3631056428226
STAT,1920,19,40-44,1939,1.4746091107561112
SIM,1855,15,25-29,1870,8
SIM,1870,34,20-24,1904,2
STAT,1910,48,50-100,1958,0.19874190763087282
STAT,1900,16,20-24,1916,23.29189272151981
STAT,1901,45,20-24,1946,0.009039793112853424
STAT,1899,15,50-100,1914,0.06372023048407581
SIM,1830,30,30-34,1860,20
STAT,1786,87,na,1873,54.313704301514974
STAT,1864,30,20-24,1894,2.3005664140701603
STAT,1855,34,50-100,1889,0.6471529839333696
SIM,1912,25,35-39,1937,16
STAT,1856,61,na,1917,1382.5922280276784
SIM,1852,6,na,1858,2369
SIM,1800,86,na,1886,59
SIM,1851,98,na,1949,3
SIM,1922,36,na,1958,4063
STAT,1950,18,25-29,1968,48.39419115193521
STAT,1871,78,na,1949,731.7520289116947
SIM,1909,26,50-100,1935,1
STAT,1895,37,35-39,1932,8.719496081425861
STAT,1896,42,35-39,1938,0.15680541896581926
STAT,1901,38,na,1939,3124.28600165365
STAT,1904,25,35-39,1929,13.161280010226694
STAT,1941,18,15-19,1959,44.14259586175109
STAT,1879,50,35-39,1929,0.00862302218261832
STAT,1894,45,20-24,1939,0.008307833431969723
SIM,1835,38,30-34,1873,3
STAT,1837,70,na,1907,885.7014046275929
SIM,1929,34,50-100,1963,5
SIM,1853,43,30-34,1896,1
STAT,1803,54,35-39,1857,0.023706637621175572
SIM,1843,79,na,1922,460
SIM,1844,17,na,1861,2116
STAT,1831,23,35-39,1854,11.772315549004544
STAT,1942,23,15-19,1965,5.270627810405169
SIM,1864,31,25-29,1895,9
SIM,1921,32,35-39,1953,12
STAT,1828,46,35-39,1874,0.11949213216231827
STAT,1917,16,30-34,1933,2.483844348909579
SIM,1861,98,na,1959,3
STAT,1833,51,40-44,1884,0.00673390271747406
STAT,1899,43,15-19,1942,0.0012325437726186396
STAT,1853,30,45-49,1883,1.359707784510894
STAT,1843,17,50-100,1860,0.04516905928407376
STAT,1867,18,30-34,1885,1.4367771296865017
SIM,1899,0,na,1899,3515
STAT,1847,15,25-29,1862,5.265813695994044
SIM,1823,49,50-100,1872,4
STAT,1870,45,35-39,1915,0.1308857229002749
STAT,1860,53,25-29,1913,0.002675751539208228
STAT,1856,77,na,1933,639.558553632137
STAT,1847,33,40-44,1880,3.707829714762546
SIM,1821,54,na,1875,1224
STAT,1900,40,50-100,1940,0.09711787829780431
STAT,1845,43,30-34,1888,0.8141416353112622
STAT,1850,43,40-44,1893,1.5720565860926652
SIM,1939,21,40-44,1960,3
STAT,1798,72,na,1870,545.899784449865
SIM,1785,74,na,1859,335
SIM,1856,12,na,1868,2248
STAT,1838,49,50-100,1887,0.16797259258894995
SIM,1814,72,na,1886,531
SIM,1940,27,20-24,1967,21
SIM,1814,82,na,1896,188
SIM,1776,93,na,1869,6
STAT,1816,54,45-49,1870,0.03514552957001094
STAT,1907,35,15-19,1942,0.016976461751131634
STAT,1863,59,na,1922,1613.8790280907292
STAT,1868,29,50-100,1897,0.5728640028680116
STAT,1834,52,na,1886,1366.4850964253592
STAT,1878,42,30-34,1920,1.1292521182859658
STAT,1925,40,15-19,1965,0.0017615062997573484
STAT,1863,49,na,1912,1829.289695749037
SIM,1853,29,35-39,1882,12
SIM,1864,31,na,1895,2146
STAT,1827,54,20-24,1881,5.458575301756086E-4
STAT,1859,51,50-100,1910,0.011440812828629708
STAT,1960,7,na,1967,4835.041837244982
STAT,1852,54,30-34,1906,0.004398214464640515
SIM,1831,28,50-100,1859,1
STAT,1845,29,35-39,1874,8.154216016408702
STAT,1831,30,25-29,1861,8.614554161231341
STAT,1864,96,na,1960,14.436044382721422
STAT,1895,64,na,1959,2235.9713235918207
STAT,1932,27,20-24,1959,22.58701254762994
SIM,1870,26,30-34,1896,30
STAT,1881,16,50-100,1897,0.0447974007434879
STAT,1811,44,15-19,1855,0.048706015997998515
STAT,1912,24,30-34,1936,26.9405063654721
SIM,1869,35,50-100,1904,1
SIM,1882,50,na,1932,1975
STAT,1869,44,30-34,1913,1.0371083709213063
SIM,1861,29,na,1890,2045
SIM,1872,31,35-39,1903,16
STAT,1920,35,30-34,1955,1.8885028198465588
STAT,1918,16,50-100,1934,0.07747783573393834
STAT,1903,35,30-34,1938,1.5607818851637123
SIM,1917,53,na,1970,3483
STAT,1866,45,45-49,1911,0.2076026915173423
STAT,1862,26,30-34,1888,20.51463031142351
STAT,1865,54,40-44,1919,0.008788883615433434
SIM,1773,89,na,1862,31
SIM,1898,20,30-34,1918,24
SIM,1857,99,na,1956,1
SIM,1872,1,na,1873,3147
SIM,1880,31,25-29,1911,14
STAT,1897,32,25-29,1929,12.940663699905668
STAT,1850,52,na,1902,1507.7654764134759
SIM,1846,12,na,1858,2136
STAT,1788,72,na,1860,524.5376156084033
SIM,1822,40,35-39,1862,1
STAT,1872,31,25-29,1903,9.75175066354843
SIM,1855,98,na,1953,3
STAT,1924,28,25-29,1952,72.1503633126726
SIM,1874,31,na,1905,2298
SIM,1912,27,45-49,1939,1
STAT,1840,54,35-39,1894,0.005830620561443688
STAT,1881,44,na,1925,2079.726910599344
STAT,1909,17,35-39,1926,0.7771658652142731
STAT,1904,27,45-49,1931,1.5042643310769583
SIM,1925,16,30-34,1941,20
STAT,1848,54,40-44,1902,0.007375801374146427
STAT,1823,54,35-39,1877,0.009493862878850626
STAT,1890,11,na,1901,2987.3189076621547
STAT,1907,33,50-100,1940,0.7268774044535302
SIM,1869,19,na,1888,2310
SIM,1806,53,na,1859,1130
SIM,1920,24,30-34,1944,34
SIM,1870,65,na,1935,1549
STAT,1818,101,na,1919,0.275111054724665
STAT,1849,15,45-49,1864,0.05864530066972923
STAT,1889,21,25-29,1910,66.96552046380035
STAT,1827,38,30-34,1865,5.195965279346472
SIM,1902,29,40-44,1931,3
SIM,1879,47,50-100,1926,2
STAT,1761,95,na,1856,1.4990574095999998
STAT,1835,49,30-34,1884,0.062051850820947725
SIM,1823,59,na,1882,1078
STAT,1908,40,15-19,1948,0.0013571217184055952
SIM,1901,44,na,1945,3077
STAT,1915,28,15-19,1943,0.6777750946974701
SIM,1915,28,25-29,1943,72
STAT,1855,35,40-44,1890,3.129752554177964
STAT,1866,61,na,1927,1627.5610930228984
STAT,1814,40,35-39,1854,6.104501698604232
STAT,1870,42,15-19,1912,0.012767599567368943
STAT,1888,31,20-24,1919,3.028968912007586
SIM,1897,21,25-29,1918,77
STAT,1870,28,30-34,1898,23.228064725812377
STAT,1922,46,20-24,1968,0.012024177493937834
STAT,1819,53,30-34,1872,0.009965705431593018
STAT,1829,51,35-39,1880,0.006845150171954783
SIM,1862,46,na,1908,1964
SIM,1873,83,na,1956,370
SIM,1896,31,20-24,1927,5
STAT,1881,78,na,1959,842.697165463775
STAT,1890,45,35-39,1935,0.1633158994988035
SIM,1851,40,50-100,1891,3
SIM,1910,48,50-100,1958,1
SIM,1869,40,na,1909,2147
SIM,1911,35,30-34,1946,5
STAT,1881,31,35-39,1912,9.27509189589387
STAT,1899,20,40-44,1919,2.7138231685997667
STAT,1928,43,35-39,1971,0.24214887470558008
SIM,1808,72,na,1880,537
STAT,1886,44,30-34,1930,1.1320223774450042
STAT,1907,28,25-29,1935,58.48523207324002
STAT,1919,46,45-49,1965,0.22324975971747163
STAT,1894,29,30-34,1923,30.3828397796316
STAT,1857,25,na,1882,1857.2885868598703
SIM,1852,38,30-34,1890,4
STAT,1799,105,na,1904,0.009802786714695092
STAT,1838,40,20-24,1878,0.12996143101313543
SIM,1918,28,50-100,1946,1
STAT,1933,18,25-29,1951,54.6589518965536
STAT,1822,67,na,1889,819.3526853771122
SIM,1882,60,na,1942,1725
STAT,1857,46,50-100,1903,0.18343010805590484
STAT,1891,44,40-44,1935,2.594592044052085
STAT,1869,22,20-24,1891,63.01611996721754
SIM,1921,25,45-49,1946,2
SIM,1880,31,na,1911,2450
STAT,1837,41,30-34,1878,0.8674380827252125
SIM,1842,91,na,1933,20
STAT,1875,0,na,1875,3563.1500438506946
SIM,1909,24,na,1933,3315
STAT,1870,42,30-34,1912,1.0629025886458545
STAT,1854,23,50-100,1877,0.34254823121578304
SIM,1888,32,25-29,1920,11
STAT,1880,23,30-34,1903,17.650671714803043
SIM,1842,34,50-100,1876,3
STAT,1772,102,na,1874,0.06998690662139287
STAT,1848,20,25-29,1868,50.94417607314546
STAT,1944,1,na,1945,4203.249913789237
SIM,1941,18,25-29,1959,49
SIM,1932,28,25-29,1960,74
STAT,1811,49,45-49,1860,0.7592012037378713
STAT,1841,20,25-29,1861,50.33699077743762
SIM,1812,87,na,1899,78
SIM,1900,25,na,1925,3097
STAT,1938,15,na,1953,3445.576298006293
STAT,1913,25,45-49,1938,1.6368599612477885
SIM,1873,14,na,1887,2496
STAT,1844,38,30-34,1882,3.912803308396365
STAT,1851,33,15-19,1884,0.1075699997989243
STAT,1803,53,50-100,1856,0.04243001341766224
STAT,1915,42,na,1957,3531.9569855828618
SIM,1870,0,na,1870,3283
STAT,1810,86,na,1896,100.47592618690072
STAT,1933,25,15-19,1958,0.886297911982381
SIM,1842,15,15-19,1857,7
SIM,1932,20,na,1952,4405
SIM,1899,21,45-49,1920,3
STAT,1912,17,40-44,1929,0.26713145348394546
SIM,1861,28,30-34,1889,18
STAT,1913,23,na,1936,3472.08622199161
STAT,1875,34,na,1909,2296.1768935985183
SIM,1917,17,35-39,1934,2
SIM,1867,83,na,1950,300
SIM,1877,44,30-34,1921,1
STAT,1854,36,35-39,1890,5.117683619475207
SIM,1877,22,20-24,1899,70
STAT,1807,53,40-44,1860,0.03653834367795475
STAT,1853,28,30-34,1881,19.545824781025942
STAT,1890,21,35-39,1911,6.760486182131552
STAT,1912,18,50-100,1930,0.0713655815052652
SIM,1882,44,40-44,1926,4
STAT,1829,45,40-44,1874,0.1417994242237634
STAT,1874,44,40-44,1918,2.1424322427364957
STAT,1930,25,45-49,1955,2.077156735458332
SIM,1855,30,20-24,1885,2
SIM,1856,20,25-29,1876,52
STAT,1873,23,40-44,1896,1.9920072660589678
STAT,1807,50,na,1857,1226.6016752730573
SIM,1920,17,40-44,1937,1
STAT,1830,32,30-34,1862,14.607353148632045
SIM,1891,23,50-100,1914,1
SIM,1938,21,na,1959,3347
STAT,1861,52,30-34,1913,0.004644777274656605
SIM,1845,36,35-39,1881,11
SIM,1905,24,na,1929,3205
STAT,1858,22,45-49,1880,0.5933616579523461
STAT,1817,101,na,1918,0.2530505719432917
SIM,1897,9,na,1906,3329
SIM,1935,35,30-34,1970,2
STAT,1863,31,30-34,1894,14.55803770452656
STAT,1848,42,na,1890,1663.021539423369
STAT,1905,58,na,1963,2854.275231452069
SIM,1891,33,na,1924,2923
STAT,1822,33,35-39,1855,26.220775597056008
STAT,1875,42,50-100,1917,1.0240643806558187
SIM,1849,7,na,1856,2214
STAT,1941,17,20-24,1958,131.91123197275775
STAT,1877,26,50-100,1903,0.629253355709287
SIM,1843,29,50-100,1872,1
STAT,1893,48,40-44,1941,0.11429719284537324
STAT,1805,55,na,1860,1093.4934843868184
STAT,1903,57,na,1960,2799.315613790183
SIM,1845,98,na,1943,2
STAT,1864,33,25-29,1897,8.611446771636405
STAT,1882,50,25-29,1932,0.0033027856221382527
STAT,1850,46,45-49,1896,0.16661626209162284
STAT,1883,27,15-19,1910,0.4200682600530212
STAT,1931,20,35-39,1951,11.605917103007387
SIM,1880,21,30-34,1901,20
STAT,1848,21,50-100,1869,0.36029635398413673
STAT,1900,19,25-29,1919,7.386926789555022
SIM,1848,22,40-44,1870,1
STAT,1839,49,15-19,1888,2.648670847245701E-4
STAT,1907,23,na,1930,3271.287385605883
STAT,1919,36,35-39,1955,2.4570056245115857
SIM,1880,40,50-100,1920,1
SIM,1909,38,40-44,1947,2
STAT,1837,36,35-39,1873,5.492899625238279
SIM,1879,40,na,1919,2293
SIM,1810,52,na,1862,1214
SIM,1898,37,na,1935,3016
STAT,1803,51,30-34,1854,0.017407081152085554
STAT,1840,52,na,1892,1491.5193362124844
SIM,1831,30,35-39,1861,9
STAT,1933,33,15-19,1966,0.16349874966282993
SIM,1913,8,na,1921,3717
SIM,1815,85,na,1900,101
STAT,1836,39,35-39,1875,5.369650874599926
STAT,1849,26,15-19,1875,0.39046052296948913
SIM,1819,44,na,1863,1392
STAT,1836,30,45-49,1866,1.4211426889012102
SIM,1881,23,40-44,1904,4
SIM,1908,24,15-19,1932,5
STAT,1900,17,15-19,1917,7.7777600912589815
STAT,1820,38,30-34,1858,11.367288620530536
STAT,1930,17,45-49,1947,0.6101419577686595
STAT,1845,46,35-39,1891,0.09889337039831977
SIM,1944,21,na,1965,3672
SIM,1851,4,na,1855,2293
SIM,1844,39,35-39,1883,16
STAT,1925,23,15-19,1948,6.001553708148426
STAT,1945,26,35-39,1971,15.567336130367831
STAT,1798,68,na,1866,710.9308877202337
STAT,1856,53,35-39,1909,0.006267517318917166
STAT,1825,43,15-19,1868,0.015087403715674644
SIM,1915,5,na,1920,3900
STAT,1836,57,na,1893,1269.0599296067373
SIM,1854,17,na,1871,2145
STAT,1813,84,na,1897,140.69238873174092
SIM,1933,9,na,1942,5056
SIM,1799,56,na,1855,1037
STAT,1917,6,na,1923,4061.055093786415
STAT,1878,37,35-39,1915,6.955882476391495
STAT,1860,49,40-44,1909,0.12869607955596016
SIM,1771,94,na,1865,2
STAT,1820,70,na,1890,747.4659248122881
STAT,1878,45,35-39,1923,0.1390559976214071
SIM,1924,25,50-100,1949,1
SIM,1846,46,na,1892,1588
SIM,1868,37,30-34,1905,7
STAT,1846,105,na,1951,0.020673197545810974
STAT,1893,45,50-100,1938,0.16771038411110634
STAT,1820,34,15-19,1854,0.4388636608131324
STAT,1840,20,25-29,1860,51.43465847502473
STAT,1850,25,50-100,1875,0.5376590291795187
SIM,1887,38,na,1925,2431
SIM,1921,22,40-44,1943,2
STAT,1891,47,45-49,1938,0.1549366777493504
STAT,1915,35,20-24,1950,0.25393668570525
STAT,1822,71,na,1893,689.4684903301394
SIM,1829,71,na,1900,700
STAT,1868,58,na,1926,1783.7475095074542
SIM,1871,25,50-100,1896,1
SIM,1874,8,na,1882,2581
STAT,1884,48,15-19,1932,3.687235939243333E-4
STAT,1869,10,na,1879,2462.5675586288367
SIM,1869,42,30-34,1911,5
STAT,1881,21,25-29,1902,52.37388528392137
STAT,1808,66,na,1874,829.315080218686
STAT,1863,25,50-100,1888,0.5389203625048209
STAT,1810,50,45-49,1860,0.051273398525111584
STAT,1903,35,50-100,1938,0.35954793099528576
STAT,1868,17,20-24,1885,16.280253706538428
SIM,1778,88,na,1866,41
STAT,1938,9,na,1947,3709.2813114846376
STAT,1923,19,na,1942,4061.51110293645
SIM,1872,66,na,1938,1540
SIM,1935,28,40-44,1963,5
STAT,1878,52,25-29,1930,0.0034648575827602598
SIM,1886,37,35-39,1923,17
STAT,1927,35,30-34,1962,2.144625605505156
SIM,1828,27,na,1855,1653
SIM,1780,92,na,1872,10
STAT,1862,20,45-49,1882,0.5835898030061023
STAT,1930,25,na,1955,4504.103428699028
STAT,1850,28,15-19,1878,0.3731801393622441
SIM,1830,33,35-39,1863,7
SIM,1915,25,20-24,1940,20
SIM,1932,36,na,1968,4651
STAT,1919,27,50-100,1946,1.0159864736693927
SIM,1878,42,25-29,1920,3
STAT,1924,18,15-19,1942,50.92608447908744
SIM,1932,18,15-19,1950,49
SIM,1893,38,na,1931,2921
SIM,1885,26,50-100,1911,1
STAT,1853,59,na,1912,1441.2882352344898
STAT,1828,37,50-100,1865,1.1659506067499348
STAT,1800,56,na,1856,1057.2473793428162
STAT,1828,28,na,1856,1606.6151972837192
STAT,1866,17,50-100,1883,0.04379871511437003
SIM,1889,39,na,1928,2745
STAT,1923,24,50-100,1947,0.7187984398903029
STAT,1845,26,30-34,1871,21.74603413147201
STAT,1896,32,25-29,1928,12.78822141239369
STAT,1834,20,50-100,1854,0.6086190654929118
STAT,1849,19,25-29,1868,4.9686746310971035
STAT,1844,40,45-49,1884,1.1039744534432563
STAT,1842,26,15-19,1868,0.4024352286156654
STAT,1927,28,40-44,1955,5.334842925616372
STAT,1816,71,na,1887,687.2497811137287
SIM,1886,80,na,1966,869
STAT,1876,46,15-19,1922,3.9120940250917747E-4
STAT,1929,22,50-100,1951,0.7861156756532168
STAT,1911,23,50-100,1934,0.5875739733391587
SIM,1878,35,35-39,1913,14
STAT,1921,24,40-44,1945,3.5655373066108926
STAT,1793,69,na,1862,673.8123773754509
STAT,1815,52,35-39,1867,0.02002347982115454
STAT,1941,25,20-24,1966,17.852865598548487
STAT,1859,44,na,1903,1718.9799020085738
SIM,1916,40,na,1956,3526
STAT,1883,45,45-49,1928,0.22068303581423906
STAT,1893,63,na,1956,2162.224278660342
SIM,1887,65,na,1952,1684
STAT,1893,17,50-100,1910,0.058722450437047984
SIM,1879,5,na,1884,2696
SIM,1901,38,40-44,1939,2
STAT,1847,50,40-44,1897,0.007857440627116097
SIM,1912,6,na,1918,3662
SIM,1938,16,40-44,1954,1
SIM,1875,18,30-34,1893,1
SIM,1916,36,na,1952,3564
STAT,1833,102,na,1935,0.17798361647867858
STAT,1866,44,15-19,1910,0.011865851901296428
STAT,1886,47,35-39,1933,0.1390859186154905
STAT,1930,15,35-39,1945,5.149005790804559
SIM,1873,79,na,1952,629
STAT,1877,31,45-49,1908,1.7164845939739681
STAT,1907,25,20-24,1932,16.387430556565388
STAT,1884,32,15-19,1916,0.13294321993331432
STAT,1829,41,25-29,1870,0.548633297684202
SIM,1868,15,20-24,1883,16
SIM,1853,26,30-34,1879,34
SIM,1908,19,35-39,1927,3
STAT,1910,38,25-29,1948,0.8849203070936809
STAT,1941,15,50-100,1956,0.36472313804104445
STAT,1890,42,30-34,1932,1.326263006367517
SIM,1857,19,25-29,1876,7
STAT,1913,22,40-44,1935,3.0772467403931096
SIM,1904,55,na,1959,2827
SIM,1871,13,na,1884,2534
SIM,1934,21,na,1955,4543
STAT,1899,21,35-39,1920,7.5774993807763265
STAT,1940,28,50-100,1968,0.958293023692015
SIM,1830,25,35-39,1855,11
STAT,1844,76,na,1920,665.0860631911845
STAT,1855,41,35-39,1896,1.2882878829455653
STAT,1901,48,40-44,1949,0.12609016150868071
STAT,1928,40,30-34,1968,0.15440869571829163
STAT,1899,23,45-49,1922,0.8999723674607889
SIM,1866,66,na,1932,1402
SIM,1870,29,35-39,1899,11
STAT,1810,70,na,1880,722.7654176554084
STAT,1907,43,15-19,1950,0.0013209455186042902
STAT,1862,29,35-39,1891,7.719898827132896
STAT,1866,42,40-44,1908,1.9566826264708546
STAT,1933,39,na,1972,4830.706771500988
SIM,1885,31,45-49,1916,1
SIM,1876,17,20-24,1893,16
STAT,1902,47,30-34,1949,0.07245486666384095
SIM,1858,31,na,1889,1944
STAT,1911,41,15-19,1952,0.0013923265374576623
SIM,1896,34,40-44,1930,6
STAT,1830,50,50-100,1880,0.011131034894693265
STAT,1915,27,20-24,1942,17.587234373080893
STAT,1858,42,15-19,1900,0.010229169303624655
STAT,1839,51,45-49,1890,0.009722771098266157
SIM,1850,82,na,1932,311
SIM,1818,40,45-49,1858,1
STAT,1874,52,40-44,1926,0.010110665213185883
STAT,1902,24,50-100,1926,0.5402417177236988
SIM,1834,27,na,1861,1708
STAT,1940,6,na,1946,3828.3371840110744
SIM,1874,42,40-44,1916,5
SIM,1923,27,20-24,1950,19
STAT,1856,4,na,1860,2331.9062869806194
STAT,1870,35,na,1905,2201.5680440429805
STAT,1923,37,20-24,1960,0.28857330394030073
SIM,1890,43,35-39,1933,5
SIM,1827,86,na,1913,107
STAT,1861,24,na,1885,1878.7754418378838
STAT,1891,29,15-19,1920,0.5267257236605871
STAT,1905,30,35-39,1935,13.936146529851174
STAT,1844,28,50-100,1872,0.545790288449606
STAT,1837,51,25-29,1888,0.0022889900309579054
STAT,1818,50,45-49,1868,0.03094941160813252
SIM,1863,31,25-29,1894,14
SIM,1889,23,na,1912,2787
SIM,1829,43,40-44,1872,4
SIM,1802,87,na,1889,38
STAT,1898,38,15-19,1936,0.015423102067582623
STAT,1819,36,30-34,1855,15.519218650270439
STAT,1900,50,na,1950,2862.549637106868
STAT,1953,18,40-44,1971,1.5979487471086549
SIM,1878,51,na,1929,2188
SIM,1927,36,35-39,1963,5
SIM,1883,14,na,1897,2445
SIM,1941,15,20-24,1956,115
STAT,1851,51,45-49,1902,0.010693110595843377
STAT,1817,41,15-19,1858,0.03634907194815079
STAT,1830,35,35-39,1865,5.766636883040663
SIM,1850,44,45-49,1894,3
STAT,1771,102,na,1873,0.05677202869164838
STAT,1858,20,35-39,1878,5.037579744052574
SIM,1837,69,na,1906,894
SIM,1872,7,na,1879,2540
STAT,1812,43,20-24,1855,0.5715904099793766
SIM,1836,21,20-24,1857,51
STAT,1848,24,40-44,1872,1.8017406943818666
STAT,1865,44,na,1909,1957.2905890833697
STAT,1844,52,30-34,1896,0.004156498790275227
SIM,1804,52,na,1856,1129
SIM,1900,17,25-29,1917,8
SIM,1844,30,45-49,1874,3
STAT,1939,29,15-19,1968,0.6697061978910887
STAT,1837,44,35-39,1881,1.1964346898617424
SIM,1917,3,na,1920,4057
STAT,1882,43,35-39,1925,1.652566063389183
STAT,1919,38,45-49,1957,0.691172437905065
SIM,1888,32,50-100,1920,1
SIM,1913,30,35-39,1943,8
SIM,1827,36,30-34,1863,5
SIM,1864,41,na,1905,2079
STAT,1896,25,35-39,1921,12.128728737474066
SIM,1852,40,45-49,1892,1
STAT,1862,40,15-19,1902,0.011240773561156771
STAT,1817,40,na,1857,1384.7060223335304
STAT,1860,35,na,1895,1826.0028853874126
SIM,1856,24,40-44,1880,1
STAT,1859,3,na,1862,2472.5795419709184
SIM,1792,86,na,1878,45
SIM,1854,3,na,1857,2531
SIM,1907,17,25-29,1924,10
STAT,1886,27,30-34,1913,25.13466232331521
STAT,1842,44,45-49,1886,1.0747661508650554
SIM,1900,24,15-19,1924,3
SIM,1920,27,35-39,1947,20
SIM,1928,21,na,1949,4315
SIM,1849,28,30-34,1877,30
STAT,1832,22,40-44,1854,3.1323073856058077
SIM,1821,85,na,1906,121
STAT,1811,46,40-44,1857,0.57992170091943
STAT,1830,38,na,1868,1593.1692138863173
STAT,1915,5,na,1920,3962.085615236713
STAT,1925,24,50-100,1949,0.7394894259674948
SIM,1837,34,35-39,1871,13
STAT,1844,51,50-100,1895,0.010652996628046335
SIM,1845,44,35-39,1889,4
STAT,1868,62,na,1930,1648.571510895691
STAT,1859,75,na,1934,776.1367280563194
SIM,1866,20,35-39,1886,5
STAT,1933,15,20-24,1948,172.24797560849157
SIM,1912,17,35-39,1929,1
STAT,1824,38,15-19,1862,0.08026902516954237
SIM,1903,34,40-44,1937,3
STAT,1838,43,25-29,1881,0.4601705741639498
SIM,1907,53,na,1960,3029
SIM,1857,83,na,1940,258
STAT,1875,16,15-19,1891,5.7738531138383475
STAT,1904,17,35-39,1921,0.7434038288367604
SIM,1894,27,30-34,1921,50
STAT,1851,52,20-24,1903,5.382477104223734E-4
STAT,1912,27,35-39,1939,13.973725855890102
SIM,1840,22,40-44,1862,2
SIM,1883,16,15-19,1899,10
SIM,1803,73,na,1876,452
STAT,1875,22,45-49,1897,0.676777100279604
SIM,1918,35,30-34,1953,5
STAT,1865,82,na,1947,400.53527715386696
STAT,1865,39,15-19,1904,0.04772042562109276
STAT,1920,31,15-19,1951,0.13352210278279708
STAT,1830,90,na,1920,47.09552904656678
SIM,1840,68,na,1908,1003
STAT,1949,17,na,1966,4044.4164824053773
SIM,1929,37,na,1966,4674
STAT,1812,53,30-34,1865,0.01836136773097839
STAT,1928,22,na,1950,4307.712646968642
SIM,1942,29,na,1971,3558
STAT,1899,17,15-19,1916,7.682949377925014
STAT,1874,50,35-39,1924,0.008431769608315437
STAT,1928,33,40-44,1961,4.6201616671647265
STAT,1827,43,na,1870,1468.8433819605136
STAT,1823,32,25-29,1855,27.34768530016336
SIM,1817,39,25-29,1856,2
SIM,1831,32,25-29,1863,12
SIM,1866,97,na,1963,10
SIM,1922,20,35-39,1942,13
SIM,1878,82,na,1960,640
SIM,1850,8,na,1858,2177
STAT,1869,23,15-19,1892,3.007427200552789
SIM,1830,102,na,1932,1
SIM,1877,27,30-34,1904,32
STAT,1917,42,30-34,1959,0.12603374552436272
STAT,1923,40,50-100,1963,0.13008723650862475
STAT,1929,39,50-100,1968,0.5081580121246915
STAT,1804,70,na,1874,690.4575443838587
STAT,1901,46,35-39,1947,0.10471967152907563
SIM,1845,33,30-34,1878,21
STAT,1846,45,40-44,1891,0.121911815448725
STAT,1846,31,30-34,1877,14.699629565002997
SIM,1911,27,na,1938,3473
STAT,1887,45,50-100,1932,0.26206240553667565
SIM,1923,22,na,1945,3901
STAT,1914,46,45-49,1960,0.20409676396215964
SIM,1796,86,na,1882,72
SIM,1839,71,na,1910,942
STAT,1888,42,25-29,1930,0.715771452688997
STAT,1910,44,35-39,1954,0.17752196126689165
SIM,1936,33,40-44,1969,4
STAT,1915,38,25-29,1953,0.9348954792555042
STAT,1916,37,na,1953,3639.508965815962
SIM,1909,23,20-24,1932,104
SIM,1834,65,na,1899,1040
STAT,1854,45,na,1899,1636.2490278460086
SIM,1831,32,40-44,1863,7
SIM,1858,78,na,1936,584
STAT,1810,51,20-24,1861,0.002555329669134513
SIM,1878,92,na,1970,185
STAT,1858,40,50-100,1898,0.7914017639983837
SIM,1833,80,na,1913,345
SIM,1847,90,na,1937,43
STAT,1845,68,na,1913,1076.433845822805
STAT,1803,53,20-24,1856,0.002073127773497273
STAT,1871,16,30-34,1887,1.5112699593227246
STAT,1878,34,30-34,1912,17.023793595480672
STAT,1914,20,35-39,1934,8.771099956487172
SIM,1896,30,25-29,1926,17
STAT,1898,62,na,1960,2446.794223054986
STAT,1911,45,30-34,1956,0.08008413853689074
STAT,1866,22,35-39,1888,5.124139428414402
STAT,1817,49,na,1866,1252.747646498778
SIM,1860,82,na,1942,339
SIM,1874,22,35-39,1896,6
STAT,1862,18,30-34,1880,1.4623601847541876
STAT,1870,44,20-24,1914,0.14502404137998287
SIM,1877,38,na,1915,2294
STAT,1853,50,na,1903,1619.7527993373094
STAT,1865,50,25-29,1915,0.0030843176926127996
SIM,1870,18,30-34,1888,1
STAT,1891,48,20-24,1939,0.007815584052265677
STAT,1854,19,35-39,1873,0.46710897878487756
STAT,1915,45,15-19,1960,3.522808148451433E-4
STAT,1811,55,na,1866,1139.1845720651052
STAT,1937,26,45-49,1963,1.5914184606727497
STAT,1841,42,35-39,1883,1.2874173903941826
SIM,1822,33,na,1855,1602
SIM,1910,33,20-24,1943,2
STAT,1860,45,25-29,1905,0.04466384071842267
SIM,1859,39,30-34,1898,6
STAT,1872,21,30-34,1893,16.940639255540557
STAT,1916,4,na,1920,4032.0653710153338
STAT,1866,30,na,1896,2095.1576417891265
STAT,1822,98,na,1920,1.6779785413549446
STAT,1850,47,20-24,1897,0.008408642986119388
SIM,1883,45,na,1928,2156
STAT,1879,44,25-29,1923,0.6255274795831673
SIM,1846,50,na,1896,1531
STAT,1795,102,na,1897,0.05663548564271434
SIM,1859,26,na,1885,2019
STAT,1796,102,na,1898,0.06830170199091005
STAT,1830,27,50-100,1857,0.6224568148373907
STAT,1838,46,45-49,1884,0.16773135117347784
STAT,1897,31,50-100,1928,1.1623293917141866
SIM,1963,7,na,1970,4681
SIM,1944,25,30-34,1969,38
SIM,1798,71,na,1869,584
SIM,1954,14,na,1968,4435
STAT,1893,25,na,1918,2879.931716691996
STAT,1909,18,30-34,1927,2.2515672372473703
STAT,1856,30,na,1886,1824.73862381479
STAT,1837,33,30-34,1870,13.676366865010452
STAT,1851,41,15-19,1892,0.010172797199616928
STAT,1869,30,20-24,1899,2.491644860566245
SIM,1849,26,na,1875,1889
STAT,1855,43,40-44,1898,1.5815122848097427
STAT,1793,90,na,1883,30.32510461207996
SIM,1945,26,45-49,1971,1
SIM,1807,66,na,1873,760
SIM,1859,25,20-24,1884,13
STAT,1886,77,na,1963,1103.6551343737679
SIM,1891,74,na,1965,1552
STAT,1878,58,na,1936,1944.8732359676414
STAT,1806,54,35-39,1860,0.023350746031493064
SIM,1900,39,35-39,1939,3
SIM,1848,25,45-49,1873,1
SIM,1898,30,40-44,1928,4
STAT,1833,36,15-19,1869,0.04318900590925641
SIM,1955,2,na,1957,4549
STAT,1783,73,na,1856,389.66658248790003
STAT,1853,97,na,1950,3.9840969565360447
STAT,1876,39,50-100,1915,1.1853118342267983
STAT,1872,41,35-39,1913,1.7247869000951046
SIM,1880,41,35-39,1921,5
STAT,1835,29,25-29,1864,33.90607876609154
STAT,1937,33,35-39,1970,8.534565992739482
SIM,1841,13,na,1854,2140
SIM,1904,22,40-44,1926,1
SIM,1843,29,25-29,1872,37
SIM,1816,46,na,1862,1318
STAT,1766,94,na,1860,3.679557722612633
SIM,1942,26,na,1968,3553
STAT,1890,23,25-29,1913,65.91591635292517
STAT,1855,39,50-100,1894,0.8607811373154958
STAT,1942,27,30-34,1969,38.847897613836295
SIM,1872,33,40-44,1905,2
SIM,1911,37,na,1948,3469
STAT,1805,50,35-39,1855,0.026149542460187653
STAT,1913,15,35-39,1928,0.8140662765346237
STAT,1874,48,50-100,1922,0.2341549399616323
SIM,1897,65,na,1962,2264
STAT,1917,47,25-29,1964,0.05233970156903504
SIM,1890,27,na,1917,2850
SIM,1909,19,35-39,1928,3
STAT,1811,48,30-34,1859,0.31680085751921633
STAT,1873,31,25-29,1904,9.861856338580335
SIM,1839,64,na,1903,1260
STAT,1877,18,25-29,1895,5.540635508290619
SIM,1949,17,30-34,1966,14
STAT,1946,24,50-100,1970,0.6912723134582678
STAT,1900,17,50-100,1917,0.06420824312644721
STAT,1857,17,45-49,1874,0.05717932601030122
STAT,1811,65,na,1876,856.2915700513021
SIM,1878,32,30-34,1910,23
SIM,1921,15,35-39,1936,4
STAT,1785,105,na,1890,0.021158024243389556
STAT,1829,50,20-24,1879,5.984729118401175E-4
STAT,1873,40,40-44,1913,2.178612721868874
SIM,1859,16,na,1875,2236
STAT,1945,25,40-44,1970,4.834997428558285
SIM,1844,28,30-34,1872,25
STAT,1862,30,na,1892,1938.436908629216
STAT,1945,24,na,1969,3778.3853317219823
STAT,1941,28,25-29,1969,64.28723083181525
STAT,1883,44,15-19,1927,0.012613479145965258
STAT,1916,37,30-34,1953,1.7631345035619659
SIM,1918,28,40-44,1946,8
SIM,1903,24,30-34,1927,24
SIM,1877,45,na,1922,2245
STAT,1828,29,35-39,1857,12.192406112205852
SIM,1881,40,40-44,1921,6
STAT,1873,45,35-39,1918,0.1355855526542083
SIM,1828,41,30-34,1869,3
STAT,1860,45,na,1905,1744.5578275138384
STAT,1941,21,40-44,1962,3.2833764060203294
STAT,1896,41,20-24,1937,0.013831493517558803
SIM,1935,16,25-29,1951,65
SIM,1948,14,na,1962,4010
STAT,1802,52,25-29,1854,0.010095820756947179
SIM,1765,91,na,1856,14
SIM,1827,79,na,1906,398
STAT,1883,49,25-29,1932,0.05221645659303492
STAT,1887,32,30-34,1919,18.446130728138815
STAT,1843,40,50-100,1883,0.8051213857503818
SIM,1836,29,35-39,1865,5
SIM,1848,18,20-24,1866,13
STAT,1924,25,na,1949,4148.891474821468
SIM,1889,30,na,1919,2811
SIM,1886,34,30-34,1920,20
STAT,1817,43,na,1860,1334.264513521732
STAT,1887,46,40-44,1933,0.18138573439978914
STAT,1888,30,25-29,1918,11.52273324678536
SIM,1873,9,na,1882,2559
SIM,1890,21,25-29,1911,79
STAT,1842,16,na,1858,2111.495059464612
SIM,1848,78,na,1926,538
STAT,1929,31,35-39,1960,10.972784914051031
SIM,1895,32,30-34,1927,27
STAT,1962,5,na,1967,4757.810290926204
STAT,1936,28,35-39,1964,13.5646634179627
STAT,1902,31,30-34,1933,23.371512039031796
STAT,1916,32,50-100,1948,0.8063681333644994
SIM,1849,30,45-49,1879,2
SIM,1937,31,35-39,1968,15
STAT,1902,48,50-100,1950,0.18237214442076086
STAT,1927,16,25-29,1943,51.032752266075086
SIM,1886,20,20-24,1906,67
STAT,1879,47,45-49,1926,0.23194755484474447
STAT,1844,45,na,1889,1604.3160568656128
SIM,1836,50,na,1886,1406
STAT,1936,10,na,1946,3593.867102401328
SIM,1923,12,na,1935,4299
SIM,1899,15,15-19,1914,6
STAT,1827,49,na,1876,1366.524871721513
SIM,1847,93,na,1940,15
STAT,1857,18,50-100,1875,0.04263190483507542
SIM,1948,18,25-29,1966,52
SIM,1815,51,na,1866,1190
SIM,1840,30,25-29,1870,12
STAT,1857,108,na,1965,0.009723991640026809
SIM,1924,37,30-34,1961,1
STAT,1874,37,15-19,1911,0.054219000023085655
STAT,1902,36,25-29,1938,0.8324716798372354
STAT,1855,40,20-24,1895,0.11361216807043047
STAT,1872,30,na,1902,2280.8935901725486
SIM,1830,68,na,1898,982
STAT,1855,2,na,1857,2522.7789169296825
STAT,1863,48,45-49,1911,0.19351514028739766
SIM,1840,44,35-39,1884,6
STAT,1836,28,30-34,1864,20.42895261806725
STAT,1873,70,na,1943,1345.4195390236416
STAT,1842,43,15-19,1885,0.010044977302207094
STAT,1849,41,50-100,1890,0.7649263519820175
SIM,1860,72,na,1932,1021
STAT,1771,88,na,1859,29.856998974174633
STAT,1919,35,40-44,1954,1.5277544742790403
STAT,1922,22,35-39,1944,10.201438396528728
STAT,1898,18,45-49,1916,0.08331731391214457
STAT,1831,40,35-39,1871,1.4162836614952419
STAT,1886,25,50-100,1911,0.6428241651186818
STAT,1939,5,na,1944,3793.4244980687313
SIM,1889,19,20-24,1908,25
SIM,1828,31,na,1859,1611
SIM,1839,20,25-29,1859,67
STAT,1861,19,25-29,1880,5.04947927529799
STAT,1922,15,45-49,1937,0.5487281477403262
STAT,1890,26,45-49,1916,1.2868310619631176
STAT,1915,52,na,1967,3438.029502060169
STAT,1832,30,25-29,1862,8.288150858218813
SIM,1852,53,na,1905,1630
SIM,1879,16,25-29,1895,6
STAT,1853,54,30-34,1907,0.004293062663605598
STAT,1925,46,20-24,1971,0.012683705544959034
SIM,1780,98,na,1878,1
SIM,1831,35,45-49,1866,1
SIM,1892,12,na,1904,3119
SIM,1872,33,25-29,1905,15
STAT,1832,44,35-39,1876,1.3089819070386397
STAT,1866,15,45-49,1881,0.05909234460103205
STAT,1867,18,na,1885,2276.6815305130017
SIM,1839,27,45-49,1866,2
SIM,1854,31,30-34,1885,17
STAT,1900,12,na,1912,3384.609411330791
SIM,1895,30,na,1925,2993
STAT,1912,34,50-100,1946,0.7618068770500124
STAT,1850,45,na,1895,1599.6838533288267
STAT,1900,38,30-34,1938,1.5001490586980126
STAT,1936,35,40-44,1971,1.3905032343412176
SIM,1809,51,na,1860,1237
STAT,1823,35,45-49,1858,3.5630519306398405
STAT,1840,90,na,1930,54.90588812215204
SIM,1908,18,20-24,1926,25
STAT,1914,43,40-44,1957,0.23372612968833487
STAT,1842,48,25-29,1890,0.040502295930794206
STAT,1896,22,30-34,1918,22.239209213271792
SIM,1863,102,na,1965,1
STAT,1897,22,na,1919,2988.038751321426
STAT,1829,31,30-34,1860,17.49663080483694
SIM,1923,31,40-44,1954,5
STAT,1885,37,na,1922,2217.3970837497827
STAT,1850,32,35-39,1882,7.458148488278818
SIM,1845,22,25-29,1867,56
STAT,1840,32,25-29,1872,8.688091566178942
SIM,1878,3,na,1881,2907
STAT,1765,112,na,1877,7.022920374747095E-4
STAT,1842,41,40-44,1883,1.6785391590836092
STAT,1879,40,25-29,1919,0.6404846175131463
STAT,1886,81,na,1967,864.2642081508116
STAT,1832,41,30-34,1873,0.8639987988612123
STAT,1932,34,45-49,1966,1.9736431098010323
SIM,1880,35,40-44,1915,8
STAT,1928,18,na,1946,4370.3096261265755
SIM,1896,32,50-100,1928,1
STAT,1890,20,20-24,1910,80.07070587915376
STAT,1857,41,50-100,1898,0.7903534168252049
STAT,1921,47,15-19,1968,3.9233617806006275E-4
SIM,1903,37,45-49,1940,1
STAT,1878,20,20-24,1898,68.17653345721901
SIM,1865,26,na,1891,2048
SIM,1876,41,45-49,1917,4
STAT,1860,31,15-19,1891,0.10978168064397145
SIM,1836,22,15-19,1858,2
SIM,1867,45,na,1912,1976
SIM,1849,64,na,1913,1275
STAT,1842,20,50-100,1862,0.3715875678496183
SIM,1837,31,30-34,1868,24
STAT,1815,48,15-19,1863,9.574585561414517E-4
STAT,1888,40,35-39,1928,2.0412780430520368
SIM,1813,44,40-44,1857,9
STAT,1825,48,25-29,1873,0.05957074826502371
STAT,1849,22,35-39,1871,5.085374410103785
STAT,1937,30,30-34,1967,14.739924115890474
SIM,1910,42,na,1952,3233
STAT,1917,44,20-24,1961,0.01735213985790567
STAT,1832,102,na,1934,0.1772707558440823
SIM,1827,31,20-24,1858,1
SIM,1822,39,na,1861,1532
SIM,1909,26,25-29,1935,62
STAT,1834,21,45-49,1855,0.5814496479626953
STAT,1945,21,25-29,1966,95.66794886745876
SIM,1918,38,35-39,1956,7
STAT,1931,11,na,1942,4906.811364181299
STAT,1882,39,15-19,1921,0.05110055167181806
STAT,1846,35,50-100,1881,0.9229489039900701
STAT,1892,39,25-29,1931,3.3718288216946406
SIM,1866,40,50-100,1906,1
STAT,1901,49,50-100,1950,0.17936328996748896
STAT,1900,30,35-39,1930,13.379112301224996
SIM,1854,35,50-100,1889,1
STAT,1852,40,20-24,1892,0.1218792706032983
SIM,1879,30,na,1909,2373
STAT,1902,43,15-19,1945,0.0012692309244721235
SIM,1778,98,na,1876,1
STAT,1911,43,40-44,1954,0.22412289280353098
STAT,1901,43,30-34,1944,0.10480262352098299
SIM,1856,27,45-49,1883,4
STAT,1852,49,30-34,1901,0.07201037967844412
SIM,1930,22,35-39,1952,10
STAT,1852,16,na,1868,2121.815829014874
SIM,1854,34,35-39,1888,9
STAT,1841,53,40-44,1894,0.007087278372197114
STAT,1867,20,45-49,1887,0.6300882157063705
SIM,1842,53,na,1895,1440
STAT,1862,64,na,1926,1400.8349749029833
SIM,1892,59,na,1951,2328
STAT,1854,33,30-34,1887,12.742143913615639
SIM,1933,15,na,1948,4711
STAT,1864,33,40-44,1897,3.646084736136215
SIM,1859,19,na,1878,2204
SIM,1862,33,30-34,1895,18
STAT,1872,35,40-44,1907,4.190178513239529
STAT,1936,18,40-44,1954,1.2615227421456532
STAT,1846,34,35-39,1880,8.26464185396427
SIM,1837,79,na,1916,395
STAT,1882,21,25-29,1903,52.781906058638114
STAT,1837,22,25-29,1859,47.30706758671574
STAT,1914,41,50-100,1955,0.11011001839625623
STAT,1924,35,15-19,1959,0.021430915041883932
SIM,1850,41,40-44,1891,5
STAT,1848,27,45-49,1875,0.9549156999164002
SIM,1881,71,na,1952,1101
STAT,1814,42,25-29,1856,2.000071768118821
SIM,1853,21,20-24,1874,77
SIM,1886,46,50-100,1932,3
SIM,1939,24,45-49,1963,2
STAT,1824,42,35-39,1866,2.290635771571134
STAT,1843,97,na,1940,3.8758331359826297
STAT,1871,82,na,1953,436.97472007058644
SIM,1897,58,na,1955,2518
STAT,1915,49,30-34,1964,0.08435530802325092
STAT,1820,54,35-39,1874,0.013111833585422287
SIM,1898,33,45-49,1931,5
SIM,1838,27,na,1865,1742
SIM,1908,48,na,1956,3041
STAT,1810,54,25-29,1864,0.011549014103002448
STAT,1878,46,50-100,1924,0.2422217050896968
SIM,1862,16,30-34,1878,2
SIM,1885,29,30-34,1914,28
STAT,1901,22,15-19,1923,4.3622564333302005
SIM,1852,16,20-24,1868,14
STAT,1776,94,na,1870,3.3892185406764987
STAT,1835,31,na,1866,1739.437672334625
STAT,1806,51,30-34,1857,0.017148129657215353
STAT,1854,16,30-34,1870,1.3811009882060044
STAT,1913,19,na,1932,3709.66564358477
STAT,1816,51,40-44,1867,0.02707250254243708
STAT,1874,96,na,1970,44.130494294460284
SIM,1904,25,45-49,1929,1
STAT,1844,16,20-24,1860,15.914216247356759
STAT,1906,44,45-49,1950,0.14103694307024636
SIM,1818,65,na,1883,774
SIM,1880,27,na,1907,2454
STAT,1823,108,na,1931,9.639227420875492E-4
STAT,1864,36,45-49,1900,1.6912232424990765
STAT,1845,31,na,1876,1834.0468216913087
STAT,1868,41,45-49,1909,1.3560432044340394
SIM,1894,44,na,1938,2939
STAT,1877,29,30-34,1906,24.50980664812712
STAT,1878,23,25-29,1901,56.12437941262653
SIM,1846,43,40-44,1889,5
SIM,1787,72,na,1859,485
STAT,1844,54,20-24,1898,5.03780805033513E-4
SIM,1836,43,30-34,1879,1
STAT,1832,98,na,1930,1.9642581153067784
SIM,1872,36,45-49,1908,1
STAT,1872,24,35-39,1896,5.498576763586435
STAT,1857,15,na,1872,2033.1700197439839
STAT,1955,17,na,1972,4615.661570330783
STAT,1966,3,na,1969,4640.398961309491
STAT,1833,47,20-24,1880,0.00855314273336777
SIM,1803,66,na,1869,747
STAT,1921,0,na,1921,4851.665247468785
SIM,1857,22,35-39,1879,5
SIM,1877,11,na,1888,2542
SIM,1886,23,25-29,1909,59
STAT,1838,43,40-44,1881,1.6118340227188699
STAT,1915,31,40-44,1946,3.7801772789900756
STAT,1828,43,30-34,1871,0.9973498565129155
STAT,1852,45,15-19,1897,3.069385222707202E-4
SIM,1879,77,na,1956,836
STAT,1883,42,40-44,1925,2.0799665889615677
SIM,1908,16,30-34,1924,2
STAT,1879,41,20-24,1920,0.15752664273552944
STAT,1873,42,30-34,1915,1.1010691747406323
STAT,1911,48,35-39,1959,0.1149611040107316
STAT,1884,48,na,1932,2073.925185849309
SIM,1932,26,na,1958,4458
SIM,1859,28,25-29,1887,38
STAT,1826,50,20-24,1876,6.927839231704533E-4
STAT,1901,48,25-29,1949,0.042422857747428544
STAT,1832,34,50-100,1866,0.7094844463335714
SIM,1907,59,na,1966,2940
STAT,1856,49,15-19,1905,2.8977798305288927E-4
STAT,1805,65,na,1870,821.9469219891656
STAT,1903,19,40-44,1922,0.2445094323547002
STAT,1843,105,na,1948,0.02115355606147647
SIM,1818,38,30-34,1856,4
STAT,1831,34,40-44,1865,3.4705939988158727
STAT,1866,49,25-29,1915,0.04912147818800796
STAT,1928,36,45-49,1964,0.8147228414087114
STAT,1901,26,30-34,1927,33.41196642653352
SIM,1945,23,40-44,1968,3
STAT,1846,51,35-39,1897,0.006099053204081904
STAT,1937,23,40-44,1960,3.0917407513390613
SIM,1962,5,na,1967,4680
SIM,1824,72,na,1896,726
STAT,1830,32,na,1862,1675.4562306225416
STAT,1841,31,na,1872,1817.877044889891
STAT,1822,47,45-49,1869,0.3292181298856766
SIM,1904,32,35-39,1936,8
STAT,1895,34,30-34,1929,21.34005312059298
STAT,1967,5,na,1972,4638.675498319364
SIM,1906,38,25-29,1944,4
STAT,1847,41,25-29,1888,0.48125343754753774
STAT,1874,17,45-49,1891,0.06307093822973468
SIM,1891,42,40-44,1933,6
STAT,1879,44,40-44,1923,2.1910276978695165
STAT,1837,97,na,1934,3.3912693424070435
STAT,1921,27,45-49,1948,1.8190960833450458
STAT,1910,35,20-24,1945,0.2403624093632264
STAT,1858,96,na,1954,6.368119517238212
STAT,1900,20,40-44,1920,2.747312847864926
STAT,1853,50,50-100,1903,0.011361270594757757
SIM,1898,23,35-39,1921,9
SIM,1868,32,20-24,1900,2
STAT,1893,41,20-24,1934,0.1912171585287276
STAT,1835,68,na,1903,953.4879460289179
STAT,1834,83,na,1917,245.7176352254726
STAT,1812,45,50-100,1857,0.8349188572548707
STAT,1887,35,35-39,1922,7.543484340086385
STAT,1803,91,na,1894,19.144652749608476
STAT,1846,41,25-29,1887,0.46415719635479985
SIM,1895,35,35-39,1930,19
STAT,1859,27,20-24,1886,8.997296114413853
SIM,1909,16,30-34,1925,3
SIM,1894,0,na,1894,3479
STAT,1875,37,na,1912,2286.5654227603377
STAT,1877,15,20-24,1892,17.46032839586447
STAT,1954,16,35-39,1970,4.901725273719047
STAT,1918,22,na,1940,3720.6443981429693
STAT,1906,37,20-24,1943,0.22887515615284892
STAT,1899,0,na,1899,3801.420788118709
STAT,1876,81,na,1957,596.2821790539592
STAT,1893,46,15-19,1939,2.712153239582549E-4
SIM,1824,65,na,1889,891
STAT,1936,25,30-34,1961,35.4490708776812
SIM,1873,32,50-100,1905,1
STAT,1858,16,15-19,1874,5.171692737421821
STAT,1823,50,na,1873,1320.1182382968254
STAT,1841,38,15-19,1879,0.044799269861663035
STAT,1849,82,na,1931,336.30833672803493
SIM,1836,26,30-34,1862,29
STAT,1764,112,na,1876,5.423607110116072E-4
STAT,1776,87,na,1863,45.525466448786986
STAT,1909,17,50-100,1926,0.06938979653785177
STAT,1917,19,35-39,1936,4.228818793714305
SIM,1826,29,25-29,1855,41
STAT,1855,43,25-29,1898,0.4515138692262071
SIM,1882,31,50-100,1913,5
SIM,1832,42,35-39,1874,1
STAT,1876,15,50-100,1891,0.04800158513871249
SIM,1842,94,na,1936,8
SIM,1858,18,30-34,1876,1
SIM,1939,5,na,1944,3729
STAT,1829,53,25-29,1882,0.0024632212086296546
SIM,1944,18,40-44,1962,1
STAT,1845,21,20-24,1866,60.69591274077993
STAT,1895,17,30-34,1912,1.9649219119718497
STAT,1940,18,na,1958,3529.0389794385765
STAT,1889,48,15-19,1937,2.598431095497837E-4
STAT,1867,15,na,1882,2317.3890838705865
STAT,1823,52,45-49,1875,0.016653977553523793
SIM,1932,25,20-24,1957,26
STAT,1839,50,30-34,1889,0.0040677527120291665
STAT,1924,25,20-24,1949,20.216369611677997
STAT,1904,24,40-44,1928,2.805518699573467
SIM,1861,30,45-49,1891,1
SIM,1912,24,40-44,1936,3
STAT,1891,33,35-39,1924,11.79167464421421
STAT,1828,83,na,1911,225.36018829237003
SIM,1820,45,50-100,1865,3
STAT,1890,43,45-49,1933,1.7161723830761375
STAT,1834,41,15-19,1875,0.010438064427796104
STAT,1843,53,25-29,1896,0.002514374522080486
STAT,1902,33,20-24,1935,3.588370671111637
STAT,1828,26,30-34,1854,59.91807574582017
SIM,1925,19,35-39,1944,7
STAT,1878,30,15-19,1908,0.14117693775192675
STAT,1919,31,25-29,1950,9.458722073392085
STAT,1906,37,na,1943,3266.4766487067154
STAT,1892,77,na,1969,1422.7881764912013
STAT,1869,47,35-39,1916,0.12742431010858044
STAT,1874,31,50-100,1905,0.8882792685658741
SIM,1873,45,na,1918,2194
SIM,1903,27,35-39,1930,19
STAT,1833,54,45-49,1887,0.00874724759204716
SIM,1927,31,25-29,1958,15
STAT,1867,51,20-24,1918,6.576665513775109E-4
STAT,1921,17,35-39,1938,4.518903581640104
SIM,1811,92,na,1903,12
STAT,1823,32,40-44,1855,11.57900415409922
STAT,1905,19,50-100,1924,0.06652285686742217
STAT,1896,44,25-29,1940,0.054923910829707934
STAT,1891,40,25-29,1931,0.7584551735942126
SIM,1938,14,na,1952,3610
SIM,1866,16,15-19,1882,7
STAT,1872,17,50-100,1889,0.046607017638206245
STAT,1860,42,20-24,1902,0.12178012540372751
STAT,1930,32,50-100,1962,1.0080485762354698
STAT,1928,26,35-39,1954,17.535276270169717
STAT,1950,15,20-24,1965,151.53145671516108
STAT,1864,53,45-49,1917,0.012056252527776659
STAT,1890,23,40-44,1913,2.3994183163030036
STAT,1875,42,15-19,1917,0.013386463470428989
SIM,1839,24,40-44,1863,1
STAT,1836,24,15-19,1860,2.71008873806034
STAT,1848,47,15-19,1895,2.8682571133379584E-4
STAT,1841,40,45-49,1881,1.0916693060771474
STAT,1857,52,40-44,1909,0.007798736261780989
STAT,1871,19,35-39,1890,0.511134068685646
SIM,1857,93,na,1950,21
SIM,1832,91,na,1923,19
SIM,1849,20,35-39,1869,5
STAT,1839,43,50-100,1882,0.7329690312287646
SIM,1867,27,20-24,1894,14
STAT,1860,47,15-19,1907,3.0567187814469415E-4
SIM,1899,19,30-34,1918,2
SIM,1873,43,35-39,1916,2
SIM,1872,30,20-24,1902,2
STAT,1910,12,na,1922,3695.725464399977
STAT,1880,26,35-39,1906,9.62393350889133
STAT,1934,30,50-100,1964,1.0676030428742231
SIM,1885,30,na,1915,2252
SIM,1857,32,45-49,1889,1
SIM,1919,33,40-44,1952,6
STAT,1817,50,na,1867,1238.722247902697
STAT,1883,47,50-100,1930,0.22633284455472358
STAT,1816,43,50-100,1859,3.028812543538286
SIM,1855,64,na,1919,1314
STAT,1856,108,na,1964,0.008196321521865854
SIM,1891,47,50-100,1938,1
STAT,1851,35,20-24,1886,0.5833187296604064
STAT,1874,48,20-24,1922,0.011440795565102888
STAT,1887,22,na,1909,2498.665629658038
SIM,1872,60,na,1932,1822
SIM,1949,19,20-24,1968,136
STAT,1890,22,50-100,1912,0.4710089383376218
SIM,1821,35,35-39,1856,12
STAT,1916,33,15-19,1949,0.12480105848695815
SIM,1887,44,40-44,1931,7
SIM,1894,22,20-24,1916,84
SIM,1835,40,45-49,1875,2
STAT,1865,43,35-39,1908,1.5432544920135853
SIM,1936,26,35-39,1962,15
SIM,1854,41,25-29,1895,3
STAT,1888,32,50-100,1920,1.0225393419006474
STAT,1894,31,45-49,1925,2.1277881605362308
STAT,1855,82,na,1937,330.45084364357785
STAT,1870,33,50-100,1903,0.8445614022392144
SIM,1844,17,25-29,1861,8
STAT,1910,38,40-44,1948,1.3454240520023486
SIM,1903,60,na,1963,2710
STAT,1849,32,45-49,1881,1.3244916626145657
STAT,1827,40,45-49,1867,1.426133540747292
STAT,1898,15,40-44,1913,0.23498809705786214
STAT,1905,52,na,1957,2958.2215390081033
STAT,1841,33,50-100,1874,0.7527446323832372
STAT,1886,22,20-24,1908,68.78322453349672
STAT,1818,38,50-100,1856,3.756751330900694
STAT,1842,66,na,1908,1167.159751731881
STAT,1845,37,30-34,1882,3.9443514115806004
STAT,1887,78,na,1965,1127.8268153577724
STAT,1847,45,40-44,1892,0.12722286265307567
STAT,1829,44,50-100,1873,0.8620203250706335
STAT,1846,56,na,1902,1438.0897659431178
SIM,1864,27,35-39,1891,11
STAT,1920,46,50-100,1966,0.2367928635485304
STAT,1884,39,35-39,1923,6.536398345420153
SIM,1945,18,na,1963,3671
STAT,1947,21,45-49,1968,1.2017887234024185
SIM,1901,23,15-19,1924,4
STAT,1913,15,50-100,1928,0.07268447550960025
SIM,1842,34,20-24,1876,2
STAT,1850,50,40-44,1900,0.007517995863421255
SIM,1901,3,na,1904,3557
STAT,1924,21,50-100,1945,0.7357690603795229
STAT,1886,36,35-39,1922,7.093632241401119
SIM,1889,43,45-49,1932,2
SIM,1848,19,20-24,1867,12
SIM,1825,37,25-29,1862,5
STAT,1840,31,40-44,1871,3.7169320337939222
SIM,1903,31,25-29,1934,13
STAT,1819,45,35-39,1864,0.2564904158652532
STAT,1863,17,25-29,1880,5.369678585813019
SIM,1844,42,30-34,1886,1
STAT,1895,73,na,1968,1808.603536244304
STAT,1936,28,50-100,1964,0.8992928068787258
STAT,1836,31,20-24,1867,2.1801248969123628
SIM,1862,39,na,1901,2008
SIM,1871,17,25-29,1888,5
SIM,1875,25,45-49,1900,1
STAT,1892,47,15-19,1939,2.656810939578433E-4
STAT,1852,32,50-100,1884,0.7207678114396956
STAT,1920,47,45-49,1967,0.22697282476313776
STAT,1854,51,na,1905,1557.9020987109627
STAT,1899,63,na,1962,2464.1268038490293
STAT,1817,48,35-39,1865,0.30832103943003564
SIM,1919,23,30-34,1942,36
STAT,1823,34,45-49,1857,3.4664127229133435
SIM,1875,81,na,1956,538
SIM,1892,22,40-44,1914,3
STAT,1856,27,35-39,1883,7.397829327031581
STAT,1836,42,30-34,1878,0.8636695236139804
SIM,1917,15,20-24,1932,23
STAT,1883,88,na,1971,354.8223197508282
SIM,1855,32,35-39,1887,9
SIM,1892,28,25-29,1920,63
STAT,1834,45,30-34,1879,0.07164194730295396
STAT,1841,26,50-100,1867,0.5475412525542465
SIM,1890,25,40-44,1915,8
STAT,1844,104,na,1948,0.04682404112090963
SIM,1808,51,na,1859,1215
SIM,1922,28,50-100,1950,1
STAT,1825,31,45-49,1856,3.3992228234547497
STAT,1911,37,na,1948,3432.054070129745
STAT,1817,37,25-29,1854,9.984298596763137
STAT,1852,27,20-24,1879,10.381608693195464
SIM,1766,94,na,1860,5
STAT,1939,29,20-24,1968,17.31668869233837
STAT,1877,49,45-49,1926,0.22652429494192053
SIM,1892,39,35-39,1931,17
STAT,1884,28,25-29,1912,39.35105157636418
SIM,1873,28,45-49,1901,1
STAT,1892,43,50-100,1935,1.240761550707027
STAT,1894,44,15-19,1938,0.0011496450697610547
STAT,1824,53,na,1877,1243.1097626333528
STAT,1834,34,20-24,1868,2.0991579667883666
SIM,1901,34,25-29,1935,12
SIM,1853,78,na,1931,590
STAT,1858,35,45-49,1893,1.4924695952131637
STAT,1847,32,35-39,1879,8.748870404641028
STAT,1812,68,na,1880,772.8611103743173
STAT,1894,46,40-44,1940,0.11768829858497235
SIM,1908,20,20-24,1928,94
SIM,1831,34,45-49,1865,1
STAT,1884,22,40-44,1906,1.945318318432349
STAT,1831,42,25-29,1873,0.4890958606834962
SIM,1886,25,20-24,1911,11
STAT,1919,23,35-39,1942,9.710232333386221
SIM,1906,19,na,1925,3513
SIM,1848,42,45-49,1890,4
STAT,1763,93,na,1856,2.2485861144
STAT,1893,15,15-19,1908,7.146296788106211
SIM,1898,50,na,1948,2769
STAT,1833,50,35-39,1883,0.005616843647216362
STAT,1862,21,20-24,1883,57.258910249458836
STAT,1899,36,45-49,1935,2.5932162497002733
STAT,1819,47,30-34,1866,0.17212634443758254
STAT,1851,46,15-19,1897,2.941591357386384E-4
SIM,1851,27,25-29,1878,42
SIM,1853,35,35-39,1888,10
STAT,1927,42,25-29,1969,0.08461405374607081
STAT,1829,52,40-44,1881,0.007467794184443786
SIM,1838,37,35-39,1875,12
STAT,1825,94,na,1919,11.300010911413297
STAT,1843,27,25-29,1870,37.55857217844588
STAT,1832,37,20-24,1869,0.5909391196204179
SIM,1834,24,15-19,1858,1
SIM,1865,63,na,1928,1508
SIM,1857,42,40-44,1899,2
STAT,1896,43,40-44,1939,0.19360491535020138
STAT,1936,20,30-34,1956,25.97161365838401
SIM,1910,24,na,1934,3285
SIM,1894,60,na,1954,2465
STAT,1874,12,na,1886,2524.180718959518
STAT,1881,37,50-100,1918,1.119878167822099
SIM,1914,38,na,1952,3810
SIM,1851,38,35-39,1889,13
SIM,1870,21,20-24,1891,66
SIM,1907,44,na,1951,3203
STAT,1873,30,na,1903,2306.646845878792
STAT,1949,20,40-44,1969,3.7093246578343027
SIM,1825,31,40-44,1856,3
STAT,1769,90,na,1859,23.955034060674997
STAT,1890,25,45-49,1915,1.2911305266167519
STAT,1923,22,na,1945,4014.37665391214
STAT,1770,87,na,1857,38.694699766061
SIM,1861,73,na,1934,948
STAT,1841,25,na,1866,1865.0306133508434
STAT,1923,37,15-19,1960,0.021021898958418016
STAT,1816,58,na,1874,1141.338105296046
STAT,1927,31,15-19,1958,0.14943650735974984
STAT,1897,20,25-29,1917,72.75651744165124
STAT,1860,24,20-24,1884,53.76043578124861
STAT,1897,39,45-49,1936,0.5381467841451835
STAT,1821,39,40-44,1860,8.052450628754759
SIM,1853,37,30-34,1890,6
STAT,1878,25,20-24,1903,11.615598397222943
STAT,1843,38,35-39,1881,5.364930047642334
SIM,1836,21,15-19,1857,1
SIM,1880,9,na,1889,2682
STAT,1849,42,40-44,1891,1.6192613637227946
STAT,1879,46,45-49,1925,0.23369559791716485
STAT,1817,99,na,1916,0.8398603579114449
STAT,1855,40,15-19,1895,0.009879319496236723
STAT,1865,32,50-100,1897,0.7865462619670837
SIM,1869,27,40-44,1896,2
SIM,1903,20,15-19,1923,4
STAT,1853,43,15-19,1896,0.010167495651876584
STAT,1831,53,35-39,1884,0.00545899222848739
STAT,1851,21,45-49,1872,0.6150766891705988
SIM,1902,29,na,1931,3175
STAT,1850,61,na,1911,1315.5237726320522
SIM,1818,49,50-100,1867,2
STAT,1863,28,50-100,1891,0.5293393921817924
STAT,1885,9,na,1894,2442.0151153104694
SIM,1815,44,50-100,1859,1
SIM,1855,34,30-34,1889,18
STAT,1939,16,15-19,1955,42.92233851972854
STAT,1948,14,na,1962,4245.525918162248
STAT,1772,111,na,1883,0.001043198466366125
STAT,1897,28,35-39,1925,12.147693536174609
STAT,1845,35,35-39,1880,5.872992223061287
STAT,1821,37,45-49,1858,4.170164342709447
SIM,1857,68,na,1925,1225
STAT,1847,34,30-34,1881,13.443976702924848
STAT,1925,34,15-19,1959,0.14399092298623817
SIM,1947,16,15-19,1963,39
STAT,1820,63,na,1883,970.3868555966332
SIM,1852,37,na,1889,1825
STAT,1898,40,40-44,1938,0.20176101891216014
STAT,1915,27,na,1942,3609.3288833625625
STAT,1862,32,30-34,1894,14.069700817094972
STAT,1902,60,na,1962,2687.357796716165
STAT,1919,36,40-44,1955,1.5206656935183862
STAT,1880,51,35-39,1931,0.008598335122706337
SIM,1841,37,50-100,1878,1
SIM,1870,38,45-49,1908,1
SIM,1920,34,35-39,1954,10
STAT,1917,28,30-34,1945,38.68053349711117
STAT,1838,45,45-49,1883,0.1698941031060175
STAT,1855,54,35-39,1909,0.005929582039500968
STAT,1873,22,35-39,1895,5.595690431928475
SIM,1819,35,na,1854,1536
STAT,1851,49,25-29,1900,0.04135710774297436
SIM,1925,39,40-44,1964,4
STAT,1805,52,25-29,1857,0.010333471815745907
SIM,1860,32,na,1892,2021
STAT,1861,51,25-29,1912,0.002791921111106205
STAT,1936,29,na,1965,3382.899043740594
SIM,1877,22,15-19,1899,2
SIM,1872,32,40-44,1904,4
SIM,1822,41,40-44,1863,5
STAT,1870,43,20-24,1913,0.14594642277190129
SIM,1924,32,50-100,1956,5
STAT,1879,27,na,1906,2356.529609563638
SIM,1823,40,na,1863,1452
STAT,1860,21,40-44,1881,1.661158746403494
STAT,1888,49,20-24,1937,0.007396544860617042
STAT,1933,23,50-100,1956,0.8242623157512904
SIM,1843,19,15-19,1862,5
STAT,1843,30,50-100,1873,0.8113614885510475
SIM,1922,31,35-39,1953,17
STAT,1899,39,25-29,1938,0.7964394806456491
SIM,1879,38,35-39,1917,13
STAT,1917,39,40-44,1956,1.4598928185059705
SIM,1832,27,45-49,1859,5
SIM,1877,38,30-34,1915,4
STAT,1872,54,35-39,1926,0.007938649086248226
SIM,1891,12,na,1903,3179
SIM,1911,32,50-100,1943,6
SIM,1786,90,na,1876,18
STAT,1862,38,45-49,1900,1.598459127356967
STAT,1839,38,15-19,1877,0.04428180522174909
STAT,1841,27,45-49,1868,0.94353440344009
SIM,1799,81,na,1880,171
SIM,1927,23,35-39,1950,15
SIM,1936,29,45-49,1965,1
SIM,1890,70,na,1960,1778
STAT,1895,25,20-24,1920,14.56064921334671
SIM,1895,26,na,1921,2997
STAT,1938,27,50-100,1965,0.9314512608462597
SIM,1886,65,na,1951,1610
STAT,1869,38,30-34,1907,4.849389151948968
SIM,1802,94,na,1896,3
STAT,1878,16,30-34,1894,1.5713447240202345
STAT,1831,23,na,1854,1563.4232821612
STAT,1860,38,35-39,1898,5.403369571176833
STAT,1879,40,30-34,1919,1.146674068598054
STAT,1820,52,20-24,1872,0.0011695582661567037
STAT,1886,38,30-34,1924,5.2931951866019835
STAT,1912,47,40-44,1959,0.14310766924366677
STAT,1890,20,15-19,1910,3.8331972580754585
STAT,1904,67,na,1971,2494.700198459173
STAT,1947,23,40-44,1970,3.588940163773218
SIM,1934,18,30-34,1952,21
SIM,1811,55,na,1866,1153
STAT,1828,34,20-24,1862,2.7130670232000655
STAT,1891,18,45-49,1909,0.07618192337527528
STAT,1841,16,35-39,1857,0.4870648252457254
STAT,1840,99,na,1939,1.3189206390051167
STAT,1881,33,25-29,1914,9.30330353250719
SIM,1856,27,na,1883,1947
SIM,1888,20,25-29,1908,67
STAT,1883,36,50-100,1919,1.1421977735571018
SIM,1865,101,na,1966,1
STAT,1892,22,45-49,1914,0.8249361532033593
STAT,1810,45,15-19,1855,0.0014710183154354071
STAT,1832,64,na,1896,1051.113230227569
SIM,1894,38,30-34,1932,5
STAT,1860,27,25-29,1887,32.82530932795274
STAT,1903,41,30-34,1944,0.10778682294826797
STAT,1837,24,20-24,1861,56.133591540539655
STAT,1896,41,15-19,1937,0.0012027386317051986
STAT,1928,29,45-49,1957,2.008894811912935
STAT,1829,84,na,1913,203.9054527811079
STAT,1854,24,20-24,1878,57.471589222337286
STAT,1882,28,45-49,1910,1.0170535485727887
SIM,1934,29,40-44,1963,7
STAT,1879,41,15-19,1920,0.013697969673363503
STAT,1875,46,30-34,1921,0.09421481672605889
STAT,1943,18,30-34,1961,12.206062843618483
SIM,1902,13,na,1915,3458
SIM,1879,30,25-29,1909,10
SIM,1915,18,20-24,1933,29
SIM,1951,18,30-34,1969,17
STAT,1880,19,50-100,1899,0.04843669358851982
SIM,1903,54,na,1957,2854
SIM,1898,30,35-39,1928,10
SIM,1874,32,45-49,1906,3
STAT,1820,79,na,1899,372.43743150846683
SIM,1831,31,40-44,1862,3
SIM,1896,30,30-34,1926,31
STAT,1875,35,20-24,1910,0.7552433135320681
STAT,1835,19,15-19,1854,9.341023353008406
STAT,1924,18,20-24,1942,152.13361925981098
STAT,1834,31,40-44,1865,3.474397092074238
STAT,1830,24,35-39,1854,13.004837363216803
SIM,1833,31,45-49,1864,1
STAT,1870,41,25-29,1911,0.5971148080815898
STAT,1891,18,15-19,1909,6.921129139174805
SIM,1932,18,20-24,1950,149
STAT,1850,17,15-19,1867,5.105373009786921
SIM,1894,36,35-39,1930,16
STAT,1844,73,na,1917,833.8132702372246
SIM,1847,9,na,1856,2165
STAT,1873,24,30-34,1897,16.973420683964985
STAT,1913,15,40-44,1928,0.27135544122269756
STAT,1927,31,50-100,1958,0.9614688001584315
SIM,1845,24,20-24,1869,48
SIM,1823,37,45-49,1860,1
SIM,1864,7,na,1871,2504
STAT,1861,53,20-24,1914,5.695859873440317E-4
STAT,1872,43,25-29,1915,0.6044962598515115
STAT,1820,50,25-29,1870,0.005842091075139442
SIM,1888,40,50-100,1928,4
STAT,1807,81,na,1888,217.42351739714886
STAT,1862,86,na,1948,178.79622292647895
STAT,1853,10,na,1863,2156.3519542761533
SIM,1862,24,20-24,1886,54
SIM,1920,26,na,1946,3824
STAT,1782,72,na,1854,467.0
SIM,1883,22,45-49,1905,4
STAT,1853,45,40-44,1898,0.1282290300720265
STAT,1803,52,20-24,1855,0.0021150905280398254
SIM,1890,28,45-49,1918,1
STAT,1922,41,40-44,1963,0.2716250568906838
SIM,1921,15,40-44,1936,1
SIM,1892,25,20-24,1917,15
STAT,1830,26,30-34,1856,26.57014047538798
SIM,1877,36,35-39,1913,9
STAT,1959,3,na,1962,4859.924256223042
SIM,1849,57,na,1906,1508
STAT,1922,17,50-100,1939,0.40964285037999437
STAT,1854,26,50-100,1880,0.5344966235887103
SIM,1898,43,40-44,1941,2
STAT,1819,106,na,1925,0.006063401951372377
STAT,1847,48,20-24,1895,0.008718522213825443
STAT,1861,40,45-49,1901,1.1859261719840257
STAT,1843,21,40-44,1864,1.9006904028395164
STAT,1881,32,40-44,1913,3.9557098374208923
STAT,1869,36,35-39,1905,6.498869213521165
STAT,1849,48,25-29,1897,0.040995881909134384
STAT,1909,18,25-29,1927,8.005059735317182
SIM,1851,21,40-44,1872,2
SIM,1930,41,40-44,1971,1
STAT,1861,45,na,1906,1782.5433461973303
SIM,1841,53,na,1894,1494
STAT,1943,29,40-44,1972,4.684676898802413
STAT,1814,41,40-44,1855,7.328162106628937
SIM,1852,43,50-100,1895,1
STAT,1907,18,20-24,1925,24.533306924437177
SIM,1849,33,na,1882,1813
STAT,1936,32,25-29,1968,8.479468595899869
STAT,1862,37,30-34,1899,4.294775406675404
STAT,1821,34,40-44,1855,11.792874208909778
STAT,1835,41,50-100,1876,0.7999877374483347
SIM,1890,28,20-24,1918,13
STAT,1880,17,25-29,1897,5.632719140527168
STAT,1934,24,15-19,1958,6.753338664164846
SIM,1826,29,na,1855,1689
SIM,1843,41,50-100,1884,1
SIM,1870,32,30-34,1902,19
STAT,1892,1,na,1893,3219.9865209703844
STAT,1919,37,50-100,1956,0.42610762882031683
STAT,1891,43,na,1934,2683.025591154979
STAT,1857,19,20-24,1876,15.336202965265354
SIM,1919,15,25-29,1934,16
SIM,1875,39,35-39,1914,8
SIM,1847,27,35-39,1874,8
STAT,1910,23,15-19,1933,4.706513067967945
SIM,1842,37,25-29,1879,1
STAT,1867,39,35-39,1906,6.210542903873914
STAT,1897,36,40-44,1933,5.557223419739423
STAT,1858,38,25-29,1896,2.1247068163538336
STAT,1859,16,20-24,1875,15.607021745424236
STAT,1847,48,50-100,1895,0.17843908091142388
STAT,1819,82,na,1901,233.0051952369214
STAT,1915,15,45-49,1930,0.099218507288377
SIM,1919,26,35-39,1945,16
STAT,1811,86,na,1897,96.10547983302757
STAT,1815,92,na,1907,17.826001264007736
STAT,1834,37,25-29,1871,2.2168195361534537
SIM,1938,21,45-49,1959,2
SIM,1864,24,30-34,1888,18
SIM,1837,48,na,1885,1496
STAT,1838,40,15-19,1878,0.011300994611518718
STAT,1863,50,20-24,1913,6.215841631766494E-4
SIM,1942,24,15-19,1966,4
STAT,1926,29,40-44,1955,5.2413607930831905
STAT,1927,6,na,1933,4708.450023899092
STAT,1832,88,na,1920,83.00969292447505
STAT,1847,37,35-39,1884,5.399563826904062
STAT,1823,47,20-24,1870,0.014314723494741057
STAT,1872,40,50-100,1912,1.0118379338561292
SIM,1902,30,50-100,1932,1
STAT,1882,47,na,1929,2058.5243929593903
STAT,1919,20,30-34,1939,29.908884586675708
STAT,1873,86,na,1959,298.7585170550265
SIM,1847,38,45-49,1885,1
STAT,1956,16,15-19,1972,56.740608040636964
STAT,1814,51,na,1865,1197.6511374441047
STAT,1863,16,40-44,1879,0.174342156708536
STAT,1839,27,35-39,1866,8.104937051036904
SIM,1854,17,25-29,1871,5
STAT,1864,34,30-34,1898,14.615217115906935
STAT,1870,2,na,1872,3075.4222657676096
SIM,1838,34,30-34,1872,27
STAT,1940,21,35-39,1961,9.063517276513686
STAT,1874,54,45-49,1928,0.01362686727716003
STAT,1926,18,30-34,1944,14.082209389454775
STAT,1858,46,30-34,1904,0.07199357121690482
STAT,1916,52,na,1968,3499.7192925773606
STAT,1847,48,45-49,1895,0.17146426369811643
STAT,1833,89,na,1922,63.77694697893964
STAT,1890,38,20-24,1928,0.8859351461299864
STAT,1906,22,40-44,1928,2.8665063164296063
STAT,1930,15,40-44,1945,1.7163353629752902
SIM,1864,35,40-44,1899,4
STAT,1874,34,50-100,1908,0.8770898321728942
STAT,1899,49,20-24,1948,0.00858026835230558
SIM,1845,43,na,1888,1632
STAT,1890,42,na,1932,2666.257713333255
STAT,1882,28,20-24,1910,10.746177263892816
STAT,1934,35,25-29,1969,1.2857773445971754
STAT,1869,25,na,1894,2197.130266289118
STAT,1898,22,na,1920,3024.4878572722696
STAT,1791,89,na,1880,35.56998006944295
STAT,1896,46,45-49,1942,0.16668106843783514
STAT,1846,17,25-29,1863,5.019097338207196
SIM,1820,91,na,1911,21
STAT,1936,23,35-39,1959,8.499881642816161
STAT,1874,71,na,1945,1288.792081146821
SIM,1861,104,na,1965,1
STAT,1938,31,45-49,1969,1.4954190469450692
STAT,1839,38,45-49,1877,1.5720038984223843
SIM,1855,37,35-39,1892,10
STAT,1877,46,40-44,1923,0.168306767777673
STAT,1865,28,15-19,1893,0.388107636965176
STAT,1916,25,50-100,1941,0.9788022666797705
STAT,1830,27,45-49,1857,1.0803876319812613
STAT,1864,35,45-49,1899,1.6991070994404809
SIM,1888,28,35-39,1916,13
SIM,1900,7,na,1907,3394
STAT,1856,24,30-34,1880,15.087398537546429
SIM,1929,33,40-44,1962,7
STAT,1836,47,30-34,1883,0.06397177122940804
STAT,1818,84,na,1902,160.38474920500423
STAT,1893,18,25-29,1911,6.774435824960911
STAT,1848,63,na,1911,1285.4547705185303
SIM,1869,93,na,1962,41
STAT,1867,25,15-19,1892,0.40516461830792183
STAT,1908,34,15-19,1942,0.11358214158448311
SIM,1828,71,na,1899,665
SIM,1882,18,15-19,1900,8
SIM,1834,38,35-39,1872,7
SIM,1836,47,na,1883,1478
STAT,1938,20,35-39,1958,8.808590853142443
STAT,1871,17,50-100,1888,0.0461793526787517
STAT,1903,44,35-39,1947,0.16672633342956897
STAT,1858,81,na,1939,401.0469717502329
STAT,1812,45,25-29,1857,0.19581158729077838
STAT,1897,25,30-34,1922,32.03104384639508
SIM,1888,39,45-49,1927,6
STAT,1841,84,na,1925,227.60535453518705
SIM,1834,27,25-29,1861,45
STAT,1832,49,15-19,1881,2.543130969185954E-4
SIM,1908,25,20-24,1933,18
STAT,1812,42,15-19,1854,0.05187462370536844
STAT,1918,19,50-100,1937,0.3831622611620134
SIM,1872,97,na,1969,33
SIM,1919,29,45-49,1948,6
STAT,1908,45,25-29,1953,0.045974996676054564
SIM,1881,22,35-39,1903,7
SIM,1944,23,35-39,1967,13
SIM,1882,35,na,1917,2148
STAT,1903,42,na,1945,3113.2730101075595
SIM,1889,14,na,1903,3046
SIM,1886,49,na,1935,2143
STAT,1834,48,35-39,1882,0.09073388872169466
STAT,1849,45,45-49,1894,0.17180252578069363
SIM,1836,37,30-34,1873,7
STAT,1826,38,35-39,1864,7.450226805012082
STAT,1901,47,35-39,1948,0.10393636838603813
STAT,1971,0,na,1971,4738.747912102657
STAT,1861,17,20-24,1878,15.985199788074668
STAT,1936,21,15-19,1957,4.8084870276488605
SIM,1858,29,30-34,1887,23
SIM,1927,36,40-44,1963,1
STAT,1931,19,50-100,1950,0.46079163248688987
STAT,1788,69,na,1857,658.108863948544
SIM,1944,2,na,1946,4040
SIM,1864,38,45-49,1902,3
SIM,1812,96,na,1908,2
SIM,1881,20,15-19,1901,7
STAT,1832,24,45-49,1856,0.6035820918270893
STAT,1895,28,30-34,1923,30.93496491357293
SIM,1944,21,15-19,1965,4
STAT,1893,29,35-39,1922,11.48270036803502
STAT,1850,17,45-49,1867,0.05619561889581475
STAT,1877,76,na,1953,928.7558876520717
SIM,1849,35,45-49,1884,1
STAT,1914,31,35-39,1945,8.723925772641643
STAT,1810,48,25-29,1858,0.20136814172099626
SIM,1795,91,na,1886,13
SIM,1906,15,15-19,1921,11
STAT,1951,18,na,1969,4139.565458134153
SIM,1878,14,na,1892,2611
SIM,1877,34,50-100,1911,4
STAT,1828,37,30-34,1865,5.061340725764877
SIM,1870,50,na,1920,2043
STAT,1881,30,15-19,1911,0.13094042701672176
STAT,1840,34,45-49,1874,1.4487618617079818
SIM,1908,39,40-44,1947,1
STAT,1881,35,45-49,1916,1.835615953918143
SIM,1837,91,na,1928,24
STAT,1888,45,50-100,1933,0.2768246742579227
STAT,1927,30,30-34,1957,18.331561227574433
STAT,1876,19,30-34,1895,1.5460936916388135
SIM,1840,21,35-39,1861,10
SIM,1913,26,50-100,1939,1
SIM,1824,46,50-100,1870,4
SIM,1919,48,50-100,1967,1
STAT,1860,24,45-49,1884,0.5439987657627993
STAT,1864,48,20-24,1912,0.010004424016750847
STAT,1900,16,15-19,1916,7.796862404149144
STAT,1821,51,50-100,1872,0.022616254383441694
STAT,1876,28,20-24,1904,11.40088831504082
STAT,1855,51,30-34,1906,0.004235985627272182
STAT,1865,28,45-49,1893,0.9497789481615869
STAT,1886,39,45-49,1925,1.9697213068160817
STAT,1879,43,na,1922,2265.706239942235
STAT,1893,15,45-49,1908,0.07866037800782798
STAT,1905,26,50-100,1931,0.8762763973197948
SIM,1879,33,50-100,1912,4
STAT,1890,58,na,1948,2284.178513522137
SIM,1939,19,15-19,1958,38
SIM,1938,26,45-49,1964,1
STAT,1860,35,30-34,1895,4.130695550999193
STAT,1814,44,45-49,1858,4.254568574353813
STAT,1932,39,na,1971,4765.265803169939
STAT,1888,63,na,1951,1991.3016601866157
SIM,1822,44,45-49,1866,2
STAT,1864,30,15-19,1894,0.12120280861200307
SIM,1903,34,35-39,1937,10
STAT,1828,37,25-29,1865,2.7342875035071645
SIM,1965,5,na,1970,4560
SIM,1908,28,30-34,1936,47
SIM,1877,29,na,1906,2301
SIM,1895,18,25-29,1913,8
STAT,1894,42,50-100,1936,0.08904145569218942
SIM,1869,5,na,1874,2552
STAT,1908,41,50-100,1949,0.1032477567522163
SIM,1894,39,45-49,1933,4
SIM,1845,15,30-34,1860,1
STAT,1889,17,45-49,1906,0.07618380880503639
SIM,1945,16,35-39,1961,7
STAT,1789,67,na,1856,650.6258315599999
STAT,1865,35,na,1900,2041.684134213304
STAT,1871,25,35-39,1896,9.097948291427224
SIM,1884,28,20-24,1912,13
SIM,1828,27,25-29,1855,41
SIM,1839,29,20-24,1868,15
SIM,1885,43,30-34,1928,4
STAT,1804,92,na,1896,14.114116740522267
STAT,1857,40,na,1897,1738.6661203767328
SIM,1881,48,50-100,1929,2
STAT,1880,17,30-34,1897,1.5843037144962193
SIM,1851,12,na,1863,2174
STAT,1854,27,25-29,1881,31.933067859139417
STAT,1877,32,20-24,1909,2.6498543790944327
STAT,1918,41,15-19,1959,0.0015446526099372098
STAT,1838,44,30-34,1882,0.8133661080557867
STAT,1944,24,na,1968,3722.1937983676276
STAT,1837,26,40-44,1863,2.4446798600815174
SIM,1862,27,25-29,1889,40
SIM,1922,6,na,1928,4399
STAT,1877,43,30-34,1920,1.1188978075626492
STAT,1873,48,50-100,1921,0.23254872006467092
SIM,1946,20,35-39,1966,12
SIM,1837,32,na,1869,1735
STAT,1858,54,50-100,1912,0.010892635911215897
STAT,1911,18,40-44,1929,0.26366422891990765
STAT,1919,17,na,1936,3842.577186871754
SIM,1885,32,20-24,1917,2
SIM,1823,34,40-44,1857,4
STAT,1937,16,35-39,1953,3.8653245624542176
SIM,1845,26,40-44,1871,2
SIM,1924,16,na,1940,4152
STAT,1861,61,na,1922,1465.9009921178776
SIM,1846,44,30-34,1890,2
STAT,1865,75,na,1940,883.7364019739518
SIM,1914,22,40-44,1936,6
STAT,1876,78,na,1954,761.9989384428804
SIM,1886,25,na,1911,2331
SIM,1853,38,45-49,1891,2
STAT,1879,45,30-34,1924,0.09653635129978114
STAT,1877,60,na,1937,1869.6406135754594
STAT,1834,34,45-49,1868,1.3542281520516366
STAT,1808,47,25-29,1855,0.21927425791208524
STAT,1926,15,20-24,1941,157.77684987463388
SIM,1862,15,na,1877,2318
STAT,1845,15,na,1860,2067.866136014
SIM,1866,29,na,1895,2113
STAT,1875,49,35-39,1924,0.13303835026114594
STAT,1922,44,45-49,1966,0.17987519093876042
STAT,1854,27,30-34,1881,19.009652555226385
SIM,1836,37,25-29,1873,1
STAT,1849,45,20-24,1894,0.008735721981388877
SIM,1862,27,30-34,1889,27
STAT,1891,5,na,1896,3064.3302419095257
STAT,1894,49,45-49,1943,0.1583968322360688
STAT,1895,28,25-29,1923,51.9656175164353
STAT,1844,51,25-29,1895,0.0024984226443268485
STAT,1882,25,40-44,1907,2.772354143874202
SIM,1829,42,35-39,1871,2
STAT,1841,24,40-44,1865,1.7802663956369738
STAT,1881,41,30-34,1922,1.0534079063971586
SIM,1881,25,45-49,1906,4
STAT,1870,81,na,1951,500.56920469568445
STAT,1866,32,45-49,1898,1.518850008005405
SIM,1798,56,na,1854,1044
SIM,1850,73,na,1923,844
STAT,1945,26,40-44,1971,4.832966729638291
STAT,1837,28,50-100,1865,0.5145832248023254
SIM,1824,81,na,1905,273
STAT,1855,92,na,1947,29.497647234956656
SIM,1927,20,30-34,1947,37
SIM,1833,58,na,1891,1202
STAT,1881,30,20-24,1911,2.4853974267461227
STAT,1846,53,25-29,1899,0.0024572776817315812
SIM,1842,34,45-49,1876,1
STAT,1887,18,25-29,1905,5.971193279882834
STAT,1874,51,35-39,1925,0.008352089385516858
SIM,1935,30,30-34,1965,29
SIM,1875,28,25-29,1903,38
STAT,1819,48,45-49,1867,0.41343049957054795
STAT,1929,42,35-39,1971,0.24636837470574113
SIM,1883,31,50-100,1914,4
STAT,1910,39,30-34,1949,1.6296408160710338
STAT,1875,38,25-29,1913,2.7805102582879018
STAT,1900,37,na,1937,3112.0833748784685
SIM,1882,75,na,1957,945
SIM,1953,13,na,1966,4359
STAT,1803,54,40-44,1857,0.028989831081326523
STAT,1788,103,na,1891,0.042092108715507365
SIM,1844,31,20-24,1875,2
STAT,1956,16,45-49,1972,0.6245525212861021
STAT,1855,42,40-44,1897,1.5910586366295196
STAT,1903,44,40-44,1947,0.20709667542226948
STAT,1894,32,na,1926,2899.893542893526
SIM,1870,35,40-44,1905,4
STAT,1810,61,na,1871,1010.9684134734242
STAT,1835,27,20-24,1862,9.539669274640849
STAT,1865,17,35-39,1882,0.4853945597032089
SIM,1874,41,35-39,1915,3
STAT,1821,64,na,1885,954.8836109469103
STAT,1947,20,30-34,1967,30.709375694115664
SIM,1879,35,30-34,1914,5
STAT,1866,41,35-39,1907,1.584335398092228
SIM,1896,33,35-39,1929,19
SIM,1883,38,25-29,1921,3
STAT,1870,45,40-44,1915,0.16005454077751777
SIM,1843,27,20-24,1870,10
SIM,1911,44,40-44,1955,1
STAT,1921,21,25-29,1942,98.86573772087554
STAT,1828,43,na,1871,1483.1537200039907
STAT,1848,16,45-49,1864,0.05868332241937771
STAT,1888,33,35-39,1921,11.254214456724402
STAT,1836,78,na,1914,493.40303170394253
STAT,1906,3,na,1909,3636.617318804894
SIM,1934,15,20-24,1949,160
STAT,1843,37,20-24,1880,0.6492361254991247
STAT,1907,16,na,1923,3512.8016321497407
SIM,1865,19,20-24,1884,13
SIM,1849,17,na,1866,2077
STAT,1917,24,15-19,1941,5.310970493184017
SIM,1899,26,45-49,1925,2
STAT,1823,33,30-34,1856,39.96512935672037
STAT,1825,41,40-44,1866,2.569207247748362
STAT,1858,35,20-24,1893,0.5771137191399238
STAT,1853,45,35-39,1898,0.10486018838483202
SIM,1945,16,40-44,1961,1
STAT,1874,19,20-24,1893,17.025658669371573
STAT,1876,15,15-19,1891,5.814593189753053
SIM,1805,86,na,1891,56
SIM,1826,45,na,1871,1464
STAT,1915,28,20-24,1943,17.525327308087654
SIM,1820,41,30-34,1861,3
STAT,1901,47,40-44,1948,0.12709933019039246
STAT,1891,27,na,1918,2790.5776738889563
SIM,1875,36,30-34,1911,6
STAT,1886,53,na,1939,2114.680062972704
STAT,1891,25,50-100,1916,0.7530712666680225
STAT,1853,34,25-29,1887,7.6615281645151985
SIM,1934,18,25-29,1952,58
STAT,1855,42,35-39,1897,1.2809059933762874
STAT,1946,16,50-100,1962,0.39268363136348017
SIM,1775,90,na,1865,26
STAT,1908,30,20-24,1938,2.1920142557832003
SIM,1923,28,20-24,1951,19
SIM,1853,22,na,1875,1962
SIM,1875,25,20-24,1900,12
SIM,1865,42,45-49,1907,1
STAT,1791,92,na,1883,10.788260789558688
STAT,1937,16,40-44,1953,1.2884415954173043
STAT,1863,53,25-29,1916,0.002894109316459986
STAT,1874,51,40-44,1925,0.010213412139307317
SIM,1938,23,35-39,1961,11
STAT,1810,45,20-24,1855,0.044130588281797126
SIM,1780,74,na,1854,407
SIM,1784,88,na,1872,26
SIM,1869,101,na,1970,2
SIM,1880,42,40-44,1922,9
SIM,1893,75,na,1968,1622
STAT,1828,99,na,1927,1.07510380680452
STAT,1820,101,na,1921,0.30399082911803205
STAT,1817,59,na,1876,1036.5969704479585
STAT,1885,41,45-49,1926,1.4149804571531466
STAT,1892,32,40-44,1924,5.130365051788372
STAT,1919,22,20-24,1941,115.02574262415052
SIM,1831,33,30-34,1864,20
SIM,1872,32,35-39,1904,12
SIM,1817,71,na,1888,642
STAT,1842,47,na,1889,1602.4076359338028
STAT,1862,47,35-39,1909,0.11229133661782026
STAT,1855,45,45-49,1900,0.16881023568035508
STAT,1862,35,40-44,1897,3.5610590159947537
STAT,1901,5,na,1906,3465.236121466801
STAT,1921,24,35-39,1945,9.984899529906993
STAT,1819,43,15-19,1862,0.026209854082010053
STAT,1918,16,na,1934,3994.100697103841
STAT,1861,0,na,1861,3034.074542142149
SIM,1834,40,na,1874,1568
SIM,1888,36,40-44,1924,5
STAT,1868,37,50-100,1905,1.1073957757114248
SIM,1916,30,20-24,1946,2
STAT,1910,36,na,1946,3414.504087346074
SIM,1884,15,15-19,1899,6
SIM,1893,41,45-49,1934,5
STAT,1890,24,30-34,1914,20.444873456709697
STAT,1909,17,40-44,1926,0.2590553034037509
SIM,1852,77,na,1929,623
SIM,1908,28,25-29,1936,67
STAT,1886,34,15-19,1920,0.14092358815533748
SIM,1841,37,na,1878,1734
SIM,1849,39,30-34,1888,5
STAT,1877,17,na,1894,2475.8945691410518
STAT,1917,23,25-29,1940,92.45147973325143
SIM,1862,98,na,1960,4
STAT,1908,17,na,1925,3538.4522085229014
STAT,1910,34,30-34,1944,14.224073798188893
STAT,1839,24,30-34,1863,15.041844323299582
STAT,1853,46,25-29,1899,0.04283789118342506
STAT,1890,22,35-39,1912,6.740137118723338
STAT,1901,33,15-19,1934,0.18750916720640579
SIM,1927,22,20-24,1949,119
SIM,1894,22,15-19,1916,4
STAT,1810,110,na,1920,1.2513882629037613E-4
SIM,1854,63,na,1917,1364
STAT,1919,20,25-29,1939,96.12200629686718
SIM,1913,13,na,1926,3689
STAT,1908,49,40-44,1957,0.13387891760351067
STAT,1863,19,45-49,1882,0.0556658691716879
STAT,1920,44,35-39,1964,0.20940825154336107
SIM,1918,2,na,1920,4142
STAT,1823,31,35-39,1854,31.67911790884712
SIM,1900,65,na,1965,2370
STAT,1839,35,40-44,1874,3.5611928420557706
SIM,1861,34,25-29,1895,10
STAT,1812,49,40-44,1861,0.5452838803813673
STAT,1864,6,na,1870,2394.478827498735
SIM,1927,39,45-49,1966,1
STAT,1941,18,20-24,1959,131.86902037852656
STAT,1867,29,30-34,1896,22.176715075389442
STAT,1821,46,35-39,1867,0.21693598574978992
STAT,1875,35,45-49,1910,1.9531292448124342
STAT,1908,38,30-34,1946,1.6036715770760102
STAT,1817,46,15-19,1863,9.092303727079055E-4
STAT,1886,22,15-19,1908,3.2928355606270654
STAT,1808,82,na,1890,181.3537285093898
STAT,1828,26,50-100,1854,1.522090763131278
STAT,1949,23,15-19,1972,5.866504305924437
SIM,1798,96,na,1894,1
STAT,1907,18,15-19,1925,8.212420548883358
STAT,1884,37,15-19,1921,0.05242251385200566
STAT,1912,37,45-49,1949,0.6284225779178243
SIM,1925,23,25-29,1948,115
SIM,1942,20,20-24,1962,85
SIM,1875,25,na,1900,2327
SIM,1901,37,35-39,1938,5
SIM,1828,55,na,1883,1173
STAT,1855,44,30-34,1899,0.8032466656581885
SIM,1833,41,40-44,1874,7
SIM,1824,41,na,1865,1465
STAT,1865,91,na,1956,56.289010006036214
STAT,1933,39,50-100,1972,0.5390982289862063
SIM,1847,24,30-34,1871,18
STAT,1821,35,25-29,1856,6.8462766502845005
STAT,1848,101,na,1949,0.4110906643636594
SIM,1838,30,na,1868,1711
SIM,1879,36,45-49,1915,1
STAT,1870,43,15-19,1913,0.012690993969964728
STAT,1917,35,25-29,1952,0.9752527285508615
STAT,1859,51,45-49,1910,0.010993614951103278
STAT,1868,42,20-24,1910,0.14306934842143035
STAT,1930,18,45-49,1948,0.6085433858393058
SIM,1847,35,40-44,1882,1
STAT,1854,11,na,1865,2065.755530076606
STAT,1858,25,na,1883,1838.156547634738
SIM,1831,31,35-39,1862,14
SIM,1811,71,na,1882,584
SIM,1895,38,50-100,1933,4
STAT,1867,61,na,1928,1657.4806524564235
STAT,1829,44,na,1873,1558.0851485069225
STAT,1830,24,40-44,1854,4.643935839922129
SIM,1860,29,na,1889,2006
SIM,1828,37,50-100,1865,3
STAT,1873,25,45-49,1898,1.0719020409971403
SIM,1903,22,35-39,1925,10
SIM,1927,20,25-29,1947,107
SIM,1919,26,40-44,1945,8
STAT,1873,21,50-100,1894,0.39221418362118776
STAT,1938,33,40-44,1971,3.7145005751500326
SIM,1849,20,40-44,1869,2
SIM,1925,24,15-19,1949,5
SIM,1892,33,50-100,1925,1
STAT,1945,0,na,1945,4596.4085436110345
STAT,1816,41,45-49,1857,4.665438639507383
STAT,1856,23,40-44,1879,1.777796845063959
SIM,1812,56,na,1868,1115
SIM,1873,25,40-44,1898,2
SIM,1897,68,na,1965,2179
SIM,1845,25,35-39,1870,8
STAT,1845,33,15-19,1878,0.11803616563158269
STAT,1839,43,na,1882,1603.5440787605594
SIM,1860,18,30-34,1878,1
STAT,1853,66,na,1919,1215.502761330977
STAT,1870,30,45-49,1900,1.6271781955984521
STAT,1866,20,na,1886,2106.897387032582
STAT,1816,54,20-24,1870,0.0017870608934132395
STAT,1844,43,50-100,1887,0.749892773210323
STAT,1826,35,30-34,1861,6.1145697615383865
STAT,1837,29,45-49,1866,0.8867404488140134
SIM,1865,3,na,1868,2630
SIM,1891,36,50-100,1927,1
SIM,1896,27,na,1923,3015
STAT,1903,32,50-100,1935,1.2314643096892566
STAT,1883,45,20-24,1928,0.011221171738435046
STAT,1846,50,20-24,1896,5.27763371896426E-4
STAT,1894,35,25-29,1929,3.5320878359524817
SIM,1843,18,30-34,1861,3
STAT,1931,38,na,1969,4702.328570343666
STAT,1837,18,35-39,1855,0.4827841196720821
SIM,1873,39,na,1912,2230
STAT,1919,39,45-49,1958,0.690398324774611
STAT,1936,35,35-39,1971,2.2466964844673885
STAT,1882,28,15-19,1910,0.4155980190629329
SIM,1872,34,30-34,1906,19
STAT,1901,45,15-19,1946,3.013261720383462E-4
STAT,1833,37,50-100,1870,0.9344304898287533
SIM,1864,65,na,1929,1549
SIM,1853,21,15-19,1874,3
STAT,1893,26,30-34,1919,30.287009900718772
STAT,1916,44,15-19,1960,0.001481699717484593
STAT,1831,63,na,1894,1088.1847951746254
SIM,1864,23,40-44,1887,5
STAT,1877,47,25-29,1924,0.05620300884815639
STAT,1831,41,40-44,1872,1.736028976129245
STAT,1822,50,35-39,1872,0.012026690078521788
SIM,1834,35,30-34,1869,7
SIM,1874,24,na,1898,2259
STAT,1827,58,na,1885,1152.1381696050864
STAT,1861,41,50-100,1902,0.8325117991035496
SIM,1860,19,15-19,1879,5
STAT,1925,45,30-34,1970,0.10254183840559108
STAT,1805,51,40-44,1856,0.0313388937693845
SIM,1850,31,45-49,1881,2
STAT,1941,19,na,1960,3578.879253885823
STAT,1862,21,15-19,1883,2.7411360416863357
STAT,1893,15,20-24,1908,21.348430883701848
STAT,1828,35,35-39,1863,7.022431926195773
SIM,1942,28,30-34,1970,42
SIM,1860,51,na,1911,1807
SIM,1915,18,15-19,1933,9
STAT,1934,20,20-24,1954,141.62635547838664
STAT,1886,36,40-44,1922,4.390320919220085
STAT,1887,15,20-24,1902,18.81715471554255
SIM,1834,24,20-24,1858,56
SIM,1912,50,na,1962,3171
STAT,1822,52,25-29,1874,0.004755058336452069
SIM,1870,10,na,1880,2477
SIM,1896,36,45-49,1932,1
STAT,1852,19,15-19,1871,5.389301515103047
SIM,1885,64,na,1949,1643
SIM,1801,93,na,1894,7
SIM,1870,21,15-19,1891,5
STAT,1909,42,na,1951,3280.7926030187723
STAT,1888,36,45-49,1924,2.235459257988723
SIM,1881,50,na,1931,1820
SIM,1894,36,40-44,1930,7
STAT,1949,23,45-49,1972,1.2400152207387731
STAT,1856,35,40-44,1891,3.26964813135552
STAT,1948,20,50-100,1968,0.7142658511187553
SIM,1935,33,35-39,1968,13
SIM,1823,96,na,1919,5
SIM,1858,25,45-49,1883,4
SIM,1885,24,na,1909,2228
SIM,1801,53,na,1854,1120
SIM,1828,29,45-49,1857,4
STAT,1927,33,35-39,1960,10.614160413350731
STAT,1819,45,40-44,1864,0.3136511363919083
STAT,1934,28,30-34,1962,49.769951622606484
SIM,1839,74,na,1913,742
STAT,1836,46,25-29,1882,0.03855667342899679
STAT,1872,42,40-44,1914,2.1301427499785968
SIM,1851,15,na,1866,2114
STAT,1876,15,45-49,1891,0.06400211351828333
SIM,1819,35,35-39,1854,14
SIM,1876,50,na,1926,2182
STAT,1922,21,na,1943,3968.3933574765015
STAT,1871,23,15-19,1894,3.0801322432478333
STAT,1907,32,na,1939,3339.0915506375504
SIM,1910,8,na,1918,3650
SIM,1870,33,20-24,1903,2
STAT,1785,77,na,1862,326.5016871873694
STAT,1842,44,20-24,1886,0.11404669836346369
SIM,1831,75,na,1906,576
STAT,1863,25,na,1888,2010.5694429518808
SIM,1794,66,na,1860,770
SIM,1872,14,na,1886,2431
STAT,1878,26,35-39,1904,9.521827689025663
SIM,1935,31,50-100,1966,1
SIM,1838,35,45-49,1873,1
STAT,1926,18,25-29,1944,50.06687142314505
SIM,1905,18,na,1923,3442
SIM,1870,44,30-34,1914,5
STAT,1842,26,na,1868,1918.8260292348448
STAT,1846,19,45-49,1865,0.05717746966561656
STAT,1885,12,na,1897,2430.6042847015283
SIM,1886,26,35-39,1912,10
SIM,1867,16,20-24,1883,16
SIM,1839,95,na,1934,8
STAT,1817,45,30-34,1862,0.2235443628401018
STAT,1847,35,45-49,1882,1.5537901916131602
STAT,1855,76,na,1931,670.9861249944398
STAT,1836,45,40-44,1881,0.11607665833335676
SIM,1842,78,na,1920,522
STAT,1843,29,15-19,1872,0.3970693488496156
STAT,1894,46,35-39,1940,0.09624043130778336
SIM,1824,41,45-49,1865,1
STAT,1933,24,na,1957,4572.956846500404
SIM,1811,53,50-100,1864,1
STAT,1894,47,25-29,1941,0.03929988421756807
STAT,1899,20,35-39,1919,7.599766697199123
STAT,1841,27,15-19,1868,0.385555932170629
STAT,1869,65,na,1934,1545.3639034091032
SIM,1835,81,na,1916,319
STAT,1827,44,25-29,1871,0.5704219813315816
SIM,1853,35,40-44,1888,6
STAT,1826,29,15-19,1855,0.8550641224962082
SIM,1910,24,25-29,1934,82
SIM,1954,3,na,1957,4439
STAT,1883,32,45-49,1915,1.614547616234128
STAT,1865,25,40-44,1890,2.5889724355175465
STAT,1867,25,45-49,1892,0.9915208781199989
STAT,1921,37,40-44,1958,1.579197626520246
STAT,1852,18,30-34,1870,1.4560052279086717
SIM,1861,42,30-34,1903,3
STAT,1862,34,20-24,1896,2.159577888152468
SIM,1848,32,na,1880,1916
SIM,1918,33,35-39,1951,11
STAT,1858,47,15-19,1905,2.952685912994092E-4
SIM,1905,5,na,1910,3575
STAT,1902,24,25-29,1926,75.83912441199763
STAT,1892,47,20-24,1939,0.007970439829799577
SIM,1891,32,45-49,1923,4
STAT,1807,97,na,1904,1.9271029177427086
STAT,1867,36,30-34,1903,4.750090996962033
STAT,1876,75,na,1951,1003.9884476645433
STAT,1897,26,45-49,1923,1.4075879768086883
STAT,1865,51,na,1916,1857.2194577919922
STAT,1851,31,40-44,1882,3.34455233604929
STAT,1839,32,50-100,1871,0.7518161368600781
SIM,1892,36,30-34,1928,5
STAT,1825,48,50-100,1873,0.2540030534219229
SIM,1833,48,50-100,1881,1
SIM,1838,22,30-34,1860,18
STAT,1853,31,20-24,1884,2.085879775963731
SIM,1825,34,20-24,1859,3
SIM,1889,40,40-44,1929,7
STAT,1898,43,45-49,1941,0.13194808286205092
STAT,1912,20,15-19,1932,4.8470007506562505
STAT,1863,51,35-39,1914,0.0071832853204771355
STAT,1809,45,na,1854,1362.9539713227434
STAT,1850,53,45-49,1903,0.010052731861976699
SIM,1884,39,na,1923,2292
SIM,1893,40,50-100,1933,2
STAT,1908,33,25-29,1941,8.20511591010715
SIM,1881,34,35-39,1915,10
STAT,1853,4,na,1857,2377.8303432833277
STAT,1897,47,50-100,1944,0.17421610719706976
STAT,1806,56,na,1862,1046.3079554707406
STAT,1887,38,na,1925,2476.73584261917
STAT,1833,33,na,1866,1676.114628818677
STAT,1912,31,25-29,1943,8.624796467357223
STAT,1921,39,na,1960,3960.359963617628
STAT,1901,49,30-34,1950,0.07069367473006626
STAT,1947,23,35-39,1970,10.050436686689885
STAT,1904,24,35-39,1928,7.856550061214502
STAT,1892,68,na,1960,1932.6655015910876
STAT,1888,30,30-34,1918,19.64184690812198
SIM,1838,33,40-44,1871,3
SIM,1907,0,na,1907,3857
STAT,1862,44,30-34,1906,0.9139408727349396
STAT,1939,16,45-49,1955,0.4724527224451487
STAT,1932,27,15-19,1959,0.8735308790117724
STAT,1942,25,50-100,1967,0.9877070001099186
STAT,1885,40,50-100,1925,1.004343665194046
STAT,1840,33,30-34,1873,14.656882585979222
SIM,1848,88,na,1936,78
STAT,1884,36,30-34,1920,4.999319288780836
STAT,1838,42,35-39,1880,1.4443552337584156
STAT,1873,34,35-39,1907,9.627786840063488
STAT,1884,25,20-24,1909,11.026076193524224
SIM,1800,68,na,1868,745
STAT,1843,51,na,1894,1560.846928239827
STAT,1906,20,45-49,1926,0.9649652562874298
SIM,1818,96,na,1914,4
STAT,1836,44,20-24,1880,0.11628751263397255
STAT,1880,80,na,1960,784.9882098178891
SIM,1872,76,na,1948,826
SIM,1861,31,20-24,1892,4
STAT,1929,25,50-100,1954,1.1813449885039622
STAT,1864,10,na,1874,2319.985814077238
SIM,1862,36,na,1898,2044
SIM,1920,34,40-44,1954,5
STAT,1875,52,50-100,1927,0.014579761683075777
STAT,1831,50,30-34,1881,0.004005592140421052
STAT,1897,39,15-19,1936,0.015159066144901322
SIM,1831,78,na,1909,413
STAT,1910,35,15-19,1945,0.017509846593713248
STAT,1930,35,na,1965,4644.158834972135
STAT,1845,17,50-100,1862,0.04361631988050427
STAT,1903,47,45-49,1950,0.1780884449170542
SIM,1942,23,25-29,1965,96
STAT,1917,53,na,1970,3547.81344482261
SIM,1920,20,15-19,1940,5
STAT,1937,7,na,1944,3673.158538680949
STAT,1864,46,50-100,1910,0.20795146453202404
STAT,1899,23,na,1922,3052.3627498540977
STAT,1910,7,na,1917,3728.420973372689
STAT,1849,52,50-100,1901,0.010827971974043992
STAT,1892,35,45-49,1927,2.3807054423958736
SIM,1872,46,50-100,1918,3
STAT,1853,42,30-34,1895,0.8515532726594718
STAT,1875,47,15-19,1922,3.864050045582862E-4
SIM,1906,28,20-24,1934,14
STAT,1825,44,45-49,1869,1.5995509636312717
SIM,1938,20,30-34,1958,29
STAT,1928,26,40-44,1954,5.443924772936961
SIM,1920,31,25-29,1951,13
STAT,1878,61,na,1939,1837.7143710853725
STAT,1799,69,na,1868,703.1860818718313
STAT,1821,48,na,1869,1384.8752601249619
SIM,1814,43,35-39,1857,2
SIM,1842,31,40-44,1873,6
STAT,1929,19,na,1948,4414.074622365123
SIM,1816,86,na,1902,63
SIM,1874,40,na,1914,2244
SIM,1899,23,40-44,1922,2
SIM,1833,44,45-49,1877,2
STAT,1913,18,45-49,1931,0.09621170927884477
SIM,1836,35,35-39,1871,12
SIM,1841,18,20-24,1859,18
STAT,1855,14,na,1869,1992.7358861279745
STAT,1942,20,na,1962,3619.433663479219
SIM,1887,50,na,1937,2266
STAT,1905,41,35-39,1946,0.17244042270038573
STAT,1920,30,50-100,1950,0.8624569581567656
STAT,1877,45,20-24,1922,0.011881084262260396
SIM,1884,61,na,1945,1805
STAT,1821,43,30-34,1864,1.8616471047835834
STAT,1868,45,25-29,1913,0.05247183453292531
STAT,1895,26,35-39,1921,11.936018111902131
SIM,1886,28,25-29,1914,53
STAT,1954,2,na,1956,4595.644671456428
STAT,1845,106,na,1951,0.00855237986192055
STAT,1929,16,na,1945,4448.773526168472
SIM,1906,19,30-34,1925,4
SIM,1840,33,35-39,1873,7
STAT,1845,21,15-19,1866,2.9056744753254033
SIM,1861,14,na,1875,2355
SIM,1819,37,25-29,1856,2
SIM,1936,26,40-44,1962,5
STAT,1761,115,na,1876,1.163583407900415E-4
STAT,1840,46,45-49,1886,0.16787529057608824
SIM,1916,22,15-19,1938,5
STAT,1789,102,na,1891,0.06468675697423909
STAT,1792,74,na,1866,406.3381825793789
STAT,1897,2,na,1899,3367.8357283605333
SIM,1912,24,35-39,1936,9
STAT,1810,107,na,1917,0.0021356047057107252
STAT,1823,49,50-100,1872,0.28464829162452465
SIM,1851,24,20-24,1875,61
SIM,1914,54,na,1968,3620
STAT,1888,60,na,1948,2128.4318831373093
STAT,1842,31,45-49,1873,1.5157804295327726
STAT,1877,23,50-100,1900,0.3985285910038977
SIM,1901,34,30-34,1935,20
STAT,1876,51,45-49,1927,0.014221028344607563
STAT,1892,22,50-100,1914,0.4824188214244377
SIM,1863,42,40-44,1905,5
SIM,1903,14,na,1917,3441
SIM,1869,23,25-29,1892,58
STAT,1881,34,30-34,1915,15.789425938347712
SIM,1925,28,30-34,1953,52
SIM,1927,4,na,1931,4641
SIM,1887,49,50-100,1936,2
STAT,1920,41,30-34,1961,0.1335874854317366
STAT,1908,22,15-19,1930,4.622034576133611
STAT,1917,20,20-24,1937,112.30451841371105
SIM,1816,41,40-44,1857,8
STAT,1778,109,na,1887,0.0027816523642411814
SIM,1850,40,35-39,1890,2
SIM,1896,24,na,1920,2969
SIM,1858,22,40-44,1880,2
STAT,1821,100,na,1921,0.573286921852753
STAT,1843,24,20-24,1867,61.51245000703229
SIM,1829,96,na,1925,2
SIM,1813,102,na,1915,1
SIM,1905,32,40-44,1937,7
SIM,1851,35,30-34,1886,8
SIM,1879,33,40-44,1912,3
STAT,1834,74,na,1908,686.9107233628656
SIM,1916,33,25-29,1949,11
STAT,1875,32,40-44,1907,4.2089482557436515
SIM,1883,32,40-44,1915,3
STAT,1816,108,na,1924,8.53576963050064E-4
SIM,1774,89,na,1863,22
STAT,1894,16,50-100,1910,0.05968214496755517
STAT,1895,24,15-19,1919,4.041575767085269
STAT,1814,43,30-34,1857,3.419850752813415
STAT,1867,38,20-24,1905,0.6803519674730117
SIM,1840,52,na,1892,1473
STAT,1832,48,na,1880,1436.7459813470034
SIM,1875,38,20-24,1913,3
STAT,1906,37,15-19,1943,0.016673026718135718
STAT,1856,38,15-19,1894,0.041342342555669966
SIM,1935,16,na,1951,4772
STAT,1812,44,35-39,1856,6.2390383077989275
STAT,1864,32,35-39,1896,8.550390837804173
SIM,1925,20,20-24,1945,112
SIM,1822,43,30-34,1865,2
SIM,1926,42,na,1968,4193
STAT,1834,46,15-19,1880,2.9227225502082824E-4
STAT,1843,35,30-34,1878,4.582953186919182
STAT,1879,22,50-100,1901,0.4026653322291251
STAT,1897,24,40-44,1921,2.61623484630483
STAT,1842,40,35-39,1882,1.3687578075335107
STAT,1828,33,15-19,1861,0.14797706340899636
STAT,1872,51,30-34,1923,0.005671226606746649
STAT,1880,83,na,1963,621.1729869282068
SIM,1862,25,35-39,1887,16
SIM,1838,33,na,1871,1664
SIM,1828,26,40-44,1854,7
STAT,1821,33,20-24,1854,8.494193316304836
STAT,1877,79,na,1956,722.7922243287353
SIM,1899,16,na,1915,3271
STAT,1880,43,na,1923,2280.7729992909435
STAT,1827,52,50-100,1879,0.012773616079605612
SIM,1900,19,20-24,1919,23
SIM,1815,45,na,1860,1309
STAT,1887,17,40-44,1904,0.19323644519202257
SIM,1859,32,na,1891,1967
STAT,1879,43,35-39,1922,1.775139105113975
STAT,1877,44,20-24,1921,0.15358562774768084
SIM,1866,38,25-29,1904,5
SIM,1764,90,na,1854,10
STAT,1860,36,15-19,1896,0.04332071423749109
STAT,1826,37,20-24,1863,0.8354170500335294
STAT,1922,24,na,1946,3931.680438270628
SIM,1827,70,na,1897,756
STAT,1868,53,30-34,1921,0.005282856869248561
SIM,1929,31,45-49,1960,2
STAT,1931,31,35-39,1962,11.318831821259995
SIM,1929,20,35-39,1949,12
STAT,1893,28,20-24,1921,14.012008903892735
SIM,1891,41,35-39,1932,3
SIM,1856,29,20-24,1885,8
SIM,1827,30,na,1857,1651
STAT,1809,48,na,1857,1311.621172331357
STAT,1854,25,35-39,1879,8.120492156151245
STAT,1908,22,45-49,1930,0.9769690647629072
STAT,1857,51,35-39,1908,0.006442280599650283
SIM,1906,48,50-100,1954,1
SIM,1845,22,30-34,1867,19
SIM,1870,36,25-29,1906,5
STAT,1866,76,na,1942,825.1781946646984
STAT,1948,19,15-19,1967,49.03538026382046
STAT,1863,28,na,1891,1974.8253748009267
STAT,1843,29,na,1872,1893.2413163848812
STAT,1899,36,20-24,1935,1.0027545480314188
STAT,1832,33,35-39,1865,7.928718506147785
STAT,1883,41,35-39,1924,1.684159019536346
STAT,1943,23,na,1966,3669.0163615339366
SIM,1916,22,45-49,1938,2
SIM,1858,39,50-100,1897,3
STAT,1831,44,45-49,1875,1.1100755578082897
SIM,1855,48,50-100,1903,2
SIM,1887,43,35-39,1930,4
SIM,1944,20,30-34,1964,39
SIM,1885,7,na,1892,2476
SIM,1849,73,na,1922,832
STAT,1851,34,15-19,1885,0.10645880170100144
STAT,1830,29,35-39,1859,8.465674420820028
STAT,1779,92,na,1871,10.657946274958704
STAT,1899,47,30-34,1946,0.07036055691723138
STAT,1910,37,35-39,1947,2.1846961842253223
STAT,1810,45,50-100,1855,0.9032060044071585
STAT,1878,28,25-29,1906,41.45500208749749
STAT,1882,17,35-39,1899,0.5044009185074326
STAT,1934,36,50-100,1970,0.5478295781988923
SIM,1866,103,na,1969,3
STAT,1869,23,20-24,1892,62.82140015651884
SIM,1888,75,na,1963,1398
SIM,1838,32,40-44,1870,5
SIM,1860,88,na,1948,128
STAT,1816,50,35-39,1866,0.02258611609326542
STAT,1852,25,na,1877,1942.1496872391274
STAT,1912,34,40-44,1946,3.605736957918919
STAT,1846,52,40-44,1898,0.007383240554251415
SIM,1888,25,30-34,1913,43
SIM,1864,62,na,1926,1663
STAT,1848,29,20-24,1877,9.945262464800017
STAT,1934,23,25-29,1957,117.22689984581277
SIM,1886,23,30-34,1909,22
STAT,1932,37,50-100,1969,0.5329296714064344
STAT,1827,41,20-24,1868,0.14869176432151873
STAT,1908,57,na,1965,3000.207429269351
SIM,1760,94,na,1854,2
STAT,1805,54,45-49,1859,0.04066526779896041
STAT,1897,23,40-44,1920,2.624581013929126
STAT,1923,22,40-44,1945,3.696198606285077
SIM,1860,27,20-24,1887,10
STAT,1788,66,na,1854,736.0
SIM,1843,63,na,1906,1260
STAT,1835,50,45-49,1885,0.009600684651301247
STAT,1875,13,na,1888,2516.35893885206
SIM,1929,31,na,1960,4627
STAT,1858,49,35-39,1907,0.10166029375139865
STAT,1831,26,na,1857,1753.5644789933278
STAT,1829,54,30-34,1883,0.0040583420665287985
STAT,1881,47,45-49,1928,0.2142623976651974
SIM,1847,47,na,1894,1597
SIM,1931,22,40-44,1953,5
SIM,1827,35,50-100,1862,3
SIM,1879,34,40-44,1913,5
STAT,1818,81,na,1899,260.7152867090042
STAT,1819,85,na,1904,136.89916780619137
STAT,1896,45,30-34,1941,0.06885359553687963
SIM,1846,42,35-39,1888,4
STAT,1851,34,45-49,1885,1.3036180981788699
STAT,1856,38,45-49,1894,1.4676529861864505
STAT,1909,15,20-24,1924,25.226523491394882
STAT,1847,21,50-100,1868,0.3704891846253457
STAT,1878,19,35-39,1897,0.5367354704024616
STAT,1862,15,50-100,1877,0.04575329494116765
SIM,1806,71,na,1877,582
STAT,1836,54,30-34,1890,0.003655666486182294
SIM,1910,28,40-44,1938,5
STAT,1943,25,25-29,1968,66.27717466166159
STAT,1891,15,40-44,1906,0.21486344630649903
STAT,1894,32,20-24,1926,3.2848117569925175
STAT,1843,88,na,1931,99.04398577259981
SIM,1879,23,30-34,1902,21
STAT,1838,58,na,1896,1348.7695734619736
STAT,1869,34,15-19,1903,0.1291079009109673
STAT,1820,54,40-44,1874,0.016033899318911804
SIM,1826,48,na,1874,1405
STAT,1822,89,na,1911,54.263604849672376
STAT,1880,15,35-39,1895,0.5479501054098259
SIM,1875,65,na,1940,1598
STAT,1859,19,25-29,1878,4.900980826063147
SIM,1796,92,na,1888,11
STAT,1932,3,na,1935,5073.902356987521
SIM,1918,30,30-34,1948,18
SIM,1928,16,35-39,1944,9
STAT,1888,45,35-39,1933,0.15779908189652786
STAT,1836,48,45-49,1884,0.15397881077734216
STAT,1872,40,20-24,1912,0.1521063589694273
STAT,1914,47,20-24,1961,0.010352065002399373
SIM,1896,64,na,1960,2321
STAT,1878,23,30-34,1901,17.463405634363617
STAT,1837,27,25-29,1864,34.274322503326225
STAT,1954,16,40-44,1970,1.6339085191743712
STAT,1827,52,30-34,1879,0.0050345522789086985
STAT,1871,27,30-34,1898,23.583943316101458
SIM,1910,17,30-34,1927,2
STAT,1902,28,40-44,1930,3.9794732510633417
STAT,1836,43,20-24,1879,0.11778694038507456
STAT,1857,42,45-49,1899,1.1132516498314609
STAT,1873,38,20-24,1911,0.7355071170195585
SIM,1832,24,40-44,1856,5
STAT,1902,17,30-34,1919,2.124864104644619
SIM,1867,19,25-29,1886,8
SIM,1902,69,na,1971,2326
STAT,1872,45,45-49,1917,0.22600669226021616
SIM,1845,27,25-29,1872,42
STAT,1863,108,na,1971,0.02592906934388102
STAT,1898,44,50-100,1942,0.09255117924892114
STAT,1894,43,30-34,1937,0.09631666660686738
STAT,1846,16,40-44,1862,0.1629595218203597
SIM,1846,28,na,1874,1826
SIM,1857,30,40-44,1887,7
SIM,1905,40,na,1945,3189
SIM,1851,39,25-29,1890,1
SIM,1953,4,na,1957,4372
STAT,1831,41,35-39,1872,1.3976165736477753
STAT,1844,18,35-39,1862,0.48676974386809846
STAT,1939,28,15-19,1967,0.6700479223314777
SIM,1836,28,35-39,1864,9
SIM,1881,31,30-34,1912,22
STAT,1809,61,na,1870,1013.0063073562844
SIM,1908,32,20-24,1940,2
STAT,1871,1,na,1872,3288.2071400326813
SIM,1951,17,40-44,1968,1
STAT,1850,29,15-19,1879,0.3705007059616233
STAT,1948,17,na,1965,3979.621612303835
SIM,1827,33,na,1860,1567
STAT,1805,71,na,1876,620.459032211539
STAT,1828,35,40-44,1863,4.346254322212599
STAT,1943,17,40-44,1960,1.401144158121931
STAT,1852,15,20-24,1867,16.484645907464028
SIM,1855,22,30-34,1877,20
STAT,1876,52,20-24,1928,7.158287457825536E-4
STAT,1926,7,na,1933,4630.401266929139
SIM,1838,36,45-49,1874,1
SIM,1887,43,50-100,1930,4
SIM,1897,29,20-24,1926,16
STAT,1861,15,30-34,1876,1.4542168335480408
SIM,1884,79,na,1963,806
SIM,1909,30,na,1939,3411
SIM,1876,37,50-100,1913,1
SIM,1928,40,35-39,1968,3
STAT,1897,27,45-49,1924,1.4027740259280024
SIM,1808,88,na,1896,46
STAT,1750,122,na,1872,2.221776061043542E-4
STAT,1834,39,15-19,1873,0.04234720836887578
STAT,1819,35,30-34,1854,16.19194856526314
STAT,1863,49,50-100,1912,0.19969126421948616
STAT,1916,48,30-34,1964,0.08613508283063318
STAT,1827,98,na,1925,1.802775736626006
SIM,1829,34,na,1863,1584
STAT,1873,33,na,1906,2278.5971088131464
STAT,1889,29,20-24,1918,13.584274953421412
SIM,1880,89,na,1969,267
STAT,1873,31,30-34,1904,16.810687905695254
STAT,1864,48,15-19,1912,3.33480507217545E-4
STAT,1879,24,na,1903,2320.705327964487
SIM,1934,31,na,1965,4818
STAT,1834,46,20-24,1880,0.008768175363403866
STAT,1841,22,na,1863,1853.1891114394743
SIM,1862,25,40-44,1887,2
STAT,1828,28,35-39,1856,14.035298030310877
STAT,1877,23,na,1900,2311.333145653995
SIM,1853,25,30-34,1878,29
SIM,1838,70,na,1908,869
SIM,1843,18,25-29,1861,2
STAT,1874,15,40-44,1889,0.17808129821255578
STAT,1843,11,na,1854,2211.0
SIM,1965,2,na,1967,4562
STAT,1836,47,25-29,1883,0.03806584697624568
SIM,1880,55,na,1935,2156
STAT,1834,44,50-100,1878,0.7684032582626649
STAT,1895,19,35-39,1914,0.6728208601598468
STAT,1861,48,na,1909,1742.7709486773279
SIM,1812,43,30-34,1855,2
SIM,1899,37,30-34,1936,1
STAT,1780,86,na,1866,57.435606409529356
STAT,1837,28,45-49,1865,0.8931532894321359
SIM,1845,28,45-49,1873,3
STAT,1771,112,na,1883,5.303022377355488E-4
STAT,1854,23,15-19,1877,2.7712148715047578
STAT,1766,114,na,1880,2.7900700492607307E-4
STAT,1896,48,35-39,1944,0.09735976456440375
STAT,1845,25,30-34,1870,21.90329982420984
STAT,1900,27,30-34,1927,33.003134065023815
STAT,1911,6,na,1917,3775.7407501746525
SIM,1816,83,na,1899,139
SIM,1855,88,na,1943,103
STAT,1823,38,50-100,1861,1.8458284489065435
STAT,1918,45,30-34,1963,0.0900379746663758
SIM,1860,15,20-24,1875,15
STAT,1923,25,15-19,1948,0.7709473933210143
SIM,1892,74,na,1966,1580
SIM,1842,38,na,1880,1700
STAT,1835,93,na,1928,18.23459320332276
STAT,1820,40,20-24,1860,0.3045387792667741
STAT,1855,30,na,1885,1756.954473638791
SIM,1842,16,na,1858,2037
STAT,1932,38,30-34,1970,2.3110878987684647
STAT,1854,25,40-44,1879,2.5210522911758027
STAT,1910,30,15-19,1940,0.11795908884367712
SIM,1797,71,na,1868,605
SIM,1881,2,na,1883,2507
STAT,1840,52,50-100,1892,0.01046181539735968
STAT,1917,27,40-44,1944,4.617575090551872
STAT,1856,20,15-19,1876,2.87606159184506
STAT,1823,47,15-19,1870,4.7715703010112046E-4
SIM,1827,35,30-34,1862,3
STAT,1822,43,na,1865,1405.7567498250078
STAT,1947,22,35-39,1969,10.053754425650347
SIM,1917,25,25-29,1942,64
SIM,1921,7,na,1928,4214
STAT,1913,47,na,1960,3386.6921219425276
SIM,1834,80,na,1914,347
SIM,1838,30,50-100,1868,4
SIM,1933,22,15-19,1955,6
SIM,1922,12,na,1934,4360
STAT,1916,46,50-100,1962,0.21969515923236632
SIM,1935,30,25-29,1965,14
STAT,1886,26,30-34,1912,25.22091786240464
STAT,1792,71,na,1863,539.9819595501222
STAT,1866,41,40-44,1907,1.9679590317226257
STAT,1919,24,40-44,1943,3.456429076230517
SIM,1874,41,40-44,1915,4
SIM,1914,17,na,1931,4076
STAT,1825,44,15-19,1869,0.014759410158545679
STAT,1890,38,15-19,1928,0.06453833002344789
SIM,1826,85,na,1911,136
SIM,1841,17,20-24,1858,20
SIM,1877,29,35-39,1906,10
STAT,1812,42,50-100,1854,3.968408423475074
STAT,1841,15,45-49,1856,0.058327445679361975
SIM,1894,26,30-34,1920,37
STAT,1865,52,45-49,1917,0.012391785969183148
SIM,1917,28,50-100,1945,5
STAT,1859,20,na,1879,1864.58166645175
SIM,1910,27,na,1937,3333
SIM,1916,18,na,1934,3770
SIM,1934,22,20-24,1956,132
SIM,1915,17,15-19,1932,8
SIM,1810,49,50-100,1859,2
STAT,1871,34,30-34,1905,16.21178655921149
STAT,1852,87,na,1939,133.85728759218213
SIM,1943,14,na,1957,3859
STAT,1847,22,30-34,1869,16.066772134692833
STAT,1849,30,40-44,1879,3.6956076910828424
STAT,1943,15,15-19,1958,45.4862265050648
STAT,1956,12,na,1968,4909.80216084869
STAT,1858,28,50-100,1886,0.48216930859134777
SIM,1869,28,30-34,1897,27
STAT,1843,39,25-29,1882,2.1613596579823664
STAT,1845,47,35-39,1892,0.0981536479877403
STAT,1885,74,na,1959,1162.91309338808
STAT,1925,22,15-19,1947,6.020155990158014
SIM,1898,53,na,1951,2677
STAT,1851,33,45-49,1884,1.3172250327673558
STAT,1930,19,na,1949,4471.588371171283
SIM,1840,30,30-34,1870,19
SIM,1864,20,15-19,1884,3
STAT,1885,19,35-39,1904,0.5136641919458497
STAT,1892,35,15-19,1927,0.06706213311323864
STAT,1945,25,35-39,1970,15.57387715877451
SIM,1826,28,35-39,1854,8
STAT,1826,33,na,1859,1581.7438087081753
STAT,1808,49,15-19,1857,0.0014729567191850083
SIM,1927,24,40-44,1951,4
STAT,1860,36,20-24,1896,0.5946751842587678
SIM,1930,41,na,1971,4556
SIM,1843,25,30-34,1868,25
SIM,1882,45,50-100,1927,2
STAT,1784,76,na,1860,292.7570144648638
STAT,1839,83,na,1922,264.699854209336
SIM,1817,49,na,1866,1370
STAT,1877,48,25-29,1925,0.05575675695790204
STAT,1899,24,45-49,1923,0.8971104553322636
SIM,1872,37,35-39,1909,15
STAT,1860,82,na,1942,358.22317445015585
SIM,1865,104,na,1969,1
STAT,1927,30,25-29,1957,10.7540645750125
STAT,1835,25,30-34,1860,20.774425988549925
SIM,1919,27,50-100,1946,1
SIM,1833,43,45-49,1876,4
SIM,1936,19,40-44,1955,4
STAT,1860,60,na,1920,1464.2556432814051
SIM,1856,25,40-44,1881,2
SIM,1951,15,15-19,1966,49
SIM,1880,42,35-39,1922,3
STAT,1820,60,na,1880,1085.2379672171744
STAT,1925,46,15-19,1971,4.227898129316429E-4
STAT,1832,30,30-34,1862,14.128122800549129
SIM,1833,55,na,1888,1263
SIM,1879,15,na,1894,2515
STAT,1892,34,45-49,1926,2.0452913044794347
SIM,1877,36,40-44,1913,8
STAT,1896,12,na,1908,3224.3458232793278
STAT,1880,18,45-49,1898,0.06476034907799094
STAT,1880,27,35-39,1907,9.591019656290921
STAT,1830,36,35-39,1866,5.68986287178088
SIM,1839,25,40-44,1864,5
STAT,1850,41,45-49,1891,1.0584056165035751
STAT,1875,47,20-24,1922,0.011592160333598818
STAT,1777,107,na,1884,0.007507399131955006
SIM,1927,35,35-39,1962,4
STAT,1849,31,50-100,1880,0.7727288293452438
STAT,1879,52,30-34,1931,0.005846448117047209
STAT,1912,35,40-44,1947,1.3930604251305259
STAT,1858,47,20-24,1905,0.008858065530831677
STAT,1926,22,20-24,1948,127.63180172200127
SIM,1920,35,40-44,1955,3
STAT,1898,16,40-44,1914,0.234475823006276
STAT,1914,35,45-49,1949,0.649003033509495
SIM,1867,29,35-39,1896,10
SIM,1919,19,40-44,1938,1
STAT,1885,58,na,1943,1861.2739315352787
STAT,1920,40,25-29,1960,0.07471580563099521
STAT,1816,55,na,1871,1211.2051219812247
SIM,1875,42,50-100,1917,1
STAT,1863,18,45-49,1881,0.055995683748969315
SIM,1821,36,35-39,1857,10
SIM,1929,22,25-29,1951,121
STAT,1825,43,45-49,1868,1.635097262889493
STAT,1869,36,40-44,1905,4.0222160507381695
SIM,1946,22,25-29,1968,102
STAT,1827,80,na,1907,343.2895934574116
STAT,1842,63,na,1905,1270.625510632998
STAT,1872,42,35-39,1914,1.7149038711575597
SIM,1893,16,30-34,1909,1
STAT,1924,17,15-19,1941,51.0598613157347
SIM,1898,31,40-44,1929,5
STAT,1844,44,25-29,1888,0.4500146260528235
STAT,1860,29,15-19,1889,0.34702927839512837
STAT,1860,37,50-100,1897,0.94261138340024
STAT,1865,28,20-24,1893,10.03535453249306
STAT,1814,46,35-39,1860,0.38602147802178916
STAT,1868,80,na,1948,557.9596469799665
STAT,1897,21,15-19,1918,4.180621321995836
SIM,1892,2,na,1894,3207
STAT,1848,25,40-44,1873,2.6137318277644312
STAT,1907,17,15-19,1924,8.233993612147183
SIM,1905,58,na,1963,2808
SIM,1925,27,40-44,1952,6
STAT,1876,26,30-34,1902,24.643062935729453
STAT,1848,28,20-24,1876,10.017185859269574
STAT,1864,44,40-44,1908,1.8734536826156136
SIM,1889,70,na,1959,1733
STAT,1824,39,15-19,1863,0.0764042571543872
STAT,1870,53,25-29,1923,0.0032260896900334446
STAT,1858,36,20-24,1894,0.5744359114831147
SIM,1868,20,15-19,1888,3
STAT,1787,104,na,1891,0.024864864317025996
STAT,1855,36,na,1891,1676.6207251491442
SIM,1862,23,15-19,1885,2
STAT,1919,35,35-39,1954,2.4684592755501353
SIM,1836,22,20-24,1858,54
STAT,1881,37,35-39,1918,6.451522722055957
SIM,1830,90,na,1920,38
STAT,1821,36,25-29,1857,6.4086864776093115
SIM,1872,44,40-44,1916,6
STAT,1843,46,50-100,1889,0.1786374309809368
STAT,1906,38,20-24,1944,0.22773993537833084
STAT,1871,18,35-39,1889,0.5141624857265756
STAT,1940,25,45-49,1965,1.665540256619002
SIM,1879,37,45-49,1916,3
STAT,1864,72,na,1936,1066.2757618966502
STAT,1908,46,15-19,1954,3.170164942594526E-4
STAT,1823,43,40-44,1866,2.832752039877702
STAT,1901,22,na,1923,3127.2729171030214
SIM,1901,37,40-44,1938,3
STAT,1885,45,25-29,1930,0.054752400345570544
SIM,1928,3,na,1931,4822
STAT,1919,22,15-19,1941,5.50658766391341
STAT,1844,107,na,1951,0.0033106428361569496
STAT,1880,37,na,1917,2341.8375907097616
SIM,1884,45,na,1929,2232
STAT,1888,42,30-34,1930,1.2814617890872069
STAT,1805,51,35-39,1856,0.0256276001041576
STAT,1866,45,15-19,1911,3.5186867251131495E-4
STAT,1869,48,35-39,1917,0.12641256108631838
STAT,1790,70,na,1860,618.8434698596922
SIM,1858,39,35-39,1897,11
SIM,1917,43,na,1960,3604
STAT,1886,48,35-39,1934,0.13798157642168354
SIM,1877,26,30-34,1903,34
STAT,1873,27,50-100,1900,0.6134063583559599
STAT,1814,48,na,1862,1250.9153126812007
STAT,1870,31,20-24,1901,2.5123643365081927
STAT,1901,35,50-100,1936,0.35373054010111793
STAT,1858,23,45-49,1881,0.5360822000215495
STAT,1815,95,na,1910,5.690507057937707
STAT,1818,54,25-29,1872,0.006973646286994239
STAT,1890,34,40-44,1924,4.966139438480299
STAT,1923,38,20-24,1961,0.2882818449033209
STAT,1938,22,25-29,1960,86.35198650790583
SIM,1932,17,15-19,1949,51
STAT,1918,19,40-44,1937,1.4304727895267229
SIM,1856,28,20-24,1884,13
SIM,1836,35,40-44,1871,3
STAT,1848,66,na,1914,1180.7814798819343
SIM,1888,21,15-19,1909,3
STAT,1841,51,45-49,1892,0.009976779257170543
SIM,1884,26,30-34,1910,38
STAT,1867,26,20-24,1893,10.441512922471366
STAT,1928,19,40-44,1947,1.6561823886379363
STAT,1890,27,35-39,1917,11.144773006517946
STAT,1895,26,40-44,1921,3.705603703555414
STAT,1798,90,na,1888,30.824592838937857
STAT,1917,37,na,1954,3691.397684813528
STAT,1932,26,50-100,1958,1.2321787396409676
SIM,1904,39,na,1943,3129
STAT,1811,106,na,1917,0.005259162615574659
STAT,1861,41,20-24,1902,0.12514883493064766
STAT,1838,51,30-34,1889,0.004119031508221835
SIM,1835,68,na,1903,933
STAT,1796,61,na,1857,992.6569164166461
SIM,1831,43,40-44,1874,8
STAT,1854,18,35-39,1872,0.4698765516742388
SIM,1873,43,50-100,1916,3
STAT,1903,40,25-29,1943,0.06053882161099719
STAT,1884,37,20-24,1921,0.7196180541564111
SIM,1847,32,50-100,1879,6
STAT,1853,7,na,1860,2208.0754069080317
SIM,1876,18,20-24,1894,17
STAT,1840,36,35-39,1876,5.8867084846678095
STAT,1868,18,20-24,1886,16.184363012206916
STAT,1824,51,45-49,1875,0.01675040662039012
SIM,1927,22,15-19,1949,6
STAT,1879,40,na,1919,2305.220431694363
STAT,1835,54,25-29,1889,0.002164752115424601
STAT,1857,15,40-44,1872,0.16200494977815103
STAT,1873,89,na,1962,196.9029342981287
STAT,1875,23,45-49,1898,0.6746858590397405
STAT,1897,43,na,1940,2908.973707677188
STAT,1865,38,na,1903,2012.4449473873722
STAT,1817,46,20-24,1863,0.02727693517493763
STAT,1913,27,40-44,1940,4.386439121221785
SIM,1766,91,na,1857,15
SIM,1868,36,30-34,1904,5
SIM,1863,42,35-39,1905,2
STAT,1839,38,20-24,1877,0.6078683406554932
SIM,1921,27,40-44,1948,7
STAT,1891,42,45-49,1933,1.7478768501943525
SIM,1853,28,35-39,1881,10
STAT,1867,55,na,1922,1834.0629291308855
SIM,1953,15,25-29,1968,51
SIM,1883,20,40-44,1903,2
STAT,1932,28,20-24,1960,22.57617078160708
STAT,1899,21,40-44,1920,2.7058716667157676
STAT,1861,18,35-39,1879,0.49183784954984244
STAT,1810,104,na,1914,0.03020490204080306
STAT,1908,48,40-44,1956,0.13429388571035566
SIM,1872,20,na,1892,2211
STAT,1846,53,na,1899,1493.7638801232777
STAT,1906,25,15-19,1931,0.6283515410794293
SIM,1852,15,30-34,1867,1
STAT,1836,54,50-100,1890,0.00927512073023809
SIM,1949,0,na,1949,4490
STAT,1851,30,40-44,1881,3.379462180372537
STAT,1849,42,na,1891,1663.8694021939432
STAT,1869,29,35-39,1898,8.760273158947662
STAT,1850,39,na,1889,1650.2486526536934
STAT,1845,35,40-44,1880,3.6348544353393155
SIM,1911,34,30-34,1945,23
STAT,1881,32,35-39,1913,9.237342271877582
STAT,1803,54,na,1857,1079.731775990303
STAT,1841,47,50-100,1888,0.16879923158987517
SIM,1825,60,na,1885,1042
SIM,1940,28,20-24,1968,18
SIM,1890,33,na,1923,2817
STAT,1859,52,20-24,1911,5.533738778496016E-4
STAT,1902,57,na,1959,2759.156221474437
STAT,1819,54,30-34,1873,0.00976896676701942
SIM,1894,23,na,1917,3001
SIM,1897,12,na,1909,3309
STAT,1814,41,35-39,1855,5.899648540105761
STAT,1823,36,35-39,1859,11.986159992318992
STAT,1925,41,15-19,1966,0.0017591634963786715
STAT,1859,15,15-19,1874,5.255338347454138
STAT,1856,23,50-100,1879,0.3479054744433316
STAT,1876,19,25-29,1895,5.496869981594071
STAT,1810,49,30-34,1859,0.3327453861798674
STAT,1845,28,35-39,1873,8.21318669689239
SIM,1859,94,na,1953,20
SIM,1787,93,na,1880,5
SIM,1785,92,na,1877,8
SIM,1814,66,na,1880,793
SIM,1949,17,25-29,1966,59
SIM,1874,77,na,1951,788
STAT,1873,22,40-44,1895,1.9981816473492775
SIM,1899,13,na,1912,3339
SIM,1926,19,40-44,1945,2
STAT,1845,52,na,1897,1508.5772457931107
SIM,1860,35,na,1895,2006
STAT,1929,43,40-44,1972,0.30553935548258093
SIM,1831,36,35-39,1867,16
STAT,1851,46,20-24,1897,0.008824781834731106
STAT,1866,30,40-44,1896,3.807594449411655
STAT,1945,15,25-29,1960,44.74382307576098
SIM,1904,27,40-44,1931,8
STAT,1909,19,30-34,1928,2.24537542734494
SIM,1822,41,35-39,1863,4
SIM,1877,51,na,1928,2133
SIM,1934,37,na,1971,4836
SIM,1882,38,na,1920,2138
SIM,1930,25,na,1955,4434
SIM,1856,83,na,1939,267
STAT,1895,38,35-39,1933,8.676247380861987
STAT,1883,45,15-19,1928,3.7403872893062456E-4
STAT,1904,33,25-29,1937,7.934500757268376
STAT,1845,44,30-34,1889,0.8037776122937498
STAT,1828,47,50-100,1875,0.20687094274400605
STAT,1829,28,na,1857,1738.9726201291573
STAT,1773,110,na,1883,0.0013677852656103374
SIM,1915,42,na,1957,3501
STAT,1822,49,na,1871,1312.1072951812466
STAT,1866,44,45-49,1910,1.2859616095183353
STAT,1941,28,30-34,1969,38.26998167671134
STAT,1873,8,na,1881,2587.6274213332626
STAT,1923,44,15-19,1967,0.0016901375262831613
SIM,1912,33,25-29,1945,11
STAT,1828,47,35-39,1875,0.11792317618933881
STAT,1844,15,30-34,1859,1.4392319668824551
SIM,1874,44,45-49,1918,3
SIM,1917,19,30-34,1936,15
STAT,1935,10,na,1945,5132.316420607331
STAT,1817,39,15-19,1856,0.16377349521847287
SIM,1849,37,50-100,1886,3
SIM,1819,97,na,1916,1
STAT,1914,42,na,1956,3475.929891059377
SIM,1914,21,35-39,1935,15
STAT,1887,18,30-34,1905,1.679505662767318
STAT,1889,26,40-44,1915,3.5056315762619756
SIM,1842,32,na,1874,1782
STAT,1901,22,50-100,1923,0.5392159376423743
STAT,1886,29,35-39,1915,9.561995184408806
SIM,1836,69,na,1905,915
SIM,1875,26,20-24,1901,9
SIM,1827,38,35-39,1865,13
SIM,1828,27,30-34,1855,23
SIM,1845,23,15-19,1868,3
SIM,1932,27,50-100,1959,2
SIM,1933,36,na,1969,4861
STAT,1915,38,30-34,1953,1.7305512157810872
STAT,1825,49,15-19,1874,4.080300638490859E-4
STAT,1884,27,na,1911,2227.9142359921198
STAT,1921,30,50-100,1951,0.876268224020278
STAT,1806,96,na,1902,2.8571975466742208
STAT,1852,25,30-34,1877,22.607907594049735
STAT,1777,82,na,1859,145.39500274883906
STAT,1822,51,35-39,1873,0.011789727294030857
STAT,1903,34,30-34,1937,13.35906641566569
SIM,1832,79,na,1911,396
SIM,1838,41,50-100,1879,1
SIM,1866,20,40-44,1886,1
STAT,1837,23,15-19,1860,2.7066981402988044
STAT,1843,36,20-24,1879,0.6560127370730899
STAT,1882,16,45-49,1898,0.0601951954972958
SIM,1860,25,30-34,1885,29
SIM,1943,9,na,1952,3872
STAT,1842,47,25-29,1889,0.04102453830339645
STAT,1910,37,50-100,1947,0.3792273026759967
STAT,1923,25,na,1948,4091.044292532555
STAT,1924,0,na,1924,5068.64331801538
SIM,1936,22,25-29,1958,77
SIM,1865,66,na,1931,1390
SIM,1804,98,na,1902,1
SIM,1918,47,na,1965,3659
STAT,1804,52,na,1856,1174.396343134731
STAT,1885,16,30-34,1901,1.5038013368615375
STAT,1927,15,na,1942,4344.036262656042
STAT,1928,22,25-29,1950,108.96028489110941
STAT,1928,38,40-44,1966,1.7856187402986756
SIM,1917,22,20-24,1939,107
STAT,1841,109,na,1950,4.8677477869433046E-4
STAT,1926,15,15-19,1941,52.81513201784776
STAT,1911,40,15-19,1951,0.0014000407620565947
STAT,1840,29,50-100,1869,0.5475162435858524
SIM,1864,36,50-100,1900,3
SIM,1877,23,20-24,1900,63
SIM,1897,26,40-44,1923,5
STAT,1842,44,15-19,1886,0.009917104741149993
STAT,1850,35,50-100,1885,0.8964458681096332
SIM,1862,37,35-39,1899,13
SIM,1906,22,45-49,1928,1
SIM,1859,72,na,1931,1034
STAT,1875,6,na,1881,2641.691217763398
SIM,1867,15,15-19,1882,6
SIM,1810,76,na,1886,379
STAT,1854,22,30-34,1876,15.070712834935033
SIM,1885,80,na,1965,822
STAT,1838,25,50-100,1863,0.5630440938220018
STAT,1864,50,na,1914,1844.0672588358225
SIM,1851,30,50-100,1881,3
STAT,1909,22,20-24,1931,97.60442051308551
STAT,1864,37,35-39,1901,5.971743727683725
STAT,1889,42,50-100,1931,1.2305933313848243
STAT,1837,57,na,1894,1268.5950554864246
STAT,1862,24,na,1886,1923.0772659268775
STAT,1759,108,na,1867,0.002045064086439778
STAT,1825,38,na,1863,1599.6427082483042
STAT,1871,37,35-39,1908,6.624098289593622
STAT,1819,38,35-39,1857,16.907958382799407
STAT,1871,25,40-44,1896,2.824509025321494
SIM,1852,93,na,1945,18
SIM,1894,29,35-39,1923,13
STAT,1906,21,35-39,1927,8.051574489971086
SIM,1862,22,30-34,1884,20
SIM,1895,18,30-34,1913,2
STAT,1827,53,20-24,1880,6.1186000898577E-4
STAT,1867,19,50-100,1886,0.043903101086117016
STAT,1813,66,na,1879,823.9430652696124
STAT,1877,20,15-19,1897,3.2533856842652775
STAT,1816,46,50-100,1862,0.6570861355045632
STAT,1948,9,na,1957,4248.711507442543
STAT,1871,15,30-34,1886,1.5202240791489117
STAT,1912,16,na,1928,3697.728408960756
SIM,1864,37,45-49,1901,2
SIM,1877,69,na,1946,1395
STAT,1890,25,50-100,1915,0.7438746717818083
SIM,1901,27,30-34,1928,36
STAT,1867,22,40-44,1889,1.8559538227693189
STAT,1910,49,35-39,1959,0.11293929724472773
STAT,1923,48,30-34,1971,0.09825211822858795
SIM,1858,29,25-29,1887,38
STAT,1814,104,na,1918,0.027520166834868603
SIM,1854,17,30-34,1871,1
STAT,1898,19,45-49,1917,0.08308819129888614
STAT,1881,84,na,1965,536.3925668197013
STAT,1812,81,na,1893,232.58191104787903
SIM,1820,35,na,1855,1527
STAT,1852,65,na,1917,1283.986786591494
STAT,1830,33,30-34,1863,14.372081880250803
STAT,1900,17,20-24,1917,23.234827584352097
SIM,1833,40,40-44,1873,6
STAT,1854,37,35-39,1891,5.09316991493792
STAT,1909,43,50-100,1952,0.10315615682089636
STAT,1939,18,na,1957,3479.0764048740407
SIM,1900,43,na,1943,2997
SIM,1862,52,na,1914,1863
STAT,1899,48,20-24,1947,0.008653127687433773
STAT,1930,23,25-29,1953,111.44735064769239
STAT,1888,33,40-44,1921,4.819395614953255
SIM,1758,96,na,1854,1
STAT,1894,44,20-24,1938,0.013220917588178883
SIM,1934,15,15-19,1949,54
STAT,1915,28,50-100,1943,0.9556207673629834
SIM,1896,33,40-44,1929,9
STAT,1846,17,30-34,1863,1.4117115300720542
SIM,1868,39,35-39,1907,13
SIM,1922,32,40-44,1954,11
STAT,1828,32,30-34,1860,18.80147689665183
STAT,1862,37,25-29,1899,2.320166011559678
STAT,1890,37,45-49,1927,2.3025309971089967
STAT,1926,25,25-29,1951,75.0536813043927
STAT,1840,62,na,1902,1272.8625022825793
STAT,1838,54,40-44,1892,0.006982813484454597
STAT,1870,34,25-29,1904,9.400091524897325
STAT,1848,104,na,1952,0.04805227921450984
SIM,1887,10,na,1897,2709
SIM,1927,25,25-29,1952,93
STAT,1878,24,15-19,1902,3.224122792504287
SIM,1927,21,na,1948,4163
SIM,1886,24,15-19,1910,2
STAT,1818,51,20-24,1869,0.0015425735989414331
STAT,1823,46,45-49,1869,0.2856126531907623
STAT,1874,49,na,1923,2126.9364043423598
STAT,1858,20,40-44,1878,1.7988842510280234
SIM,1875,22,40-44,1897,3
SIM,1889,76,na,1965,1360
SIM,1923,38,30-34,1961,3
STAT,1840,31,35-39,1871,8.679750236646912
SIM,1882,18,20-24,1900,18
SIM,1944,24,40-44,1968,5
SIM,1923,19,30-34,1942,14
SIM,1935,19,na,1954,4725
SIM,1896,23,30-34,1919,32
STAT,1895,23,30-34,1918,21.891125606851553
STAT,1936,24,40-44,1960,3.0341855401458973
STAT,1850,21,na,1871,1819.7420813400488
SIM,1867,26,30-34,1893,28
STAT,1888,23,30-34,1911,19.81726371408954
STAT,1914,32,40-44,1946,3.7206444299539125
STAT,1885,42,20-24,1927,0.14928752371016765
SIM,1926,15,25-29,1941,58
SIM,1934,25,25-29,1959,84
STAT,1907,44,50-100,1951,0.10041367409631181
STAT,1940,22,40-44,1962,3.2354501414657593
STAT,1797,65,na,1862,800.0285064741283
SIM,1826,51,na,1877,1329
SIM,1920,20,50-100,1940,4
SIM,1921,11,na,1932,4190
STAT,1858,39,25-29,1897,2.113807070385937
STAT,1915,19,30-34,1934,2.3968131641239894
STAT,1901,37,30-34,1938,1.5210829360847213
STAT,1838,54,35-39,1892,0.005710244685035558
STAT,1838,107,na,1945,0.0032163951487736895
SIM,1855,32,40-44,1887,5
STAT,1918,15,25-29,1933,8.98118378925773
SIM,1871,72,na,1943,1119
STAT,1853,43,20-24,1896,0.11692619368129538
STAT,1886,45,30-34,1931,0.09758166216799977
STAT,1844,41,20-24,1885,0.11565481040369703
SIM,1942,10,na,1952,3736
STAT,1902,29,30-34,1931,33.33126343235839
SIM,1819,38,45-49,1857,1
SIM,1829,32,30-34,1861,18
STAT,1794,100,na,1894,0.19075305106327103
STAT,1919,25,25-29,1944,67.64070797588614
STAT,1846,21,50-100,1867,0.357327777421828
STAT,1871,20,na,1891,2228.1865632713398
STAT,1889,48,na,1937,2591.43831403129
SIM,1836,32,30-34,1868,20
SIM,1864,26,45-49,1890,2
SIM,1884,22,15-19,1906,3
STAT,1864,47,45-49,1911,0.19832839229741775
STAT,1904,64,na,1968,2629.3306284922496
STAT,1952,15,25-29,1967,49.08726385915955
STAT,1902,16,40-44,1918,0.24443574175521213
SIM,1835,84,na,1919,176
STAT,1817,49,25-29,1866,0.12486263451347386
STAT,1934,38,40-44,1972,1.9495316065827017
STAT,1857,18,45-49,1875,0.05684253978010056
STAT,1847,32,40-44,1879,3.746531383958841
SIM,1868,55,na,1923,1851
SIM,1910,29,30-34,1939,31
STAT,1857,77,na,1934,643.7567220377852
SIM,1834,25,20-24,1859,9
SIM,1848,54,na,1902,1532
STAT,1833,50,40-44,1883,0.006868597358470524
SIM,1901,28,na,1929,3214
STAT,1829,52,35-39,1881,0.006106841052763742
SIM,1937,26,na,1963,3302
SIM,1811,52,na,1863,1210
SIM,1885,27,na,1912,2277
STAT,1904,28,45-49,1932,1.498969320631568
SIM,1912,28,45-49,1940,6
STAT,1918,19,na,1937,3764.330015821857
STAT,1955,1,na,1956,4937.675014012315
SIM,1904,19,20-24,1923,30
SIM,1902,46,50-100,1948,2
STAT,1800,96,na,1896,3.422706127221101
STAT,1825,40,40-44,1865,2.626729400084171
STAT,1878,29,45-49,1907,1.0841261777259537
SIM,1891,49,na,1940,2675
SIM,1901,10,na,1911,3499
STAT,1823,90,na,1913,41.4889099706338
STAT,1856,26,45-49,1882,0.8574252440877512
SIM,1920,38,45-49,1958,3
SIM,1929,32,35-39,1961,12
STAT,1883,48,25-29,1931,0.0526598525515187
SIM,1889,54,na,1943,2440
STAT,1892,31,40-44,1923,5.151330968831517
STAT,1893,16,20-24,1909,21.30189130437539
STAT,1896,43,35-39,1939,0.1558645864520243
STAT,1912,38,45-49,1950,0.6253056019313519
SIM,1893,78,na,1971,1392
SIM,1807,87,na,1894,65
SIM,1873,28,20-24,1901,9
STAT,1825,54,na,1879,1296.5304343942744
SIM,1894,35,20-24,1929,1
SIM,1936,15,25-29,1951,41
STAT,1784,106,na,1890,0.010813642870388676
SIM,1934,19,30-34,1953,15
SIM,1888,24,40-44,1912,4
STAT,1852,31,na,1883,1896.793926908344
STAT,1869,33,30-34,1902,15.898432286240338
SIM,1945,15,35-39,1960,3
SIM,1943,3,na,1946,3926
STAT,1906,44,15-19,1950,0.0013013790354985386
SIM,1947,23,45-49,1970,1
STAT,1866,33,45-49,1899,1.5124404609716218
SIM,1887,44,na,1931,2376
SIM,1831,43,35-39,1874,1
STAT,1919,32,25-29,1951,9.420225074553379
STAT,1851,37,25-29,1888,2.133972854484468
STAT,1832,33,40-44,1865,3.3953174917415816
SIM,1872,25,35-39,1897,8
STAT,1888,31,15-19,1919,0.15957789224795946
STAT,1936,8,na,1944,3606.6594278368593
SIM,1870,35,35-39,1905,15
STAT,1864,25,35-39,1889,8.233769918932396
SIM,1820,54,na,1874,1164
SIM,1813,81,na,1894,210
STAT,1915,27,15-19,1942,0.6801692906003832
STAT,1856,38,20-24,1894,0.567517540043356
STAT,1914,28,50-100,1942,0.9444147579490292
STAT,1851,86,na,1937,162.70545248568328
SIM,1849,32,40-44,1881,4
SIM,1857,12,na,1869,2279
STAT,1880,50,20-24,1930,7.44031275873754E-4
STAT,1878,28,30-34,1906,24.67802936553649
SIM,1782,87,na,1869,49
STAT,1895,35,30-34,1930,6.6327013141337705
STAT,1879,43,50-100,1922,1.0356388263570784
SIM,1886,16,30-34,1902,1
STAT,1954,18,50-100,1972,0.43739140804653803
STAT,1840,46,na,1886,1600.3926854112617
STAT,1943,26,15-19,1969,0.7105551636198111
STAT,1845,38,50-100,1883,0.8992502847987497
STAT,1814,50,30-34,1864,0.016077321349956413
STAT,1844,17,20-24,1861,15.820481513659832
SIM,1840,21,40-44,1861,2
SIM,1868,33,20-24,1901,2
STAT,1873,27,35-39,1900,9.252437833252774
STAT,1874,34,na,1908,2284.332134227192
SIM,1877,33,30-34,1910,25
SIM,1886,28,30-34,1914,31
SIM,1779,80,na,1859,188
STAT,1905,45,45-49,1950,0.18354629253158106
STAT,1920,34,30-34,1954,16.164100081066646
SIM,1944,22,15-19,1966,4
STAT,1870,43,50-100,1913,0.9708609677580639
SIM,1875,59,na,1934,1873
STAT,1909,29,40-44,1938,4.176995932725583
SIM,1875,29,25-29,1904,42
SIM,1906,1,na,1907,3761
SIM,1840,33,40-44,1873,2
SIM,1923,15,15-19,1938,40
STAT,1901,21,15-19,1922,4.375426466995857
STAT,1910,33,25-29,1943,8.380980824131308
STAT,1902,19,45-49,1921,0.08661756001469965
SIM,1819,37,30-34,1856,5
SIM,1837,94,na,1931,11
SIM,1852,17,20-24,1869,13
STAT,1847,37,50-100,1884,0.9372754163663249
STAT,1833,31,50-100,1864,0.7261557921619971
STAT,1925,34,50-100,1959,0.9264321175815475
STAT,1928,22,30-34,1950,33.90358473453661
SIM,1862,61,na,1923,1603
STAT,1862,49,na,1911,1775.152613140229
SIM,1831,38,50-100,1869,3
SIM,1794,72,na,1866,524
STAT,1812,42,20-24,1854,0.5965581403911134
STAT,1869,45,30-34,1914,0.08939996302128232
STAT,1783,97,na,1880,0.7794628480814739
SIM,1936,22,30-34,1958,19
STAT,1836,94,na,1930,12.620988827535566
STAT,1845,38,45-49,1883,1.4601132591930301
STAT,1849,67,na,1916,1142.6104750552206
SIM,1827,32,20-24,1859,1
STAT,1929,36,50-100,1965,0.5097059542077438
SIM,1884,29,35-39,1913,9
STAT,1838,35,35-39,1873,5.943052847019944
STAT,1835,21,15-19,1856,2.7559189628471366
SIM,1868,52,na,1920,1924
SIM,1881,27,35-39,1908,6
STAT,1932,34,15-19,1966,0.16117579277886526
SIM,1918,34,40-44,1952,7
STAT,1888,45,40-44,1933,0.19296573398846725
STAT,1855,32,30-34,1887,12.590746409175654
STAT,1824,39,20-24,1863,1.0488219435246058
STAT,1837,27,30-34,1864,20.403393912167864
STAT,1919,44,25-29,1963,0.0728618162944031
STAT,1871,27,25-29,1898,39.61711873014276
STAT,1871,28,45-49,1899,1.036186857125222
STAT,1889,29,45-49,1918,1.2856604452810658
STAT,1903,30,15-19,1933,0.19293912634542634
STAT,1926,11,na,1937,4596.645055492923
STAT,1870,50,20-24,1920,6.92885458371379E-4
STAT,1916,45,20-24,1961,0.010758066920598395
STAT,1847,48,15-19,1895,2.9061715149076623E-4
SIM,1894,23,20-24,1917,81
SIM,1843,21,15-19,1864,6
STAT,1889,19,50-100,1908,0.05683143799207184
STAT,1923,21,35-39,1944,10.382052269572394
STAT,1886,23,20-24,1909,68.57068436968818
SIM,1931,21,35-39,1952,14
STAT,1937,15,35-39,1952,3.873769379701966
SIM,1871,51,50-100,1922,1
SIM,1917,29,40-44,1946,4
SIM,1845,27,30-34,1872,30
SIM,1937,32,25-29,1969,4
STAT,1815,49,15-19,1864,9.417970235183679E-4
SIM,1847,23,40-44,1870,1
STAT,1823,43,35-39,1866,2.2805501834393733
STAT,1869,26,30-34,1895,23.10627913244524
STAT,1805,50,50-100,1855,0.04587376863372262
STAT,1868,54,20-24,1922,6.472831533595717E-4
SIM,1862,34,30-34,1896,19
STAT,1926,19,30-34,1945,14.043483313633779
SIM,1869,45,50-100,1914,1
SIM,1846,35,35-39,1881,9
SIM,1906,4,na,1910,3695
SIM,1922,9,na,1931,4377
SIM,1927,32,25-29,1959,10
STAT,1862,46,na,1908,1818.1542753050624
STAT,1882,63,na,1945,1640.2218051071604
STAT,1870,59,na,1929,1799.0054708276207
STAT,1857,54,45-49,1911,0.010510915130516737
SIM,1897,29,45-49,1926,1
SIM,1914,29,30-34,1943,56
STAT,1886,35,20-24,1921,0.7767100044305889
STAT,1899,25,50-100,1924,0.8337728549316579
STAT,1825,32,50-100,1857,1.6094904850237939
STAT,1917,36,15-19,1953,0.01893263196036917
SIM,1829,42,40-44,1871,4
SIM,1845,27,na,1872,1837
SIM,1863,32,30-34,1895,14
STAT,1838,47,35-39,1885,0.09823499314637885
STAT,1933,2,na,1935,5172.1023971620825
SIM,1877,38,25-29,1915,2
STAT,1890,34,35-39,1924,11.596889470796494
STAT,1847,30,15-19,1877,0.1256090479688831
STAT,1903,21,50-100,1924,0.5497385019909603
STAT,1863,15,40-44,1878,0.17537511614261594
STAT,1869,38,25-29,1907,2.6197849297753915
STAT,1871,43,50-100,1914,0.9822657983364569
STAT,1787,87,na,1874,55.47798071950599
STAT,1891,18,20-24,1909,20.67577816118154
SIM,1846,46,50-100,1892,3
STAT,1840,40,30-34,1880,0.9416150930537239
STAT,1819,44,20-24,1863,0.2915932259397464
STAT,1910,46,30-34,1956,0.07874515788542111
STAT,1939,23,45-49,1962,1.0670238021478835
SIM,1807,72,na,1879,487
SIM,1834,21,40-44,1855,4
SIM,1966,4,na,1970,4541
STAT,1970,1,na,1971,4655.721991175436
SIM,1870,22,20-24,1892,60
SIM,1819,75,na,1894,462
STAT,1888,38,35-39,1926,7.854300664256682
SIM,1854,57,na,1911,1585
STAT,1841,27,20-24,1868,9.96937473762023
STAT,1857,96,na,1953,6.394919860755816
STAT,1839,23,40-44,1862,1.7724290450309792
SIM,1821,33,30-34,1854,22
SIM,1858,26,20-24,1884,14
STAT,1833,41,45-49,1874,1.1178706996196357
SIM,1853,22,20-24,1875,72
SIM,1903,35,40-44,1938,1
STAT,1884,73,na,1957,1170.073910284171
SIM,1857,15,na,1872,2206
STAT,1893,19,25-29,1912,6.75580612644227
STAT,1799,75,na,1874,421.7523847089263
STAT,1925,44,25-29,1969,0.08141152399200734
SIM,1843,28,35-39,1871,9
STAT,1882,44,na,1926,2095.929103365102
STAT,1800,62,na,1862,906.5367036946283
STAT,1916,32,15-19,1948,0.12532995087967033
SIM,1857,31,na,1888,1923
STAT,1935,28,na,1963,4821.511378999282
STAT,1845,34,20-24,1879,2.217315996878742
SIM,1779,83,na,1862,109
SIM,1832,54,na,1886,1308
STAT,1929,32,25-29,1961,11.091535099821257
STAT,1815,79,na,1894,299.21792278806646
STAT,1920,11,na,1931,4206.053742661903
SIM,1914,33,35-39,1947,12
STAT,1862,22,20-24,1884,56.84779127386772
SIM,1792,62,na,1854,832
STAT,1861,20,50-100,1881,0.33341853735369525
STAT,1865,29,na,1894,2034.0561150533642
STAT,1896,40,30-34,1936,0.10068274592250648
STAT,1879,36,35-39,1915,7.017644082229203
SIM,1896,38,35-39,1934,14
SIM,1860,28,35-39,1888,11
SIM,1869,24,15-19,1893,3
STAT,1902,38,na,1940,3149.9487289432846
SIM,1867,28,20-24,1895,8
STAT,1841,39,15-19,1880,0.044336493403992074
STAT,1866,45,20-24,1911,0.010556069460809654
STAT,1900,23,15-19,1923,4.310306211281832
SIM,1853,34,20-24,1887,2
STAT,1821,34,35-39,1855,27.538626419556177
STAT,1850,29,20-24,1879,9.580089605908661
STAT,1871,22,30-34,1893,16.681977134127617
STAT,1886,59,na,1945,1939.818505261975
SIM,1882,1,na,1883,2919
STAT,1870,75,na,1945,952.9416374159407
SIM,1912,37,40-44,1949,1
STAT,1850,50,35-39,1900,0.006147893827723166
SIM,1907,18,25-29,1925,6
STAT,1895,36,na,1931,2918.42741964921
STAT,1852,28,35-39,1880,8.477396893904784
STAT,1832,37,15-19,1869,0.04304855055409728
STAT,1842,43,45-49,1885,1.088624338696664
SIM,1844,64,na,1908,1213
STAT,1836,32,20-24,1868,2.1576042067272567
SIM,1850,43,45-49,1893,5
SIM,1903,23,40-44,1926,5
SIM,1906,59,na,1965,2896
SIM,1905,31,35-39,1936,11
STAT,1871,24,20-24,1895,64.13551616890896
STAT,1915,15,15-19,1930,9.014003211185432
STAT,1945,19,40-44,1964,1.4424488509100364
SIM,1864,16,na,1880,2366
SIM,1908,29,30-34,1937,42
STAT,1832,26,35-39,1858,8.031524685222394
STAT,1936,22,15-19,1958,4.806900226929739
STAT,1793,75,na,1868,404.1348148530117
SIM,1891,3,na,1894,3239
STAT,1830,84,na,1914,198.71684871318195
STAT,1877,14,na,1891,2523.4815370241345
SIM,1881,22,40-44,1903,1
STAT,1837,25,40-44,1862,2.4623596020240512
STAT,1883,44,45-49,1927,1.3669857064707875
STAT,1907,23,50-100,1930,0.5640474437904762
STAT,1897,39,20-24,1936,0.2080926090804944
STAT,1851,83,na,1934,291.1170886527194
SIM,1780,77,na,1857,326
STAT,1859,28,20-24,1887,8.932695528312358
STAT,1922,43,50-100,1965,0.1271933109459
SIM,1887,36,35-39,1923,13
STAT,1850,17,20-24,1867,15.251494034833682
STAT,1892,35,20-24,1927,0.920580075094599
SIM,1822,61,na,1883,1048
STAT,1856,15,na,1871,2032.0957259821205
STAT,1864,44,35-39,1908,1.508252427112776
STAT,1807,51,45-49,1858,0.052427532717515525
STAT,1945,22,25-29,1967,95.6363784443325
SIM,1919,25,35-39,1944,15
STAT,1825,44,20-24,1869,0.16973320765583727
STAT,1932,15,15-19,1947,57.03564748688012
SIM,1883,60,na,1943,1762
STAT,1904,37,40-44,1941,1.2800985531966456
STAT,1871,23,na,1894,2208.1265264021217
STAT,1769,102,na,1871,0.06954500974091087
STAT,1919,29,40-44,1948,4.723677088713961
SIM,1866,42,na,1908,2031
STAT,1833,53,45-49,1886,0.008922214089560931
STAT,1813,69,na,1882,736.7448840256328
SIM,1814,43,40-44,1857,4
STAT,1883,20,50-100,1903,0.3798124643972208
SIM,1927,29,40-44,1956,6
SIM,1940,15,15-19,1955,37
SIM,1912,25,40-44,1937,5
SIM,1841,41,45-49,1882,1
STAT,1879,48,35-39,1927,0.1365034950051238
STAT,1902,25,15-19,1927,0.6089562218923498
STAT,1934,1,na,1935,5336.051005246037
SIM,1845,25,40-44,1870,3
STAT,1921,25,40-44,1946,4.941162226188649
STAT,1926,14,na,1940,4574.937138114876
SIM,1940,26,50-100,1966,5
SIM,1877,66,na,1943,1568
SIM,1934,15,na,1949,4676
STAT,1845,22,20-24,1867,60.26011608730114
SIM,1856,67,na,1923,1206
SIM,1840,26,35-39,1866,12
STAT,1847,47,45-49,1894,0.17283658619248474
SIM,1913,16,na,1929,3618
SIM,1882,81,na,1963,664
SIM,1945,21,na,1966,3666
STAT,1826,28,25-29,1854,128.8603306034849
STAT,1877,46,35-39,1923,0.1376340393879269
STAT,1896,3,na,1899,3300.6716726456475
STAT,1941,17,15-19,1958,44.156726014075595
STAT,1876,16,20-24,1892,17.332310115279252
STAT,1816,53,45-49,1869,0.0358557598640086
STAT,1931,35,45-49,1966,0.8544106949825669
SIM,1881,34,40-44,1915,4
STAT,1904,25,40-44,1929,4.085993125361786
SIM,1817,41,50-100,1858,4
STAT,1888,49,15-19,1937,2.4655127847899623E-4
STAT,1935,19,40-44,1954,1.7965964606724532
SIM,1943,19,40-44,1962,2
SIM,1788,97,na,1885,2
STAT,1880,53,25-29,1933,0.0034642257232539667
SIM,1786,68,na,1854,683
STAT,1825,32,na,1857,1649.7590144883131
STAT,1901,34,20-24,1935,3.5436182736107122
SIM,1843,17,na,1860,2111
STAT,1947,13,na,1960,4179.7170419230115
SIM,1834,28,25-29,1862,37
SIM,1860,45,50-100,1905,3
STAT,1890,15,35-39,1905,0.6367184890174366
STAT,1873,34,40-44,1907,4.1229100313600755
STAT,1832,36,45-49,1868,1.5448085355639125
SIM,1882,42,45-49,1924,2
STAT,1836,45,35-39,1881,0.09492250119244158
STAT,1930,27,40-44,1957,5.599230896435143
SIM,1866,45,na,1911,2007
SIM,1831,24,35-39,1855,5
SIM,1893,28,50-100,1921,4
STAT,1857,51,40-44,1908,0.007877988829404802
SIM,1872,22,30-34,1894,23
STAT,1829,90,na,1919,48.325218703858155
STAT,1842,30,50-100,1872,0.804739964262236
STAT,1886,33,30-34,1919,17.35342382622018
STAT,1885,28,50-100,1913,0.5999460030730408
SIM,1829,50,na,1879,1327
SIM,1788,94,na,1882,4
STAT,1901,40,15-19,1941,0.001280845664265712
SIM,1888,27,45-49,1915,1
STAT,1851,39,15-19,1890,0.040764614191005126
STAT,1830,53,50-100,1883,0.009544782150197583
STAT,1886,38,25-29,1924,2.859542211547688
SIM,1887,43,40-44,1930,6
SIM,1944,20,25-29,1964,97
SIM,1843,15,20-24,1858,18
STAT,1854,37,50-100,1891,0.8840904757644044
SIM,1871,75,na,1946,897
STAT,1883,48,na,1931,2056.879938822264
STAT,1886,37,na,1923,2351.557713681903
STAT,1926,17,40-44,1943,1.6202363250054508
SIM,1934,17,40-44,1951,1
STAT,1852,18,25-29,1870,5.176575956306871
SIM,1888,29,na,1917,2567
SIM,1893,22,na,1915,2960
STAT,1750,106,na,1856,0.39271528890000007
STAT,1851,34,20-24,1885,2.020708484235773
STAT,1850,22,50-100,1872,0.3445749539184354
SIM,1909,44,40-44,1953,1
STAT,1869,35,20-24,1904,0.7115870352239778
STAT,1849,33,45-49,1882,1.3108096637397575
STAT,1890,31,30-34,1921,20.248858103002792
SIM,1866,26,na,1892,2138
STAT,1840,43,35-39,1883,1.2987451026908006
SIM,1862,28,45-49,1890,3
SIM,1862,37,50-100,1899,4
SIM,1894,38,25-29,1932,2
STAT,1935,25,na,1960,4828.026286242964
SIM,1868,24,30-34,1892,15
SIM,1949,21,20-24,1970,117
SIM,1855,82,na,1937,331
STAT,1819,47,25-29,1866,0.10242228661209143
STAT,1874,42,45-49,1916,1.4432741859258986
STAT,1857,93,na,1950,21.765634632666682
SIM,1825,34,45-49,1859,3
STAT,1913,41,na,1954,3440.3875373239603
STAT,1814,53,35-39,1867,0.02189668597553949
STAT,1954,15,35-39,1969,4.9029510114719175
STAT,1852,50,45-49,1902,0.011184581016235836
STAT,1860,39,25-29,1899,2.1882834689491615
STAT,1932,36,na,1968,4779.781672835785
STAT,1878,26,40-44,1904,2.9561047594160432
STAT,1920,44,40-44,1964,0.2601133954579554
STAT,1952,19,40-44,1971,1.5824724505117231
SIM,1892,25,45-49,1917,2
STAT,1823,31,40-44,1854,13.565958114851988
SIM,1835,65,na,1900,1068
STAT,1872,85,na,1957,307.80984630125334
STAT,1936,20,25-29,1956,83.46829532797571
SIM,1937,29,na,1966,3304
STAT,1830,110,na,1940,1.6507096391323928E-4
STAT,1932,23,35-39,1955,11.6354043918135
STAT,1834,49,25-29,1883,0.036855296399036376
STAT,1899,33,40-44,1932,5.590678952330995
STAT,1783,91,na,1874,14.808824892146092
STAT,1896,34,50-100,1930,1.1341679380444107
SIM,1831,40,30-34,1871,4
SIM,1940,23,35-39,1963,11
STAT,1874,18,45-49,1892,0.0629056923715728
SIM,1817,65,na,1882,923
STAT,1890,22,40-44,1912,2.4068554997973775
SIM,1819,35,40-44,1854,1
STAT,1864,22,30-34,1886,15.28094358588177
SIM,1844,42,na,1886,1693
SIM,1886,26,40-44,1912,3
STAT,1921,28,45-49,1949,1.8126928651316712
STAT,1921,43,50-100,1964,0.12481514223716325
SIM,1891,41,40-44,1932,5
SIM,1931,26,na,1957,4549
STAT,1942,22,15-19,1964,5.272367691743443
STAT,1881,44,35-39,1925,1.629427726277919
STAT,1837,79,na,1916,441.3155774369008
STAT,1888,48,45-49,1936,0.14670059575460345
STAT,1911,37,50-100,1948,0.3830110910286013
SIM,1852,90,na,1942,41
SIM,1866,35,45-49,1901,1
STAT,1842,72,na,1914,899.323355897302
SIM,1936,25,35-39,1961,10
SIM,1901,39,30-34,1940,3
STAT,1875,96,na,1971,47.308049740048034
STAT,1934,20,50-100,1954,0.83807545114202
SIM,1853,32,30-34,1885,23
SIM,1918,30,25-29,1948,12
STAT,1830,26,25-29,1856,44.633435375133125
STAT,1905,42,40-44,1947,0.21296701418489283
STAT,1855,35,35-39,1890,5.05687717012456
STAT,1900,29,20-24,1929,15.265228357343172
SIM,1849,39,25-29,1888,1
STAT,1862,35,35-39,1897,5.753757758072949
STAT,1906,33,35-39,1939,7.965357660691254
STAT,1928,40,na,1968,4485.583590550051
SIM,1900,49,na,1949,2860
STAT,1814,91,na,1905,23.90903455966338
STAT,1823,40,30-34,1863,1.5774766837487055
STAT,1876,22,15-19,1898,3.217390992676746
SIM,1847,53,na,1900,1510
STAT,1820,43,25-29,1863,1.123452233662773
STAT,1881,81,na,1962,695.4619598406158
SIM,1836,34,20-24,1870,2
SIM,1890,30,na,1920,2864
STAT,1796,64,na,1860,887.6036896109023
SIM,1899,27,20-24,1926,16
STAT,1835,28,35-39,1863,7.789887392955369
STAT,1858,32,40-44,1890,3.216237387365593
STAT,1934,36,15-19,1970,0.025056657471256637
STAT,1873,38,15-19,1911,0.05357999539826171
SIM,1830,29,45-49,1859,3
STAT,1849,45,na,1894,1637.8318968269025
SIM,1828,48,50-100,1876,2
SIM,1846,32,30-34,1878,23
SIM,1869,56,na,1925,1848
SIM,1942,20,50-100,1962,1
SIM,1943,11,na,1954,3863
STAT,1910,37,40-44,1947,1.3521306198769374
STAT,1838,32,30-34,1870,14.797170270604338
SIM,1890,48,na,1938,2646
STAT,1895,33,na,1928,2929.4291755149015
SIM,1918,44,na,1962,3679
SIM,1866,32,40-44,1898,2
STAT,1895,16,30-34,1911,1.969747794067314
STAT,1774,109,na,1883,0.0029351424904392803
STAT,1927,34,40-44,1961,4.542259726569077
SIM,1840,36,45-49,1876,1
SIM,1860,18,25-29,1878,12
SIM,1868,43,30-34,1911,4
STAT,1928,25,35-39,1953,17.59386383674607
SIM,1857,33,45-49,1890,1
STAT,1869,22,15-19,1891,3.016748954823193
STAT,1847,19,na,1866,2083.2300852912113
STAT,1928,34,25-29,1962,10.904743675862711
STAT,1905,12,na,1917,3525.5263309435327
STAT,1919,48,40-44,1967,0.16109992901599937
SIM,1881,24,30-34,1905,16
STAT,1854,28,45-49,1882,0.8321426221417529
STAT,1879,43,40-44,1922,2.2049630644367566
STAT,1892,22,na,1914,2797.8685525092783
SIM,1908,23,25-29,1931,82
SIM,1880,71,na,1951,1377
SIM,1893,59,na,1952,2386
STAT,1925,38,30-34,1963,2.0646753082987375
SIM,1908,27,40-44,1935,3
STAT,1848,52,45-49,1900,0.010399426819025183
SIM,1779,98,na,1877,1
STAT,1935,9,na,1944,5140.850231992438
STAT,1910,52,na,1962,3182.655163862421
SIM,1935,34,40-44,1969,12
SIM,1836,25,30-34,1861,29
SIM,1936,34,25-29,1970,4
SIM,1913,42,40-44,1955,2
SIM,1839,21,25-29,1860,62
SIM,1933,38,30-34,1971,1
SIM,1930,9,na,1939,4823
STAT,1837,42,na,1879,1566.081513536288
STAT,1913,23,25-29,1936,87.8237558814251
STAT,1833,83,na,1916,241.0068515643566
SIM,1900,18,15-19,1918,7
STAT,1854,15,30-34,1869,1.389283870201491
SIM,1871,17,30-34,1888,6
STAT,1859,26,na,1885,1843.552130293395
STAT,1880,24,30-34,1904,17.59454257874997
STAT,1906,48,30-34,1954,0.07416894698470708
SIM,1881,37,45-49,1918,3
STAT,1854,34,30-34,1888,12.610517566987994
STAT,1936,36,40-44,1972,1.3893630216890578
SIM,1841,29,20-24,1870,12
STAT,1834,68,na,1902,945.8876284873089
STAT,1880,15,40-44,1895,0.18265004571182844
STAT,1838,46,50-100,1884,0.17455432110402755
STAT,1832,24,50-100,1856,0.3529719969738568
SIM,1850,40,40-44,1890,5
STAT,1859,19,30-34,1878,1.3784891335235117
SIM,1917,15,15-19,1932,7
STAT,1858,41,na,1899,1721.8396773451884
STAT,1888,35,30-34,1923,6.004350504381463
STAT,1843,24,45-49,1867,0.6224409530278229
STAT,1848,28,45-49,1876,0.948059405191001
STAT,1839,26,45-49,1865,0.9393806374943303
STAT,1812,65,na,1877,864.3338638878643
SIM,1820,51,na,1871,1242
STAT,1931,32,40-44,1963,4.84425542954715
STAT,1901,44,30-34,1945,0.10414027094033038
SIM,1899,69,na,1968,2212
STAT,1873,37,45-49,1910,1.911571002606245
STAT,1909,25,25-29,1934,60.32022073988757
SIM,1867,19,30-34,1886,1
STAT,1851,103,na,1954,0.10524192356643244
SIM,1855,44,40-44,1899,7
STAT,1906,29,30-34,1935,34.392867649440355
STAT,1875,20,40-44,1895,2.0344825930096757
STAT,1904,45,50-100,1949,0.18956688512833167
SIM,1832,27,20-24,1859,10
SIM,1896,35,30-34,1931,11
SIM,1856,28,45-49,1884,4
STAT,1835,51,20-24,1886,4.7859740249964655E-4
STAT,1892,38,25-29,1930,3.389215497195251
STAT,1904,21,25-29,1925,77.79183109619092
STAT,1929,30,35-39,1959,10.978823266847797
SIM,1863,35,35-39,1898,8
STAT,1854,52,50-100,1906,0.010817507370810364
SIM,1912,45,50-100,1957,2
STAT,1793,72,na,1865,537.0539087946142
STAT,1811,80,na,1891,267.9444558053648
STAT,1845,32,30-34,1877,14.622731474809202
STAT,1866,48,25-29,1914,0.04953859314226585
STAT,1869,81,na,1950,494.4949602629551
STAT,1816,50,40-44,1866,0.027619593330356337
STAT,1827,64,na,1891,964.7008268080377
STAT,1876,29,35-39,1905,9.342913307361364
STAT,1856,36,50-100,1892,0.9127716675783037
STAT,1895,11,na,1906,3188.4675155295104
SIM,1822,95,na,1917,9
SIM,1864,19,na,1883,2295
SIM,1948,19,25-29,1967,50
STAT,1862,25,25-29,1887,34.71040191654229
SIM,1847,26,45-49,1873,4
STAT,1769,87,na,1856,45.19268781
STAT,1902,23,na,1925,3143.2175318127884
SIM,1877,39,45-49,1916,1
STAT,1869,39,45-49,1908,1.804570736747876
SIM,1870,25,25-29,1895,41
STAT,1870,46,25-29,1916,0.053469943564176683
STAT,1938,32,35-39,1970,8.679453574902206
STAT,1920,30,15-19,1950,0.13404756925427386
SIM,1841,50,na,1891,1528
SIM,1884,16,20-24,1900,21
SIM,1886,22,25-29,1908,60
STAT,1838,42,40-44,1880,1.7940847188754498
STAT,1909,15,15-19,1924,8.44447185761415
STAT,1841,106,na,1947,0.00830724195533594
SIM,1820,69,na,1889,719
SIM,1898,34,45-49,1932,4
SIM,1817,38,35-39,1855,12
STAT,1878,22,25-29,1900,56.29834128720402
SIM,1846,42,40-44,1888,7
SIM,1853,37,25-29,1890,2
SIM,1937,30,35-39,1967,7
STAT,1836,35,25-29,1871,2.2785417926778044
SIM,1909,48,na,1957,3169
STAT,1837,21,25-29,1858,47.64918876202709
SIM,1879,92,na,1971,141
STAT,1885,18,20-24,1903,16.642011232664114
STAT,1887,84,na,1971,717.8829420707833
SIM,1901,33,25-29,1934,20
STAT,1781,87,na,1868,50.00892880197601
STAT,1891,77,na,1968,1389.947206093527
STAT,1932,19,30-34,1951,15.165713559016101
SIM,1836,38,45-49,1874,1
SIM,1831,91,na,1922,28
STAT,1911,0,na,1911,4244.000383019025
STAT,1844,27,na,1871,1859.0664934917465
STAT,1863,71,na,1934,1108.436561239728
SIM,1858,36,30-34,1894,1
STAT,1825,47,25-29,1872,0.06039655424195371
SIM,1912,21,25-29,1933,80
STAT,1883,26,na,1909,2217.186155160219
STAT,1913,19,20-24,1932,26.040055524747185
STAT,1832,23,30-34,1855,16.80816548411781
STAT,1888,19,50-100,1907,0.05438222101639479
STAT,1873,20,15-19,1893,3.182336626524013
SIM,1858,93,na,1951,13
STAT,1883,41,40-44,1924,2.0919534824158106
STAT,1884,25,45-49,1909,1.0435441035517998
STAT,1933,18,na,1951,4642.564595761063
SIM,1810,92,na,1902,15
STAT,1828,44,30-34,1872,0.9808758905869269
STAT,1865,16,45-49,1881,0.058127426467028
STAT,1874,7,na,1881,2617.1119667448
STAT,1847,44,40-44,1891,1.632652466659649
STAT,1861,44,25-29,1905,0.49695742845461716
STAT,1864,32,40-44,1896,3.6615364198278866
STAT,1839,53,50-100,1892,0.009908405941808383
SIM,1844,79,na,1923,424
SIM,1893,18,20-24,1911,24
STAT,1842,40,40-44,1882,1.7001824820804945
SIM,1905,21,25-29,1926,64
SIM,1921,19,20-24,1940,158
STAT,1848,82,na,1930,336.1369631107489
STAT,1884,70,na,1954,1309.8254999546612
STAT,1846,52,35-39,1898,0.0060376967288488445
STAT,1895,29,45-49,1924,1.3589985153625828
SIM,1840,23,30-34,1863,23
SIM,1844,35,25-29,1879,2
STAT,1845,37,25-29,1882,2.1308564980074207
STAT,1914,26,na,1940,3579.2454002489194
SIM,1859,78,na,1937,631
SIM,1921,23,25-29,1944,86
STAT,1949,8,na,1957,4318.405818052644
SIM,1862,15,30-34,1877,1
STAT,1868,104,na,1972,0.7826097580030432
SIM,1839,49,na,1888,1533
STAT,1928,15,25-29,1943,51.82842585794797
SIM,1819,72,na,1891,585
STAT,1828,38,45-49,1866,1.8515434685620815
STAT,1803,51,na,1854,1145.8274397207674
STAT,1925,21,50-100,1946,0.7463945689401743
SIM,1943,15,25-29,1958,51
STAT,1865,5,na,1870,2444.396291232389
SIM,1845,21,25-29,1866,51
STAT,1834,22,45-49,1856,0.5772748394903235
STAT,1878,36,50-100,1914,1.2132381312609462
STAT,1879,33,30-34,1912,17.167531086505203
STAT,1830,87,na,1917,105.24185110241353
SIM,1919,22,30-34,1941,37
SIM,1887,33,30-34,1920,25
STAT,1824,50,na,1874,1319.20671409146
SIM,1842,22,45-49,1864,1
STAT,1898,25,na,1923,3072.655629233285
SIM,1940,19,30-34,1959,12
STAT,1864,41,30-34,1905,0.975069348545203
STAT,1867,29,25-29,1896,37.253208354958154
SIM,1872,41,30-34,1913,1
STAT,1935,15,25-29,1950,56.22253146598945
SIM,1878,30,na,1908,2433
SIM,1881,34,na,1915,1959
STAT,1863,17,30-34,1880,1.5103188206110667
STAT,1819,42,30-34,1861,2.257010360511678
STAT,1852,53,50-100,1905,0.011290413602399208
SIM,1872,35,45-49,1907,3
SIM,1894,33,30-34,1927,27
STAT,1910,27,30-34,1937,35.73348726684645
STAT,1949,20,35-39,1969,10.387560372348684
SIM,1886,36,50-100,1922,1
STAT,1844,53,20-24,1897,5.097087174170733E-4
SIM,1876,17,15-19,1893,3
SIM,1947,19,na,1966,3747
SIM,1846,90,na,1936,64
SIM,1806,62,na,1868,910
STAT,1927,39,40-44,1966,1.754720374140276
STAT,1862,40,20-24,1902,0.12926888897137787
SIM,1919,34,25-29,1953,12
SIM,1939,31,45-49,1970,1
SIM,1825,69,na,1894,754
STAT,1844,67,na,1911,1112.8374711263455
SIM,1942,16,25-29,1958,54
STAT,1836,53,25-29,1889,0.0022187829322127964
STAT,1901,38,50-100,1939,0.34866472547546845
SIM,1836,29,40-44,1865,3
SIM,1862,37,40-44,1899,3
STAT,1912,44,50-100,1956,0.10618593906886085
STAT,1934,16,25-29,1950,55.5081504669072
STAT,1889,79,na,1968,1210.0013000018528
STAT,1860,34,50-100,1894,0.6974336739398594
SIM,1881,30,25-29,1911,7
STAT,1871,69,na,1940,1374.4181488905776
STAT,1897,74,na,1971,1818.0022580325715
SIM,1940,19,25-29,1959,54
SIM,1829,59,na,1888,1087
STAT,1897,17,40-44,1914,0.23108253443274188
STAT,1829,103,na,1932,0.08796733738274809
STAT,1852,62,na,1914,1388.65957776946
SIM,1873,92,na,1965,96
STAT,1860,43,20-24,1903,0.12104944465130513
SIM,1928,12,na,1940,4716
SIM,1955,14,na,1969,4541
STAT,1840,24,35-39,1864,5.094156932003812
STAT,1932,20,30-34,1952,35.83868594755776
STAT,1945,19,35-39,1964,4.327346302181905
STAT,1859,40,15-19,1899,0.01051662599779951
SIM,1811,49,na,1860,1280
SIM,1937,18,40-44,1955,1
STAT,1838,50,25-29,1888,0.002500019310359377
STAT,1868,17,15-19,1885,5.449745951184197
STAT,1911,29,35-39,1940,13.729749712852565
SIM,1891,18,na,1909,3094
STAT,1831,31,30-34,1862,14.504548089181316
SIM,1867,22,15-19,1889,2
STAT,1932,19,25-29,1951,53.91908398749527
SIM,1859,16,30-34,1875,1
SIM,1833,64,na,1897,1098
SIM,1838,26,40-44,1864,4
SIM,1879,18,na,1897,2498
STAT,1857,30,50-100,1887,0.7009951718941764
SIM,1928,41,40-44,1969,2
STAT,1859,22,15-19,1881,2.5805700797740574
STAT,1837,51,50-100,1888,0.009759999228631789
STAT,1913,26,35-39,1939,14.177525476394939
SIM,1830,25,50-100,1855,1
STAT,1839,106,na,1945,0.008095740108872661
SIM,1921,26,35-39,1947,18
STAT,1866,82,na,1948,406.38818065797375
STAT,1854,37,40-44,1891,3.152214501928803
STAT,1929,36,40-44,1965,1.817350762866117
STAT,1930,23,30-34,1953,34.67744875942367
STAT,1932,37,25-29,1969,1.2497810218879357
STAT,1798,81,na,1879,206.97194703137274
SIM,1846,32,25-29,1878,12
STAT,1911,47,35-39,1958,0.11528158682209709
SIM,1869,35,30-34,1904,9
STAT,1839,80,na,1919,412.4627505127117
STAT,1846,24,50-100,1870,0.34968606814616976
STAT,1955,4,na,1959,4931.505368034104
SIM,1874,46,na,1920,2158
STAT,1927,20,20-24,1947,130.20759388811788
STAT,1838,32,25-29,1870,8.680642234561585
STAT,1865,106,na,1971,0.14892219129084905
STAT,1906,30,30-34,1936,13.901844179471151
STAT,1936,26,30-34,1962,35.43418226791256
SIM,1822,34,35-39,1856,11
STAT,1887,44,na,1931,2408.856829945792
STAT,1855,26,50-100,1881,0.47564806179483393
STAT,1911,9,na,1920,3750.123274258585
STAT,1929,34,45-49,1963,1.885919022368776
STAT,1883,49,30-34,1932,0.08775265706459778
STAT,1847,16,na,1863,2120.4786853771498
STAT,1932,0,na,1932,5635.667389781368
SIM,1871,24,30-34,1895,20
STAT,1793,101,na,1894,0.10378877819916689
STAT,1827,95,na,1922,7.37835002221528
STAT,1879,33,25-29,1912,10.071195552079
STAT,1869,1,na,1870,3234.1618965341413
STAT,1894,20,15-19,1914,4.032961067603214
STAT,1809,70,na,1879,724.2223565703665
STAT,1863,24,30-34,1887,14.870479598043412
STAT,1898,16,na,1914,3237.745620294303
SIM,1899,18,25-29,1917,4
STAT,1926,4,na,1930,4675.422097372332
STAT,1904,33,30-34,1937,13.52528482859067
STAT,1772,88,na,1860,36.8068403993458
SIM,1810,46,50-100,1856,1
STAT,1856,52,na,1908,1584.634860080772
SIM,1859,1,na,1860,2885
STAT,1896,36,35-39,1932,8.873273248300347
STAT,1924,42,15-19,1966,0.0017257845173337004
SIM,1912,33,30-34,1945,15
STAT,1886,35,50-100,1921,1.2370778540269005
SIM,1905,41,45-49,1946,2
SIM,1926,15,30-34,1941,16
STAT,1846,27,35-39,1873,8.230182565942677
SIM,1887,33,25-29,1920,13
STAT,1896,30,20-24,1926,3.401983477299211
SIM,1854,27,35-39,1881,7
STAT,1901,13,na,1914,3409.5251554445035
SIM,1905,43,na,1948,3132
SIM,1873,21,30-34,1894,19
STAT,1819,100,na,1919,0.530171719853035
SIM,1830,26,40-44,1856,3
STAT,1885,30,45-49,1915,1.6544420510580882
STAT,1902,36,30-34,1938,1.5409582243278022
STAT,1904,15,30-34,1919,2.1694440999840894
SIM,1849,24,20-24,1873,61
STAT,1914,39,30-34,1953,1.7014844235389537
STAT,1916,18,30-34,1934,2.436529441162498
SIM,1940,20,30-34,1960,32
STAT,1918,15,30-34,1933,2.5261197093101586
SIM,1914,26,50-100,1940,5
STAT,1894,39,35-39,1933,8.508651049150727
SIM,1811,44,30-34,1855,4
STAT,1848,57,na,1905,1447.7854653927463
STAT,1815,39,50-100,1854,4.102534177335308
SIM,1924,18,30-34,1942,17
STAT,1865,21,30-34,1886,15.588662408615914
STAT,1848,24,35-39,1872,5.045578903070804
SIM,1893,30,45-49,1923,2
SIM,1879,27,40-44,1906,4
SIM,1922,39,30-34,1961,1
STAT,1900,26,25-29,1926,55.63005393918787
STAT,1899,30,45-49,1929,2.275722415707068
SIM,1937,34,45-49,1971,5
SIM,1934,34,50-100,1968,1
STAT,1922,45,15-19,1967,4.016933061088645E-4
STAT,1940,15,40-44,1955,1.342201033400038
SIM,1910,36,30-34,1946,1
SIM,1912,15,30-34,1927,2
STAT,1844,48,35-39,1892,0.09704637764641541
SIM,1857,46,na,1903,1790
SIM,1922,23,45-49,1945,1
STAT,1950,19,15-19,1969,50.66367094154566
SIM,1858,21,35-39,1879,5
STAT,1872,32,30-34,1904,16.555344291319326
SIM,1859,36,50-100,1895,1
SIM,1936,35,na,1971,2885
STAT,1864,54,45-49,1918,0.011916038310878613
STAT,1840,26,50-100,1866,0.5594811467899304
STAT,1846,48,50-100,1894,0.17098996082358403
SIM,1932,24,15-19,1956,5
STAT,1890,46,40-44,1936,0.11185886892570071
SIM,1916,30,50-100,1946,4
STAT,1877,54,25-29,1931,0.0033768095372696733
STAT,1829,45,35-39,1874,0.1159574733475916
STAT,1866,51,45-49,1917,0.012700631827546193
STAT,1912,41,40-44,1953,0.22915533272419933
STAT,1920,34,25-29,1954,9.482540734570916
STAT,1860,97,na,1957,5.570236177974644
STAT,1815,70,na,1885,707.7416487283946
SIM,1853,84,na,1937,229
SIM,1884,76,na,1960,990
STAT,1870,35,30-34,1905,4.980280917147026
STAT,1864,22,25-29,1886,49.11032209601556
STAT,1923,44,20-24,1967,0.019436580502469752
STAT,1839,31,30-34,1870,14.47593310881363
STAT,1917,47,30-34,1964,0.08795977709570531
STAT,1786,96,na,1882,1.515349698621014
STAT,1830,32,25-29,1862,8.569287529864507
SIM,1904,20,20-24,1924,87
STAT,1933,18,30-34,1951,15.373814734898268
SIM,1856,21,30-34,1877,16
STAT,1860,49,35-39,1909,0.1052421213749108
STAT,1919,47,35-39,1966,0.13210785630227267
STAT,1854,19,40-44,1873,0.1557030019433106
STAT,1801,100,na,1901,0.403976751844738
SIM,1850,36,na,1886,1776
SIM,1889,30,25-29,1919,19
SIM,1828,37,35-39,1865,12
SIM,1916,26,25-29,1942,65
SIM,1826,82,na,1908,224
STAT,1792,96,na,1888,1.4597370342540181
STAT,1906,44,20-24,1950,0.014965858099914194
SIM,1849,79,na,1928,447
SIM,1909,33,na,1942,3392
SIM,1935,20,20-24,1955,128
STAT,1821,42,25-29,1863,1.0717828583561613
STAT,1887,28,35-39,1915,10.158176263622861
SIM,1886,38,40-44,1924,10
SIM,1950,4,na,1954,4295
STAT,1921,46,50-100,1967,0.24149351961881882
STAT,1940,31,45-49,1971,1.5392515900848107
SIM,1920,41,40-44,1961,2
STAT,1927,37,45-49,1964,0.8007931882150414
SIM,1879,44,50-100,1923,1
STAT,1915,49,50-100,1964,0.21402545038214377
SIM,1770,93,na,1863,6
SIM,1941,18,30-34,1959,15
SIM,1945,24,25-29,1969,92
STAT,1919,29,35-39,1948,15.215306275619882
SIM,1927,29,35-39,1956,18
SIM,1905,23,45-49,1928,5
STAT,1937,24,25-29,1961,84.90541025811122
SIM,1895,28,35-39,1923,12
STAT,1878,38,40-44,1916,4.283713064641652
STAT,1803,85,na,1888,88.8689137818451
STAT,1877,54,na,1931,2052.7415986925594
STAT,1881,25,35-39,1906,8.860922281066246
STAT,1894,26,na,1920,2910.103953849109
STAT,1883,54,na,1937,1938.779051750688
STAT,1927,44,50-100,1971,0.1387406013263655
SIM,1870,56,na,1926,1893
STAT,1832,42,na,1874,1545.9149772602946
STAT,1860,107,na,1967,0.03384452378345213
SIM,1856,21,na,1877,1994
STAT,1839,19,45-49,1858,0.05630735268195291
SIM,1785,83,na,1868,96
STAT,1879,49,na,1928,2175.1803770320103
SIM,1861,38,35-39,1899,15
STAT,1853,38,35-39,1891,5.219317104931704
STAT,1854,97,na,1951,3.86852065218855
SIM,1815,39,na,1854,1382
SIM,1949,14,na,1963,4295
SIM,1901,30,20-24,1931,1
STAT,1871,33,25-29,1904,9.552163058586011
STAT,1914,25,40-44,1939,4.468255824000305
STAT,1895,38,40-44,1933,5.369817475765151
STAT,1865,69,na,1934,1259.805038841303
STAT,1890,44,45-49,1934,1.7053261736150969
SIM,1926,17,na,1943,4147
SIM,1878,28,35-39,1906,11
SIM,1922,25,40-44,1947,5
STAT,1885,46,30-34,1931,0.09136482944021143
STAT,1914,41,45-49,1955,0.15598919317503673
SIM,1881,28,na,1909,1964
STAT,1895,37,50-100,1932,1.5135610175588672
STAT,1908,26,25-29,1934,59.46898130970317
SIM,1766,88,na,1854,36
STAT,1828,37,na,1865,1575.499817496
STAT,1828,47,40-44,1875,0.14420319797898526
SIM,1847,31,30-34,1878,19
STAT,1914,23,45-49,1937,1.082411467212043
SIM,1872,22,25-29,1894,57
STAT,1932,34,20-24,1966,3.05929887165559
STAT,1824,75,na,1899,543.4918245771028
STAT,1923,31,45-49,1954,1.7112939434534202
SIM,1948,1,na,1949,4123
STAT,1900,41,45-49,1941,0.13682557534230105
STAT,1884,49,20-24,1933,0.010968577886231057
SIM,1895,48,na,1943,2762
STAT,1855,32,25-29,1887,7.386261227342152
SIM,1802,72,na,1874,544
STAT,1875,29,50-100,1904,0.616408484842552
SIM,1931,26,20-24,1957,20
STAT,1767,113,na,1880,3.4230193025410084E-4
SIM,1827,64,na,1891,889
STAT,1903,34,25-29,1937,7.836990047517013
SIM,1925,32,50-100,1957,2
STAT,1851,49,na,1900,1615.3977104476628
STAT,1923,26,20-24,1949,19.86811485051531
SIM,1888,38,na,1926,2567
SIM,1911,34,25-29,1945,13
STAT,1872,53,50-100,1925,0.01409053152204674
SIM,1804,67,na,1871,708
SIM,1899,22,35-39,1921,8
STAT,1828,29,40-44,1857,3.785200794860534
SIM,1862,21,na,1883,2110
STAT,1889,22,30-34,1911,20.77396715963899
SIM,1931,31,45-49,1962,1
SIM,1925,16,25-29,1941,52
STAT,1903,48,na,1951,2986.4206112178244
STAT,1840,77,na,1917,601.9771326586861
SIM,1791,83,na,1874,122
SIM,1845,37,40-44,1882,9
SIM,1897,22,30-34,1919,33
STAT,1880,54,30-34,1934,0.0057541160297517185
STAT,1921,16,45-49,1937,0.539285862791798
STAT,1831,24,50-100,1855,0.42320679583127285
STAT,1888,26,na,1914,2672.5242040416765
STAT,1898,18,50-100,1916,0.06248798543410841
STAT,1848,97,na,1945,3.870289768145383
STAT,1908,23,na,1931,3303.267423341414
SIM,1902,29,35-39,1931,15
STAT,1811,45,50-100,1856,0.8464131657294345
SIM,1868,46,na,1914,2051
SIM,1886,35,30-34,1921,8
STAT,1928,19,35-39,1947,4.968546878240855
STAT,1945,16,30-34,1961,12.581859911762278
SIM,1908,29,50-100,1937,4
STAT,1948,20,na,1968,3964.0906290849753
SIM,1844,23,30-34,1867,20
SIM,1847,44,na,1891,1605
SIM,1915,28,30-34,1943,50
SIM,1878,43,30-34,1921,4
STAT,1778,106,na,1884,0.011302802511452964
STAT,1930,10,na,1940,4854.188226533866
SIM,1919,31,20-24,1950,3
SIM,1863,32,25-29,1895,10
STAT,1904,18,35-39,1922,0.7414561108052079
SIM,1905,39,30-34,1944,1
STAT,1887,46,35-39,1933,0.1483294560428269
SIM,1912,18,35-39,1930,2
STAT,1851,40,45-49,1891,1.108585123134372
STAT,1854,101,na,1955,0.41090275413016303
SIM,1821,39,na,1860,1502
SIM,1843,54,na,1897,1495
STAT,1819,53,25-29,1872,0.005930006480654869
STAT,1852,54,25-29,1906,0.0026171193256370536
STAT,1930,26,35-39,1956,18.043648192256605
STAT,1906,26,20-24,1932,16.193271671736646
STAT,1836,23,30-34,1859,14.738290252578384
STAT,1862,43,25-29,1905,0.5137363120634854
STAT,1850,104,na,1954,0.04695698342214505
SIM,1896,23,25-29,1919,67
STAT,1871,29,na,1900,2219.108158959643
STAT,1836,50,20-24,1886,4.905428850264958E-4
STAT,1800,65,na,1865,810.5976089621327
STAT,1907,28,30-34,1935,34.8160704830581
SIM,1923,19,25-29,1942,51
STAT,1766,88,na,1854,40.0
STAT,1933,36,30-34,1969,2.347330579100723
SIM,1819,44,30-34,1863,1
SIM,1939,29,30-34,1968,32
STAT,1888,23,25-29,1911,63.68927406811441
STAT,1813,75,na,1888,441.88006527772444
SIM,1857,21,45-49,1878,1
STAT,1910,30,20-24,1940,2.2389969435180803
STAT,1931,39,30-34,1970,2.2754586096539633
STAT,1902,32,50-100,1934,1.2214910658177607
STAT,1918,41,na,1959,3735.6160593959353
STAT,1834,53,20-24,1887,4.5916220140379495E-4
STAT,1859,29,na,1888,1804.1264536335257
STAT,1910,49,40-44,1959,0.138108626026487
SIM,1827,35,25-29,1862,2
SIM,1891,58,na,1949,2342
SIM,1886,71,na,1957,1392
STAT,1915,19,25-29,1934,8.52145662621363
STAT,1906,47,50-100,1953,0.18968682967126585
STAT,1886,26,25-29,1912,42.36696484747285
SIM,1888,32,30-34,1920,29
SIM,1932,29,15-19,1961,3
STAT,1825,50,45-49,1875,0.015263080312677318
SIM,1894,26,25-29,1920,56
STAT,1849,21,45-49,1870,0.6120810401029425
SIM,1914,26,20-24,1940,17
STAT,1788,91,na,1879,18.131769968643834
STAT,1924,29,15-19,1953,0.7710296187010212
STAT,1907,46,30-34,1953,0.07597532307032234
STAT,1904,19,50-100,1923,0.06601937227715236
STAT,1894,20,45-49,1914,0.8524553716639327
SIM,1885,36,50-100,1921,3
STAT,1836,32,na,1868,1729.8873214915257
SIM,1903,48,na,1951,3000
STAT,1879,89,na,1968,284.5278553906756
STAT,1911,26,30-34,1937,36.213874102744356
STAT,1875,54,20-24,1929,6.964843764470405E-4
SIM,1913,30,40-44,1943,5
STAT,1854,26,na,1880,1807.5262086405894
STAT,1870,53,30-34,1923,0.0054216230035590285
STAT,1904,36,35-39,1940,2.0782657376266176
STAT,1918,18,35-39,1936,4.303252063286203
STAT,1926,31,50-100,1957,0.9451030426062316
SIM,1796,67,na,1863,729
SIM,1792,77,na,1869,268
SIM,1860,26,na,1886,2068
SIM,1822,92,na,1914,16
SIM,1905,2,na,1907,3608
STAT,1861,47,50-100,1908,0.19176924174160953
STAT,1924,27,50-100,1951,1.0949295177136356
STAT,1915,34,15-19,1949,0.12256855831319034
STAT,1838,67,na,1905,1081.1571107619989
SIM,1915,33,na,1948,3588
SIM,1921,21,35-39,1942,12
SIM,1836,47,50-100,1883,1
SIM,1907,18,30-34,1925,4
SIM,1885,18,na,1903,2389
STAT,1817,43,50-100,1860,2.5650793967804253
SIM,1868,36,25-29,1904,5
STAT,1902,39,35-39,1941,2.0147376484757626
STAT,1936,29,35-39,1965,13.55774543961954
STAT,1928,37,35-39,1965,2.8880186716196015
SIM,1928,28,40-44,1956,8
STAT,1881,22,30-34,1903,16.247366784807294
STAT,1832,48,45-49,1880,0.16701295301720295
STAT,1872,70,na,1942,1330.3981960371495
SIM,1867,92,na,1959,45
STAT,1842,48,30-34,1890,0.06806635909526515
STAT,1905,49,30-34,1954,0.07298555960395635
STAT,1861,79,na,1940,548.431752419757
STAT,1848,21,30-34,1869,15.737743035225183
STAT,1886,44,25-29,1930,0.6323007899887695
STAT,1896,33,25-29,1929,12.73425511803339
SIM,1945,21,20-24,1966,107
SIM,1869,31,na,1900,2185
STAT,1829,42,25-29,1871,0.5402631831945527
STAT,1911,44,30-34,1955,0.11383153205399299
SIM,1886,9,na,1895,2536
SIM,1936,19,35-39,1955,2
SIM,1926,18,35-39,1944,9
SIM,1827,95,na,1922,5
STAT,1896,21,na,1917,2961.7542420541226
SIM,1907,33,20-24,1940,2
SIM,1875,31,na,1906,2298
STAT,1941,27,25-29,1968,64.31810352150556
SIM,1899,15,20-24,1914,25
STAT,1856,44,50-100,1900,0.7711114267363378
STAT,1829,50,na,1879,1449.2355862267834
STAT,1902,20,15-19,1922,4.424329283625572
STAT,1913,21,35-39,1934,8.64351186400195
SIM,1904,26,35-39,1930,16
SIM,1953,16,30-34,1969,18
SIM,1829,32,25-29,1861,10
STAT,1867,21,35-39,1888,5.234984059826831
STAT,1888,41,25-29,1929,0.7198964594013669
STAT,1859,40,45-49,1899,1.1397392624928209
STAT,1908,30,50-100,1938,0.7430187444257357
STAT,1812,50,na,1862,1269.3853010797432
STAT,1827,48,35-39,1875,0.12103749401378569
STAT,1846,45,35-39,1891,0.09969424183517214
SIM,1890,4,na,1894,3147
STAT,1943,21,15-19,1964,5.351815263498097
SIM,1780,83,na,1863,118
STAT,1909,21,15-19,1930,4.6866896610961275
STAT,1847,54,45-49,1901,0.010384430382023205
SIM,1898,28,na,1926,2987
SIM,1889,15,35-39,1904,2
STAT,1837,34,30-34,1871,13.535089995294896
STAT,1866,4,na,1870,2618.5466360465475
STAT,1828,31,25-29,1859,11.438073312544397
STAT,1922,31,25-29,1953,9.90649916458555
SIM,1856,24,35-39,1880,5
STAT,1840,21,25-29,1861,51.06535762717405
SIM,1853,25,25-29,1878,41
SIM,1911,31,20-24,1942,2
STAT,1829,42,30-34,1871,0.9672453724069614
STAT,1852,45,50-100,1897,0.18846041098864094
SIM,1876,30,45-49,1906,1
STAT,1822,41,30-34,1863,1.7810982181045316
STAT,1830,47,na,1877,1442.491637576145
SIM,1859,34,30-34,1893,20
SIM,1884,8,na,1892,2552
STAT,1920,19,35-39,1939,4.423827076134007
SIM,1917,21,15-19,1938,5
STAT,1851,32,50-100,1883,0.6993253146310046
STAT,1920,51,na,1971,3787.7651560603395
STAT,1845,25,25-29,1870,36.79391601680118
SIM,1918,23,25-29,1941,101
STAT,1941,24,15-19,1965,5.192895281353293
STAT,1889,8,na,1897,3031.7780020497735
STAT,1916,20,45-49,1936,1.1204289502769431
SIM,1880,86,na,1966,440
STAT,1882,69,na,1951,1349.0393609413202
SIM,1816,92,na,1908,9
SIM,1854,26,na,1880,1935
STAT,1819,60,na,1879,1064.023141986675
STAT,1937,21,20-24,1958,102.31277012144596
SIM,1905,20,40-44,1925,2
STAT,1905,30,40-44,1935,5.9678801868912625
STAT,1867,64,na,1931,1541.9247497476065
SIM,1849,27,25-29,1876,44
SIM,1900,17,30-34,1917,3
SIM,1862,21,25-29,1883,57
SIM,1922,27,na,1949,3989
SIM,1909,30,20-24,1939,2
STAT,1824,47,na,1871,1369.842169785934
SIM,1866,11,na,1877,2401
SIM,1914,30,30-34,1944,26
STAT,1907,38,na,1945,3278.292844197325
SIM,1948,20,na,1968,3747
STAT,1877,51,20-24,1928,7.268560721642534E-4
SIM,1837,42,30-34,1879,7
SIM,1928,6,na,1934,4764
STAT,1841,20,50-100,1861,0.35857669208985227
STAT,1921,34,45-49,1955,1.640273067102833
SIM,1878,43,25-29,1921,3
STAT,1829,59,na,1888,1212.6715424393885
STAT,1877,21,20-24,1898,67.76004550418816
STAT,1765,94,na,1859,3.6372744076240036
SIM,1905,39,25-29,1944,3
SIM,1837,24,30-34,1861,16
STAT,1904,18,40-44,1922,0.24715205124487824
SIM,1813,72,na,1885,535
SIM,1924,20,45-49,1944,1
STAT,1923,29,30-34,1952,42.19786207195589
SIM,1931,29,30-34,1960,46
STAT,1910,21,50-100,1931,0.5853343922937283
STAT,1952,15,30-34,1967,13.806677117447057
STAT,1920,33,50-100,1953,0.8519691407650588
SIM,1920,28,40-44,1948,3
STAT,1819,35,25-29,1854,8.747374464251097
STAT,1811,53,25-29,1864,0.01102343355291702
SIM,1839,89,na,1928,74
SIM,1904,23,25-29,1927,82
STAT,1860,85,na,1945,210.46936065633116
SIM,1897,43,na,1940,2949
STAT,1892,41,45-49,1933,1.7785467420526195
SIM,1845,34,30-34,1879,15
STAT,1912,28,40-44,1940,4.32295095085372
STAT,1854,21,25-29,1875,48.78495261310881
STAT,1896,33,30-34,1929,21.707027678277722
SIM,1808,57,na,1865,1076
STAT,1925,41,20-24,1966,0.020230379115694367
SIM,1774,83,na,1857,92
SIM,1863,5,na,1868,2433
SIM,1897,74,na,1971,1793
STAT,1867,17,25-29,1884,5.138479406638974
STAT,1845,43,25-29,1888,0.45474578014255623
STAT,1945,19,50-100,1964,0.3863701339667549
STAT,1825,60,na,1885,1151.3176233524887
SIM,1874,86,na,1960,276
STAT,1856,16,40-44,1872,0.1609656440485038
SIM,1931,29,25-29,1960,66
STAT,1861,39,na,1900,1829.6076978982514
STAT,1917,31,15-19,1948,0.12763626785285348
SIM,1933,23,20-24,1956,5
STAT,1914,21,25-29,1935,85.79170904239851
STAT,1850,67,na,1917,1115.9970270034325
STAT,1837,52,30-34,1889,0.0037713396934385885
STAT,1878,53,30-34,1931,0.005760056779160644
SIM,1801,87,na,1888,45
SIM,1820,37,35-39,1857,12
SIM,1897,25,35-39,1922,17
STAT,1911,41,20-24,1952,0.016011754315954353
STAT,1825,106,na,1931,0.006864840110693016
STAT,1873,30,25-29,1903,9.900666953036236
STAT,1889,25,35-39,1914,11.329621033921097
STAT,1901,37,25-29,1938,0.8217344552131323
SIM,1848,26,na,1874,1926
STAT,1798,100,na,1898,0.2944598346398927
STAT,1868,49,35-39,1917,0.12364022193014351
STAT,1849,29,50-100,1878,0.5387517034061379
SIM,1885,58,na,1943,1877
SIM,1836,31,25-29,1867,15
STAT,1923,29,25-29,1952,70.88541934891379
SIM,1856,52,na,1908,1709
STAT,1925,23,20-24,1948,125.3649654399386
STAT,1890,36,na,1926,2734.3146414053726
STAT,1903,31,20-24,1934,3.647847038689357
STAT,1919,26,30-34,1945,40.132209065995745
SIM,1837,54,na,1891,1336
SIM,1908,20,na,1928,3257
SIM,1903,26,45-49,1929,2
SIM,1875,17,25-29,1892,6
STAT,1878,35,30-34,1913,5.291164811737321
STAT,1880,42,50-100,1922,1.0488186509142665
SIM,1949,18,30-34,1967,12
STAT,1840,21,30-34,1861,15.889263515073416
SIM,1878,25,30-34,1903,30
STAT,1858,29,20-24,1887,8.779112992678405
STAT,1915,37,25-29,1952,0.9395556754055159
SIM,1923,28,50-100,1951,1
SIM,1905,48,50-100,1953,4
SIM,1872,11,na,1883,2458
STAT,1895,22,25-29,1917,70.57237782706355
SIM,1858,19,20-24,1877,14
SIM,1927,26,30-34,1953,48
STAT,1771,94,na,1865,2.746513778736543
STAT,1868,49,na,1917,1986.934373357053
STAT,1881,22,25-29,1903,52.2162398892168
STAT,1919,44,30-34,1963,0.13044615444496968
STAT,1872,17,35-39,1889,0.5219986942618412
STAT,1865,97,na,1962,12.107486284525157
STAT,1873,49,45-49,1922,0.22157734451149153
STAT,1936,35,na,1971,3494.585927841526
STAT,1831,53,50-100,1884,0.00957663205175343
SIM,1922,21,25-29,1943,109
STAT,1873,64,na,1937,1666.926358073557
STAT,1868,5,na,1873,2537.5073919740157
SIM,1916,27,na,1943,3544
STAT,1842,32,na,1874,1864.3782606119412
SIM,1866,29,20-24,1895,9
SIM,1845,89,na,1934,70
STAT,1946,18,40-44,1964,1.465139766730046
SIM,1930,31,25-29,1961,10
STAT,1807,75,na,1882,431.53531091439095
STAT,1931,20,40-44,1951,4.1443912664579114
STAT,1794,91,na,1885,17.944055969390753
SIM,1839,80,na,1919,412
SIM,1936,32,35-39,1968,11
STAT,1860,46,25-29,1906,0.04434851400295061
STAT,1923,47,25-29,1970,0.05862705299475246
STAT,1908,1,na,1909,3813.4190236733484
STAT,1793,81,na,1874,203.61812979290337
SIM,1908,16,25-29,1924,9
SIM,1949,20,45-49,1969,2
SIM,1877,32,25-29,1909,5
SIM,1886,38,35-39,1924,12
STAT,1816,54,50-100,1870,0.036575178170417284
STAT,1905,35,40-44,1940,1.3021109552918233
STAT,1868,30,45-49,1898,1.585530661660874
SIM,1855,45,50-100,1900,1
STAT,1928,16,30-34,1944,14.545898964562202
STAT,1907,42,45-49,1949,0.14402159006836537
STAT,1870,44,na,1914,2110.565655883093
SIM,1821,39,45-49,1860,3
SIM,1786,77,na,1863,295
STAT,1868,19,35-39,1887,0.49796576869788467
STAT,1884,44,20-24,1928,0.14625706489558943
SIM,1870,28,na,1898,2199
SIM,1904,23,30-34,1927,29
STAT,1808,85,na,1893,106.55202123815722
STAT,1909,28,35-39,1937,13.503559605607956
STAT,1851,38,30-34,1889,3.909315246908477
STAT,1878,38,35-39,1916,6.921381299308595
STAT,1910,27,25-29,1937,60.026340324783135
SIM,1906,65,na,1971,2682
SIM,1900,35,30-34,1935,3
STAT,1904,16,45-49,1920,0.08871779802202645
SIM,1926,5,na,1931,4536
STAT,1930,24,45-49,1954,1.3532479969350824
SIM,1854,66,na,1920,1218
STAT,1832,45,40-44,1877,0.12590820779774572
STAT,1872,9,na,1881,2546.9502175970997
STAT,1912,25,na,1937,3510.348443104781
SIM,1917,28,35-39,1945,18
STAT,1941,13,na,1954,3827.0344061139103
STAT,1857,62,na,1919,1361.2041847091962
STAT,1937,28,40-44,1965,4.289606265258902
SIM,1883,54,na,1937,1975
SIM,1943,18,35-39,1961,4
SIM,1936,16,30-34,1952,11
STAT,1853,23,30-34,1876,15.495786234967879
SIM,1843,26,na,1869,1881
SIM,1861,23,30-34,1884,22
STAT,1875,90,na,1965,192.78123613772286
STAT,1911,31,50-100,1942,0.7635120045025499
STAT,1806,53,45-49,1859,0.040161284316551166
STAT,1941,24,20-24,1965,108.47310032336969
STAT,1841,20,30-34,1861,15.662628211829258
STAT,1852,51,20-24,1903,5.63333244715896E-4
SIM,1913,33,45-49,1946,2
STAT,1920,20,na,1940,3858.3269309702678
STAT,1935,18,35-39,1953,5.404651862577068
STAT,1853,111,na,1964,3.5269073866476126E-4
SIM,1882,10,na,1892,2375
STAT,1873,44,45-49,1917,1.4157690244175112
STAT,1884,64,na,1948,1622.826625467146
STAT,1910,21,na,1931,3394.7445998585818
STAT,1924,46,30-34,1970,0.1005186032004775
SIM,1868,24,25-29,1892,57
STAT,1840,37,na,1877,1764.1850681014366
SIM,1852,62,na,1914,1381
STAT,1924,10,na,1934,4471.367158649437
STAT,1827,33,30-34,1860,19.454488038355652
STAT,1872,47,35-39,1919,0.1321294434620599
STAT,1909,21,45-49,1930,0.9906353445900117
STAT,1909,28,50-100,1937,0.8952418240249441
SIM,1948,19,30-34,1967,14
STAT,1931,25,40-44,1956,5.6898748891776485
SIM,1866,51,na,1917,1885
SIM,1909,33,25-29,1942,8
STAT,1838,95,na,1933,9.067880472894473
SIM,1782,78,na,1860,265
SIM,1858,19,15-19,1877,4
SIM,1881,44,45-49,1925,2
SIM,1893,17,15-19,1910,7
SIM,1900,29,30-34,1929,37
STAT,1859,26,30-34,1885,19.4526263740063
STAT,1934,31,15-19,1965,0.16584118337381845
SIM,1946,9,na,1955,4073
STAT,1825,69,na,1894,829.7404074145863
STAT,1906,23,50-100,1929,0.5592268140541355
SIM,1835,33,30-34,1868,15
STAT,1845,77,na,1922,608.8617041484343
STAT,1940,30,30-34,1970,15.419970691186617
STAT,1836,38,35-39,1874,5.42569833843597
STAT,1773,104,na,1877,0.022583148655567827
SIM,1837,85,na,1922,147
STAT,1861,45,30-34,1906,0.07669440345978003
STAT,1871,21,25-29,1892,53.77486507836978
SIM,1903,17,na,1920,3377
STAT,1919,45,45-49,1964,0.22374423447566283
STAT,1848,29,na,1877,1833.898636258834
SIM,1900,40,na,1940,3039
SIM,1870,25,na,1895,2231
SIM,1844,38,35-39,1882,10
STAT,1938,30,na,1968,3596.1853902514513
STAT,1860,46,30-34,1906,0.07453014230660279
STAT,1885,17,15-19,1902,5.585476699292615
SIM,1845,37,35-39,1882,13
STAT,1861,70,na,1931,1100.6789660172449
STAT,1781,96,na,1877,1.3952466723268646
SIM,1937,20,na,1957,3226
STAT,1830,36,40-44,1866,3.5215138230142005
STAT,1869,44,25-29,1913,0.5792857591009644
STAT,1871,15,25-29,1886,5.404895027488617
STAT,1902,32,15-19,1934,0.18985052725253918
STAT,1817,53,20-24,1870,0.0015500689563009463
STAT,1844,36,na,1880,1764.2212509905603
STAT,1915,39,15-19,1954,0.018140240028203285
STAT,1835,109,na,1944,4.439009278863474E-4
SIM,1880,35,35-39,1915,20
STAT,1923,33,35-39,1956,9.891576688280924
SIM,1928,21,20-24,1949,131
SIM,1879,42,30-34,1921,1
SIM,1904,61,na,1965,2695
SIM,1877,26,25-29,1903,41
SIM,1883,51,na,1934,2046
STAT,1933,32,15-19,1965,0.16360018177553076
STAT,1811,49,na,1860,1270.8964728570995
STAT,1820,85,na,1905,146.0408470684181
STAT,1869,32,25-29,1901,9.366214260179225
STAT,1934,31,na,1965,4880.917112302071
STAT,1870,31,15-19,1901,0.13236114896708998
SIM,1808,97,na,1905,1
SIM,1917,21,45-49,1938,1
STAT,1888,20,20-24,1908,77.36591423929276
SIM,1824,59,na,1883,1088
SIM,1896,20,20-24,1916,87
SIM,1813,44,35-39,1857,4
SIM,1901,33,50-100,1934,3
STAT,1924,28,30-34,1952,42.95087914375605
SIM,1932,28,30-34,1960,57
SIM,1844,67,na,1911,1096
SIM,1931,33,35-39,1964,14
STAT,1825,48,30-34,1873,0.10011195291025164
STAT,1894,24,30-34,1918,21.51034061951252
SIM,1834,20,35-39,1854,6
SIM,1882,13,na,1895,2365
STAT,1926,34,50-100,1960,0.943336799410753
SIM,1875,21,35-39,1896,8
STAT,1857,65,na,1922,1258.6008947038083
SIM,1898,24,40-44,1922,1
SIM,1910,20,15-19,1930,7
STAT,1850,38,50-100,1888,0.8689509987594891
STAT,1892,39,30-34,1931,6.241470406334748
SIM,1876,72,na,1948,1227
STAT,1912,43,30-34,1955,0.11575786314784364
STAT,1881,52,50-100,1933,0.013702545912341026
SIM,1915,24,15-19,1939,5
SIM,1944,27,45-49,1971,1
STAT,1777,88,na,1865,40.85137909190048
SIM,1835,99,na,1934,1
STAT,1873,46,40-44,1919,0.16463120071536153
STAT,1822,44,35-39,1866,2.5893507097724626
STAT,1781,93,na,1874,6.0815402341600855
STAT,1896,9,na,1905,3239.4829907095273
SIM,1875,28,na,1903,2307
SIM,1919,38,40-44,1957,7
SIM,1858,87,na,1945,103
STAT,1878,39,na,1917,2293.6722042996385
STAT,1858,113,na,1971,1.0673696636147214E-4
SIM,1927,27,45-49,1954,3
STAT,1811,50,20-24,1861,0.002439170383322864
STAT,1877,36,30-34,1913,5.249822234752426
SIM,1810,67,na,1877,765
STAT,1916,36,25-29,1952,0.9570823695215449
STAT,1819,50,50-100,1869,0.02684351414593286
SIM,1913,47,na,1960,3264
STAT,1837,37,35-39,1874,5.436157972109568
SIM,1862,92,na,1954,34
STAT,1832,70,na,1902,848.3807762862324
STAT,1925,38,25-29,1963,1.1153992983603953
STAT,1856,31,30-34,1887,13.212993697347008
STAT,1872,35,35-39,1907,6.770253461111983
STAT,1833,52,na,1885,1346.9861677857587
STAT,1834,37,na,1871,1648.9494323548165
SIM,1889,6,na,1895,3084
STAT,1931,23,45-49,1954,1.3743849131048598
SIM,1885,36,30-34,1921,5
SIM,1880,29,35-39,1909,14
SIM,1931,32,na,1963,4639
STAT,1936,27,45-49,1963,1.561636707299268
SIM,1933,38,25-29,1971,1
STAT,1819,69,na,1888,760.6955077565688
SIM,1839,21,30-34,1860,19
SIM,1848,33,40-44,1881,3
STAT,1872,29,35-39,1901,9.08374560616463
SIM,1803,82,na,1885,134
SIM,1885,24,30-34,1909,18
STAT,1846,22,na,1868,1860.089940627787
STAT,1886,48,40-44,1934,0.16873175592082962
SIM,1949,6,na,1955,4297
STAT,1919,27,45-49,1946,1.7634303203820136
SIM,1925,32,na,1957,4132
STAT,1820,44,30-34,1864,1.9513925593170842
STAT,1831,46,35-39,1877,0.10426542626045163
STAT,1856,24,na,1880,1811.0416099485892
STAT,1905,1,na,1906,3715.770782508374
STAT,1911,34,50-100,1945,0.7538942307775692
SIM,1847,84,na,1931,210
SIM,1830,44,35-39,1874,2
STAT,1853,53,25-29,1906,0.002584608658203474
STAT,1804,50,50-100,1854,0.04674943713074185
SIM,1912,31,40-44,1943,6
SIM,1851,46,50-100,1897,3
STAT,1907,24,15-19,1931,4.5486324992637055
SIM,1967,3,na,1970,4512
SIM,1751,103,na,1854,1
STAT,1805,49,na,1854,1220.0456166110364
SIM,1871,66,na,1937,1507
SIM,1883,0,na,1883,3202
STAT,1880,23,25-29,1903,56.72622035761473
STAT,1889,40,25-29,1929,0.7564867428996096
STAT,1897,20,50-100,1917,0.5182826972624405
STAT,1928,31,na,1959,4470.53899313191
STAT,1907,42,15-19,1949,0.0013289190328010967
SIM,1898,29,50-100,1927,3
STAT,1905,33,45-49,1938,1.361165432191317
SIM,1850,67,na,1917,1168
STAT,1877,24,30-34,1901,17.35237039537847
SIM,1864,31,30-34,1895,21
STAT,1846,9,na,1855,2157.8827499999998
SIM,1849,11,na,1860,2156
STAT,1888,57,na,1945,2242.768603727446
STAT,1916,48,25-29,1964,0.051253933091192146
STAT,1858,54,20-24,1912,5.322135020757585E-4
SIM,1904,21,35-39,1925,10
STAT,1888,0,na,1888,3342.5749019204113
SIM,1918,53,na,1971,3589
SIM,1927,27,na,1954,4174
SIM,1827,39,40-44,1866,4
SIM,1894,38,na,1932,3017
SIM,1924,36,25-29,1960,1
STAT,1922,17,40-44,1939,1.529333679981014
STAT,1911,44,25-29,1955,0.06358157672273437
STAT,1842,49,15-19,1891,2.7889745239777355E-4
STAT,1845,47,40-44,1892,0.1200278892624958
SIM,1885,86,na,1971,438
STAT,1872,79,na,1951,662.8932110049117
STAT,1890,3,na,1893,3053.4774489267725
SIM,1857,23,40-44,1880,1
SIM,1923,8,na,1931,4321
STAT,1942,26,25-29,1968,65.28741322602778
SIM,1930,17,40-44,1947,2
STAT,1882,52,45-49,1934,0.013269519099688475
STAT,1936,29,40-44,1965,4.209078039419083
STAT,1905,17,40-44,1922,0.2496911015556862
SIM,1830,26,35-39,1856,7
STAT,1819,39,40-44,1858,9.663196238946892
STAT,1821,70,na,1891,757.6582215572814
STAT,1910,42,20-24,1952,0.01576273230945492
STAT,1831,34,35-39,1865,8.104503609063725
STAT,1939,15,na,1954,3488.770311115008
STAT,1887,16,na,1903,2674.8474719622373
SIM,1861,11,na,1872,2380
SIM,1900,31,45-49,1931,2
SIM,1821,79,na,1900,356
SIM,1864,87,na,1951,136
STAT,1952,18,35-39,1970,4.749079254404413
SIM,1923,34,20-24,1957,2
STAT,1843,46,25-29,1889,0.04189542325697673
STAT,1904,31,40-44,1935,5.899494686273079
SIM,1923,16,20-24,1939,138
SIM,1849,70,na,1919,1001
STAT,1823,34,na,1857,1502.34473874621
STAT,1950,18,30-34,1968,13.611737934953272
STAT,1901,22,20-24,1923,91.12209164471675
SIM,1913,35,40-44,1948,1
SIM,1849,31,35-39,1880,9
STAT,1945,17,45-49,1962,0.5155055095771396
SIM,1838,29,45-49,1867,3
STAT,1866,23,40-44,1889,1.8166561830721775
STAT,1868,34,30-34,1902,15.613433753279761
STAT,1915,34,20-24,1949,2.326489888357262
STAT,1941,29,15-19,1970,0.6891589926995939
SIM,1855,11,na,1866,2313
SIM,1818,56,na,1874,1093
SIM,1895,21,15-19,1916,3
STAT,1832,43,45-49,1875,1.0959833410791706
STAT,1865,43,50-100,1908,0.900354381397406
SIM,1840,43,45-49,1883,4
SIM,1878,76,na,1954,898
STAT,1799,66,na,1865,786.4123773572719
STAT,1910,58,na,1968,3070.8226833854615
SIM,1798,62,na,1860,888
STAT,1901,40,20-24,1941,0.014729724343490479
STAT,1881,90,na,1971,239.534045415499
STAT,1893,3,na,1896,3168.7111458605355
SIM,1889,79,na,1968,1155
STAT,1897,32,30-34,1929,22.058875254614588
STAT,1917,16,25-29,1933,8.830881022482515
SIM,1876,10,na,1886,2614
STAT,1890,64,na,1954,2007.8509268708399
STAT,1915,16,20-24,1931,26.86920545219161
SIM,1876,34,30-34,1910,27
STAT,1862,28,35-39,1890,7.748101918114834
STAT,1893,16,na,1909,3034.6668900194586
STAT,1926,45,na,1971,4302.968945800594
STAT,1812,52,25-29,1864,0.011146790761030693
SIM,1903,24,25-29,1927,76
STAT,1831,28,35-39,1859,8.26342765009344
SIM,1874,23,40-44,1897,5
STAT,1931,41,45-49,1972,0.21034836618233477
SIM,1870,28,35-39,1898,10
SIM,1893,53,na,1946,2625
SIM,1890,34,45-49,1924,2
STAT,1868,16,30-34,1884,1.472335250395911
SIM,1921,23,30-34,1944,33
STAT,1922,35,40-44,1957,1.6120745975896296
STAT,1917,43,15-19,1960,0.00151152698048627
STAT,1910,24,20-24,1934,98.00054709714347
SIM,1843,85,na,1928,172
STAT,1930,21,40-44,1951,4.0816773354740485
SIM,1869,38,35-39,1907,5
STAT,1863,65,na,1928,1403.3678278086863
SIM,1859,18,20-24,1877,24
SIM,1846,99,na,1945,1
STAT,1870,84,na,1954,307.9361681023096
SIM,1872,51,na,1923,2036
STAT,1853,26,35-39,1879,8.349532762827382
STAT,1837,25,50-100,1862,0.5258284408983421
STAT,1892,31,na,1923,2834.558823984008
SIM,1803,57,na,1860,1000
SIM,1894,32,25-29,1926,17
STAT,1866,79,na,1945,608.9130079154664
STAT,1823,37,na,1860,1510.227932350983
SIM,1849,29,20-24,1878,9
STAT,1887,13,na,1900,2724.1828728064947
SIM,1870,25,30-34,1895,24
STAT,1839,77,na,1916,576.3525707011947
STAT,1880,27,40-44,1907,2.9775857933547196
SIM,1844,17,30-34,1861,1
SIM,1853,29,40-44,1882,2
STAT,1826,70,na,1896,765.8219484129608
STAT,1845,29,40-44,1874,2.531522052556576
STAT,1787,110,na,1897,1.0301506465072323E-4
STAT,1833,29,15-19,1862,0.3593674438924934
SIM,1918,39,40-44,1957,1
STAT,1830,39,45-49,1869,1.5399591688021836
SIM,1861,26,35-39,1887,11
SIM,1864,25,na,1889,2159
SIM,1823,43,45-49,1866,2
SIM,1911,43,na,1954,3383
STAT,1849,23,40-44,1872,1.8029128587179695
STAT,1815,49,20-24,1864,0.028253935558653572
STAT,1887,21,15-19,1908,3.4959301659882893
STAT,1847,41,30-34,1888,0.8615988927292354
STAT,1851,35,50-100,1886,0.9290606251827679
STAT,1864,40,25-29,1904,0.5476508884417196
STAT,1819,41,25-29,1860,1.3047827041436477
STAT,1820,40,15-19,1860,0.02648163441001548
STAT,1890,6,na,1896,3017.3432503964395
SIM,1830,59,na,1889,1240
STAT,1838,36,na,1874,1781.0324890673876
STAT,1834,77,na,1911,535.0210378915444
STAT,1879,30,20-24,1909,2.690541421327616
STAT,1875,50,na,1925,2119.7614287053434
SIM,1940,16,20-24,1956,130
STAT,1854,15,25-29,1869,4.939359654154414
SIM,1878,79,na,1957,747
SIM,1917,25,30-34,1942,39
STAT,1866,26,45-49,1892,0.9703805460935722
SIM,1885,20,15-19,1905,2
SIM,1899,38,na,1937,3043
SIM,1835,59,na,1894,1229
SIM,1814,97,na,1911,2
SIM,1919,32,35-39,1951,15
STAT,1884,47,25-29,1931,0.05352120008218881
SIM,1866,31,35-39,1897,11
SIM,1922,41,45-49,1963,1
SIM,1887,30,20-24,1917,2
STAT,1924,42,45-49,1966,0.18703188393492387
STAT,1901,25,25-29,1926,56.314095748897735
STAT,1932,16,20-24,1948,170.01353277998427
STAT,1812,90,na,1902,33.90919628504624
SIM,1862,15,25-29,1877,9
SIM,1821,36,40-44,1857,3
SIM,1943,20,na,1963,3614
STAT,1909,25,30-34,1934,35.9084333324285
STAT,1886,32,25-29,1918,10.223390758140836
SIM,1911,40,na,1951,3445
STAT,1855,47,35-39,1902,0.09869089392036023
STAT,1817,96,na,1913,3.8078667436527662
STAT,1841,39,20-24,1880,0.6086190601536487
SIM,1864,44,45-49,1908,3
SIM,1885,18,30-34,1903,4
SIM,1840,74,na,1914,684
SIM,1927,42,40-44,1969,3
SIM,1854,24,30-34,1878,26
SIM,1930,10,na,1940,4819
STAT,1923,30,30-34,1953,17.20146368348376
SIM,1943,15,30-34,1958,14
STAT,1861,41,15-19,1902,0.010882507973047389
STAT,1900,23,20-24,1923,90.03691635371695
STAT,1855,39,na,1894,1651.7960986143546
STAT,1827,36,35-39,1863,7.247428283175058
STAT,1868,30,15-19,1898,0.12948093811862096
SIM,1854,20,15-19,1874,4
STAT,1850,36,na,1886,1702.4649124482487
STAT,1905,4,na,1909,3591.297634434644
STAT,1905,43,na,1948,3143.226948109545
SIM,1890,21,30-34,1911,28
STAT,1935,15,30-34,1950,15.813599651910087
STAT,1858,31,35-39,1889,7.5889256673765155
STAT,1855,23,50-100,1878,0.334981718339886
STAT,1916,38,50-100,1954,0.40414811913090787
SIM,1868,21,20-24,1889,62
STAT,1929,31,40-44,1960,4.698878957918348
SIM,1816,52,na,1868,1180
SIM,1937,31,40-44,1968,8
STAT,1856,19,45-49,1875,0.05647787945730142
STAT,1836,35,30-34,1871,4.2177263202370705
SIM,1880,32,30-34,1912,29
STAT,1894,27,35-39,1921,11.725573357299233
STAT,1913,23,30-34,1936,27.326838877181604
SIM,1948,21,45-49,1969,2
SIM,1909,15,25-29,1924,8
STAT,1879,49,50-100,1928,0.23744982569154097
SIM,1900,4,na,1904,3425
SIM,1918,20,20-24,1938,111
STAT,1869,48,40-44,1917,0.15458450291477965
STAT,1878,64,na,1942,1709.5929702370327
STAT,1899,28,50-100,1927,0.825239280235899
STAT,1859,29,35-39,1888,7.294245772868162
STAT,1863,62,na,1925,1517.7727649311657
SIM,1918,35,25-29,1953,1
SIM,1858,84,na,1942,208
STAT,1846,62,na,1908,1288.6828842275193
STAT,1919,42,40-44,1961,0.2560642072035726
STAT,1945,22,30-34,1967,29.75777884145565
SIM,1929,23,50-100,1952,4
STAT,1883,51,45-49,1934,0.01350085573542626
STAT,1846,20,15-19,1866,2.911687301370633
STAT,1911,42,35-39,1953,0.18152268521860396
SIM,1854,39,35-39,1893,14
STAT,1856,44,45-49,1900,1.0924078576735805
STAT,1921,18,40-44,1939,1.5023547717366175
STAT,1882,32,na,1914,2193.616602135155
STAT,1840,101,na,1941,0.39739180317788936
STAT,1859,27,15-19,1886,0.3479617309717138
STAT,1824,78,na,1902,412.4949787455231
STAT,1917,31,na,1948,3756.497820623454
STAT,1846,24,30-34,1870,15.274285800086012
SIM,1893,13,na,1906,3217
SIM,1898,20,25-29,1918,78
SIM,1928,24,25-29,1952,108
STAT,1835,44,50-100,1879,0.7698234764321996
STAT,1853,50,20-24,1903,5.551109630902373E-4
STAT,1871,19,40-44,1890,0.17037803275990024
STAT,1931,20,na,1951,4501.150862525604
STAT,1870,47,30-34,1917,0.08918706467546533
SIM,1844,35,30-34,1879,3
SIM,1835,36,35-39,1871,14
STAT,1924,24,15-19,1948,5.897303660660148
STAT,1830,78,na,1908,466.7302441796803
STAT,1905,31,25-29,1936,8.061704836856448
SIM,1839,58,na,1897,1420
STAT,1879,51,25-29,1930,0.0035142313522832994
STAT,1895,16,25-29,1911,7.003099216479556
STAT,1901,43,25-29,1944,0.058538402566545134
STAT,1851,77,na,1928,633.8729687676745
STAT,1940,29,30-34,1969,37.70457823058842
SIM,1927,32,30-34,1959,20
SIM,1918,13,na,1931,4036
STAT,1811,103,na,1914,0.062163408837161004
SIM,1776,78,na,1854,264
SIM,1834,74,na,1908,651
SIM,1818,59,na,1877,1017
SIM,1839,18,na,1857,2075
STAT,1916,33,20-24,1949,2.36886526709636
STAT,1916,46,na,1962,3568.4648435910485
STAT,1845,31,25-29,1876,8.66784797214103
STAT,1856,20,50-100,1876,0.35550827230485393
SIM,1775,93,na,1868,6
STAT,1854,33,25-29,1887,7.475077369024304
SIM,1907,20,45-49,1927,1
STAT,1911,43,na,1954,3327.846087953983
SIM,1797,77,na,1874,341
SIM,1924,33,20-24,1957,2
STAT,1807,49,25-29,1856,0.2064461101741605
STAT,1882,21,30-34,1903,16.42337688725519
SIM,1836,44,na,1880,1522
SIM,1935,23,25-29,1958,120
STAT,1893,40,15-19,1933,0.01671970547775045
STAT,1887,25,30-34,1912,26.785083796407424
STAT,1903,19,35-39,1922,0.7335282545936871
STAT,1898,15,35-39,1913,0.7049642503569947
SIM,1931,30,30-34,1961,25
STAT,1841,39,50-100,1880,0.9693568469054389
STAT,1877,39,35-39,1916,6.863920343314168
STAT,1881,28,na,1909,2169.1902785615907
STAT,1906,47,25-29,1953,0.044486813159554425
STAT,1829,46,40-44,1875,0.13995792343748958
SIM,1936,34,30-34,1970,13
SIM,1836,25,25-29,1861,41
STAT,1846,42,30-34,1888,0.8204125894209887
SIM,1862,33,25-29,1895,9
STAT,1887,75,na,1962,1301.4459959650358
STAT,1937,22,35-39,1959,8.660941905773932
STAT,1925,35,20-24,1960,0.29944614297091454
SIM,1871,27,35-39,1898,11
SIM,1887,13,na,1900,2703
SIM,1913,31,25-29,1944,14
STAT,1900,28,50-100,1928,0.8354230678650584
STAT,1910,45,25-29,1955,0.046960404917239296
SIM,1922,0,na,1922,4568
SIM,1841,39,25-29,1880,2
STAT,1925,37,50-100,1962,0.47610769551386106
SIM,1885,39,35-39,1924,11
SIM,1854,42,30-34,1896,1
SIM,1839,24,35-39,1863,6
STAT,1890,49,45-49,1939,0.15055099536975589
SIM,1867,36,na,1903,2047
SIM,1875,19,20-24,1894,14
STAT,1867,19,20-24,1886,15.887072040663595
SIM,1848,36,45-49,1884,2
SIM,1922,20,40-44,1942,3
STAT,1863,27,35-39,1890,8.012601244571805
STAT,1833,39,25-29,1872,2.145900038764557
STAT,1873,24,na,1897,2253.6675750973404
SIM,1876,13,na,1889,2579
STAT,1868,37,35-39,1905,6.379612724485203
SIM,1806,93,na,1899,11
STAT,1828,43,25-29,1871,0.5570783005117225
SIM,1931,35,na,1966,4702
STAT,1860,48,20-24,1908,0.009097353305301656
STAT,1928,5,na,1933,4786.562573195769
STAT,1787,81,na,1868,197.45284831306674
SIM,1903,28,40-44,1931,3
STAT,1931,21,25-29,1952,113.51956632702442
STAT,1834,110,na,1944,1.7104122320026776E-4
SIM,1859,28,30-34,1887,26
STAT,1928,34,30-34,1962,18.588411383502418
STAT,1898,56,na,1954,2608.338914478949
SIM,1892,68,na,1960,1950
SIM,1823,34,na,1857,1521
SIM,1876,37,35-39,1913,13
SIM,1914,29,25-29,1943,69
SIM,1945,22,35-39,1967,17
STAT,1839,16,40-44,1855,0.16047963160460108
SIM,1906,38,30-34,1944,2
STAT,1922,46,na,1968,3997.2693390759473
SIM,1895,25,30-34,1920,37
STAT,1866,49,30-34,1915,0.08255137386157607
STAT,1914,20,40-44,1934,3.13209802674494
SIM,1911,19,35-39,1930,3
STAT,1862,25,30-34,1887,20.6629905838153
SIM,1834,45,50-100,1879,1
STAT,1867,50,50-100,1917,0.01358865433540309
SIM,1858,17,25-29,1875,6
STAT,1927,23,25-29,1950,107.18967408877714
STAT,1895,34,25-29,1929,12.518972412881583
STAT,1842,50,45-49,1892,0.01048298339951186
STAT,1826,45,50-100,1871,0.2358816016369486
STAT,1935,33,50-100,1968,1.0798747480283188
SIM,1866,5,na,1871,2500
STAT,1951,12,na,1963,4419.205226855654
STAT,1920,31,20-24,1951,2.534400553220401
STAT,1933,8,na,1941,5043.82390610958
STAT,1829,81,na,1910,331.46087048092704
STAT,1843,43,20-24,1886,0.11646772630717185
SIM,1828,34,30-34,1862,19
STAT,1869,50,na,1919,1997.2301951012655
SIM,1852,16,15-19,1868,5
STAT,1890,30,25-29,1920,11.925579808616906
STAT,1858,87,na,1945,130.6608867912171
STAT,1835,22,na,1857,1773.2217685719675
STAT,1919,32,30-34,1951,16.057875748017484
STAT,1863,39,40-44,1902,3.598551751915677
STAT,1844,16,15-19,1860,5.327216462570888
STAT,1867,24,na,1891,2084.666665036274
STAT,1891,46,na,1937,2638.7136636284254
STAT,1857,54,50-100,1911,0.01093847776192905
STAT,1942,23,20-24,1965,110.09683582454778
STAT,1890,28,50-100,1918,0.7362611952355456
SIM,1770,90,na,1860,18
SIM,1781,93,na,1874,5
STAT,1941,30,45-49,1971,1.5623961464308134
STAT,1900,28,15-19,1928,0.5925247423171733
STAT,1904,34,45-49,1938,1.3449735576432809
SIM,1944,25,25-29,1969,62
STAT,1814,85,na,1899,113.10675587889472
STAT,1875,28,na,1903,2308.0584811753065
SIM,1863,36,40-44,1899,5
SIM,1912,34,45-49,1946,1
SIM,1860,66,na,1926,1339
STAT,1908,41,15-19,1949,0.0013496439777371805
STAT,1936,25,25-29,1961,59.54856789685053
STAT,1855,36,40-44,1891,3.115230502326579
STAT,1864,104,na,1968,0.4577398669833985
STAT,1856,21,na,1877,1850.6184039075695
STAT,1887,43,30-34,1930,1.2058463436904518
SIM,1871,39,40-44,1910,3
SIM,1853,31,25-29,1884,11
STAT,1906,29,25-29,1935,57.77432140483962
STAT,1870,13,na,1883,2440.34646739885
SIM,1848,18,15-19,1866,6
STAT,1904,21,30-34,1925,24.205350966732535
SIM,1867,61,na,1928,1635
STAT,1841,49,30-34,1890,0.06484691829321569
STAT,1870,26,35-39,1896,8.9623699928648
STAT,1927,21,na,1948,4263.680869648993
STAT,1873,42,25-29,1915,0.6150116136327058
STAT,1925,20,na,1945,4154.57409866824
STAT,1872,14,na,1886,2473.028159401172
SIM,1843,57,na,1900,1426
SIM,1910,24,30-34,1934,30
SIM,1926,27,30-34,1953,56
STAT,1767,110,na,1877,0.001390889518290572
SIM,1879,41,50-100,1920,1
STAT,1894,32,15-19,1926,0.173056690854168
STAT,1919,16,50-100,1935,0.07866419274057872
STAT,1890,19,45-49,1909,0.07504463891924724
STAT,1901,16,na,1917,3347.778092899054
STAT,1845,12,na,1857,2125.301407099742
STAT,1928,17,45-49,1945,0.5946827279514016
SIM,1851,52,na,1903,1601
SIM,1894,63,na,1957,2375
STAT,1849,41,35-39,1890,1.3111237676476242
STAT,1900,38,25-29,1938,0.8104253491007832
STAT,1769,93,na,1862,5.495841558507673
SIM,1875,31,45-49,1906,1
STAT,1801,81,na,1882,217.22576302570465
STAT,1902,24,30-34,1926,23.59775567092907
STAT,1859,44,30-34,1903,0.8550634251604591
SIM,1831,28,45-49,1859,3
SIM,1850,33,na,1883,1804
STAT,1855,47,50-100,1902,0.17313202480887216
STAT,1889,42,na,1931,2692.215585965845
SIM,1888,69,na,1957,1663
STAT,1918,27,30-34,1945,39.391781619811375
SIM,1878,15,20-24,1893,14
STAT,1860,29,na,1889,1825.410627041492
STAT,1812,59,na,1871,1062.3055389996198
STAT,1919,17,35-39,1936,4.3806215975649065
SIM,1858,25,na,1883,1997
SIM,1870,59,na,1929,1785
SIM,1850,22,40-44,1872,5
STAT,1871,52,30-34,1923,0.005545143616645373
STAT,1958,13,na,1971,4872.144617510835
STAT,1827,41,15-19,1868,0.012929719334999142
STAT,1939,17,20-24,1956,128.18779201813808
STAT,1943,28,35-39,1971,15.09738350276118
STAT,1892,16,45-49,1908,0.0774667602465655
STAT,1881,19,35-39,1900,0.4978176521509102
STAT,1806,51,25-29,1857,0.010203845648099003
SIM,1890,47,50-100,1937,1
SIM,1839,30,50-100,1869,5
STAT,1880,52,40-44,1932,0.010408759270131003
SIM,1833,25,45-49,1858,4
STAT,1846,15,35-39,1861,0.4917750924501246
STAT,1834,28,20-24,1862,9.453701438290626
SIM,1842,28,20-24,1870,14
SIM,1947,17,20-24,1964,135
STAT,1842,22,40-44,1864,1.871643276788689
STAT,1832,49,20-24,1881,0.007629399618631816
STAT,1858,41,45-49,1899,1.1149749519233367
STAT,1782,75,na,1857,351.4190204107292
SIM,1873,34,45-49,1907,2
SIM,1837,20,15-19,1857,2
SIM,1855,44,35-39,1899,2
STAT,1807,72,na,1879,573.4663706064663
STAT,1847,44,35-39,1891,1.3143917398764482
SIM,1890,24,35-39,1914,6
STAT,1821,49,45-49,1870,0.3499750615017622
SIM,1825,30,35-39,1855,6
SIM,1884,34,20-24,1918,2
SIM,1920,23,na,1943,3764
SIM,1927,17,35-39,1944,3
STAT,1833,27,na,1860,1730.2075863736366
STAT,1808,110,na,1918,1.0740855017556426E-4
STAT,1830,51,30-34,1881,0.003913996904186355
SIM,1877,91,na,1968,149
STAT,1860,31,50-100,1891,0.7063311545018435
STAT,1877,42,25-29,1919,0.628742403544855
SIM,1953,10,na,1963,4361
STAT,1884,21,35-39,1905,5.464099366462355
SIM,1907,32,45-49,1939,1
SIM,1818,51,50-100,1869,3
STAT,1911,22,15-19,1933,4.768206655645068
SIM,1839,43,40-44,1882,6
SIM,1919,22,25-29,1941,110
SIM,1867,37,25-29,1904,2
STAT,1820,44,50-100,1864,1.7931715370591421
SIM,1910,17,25-29,1927,5
STAT,1902,17,25-29,1919,7.554588557571312
STAT,1876,34,20-24,1910,2.613602773988233
STAT,1837,22,30-34,1859,14.719851146420186
STAT,1851,15,45-49,1866,0.05893232269583895
STAT,1900,45,30-34,1945,0.07227590966687006
SIM,1892,21,35-39,1913,9
STAT,1934,35,30-34,1969,2.3800559488086948
STAT,1881,29,50-100,1910,0.5793212363763254
STAT,1899,42,45-49,1941,0.13438322130723318
STAT,1914,43,35-39,1957,0.1881647812557288
SIM,1886,34,na,1920,2317
SIM,1905,17,15-19,1922,8
STAT,1891,2,na,1893,3116.9740934970823
SIM,1793,87,na,1880,44
SIM,1825,38,30-34,1863,7
STAT,1926,40,20-24,1966,0.020626958335326386
STAT,1877,18,30-34,1895,1.5584035343244427
SIM,1879,20,20-24,1899,53
STAT,1884,29,30-34,1913,23.34028537750081
STAT,1906,53,na,1959,2983.8679131242184
STAT,1847,47,na,1894,1647.6898259695704
STAT,1919,26,na,1945,3836.941900371624
SIM,1864,4,na,1868,2556
STAT,1909,9,na,1918,3674.9164820670753
STAT,1851,46,na,1897,1654.529436977718
STAT,1826,36,15-19,1862,0.06263459591677399
SIM,1901,50,na,1951,2919
STAT,1869,4,na,1873,2715.4972784850415
STAT,1839,109,na,1948,4.7438152410283807E-4
STAT,1884,33,50-100,1917,0.8517420328396678
STAT,1941,28,50-100,1969,0.9721671614160451
SIM,1912,21,30-34,1933,23
STAT,1880,45,35-39,1925,0.14054714271540375
STAT,1882,24,35-39,1906,5.330684230369224
STAT,1864,19,na,1883,2180.0076553777317
STAT,1861,26,25-29,1887,33.667300914147866
STAT,1923,49,15-19,1972,4.047456059896366E-4
STAT,1957,15,15-19,1972,56.547773258460936
STAT,1912,46,35-39,1958,0.11731824914290083
SIM,1889,37,45-49,1926,2
STAT,1841,56,na,1897,1395.5004163106523
STAT,1909,43,25-29,1952,0.06270276238331529
STAT,1813,54,35-39,1867,0.023876901960391095
SIM,1848,94,na,1942,11
SIM,1866,100,na,1966,5
SIM,1892,29,30-34,1921,39
STAT,1879,15,30-34,1894,1.581150103026474
SIM,1887,21,25-29,1908,57
STAT,1897,45,45-49,1942,0.16986725678116293
SIM,1823,33,35-39,1856,10
SIM,1869,62,na,1931,1647
STAT,1910,19,40-44,1929,0.26034156144984055
STAT,1898,34,40-44,1932,5.498427997307139
STAT,1881,50,na,1931,1992.222433495701
SIM,1783,97,na,1880,1
STAT,1879,21,25-29,1900,56.69681083428811
STAT,1817,38,30-34,1855,16.99545897420126
SIM,1818,50,na,1868,1232
STAT,1856,83,na,1939,293.7282915191994
SIM,1865,33,40-44,1898,6
STAT,1876,26,50-100,1902,0.6260043902086281
SIM,1879,86,na,1965,438
STAT,1869,26,25-29,1895,38.814722013724065
STAT,1824,33,45-49,1857,3.5299208862676172
SIM,1846,39,45-49,1885,3
STAT,1832,79,na,1911,422.7199485254839
STAT,1952,4,na,1956,4452.263157793793
SIM,1927,7,na,1934,4606
STAT,1856,55,na,1911,1529.8888392887034
STAT,1864,49,50-100,1913,0.2030331477830298
SIM,1862,30,20-24,1892,2
SIM,1837,39,35-39,1876,10
STAT,1903,16,30-34,1919,2.1474745313762953
SIM,1826,36,25-29,1862,4
STAT,1876,27,15-19,1903,0.4424758511572516
STAT,1818,43,30-34,1861,2.6527208634930823
STAT,1814,53,40-44,1867,0.02677651878833853
SIM,1893,27,25-29,1920,51
STAT,1818,44,na,1862,1387.5885504222829
SIM,1851,20,35-39,1871,5
STAT,1887,16,35-39,1903,0.581133078052818
SIM,1843,36,25-29,1879,2
SIM,1874,26,45-49,1900,1
SIM,1925,35,30-34,1960,1
STAT,1927,32,20-24,1959,2.834828799833924
STAT,1855,100,na,1955,0.751896076494182
STAT,1857,33,40-44,1890,3.2161433372711694
STAT,1913,18,50-100,1931,0.0721587819591336
STAT,1805,53,30-34,1858,0.01701935306641546
STAT,1835,43,30-34,1878,0.8485511350818128
STAT,1829,39,35-39,1868,6.088771352076939
STAT,1891,24,45-49,1915,0.810278366514547
STAT,1855,39,45-49,1894,1.3976508799648464
STAT,1838,20,25-29,1858,51.39055744032828
SIM,1935,32,20-24,1967,2
SIM,1849,42,na,1891,1700
SIM,1787,87,na,1874,43
SIM,1774,80,na,1854,162
STAT,1853,31,15-19,1884,0.10989227945238955
STAT,1912,47,50-100,1959,0.2052993197463558
SIM,1906,28,na,1934,3325
STAT,1880,16,50-100,1896,0.048817452935646495
STAT,1809,46,25-29,1855,0.2140237506190772
STAT,1810,64,na,1874,903.9772745636651
STAT,1828,40,20-24,1868,0.14487352344282262
SIM,1819,46,50-100,1865,2
STAT,1835,100,na,1935,0.6623919465437248
STAT,1825,91,na,1916,32.76335511524225
STAT,1886,38,50-100,1924,1.2193615237258622
STAT,1908,54,na,1962,3056.0970800047035
STAT,1801,87,na,1888,61.033541910787996
SIM,1826,43,30-34,1869,3
SIM,1852,36,35-39,1888,12
STAT,1925,26,na,1951,4194.7917976111075
STAT,1830,44,25-29,1874,0.4751024899577282
SIM,1863,8,na,1871,2387
STAT,1928,18,50-100,1946,0.4448434944031266
SIM,1901,6,na,1907,3520
STAT,1844,36,35-39,1880,5.826018273400166
STAT,1917,35,30-34,1952,1.8052550606315056
SIM,1910,33,na,1943,3344
STAT,1885,34,30-34,1919,16.292035207806535
SIM,1893,34,30-34,1927,32
STAT,1829,49,45-49,1878,0.18551391377826498
STAT,1908,38,25-29,1946,0.8663513069979908
STAT,1840,43,40-44,1883,1.613217225231186
STAT,1841,33,45-49,1874,1.4326430188633732
SIM,1911,16,30-34,1927,2
STAT,1881,50,35-39,1931,0.007965548113687519
STAT,1849,49,30-34,1898,0.06831575463895345
STAT,1843,20,35-39,1863,5.361170002971258
STAT,1920,22,25-29,1942,97.01457394626169
SIM,1889,19,15-19,1908,6
STAT,1902,63,na,1965,2592.7103033153903
STAT,1852,93,na,1945,22.204645958637318
STAT,1837,49,50-100,1886,0.15687007011323437
SIM,1762,95,na,1857,3
STAT,1845,17,40-44,1862,0.1628343004844454
STAT,1840,18,35-39,1858,0.49184047265879455
SIM,1799,72,na,1871,495
STAT,1924,48,50-100,1972,0.25369507775350136
STAT,1775,93,na,1868,5.935823047717649
STAT,1843,28,30-34,1871,22.197963167304263
STAT,1928,30,15-19,1958,0.15198116542057
SIM,1883,29,20-24,1912,17
SIM,1895,17,na,1912,3166
SIM,1863,44,30-34,1907,8
STAT,1903,22,25-29,1925,76.93999427680279
STAT,1923,25,45-49,1948,1.886666312577745
SIM,1925,28,25-29,1953,71
SIM,1863,20,25-29,1883,52
STAT,1864,13,na,1877,2280.8752820739774
STAT,1873,27,na,1900,2288.457007804845
STAT,1878,16,25-29,1894,5.586645680603984
STAT,1860,28,30-34,1888,19.40049807951499
SIM,1928,34,50-100,1962,1
STAT,1876,37,25-29,1913,2.807952589806043
SIM,1942,28,25-29,1970,68
SIM,1846,20,25-29,1866,49
SIM,1944,22,20-24,1966,106
STAT,1913,45,40-44,1958,0.14602574211077116
STAT,1815,43,45-49,1858,4.020812720292817
SIM,1840,43,na,1883,1612
STAT,1948,23,na,1971,3960.048630045302
SIM,1851,28,30-34,1879,19
SIM,1914,57,na,1971,3551
SIM,1888,20,30-34,1908,24
SIM,1857,77,na,1934,625
SIM,1902,32,25-29,1934,14
STAT,1902,35,50-100,1937,0.35663606487696314
STAT,1853,41,na,1894,1721.789105591623
SIM,1912,28,na,1940,3311
STAT,1835,36,25-29,1871,2.244098357498482
STAT,1890,33,na,1923,2744.6223372357344
STAT,1934,28,25-29,1962,83.60527568263342
STAT,1824,44,na,1868,1414.3735780161876
SIM,1930,35,40-44,1965,1
STAT,1882,34,45-49,1916,1.5892843528010714
STAT,1918,43,35-39,1961,0.20193134162220272
SIM,1825,66,na,1891,846
STAT,1860,20,35-39,1880,5.148941337220609
STAT,1899,32,35-39,1931,13.110636079668367
SIM,1874,49,na,1923,2105
SIM,1931,25,45-49,1956,3
STAT,1881,44,40-44,1925,2.023969807358447
STAT,1821,54,25-29,1875,0.004996425080878357
STAT,1854,30,20-24,1884,2.035117847641379
STAT,1855,20,25-29,1875,48.05236274445295
STAT,1931,1,na,1932,5163.88704543931
STAT,1838,39,45-49,1877,1.6068884248192135
SIM,1857,41,35-39,1898,4
STAT,1917,28,25-29,1945,64.97688989330696
SIM,1863,77,na,1940,669
STAT,1944,27,40-44,1971,4.758949141676598
STAT,1875,29,20-24,1904,11.304442956130094
STAT,1860,42,45-49,1902,1.1476452936401593
STAT,1804,54,25-29,1858,0.010118924183526251
SIM,1911,22,25-29,1933,92
STAT,1887,47,na,1934,2365.867497917202
SIM,1870,87,na,1957,164
SIM,1832,33,45-49,1865,2
STAT,1806,59,na,1865,985.9528479369054
STAT,1850,47,15-19,1897,2.802878529865675E-4
SIM,1941,25,na,1966,3526
STAT,1844,17,50-100,1861,0.043719081612236546
STAT,1854,52,30-34,1906,0.004263577834688332
SIM,1852,40,50-100,1892,1
SIM,1945,1,na,1946,4043
STAT,1845,103,na,1948,0.10108930351627432
STAT,1876,44,30-34,1920,1.1060857834050117
STAT,1818,36,25-29,1854,10.732925794565643
STAT,1809,53,30-34,1862,0.020226786952020778
SIM,1829,28,na,1857,1648
STAT,1833,54,20-24,1887,4.4477531816988194E-4
STAT,1907,20,50-100,1927,0.5691716123483633
STAT,1871,45,25-29,1916,0.05448270990609974
STAT,1883,85,na,1968,519.6880332536331
STAT,1859,15,45-49,1874,0.05784631022570856
STAT,1885,27,25-29,1912,39.81322421350278
STAT,1908,45,30-34,1953,0.07726353682524649
SIM,1901,24,20-24,1925,78
SIM,1885,1,na,1886,2990
STAT,1821,39,35-39,1860,13.010694309921364
STAT,1891,46,50-100,1937,0.1624543449098649
STAT,1928,40,25-29,1968,0.08624629886219234
STAT,1890,16,40-44,1906,0.21177682649875176
SIM,1943,27,30-34,1970,55
STAT,1900,68,na,1968,2301.3575777411193
SIM,1889,17,na,1906,2980
STAT,1842,29,25-29,1871,36.719037424897266
SIM,1861,25,20-24,1886,9
SIM,1868,18,30-34,1886,2
SIM,1825,40,45-49,1865,5
SIM,1865,18,15-19,1883,10
STAT,1889,70,na,1959,1749.092502700088
STAT,1867,44,20-24,1911,0.13896579255534078
STAT,1884,31,45-49,1915,1.6345800211564456
STAT,1877,32,15-19,1909,0.13960466048482698
SIM,1831,25,40-44,1856,3
STAT,1827,27,na,1854,1486.61668647918
STAT,1870,23,30-34,1893,16.437338265534414
STAT,1813,48,40-44,1861,0.5091462941613222
STAT,1863,15,35-39,1878,0.5261253179658177
STAT,1869,41,20-24,1910,0.14588158601199389
SIM,1914,47,50-100,1961,2
STAT,1940,25,15-19,1965,0.6805887775444766
SIM,1789,82,na,1871,116
SIM,1873,31,40-44,1904,8
STAT,1954,5,na,1959,4591.64758642252
STAT,1926,43,25-29,1969,0.08304237080814976
STAT,1834,38,30-34,1872,4.061085591654767
STAT,1909,36,na,1945,3379.413382227417
SIM,1892,19,20-24,1911,17
STAT,1869,56,na,1925,1865.1163896200828
SIM,1874,32,50-100,1906,3
SIM,1919,16,30-34,1935,16
STAT,1921,21,30-34,1942,30.76261152870455
STAT,1855,54,40-44,1909,0.007251031734439473
SIM,1827,92,na,1919,12
STAT,1865,66,na,1931,1406.9997923639244
SIM,1813,41,na,1854,1421
STAT,1897,35,35-39,1932,9.020904302129157
SIM,1812,65,na,1877,800
STAT,1879,18,35-39,1897,0.5403934611626366
SIM,1821,70,na,1891,754
SIM,1889,34,40-44,1923,5
SIM,1901,27,25-29,1928,62
STAT,1881,22,na,1903,2157.2648428036364
STAT,1932,39,15-19,1971,0.02432327323898908
STAT,1817,40,45-49,1857,4.0971984564493455
STAT,1936,22,20-24,1958,100.41014546018225
SIM,1906,16,20-24,1922,25
STAT,1871,42,20-24,1913,0.14855218758567273
SIM,1854,94,na,1948,9
STAT,1853,25,20-24,1878,10.225023435792277
SIM,1880,18,na,1898,2587
STAT,1895,16,50-100,1911,0.06054551414746126
STAT,1885,80,na,1965,856.9706937425433
STAT,1884,19,20-24,1903,16.461532434287356
STAT,1909,37,30-34,1946,1.6292911614425156
STAT,1898,37,45-49,1935,2.549324491590563
SIM,1951,18,25-29,1969,60
STAT,1889,44,40-44,1933,2.587858258329085
STAT,1943,18,25-29,1961,43.39655533256743
STAT,1912,53,na,1965,3263.706988234005
SIM,1878,21,15-19,1899,5
SIM,1892,34,na,1926,2827
STAT,1893,19,30-34,1912,1.900192158264984
SIM,1897,44,40-44,1941,1
STAT,1890,67,na,1957,1881.5079814855303
STAT,1900,48,35-39,1948,0.1021989555371226
STAT,1888,15,40-44,1903,0.2050700495565928
STAT,1819,109,na,1928,3.552937495841487E-4
SIM,1932,30,45-49,1962,2
STAT,1847,72,na,1919,929.223801449669
STAT,1875,35,15-19,1910,0.055017731748937065
STAT,1857,18,15-19,1875,5.164145784017302
SIM,1812,93,na,1905,12
STAT,1855,29,35-39,1884,7.02110043584195
STAT,1866,14,na,1880,2324.016024029713
STAT,1918,37,40-44,1955,1.4905579660306438
SIM,1892,31,45-49,1923,5
STAT,1835,26,15-19,1861,0.37160561704814304
STAT,1880,39,40-44,1919,4.307437688876006
STAT,1900,35,20-24,1935,1.0198611016186083
STAT,1920,38,40-44,1958,1.546894701468782
STAT,1933,21,na,1954,4589.883593852116
SIM,1864,34,35-39,1898,11
STAT,1895,31,20-24,1926,3.34594825343439
STAT,1861,48,35-39,1909,0.10844675584519194
STAT,1864,107,na,1971,0.06394175873348153
SIM,1875,62,na,1937,1754
SIM,1938,27,20-24,1965,15
SIM,1894,69,na,1963,2096
STAT,1844,33,30-34,1877,14.50577449170465
STAT,1851,28,20-24,1879,10.0004383895408
SIM,1934,31,50-100,1965,1
SIM,1887,37,40-44,1924,3
STAT,1826,28,30-34,1854,76.71014021356442
SIM,1880,44,30-34,1924,1
SIM,1867,34,20-24,1901,2
STAT,1812,46,30-34,1858,0.323753964380902
STAT,1898,19,15-19,1917,7.548563706999917
STAT,1814,110,na,1924,1.140159756975405E-4
STAT,1828,110,na,1938,1.568706382462113E-4
SIM,1863,29,35-39,1892,8
STAT,1808,48,30-34,1856,0.36242745527271525
STAT,1932,9,na,1941,4979.84107846969
STAT,1830,54,35-39,1884,0.005334109969235531
STAT,1912,22,35-39,1934,8.522767672640072
STAT,1885,37,35-39,1922,6.656887700801271
STAT,1832,73,na,1905,718.1847678812562
SIM,1875,29,30-34,1904,23
SIM,1893,37,35-39,1930,15
STAT,1864,52,25-29,1916,0.0029746393225292067
SIM,1926,33,25-29,1959,10
SIM,1853,47,na,1900,1802
SIM,1886,6,na,1892,2542
STAT,1929,4,na,1933,4866.417234123245
SIM,1842,38,30-34,1880,1
SIM,1834,28,30-34,1862,26
SIM,1946,18,15-19,1964,41
STAT,1909,40,20-24,1949,0.015777581296853766
STAT,1848,43,40-44,1891,1.608725614608125
SIM,1939,15,na,1954,3423
STAT,1891,48,15-19,1939,2.6051923924725657E-4
STAT,1903,11,na,1914,3476.1571021138966
SIM,1850,25,45-49,1875,5
STAT,1908,35,20-24,1943,0.2353186900964321
SIM,1856,43,40-44,1899,7
SIM,1920,22,35-39,1942,15
STAT,1872,44,30-34,1916,1.0754035218468752
SIM,1834,49,na,1883,1412
STAT,1837,25,35-39,1862,7.931438750337943
SIM,1877,16,15-19,1893,6
STAT,1888,23,na,1911,2631.2624597697627
SIM,1866,41,45-49,1907,4
SIM,1859,30,45-49,1889,1
STAT,1854,29,na,1883,1775.7932101030326
STAT,1853,19,50-100,1872,0.0431926069181009
STAT,1863,45,35-39,1908,0.1174169432447982
STAT,1869,34,50-100,1903,0.8306753200608877
SIM,1852,33,30-34,1885,23
STAT,1858,39,30-34,1897,3.9127918326186584
STAT,1938,18,15-19,1956,42.27353298772089
SIM,1904,33,na,1937,3184
STAT,1842,25,45-49,1867,0.9919638021283976
STAT,1856,34,35-39,1890,7.428803579325978
STAT,1844,41,15-19,1885,0.010056940578288159
SIM,1850,29,25-29,1879,39
SIM,1934,28,35-39,1962,27
STAT,1914,35,15-19,1949,0.01828177776596697
SIM,1851,18,20-24,1869,17
STAT,1926,28,35-39,1954,16.94448091973887
STAT,1791,86,na,1877,67.1050185365907
STAT,1869,28,na,1897,2174.642876428931
STAT,1843,82,na,1925,336.6184078970165
STAT,1874,40,na,1914,2254.09226194596
SIM,1919,32,na,1951,3863
STAT,1836,31,15-19,1867,0.11485747988611361
STAT,1879,37,40-44,1916,4.322486712776932
SIM,1828,40,na,1868,1486
STAT,1935,27,30-34,1962,50.45445860254951
STAT,1869,16,15-19,1885,5.534517214736709
STAT,1934,38,35-39,1972,3.1499429118138957
SIM,1873,61,na,1934,1787
STAT,1913,41,50-100,1954,0.10882717558934057
SIM,1854,48,50-100,1902,3
STAT,1876,38,na,1914,2286.2829620063058
SIM,1836,75,na,1911,635
SIM,1883,39,30-34,1922,6
STAT,1887,32,50-100,1919,0.9680102411850076
STAT,1904,46,45-49,1950,0.1808710757407026
STAT,1927,35,25-29,1962,1.1585908379934362
STAT,1830,41,20-24,1871,0.1224737291628755
STAT,1950,20,45-49,1970,1.2619527306136933
STAT,1870,46,50-100,1916,0.22798989986118767
STAT,1783,107,na,1890,0.006787426870811908
SIM,1896,45,50-100,1941,1
STAT,1863,31,na,1894,1989.7232852158108
STAT,1846,27,50-100,1873,0.5456341785119327
SIM,1895,32,50-100,1927,1
SIM,1832,30,40-44,1862,4
STAT,1896,52,na,1948,2674.0613015314593
SIM,1876,44,na,1920,2262
SIM,1831,38,na,1869,1594
SIM,1869,25,20-24,1894,9
SIM,1908,38,35-39,1946,5
SIM,1918,32,20-24,1950,2
STAT,1901,19,30-34,1920,2.0962503992315598
SIM,1893,24,20-24,1917,80
STAT,1894,23,na,1917,2865.1741586514413
STAT,1838,98,na,1936,2.215584087219919
SIM,1845,52,na,1897,1516
SIM,1933,22,45-49,1955,2
STAT,1868,36,20-24,1904,0.6986344516581668
STAT,1897,37,na,1934,2976.5777581615657
STAT,1820,47,35-39,1867,0.23083949453565172
STAT,1854,49,40-44,1903,0.12070613638593304
SIM,1847,22,35-39,1869,9
STAT,1939,24,50-100,1963,0.6237721546547154
SIM,1861,76,na,1937,729
STAT,1818,46,35-39,1864,0.3039043808750364
STAT,1877,50,45-49,1927,0.014431210482463205
STAT,1906,49,15-19,1955,3.039024069453904E-4
STAT,1843,30,45-49,1873,1.544204132903676
SIM,1860,33,20-24,1893,1
STAT,1839,22,35-39,1861,4.999390439610379
STAT,1834,34,15-19,1868,0.11059182631675712
STAT,1918,33,25-29,1951,9.239002169550725
SIM,1867,40,50-100,1907,1
STAT,1842,33,50-100,1875,0.7800578044516405
SIM,1935,35,25-29,1970,1
SIM,1945,15,na,1960,3678
STAT,1875,39,30-34,1914,5.120498388484243
SIM,1830,53,na,1883,1404
STAT,1908,48,35-39,1956,0.10981976660518336
STAT,1849,100,na,1949,0.7652240075708098
STAT,1935,30,50-100,1965,1.0817667370627657
STAT,1826,43,20-24,1869,0.15356804587027217
STAT,1853,47,30-34,1900,0.07145296061423859
SIM,1825,43,50-100,1868,2
STAT,1831,43,30-34,1874,0.8641026950484176
SIM,1826,33,20-24,1859,1
STAT,1874,33,40-44,1907,4.169566384764654
SIM,1846,36,40-44,1882,7
SIM,1928,43,na,1971,4462
STAT,1815,109,na,1924,3.045056696717685E-4
SIM,1845,80,na,1925,421
STAT,1862,31,25-29,1893,8.287608633483737
STAT,1897,44,50-100,1941,0.09143581430202333
STAT,1926,33,15-19,1959,0.14671663715860045
STAT,1843,36,15-19,1879,0.04778901334906123
STAT,1868,40,na,1908,2105.720409333716
STAT,1914,40,30-34,1954,0.1204895056940691
SIM,1948,15,15-19,1963,43
STAT,1795,76,na,1871,362.10292923260846
STAT,1845,46,na,1891,1589.245262375632
SIM,1825,38,na,1863,1507
SIM,1886,16,25-29,1902,8
STAT,1859,97,na,1956,4.719256638556396
STAT,1936,32,30-34,1968,14.454246267426043
STAT,1862,53,35-39,1915,0.006826116499325054
STAT,1860,24,15-19,1884,2.573654781320904
STAT,1877,20,45-49,1897,0.6876749009369153
STAT,1882,38,na,1920,2154.990146927839
SIM,1845,15,25-29,1860,6
STAT,1816,39,25-29,1855,9.961484136689526
STAT,1822,54,45-49,1876,0.018722363989951113
SIM,1882,44,na,1926,2072
SIM,1868,28,40-44,1896,3
STAT,1857,31,na,1888,1806.843780512082
STAT,1894,26,20-24,1920,14.30522117914839
STAT,1773,92,na,1865,7.423278914282599
STAT,1804,51,20-24,1855,0.002238826875226307
STAT,1903,26,40-44,1929,4.039953541629389
STAT,1924,30,45-49,1954,1.7423214629779384
STAT,1913,49,20-24,1962,0.010127788330078973
STAT,1873,95,na,1968,54.592551669863646
SIM,1851,30,45-49,1881,2
SIM,1775,100,na,1875,1
STAT,1838,36,40-44,1874,3.6402196980499357
STAT,1861,16,15-19,1877,5.3826818984611515
SIM,1888,42,40-44,1930,6
STAT,1852,33,20-24,1885,2.1044053307446933
SIM,1834,42,50-100,1876,3
STAT,1933,32,45-49,1965,2.0033304378808214
SIM,1795,82,na,1877,141
SIM,1837,23,na,1860,1778
STAT,1871,37,40-44,1908,4.099721595664319
SIM,1816,55,na,1871,1107
STAT,1893,34,20-24,1927,3.212190517825519
STAT,1885,24,20-24,1909,64.45298818105908
SIM,1903,21,20-24,1924,95
STAT,1793,104,na,1897,0.012131842879670314
STAT,1836,41,25-29,1877,0.48863026948510524
STAT,1915,36,na,1951,3607.3354962814124
STAT,1841,23,35-39,1864,5.0214968115417875
SIM,1911,26,40-44,1937,7
STAT,1881,40,25-29,1921,0.5916499956548387
STAT,1844,98,na,1942,2.2805057360736822
STAT,1846,50,50-100,1896,0.010801556583818293
STAT,1885,42,15-19,1927,0.012981524502027521
SIM,1824,39,25-29,1863,1
STAT,1921,36,na,1957,3972.423943138658
SIM,1918,17,50-100,1935,1
STAT,1850,98,na,1948,2.2869805228130713
STAT,1794,60,na,1854,910.9999999999999
STAT,1880,20,20-24,1900,68.90761377830817
STAT,1839,46,na,1885,1548.1474717697172
STAT,1875,31,50-100,1906,0.8928851899347744
STAT,1913,48,45-49,1961,0.1997972029564244
STAT,1925,22,45-49,1947,1.2724928969162839
STAT,1891,80,na,1971,1167.5094886699064
SIM,1942,25,20-24,1967,18
STAT,1826,42,50-100,1868,1.0407854442232805
STAT,1833,32,40-44,1865,3.4010310897768146
SIM,1843,23,na,1866,1886
STAT,1827,35,20-24,1862,0.8096760377521148
STAT,1944,23,25-29,1967,94.18299909797369
SIM,1898,59,na,1957,2519
STAT,1955,15,50-100,1970,0.4700663915782406
STAT,1828,50,30-34,1878,0.005037355936886787
SIM,1805,83,na,1888,116
SIM,1833,22,40-44,1855,4
SIM,1888,23,35-39,1911,7
SIM,1838,44,35-39,1882,1
STAT,1824,30,40-44,1854,14.253786789154235
SIM,1841,32,40-44,1873,7
STAT,1859,47,35-39,1906,0.10505735958274193
STAT,1823,51,25-29,1874,0.0041464266823317
STAT,1899,48,15-19,1947,2.884373358618174E-4
STAT,1890,42,25-29,1932,0.7407955561371418
STAT,1891,21,40-44,1912,2.4439680321108352
STAT,1876,40,15-19,1916,0.013604008969709702
STAT,1911,17,35-39,1928,0.7930704856345522
SIM,1801,56,na,1857,1063
STAT,1857,36,45-49,1893,1.4917964767230099
SIM,1872,29,45-49,1901,4
SIM,1928,22,35-39,1950,9
STAT,1930,41,25-29,1971,0.08889279575574721
STAT,1934,25,20-24,1959,23.217577282127625
SIM,1947,8,na,1955,4005
STAT,1837,17,na,1854,1923.024919108426
SIM,1830,50,na,1880,1484
SIM,1904,64,na,1968,2587
STAT,1926,25,30-34,1951,44.67921500310385
SIM,1879,23,25-29,1902,49
SIM,1911,38,40-44,1949,1
STAT,1848,26,na,1874,1873.9749260967756
STAT,1789,76,na,1865,329.43367748267946
STAT,1863,54,30-34,1917,0.0048071465718619215
STAT,1953,6,na,1959,4492.569245792548
SIM,1847,16,na,1863,2038
STAT,1932,15,45-49,1947,0.6278000654417453
STAT,1864,26,40-44,1890,2.5378663477041195
SIM,1809,76,na,1885,387
SIM,1949,9,na,1958,4296
STAT,1889,35,45-49,1924,2.3470280476503187
SIM,1822,55,na,1877,1226
STAT,1815,103,na,1918,0.061424608520775824
STAT,1876,47,35-39,1923,0.1358992192359681
STAT,1917,25,20-24,1942,18.206378484994776
STAT,1825,29,25-29,1854,139.3644582986882
SIM,1874,18,na,1892,2410
SIM,1869,48,50-100,1917,4
STAT,1874,18,15-19,1892,5.7149833084177555
STAT,1943,14,na,1957,3933.5133257884945
STAT,1906,26,50-100,1932,0.8829864589131489
SIM,1796,61,na,1857,885
SIM,1846,17,35-39,1863,2
STAT,1900,25,50-100,1925,0.8440619503357871
STAT,1838,17,35-39,1855,0.4943303653235097
STAT,1847,29,45-49,1876,0.9678804895506595
STAT,1825,40,35-39,1865,2.1146885187544258
STAT,1940,15,50-100,1955,0.3595180465206202
STAT,1797,71,na,1868,603.9135856452829
STAT,1854,20,na,1874,1835.298992650435
STAT,1840,51,25-29,1891,0.00247851925647588
STAT,1867,95,na,1962,29.014426166803307
STAT,1867,47,25-29,1914,0.0508530373780161
STAT,1823,65,na,1888,898.7894183818701
SIM,1885,55,na,1940,1982
SIM,1842,40,45-49,1882,9
SIM,1934,25,30-34,1959,52
STAT,1892,31,35-39,1923,12.029347265229253
STAT,1821,36,30-34,1857,11.862887800268835
STAT,1830,48,40-44,1878,0.12386649788368946
STAT,1840,47,20-24,1887,0.00842736836017971
STAT,1853,35,30-34,1888,4.0353973247541495
SIM,1951,15,20-24,1966,148
SIM,1865,36,45-49,1901,1
SIM,1886,0,na,1886,3250
STAT,1872,45,na,1917,2154.5723370367377
STAT,1816,80,na,1896,288.2637657200925
STAT,1912,24,25-29,1936,86.58214969528971
SIM,1872,26,40-44,1898,2
STAT,1785,86,na,1871,69.03209528147305
SIM,1871,35,na,1906,2289
SIM,1871,42,30-34,1913,4
STAT,1916,12,na,1928,3958.2218130015744
STAT,1869,103,na,1972,1.5450301808507865
STAT,1850,20,40-44,1870,1.786337604428812
STAT,1849,45,15-19,1894,2.91190476571898E-4
SIM,1879,30,30-34,1909,28
SIM,1833,40,35-39,1873,5
STAT,1872,40,15-19,1912,0.013226640624767297
SIM,1929,18,15-19,1947,51
STAT,1833,34,50-100,1867,0.7035900266169437
STAT,1842,35,na,1877,1826.7278008705737
SIM,1919,19,35-39,1938,5
SIM,1784,76,na,1860,277
STAT,1931,29,na,1960,4564.537714884833
SIM,1833,29,25-29,1862,42
SIM,1925,25,20-24,1950,21
SIM,1939,19,20-24,1958,129
STAT,1895,46,25-29,1941,0.04016886423486309
STAT,1863,42,30-34,1905,0.9535247249302334
STAT,1872,54,40-44,1926,0.009707833717367597
STAT,1845,52,20-24,1897,5.170096129180006E-4
SIM,1929,36,45-49,1965,3
STAT,1875,41,45-49,1916,1.4591186264828224
SIM,1846,29,35-39,1875,8
SIM,1865,6,na,1871,2445
STAT,1896,15,30-34,1911,1.9992431571530231
STAT,1907,30,45-49,1937,1.4004417680752315
SIM,1911,12,na,1923,3767
SIM,1874,15,na,1889,2429
STAT,1912,22,na,1934,3454.1733613327992
STAT,1921,36,35-39,1957,2.5539022625711314
SIM,1861,35,30-34,1896,4
STAT,1922,41,35-39,1963,0.21867588994676812
SIM,1803,51,na,1854,1140
STAT,1823,68,na,1891,804.1957688189186
STAT,1833,23,45-49,1856,0.5807548149574648
STAT,1848,28,15-19,1876,0.3874049810890205
STAT,1918,42,20-24,1960,0.01773792460901663
STAT,1879,46,50-100,1925,0.24320185912793582
STAT,1851,19,25-29,1870,4.992992335046288
STAT,1926,37,30-34,1963,2.104475125628219
SIM,1858,56,na,1914,1653
STAT,1891,22,50-100,1913,0.4768320676334493
STAT,1808,50,45-49,1858,0.05494215225180852
STAT,1897,23,50-100,1920,0.5136166741442959
SIM,1858,53,na,1911,1702
STAT,1891,12,na,1903,3019.7452871242413
SIM,1904,30,na,1934,3189
STAT,1916,15,na,1931,3888.991631771738
STAT,1859,66,na,1925,1235.6899781225084
SIM,1932,20,35-39,1952,12
SIM,1883,20,na,1903,2287
STAT,1865,60,na,1925,1637.2085385208288
STAT,1867,92,na,1959,60.14007971852525
STAT,1868,16,50-100,1884,0.045256197266036975
SIM,1841,28,na,1869,1853
STAT,1935,23,15-19,1958,6.845329837741843
SIM,1866,82,na,1948,355
SIM,1883,41,45-49,1924,4
SIM,1902,26,30-34,1928,38
STAT,1835,46,35-39,1881,0.09326089890796188
STAT,1815,100,na,1915,0.4543854058334505
SIM,1907,36,25-29,1943,3
STAT,1870,25,20-24,1895,10.93312060713125
STAT,1808,51,na,1859,1239.404690494276
STAT,1889,47,45-49,1936,0.15453456814179595
SIM,1915,30,45-49,1945,2
STAT,1838,29,35-39,1867,8.251490019217696
SIM,1833,95,na,1928,6
STAT,1879,18,na,1897,2487.3305926743797
STAT,1909,47,40-44,1956,0.13682687687283257
STAT,1900,41,15-19,1941,0.0012625198149807382
STAT,1821,52,35-39,1873,0.0126377145084416
STAT,1924,41,na,1965,4179.687519649382
SIM,1876,36,20-24,1912,3
SIM,1929,22,na,1951,4434
STAT,1910,15,25-29,1925,8.147105903258847
STAT,1912,31,30-34,1943,14.701974626792948
SIM,1830,41,30-34,1871,3
STAT,1878,33,na,1911,2336.9200327069802
STAT,1873,19,45-49,1892,0.06230237761802364
STAT,1873,24,50-100,1897,0.38858568051235276
SIM,1929,24,45-49,1953,2
STAT,1922,49,30-34,1971,0.09618736286444254
STAT,1855,50,25-29,1905,0.0025446332488640658
SIM,1841,90,na,1931,38
SIM,1897,40,na,1937,3008
STAT,1839,41,40-44,1880,1.759402921329893
STAT,1853,72,na,1925,936.5727534731893
STAT,1819,50,20-24,1869,0.0013115724043357235
STAT,1930,2,na,1932,4995.361615328428
STAT,1886,41,20-24,1927,0.15923236611815547
STAT,1908,4,na,1912,3685.674795467635
STAT,1879,80,na,1959,749.3964504181104
STAT,1884,25,15-19,1909,0.4264228396327092
SIM,1847,41,40-44,1888,4
STAT,1822,53,30-34,1875,0.007833689977212172
STAT,1951,21,50-100,1972,0.742942979354272
SIM,1897,35,45-49,1932,6
SIM,1870,37,30-34,1907,6
SIM,1926,30,20-24,1956,1
SIM,1869,23,30-34,1892,15
STAT,1920,16,30-34,1936,12.951179341377756
STAT,1847,22,25-29,1869,51.63583977281737
SIM,1841,35,45-49,1876,6
SIM,1946,21,40-44,1967,2
SIM,1869,28,25-29,1897,46
STAT,1894,36,30-34,1930,6.5077831955161
STAT,1843,18,20-24,1861,16.248907094592724
STAT,1882,23,50-100,1905,0.3737030405389494
STAT,1865,31,40-44,1896,3.7380457229454773
SIM,1835,28,na,1863,1736
STAT,1878,30,na,1908,2365.687730255323
STAT,1912,56,na,1968,3210.3763600632246
STAT,1921,43,40-44,1964,0.2657420439550754
STAT,1859,17,50-100,1876,0.04287516562592152
STAT,1918,30,20-24,1948,2.4682191801727575
SIM,1814,91,na,1905,13
STAT,1856,22,35-39,1878,5.0145310898055735
STAT,1868,52,25-29,1920,0.0031778066404269567
STAT,1810,95,na,1905,6.020842375701029
SIM,1920,31,30-34,1951,27
STAT,1883,26,45-49,1909,1.0315209462933177
STAT,1768,106,na,1874,0.007490789044474706
STAT,1831,53,40-44,1884,0.006675567624012815
STAT,1922,40,50-100,1962,0.12774821228972633
STAT,1858,53,45-49,1911,0.010590027159467365
SIM,1926,8,na,1934,4512
SIM,1902,5,na,1907,3508
STAT,1813,44,25-29,1857,2.0533031375091766
STAT,1910,27,na,1937,3416.390917207965
SIM,1772,88,na,1860,31
SIM,1798,93,na,1891,4
STAT,1920,32,35-39,1952,9.456539176833536
STAT,1918,47,na,1965,3693.1794899206534
STAT,1938,21,40-44,1959,3.1443533870483815
STAT,1898,40,35-39,1938,0.16243078187348398
SIM,1873,24,35-39,1897,8
STAT,1833,35,45-49,1868,1.5493407818661888
STAT,1880,35,25-29,1915,2.889097430896897
SIM,1838,22,25-29,1860,57
SIM,1847,13,na,1860,2115
STAT,1893,47,na,1940,2684.6221031536857
STAT,1841,87,na,1928,120.54140847753494
SIM,1874,27,20-24,1901,10
SIM,1889,40,35-39,1929,6
STAT,1930,41,na,1971,4623.225242363303
STAT,1884,33,na,1917,2218.315187701449
SIM,1849,48,na,1897,1656
STAT,1931,35,15-19,1966,0.02406790976318011
STAT,1852,46,35-39,1898,0.1066701276373673
SIM,1887,18,35-39,1905,1
STAT,1837,19,40-44,1856,0.15488914028138384
STAT,1827,45,30-34,1872,0.08709581653764843
SIM,1845,49,50-100,1894,3
STAT,1852,36,25-29,1888,2.2223610608236624
STAT,1865,24,35-39,1889,4.997783100153404
SIM,1826,103,na,1929,1
STAT,1953,3,na,1956,4495.490698007223
SIM,1809,73,na,1882,527
SIM,1934,37,30-34,1971,9
STAT,1851,30,35-39,1881,7.891693308657934
STAT,1894,48,30-34,1942,0.06552123701429745
STAT,1935,30,20-24,1965,3.191370509644881
SIM,1900,71,na,1971,2072
SIM,1941,23,50-100,1964,1
STAT,1904,43,40-44,1947,0.21008702209716518
STAT,1812,47,45-49,1859,0.7765631472523883
STAT,1847,78,na,1925,574.8957759496126
SIM,1803,88,na,1891,36
STAT,1904,27,na,1931,3233.3168420380184
STAT,1804,53,50-100,1857,0.04401994830881724
STAT,1849,51,45-49,1900,0.010510464055331513
SIM,1835,90,na,1925,60
SIM,1894,38,50-100,1932,4
SIM,1903,31,30-34,1934,20
SIM,1829,39,45-49,1868,1
SIM,1860,36,25-29,1896,3
STAT,1868,2,na,1870,3022.175637706607
STAT,1862,33,15-19,1895,0.11427321456727618
STAT,1820,88,na,1908,73.13569404741318
SIM,1912,43,40-44,1955,2
SIM,1828,49,na,1877,1313
STAT,1889,29,15-19,1918,0.5253587040684113
SIM,1872,85,na,1957,257
STAT,1925,26,25-29,1951,73.70292397358163
STAT,1893,37,25-29,1930,3.451051848141018
STAT,1942,22,50-100,1964,0.6517142520043151
SIM,1824,50,na,1874,1285
STAT,1842,19,15-19,1861,5.363087298857855
STAT,1927,45,35-39,1972,0.15362538568763812
STAT,1943,17,na,1960,3687.1508843288607
SIM,1920,24,25-29,1944,97
STAT,1921,31,40-44,1952,4.131240097389288
STAT,1944,20,20-24,1964,113.49359131182885
STAT,1906,25,45-49,1931,1.5377050305652242
STAT,1897,20,30-34,1917,22.638585761205942
STAT,1848,110,na,1958,2.957053835000349E-4
STAT,1948,23,50-100,1971,0.7135375474157292
STAT,1853,48,45-49,1901,0.17282032307337114
STAT,1860,20,na,1880,1886.5790599504942
SIM,1855,29,45-49,1884,1
STAT,1845,40,20-24,1885,0.11687072805961443
SIM,1850,19,15-19,1869,7
STAT,1861,36,35-39,1897,5.575247244514875
SIM,1790,73,na,1863,430
STAT,1901,21,45-49,1922,0.9248429956522775
STAT,1877,85,na,1962,438.7407741369394
SIM,1930,19,na,1949,4407
SIM,1917,37,30-34,1954,1
STAT,1813,52,50-100,1865,0.04360217038797503
STAT,1930,33,40-44,1963,4.768274698191192
STAT,1874,36,45-49,1910,1.9340383154478034
SIM,1935,25,na,1960,4791
SIM,1889,48,na,1937,2597
SIM,1869,16,25-29,1885,5
STAT,1877,48,30-34,1925,0.09370232856845269
STAT,1870,48,45-49,1918,0.2157130677116844
SIM,1878,47,50-100,1925,3
SIM,1920,47,50-100,1967,1
STAT,1864,25,50-100,1889,0.5458720082788783
STAT,1935,37,40-44,1972,1.9773928524057778
STAT,1892,62,na,1954,2162.2183424222258
STAT,1859,40,50-100,1899,0.8045218300424128
SIM,1821,44,25-29,1865,3
STAT,1779,86,na,1865,66.29443765720723
STAT,1872,48,na,1920,2106.4991680689072
SIM,1855,22,25-29,1877,53
STAT,1826,46,25-29,1872,0.054583645754743136
STAT,1862,41,50-100,1903,0.8551809602697708
SIM,1878,18,25-29,1896,7
STAT,1822,51,40-44,1873,0.01441715220059584
SIM,1777,94,na,1871,3
SIM,1834,43,na,1877,1505
SIM,1841,17,15-19,1858,4
SIM,1784,73,na,1857,373
SIM,1891,26,45-49,1917,1
STAT,1937,19,45-49,1956,0.4576673158216127
STAT,1917,32,50-100,1949,0.8178645769434921
SIM,1855,42,na,1897,1846
STAT,1819,91,na,1910,28.93838576514369
STAT,1817,65,na,1882,843.4163542114966
STAT,1868,46,30-34,1914,0.08755927013715954
SIM,1824,35,45-49,1859,1
SIM,1908,35,30-34,1943,3
STAT,1840,107,na,1947,0.0032842689924225104
SIM,1933,26,25-29,1959,73
SIM,1884,44,30-34,1928,1
STAT,1943,25,30-34,1968,39.45458883618186
STAT,1861,23,20-24,1884,55.139427648339655
STAT,1846,54,30-34,1900,0.004081564547913341
SIM,1833,26,20-24,1859,9
STAT,1847,26,40-44,1873,2.6683771366638314
STAT,1875,31,35-39,1906,9.868868916466695
STAT,1822,51,50-100,1873,0.020682550104441675
STAT,1871,60,na,1931,1786.1566349434993
STAT,1855,17,35-39,1872,0.46221997217494076
SIM,1807,47,na,1854,1224
STAT,1802,66,na,1868,762.226436240855
SIM,1832,35,50-100,1867,1
STAT,1925,29,na,1954,4150.5671823116
STAT,1919,40,15-19,1959,0.0015765157329195101
STAT,1871,43,35-39,1914,1.6836549440469186
SIM,1928,16,40-44,1944,4
STAT,1899,36,15-19,1935,0.07304835374921421
SIM,1868,15,na,1883,2332
STAT,1951,16,25-29,1967,48.76617748032612
STAT,1849,103,na,1952,0.10344431069373909
STAT,1867,40,40-44,1907,2.0152401212533824
STAT,1847,41,na,1888,1732.1185032753126
SIM,1880,49,na,1929,2305
STAT,1922,39,20-24,1961,0.2827813436592135
STAT,1907,2,na,1909,3698.5153117406685
STAT,1889,32,40-44,1921,5.0577910466380365
SIM,1870,31,25-29,1901,12
SIM,1816,40,35-39,1856,1
STAT,1863,52,40-44,1915,0.008695763377733841
SIM,1847,44,45-49,1891,1
SIM,1897,32,40-44,1929,10
STAT,1895,43,20-24,1938,0.01349747704759479
STAT,1824,35,50-100,1859,2.0249376203522176
SIM,1883,31,35-39,1914,11
SIM,1884,70,na,1954,1294
STAT,1896,58,na,1954,2469.094152798891
STAT,1810,92,na,1902,18.860804969906198
STAT,1838,64,na,1902,1185.6027110748698
STAT,1884,43,45-49,1927,1.3870801860214554
STAT,1864,29,45-49,1893,0.9307408116548979
SIM,1839,51,50-100,1890,1
SIM,1879,55,na,1934,2029
STAT,1827,51,25-29,1878,0.0030557841188620797
STAT,1863,34,na,1897,1964.6592283055354
STAT,1897,23,35-39,1920,7.349853746753585
STAT,1900,47,20-24,1947,0.008830021162872672
SIM,1820,34,30-34,1854,15
STAT,1885,30,15-19,1915,0.1351085248704673
STAT,1885,49,35-39,1934,0.1290139555857646
STAT,1839,44,45-49,1883,1.0251543115077768
STAT,1908,23,20-24,1931,96.25019780990468
STAT,1874,74,na,1948,1071.5358611669099
STAT,1937,14,na,1951,3629.160507711222
STAT,1845,50,30-34,1895,0.0042531180586729035
SIM,1925,6,na,1931,4468
STAT,1817,52,45-49,1869,0.031100401354412225
SIM,1846,100,na,1946,1
SIM,1864,56,na,1920,1809
SIM,1901,15,25-29,1916,8
STAT,1792,65,na,1857,715.3357216832
SIM,1910,27,35-39,1937,21
STAT,1892,17,20-24,1909,20.97297297491383
STAT,1893,30,40-44,1923,5.239840577804045
STAT,1902,27,35-39,1929,12.863451122484994
STAT,1922,15,na,1937,4043.1836191296534
SIM,1884,37,25-29,1921,2
STAT,1821,46,40-44,1867,0.2652817191051163
STAT,1867,37,15-19,1904,0.04980912334312121
STAT,1881,59,na,1940,1772.7191189558935
SIM,1827,61,na,1888,981
SIM,1863,17,35-39,1880,1
STAT,1841,53,na,1894,1449.5257291639064
STAT,1869,53,20-24,1922,6.639463104071325E-4
SIM,1951,18,na,1969,4057
STAT,1911,39,45-49,1950,0.6156362519318102
SIM,1853,16,na,1869,2219
SIM,1916,23,20-24,1939,102
SIM,1818,87,na,1905,63
SIM,1932,11,na,1943,4825
STAT,1920,26,40-44,1946,4.847087569289862
STAT,1894,42,25-29,1936,0.05412323811389676
STAT,1898,30,25-29,1928,13.203806038093393
STAT,1903,48,50-100,1951,0.18386117853863077
STAT,1829,27,35-39,1856,13.90408939411944
STAT,1931,16,50-100,1947,0.46441390122879944
STAT,1850,23,45-49,1873,0.5849925265414146
STAT,1899,32,na,1931,3089.3504334259355
STAT,1921,33,30-34,1954,16.4948673549431
STAT,1826,79,na,1905,381.58362808493314
SIM,1875,40,40-44,1915,7
STAT,1918,45,25-29,1963,0.05357631498759833
STAT,1866,45,na,1911,1979.1228824438426
STAT,1802,69,na,1871,681.5597473179572
STAT,1858,19,na,1877,1965.2353737281865
STAT,1909,33,na,1942,3394.2245506894083
STAT,1918,49,40-44,1967,0.15756574636738627
SIM,1908,23,na,1931,3226
STAT,1880,42,30-34,1922,1.141361475558364
SIM,1790,76,na,1866,317
STAT,1836,43,15-19,1879,0.010242343195378222
STAT,1873,16,40-44,1889,0.17642641730102007
SIM,1946,0,na,1946,4288
STAT,1813,51,30-34,1864,0.017533558272080942
SIM,1903,41,40-44,1944,1
STAT,1912,34,35-39,1946,8.420088376444724
STAT,1858,35,15-19,1893,0.04204140204800838
SIM,1887,25,40-44,1912,4
SIM,1856,34,50-100,1890,5
SIM,1861,42,na,1903,1991
SIM,1876,41,na,1917,2303
STAT,1848,34,50-100,1882,0.6860989486634328
SIM,1902,22,15-19,1924,3
STAT,1908,33,50-100,1941,0.7339833429063292
STAT,1834,30,35-39,1864,8.198070631937265
SIM,1845,83,na,1928,273
STAT,1804,52,35-39,1856,0.025601082679824687
STAT,1892,4,na,1896,3112.121455421428
SIM,1837,27,35-39,1864,10
STAT,1773,98,na,1871,0.39072446104069863
STAT,1851,16,20-24,1867,15.900029547840541
STAT,1859,46,20-24,1905,0.009072781268739203
SIM,1911,32,35-39,1943,14
STAT,1828,52,20-24,1880,6.001831970440568E-4
SIM,1911,48,50-100,1959,2
SIM,1864,22,35-39,1886,7
STAT,1846,93,na,1939,20.606020118472976
STAT,1871,40,50-100,1911,0.9993966330504991
SIM,1842,30,35-39,1872,9
SIM,1947,10,na,1957,4004
STAT,1795,79,na,1874,272.48363314513676
STAT,1844,45,30-34,1889,0.06902612674454073
SIM,1898,22,na,1920,3003
STAT,1896,18,35-39,1914,0.6832861265554053
SIM,1938,23,40-44,1961,1
STAT,1921,46,45-49,1967,0.2320540338910502
SIM,1891,23,40-44,1914,3
STAT,1879,25,40-44,1904,2.9779833696469225
STAT,1889,16,50-100,1905,0.05727818816478101
SIM,1896,27,40-44,1923,7
SIM,1914,23,na,1937,3770
STAT,1893,27,15-19,1920,0.5438151304397485
STAT,1903,32,35-39,1935,13.611111467218103
STAT,1907,20,35-39,1927,8.144844819405396
STAT,1926,21,15-19,1947,6.128520024125132
SIM,1943,23,15-19,1966,4
SIM,1948,7,na,1955,4016
STAT,1860,18,20-24,1878,15.605673645423895
STAT,1881,48,20-24,1929,0.010808194692940247
SIM,1865,33,50-100,1898,7
SIM,1885,39,50-100,1924,3
SIM,1925,38,35-39,1963,9
SIM,1831,69,na,1900,876
SIM,1854,97,na,1951,2
STAT,1914,47,15-19,1961,3.4506852987927633E-4
SIM,1917,37,na,1954,3637
STAT,1817,68,na,1885,754.1573080241175
STAT,1815,39,na,1854,1359.4795208292137
STAT,1862,47,40-44,1909,0.13731626274741032
STAT,1814,54,na,1868,1128.5660636562623
STAT,1872,50,25-29,1922,0.0034068084868982907
SIM,1830,84,na,1914,184
STAT,1928,39,50-100,1967,0.5002452829067869
SIM,1852,68,na,1920,1137
STAT,1857,33,50-100,1890,0.6794949660792338
SIM,1883,23,na,1906,2253
STAT,1870,8,na,1878,2521.727276597982
SIM,1829,36,40-44,1865,7
SIM,1887,81,na,1968,795
SIM,1935,22,na,1957,4724
SIM,1929,21,40-44,1950,8
STAT,1931,40,30-34,1971,0.16179767277722878
SIM,1824,32,40-44,1856,3
SIM,1866,39,30-34,1905,8
STAT,1888,27,40-44,1915,3.343079733829576
SIM,1800,77,na,1877,333
SIM,1915,20,35-39,1935,15
SIM,1872,82,na,1954,347
STAT,1788,97,na,1885,0.9543661406930919
STAT,1935,33,25-29,1968,12.071796399200961
SIM,1832,23,35-39,1855,4
STAT,1822,80,na,1902,319.5253627997436
STAT,1869,59,na,1928,1777.175124767344
SIM,1887,15,30-34,1902,5
STAT,1839,34,35-39,1873,8.13887194348927
STAT,1860,30,45-49,1890,1.349598114054134
STAT,1924,24,50-100,1948,0.7289622175001479
STAT,1917,38,35-39,1955,2.3614570820814227
SIM,1932,24,50-100,1956,3
STAT,1767,98,na,1865,0.39732447122007786
STAT,1905,45,15-19,1950,3.1109514922674213E-4
SIM,1821,76,na,1897,511
SIM,1851,83,na,1934,243
SIM,1867,67,na,1934,1362
STAT,1778,100,na,1878,0.18661764807560483
STAT,1881,52,25-29,1933,0.003213626380223446
SIM,1934,21,15-19,1955,7
STAT,1847,8,na,1855,2255.11149
SIM,1946,24,45-49,1970,1
STAT,1885,36,20-24,1921,0.7289989674059056
SIM,1846,68,na,1914,1036
STAT,1812,49,35-39,1861,0.44590971629345555
STAT,1866,32,50-100,1898,0.7980398297884274
STAT,1889,73,na,1962,1598.4910624249785
STAT,1818,45,20-24,1863,0.026456681841867277
SIM,1907,34,50-100,1941,1
STAT,1916,32,45-49,1948,1.534700650393194
SIM,1851,24,15-19,1875,5
SIM,1893,36,20-24,1929,3
SIM,1869,26,35-39,1895,10
STAT,1861,33,30-34,1894,13.638940542387495
STAT,1877,39,50-100,1916,1.1914636077880703
STAT,1870,38,35-39,1908,6.51471357096638
STAT,1938,24,45-49,1962,1.0511576697900074
STAT,1915,25,50-100,1940,0.9655025815160606
SIM,1812,62,na,1874,912
SIM,1847,34,35-39,1881,11
SIM,1887,8,na,1895,2716
STAT,1943,15,20-24,1958,135.88290432045113
STAT,1929,18,40-44,1947,1.6820059830155982
STAT,1820,54,na,1874,1222.0804749449371
SIM,1841,20,40-44,1861,2
SIM,1846,24,40-44,1870,3
STAT,1820,35,35-39,1855,18.85749668057827
STAT,1843,24,15-19,1867,2.944764281962539
STAT,1843,42,45-49,1885,1.1117340821789863
STAT,1848,46,45-49,1894,0.17050267211008308
STAT,1948,19,20-24,1967,146.4854395860631
SIM,1879,33,35-39,1912,15
STAT,1868,42,15-19,1910,0.012440813578150446
STAT,1918,40,30-34,1958,0.12876357621913243
STAT,1871,30,20-24,1901,2.5518807811348476
STAT,1850,54,20-24,1904,5.052111339401203E-4
SIM,1869,96,na,1965,18
SIM,1902,38,na,1940,3168
STAT,1913,41,25-29,1954,0.06614985224462586
SIM,1923,25,50-100,1948,5
STAT,1805,106,na,1911,0.004065383440669595
SIM,1815,76,na,1891,369
STAT,1779,83,na,1862,125.0686522504261
STAT,1768,103,na,1871,0.030437631356479627
STAT,1909,33,15-19,1942,0.11532714102110757
STAT,1829,53,na,1882,1365.6421083431155
STAT,1831,27,50-100,1858,0.5611422905188801
STAT,1844,35,20-24,1879,0.6415815265895363
STAT,1812,44,40-44,1856,7.7497301403989765
STAT,1849,39,20-24,1888,0.5568615127444088
SIM,1860,97,na,1957,3
STAT,1942,22,45-49,1964,1.1144313284643548
SIM,1838,32,35-39,1870,6
STAT,1853,41,25-29,1894,0.4783835079591922
SIM,1888,35,35-39,1923,17
SIM,1902,36,40-44,1938,5
STAT,1880,74,na,1954,1103.128092269652
STAT,1912,44,45-49,1956,0.15043008077862968
STAT,1883,23,40-44,1906,1.9233684399959972
SIM,1855,26,40-44,1881,2
SIM,1820,44,40-44,1864,3
SIM,1843,33,20-24,1876,2
SIM,1837,17,25-29,1854,4
STAT,1838,24,40-44,1862,1.8175278468389469
STAT,1834,40,45-49,1874,1.1458113311874756
STAT,1864,19,35-39,1883,0.47362497197606696
SIM,1867,30,na,1897,2095
SIM,1941,20,45-49,1961,1
STAT,1875,59,na,1934,1886.2058518724807
STAT,1927,42,30-34,1969,0.15148645044170783
STAT,1912,21,20-24,1933,100.9511393044298
STAT,1852,26,15-19,1878,0.4044022904067088
STAT,1865,34,45-49,1899,1.484158649317215
SIM,1920,21,20-24,1941,107
STAT,1903,38,40-44,1941,1.2636048942759235
SIM,1906,19,25-29,1925,13
SIM,1875,96,na,1971,48
STAT,1869,18,40-44,1887,0.16857056600826856
SIM,1852,31,na,1883,1930
SIM,1969,1,na,1970,4467
STAT,1871,49,40-44,1920,0.156988540522167
STAT,1877,44,15-19,1921,0.013355272699389048
STAT,1835,53,na,1888,1342.1975383658826
SIM,1892,37,na,1929,2832
STAT,1869,100,na,1969,6.549378190130327
STAT,1898,15,50-100,1913,0.06294322497713412
STAT,1880,32,20-24,1912,2.6868361289061324
SIM,1851,42,45-49,1893,2
SIM,1923,37,na,1960,4025
STAT,1835,33,20-24,1868,2.1249889170380984
STAT,1813,41,20-24,1854,0.5869292822250174
STAT,1831,50,50-100,1881,0.01016294862754212
STAT,1933,20,45-49,1953,1.4183663782684974
STAT,1850,97,na,1947,3.782071016244805
STAT,1861,32,40-44,1893,3.4020528745822634
STAT,1864,33,20-24,1897,2.2725906174578565
STAT,1882,29,30-34,1911,22.98301671243778
STAT,1910,46,20-24,1956,0.009761796793354899
STAT,1887,38,20-24,1925,0.8103597495320704
SIM,1816,40,30-34,1856,3
STAT,1879,23,na,1902,2328.1087136739693
SIM,1924,21,15-19,1945,4
STAT,1842,27,35-39,1869,8.4971714985373
STAT,1861,49,na,1910,1728.0968172894652
STAT,1884,37,40-44,1921,4.086572747993493
SIM,1841,29,35-39,1870,10
STAT,1940,25,50-100,1965,0.9595878853382647
SIM,1821,35,50-100,1856,1
SIM,1834,31,35-39,1865,5
SIM,1859,44,45-49,1903,2
SIM,1965,1,na,1966,4562
SIM,1887,19,30-34,1906,4
STAT,1875,31,30-34,1906,17.01456889401656
SIM,1846,38,25-29,1884,2
SIM,1949,22,30-34,1971,40
STAT,1840,19,25-29,1859,5.049506205584673
SIM,1843,37,45-49,1880,3
SIM,1936,5,na,1941,3031
SIM,1883,39,40-44,1922,6
STAT,1849,44,35-39,1893,1.2875999735185877
STAT,1861,44,35-39,1905,1.4013665076410422
STAT,1883,50,20-24,1933,6.930333814438418E-4
SIM,1919,7,na,1926,4163
STAT,1880,16,15-19,1896,5.913421995553581
SIM,1860,34,40-44,1894,7
STAT,1866,53,25-29,1919,0.0030355205287337073
STAT,1887,42,na,1929,2438.8104955570643
SIM,1890,29,30-34,1919,34
SIM,1879,2,na,1881,3053
SIM,1844,14,na,1858,2181
SIM,1904,30,50-100,1934,1
SIM,1823,38,30-34,1861,4
SIM,1848,28,na,1876,1907
SIM,1881,23,20-24,1904,50
STAT,1833,21,25-29,1854,60.33276832731385
SIM,1916,17,na,1933,3778
SIM,1948,3,na,1951,4065
STAT,1811,50,30-34,1861,0.01967597369727578
STAT,1916,21,15-19,1937,5.285211228037955
SIM,1878,26,na,1904,2419
SIM,1832,23,25-29,1855,44
STAT,1889,46,30-34,1935,0.11321566043189843
STAT,1824,36,30-34,1860,8.405511476326419
SIM,1808,63,na,1871,882
STAT,1828,31,na,1859,1647.5052724314348
STAT,1893,22,35-39,1915,6.994499867760165
SIM,1886,40,50-100,1926,1
STAT,1844,35,45-49,1879,1.6591893235744908
STAT,1888,17,30-34,1905,1.7787744863586092
STAT,1838,38,25-29,1876,2.3450568783214267
SIM,1855,6,na,1861,2394
SIM,1894,32,45-49,1926,2
STAT,1871,51,40-44,1922,0.00990677564867275
STAT,1874,52,20-24,1926,7.086915144469375E-4
SIM,1835,53,na,1888,1367
SIM,1841,21,25-29,1862,50
STAT,1854,54,45-49,1908,0.010162929053513613
STAT,1895,61,na,1956,2325.872098308432
SIM,1799,85,na,1884,61
SIM,1852,35,45-49,1887,1
STAT,1863,52,45-49,1915,0.011987150461546959
SIM,1830,28,20-24,1858,8
SIM,1827,34,na,1861,1559
STAT,1891,27,30-34,1918,29.445364720533465
SIM,1910,12,na,1922,3636
STAT,1847,36,25-29,1883,2.220960554751189
STAT,1895,30,45-49,1925,2.1670638937488387
SIM,1836,70,na,1906,876
STAT,1856,111,na,1967,6.000743356540553E-4
SIM,1889,27,40-44,1916,4
STAT,1845,28,15-19,1873,0.3861924862067148
STAT,1864,45,15-19,1909,3.4109098483555583E-4
STAT,1901,48,20-24,1949,0.008838095776320215
STAT,1871,23,50-100,1894,0.38073332482599415
STAT,1842,78,na,1920,556.3968526329156
STAT,1900,39,15-19,1939,0.015725084444023523
STAT,1855,35,20-24,1890,0.5511284349787845
STAT,1908,15,30-34,1923,2.243435453019699
STAT,1887,25,15-19,1912,0.4825871230015784
SIM,1827,41,45-49,1868,3
SIM,1844,48,50-100,1892,2
SIM,1795,71,na,1866,559
SIM,1829,26,30-34,1855,18
SIM,1939,15,25-29,1954,50
STAT,1882,11,na,1893,2377.514190811324
SIM,1820,87,na,1907,61
STAT,1855,47,15-19,1902,2.819737449037818E-4
STAT,1853,30,na,1883,1860.6746302339425
STAT,1831,26,20-24,1857,10.599029244349916
STAT,1871,18,15-19,1889,5.560912217390383
STAT,1873,26,25-29,1899,40.702386889432056
SIM,1842,30,30-34,1872,27
STAT,1886,32,45-49,1918,1.7405510467932221
STAT,1919,37,na,1956,3818.2299574632825
SIM,1938,16,20-24,1954,122
SIM,1896,17,30-34,1913,3
STAT,1819,70,na,1889,732.8540521726779
SIM,1825,33,35-39,1858,11
SIM,1883,48,50-100,1931,1
STAT,1870,42,35-39,1912,1.6741513762997005
STAT,1873,43,15-19,1916,0.013146700747949018
STAT,1884,24,35-39,1908,5.413549176371978
STAT,1802,52,30-34,1854,0.016966587824502232
STAT,1835,42,40-44,1877,1.6815596027364503
STAT,1812,48,na,1860,1299.4233542789445
STAT,1856,34,25-29,1890,7.513557788165243
STAT,1915,23,na,1938,3554.6986791943636
STAT,1793,107,na,1900,8.577687392519097E-4
STAT,1853,33,45-49,1886,1.3180042202250377
STAT,1851,25,35-39,1876,8.4049441232601
STAT,1879,39,25-29,1918,2.814398013532054
STAT,1898,44,30-34,1942,0.10071745999189917
STAT,1866,80,na,1946,538.7905859239215
STAT,1949,19,35-39,1968,4.607634118108092
STAT,1823,44,15-19,1867,0.016912272066297685
SIM,1840,22,20-24,1862,58
SIM,1869,97,na,1966,18
SIM,1912,9,na,1921,3647
SIM,1890,21,20-24,1911,88
STAT,1869,40,45-49,1909,1.3823923407519896
SIM,1894,64,na,1958,2329
STAT,1803,51,35-39,1854,0.025175530603268194
STAT,1890,35,15-19,1925,0.06547601942033751
SIM,1872,4,na,1876,2629
STAT,1919,21,40-44,1940,3.488704232721189
SIM,1865,83,na,1948,269
STAT,1896,36,20-24,1932,0.9670618909563956
STAT,1847,49,30-34,1896,0.06973723629046831
STAT,1852,34,40-44,1886,3.341375986478496
SIM,1887,39,25-29,1926,2
STAT,1889,2,na,1891,3108.8845613882204
STAT,1923,42,na,1965,4101.104775309022
STAT,1889,33,25-29,1922,11.895251988844059
SIM,1864,34,25-29,1898,14
STAT,1847,16,30-34,1863,1.4723812413880826
SIM,1892,24,35-39,1916,8
SIM,1877,40,45-49,1917,4
STAT,1833,34,30-34,1867,13.407413535318517
STAT,1835,37,45-49,1872,1.5377092590612464
STAT,1875,51,25-29,1926,0.003454106071825015
STAT,1882,21,20-24,1903,63.53906746862491
SIM,1890,50,na,1940,2592
STAT,1883,16,40-44,1899,0.16975983789179733
SIM,1927,21,40-44,1948,5
STAT,1834,30,30-34,1864,14.134004488839663
SIM,1905,41,50-100,1946,1
STAT,1832,22,20-24,1854,103.5868116446025
SIM,1886,45,na,1931,2219
STAT,1829,45,20-24,1874,0.009939212364561868
STAT,1821,84,na,1905,179.63768539215866
STAT,1833,29,35-39,1862,7.642696362285493
STAT,1912,49,35-39,1961,0.11634135492261276
SIM,1855,16,30-34,1871,2
STAT,1866,19,45-49,1885,0.05771238095963646
STAT,1919,16,45-49,1935,0.10488559032077166
STAT,1825,98,na,1923,1.8367060990187005
SIM,1843,42,40-44,1885,6
SIM,1897,33,25-29,1930,20
SIM,1874,33,30-34,1907,18
STAT,1948,18,na,1966,3978.348133387898
SIM,1854,43,50-100,1897,1
SIM,1876,41,40-44,1917,7
SIM,1892,37,40-44,1929,6
SIM,1890,16,25-29,1906,7
STAT,1950,20,50-100,1970,0.7379840811097693
SIM,1841,34,30-34,1875,21
STAT,1817,46,40-44,1863,0.3891509267058081
STAT,1865,31,na,1896,2056.8879290693703
SIM,1831,30,50-100,1861,1
SIM,1778,91,na,1869,10
SIM,1824,37,35-39,1861,6
STAT,1852,51,30-34,1903,0.004544221339196142
STAT,1892,43,25-29,1935,0.7541883983077655
SIM,1881,14,na,1895,2148
STAT,1878,81,na,1959,665.6981528024108
SIM,1875,32,35-39,1907,12
SIM,1852,33,na,1885,1864
SIM,1827,66,na,1893,860
STAT,1791,69,na,1860,639.6314933950309
STAT,1818,45,45-49,1863,0.5203147231439657
STAT,1868,41,40-44,1909,2.0379749670793976
STAT,1825,52,25-29,1877,0.0035801195353168994
SIM,1857,64,na,1921,1403
SIM,1853,50,na,1903,1765
STAT,1850,26,30-34,1876,21.013324540485954
STAT,1885,36,45-49,1921,1.8852589320118276
STAT,1877,19,20-24,1896,17.28637720450436
STAT,1836,50,na,1886,1431.3244106334807
STAT,1820,67,na,1887,835.9330056141861
SIM,1882,31,na,1913,2158
STAT,1841,40,15-19,1881,0.01007307388900538
STAT,1803,87,na,1890,58.2061605298077
SIM,1851,23,35-39,1874,7
SIM,1874,28,35-39,1902,12
STAT,1833,51,20-24,1884,4.720025452688582E-4
STAT,1890,15,20-24,1905,20.57207150563813
STAT,1963,3,na,1966,4719.841080334885
SIM,1856,32,25-29,1888,16
SIM,1896,34,20-24,1930,3
STAT,1798,91,na,1889,18.870199244140977
SIM,1953,17,na,1970,4090
STAT,1825,35,35-39,1860,9.794076573350848
STAT,1898,19,40-44,1917,0.23264699221081123
SIM,1876,45,50-100,1921,3
STAT,1854,39,20-24,1893,0.5494971614545118
STAT,1813,53,45-49,1866,0.04106547283958727
SIM,1823,52,na,1875,1215
STAT,1874,47,25-29,1921,0.055355337530818255
SIM,1949,17,35-39,1966,3
STAT,1865,37,30-34,1902,4.57514851715177
STAT,1834,38,40-44,1872,3.335613874415941
STAT,1837,39,20-24,1876,0.5802876044148786
STAT,1882,41,15-19,1923,0.01275212728643106
SIM,1839,28,40-44,1867,3
STAT,1830,53,45-49,1883,0.009171696218021583
STAT,1827,40,40-44,1867,2.1433125775430706
SIM,1857,25,50-100,1882,1
STAT,1862,98,na,1960,5.481606790372012
STAT,1814,46,15-19,1860,0.0011029175787883017
STAT,1892,26,35-39,1918,11.45392024157281
SIM,1842,38,40-44,1880,1
STAT,1840,24,20-24,1864,60.15804258979841
STAT,1940,22,na,1962,3513.965805493062
STAT,1875,26,35-39,1901,9.396788948846787
STAT,1865,32,25-29,1897,8.792710775352084
SIM,1893,33,40-44,1926,6
STAT,1899,40,30-34,1939,0.10439877977431068
STAT,1860,23,35-39,1883,4.58533305598765
SIM,1923,45,50-100,1968,1
STAT,1894,31,40-44,1925,5.2916025863499625
STAT,1946,5,na,1951,4158.84534864811
STAT,1857,12,na,1869,2089.6416013486305
STAT,1809,52,40-44,1861,0.03650100480807878
SIM,1843,37,50-100,1880,1
SIM,1917,48,50-100,1965,2
SIM,1816,50,na,1866,1240
STAT,1876,43,40-44,1919,2.1777721953878886
STAT,1888,34,20-24,1922,2.990813732463724
SIM,1908,23,50-100,1931,2
SIM,1867,42,na,1909,2004
STAT,1843,23,35-39,1866,5.246517560231766
STAT,1848,51,na,1899,1558.6145440382093
STAT,1881,37,15-19,1918,0.051221045334776207
STAT,1864,14,na,1878,2270.5201082933613
STAT,1897,35,25-29,1932,3.6721688933872914
SIM,1864,39,30-34,1903,3
SIM,1914,20,50-100,1934,1
STAT,1792,86,na,1878,64.64897485815143
STAT,1848,45,30-34,1893,0.07043224604600659
STAT,1870,6,na,1876,2561.892793469431
SIM,1915,26,50-100,1941,4
STAT,1872,27,20-24,1899,11.123789163333438
SIM,1840,32,na,1872,1766
STAT,1855,18,30-34,1873,1.3347308473500703
SIM,1826,42,40-44,1868,6
STAT,1853,8,na,1861,2190.6978534556656
STAT,1838,18,30-34,1856,1.4274545175416995
STAT,1899,48,40-44,1947,0.12345128354312035
STAT,1777,106,na,1883,0.011979828509351023
STAT,1880,44,45-49,1924,1.467577387351379
STAT,1923,10,na,1933,4409.023760978805
SIM,1897,36,50-100,1933,1
SIM,1903,42,na,1945,3130
STAT,1831,46,15-19,1877,2.9790096673329767E-4
STAT,1845,102,na,1947,0.20650699361879865
STAT,1871,59,na,1930,1820.1386230355733
SIM,1844,46,na,1890,1588
SIM,1835,40,40-44,1875,6
STAT,1848,28,40-44,1876,2.5578353091774315
STAT,1936,17,na,1953,3328.453687711538
SIM,1842,25,35-39,1867,8
SIM,1856,28,40-44,1884,3
SIM,1907,56,na,1963,3004
STAT,1839,42,25-29,1881,0.45127492808789343
SIM,1863,18,30-34,1881,1
SIM,1889,10,na,1899,3057
STAT,1872,50,45-49,1922,0.013958451560770755
SIM,1873,37,30-34,1910,5
SIM,1926,32,50-100,1958,2
STAT,1868,28,na,1896,2145.012038108591
STAT,1819,41,45-49,1860,3.040985485546715
STAT,1865,54,20-24,1919,6.160432680132978E-4
STAT,1891,47,25-29,1938,0.03781505322350859
SIM,1766,90,na,1856,23
STAT,1854,26,15-19,1880,0.37909232620382355
SIM,1848,29,45-49,1877,1
SIM,1882,27,30-34,1909,31
SIM,1884,43,40-44,1927,3
SIM,1867,43,40-44,1910,4
STAT,1855,50,45-49,1905,0.010425927985325047
STAT,1870,25,45-49,1895,1.0347464812272267
SIM,1916,15,30-34,1931,3
STAT,1820,43,35-39,1863,3.168014487851254
STAT,1875,21,50-100,1896,0.396970979764148
STAT,1876,38,45-49,1914,1.9345156441387055
STAT,1908,53,na,1961,3071.2382847485123
STAT,1840,87,na,1927,122.69524133986855
STAT,1875,39,40-44,1914,4.205773329094728
STAT,1877,64,na,1941,1704.1422660570468
SIM,1832,36,30-34,1868,4
STAT,1838,43,20-24,1881,0.1138056273225714
STAT,1863,29,20-24,1892,9.67232892053382
SIM,1836,27,na,1863,1737
STAT,1860,17,50-100,1877,0.04338098519208302
STAT,1881,25,20-24,1906,10.773370200589751
STAT,1849,25,na,1874,1875.1940840932455
STAT,1858,61,na,1919,1385.8354795866449
SIM,1871,41,50-100,1912,1
SIM,1847,35,50-100,1882,3
SIM,1862,11,na,1873,2393
STAT,1808,48,40-44,1856,0.6409873990466781
SIM,1883,26,35-39,1909,14
SIM,1851,36,40-44,1887,3
SIM,1866,25,na,1891,2108
SIM,1868,42,45-49,1910,3
SIM,1888,35,25-29,1923,5
SIM,1846,18,30-34,1864,1
SIM,1861,30,40-44,1891,3
STAT,1873,50,na,1923,2094.360899442342
STAT,1874,18,40-44,1892,0.1761359814722693
STAT,1845,11,na,1856,2134.9942811360997
STAT,1832,68,na,1900,924.0376711764319
SIM,1895,38,na,1933,2920
STAT,1899,35,35-39,1934,9.243661697967562
STAT,1829,28,30-34,1857,30.83904721682279
STAT,1809,47,45-49,1856,0.8608808542323985
STAT,1860,36,40-44,1896,3.377046181461816
STAT,1857,18,40-44,1875,0.1591591500878063
SIM,1891,24,na,1915,2872
SIM,1879,75,na,1954,949
STAT,1841,23,25-29,1864,49.260498342094195
STAT,1864,28,25-29,1892,35.589826242371345
STAT,1872,47,15-19,1919,3.775123773335615E-4
SIM,1875,61,na,1936,1792
SIM,1883,80,na,1963,805
STAT,1843,36,40-44,1879,3.7253703658146704
SIM,1852,40,40-44,1892,6
STAT,1819,38,15-19,1857,0.13423858833870608
STAT,1834,50,25-29,1884,0.0023388950144220275
STAT,1858,93,na,1951,21.674417463767693
STAT,1850,46,25-29,1896,0.04066566361445808
STAT,1908,21,na,1929,3323.509922233603
STAT,1902,44,20-24,1946,0.014503907144470158
SIM,1816,82,na,1898,161
SIM,1831,24,20-24,1855,58
STAT,1886,29,15-19,1915,0.4496148486142048
SIM,1855,33,20-24,1888,1
STAT,1848,32,25-29,1880,8.605241671857284
STAT,1865,41,15-19,1906,0.01190861784802313
SIM,1884,38,45-49,1922,2
STAT,1849,53,25-29,1902,0.0025120584424216507
SIM,1833,35,35-39,1868,11
SIM,1883,31,30-34,1914,24
STAT,1896,19,30-34,1915,1.9793253915119324
STAT,1844,40,40-44,1884,1.6591449985190754
STAT,1859,43,40-44,1902,1.6835342977423737
STAT,1874,27,30-34,1901,24.313918221179957
STAT,1939,17,25-29,1956,40.9738060651597
SIM,1893,38,50-100,1931,2
STAT,1812,91,na,1903,24.923259269508996
SIM,1820,41,35-39,1861,3
SIM,1922,34,50-100,1956,6
STAT,1890,23,20-24,1913,79.34984105636168
STAT,1948,16,50-100,1964,0.40518973738701286
SIM,1839,36,40-44,1875,2
STAT,1922,21,50-100,1943,0.7150411340888662
SIM,1876,44,45-49,1920,2
SIM,1785,93,na,1878,3
SIM,1826,44,50-100,1870,3
STAT,1818,44,50-100,1862,2.3462544042551103
STAT,1847,33,20-24,1880,2.3110760255753955
STAT,1856,39,30-34,1895,3.903634780141665
STAT,1811,53,35-39,1864,0.02679306793370967
SIM,1896,23,na,1919,2997
STAT,1843,52,na,1895,1545.1448081417336
SIM,1866,57,na,1923,1751
STAT,1893,47,35-39,1940,0.09421540109811742
STAT,1898,27,40-44,1925,3.8308077979398933
STAT,1827,35,45-49,1862,2.093897317358193
STAT,1849,41,30-34,1890,0.832419855454152
SIM,1893,28,45-49,1921,3
SIM,1896,29,25-29,1925,62
SIM,1947,17,25-29,1964,42
STAT,1842,24,30-34,1866,15.769786990884091
SIM,1816,43,35-39,1859,2
STAT,1833,46,25-29,1879,0.04158460626394356
STAT,1837,47,20-24,1884,0.007863594507515054
STAT,1888,29,25-29,1917,46.871405030297396
SIM,1893,41,40-44,1934,7
SIM,1834,79,na,1913,393
SIM,1893,47,na,1940,2772
STAT,1824,40,15-19,1864,0.0183809693087009
STAT,1865,24,25-29,1889,49.027868653303514
STAT,1803,55,na,1858,1058.7175414607786
SIM,1873,24,25-29,1897,58
STAT,1840,16,20-24,1856,16.079996219352523
STAT,1855,38,25-29,1893,2.0290391713975744
STAT,1807,69,na,1876,719.4971160166879
SIM,1800,67,na,1867,769
STAT,1936,16,45-49,1952,0.4528367022411683
SIM,1929,26,20-24,1955,23
STAT,1910,49,25-29,1959,0.04646645325465067
STAT,1925,15,30-34,1940,13.976054890011907
STAT,1868,44,45-49,1912,1.3317134790806364
STAT,1911,15,50-100,1926,0.07113884456719437
STAT,1857,43,30-34,1900,0.8500311934260052
STAT,1894,26,45-49,1920,1.3538931664803955
STAT,1900,57,na,1957,2674.8895327106443
STAT,1892,18,35-39,1910,0.6474259286151072
SIM,1841,26,30-34,1867,19
STAT,1824,49,na,1873,1335.1908881360434
SIM,1931,38,na,1969,4685
STAT,1860,28,40-44,1888,2.307825553115351
SIM,1833,27,35-39,1860,11
STAT,1843,44,40-44,1887,1.628538834108616
STAT,1859,51,40-44,1910,0.007975029143696428
STAT,1927,23,40-44,1950,3.9018325399605547
STAT,1820,35,na,1855,1520.681618324247
SIM,1824,42,30-34,1866,1
STAT,1841,36,30-34,1877,4.341080978371696
SIM,1858,81,na,1939,386
SIM,1883,34,35-39,1917,11
STAT,1826,47,45-49,1873,0.2206616370385728
SIM,1843,34,40-44,1877,4
STAT,1890,43,50-100,1933,1.2114157963469823
STAT,1853,30,40-44,1883,3.3814612575834553
STAT,1916,40,na,1956,3605.3119596980405
STAT,1862,66,na,1928,1320.7763819662534
STAT,1854,51,40-44,1905,0.007617171346495086
STAT,1883,33,30-34,1916,16.097160220462563
STAT,1850,30,15-19,1880,0.11766805610922584
STAT,1847,19,35-39,1866,0.4979813235382405
STAT,1867,32,35-39,1899,8.98271242953711
SIM,1859,41,40-44,1900,3
SIM,1891,33,30-34,1924,30
STAT,1823,32,20-24,1855,7.217148833462643
SIM,1908,21,30-34,1929,32
STAT,1818,37,45-49,1855,6.756165027499704
SIM,1831,32,20-24,1863,3
STAT,1875,34,35-39,1909,9.744553191762522
STAT,1882,24,25-29,1906,52.29360319193458
STAT,1861,103,na,1964,0.5012353773347463
STAT,1907,36,na,1943,3310.491484187273
STAT,1835,34,40-44,1869,3.374058616555303
STAT,1903,22,na,1925,3178.703503182279
STAT,1851,38,50-100,1889,0.9005654294141383
STAT,1869,45,na,1914,2077.8479529793244
SIM,1935,23,40-44,1958,3
SIM,1850,24,30-34,1874,19
STAT,1861,41,30-34,1902,0.9059687245419208
SIM,1881,26,25-29,1907,31
STAT,1885,28,45-49,1913,1.0413160015703793
SIM,1878,38,20-24,1916,2
SIM,1823,33,25-29,1856,14
STAT,1896,39,25-29,1935,3.558590648218051
STAT,1840,44,15-19,1884,0.00977854846231175
STAT,1856,27,na,1883,1829.7463512962463
STAT,1844,52,35-39,1896,0.006011465195271066
STAT,1852,13,na,1865,2183.7110152434307
STAT,1833,26,30-34,1859,20.44697882196908
STAT,1853,50,35-39,1903,0.006476294332637452
SIM,1817,99,na,1916,1
STAT,1858,34,35-39,1892,7.446229887894397
STAT,1873,35,15-19,1908,0.05435846911383648
SIM,1840,25,25-29,1865,37
STAT,1774,108,na,1882,0.004683713103290855
STAT,1842,15,40-44,1857,0.169242804669211
SIM,1919,19,15-19,1938,42
STAT,1873,23,20-24,1896,65.8765746976718
SIM,1840,17,25-29,1857,11
SIM,1828,51,na,1879,1256
SIM,1868,34,45-49,1902,2
STAT,1885,41,40-44,1926,2.1265507921543105
SIM,1933,15,30-34,1948,23
SIM,1857,96,na,1953,6
STAT,1848,48,35-39,1896,0.09959199427876564
SIM,1853,82,na,1935,330
STAT,1899,11,na,1910,3348.3401286761055
SIM,1902,57,na,1959,2775
SIM,1835,35,45-49,1870,2
SIM,1910,44,na,1954,3189
SIM,1829,29,35-39,1858,9
STAT,1835,45,45-49,1880,0.17498707855711745
SIM,1907,24,na,1931,3316
STAT,1818,50,40-44,1868,0.02245143755288093
STAT,1832,25,25-29,1857,35.77476361180947
STAT,1891,31,15-19,1922,0.1671987496802232
STAT,1937,20,50-100,1957,0.6056549312421091
SIM,1903,10,na,1913,3458
SIM,1897,38,30-34,1935,4
SIM,1915,2,na,1917,3940
STAT,1790,109,na,1899,1.432187482260159E-4
SIM,1824,34,30-34,1858,18
SIM,1900,32,50-100,1932,1
STAT,1881,45,15-19,1926,3.6849475451428463E-4
STAT,1897,48,30-34,1945,0.06811978059296372
SIM,1852,27,45-49,1879,2
STAT,1829,48,25-29,1877,0.045873628795310165
SIM,1847,34,25-29,1881,14
STAT,1882,19,50-100,1901,0.04479427025279957
SIM,1881,31,50-100,1912,4
STAT,1856,31,20-24,1887,2.0455942860663434
STAT,1895,27,15-19,1922,0.5593243945176205
STAT,1857,52,20-24,1909,5.466404134246164E-4
SIM,1838,16,30-34,1854,1
STAT,1844,27,45-49,1871,0.9541697944093984
STAT,1852,37,45-49,1889,1.5228143493741815
STAT,1880,41,40-44,1921,2.2458929977480495
SIM,1897,30,20-24,1927,2
STAT,1836,18,20-24,1854,29.076414767551682
STAT,1889,30,20-24,1919,3.177841997766386
SIM,1938,19,25-29,1957,47
STAT,1857,44,na,1901,1698.0633201445744
SIM,1944,24,na,1968,3660
STAT,1771,92,na,1863,7.32864201503639
SIM,1844,18,20-24,1862,17
STAT,1847,54,50-100,1901,0.0108068478713401
STAT,1820,51,35-39,1871,0.013919423667918823
STAT,1834,33,35-39,1867,7.946627807593965
STAT,1947,16,20-24,1963,144.32302469372908
SIM,1829,38,25-29,1867,5
STAT,1879,44,20-24,1923,0.1547003463896113
SIM,1940,10,na,1950,3634
SIM,1860,37,45-49,1897,2
SIM,1864,31,20-24,1895,2
SIM,1955,16,20-24,1971,147
SIM,1842,33,35-39,1875,9
STAT,1897,40,20-24,1937,0.014073919450370172
STAT,1839,34,25-29,1873,8.231727225641865
STAT,1883,25,30-34,1908,23.473270021890045
STAT,1886,25,na,1911,2398.207070097698
STAT,1840,27,25-29,1867,36.73159148212525
STAT,1887,74,na,1961,1354.7979387947742
SIM,1853,31,45-49,1884,1
SIM,1871,79,na,1950,584
STAT,1883,60,na,1943,1765.7949351242034
SIM,1848,38,35-39,1886,14
SIM,1854,24,15-19,1878,3
STAT,1910,38,20-24,1948,0.23692015241684994
SIM,1882,22,25-29,1904,46
STAT,1889,38,30-34,1927,6.18490730941245
STAT,1828,36,15-19,1864,0.054532492674724056
SIM,1819,47,na,1866,1363
STAT,1880,48,50-100,1928,0.24105856049847613
STAT,1763,110,na,1873,6.767878132319305E-4
STAT,1854,79,na,1933,503.42165515977825
SIM,1822,35,na,1857,1602
STAT,1827,43,45-49,1870,1.3528758254983981
STAT,1850,65,na,1915,1189.7375263941415
STAT,1891,47,na,1938,2618.9760854244832
SIM,1856,15,na,1871,2178
SIM,1859,29,20-24,1888,15
SIM,1863,27,20-24,1890,12
SIM,1896,37,25-29,1933,3
SIM,1826,49,na,1875,1390
STAT,1842,32,30-34,1874,15.019715652035233
SIM,1876,36,45-49,1912,2
STAT,1870,30,40-44,1900,4.046634203524804
SIM,1891,25,30-34,1916,37
STAT,1861,52,35-39,1913,0.006717653086225319
SIM,1812,68,na,1880,746
STAT,1833,54,25-29,1887,0.0021349214276272775
STAT,1824,44,30-34,1868,1.3825912539565814
STAT,1906,15,20-24,1921,24.50083643073614
STAT,1851,42,25-29,1893,0.4703245474204714
SIM,1871,29,20-24,1900,9
STAT,1884,45,40-44,1929,0.1614153566166048
STAT,1812,107,na,1919,0.00202832384150097
SIM,1825,33,50-100,1858,3
SIM,1811,83,na,1894,152
STAT,1832,36,na,1868,1641.7354085758695
STAT,1891,9,na,1900,3033.921927135289
STAT,1868,36,45-49,1904,1.8067334784939146
STAT,1888,37,25-29,1925,3.2132132890584386
SIM,1881,46,na,1927,1884
STAT,1829,37,20-24,1866,0.6878971128076627
SIM,1909,33,40-44,1942,4
STAT,1876,52,30-34,1928,0.0057743516689408355
STAT,1933,17,50-100,1950,0.47379703293666947
STAT,1845,31,45-49,1876,1.4757170314888923
STAT,1866,45,25-29,1911,0.0506691310483121
SIM,1861,42,35-39,1903,1
STAT,1917,16,35-39,1933,0.8550939407611741
STAT,1817,54,40-44,1871,0.02167650667142734
STAT,1929,15,na,1944,4458.493040997846
STAT,1831,51,na,1882,1388.6957963303798
STAT,1852,21,35-39,1873,5.305042787674806
STAT,1831,41,45-49,1872,1.1551320962270344
STAT,1894,12,na,1906,3138.3174168521878
SIM,1957,8,na,1965,4697
STAT,1860,39,45-49,1899,1.5151147125957445
STAT,1898,26,na,1924,3062.423685987939
SIM,1878,58,na,1936,2002
STAT,1878,48,20-24,1926,0.011653145358851385
STAT,1937,20,45-49,1957,1.0356698929620187
SIM,1841,37,35-39,1878,15
SIM,1857,44,35-39,1901,3
SIM,1861,33,45-49,1894,1
SIM,1874,44,na,1918,2163
SIM,1925,16,35-39,1941,4
STAT,1841,53,20-24,1894,4.967718678241885E-4
STAT,1849,16,40-44,1865,0.16323970327240983
STAT,1886,17,50-100,1903,0.048899977383266464
SIM,1870,30,na,1900,2210
STAT,1852,29,45-49,1881,0.8813266397124043
STAT,1858,47,40-44,1905,0.12637506332863893
STAT,1833,37,35-39,1870,5.3831744474812835
STAT,1897,32,20-24,1929,3.415085953378611
STAT,1816,42,30-34,1858,3.4378211099483185
STAT,1860,20,30-34,1880,15.716684803763743
STAT,1857,26,40-44,1883,2.314530071471635
SIM,1849,13,na,1862,2137
SIM,1883,23,30-34,1906,20
SIM,1860,29,45-49,1889,2
STAT,1828,63,na,1891,1012.9075918213285
STAT,1892,35,25-29,1927,3.4384580393301243
STAT,1811,45,35-39,1856,0.48248307639222643
SIM,1842,22,30-34,1864,15
SIM,1865,35,30-34,1900,4
SIM,1815,39,35-39,1854,9
SIM,1846,80,na,1926,383
SIM,1884,35,40-44,1919,4
STAT,1870,17,45-49,1887,0.061043059408403974
STAT,1921,47,35-39,1968,0.13731777809050158
STAT,1837,67,na,1904,1000.6809728422018
SIM,1806,72,na,1878,521
SIM,1898,17,40-44,1915,1
SIM,1932,23,na,1955,4389
STAT,1825,44,25-29,1869,0.6863125265351844
STAT,1838,51,20-24,1889,5.106237595865184E-4
SIM,1851,44,40-44,1895,5
STAT,1851,17,35-39,1868,0.48921730377263883
STAT,1854,34,15-19,1888,0.10285587286342639
SIM,1865,26,40-44,1891,3
STAT,1829,80,na,1909,379.16775776261983
SIM,1817,44,40-44,1861,8
STAT,1902,47,25-29,1949,0.04311363925221702
SIM,1860,21,35-39,1881,5
SIM,1855,36,25-29,1891,2
STAT,1826,39,45-49,1865,2.0421528517168372
SIM,1834,39,45-49,1873,2
STAT,1876,35,40-44,1911,4.309728199014877
STAT,1896,28,20-24,1924,14.595537029733705
SIM,1805,98,na,1903,2
STAT,1850,51,20-24,1901,5.219825531717945E-4
STAT,1826,31,35-39,1857,14.254375443001797
SIM,1888,27,25-29,1915,52
SIM,1856,37,30-34,1893,5
STAT,1922,25,na,1947,4032.009804595124
STAT,1903,48,30-34,1951,0.07246645817799485
STAT,1790,95,na,1885,2.4856110968299063
STAT,1834,22,30-34,1856,14.74582644154316
STAT,1926,39,na,1965,4334.865276190133
STAT,1848,83,na,1931,285.9987736931496
SIM,1920,22,na,1942,3740
STAT,1914,49,45-49,1963,0.20239727602613306
SIM,1924,36,na,1960,4152
STAT,1869,37,15-19,1906,0.05134979741582486
STAT,1871,21,45-49,1892,0.6550436343194402
SIM,1822,37,25-29,1859,4
SIM,1893,7,na,1900,3234
STAT,1808,49,50-100,1857,0.904396185309215
SIM,1872,33,20-24,1905,2
STAT,1912,26,50-100,1938,0.929591511205649
STAT,1832,42,15-19,1874,0.010244762262618163
STAT,1848,37,30-34,1885,3.9567351478555635
STAT,1841,28,30-34,1869,21.24590263687525
STAT,1880,52,45-49,1932,0.01434852330602378
SIM,1835,43,45-49,1878,2
SIM,1827,33,45-49,1860,2
STAT,1820,40,30-34,1860,2.2045959083739506
SIM,1857,41,30-34,1898,1
STAT,1846,24,15-19,1870,2.828959965623791
SIM,1880,42,45-49,1922,1
STAT,1796,105,na,1901,0.006830909214543176
STAT,1930,35,50-100,1965,0.5182798131806678
STAT,1841,20,20-24,1861,60.595868774082014
STAT,1849,49,40-44,1898,0.1208229046747675
STAT,1894,34,45-49,1928,2.100984934205738
STAT,1889,49,35-39,1938,0.0901794067267774
SIM,1850,32,30-34,1882,32
STAT,1860,40,25-29,1900,0.49799704728376093
SIM,1875,34,50-100,1909,6
STAT,1805,51,45-49,1856,0.0432008115439255
STAT,1819,102,na,1921,0.14640777518026246
STAT,1872,42,45-49,1914,1.4173705012297035
STAT,1867,34,50-100,1901,0.8057521462051279
STAT,1876,58,na,1934,1928.6626191303694
SIM,1906,16,25-29,1922,8
STAT,1886,24,45-49,1910,0.6916563378829023
SIM,1861,26,na,1887,2072
SIM,1889,39,35-39,1928,8
STAT,1881,28,25-29,1909,38.44916713559991
SIM,1919,22,45-49,1941,3
SIM,1894,24,45-49,1918,4
STAT,1833,29,50-100,1862,0.5066857652111074
STAT,1855,41,50-100,1896,0.751603605182325
STAT,1834,49,45-49,1883,0.1510043407259941
STAT,1908,37,50-100,1945,0.3712696687927761
SIM,1891,36,35-39,1927,13
SIM,1876,28,45-49,1904,1
STAT,1835,51,30-34,1886,0.003860685570615621
SIM,1879,29,25-29,1908,40
STAT,1872,44,na,1916,2161.941425873889
SIM,1867,31,na,1898,2071
STAT,1839,39,30-34,1878,4.159331024719911
STAT,1856,43,15-19,1899,0.010143998739802504
STAT,1820,34,45-49,1854,5.374009492196365
SIM,1886,13,na,1899,2522
STAT,1836,48,50-100,1884,0.1602423553593506
STAT,1917,41,25-29,1958,0.07049874571167893
SIM,1902,37,25-29,1939,1
SIM,1870,20,40-44,1890,1
STAT,1830,47,50-100,1877,0.18000616772681774
STAT,1827,32,40-44,1859,5.046259974770498
SIM,1873,21,20-24,1894,59
STAT,1768,93,na,1861,3.8383111685675626
STAT,1810,53,50-100,1863,0.05024180132393859
STAT,1823,35,25-29,1858,5.146123639357001
STAT,1865,45,30-34,1910,0.08392590606380863
SIM,1870,32,35-39,1902,10
SIM,1822,67,na,1889,838
STAT,1821,52,na,1873,1298.685293850312
STAT,1859,38,45-49,1897,1.4954839828169502
STAT,1867,41,25-29,1908,0.5721708743047172
SIM,1891,17,30-34,1908,4
SIM,1908,24,35-39,1932,7
STAT,1868,39,na,1907,2103.649742503849
STAT,1825,66,na,1891,926.6867054461306
STAT,1938,26,20-24,1964,17.08976811452255
SIM,1763,93,na,1856,2
SIM,1880,19,20-24,1899,21
STAT,1842,40,30-34,1882,0.869011152427682
STAT,1851,46,40-44,1897,0.1259002159493911
STAT,1863,37,20-24,1900,0.6401233868413108
STAT,1894,23,40-44,1917,2.5244619577450327
STAT,1857,76,na,1933,705.5796072226324
SIM,1847,39,30-34,1886,7
STAT,1853,62,na,1915,1355.4597288760556
STAT,1881,17,20-24,1898,16.170973152857705
SIM,1831,35,25-29,1866,2
STAT,1864,52,50-100,1916,0.012683531645261566
SIM,1879,17,30-34,1896,2
STAT,1844,35,50-100,1879,1.0218566692449689
STAT,1818,54,35-39,1872,0.016949834896374534
STAT,1887,28,50-100,1915,0.6734538531037345
SIM,1863,42,45-49,1905,1
STAT,1797,104,na,1901,0.01624046631872145
STAT,1865,21,20-24,1886,60.30970849212497
STAT,1953,16,45-49,1969,0.5710384142147314
STAT,1872,33,na,1905,2253.1570228721116
STAT,1872,19,20-24,1891,16.720084511517765
STAT,1914,38,na,1952,3530.359983603781
STAT,1898,34,50-100,1932,1.1616876966339973
STAT,1910,24,na,1934,3363.3386950017994
STAT,1866,28,35-39,1894,8.374528400090634
STAT,1874,31,15-19,1905,0.1380610077338799
STAT,1872,35,20-24,1907,0.737862334579987
SIM,1845,18,15-19,1863,7
SIM,1948,22,15-19,1970,4
SIM,1835,96,na,1931,3
STAT,1854,21,45-49,1875,0.5942603968084418
SIM,1919,30,45-49,1949,2
STAT,1844,26,na,1870,1872.5111233574528
STAT,1857,22,25-29,1879,49.21817122258037
STAT,1879,52,20-24,1931,7.247663223248615E-4
STAT,1899,32,30-34,1931,22.60358534600559
SIM,1847,26,25-29,1873,44
STAT,1834,41,35-39,1875,1.368691102465465
SIM,1871,47,na,1918,2161
STAT,1882,75,na,1957,1010.6670304942697
STAT,1883,17,30-34,1900,1.4757112988320904
STAT,1819,59,na,1878,1085.3059924995912
SIM,1850,40,30-34,1890,1
STAT,1819,46,15-19,1865,7.219645461890474E-4
STAT,1846,48,25-29,1894,0.040101879779957154
STAT,1769,116,na,1885,1.0018683035472653E-4
STAT,1846,16,15-19,1862,5.287454268949128
STAT,1826,53,30-34,1879,0.005265487250087844
STAT,1815,105,na,1920,0.012549283907257935
STAT,1894,42,45-49,1936,0.12614206259207797
STAT,1842,41,20-24,1883,0.11851542981006422
STAT,1886,37,15-19,1923,0.05604922434513075
SIM,1860,84,na,1944,237
STAT,1893,44,30-34,1937,0.09440023304131388
SIM,1854,16,15-19,1870,4
STAT,1833,43,20-24,1876,0.11561202699113311
SIM,1864,98,na,1962,14
STAT,1824,41,50-100,1865,1.3708529710508448
STAT,1827,51,45-49,1878,0.012520226707003127
SIM,1843,29,na,1872,1842
STAT,1880,49,15-19,1929,3.892974700734767E-4
STAT,1889,37,40-44,1926,5.105358981565777
STAT,1837,18,15-19,1855,5.221540240635602
STAT,1856,47,30-34,1903,0.07128783401960109
SIM,1847,31,20-24,1878,2
STAT,1842,48,40-44,1890,0.12038182495368974
STAT,1890,39,30-34,1929,6.093850859867164
STAT,1833,30,15-19,1863,0.1140557487149084
STAT,1876,46,45-49,1922,0.23081374175242872
STAT,1879,47,25-29,1926,0.05661092814773138
SIM,1870,25,50-100,1895,1
SIM,1882,19,30-34,1901,2
STAT,1847,7,na,1854,2273.0
STAT,1873,45,50-100,1918,0.23785579736257956
STAT,1815,45,na,1860,1333.0740387954927
SIM,1863,38,25-29,1901,3
STAT,1921,39,35-39,1960,2.5461462362669427
SIM,1945,20,45-49,1965,1
STAT,1876,27,40-44,1903,2.921439864729792
STAT,1901,30,50-100,1931,1.2212780682739857
STAT,1839,31,20-24,1870,2.241118608783825
SIM,1884,27,40-44,1911,3
SIM,1899,63,na,1962,2471
STAT,1843,47,45-49,1890,0.16946969429442388
SIM,1842,66,na,1908,1140
SIM,1882,38,35-39,1920,7
STAT,1843,20,30-34,1863,16.364493902269963
STAT,1885,45,35-39,1930,0.13307875218283033
STAT,1924,43,50-100,1967,0.13181391036931023
SIM,1851,48,na,1899,1661
STAT,1863,83,na,1946,329.6633931598801
STAT,1892,47,40-44,1939,0.11371160381937888
STAT,1836,21,50-100,1857,0.34231307517761056
STAT,1853,41,45-49,1894,1.114942204252783
STAT,1874,38,35-39,1912,6.79525621924628
STAT,1900,25,na,1925,3148.9720622466166
STAT,1843,28,40-44,1871,2.6406036801040145
SIM,1937,15,15-19,1952,41
STAT,1928,36,50-100,1964,0.5017691213719565
SIM,1880,35,20-24,1915,1
STAT,1850,33,na,1883,1739.261337764197
SIM,1835,27,45-49,1862,4
STAT,1905,23,50-100,1928,0.554977092748582
STAT,1938,31,50-100,1969,0.7857286469344172
SIM,1825,86,na,1911,85
SIM,1851,28,40-44,1879,3
STAT,1823,48,30-34,1871,0.11381914562670394
STAT,1824,81,na,1905,285.489960460632
STAT,1867,97,na,1964,15.832750620033014
SIM,1832,44,30-34,1876,4
STAT,1807,53,20-24,1860,0.0025610989554616134
STAT,1870,50,35-39,1920,0.00808366338549148
SIM,1935,26,45-49,1961,2
STAT,1862,20,40-44,1882,1.7439437368579696
STAT,1837,54,45-49,1891,0.008909446512790764
SIM,1889,42,na,1931,2700
STAT,1807,47,35-39,1854,0.5184242717457254
STAT,1897,44,15-19,1941,0.0011952394899811898
STAT,1942,0,na,1942,4415.227113810353
STAT,1920,27,25-29,1947,68.21335338076649
STAT,1855,27,20-24,1882,8.660377184613399
STAT,1876,51,40-44,1927,0.01031627139989986
SIM,1814,48,na,1862,1296
STAT,1949,20,15-19,1969,5.872492213393771
SIM,1914,15,20-24,1929,33
STAT,1823,40,20-24,1863,0.21790969572512806
STAT,1838,84,na,1922,226.88438682426133
STAT,1834,70,na,1904,868.4417373524869
SIM,1895,17,15-19,1912,9
STAT,1859,5,na,1864,2200.604594737287
STAT,1861,19,45-49,1880,0.05820724214605723
STAT,1891,35,30-34,1926,6.29109635947855
STAT,1942,15,30-34,1957,12.039063962874645
STAT,1828,29,50-100,1857,0.8083166369414951
STAT,1878,40,50-100,1918,1.0494538611725683
STAT,1874,44,20-24,1918,0.15126920138430205
STAT,1927,26,45-49,1953,1.9911494399486633
STAT,1894,18,45-49,1912,0.07917325278967763
SIM,1835,32,40-44,1867,8
SIM,1858,32,35-39,1890,7
STAT,1808,51,35-39,1859,0.031945900291567575
STAT,1895,22,45-49,1917,0.8596578863941949
STAT,1852,43,30-34,1895,0.8671762630571144
STAT,1861,81,na,1942,424.21713286622537
STAT,1912,58,na,1970,3163.3247277783626
SIM,1850,85,na,1935,178
SIM,1946,15,na,1961,3842
STAT,1822,36,20-24,1858,1.4683806860063444
STAT,1861,1,na,1862,2862.3459230569033
STAT,1857,46,35-39,1903,0.10456113683144444
SIM,1851,20,30-34,1871,18
SIM,1916,23,30-34,1939,35
STAT,1865,95,na,1960,22.187665005185707
STAT,1890,26,25-29,1916,49.02695601757082
SIM,1897,61,na,1958,2423
STAT,1853,42,35-39,1895,1.3412603362191737
STAT,1945,4,na,1949,4117.959785434517
SIM,1850,16,30-34,1866,1
STAT,1887,17,15-19,1904,6.269832260390578
SIM,1950,15,30-34,1965,21
STAT,1908,23,30-34,1931,24.87844623916605
STAT,1888,1,na,1889,3153.385162471717
STAT,1962,2,na,1964,4761.952022614035
STAT,1828,31,45-49,1859,1.947352981846427
SIM,1892,33,25-29,1925,16
STAT,1800,90,na,1890,31.426441656968517
STAT,1841,105,na,1946,0.02006095618289288
STAT,1887,46,20-24,1933,0.012713953839873149
SIM,1924,25,30-34,1949,50
STAT,1877,31,40-44,1908,4.268730546284033
STAT,1943,19,na,1962,3684.6809061972604
STAT,1842,35,35-39,1877,6.032434731428708
SIM,1945,17,15-19,1962,39
STAT,1873,50,50-100,1923,0.014690266879847192
STAT,1833,25,40-44,1858,2.454043935980928
SIM,1907,25,30-34,1932,41
STAT,1898,23,25-29,1921,72.98101964973993
STAT,1865,16,25-29,1881,5.042555263744745
SIM,1927,24,45-49,1951,1
STAT,1929,15,15-19,1944,54.97267697361459
STAT,1860,54,50-100,1914,0.011276419419603768
STAT,1878,22,45-49,1900,0.685782661270868
STAT,1911,29,25-29,1940,60.19196063618434
SIM,1873,16,25-29,1889,5
STAT,1845,36,15-19,1881,0.04199305126129152
STAT,1884,29,40-44,1913,2.7764909328836973
SIM,1813,85,na,1898,96
SIM,1836,31,45-49,1867,1
SIM,1872,36,25-29,1908,1
STAT,1842,19,35-39,1861,0.4958715744740556
STAT,1883,42,20-24,1925,0.1468587330520983
STAT,1946,15,15-19,1961,47.57898158337091
STAT,1869,19,50-100,1888,0.04488686909565481
STAT,1909,48,50-100,1957,0.19574334066837207
SIM,1880,29,na,1909,2419
STAT,1827,27,45-49,1854,2.985659789738504
STAT,1886,57,na,1943,2005.861236959737
STAT,1838,19,50-100,1857,0.04361823325594129
STAT,1882,43,na,1925,2109.259624189983
STAT,1928,41,na,1969,4479.617764374618
STAT,1863,41,40-44,1904,1.876280695257213
SIM,1845,95,na,1940,9
STAT,1867,48,45-49,1915,0.20670184842356554
STAT,1832,46,30-34,1878,0.07028374947337043
STAT,1866,33,30-34,1899,15.143047924929347
SIM,1875,29,40-44,1904,3
STAT,1780,110,na,1890,0.0017013739885949042
STAT,1816,51,20-24,1867,0.0018976053921404387
SIM,1818,40,40-44,1858,5
SIM,1834,20,30-34,1854,24
STAT,1928,41,50-100,1969,0.1417003589647698
SIM,1850,35,35-39,1885,12
SIM,1925,42,na,1967,4155
STAT,1840,42,50-100,1882,0.7674744302403683
STAT,1918,32,50-100,1950,0.8299714498313613
SIM,1892,29,40-44,1921,3
STAT,1937,17,15-19,1954,41.7029034378127
SIM,1881,18,25-29,1899,4
STAT,1887,20,45-49,1907,0.7411134952072403
STAT,1828,95,na,1923,7.547564686793712
STAT,1868,53,35-39,1921,0.007640495475516191
STAT,1906,20,50-100,1926,0.5643071889212681
SIM,1885,31,40-44,1916,6
SIM,1871,41,40-44,1912,7
STAT,1864,49,30-34,1913,0.08002283695507931
STAT,1868,33,40-44,1901,3.8951116521250984
SIM,1847,11,na,1858,2136
SIM,1856,47,na,1903,1781
STAT,1878,38,na,1916,2305.4994163052856
SIM,1830,43,45-49,1873,3
SIM,1954,15,15-19,1969,49
SIM,1876,33,40-44,1909,4
STAT,1857,51,30-34,1908,0.004454376869739582
STAT,1916,25,30-34,1941,38.53117683629269
STAT,1897,19,25-29,1916,7.121037232519717
STAT,1799,65,na,1864,816.2885378423001
STAT,1846,28,na,1874,1831.9420059496674
STAT,1842,14,na,1856,2163.2233551228
STAT,1817,38,40-44,1855,13.959392747817732
STAT,1849,25,50-100,1874,0.5545064307948074
STAT,1884,21,30-34,1905,16.6786766161703
STAT,1806,52,na,1858,1132.4007338879846
SIM,1864,77,na,1941,723
SIM,1860,63,na,1923,1464
STAT,1783,93,na,1876,5.549819670510129
STAT,1884,51,50-100,1935,0.01416647497179904
SIM,1838,28,25-29,1866,36
SIM,1860,30,25-29,1890,12
STAT,1873,18,25-29,1891,5.419636349151347
SIM,1890,24,25-29,1914,64
STAT,1919,24,45-49,1943,1.1566524315378253
STAT,1850,34,30-34,1884,12.594049796498533
SIM,1825,38,40-44,1863,2
SIM,1839,32,25-29,1871,14
SIM,1938,27,25-29,1965,66
STAT,1853,38,15-19,1891,0.04143810532268957
STAT,1866,42,20-24,1908,0.13815410931770095
STAT,1862,36,15-19,1898,0.04546926811389169
STAT,1864,101,na,1965,2.18721651989435
STAT,1831,34,20-24,1865,2.163207914655506
STAT,1864,41,20-24,1905,0.1346942666356594
SIM,1876,9,na,1885,2640
STAT,1893,38,45-49,1931,2.377573543513333
STAT,1892,32,20-24,1924,3.1977368395401884
SIM,1929,35,na,1964,4665
STAT,1822,43,45-49,1865,2.1976711521812042
STAT,1835,50,40-44,1885,0.006964564452558215
SIM,1844,30,40-44,1874,8
STAT,1870,34,35-39,1904,9.294056894876345
SIM,1918,26,45-49,1944,1
STAT,1867,54,30-34,1921,0.005134720108055415
STAT,1846,52,45-49,1898,0.010177831614442074
STAT,1847,66,na,1913,1205.9651451187274
SIM,1825,30,30-34,1855,20
SIM,1925,21,na,1946,4033
STAT,1909,48,25-29,1957,0.045907232666770555
SIM,1854,29,20-24,1883,17
STAT,1921,44,30-34,1965,0.13559054389504535
SIM,1827,30,40-44,1857,3
STAT,1865,29,30-34,1894,21.462769063980204
STAT,1871,26,15-19,1897,0.4263703294364604
STAT,1894,39,15-19,1933,0.06755335444086502
SIM,1864,66,na,1930,1506
SIM,1943,25,50-100,1968,1
SIM,1860,52,na,1912,1790
STAT,1834,50,50-100,1884,0.00997278853462579
STAT,1826,29,na,1855,1528.168599033352
STAT,1819,81,na,1900,270.0507582542378
STAT,1858,43,25-29,1901,0.4728024028054813
SIM,1865,22,25-29,1887,43
STAT,1873,27,15-19,1900,0.4350591435659139
SIM,1894,21,40-44,1915,3
STAT,1849,52,35-39,1901,0.0061722967466169626
STAT,1816,45,35-39,1861,0.38059949137674154
STAT,1886,21,40-44,1907,2.086179329042121
STAT,1894,43,35-39,1937,0.15170598104001082
STAT,1913,37,50-100,1950,0.391332758286203
STAT,1912,15,45-49,1927,0.0958473285406533
SIM,1877,32,45-49,1909,1
SIM,1910,30,25-29,1940,12
SIM,1899,30,30-34,1929,20
STAT,1902,39,25-29,1941,0.8201458161265205
STAT,1856,18,25-29,1874,4.928485813209503
STAT,1869,32,45-49,1901,1.5946151742329757
SIM,1855,28,25-29,1883,41
STAT,1827,52,35-39,1879,0.00728137726618423
STAT,1848,28,50-100,1876,0.5462169504380783
STAT,1864,36,25-29,1900,2.442637401047255
STAT,1868,52,45-49,1920,0.013020180098318393
STAT,1897,6,na,1903,3300.4923542050806
STAT,1836,30,40-44,1866,3.534243900608421
STAT,1883,36,35-39,1919,6.580104069281197
STAT,1883,49,40-44,1932,0.15519891385973109
STAT,1827,48,15-19,1875,3.458211199138323E-4
STAT,1813,106,na,1919,0.005135053684723685
STAT,1877,43,35-39,1920,1.7623480500279918
STAT,1893,27,na,1920,2860.5249759946705
STAT,1843,63,na,1906,1287.295911378261
SIM,1866,39,40-44,1905,5
STAT,1815,46,30-34,1861,0.2394876428766041
STAT,1814,71,na,1885,627.8839452826406
STAT,1879,12,na,1891,2550.052359779503
STAT,1917,35,50-100,1952,0.41586574532849885
SIM,1864,18,25-29,1882,7
SIM,1885,43,35-39,1928,2
SIM,1879,43,na,1922,2252
STAT,1847,28,25-29,1875,37.141942414642095
SIM,1890,37,30-34,1927,6
STAT,1825,41,20-24,1866,0.18140220297527299
STAT,1902,30,25-29,1932,13.764669131055443
SIM,1843,26,40-44,1869,1
STAT,1764,90,na,1854,20.0
STAT,1843,84,na,1927,240.0016521225465
STAT,1847,98,na,1945,2.390239899014394
STAT,1834,48,na,1882,1458.014916556583
STAT,1893,31,25-29,1924,12.327120968394485
STAT,1848,54,20-24,1902,5.169954435131126E-4
STAT,1835,26,40-44,1861,2.453520255992768
SIM,1886,19,15-19,1905,3
STAT,1861,35,45-49,1896,1.5786958066489287
STAT,1883,41,30-34,1924,1.0692563449746197
SIM,1909,36,45-49,1945,1
STAT,1830,34,na,1864,1641.4715120806202
SIM,1891,41,30-34,1932,4
STAT,1847,77,na,1924,636.0099743886146
STAT,1846,29,20-24,1875,9.863320827776649
STAT,1816,50,30-34,1866,0.015616685977409268
STAT,1826,40,25-29,1866,0.6567259355239242
STAT,1811,74,na,1885,486.4065218411983
STAT,1924,16,na,1940,4151.319552339187
STAT,1882,37,30-34,1919,4.8992147526785255
STAT,1884,48,45-49,1932,0.21754710352106618
SIM,1811,43,35-39,1854,2
SIM,1911,18,na,1929,3684
SIM,1836,59,na,1895,1224
STAT,1876,22,35-39,1898,5.6910834384174205
SIM,1874,36,35-39,1910,11
STAT,1928,30,45-49,1958,1.8610523005981563
STAT,1799,103,na,1902,0.047981410000180365
STAT,1818,51,30-34,1869,0.012443426570937558
STAT,1847,52,25-29,1899,0.002592299063710847
STAT,1868,49,15-19,1917,3.5325747911971097E-4
SIM,1870,62,na,1932,1678
SIM,1905,25,20-24,1930,21
STAT,1861,16,40-44,1877,0.16589444062627684
SIM,1882,26,40-44,1908,6
STAT,1844,51,45-49,1895,0.010236592867866205
STAT,1865,48,35-39,1913,0.11867218249844466
STAT,1930,29,35-39,1959,18.017677792402402
SIM,1874,76,na,1950,870
STAT,1844,32,40-44,1876,3.640611513987184
STAT,1882,33,15-19,1915,0.1303558313605457
STAT,1835,33,na,1868,1703.686503504828
SIM,1884,22,35-39,1906,7
STAT,1794,66,na,1860,728.3803631035913
STAT,1900,46,50-100,1946,0.18208307403871604
SIM,1865,27,30-34,1892,29
STAT,1932,35,na,1967,4783.7043103702845
SIM,1848,43,30-34,1891,5
STAT,1788,92,na,1880,11.09990693940438
SIM,1907,21,15-19,1928,5
STAT,1891,79,na,1970,1244.5734784558952
STAT,1852,49,50-100,1901,0.18270402069565247
STAT,1880,37,20-24,1917,0.766222578442392
STAT,1864,17,20-24,1881,15.484467387557753
STAT,1854,47,na,1901,1612.5443753287902
STAT,1855,0,na,1855,2834.571714443123
STAT,1934,28,50-100,1962,1.2642993404464338
STAT,1850,43,20-24,1893,0.11099708992683324
STAT,1874,26,40-44,1900,2.9022370510308444
STAT,1925,40,50-100,1965,0.1347552220843974
SIM,1885,39,na,1924,2204
STAT,1828,28,15-19,1856,0.6599541494690294
STAT,1869,13,na,1882,2421.0533705990915
STAT,1908,49,20-24,1957,0.009384036645305191
STAT,1874,22,25-29,1896,55.272443060366925
STAT,1895,19,15-19,1914,7.276878117801216
STAT,1848,41,15-19,1889,0.010064802415253538
SIM,1872,17,20-24,1889,10
SIM,1948,17,40-44,1965,1
STAT,1866,36,35-39,1902,6.190087562493341
SIM,1899,38,40-44,1937,1
SIM,1852,32,40-44,1884,3
SIM,1923,16,25-29,1939,53
STAT,1813,46,20-24,1859,0.036919779963329874
STAT,1896,43,45-49,1939,0.12882230353491866
STAT,1923,39,45-49,1962,0.7446885977614217
SIM,1802,90,na,1892,14
STAT,1915,16,25-29,1931,8.588443532651326
STAT,1835,54,35-39,1889,0.005261550333640378
STAT,1839,100,na,1939,0.7078752969746205
STAT,1873,61,na,1934,1791.8502106077624
SIM,1892,21,30-34,1913,23
STAT,1822,40,40-44,1862,3.5791156749970225
STAT,1872,38,25-29,1910,2.7165202971595694
SIM,1849,77,na,1926,570
STAT,1829,52,45-49,1881,0.010294389188878985
SIM,1845,63,na,1908,1259
STAT,1877,75,na,1952,1009.1991520630147
SIM,1885,28,na,1913,2247
STAT,1834,46,40-44,1880,0.12509263032317375
SIM,1817,67,na,1884,846
SIM,1860,43,30-34,1903,1
SIM,1879,26,20-24,1905,11
STAT,1839,47,na,1886,1528.439554454089
SIM,1939,31,25-29,1970,15
SIM,1813,53,na,1866,1176
STAT,1851,22,30-34,1873,15.598623438035927
SIM,1822,34,20-24,1856,2
SIM,1931,39,45-49,1970,1
STAT,1902,69,na,1971,2319.424399453793
SIM,1906,39,na,1945,3285
SIM,1938,24,20-24,1962,87
STAT,1941,31,15-19,1972,0.12752150327743825
SIM,1902,25,na,1927,3207
STAT,1873,39,na,1912,2236.4286240587676
STAT,1854,18,15-19,1872,5.081938743893628
SIM,1839,37,30-34,1876,4
SIM,1916,26,35-39,1942,15
SIM,1885,3,na,1888,2667
STAT,1833,85,na,1918,166.4242827887207
STAT,1856,38,40-44,1894,3.222823134792279
STAT,1867,65,na,1932,1498.997564714633
STAT,1808,52,25-29,1860,0.01288258517221462
STAT,1886,40,45-49,1926,1.5089060198691353
STAT,1898,47,35-39,1945,0.10052025916681259
SIM,1820,40,45-49,1860,1
STAT,1818,42,40-44,1860,5.395628708752125
SIM,1909,34,50-100,1943,4
SIM,1950,18,35-39,1968,4
STAT,1939,30,20-24,1969,2.353473613703705
SIM,1869,42,50-100,1911,3
STAT,1860,32,na,1892,1832.1133938949818
SIM,1927,0,na,1927,4821
SIM,1817,39,45-49,1856,2
STAT,1837,99,na,1936,1.1955181553322605
SIM,1869,30,45-49,1899,3
STAT,1942,18,35-39,1960,4.141073802347863
STAT,1863,51,na,1914,1796.57469359381
SIM,1881,30,45-49,1911,1
STAT,1823,44,50-100,1867,1.293788718530065
STAT,1824,53,20-24,1877,8.185003171075676E-4
STAT,1895,33,50-100,1928,1.1247806329984429
SIM,1851,70,na,1921,996
STAT,1912,3,na,1915,3861.060751799341
STAT,1891,38,35-39,1929,8.229393383863647
STAT,1875,47,40-44,1922,0.16538148099890423
SIM,1830,40,40-44,1870,5
STAT,1885,33,40-44,1918,4.064403588443787
STAT,1841,29,na,1870,1812.041058580939
SIM,1956,15,25-29,1971,61
STAT,1852,30,25-29,1882,8.226461859444067
SIM,1911,27,25-29,1938,65
STAT,1875,43,25-29,1918,0.6187356867428057
STAT,1843,53,30-34,1896,0.004225546112554911
STAT,1903,27,25-29,1930,56.85450791585741
STAT,1839,58,na,1897,1318.606834694732
STAT,1842,44,25-29,1886,0.46114533966466853
STAT,1918,20,na,1938,3742.84388153625
STAT,1905,48,40-44,1953,0.1301779973017916
SIM,1862,18,15-19,1880,7
STAT,1840,31,45-49,1871,1.4946027873343974
SIM,1841,25,40-44,1866,6
SIM,1936,30,45-49,1966,1
STAT,1846,45,20-24,1891,0.008545221041109758
STAT,1888,27,na,1915,2663.384171263852
SIM,1815,97,na,1912,1
STAT,1824,47,35-39,1871,0.1645217687975582
STAT,1891,44,20-24,1935,0.18319452937307923
SIM,1894,40,45-49,1934,3
SIM,1912,39,35-39,1951,4
STAT,1897,39,40-44,1936,1.1817179688801667
STAT,1849,28,35-39,1877,8.185138667946253
STAT,1778,105,na,1883,0.018036291048642766
STAT,1779,88,na,1867,43.420635138864846
SIM,1838,25,20-24,1863,11
STAT,1838,101,na,1939,0.3891791661562414
STAT,1849,19,45-49,1868,0.05727577669484999
STAT,1845,32,50-100,1877,0.7673670988420819
STAT,1878,35,15-19,1913,0.05574982735125777
STAT,1885,42,30-34,1927,1.0807118381938767
STAT,1948,15,25-29,1963,46.87867541902788
SIM,1868,80,na,1948,496
STAT,1862,23,45-49,1885,0.5711093190006655
SIM,1915,43,na,1958,3500
STAT,1816,104,na,1920,0.031081992065931912
SIM,1871,44,45-49,1915,3
SIM,1870,23,45-49,1893,3
STAT,1863,44,45-49,1907,1.2260544573781673
SIM,1873,29,30-34,1902,27
STAT,1904,39,35-39,1943,2.047494216075707
SIM,1878,1,na,1879,3314
SIM,1857,28,35-39,1885,10
SIM,1791,89,na,1880,40
SIM,1935,4,na,1939,5183
STAT,1954,17,15-19,1971,52.9996498373431
STAT,1832,26,15-19,1858,0.3776505515685197
STAT,1873,30,45-49,1903,1.6856067264509111
SIM,1858,37,40-44,1895,5
SIM,1893,36,45-49,1929,2
STAT,1869,41,35-39,1910,1.6633671880412035
SIM,1843,29,45-49,1872,3
SIM,1822,41,45-49,1863,3
STAT,1892,23,30-34,1915,21.00693919432835
STAT,1832,49,35-39,1881,0.08900965896351717
STAT,1902,48,15-19,1950,2.9702278700445274E-4
STAT,1810,89,na,1899,47.573154191844054
STAT,1915,41,15-19,1956,0.001462546993403305
STAT,1916,28,35-39,1944,14.612852769957783
STAT,1837,51,40-44,1888,0.00680338708942202
STAT,1889,42,15-19,1931,0.016086188513838206
SIM,1871,24,15-19,1895,6
SIM,1838,29,na,1867,1705
STAT,1842,16,30-34,1858,1.4661433469143097
STAT,1867,45,40-44,1912,0.15336840636616583
STAT,1881,32,45-49,1913,1.5906169107054355
STAT,1848,16,25-29,1864,5.0907792473440425
SIM,1856,16,25-29,1872,8
STAT,1825,32,30-34,1857,30.669997722441696
STAT,1931,38,40-44,1969,1.871066621628796
STAT,1892,42,35-39,1934,2.139567586667628
SIM,1917,30,35-39,1947,12
STAT,1841,29,50-100,1870,0.5358316925009012
SIM,1892,30,20-24,1922,2
STAT,1883,28,na,1911,2201.8255746172176
SIM,1857,32,na,1889,1912
STAT,1884,30,20-24,1914,2.543696251799799
STAT,1897,16,20-24,1913,22.45351010115925
STAT,1892,64,na,1956,2080.7011817920966
STAT,1825,51,35-39,1876,0.008876273001715965
SIM,1833,32,30-34,1865,20
SIM,1833,30,na,1863,1700
SIM,1837,44,na,1881,1559
STAT,1887,49,25-29,1936,0.0336101180912791
SIM,1849,26,35-39,1875,9
STAT,1868,28,45-49,1896,0.9979427492863998
STAT,1866,23,50-100,1889,0.35551004212148873
SIM,1897,37,40-44,1934,6
STAT,1874,35,30-34,1909,5.194746400925317
SIM,1885,40,30-34,1925,3
STAT,1908,26,35-39,1934,13.564838566991233
SIM,1818,43,45-49,1861,1
STAT,1841,32,15-19,1873,0.11821668436971788
STAT,1859,52,30-34,1911,0.004463882449447993
STAT,1916,20,25-29,1936,91.9800032766367
SIM,1792,74,na,1866,376
STAT,1827,42,50-100,1869,0.971870802534
SIM,1815,44,30-34,1859,4
STAT,1814,41,45-49,1855,4.8760679528494215
SIM,1904,16,15-19,1920,6
SIM,1950,20,na,1970,4009
STAT,1841,27,40-44,1868,2.5456269927057043
STAT,1839,49,50-100,1888,0.1626285266354701
STAT,1832,41,25-29,1873,0.4825939256627754
STAT,1877,34,45-49,1911,1.6948624579369418
STAT,1904,39,na,1943,3184.7401392677693
SIM,1796,88,na,1884,48
STAT,1838,27,20-24,1865,10.178036413878582
SIM,1885,34,45-49,1919,1
STAT,1818,85,na,1903,132.16665642987581
STAT,1834,42,25-29,1876,0.47919120384076014
SIM,1867,10,na,1877,2358
STAT,1858,31,30-34,1889,13.083799135653873
SIM,1898,29,35-39,1927,12
STAT,1842,104,na,1946,0.04749793863955778
STAT,1923,15,20-24,1938,151.10532563813922
SIM,1846,27,20-24,1873,8
STAT,1850,18,30-34,1868,1.3630971686242692
STAT,1840,40,20-24,1880,0.1300729579913155
STAT,1909,30,35-39,1939,8.302241076423188
SIM,1904,37,35-39,1941,3
SIM,1931,15,20-24,1946,181
STAT,1863,24,15-19,1887,2.7541707679879406
SIM,1924,28,35-39,1952,22
STAT,1853,17,45-49,1870,0.058274595625841384
SIM,1899,33,35-39,1932,21
STAT,1898,20,20-24,1918,88.65297006336381
SIM,1855,84,na,1939,225
SIM,1865,51,na,1916,1841
SIM,1882,35,30-34,1917,5
SIM,1877,41,35-39,1918,1
SIM,1880,38,25-29,1918,3
STAT,1888,38,15-19,1926,0.06235822265982017
SIM,1859,98,na,1957,6
STAT,1858,39,40-44,1897,3.213811290115179
STAT,1877,40,30-34,1917,1.13841152109693
STAT,1774,89,na,1863,32.91380844174343
STAT,1854,9,na,1863,2098.658429357419
SIM,1832,28,30-34,1860,22
SIM,1930,27,35-39,1957,19
STAT,1789,66,na,1855,675.3433999999999
SIM,1924,20,25-29,1944,108
SIM,1918,23,40-44,1941,3
STAT,1840,48,30-34,1888,0.06711537373446985
SIM,1835,85,na,1920,141
STAT,1865,26,50-100,1891,0.5510251325199668
STAT,1898,28,30-34,1926,32.08993604725531
STAT,1851,50,25-29,1901,0.0026347422334447464
STAT,1870,22,40-44,1892,1.9289182680574857
SIM,1887,28,20-24,1915,13
SIM,1831,71,na,1902,776
STAT,1882,28,40-44,1910,2.743979400045697
SIM,1872,10,na,1882,2471
STAT,1870,31,30-34,1901,16.22797559117034
STAT,1836,33,45-49,1869,1.3775548561616289
STAT,1848,62,na,1910,1316.7405254020841
STAT,1859,46,45-49,1905,0.17843135818035064
STAT,1899,31,50-100,1930,1.1910313333081775
STAT,1847,37,15-19,1884,0.04286915128119299
STAT,1895,48,20-24,1943,0.008239968306332253
STAT,1893,35,40-44,1928,5.296775850201625
SIM,1935,20,na,1955,4685
STAT,1837,34,15-19,1871,0.11039701490091994
STAT,1879,19,30-34,1898,1.5653976533643155
STAT,1909,21,50-100,1930,0.5793189370386284
SIM,1839,99,na,1938,1
STAT,1938,19,na,1957,3427.344206762078
STAT,1831,37,25-29,1868,2.2737042282494535
STAT,1891,19,30-34,1910,1.8537275001800277
SIM,1866,31,30-34,1897,24
SIM,1889,44,30-34,1933,3
STAT,1861,40,40-44,1901,1.782308884705822
STAT,1889,17,25-29,1906,6.608946747709012
STAT,1870,39,50-100,1909,1.1250458138079915
SIM,1844,33,45-49,1877,1
STAT,1835,29,45-49,1864,0.8899470595306302
STAT,1903,54,na,1957,2851.4629321477187
STAT,1857,27,30-34,1884,19.317158676236286
STAT,1934,16,35-39,1950,5.374852521087271
STAT,1815,42,15-19,1857,0.03897116735675598
STAT,1937,34,na,1971,3529.7923890078887
SIM,1921,39,na,1960,3853
STAT,1826,44,40-44,1870,2.135014787852633
STAT,1793,92,na,1885,11.364768191408396
STAT,1911,26,20-24,1937,16.870899516174376
STAT,1869,29,15-19,1898,0.4119170543613759
STAT,1848,36,40-44,1884,3.2838265059561325
SIM,1901,62,na,1963,2565
STAT,1880,20,35-39,1900,5.835066822073377
SIM,1861,46,50-100,1907,1
STAT,1861,28,50-100,1889,0.5018403337399371
SIM,1920,38,30-34,1958,2
STAT,1850,37,35-39,1887,5.058203924186173
STAT,1883,45,25-29,1928,0.05386162183199317
STAT,1877,43,50-100,1920,1.0281763614499877
SIM,1776,89,na,1865,39
SIM,1897,17,25-29,1914,9
STAT,1912,38,30-34,1950,1.6717517272589275
SIM,1848,46,50-100,1894,1
STAT,1933,20,na,1953,4603.371472265857
STAT,1935,20,35-39,1955,12.120723560430145
STAT,1818,96,na,1914,4.139829552853375
SIM,1834,44,40-44,1878,7
STAT,1865,100,na,1965,3.9195317878282117
STAT,1878,52,40-44,1930,0.010298326784486835
STAT,1821,48,20-24,1869,0.018057761316224847
STAT,1844,103,na,1947,0.10074886203827704
STAT,1851,41,35-39,1892,1.3339079396007403
STAT,1816,54,25-29,1870,0.008577891888248722
STAT,1801,53,na,1854,1154.791301442394
STAT,1874,24,na,1898,2269.233714095015
STAT,1902,17,50-100,1919,0.06531343256059352
STAT,1835,21,35-39,1856,4.87480844037275
SIM,1864,15,20-24,1879,13
SIM,1866,34,35-39,1900,7
SIM,1942,16,35-39,1958,5
STAT,1805,67,na,1872,762.8814545183787
SIM,1888,32,20-24,1920,3
STAT,1857,39,50-100,1896,0.9051597255856092
STAT,1939,18,50-100,1957,0.35412696985758413
STAT,1860,32,25-29,1892,7.863858555356968
STAT,1856,15,20-24,1871,15.694610525657348
STAT,1830,25,15-19,1855,0.5364751354872362
STAT,1894,36,50-100,1930,1.4991588546456454
SIM,1843,21,35-39,1864,4
SIM,1856,36,40-44,1892,2
STAT,1838,46,25-29,1884,0.040937820947323546
STAT,1876,79,na,1955,681.8061701611518
SIM,1943,20,35-39,1963,8
STAT,1872,65,na,1937,1602.4263527878538
SIM,1837,33,na,1870,1716
STAT,1820,38,50-100,1858,2.618613877690739
STAT,1879,28,20-24,1907,11.543235646810205
STAT,1871,34,15-19,1905,0.1322291054562589
STAT,1867,16,35-39,1883,0.5005067896170974
STAT,1855,32,na,1887,1720.8432768926443
SIM,1884,43,na,1927,2245
STAT,1847,48,40-44,1895,0.12438424541671776
STAT,1912,42,15-19,1954,0.0013988782104357095
SIM,1852,35,50-100,1887,3
STAT,1950,21,na,1971,4094.249527510991
SIM,1831,50,na,1881,1406
SIM,1797,73,na,1870,517
STAT,1932,34,40-44,1966,4.908258809806973
STAT,1847,13,na,1860,2182.3348659797975
STAT,1862,49,20-24,1911,0.009468150994599862
SIM,1848,27,30-34,1875,30
SIM,1892,62,na,1954,2173
STAT,1771,100,na,1871,0.14456281763479967
STAT,1844,16,40-44,1860,0.16418499399081096
STAT,1882,48,35-39,1930,0.12707795278105755
STAT,1810,48,45-49,1858,0.8250500322822703
STAT,1921,48,25-29,1969,0.0563393965517832
SIM,1846,16,na,1862,2069
STAT,1832,54,30-34,1886,0.003608138427408503
STAT,1915,37,45-49,1952,0.6505256961948018
SIM,1871,15,na,1886,2467
SIM,1931,36,40-44,1967,1
STAT,1791,108,na,1899,3.362140467884218E-4
SIM,1945,19,na,1964,3680
STAT,1903,44,15-19,1947,0.0012715069214764391
STAT,1875,27,25-29,1902,41.05513736008539
SIM,1939,9,na,1948,3691
STAT,1900,30,15-19,1930,0.1881382287136706
SIM,1867,47,50-100,1914,1
SIM,1890,17,15-19,1907,6
SIM,1806,51,na,1857,1181
SIM,1892,6,na,1898,3156
SIM,1895,28,50-100,1923,4
SIM,1937,19,30-34,1956,9
STAT,1810,68,na,1878,778.7249340556164
SIM,1859,44,na,1903,1896
SIM,1867,63,na,1930,1560
SIM,1900,24,45-49,1924,5
STAT,1891,26,40-44,1917,3.5147534714748834
STAT,1850,45,35-39,1895,0.09954292869244225
STAT,1868,82,na,1950,420.84663641241
SIM,1890,28,40-44,1918,3
SIM,1832,35,40-44,1867,4
STAT,1925,22,na,1947,4129.9325689575035
SIM,1829,46,na,1875,1402
STAT,1952,20,35-39,1972,10.702690411718098
STAT,1824,35,40-44,1859,7.219891976391389
SIM,1905,54,na,1959,2875
STAT,1924,19,50-100,1943,0.4192572438353128
STAT,1858,18,35-39,1876,0.47255889953914676
SIM,1883,27,25-29,1910,39
STAT,1885,49,15-19,1934,3.6861099090585087E-4
STAT,1929,19,30-34,1948,14.617172054475828
STAT,1930,26,30-34,1956,47.09054922028567
STAT,1809,71,na,1880,658.730928865708
STAT,1909,45,20-24,1954,0.009682874398651896
SIM,1846,26,na,1872,1859
SIM,1880,8,na,1888,2698
STAT,1906,44,40-44,1950,0.21196209565500274
SIM,1823,37,40-44,1860,7
STAT,1855,42,na,1897,1634.889735464268
STAT,1867,29,40-44,1896,2.638076070283123
SIM,1884,33,na,1917,2324
STAT,1794,106,na,1900,0.002181580757208039
STAT,1869,0,na,1869,3428.1978975346
SIM,1839,29,30-34,1868,26
STAT,1833,53,35-39,1886,0.005292838874067389
STAT,1855,10,na,1865,2036.149765920596
SIM,1797,83,na,1880,122
STAT,1919,40,45-49,1959,0.17085488055978934
STAT,1864,44,25-29,1908,0.5348616821877068
SIM,1889,28,30-34,1917,35
STAT,1856,52,50-100,1908,0.011114946334174884
STAT,1927,35,na,1962,4426.99300806927
SIM,1914,37,na,1951,3820
STAT,1862,25,50-100,1887,0.5248991512963906
SIM,1869,76,na,1945,799
STAT,1823,86,na,1909,116.75970073111458
STAT,1896,40,40-44,1936,0.19698140856650523
STAT,1831,45,25-29,1876,0.043452944503851634
SIM,1852,2,na,1854,2650
STAT,1904,36,30-34,1940,1.566011859614794
SIM,1855,62,na,1917,1382
STAT,1830,46,20-24,1876,0.008909417789136165
STAT,1881,49,30-34,1930,0.08645199366238043
SIM,1857,43,na,1900,1832
STAT,1868,60,na,1928,1720.2322637800553
STAT,1917,25,na,1942,3736.3923362449045
SIM,1864,0,na,1864,3223
STAT,1918,41,40-44,1959,0.25158527633406635
STAT,1917,35,na,1952,3726.4553359255915
SIM,1878,17,15-19,1895,6
SIM,1859,66,na,1925,1357
SIM,1906,18,na,1924,3537
SIM,1864,38,40-44,1902,5
STAT,1900,43,35-39,1943,0.1636117138521347
STAT,1813,54,20-24,1867,0.0020465916714205432
SIM,1855,17,20-24,1872,15
STAT,1899,19,35-39,1918,0.70655669989144
SIM,1888,16,20-24,1904,17
STAT,1909,5,na,1914,3711.7493406044878
STAT,1853,46,15-19,1899,2.9748510763928074E-4
SIM,1923,37,45-49,1960,1
SIM,1854,45,na,1899,1789
STAT,1938,1,na,1939,3891.1738592145866
SIM,1856,26,na,1882,1961
SIM,1905,28,25-29,1933,60
STAT,1806,51,50-100,1857,0.04350806438979879
STAT,1948,19,40-44,1967,1.5112721006398118
SIM,1821,40,na,1861,1492
STAT,1891,40,50-100,1931,1.2477810841986714
SIM,1914,29,50-100,1943,1
STAT,1847,17,20-24,1864,16.280762249019208
SIM,1860,45,45-49,1905,2
SIM,1891,40,50-100,1931,2
STAT,1840,23,50-100,1863,0.3585603140852404
SIM,1865,19,30-34,1884,1
SIM,1870,44,50-100,1914,1
STAT,1871,48,na,1919,2080.5981923099957
STAT,1840,43,25-29,1883,0.460565471582236
SIM,1904,34,30-34,1938,21
STAT,1903,30,40-44,1933,5.875542166190468
SIM,1895,27,na,1922,2956
STAT,1942,28,50-100,1970,0.9863741947132321
SIM,1839,46,na,1885,1599
STAT,1907,18,40-44,1925,0.253107082834347
STAT,1954,9,na,1963,4589.122699058965
STAT,1823,43,25-29,1866,0.8087365785068684
STAT,1929,31,15-19,1960,0.1543002458837744
SIM,1921,34,30-34,1955,21
SIM,1880,61,na,1941,1974
STAT,1834,104,na,1938,0.041284416234775995
SIM,1884,32,50-100,1916,5
STAT,1820,42,45-49,1862,2.6998475033587517
STAT,1845,32,na,1877,1815.1011180232374
SIM,1842,26,25-29,1868,37
SIM,1894,43,na,1937,2956
SIM,1789,86,na,1875,54
SIM,1804,70,na,1874,607
STAT,1865,53,30-34,1918,0.005027889870587282
STAT,1877,43,na,1920,2249.3803231505494
STAT,1834,26,25-29,1860,34.58311121502418
STAT,1913,34,30-34,1947,14.678125742089655
STAT,1880,45,20-24,1925,0.012046898387423306
STAT,1922,44,25-29,1966,0.0771782828812931
STAT,1857,19,30-34,1876,1.37878906850936
SIM,1871,25,na,1896,2290
STAT,1761,93,na,1854,4.0
SIM,1853,46,50-100,1899,1
STAT,1885,17,40-44,1902,0.17214458333960922
SIM,1854,13,na,1867,2219
SIM,1911,30,40-44,1941,2
SIM,1862,32,na,1894,2069
SIM,1867,95,na,1962,24
STAT,1884,13,na,1897,2407.137988008722
STAT,1831,83,na,1914,242.1084927367248
STAT,1910,41,50-100,1951,0.1054607246204764
STAT,1892,10,na,1902,3064.37324298956
SIM,1872,32,na,1904,2225
STAT,1835,38,20-24,1873,0.5884648694010056
STAT,1895,39,30-34,1934,6.504175185760052
STAT,1903,24,20-24,1927,92.0408482138927
SIM,1911,24,20-24,1935,103
STAT,1810,53,40-44,1863,0.03502197228395758
STAT,1850,28,45-49,1878,0.9132483014501203
STAT,1881,36,25-29,1917,2.6388826133891135
STAT,1890,34,25-29,1924,11.729196804218137
STAT,1802,53,50-100,1855,0.042192201032849826
STAT,1851,49,45-49,1900,0.16944926236504326
STAT,1814,45,25-29,1859,0.16142583719744946
STAT,1830,33,15-19,1863,0.11722381883259289
STAT,1828,48,30-34,1876,0.08046493721775537
SIM,1884,65,na,1949,1604
SIM,1934,35,na,1969,4840
STAT,1839,18,25-29,1857,4.913604964262032
SIM,1875,82,na,1957,508
STAT,1854,47,20-24,1901,0.008600845650164737
STAT,1923,36,40-44,1959,1.6402450039834615
SIM,1912,18,15-19,1930,7
STAT,1935,25,50-100,1960,1.28280357521188
SIM,1922,24,na,1946,3920
STAT,1854,38,30-34,1892,3.818762712712525
STAT,1871,47,20-24,1918,0.011186127286509237
STAT,1888,80,na,1968,1070.9682159064894
SIM,1875,50,na,1925,2079
STAT,1775,107,na,1882,0.007259508821258711
STAT,1894,22,50-100,1916,0.49555516789722104
STAT,1890,47,30-34,1937,0.06277421467202947
STAT,1865,36,40-44,1901,3.775931387826572
STAT,1872,12,na,1884,2495.63710524302
STAT,1858,82,na,1940,346.0313481655359
SIM,1839,24,na,1863,1875
STAT,1885,30,na,1915,2263.9999466527483
STAT,1891,46,35-39,1937,0.09260426855228165
SIM,1816,71,na,1887,559
STAT,1880,34,50-100,1914,0.9029491857233165
STAT,1800,68,na,1868,724.8117820020045
STAT,1913,46,25-29,1959,0.04902157819730032
SIM,1830,86,na,1916,117
STAT,1875,18,35-39,1893,0.5311478238800721
STAT,1784,88,na,1872,36.874670110499395
SIM,1880,83,na,1963,642
STAT,1851,54,40-44,1905,0.007507800802062208
SIM,1935,25,50-100,1960,2
STAT,1792,108,na,1900,3.084639846188394E-4
SIM,1873,36,40-44,1909,5
STAT,1905,24,na,1929,3208.4469594213347
STAT,1923,18,25-29,1941,47.949815933633246
STAT,1855,46,25-29,1901,0.04091026184754331
STAT,1935,22,na,1957,4697.5664942557805
SIM,1931,18,25-29,1949,65
STAT,1849,50,20-24,1899,5.395289445021515E-4
STAT,1856,28,50-100,1884,0.48693043736132313
STAT,1924,35,45-49,1959,0.7607973935094635
STAT,1908,42,na,1950,3245.300883907716
SIM,1864,45,na,1909,2033
SIM,1847,18,25-29,1865,7
SIM,1880,34,50-100,1914,4
STAT,1920,44,15-19,1964,0.0015970125161070727
SIM,1872,64,na,1936,1634
STAT,1860,44,40-44,1904,1.703593332643246
STAT,1898,20,50-100,1918,0.5246048846626722
STAT,1885,62,na,1947,1720.222823660264
STAT,1904,18,15-19,1922,8.019201049662115
STAT,1922,24,30-34,1946,30.94404660019059
STAT,1872,46,25-29,1918,0.05477151857764134
STAT,1838,19,20-24,1857,15.783987847790929
STAT,1844,48,15-19,1892,2.7727513093952247E-4
STAT,1907,35,45-49,1942,0.6026643204936467
STAT,1928,19,na,1947,4358.291274654726
STAT,1900,26,45-49,1926,1.4601453404933955
STAT,1861,43,45-49,1904,1.165598001402438
SIM,1929,17,30-34,1946,21
STAT,1809,48,20-24,1857,0.04297792241433791
STAT,1843,103,na,1946,0.10353968477412426
SIM,1898,20,50-100,1918,1
SIM,1902,34,20-24,1936,2
SIM,1930,24,30-34,1954,39
SIM,1846,19,20-24,1865,19
SIM,1866,14,na,1880,2372
STAT,1839,49,45-49,1888,0.15627171151874705
STAT,1874,19,30-34,1893,1.5306782331108109
STAT,1842,43,35-39,1885,1.3171475567239097
STAT,1891,29,45-49,1920,1.2890058224566499
SIM,1802,69,na,1871,725
STAT,1840,35,25-29,1875,2.4213339745374656
STAT,1873,29,na,1902,2272.100977170909
SIM,1895,59,na,1954,2415
SIM,1923,34,40-44,1957,8
STAT,1900,31,40-44,1931,5.706882235241399
STAT,1921,45,20-24,1966,0.011825492441561933
STAT,1953,18,na,1971,4205.047783171178
STAT,1932,37,45-49,1969,0.8653182463123322
STAT,1813,86,na,1899,93.83752403419481
STAT,1821,43,15-19,1864,0.02236212896979591
STAT,1824,52,30-34,1876,0.006735205093399925
SIM,1809,48,na,1857,1293
STAT,1907,30,25-29,1937,8.225707287030023
STAT,1872,97,na,1969,27.325279286917826
STAT,1917,47,20-24,1964,0.01090410500219516
STAT,1913,53,na,1966,3314.655774999498
STAT,1875,62,na,1937,1773.8825656670572
SIM,1857,37,25-29,1894,1
STAT,1773,94,na,1867,2.7819803149956925
SIM,1855,94,na,1949,15
STAT,1824,38,45-49,1862,2.849550054637563
STAT,1873,38,40-44,1911,4.176803684964374
SIM,1898,33,50-100,1931,2
STAT,1856,59,na,1915,1437.9574422746264
STAT,1830,49,25-29,1879,0.04113995060407226
STAT,1914,20,15-19,1934,4.95864421972289
SIM,1934,25,na,1959,4698
SIM,1793,69,na,1862,613
STAT,1829,29,20-24,1858,12.841830356133025
STAT,1852,18,40-44,1870,0.16708257379776614
SIM,1821,72,na,1893,706
SIM,1942,6,na,1948,3764
STAT,1891,43,30-34,1934,1.3346037665044788
STAT,1845,40,35-39,1885,1.3325803455472869
STAT,1851,28,na,1879,1844.073033716375
STAT,1831,73,na,1904,724.3688317459342
STAT,1899,16,30-34,1915,2.0685127102985486
STAT,1844,19,45-49,1863,0.057607450050127455
SIM,1904,59,na,1963,2758
SIM,1847,43,na,1890,1611
STAT,1803,66,na,1869,766.6803361654373
STAT,1878,19,15-19,1897,5.8050497998702
STAT,1880,28,30-34,1908,24.942660327504143
STAT,1947,6,na,1953,4203.130836545911
STAT,1910,45,45-49,1955,0.1924072162648206
STAT,1829,26,na,1855,1708.688656704482
STAT,1838,50,45-49,1888,0.01024313476347304
SIM,1864,13,na,1877,2403
STAT,1849,37,25-29,1886,2.123579624006884
SIM,1917,34,50-100,1951,1
SIM,1885,60,na,1945,1796
STAT,1856,27,15-19,1883,0.3478535440355044
SIM,1800,56,na,1856,1061
SIM,1873,5,na,1878,2641
STAT,1831,42,20-24,1873,0.12095919289729949
STAT,1853,46,50-100,1899,0.18265600952900346
STAT,1873,47,30-34,1920,0.09238958371986179
SIM,1834,28,40-44,1862,2
SIM,1909,36,na,1945,3370
SIM,1914,18,25-29,1932,15
STAT,1923,40,25-29,1963,0.07907263445326515
SIM,1853,40,35-39,1893,1
SIM,1922,20,15-19,1942,8
SIM,1849,5,na,1854,2246
STAT,1844,21,50-100,1865,0.3600149186337564
STAT,1881,45,50-100,1926,0.2262559693359974
SIM,1905,7,na,1912,3554
STAT,1808,97,na,1905,2.0881115643138908
STAT,1923,44,40-44,1967,0.27528113043476454
STAT,1876,54,45-49,1930,0.013764103440080267
STAT,1878,60,na,1938,1875.6206647193505
STAT,1906,47,45-49,1953,0.1822723610583861
STAT,1796,89,na,1885,40.9643522278179
STAT,1900,40,30-34,1940,0.1056871030854127
STAT,1921,36,30-34,1957,1.92441282126453
SIM,1898,38,25-29,1936,1
SIM,1860,42,40-44,1902,6
STAT,1848,29,30-34,1877,21.34779372455688
SIM,1817,77,na,1894,472
STAT,1904,40,15-19,1944,0.0013123621189958233
SIM,1804,92,na,1896,17
SIM,1856,29,30-34,1885,22
STAT,1882,17,15-19,1899,5.455336217746805
STAT,1836,46,15-19,1882,2.6775445355432727E-4
STAT,1831,44,50-100,1875,0.783582744442748
SIM,1888,19,25-29,1907,6
SIM,1941,20,25-29,1961,94
STAT,1864,25,na,1889,2036.5041961064726
STAT,1858,15,30-34,1873,1.3972147673907798
STAT,1875,84,na,1959,431.698224389013
STAT,1769,99,na,1868,0.28927375028054025
STAT,1826,28,40-44,1854,9.125210138540492
SIM,1964,0,na,1964,4497
STAT,1892,32,na,1924,2823.0221695703917
STAT,1891,58,na,1949,2312.418034551051
SIM,1881,38,40-44,1919,6
SIM,1904,37,na,1941,3160
STAT,1888,37,na,1925,2629.294446156509
STAT,1819,50,35-39,1869,0.015301677491212414
STAT,1854,15,na,1869,2000.8043785747047
STAT,1869,49,30-34,1918,0.08666930422334386
STAT,1933,20,25-29,1953,116.43874793520891
SIM,1866,15,30-34,1881,1
STAT,1920,24,20-24,1944,116.05542421798049
SIM,1883,42,35-39,1925,5
SIM,1850,43,35-39,1893,2
STAT,1877,18,45-49,1895,0.06386898432315727
STAT,1934,32,35-39,1966,11.786657731149608
STAT,1881,58,na,1939,1803.8536326555281
STAT,1911,46,15-19,1957,3.301945671861259E-4
STAT,1903,9,na,1912,3487.2726448759877
SIM,1919,36,na,1955,3828
STAT,1846,101,na,1947,0.4023309777523533
STAT,1843,52,40-44,1895,0.0075547961380251554
STAT,1893,19,40-44,1912,0.2180548465263892
STAT,1915,34,40-44,1949,3.7325593116297227
STAT,1875,42,35-39,1917,1.7552998999186697
STAT,1860,16,25-29,1876,5.047464532702514
STAT,1938,29,25-29,1967,61.53381602420009
STAT,1869,16,45-49,1885,0.06091927457121313
SIM,1867,27,40-44,1894,6
STAT,1890,31,20-24,1921,3.1348647690029146
STAT,1805,52,20-24,1857,0.002152806728702847
STAT,1863,48,25-29,1911,0.04723081348988945
SIM,1896,18,20-24,1914,20
SIM,1923,42,40-44,1965,2
STAT,1886,41,35-39,1927,1.8155951022723833
STAT,1919,29,15-19,1948,0.7154393508674994
STAT,1781,81,na,1862,177.98783057660387
SIM,1840,64,na,1904,1167
STAT,1847,101,na,1948,0.4198583913730129
STAT,1829,48,na,1877,1486.1346927834566
SIM,1846,48,na,1894,1558
STAT,1863,61,na,1924,1551.7403614431557
SIM,1876,14,na,1890,2572
STAT,1864,46,na,1910,1904.957999896484
STAT,1923,31,20-24,1954,2.6526374521713207
STAT,1859,14,na,1873,2070.260274248393
STAT,1880,31,na,1911,2381.6828713412933
STAT,1817,90,na,1907,34.96289123544262
SIM,1834,90,na,1924,39
STAT,1802,54,45-49,1856,0.03973749650981043
SIM,1877,0,na,1877,3407
STAT,1898,37,na,1935,3012.887059046693
STAT,1809,46,50-100,1855,0.9125734986608561
STAT,1868,50,30-34,1918,0.00544621862523391
STAT,1900,23,40-44,1923,2.7225791931845307
SIM,1826,29,45-49,1855,5
SIM,1918,19,20-24,1937,130
STAT,1913,23,50-100,1936,0.6256145110085419
SIM,1909,58,na,1967,2986
SIM,1829,27,20-24,1856,6
SIM,1821,50,na,1871,1312
STAT,1917,20,40-44,1937,3.3959175582222856
STAT,1804,50,na,1854,1221.8472409169447
STAT,1926,30,35-39,1956,10.451770140389817
SIM,1886,4,na,1890,2560
STAT,1850,25,40-44,1875,2.5177601098436364
SIM,1787,73,na,1860,439
STAT,1839,26,na,1865,1830.2518881155502
SIM,1862,38,30-34,1900,4
STAT,1870,38,15-19,1908,0.05172274105472126
STAT,1908,42,35-39,1950,0.17595800434524178
STAT,1841,16,15-19,1857,5.26783811063653
STAT,1855,17,50-100,1872,0.04126963272648069
SIM,1806,83,na,1889,106
STAT,1841,47,35-39,1888,0.09622106064470287
STAT,1915,42,40-44,1957,0.23786929922385786
STAT,1888,49,40-44,1937,0.10552403591056252
STAT,1763,94,na,1857,1.3765394475133919
STAT,1801,85,na,1886,93.18574742776225
STAT,1883,44,35-39,1927,1.653942337455131
STAT,1888,18,20-24,1906,19.73338380734318
STAT,1866,17,30-34,1883,1.4249184880880321
SIM,1934,30,35-39,1964,16
SIM,1901,30,na,1931,3245
STAT,1922,48,50-100,1970,0.24480206087307066
STAT,1902,36,20-24,1938,0.22287805544603642
SIM,1899,17,35-39,1916,4
SIM,1847,15,20-24,1862,18
STAT,1821,35,15-19,1856,0.13352668864933506
SIM,1811,72,na,1883,521
STAT,1857,54,35-39,1911,0.006235288645439782
SIM,1817,46,50-100,1863,3
STAT,1848,94,na,1942,14.398440733254102
SIM,1839,16,25-29,1855,7
STAT,1940,8,na,1948,3809.562928111927
STAT,1942,24,na,1966,3614.4775850510428
STAT,1859,27,40-44,1886,2.297411869150519
STAT,1938,29,na,1967,3502.188689644765
STAT,1922,36,na,1958,4048.1126308257603
SIM,1842,41,35-39,1883,1
SIM,1869,44,na,1913,2101
SIM,1931,31,20-24,1962,2
STAT,1918,52,na,1970,3631.0363136030555
SIM,1874,17,30-34,1891,1
STAT,1888,59,na,1947,2168.9257264501343
STAT,1916,41,30-34,1957,0.12394175839409041
SIM,1840,86,na,1926,117
STAT,1896,47,25-29,1943,0.040377183280388675
SIM,1840,37,40-44,1877,4
STAT,1865,39,45-49,1904,1.6940749080818565
STAT,1786,69,na,1855,639.6975999999999
SIM,1826,71,na,1897,683
STAT,1875,40,20-24,1915,0.15568935446848642
STAT,1797,85,na,1882,89.34035036257043
STAT,1816,53,35-39,1869,0.0212703660506749
STAT,1850,42,30-34,1892,0.8083726341122902
SIM,1847,65,na,1912,1176
STAT,1863,29,na,1892,1967.6370104366504
STAT,1882,32,25-29,1914,9.415514749990649
STAT,1849,79,na,1928,503.90865347647826
STAT,1839,15,20-24,1854,15.647222922776217
SIM,1861,15,na,1876,2317
STAT,1851,19,50-100,1870,0.04316707199411607
SIM,1912,24,na,1936,3303
STAT,1839,46,40-44,1885,0.11780515756392447
SIM,1779,86,na,1865,64
STAT,1879,51,45-49,1930,0.014398586915828829
SIM,1839,78,na,1917,526
STAT,1789,87,na,1876,51.27188542457135
SIM,1821,37,30-34,1858,9
SIM,1873,39,45-49,1912,2
STAT,1815,41,25-29,1856,1.9002315459037014
STAT,1927,42,45-49,1969,0.19720533426594444
STAT,1930,23,na,1953,4406.038056306384
STAT,1897,28,15-19,1925,0.5711970446486465
SIM,1780,94,na,1874,3
STAT,1832,37,40-44,1869,3.3558297877823646
STAT,1840,34,na,1874,1800.5464673483427
SIM,1849,39,40-44,1888,7
SIM,1834,47,na,1881,1449
SIM,1841,18,30-34,1859,1
STAT,1776,107,na,1883,0.006770905119193449
STAT,1872,43,20-24,1915,0.149499076927155
STAT,1822,47,25-29,1869,0.08035154286650516
SIM,1870,83,na,1953,317
STAT,1810,45,40-44,1855,0.6295963683527396
SIM,1814,70,na,1884,649
SIM,1925,20,40-44,1945,3
STAT,1835,53,45-49,1888,0.009046879864194344
STAT,1930,30,15-19,1960,0.1568533739472446
SIM,1885,82,na,1967,675
SIM,1915,30,25-29,1945,8
STAT,1945,19,15-19,1964,46.80231169856166
STAT,1877,47,15-19,1924,3.9029834744326597E-4
SIM,1921,37,35-39,1958,5
STAT,1935,35,20-24,1970,0.348808798784372
STAT,1913,37,35-39,1950,2.254434682728216
SIM,1890,32,25-29,1922,11
SIM,1877,31,na,1908,2320
STAT,1913,43,20-24,1956,0.016240200220757103
STAT,1894,40,30-34,1934,1.4111973768433512
STAT,1806,84,na,1890,110.69318340332367
STAT,1839,27,15-19,1866,0.3811024765178152
SIM,1909,48,50-100,1957,1
STAT,1901,30,30-34,1931,23.27233116378281
STAT,1828,44,15-19,1872,0.011782293815141813
SIM,1881,78,na,1959,754
STAT,1807,52,30-34,1859,0.02107762312972285
STAT,1849,57,na,1906,1448.5235937733996
STAT,1858,23,50-100,1881,0.31349837453088664
STAT,1880,63,na,1943,1773.595608161942
STAT,1825,43,35-39,1868,1.9783356739931843
SIM,1908,41,na,1949,3202
SIM,1862,96,na,1958,9
SIM,1859,12,na,1871,2306
STAT,1864,40,45-49,1904,1.2763798888574807
STAT,1890,38,40-44,1928,5.031055576987402
STAT,1840,32,20-24,1872,2.2928174440960993
STAT,1878,59,na,1937,1911.3047239148402
STAT,1893,39,20-24,1932,0.9146526576571489
SIM,1790,94,na,1884,3
STAT,1931,18,na,1949,4539.473679332448
STAT,1787,75,na,1862,391.89815944366956
STAT,1884,6,na,1890,2438.739300505804
SIM,1824,69,na,1893,809
STAT,1826,48,20-24,1874,0.01107060404520929
STAT,1888,45,25-29,1933,0.06492305018228807
SIM,1873,59,na,1932,1854
STAT,1895,47,50-100,1942,0.16999443379686313
STAT,1892,34,35-39,1926,11.87781652389983
SIM,1856,79,na,1935,474
STAT,1830,37,30-34,1867,4.229735734426856
STAT,1911,34,20-24,1945,2.2240985353530522
STAT,1885,44,45-49,1929,1.38959329707565
SIM,1841,42,30-34,1883,5
STAT,1871,30,35-39,1901,9.560674616846219
STAT,1910,42,40-44,1952,0.22324825955553068
STAT,1872,34,50-100,1906,0.8613479456454428
STAT,1859,47,50-100,1906,0.18430062453696633
STAT,1860,31,35-39,1891,7.806927087573813
SIM,1920,31,45-49,1951,2
SIM,1929,29,25-29,1958,96
STAT,1843,16,25-29,1859,5.255510535374085
STAT,1931,20,15-19,1951,6.561276697667378
STAT,1922,48,40-44,1970,0.17064378197099805
STAT,1900,34,45-49,1934,2.2658681187543697
SIM,1833,43,35-39,1876,2
STAT,1838,94,na,1932,13.630991030146225
STAT,1895,35,15-19,1930,0.0698847921567588
SIM,1932,30,25-29,1962,13
STAT,1913,30,15-19,1943,0.12172450474000437
STAT,1907,32,40-44,1939,3.454991011446238
STAT,1855,64,na,1919,1231.169385565414
STAT,1927,25,50-100,1952,1.151017938478078
SIM,1765,95,na,1860,4
SIM,1873,49,na,1922,2117
STAT,1815,48,45-49,1863,0.564901023591073
SIM,1915,32,40-44,1947,6
STAT,1783,72,na,1855,428.40747
STAT,1891,26,na,1917,2800.154201257257
STAT,1817,47,na,1864,1285.2492999700876
STAT,1870,31,na,1901,2217.9624452837984
STAT,1823,54,na,1877,1219.5744905715612
STAT,1902,41,50-100,1943,0.0982451971192907
STAT,1924,30,25-29,1954,10.233789566319565
STAT,1823,47,40-44,1870,0.20422338058838102
STAT,1847,17,50-100,1864,0.04499104359495762
SIM,1879,18,20-24,1897,14
SIM,1872,40,45-49,1912,1
STAT,1818,53,45-49,1871,0.029149100367890163
STAT,1925,2,na,1927,4667.857630949082
STAT,1851,71,na,1922,978.8312301567727
STAT,1912,26,na,1938,3498.6589827892417
SIM,1854,67,na,1921,1172
SIM,1851,16,25-29,1867,7
STAT,1773,109,na,1882,0.0021826244524396207
STAT,1836,82,na,1918,294.6416861753962
STAT,1916,8,na,1924,3984.334662108243
STAT,1912,31,45-49,1943,1.4683874337565739
STAT,1865,17,15-19,1882,5.249773393121131
SIM,1823,84,na,1907,177
STAT,1910,18,50-100,1928,0.0699266280865104
STAT,1920,45,na,1965,3854.698342815199
STAT,1852,38,20-24,1890,0.5827647469415171
SIM,1790,72,na,1862,464
STAT,1917,40,35-39,1957,0.19906363642047825
STAT,1911,29,50-100,1940,0.9102374881387211
SIM,1862,86,na,1948,157
STAT,1851,33,35-39,1884,7.649647375722228
STAT,1914,48,50-100,1962,0.21128325045738727
STAT,1896,44,20-24,1940,0.013583332959392794
STAT,1947,19,25-29,1966,46.08744337173016
STAT,1904,44,30-34,1948,0.10670274370831526
STAT,1861,71,na,1932,1047.1199275308456
STAT,1859,54,45-49,1913,0.010640387579620856
STAT,1888,69,na,1957,1692.2191053545064
STAT,1923,47,45-49,1970,0.24020806644257478
STAT,1950,20,25-29,1970,103.59819448445825
SIM,1884,11,na,1895,2536
STAT,1890,30,45-49,1920,2.0303518578682413
STAT,1947,19,50-100,1966,0.39845043864538177
SIM,1849,15,30-34,1864,1
SIM,1894,35,50-100,1929,6
STAT,1804,72,na,1876,571.2276680956387
STAT,1823,64,na,1887,932.9348332799152
SIM,1902,41,45-49,1943,1
STAT,1893,43,40-44,1936,0.18586460999673932
SIM,1841,49,na,1890,1539
STAT,1841,31,25-29,1872,8.591428348933757
SIM,1912,25,50-100,1937,5
SIM,1841,27,na,1868,1871
STAT,1823,32,na,1855,1503.3392931488943
STAT,1886,49,30-34,1935,0.0946010991418934
SIM,1878,40,50-100,1918,2
STAT,1897,43,25-29,1940,0.0559321235932694
STAT,1841,38,45-49,1879,1.5903738909546874
STAT,1772,109,na,1881,0.0026563734487855964
STAT,1899,28,25-29,1927,54.57122005924476
SIM,1873,17,15-19,1890,2
SIM,1901,31,35-39,1932,15
STAT,1883,40,50-100,1923,0.98800378326091
STAT,1833,64,na,1897,1055.3400822019103
SIM,1815,102,na,1917,1
STAT,1864,48,40-44,1912,0.14272977709217058
STAT,1906,29,50-100,1935,0.8736773588804967
STAT,1874,43,30-34,1917,1.102022241682078
STAT,1905,30,15-19,1935,0.1959712919802836
STAT,1866,15,15-19,1881,5.368540593359418
SIM,1902,40,40-44,1942,3
STAT,1902,26,na,1928,3192.5074221113055
STAT,1876,3,na,1879,2998.3152470656255
STAT,1814,46,50-100,1860,0.6771919622448385
STAT,1925,18,35-39,1943,4.776629784203399
STAT,1894,76,na,1970,1565.248584698203
SIM,1940,30,25-29,1970,17
STAT,1847,44,25-29,1891,0.46611413607317687
SIM,1870,31,45-49,1901,1
STAT,1922,41,20-24,1963,0.019178438697943435
SIM,1933,18,35-39,1951,5
SIM,1820,66,na,1886,823
SIM,1841,17,na,1858,2066
STAT,1906,19,na,1925,3455.6150014214372
STAT,1892,28,50-100,1920,0.7540966405429027
STAT,1959,13,na,1972,4852.20244471457
STAT,1813,50,40-44,1863,0.031638323101169395
STAT,1862,44,50-100,1906,0.8398375568864643
STAT,1856,46,40-44,1902,0.12702949010605066
SIM,1874,15,15-19,1889,7
STAT,1915,45,45-49,1960,0.20784585569896827
STAT,1870,33,45-49,1903,1.607391065797012
STAT,1873,34,25-29,1907,9.737628949602303
STAT,1845,48,30-34,1893,0.06732737865948223
STAT,1868,45,50-100,1913,0.22373407382291216
STAT,1888,39,50-100,1927,1.3563832064838617
STAT,1873,31,20-24,1904,2.6025780313237736
STAT,1876,32,50-100,1908,0.893573421672809
STAT,1858,42,35-39,1900,1.3412997312222956
STAT,1899,45,50-100,1944,0.18114235062653952
STAT,1866,59,na,1925,1692.735962943696
STAT,1941,18,na,1959,3580.1323001908886
STAT,1969,0,na,1969,4673.531495037246
STAT,1911,41,45-49,1952,0.15089337790306684
STAT,1920,30,40-44,1950,4.082127665586856
STAT,1836,50,35-39,1886,0.005723000116098035
SIM,1906,60,na,1966,2873
SIM,1857,8,na,1865,2341
STAT,1826,52,40-44,1878,0.009499149930206818
STAT,1874,78,na,1952,754.4013632781458
STAT,1870,63,na,1933,1651.6760058017635
STAT,1820,99,na,1919,1.00892815449586
STAT,1846,53,20-24,1899,5.119328742409918E-4
SIM,1928,17,15-19,1945,46
SIM,1869,12,na,1881,2422
SIM,1872,96,na,1968,47
STAT,1912,46,30-34,1958,0.0811171893706168
SIM,1881,31,20-24,1912,1
STAT,1822,33,50-100,1855,2.3723227451273705
STAT,1869,45,15-19,1914,3.6942102351541746E-4
STAT,1852,54,35-39,1906,0.0063610539806685466
STAT,1906,18,25-29,1924,7.774779559307135
STAT,1843,40,25-29,1883,0.4893875120617648
SIM,1815,87,na,1902,62
STAT,1807,47,na,1854,1271.336618955169
SIM,1866,42,35-39,1908,3
STAT,1842,27,50-100,1869,0.5633346712702438
STAT,1829,53,20-24,1882,5.131711090691843E-4
STAT,1855,96,na,1951,6.081386782008587
STAT,1902,42,40-44,1944,0.207973815327959
SIM,1773,92,na,1865,7
SIM,1939,19,40-44,1958,1
STAT,1802,91,na,1893,19.768177209205902
STAT,1852,45,45-49,1897,0.18109388056337458
STAT,1848,53,30-34,1901,0.00421950257156815
SIM,1874,41,30-34,1915,4
STAT,1859,34,50-100,1893,0.6848658291481651
STAT,1898,40,15-19,1938,0.0012387477080830233
SIM,1917,23,na,1940,3615
SIM,1880,47,50-100,1927,4
STAT,1867,49,20-24,1916,0.010421767456178791
STAT,1795,72,na,1867,529.0388030064502
SIM,1833,84,na,1917,187
STAT,1886,47,na,1933,2235.1512172406105
STAT,1906,40,25-29,1946,0.061961088805443376
STAT,1840,106,na,1946,0.008455675684000182
STAT,1845,46,50-100,1891,0.173487226400557
SIM,1837,29,20-24,1866,7
STAT,1920,31,45-49,1951,1.6350158644789268
STAT,1905,56,na,1961,2896.7300282836272
STAT,1925,40,35-39,1965,0.23097749741747833
SIM,1840,33,25-29,1873,10
STAT,1842,50,50-100,1892,0.010909409824964937
STAT,1842,46,na,1888,1623.06930822754
STAT,1916,19,50-100,1935,0.07468735116363236
SIM,1824,47,na,1871,1333
STAT,1882,36,40-44,1918,4.0433875951765454
STAT,1837,45,na,1882,1512.5344586266644
STAT,1932,32,25-29,1964,11.607461172634574
SIM,1900,21,40-44,1921,2
SIM,1899,26,25-29,1925,59
SIM,1837,65,na,1902,1055
STAT,1832,33,25-29,1865,8.019176176339508
STAT,1839,79,na,1918,466.1438796988288
STAT,1867,21,50-100,1888,0.36582702114233057
STAT,1791,91,na,1882,17.622693961839147
STAT,1880,24,15-19,1904,3.258696165582194
STAT,1866,41,30-34,1907,1.0058792889072814
STAT,1880,21,50-100,1901,0.4065667894646568
STAT,1902,43,45-49,1945,0.13755289178236654
SIM,1884,45,50-100,1929,2
SIM,1892,17,25-29,1909,5
SIM,1805,87,na,1892,44
SIM,1885,42,45-49,1927,1
SIM,1899,4,na,1903,3398
STAT,1815,45,40-44,1860,0.4306219101520299
STAT,1853,33,50-100,1886,0.6925106877077986
STAT,1850,54,25-29,1904,0.0024250133297924396
SIM,1774,87,na,1861,31
SIM,1890,36,40-44,1926,4
SIM,1938,31,30-34,1969,17
STAT,1920,23,na,1943,3823.590979428073
STAT,1855,43,20-24,1898,0.11166472177298017
STAT,1930,34,30-34,1964,19.184318226231348
STAT,1833,45,35-39,1878,0.10237733215027887
STAT,1856,42,25-29,1898,0.4745431689108273
STAT,1901,63,na,1964,2554.2724156654303
STAT,1914,46,40-44,1960,0.14805663541717967
STAT,1867,53,40-44,1920,0.009188098085593248
STAT,1901,31,35-39,1932,13.445610902356353
STAT,1834,27,na,1861,1755.7302510473187
STAT,1884,17,25-29,1901,5.290116085792804
STAT,1816,84,na,1900,155.01991523852436
STAT,1845,44,15-19,1889,0.009654987018195879
STAT,1843,48,20-24,1891,0.008548683625529671
STAT,1814,50,na,1864,1221.6068129103367
STAT,1910,40,25-29,1950,0.06445874580280746
SIM,1865,15,15-19,1880,2
SIM,1863,19,20-24,1882,19
STAT,1892,31,30-34,1923,20.73937343040233
SIM,1898,18,30-34,1916,3
STAT,1959,4,na,1963,4858.563477431299
STAT,1881,40,45-49,1921,1.3789261948340952
STAT,1884,41,25-29,1925,0.6021915980598281
STAT,1829,50,50-100,1879,0.0122487451107012
STAT,1894,44,na,1938,2780.322615956562
STAT,1767,107,na,1874,0.005651658612192133
SIM,1851,31,35-39,1882,9
STAT,1862,34,na,1896,1906.5159395809012
STAT,1876,45,50-100,1921,0.24191066421006918
STAT,1906,42,25-29,1948,0.06126660242135429
SIM,1810,88,na,1898,46
SIM,1951,0,na,1951,4538
SIM,1877,41,na,1918,2287
SIM,1797,101,na,1898,1
SIM,1873,39,50-100,1912,1
SIM,1832,35,na,1867,1669
STAT,1878,30,45-49,1908,1.7287514809322915
SIM,1833,40,30-34,1873,4
SIM,1916,30,40-44,1946,7
STAT,1786,90,na,1876,28.78976001547586
STAT,1876,19,40-44,1895,0.17742059463793783
SIM,1845,31,na,1876,1820
STAT,1881,48,na,1929,2026.3930162757256
STAT,1911,37,25-29,1948,0.8982048071687816
STAT,1877,42,45-49,1919,1.465375435507889
SIM,1894,11,na,1905,3309
SIM,1838,17,20-24,1855,17
STAT,1867,11,na,1878,2389.6407716798017
STAT,1855,19,20-24,1874,14.758701741983712
SIM,1826,28,na,1854,1711
STAT,1817,41,35-39,1858,4.766271726185865
STAT,1817,50,25-29,1867,0.00790032535068891
STAT,1857,15,15-19,1872,5.256481816629589
STAT,1815,54,30-34,1869,0.013300914454810098
STAT,1870,85,na,1955,253.75787868638923
STAT,1899,21,na,1920,3071.0676991252
SIM,1842,98,na,1940,2
STAT,1875,1,na,1876,3361.4757513687455
STAT,1825,40,30-34,1865,1.342595378520521
SIM,1912,56,na,1968,3046
STAT,1795,106,na,1901,0.0023455292161918707
STAT,1950,22,40-44,1972,3.7684967702334173
SIM,1815,65,na,1880,827
STAT,1882,45,30-34,1927,0.08987053329051169
STAT,1830,33,50-100,1863,0.7542135883277455
SIM,1849,17,30-34,1866,2
STAT,1903,41,45-49,1944,0.14031708041873184
SIM,1923,19,na,1942,3973
STAT,1865,39,50-100,1904,1.0433419010282603
STAT,1822,44,20-24,1866,0.22709272552605617
STAT,1838,54,25-29,1892,0.0023493577895643274
STAT,1860,53,30-34,1913,0.004496749157841737
STAT,1877,51,35-39,1928,0.008479987198586926
SIM,1892,41,25-29,1933,6
STAT,1864,78,na,1942,659.6876129900143
STAT,1832,30,20-24,1862,2.187271706596646
SIM,1903,46,50-100,1949,1
STAT,1842,52,25-29,1894,0.0025088843934354885
STAT,1858,51,25-29,1909,0.00263943018852041
STAT,1812,45,15-19,1857,0.0013598015568225335
STAT,1892,40,20-24,1932,0.18977264023396515
STAT,1864,15,50-100,1879,0.04758141241651263
STAT,1921,32,15-19,1953,0.135108169729615
STAT,1898,16,15-19,1914,7.607902732352025
STAT,1928,41,15-19,1969,0.0018522924094028128
SIM,1825,41,35-39,1866,6
SIM,1916,18,35-39,1934,3
STAT,1852,42,40-44,1894,1.7068336025351707
STAT,1874,46,35-39,1920,0.1355581998578097
SIM,1840,30,20-24,1870,1
STAT,1884,32,35-39,1916,9.45401836370655
SIM,1851,27,na,1878,1876
STAT,1831,49,40-44,1880,0.12267693452442288
STAT,1846,82,na,1928,328.9744203663543
STAT,1911,41,na,1952,3367.2279059959064
SIM,1844,41,45-49,1885,5
STAT,1879,77,na,1956,892.1739074701086
STAT,1770,100,na,1870,0.1516252300630228
SIM,1888,43,25-29,1931,3
SIM,1947,21,na,1968,3761
STAT,1767,87,na,1854,37.99999999999999
SIM,1900,24,na,1924,3036
STAT,1881,26,na,1907,2184.323185714208
STAT,1812,49,30-34,1861,0.3083147179831829
SIM,1914,1,na,1915,4305
STAT,1908,18,35-39,1926,0.7667443129097937
SIM,1892,32,35-39,1924,21
SIM,1955,6,na,1961,4547
STAT,1869,77,na,1946,790.4319828473349
SIM,1904,27,na,1931,3173
SIM,1881,34,25-29,1915,10
STAT,1863,45,20-24,1908,0.010064309788895517
STAT,1849,15,15-19,1864,5.3279266439820825
STAT,1851,30,30-34,1881,13.605790149524383
STAT,1932,5,na,1937,5029.752901738908
SIM,1923,20,30-34,1943,47
STAT,1841,44,30-34,1885,0.7966911494864473
SIM,1865,2,na,1867,2790
SIM,1810,66,na,1876,792
STAT,1892,0,na,1892,3473.706007778528
STAT,1841,35,40-44,1876,3.602807933456185
STAT,1899,43,na,1942,2980.8063517206056
STAT,1822,46,50-100,1868,0.34754683133120284
STAT,1836,41,45-49,1877,1.1388237693403667
STAT,1850,21,25-29,1871,48.72124552109579
SIM,1942,22,na,1964,3466
STAT,1940,31,20-24,1971,2.385958550132836
SIM,1828,61,na,1889,998
SIM,1798,68,na,1866,719
STAT,1915,20,30-34,1935,27.09067799308123
SIM,1828,83,na,1911,231
STAT,1871,54,45-49,1925,0.01321774888428426
STAT,1856,49,na,1905,1629.8871763582617
STAT,1893,46,45-49,1939,0.1600171758191149
SIM,1861,100,na,1961,3
SIM,1903,20,na,1923,3167
STAT,1886,45,15-19,1931,4.032296691874078E-4
STAT,1949,13,na,1962,4315.513256024548
SIM,1883,59,na,1942,1802
STAT,1796,90,na,1886,33.15245025797303
STAT,1934,20,40-44,1954,4.282565243762852
SIM,1800,88,na,1888,31
SIM,1830,54,na,1884,1375
STAT,1813,54,na,1867,1160.3870312108195
STAT,1830,50,40-44,1880,0.007759092733563483
STAT,1879,51,50-100,1930,0.014984292121694005
STAT,1930,37,35-39,1967,2.9806027043720977
STAT,1879,55,na,1934,2041.7267100024067
SIM,1873,27,na,1900,2309
SIM,1871,3,na,1874,2849
SIM,1884,15,25-29,1899,8
SIM,1906,42,40-44,1948,1
SIM,1860,20,na,1880,2089
STAT,1914,42,25-29,1956,0.06683324079388586
STAT,1876,15,25-29,1891,5.552184468298709
STAT,1862,40,35-39,1902,1.473946330223288
SIM,1870,40,35-39,1910,3
STAT,1882,4,na,1886,2593.758876643412
STAT,1932,30,25-29,1962,11.620588730932724
SIM,1910,40,40-44,1950,2
SIM,1832,31,25-29,1863,16
STAT,1858,27,25-29,1885,32.115361689480004
STAT,1849,17,30-34,1866,1.4141387302868864
SIM,1832,98,na,1930,1
SIM,1857,15,15-19,1872,10
STAT,1847,41,20-24,1888,0.11901966887115263
STAT,1897,18,50-100,1915,0.061734922003463026
STAT,1808,65,na,1873,860.8211337125656
STAT,1844,43,45-49,1887,1.0623480984255862
STAT,1925,42,35-39,1967,0.230338132117735
STAT,1856,49,45-49,1905,0.1709691539030435
STAT,1868,92,na,1960,68.34455611086025
SIM,1908,16,35-39,1924,2
SIM,1927,33,na,1960,4303
STAT,1903,12,na,1915,3470.9776280317465
STAT,1944,23,50-100,1967,0.6709147238652652
STAT,1899,43,35-39,1942,0.1616172908925546
SIM,1942,20,40-44,1962,3
SIM,1833,52,50-100,1885,1
STAT,1845,64,na,1909,1224.4672399217134
SIM,1890,39,45-49,1929,2
SIM,1886,77,na,1963,1051
STAT,1936,36,50-100,1972,0.3896697430022458
STAT,1897,47,40-44,1944,0.12144054386775435
STAT,1862,31,45-49,1893,1.4109805859602984
SIM,1864,49,45-49,1913,3
SIM,1892,30,na,1922,2869
STAT,1885,50,30-34,1935,0.0056829258056757615
SIM,1914,44,40-44,1958,2
STAT,1860,40,50-100,1900,0.8192854597362451
SIM,1858,29,40-44,1887,3
STAT,1877,11,na,1888,2550.8626962587855
STAT,1820,47,15-19,1867,6.595408569147162E-4
STAT,1824,31,25-29,1855,27.733918378659798
STAT,1940,32,25-29,1972,9.035784049323746
STAT,1882,39,45-49,1921,1.8140693686123293
STAT,1880,48,25-29,1928,0.05653490629787956
STAT,1891,22,25-29,1913,66.93767866216174
STAT,1825,29,50-100,1854,2.1075032797877156
SIM,1922,48,50-100,1970,2
STAT,1860,47,45-49,1907,0.18034655990001203
STAT,1833,42,30-34,1875,0.8477506968084617
STAT,1910,31,35-39,1941,8.355566068539664
SIM,1784,87,na,1871,36
SIM,1932,32,40-44,1964,7
STAT,1908,30,40-44,1938,3.5168101364179494
STAT,1904,47,35-39,1951,0.10649382393313456
STAT,1820,49,30-34,1869,0.1549939491113125
STAT,1781,91,na,1872,16.227637968269278
STAT,1926,45,20-24,1971,0.012943751838140994
STAT,1847,40,50-100,1887,0.8019483234688518
STAT,1894,47,15-19,1941,2.729156352868758E-4
STAT,1897,41,50-100,1938,0.09310629994655459
STAT,1949,16,30-34,1965,13.396803248554841
SIM,1873,32,25-29,1905,13
SIM,1928,18,na,1946,4357
STAT,1928,19,15-19,1947,53.73720138069248
SIM,1897,18,na,1915,3231
SIM,1936,19,15-19,1955,26
STAT,1918,46,50-100,1964,0.2279385957575037
SIM,1857,17,30-34,1874,2
STAT,1814,42,20-24,1856,0.4946414113385499
SIM,1886,15,35-39,1901,2
STAT,1841,83,na,1924,271.615158699222
SIM,1866,27,25-29,1893,34
STAT,1822,51,45-49,1873,0.019874111696517115
STAT,1862,12,na,1874,2203.244886752517
STAT,1914,41,20-24,1955,0.016552486741115424
STAT,1922,35,50-100,1957,0.4521328726451357
STAT,1828,53,na,1881,1284.0837594072034
STAT,1881,33,20-24,1914,2.455174011987848
SIM,1877,63,na,1940,1707
STAT,1890,43,15-19,1933,0.015835501762998836
STAT,1811,44,45-49,1855,5.278514113189696
SIM,1852,43,45-49,1895,2
STAT,1866,44,35-39,1910,1.5559097218473872
STAT,1847,45,na,1892,1671.9111220643233
SIM,1898,16,15-19,1914,8
STAT,1924,32,40-44,1956,4.313495753197162
STAT,1883,81,na,1964,748.7538938085407
STAT,1825,52,50-100,1877,0.015265232015221968
STAT,1868,17,40-44,1885,0.16796135703012402
SIM,1869,19,15-19,1888,7
STAT,1875,30,na,1905,2334.621991291292
STAT,1920,48,30-34,1968,0.09283851763835616
STAT,1817,79,na,1896,310.02746145251274
STAT,1861,48,15-19,1909,3.098476126177461E-4
STAT,1902,40,40-44,1942,0.21033129848001947
SIM,1862,64,na,1926,1471
SIM,1868,26,na,1894,2167
SIM,1874,44,35-39,1918,9
STAT,1782,76,na,1858,319.64019839498695
STAT,1834,54,40-44,1888,0.006422254320798595
SIM,1867,34,50-100,1901,3
STAT,1866,50,20-24,1916,6.519558459410287E-4
STAT,1871,38,30-34,1909,4.966623925004329
STAT,1888,42,20-24,1930,0.17701874862567232
STAT,1832,46,na,1878,1474.0360464883581
STAT,1843,31,35-39,1874,8.875167467563363
SIM,1871,22,35-39,1893,8
STAT,1831,30,50-100,1861,0.7706093771471942
STAT,1914,31,20-24,1945,2.3285405483859978
STAT,1846,19,50-100,1865,0.042883102249212414
STAT,1911,30,40-44,1941,3.6280294365810355
STAT,1830,52,20-24,1882,4.7568849945055306E-4
STAT,1811,51,50-100,1862,0.04892908012029025
SIM,1776,90,na,1866,25
STAT,1848,20,45-49,1868,0.6205623797238602
STAT,1894,49,50-100,1943,0.16484009293766083
STAT,1932,22,25-29,1954,114.49621742632988
STAT,1925,45,40-44,1970,0.1813549865961627
STAT,1915,18,40-44,1933,0.27580260170726056
STAT,1918,19,20-24,1937,138.65367811727072
SIM,1806,50,na,1856,1198
SIM,1874,23,15-19,1897,2
STAT,1857,25,50-100,1882,0.497834403091812
SIM,1848,15,15-19,1863,7
SIM,1910,32,40-44,1942,6
STAT,1874,14,na,1888,2501.3131854346725
STAT,1833,105,na,1938,0.017800287407241003
SIM,1914,25,35-39,1939,18
STAT,1929,38,35-39,1967,2.930737443649162
SIM,1865,61,na,1926,1580
SIM,1896,22,40-44,1918,2
STAT,1920,41,45-49,1961,0.17390442934993625
STAT,1840,65,na,1905,1176.9181304346598
STAT,1921,29,20-24,1950,19.08317751047322
STAT,1844,79,na,1923,490.7783044666601
STAT,1911,43,45-49,1954,0.1491285862945962
SIM,1931,22,30-34,1953,46
STAT,1868,31,50-100,1899,0.8298097715806942
STAT,1888,22,40-44,1910,2.3255518249674005
SIM,1795,61,na,1856,884
SIM,1923,18,40-44,1941,1
STAT,1866,23,15-19,1889,2.8760759096599866
STAT,1915,23,35-39,1938,9.165553312236929
STAT,1923,20,na,1943,4038.3287112244107
STAT,1839,22,45-49,1861,0.5974114833397874
STAT,1946,17,na,1963,3856.7913300317127
STAT,1931,41,20-24,1972,0.022320703578109058
STAT,1885,24,50-100,1909,0.38140123683077987
STAT,1912,39,50-100,1951,0.38313576435694086
SIM,1842,13,na,1855,2097
STAT,1896,30,50-100,1926,1.1531574145519425
SIM,1884,44,na,1928,2231
STAT,1912,36,15-19,1948,0.017787247468971784
SIM,1847,53,50-100,1900,1
SIM,1922,23,na,1945,3907
SIM,1879,25,45-49,1904,1
STAT,1847,12,na,1859,2192.2878528316533
STAT,1941,20,25-29,1961,90.2321636696657
STAT,1875,21,15-19,1896,3.211494856574623
SIM,1876,25,na,1901,2393
SIM,1899,23,20-24,1922,77
SIM,1907,22,40-44,1929,5
SIM,1931,24,25-29,1955,136
STAT,1921,34,15-19,1955,0.13395142751557138
SIM,1894,74,na,1968,1740
STAT,1902,32,40-44,1934,5.7814855870587305
SIM,1905,32,30-34,1937,17
SIM,1940,30,50-100,1970,2
SIM,1940,22,25-29,1962,99
STAT,1934,38,45-49,1972,0.8878041904246123
SIM,1829,31,40-44,1860,6
STAT,1862,48,30-34,1910,0.0770249654051744
STAT,1927,17,20-24,1944,159.26634866252684
STAT,1923,42,25-29,1965,0.07885375469573913
STAT,1910,29,45-49,1939,1.5642758573652722
SIM,1888,58,na,1946,2155
SIM,1926,19,20-24,1945,156
SIM,1859,77,na,1936,692
STAT,1921,41,na,1962,3957.763568429848
SIM,1867,96,na,1963,17
STAT,1917,36,na,1953,3709.1645831668966
STAT,1897,15,45-49,1912,0.08291290040509194
STAT,1867,15,30-34,1882,1.4624670124767811
STAT,1917,46,45-49,1963,0.21498054198228175
SIM,1901,61,na,1962,2603
STAT,1927,40,45-49,1967,0.19775273059365922
SIM,1935,17,20-24,1952,182
STAT,1931,19,35-39,1950,5.160867240039004
SIM,1855,21,40-44,1876,6
SIM,1901,1,na,1902,3601
SIM,1922,26,25-29,1948,74
STAT,1859,20,20-24,1879,60.09602139567266
STAT,1904,25,50-100,1929,0.8725498066424767
STAT,1930,27,20-24,1957,21.92812663008895
SIM,1907,40,40-44,1947,1
SIM,1808,48,50-100,1856,3
SIM,1916,39,na,1955,3529
STAT,1814,49,na,1863,1234.9998121805934
SIM,1852,43,na,1895,1766
STAT,1914,20,50-100,1934,0.6129350791814001
STAT,1907,19,45-49,1926,0.09014677749160742
SIM,1892,63,na,1955,2107
STAT,1924,16,40-44,1940,1.5775316285479708
SIM,1922,24,30-34,1946,39
SIM,1818,43,50-100,1861,1
SIM,1808,85,na,1893,86
SIM,1905,27,35-39,1932,21
STAT,1846,30,35-39,1876,8.615141515627517
STAT,1923,45,50-100,1968,0.25115578571651015
STAT,1903,31,45-49,1934,2.3533327326143842
SIM,1932,16,40-44,1948,1
STAT,1857,25,15-19,1882,0.3530896054407803
SIM,1922,31,20-24,1953,2
SIM,1884,64,na,1948,1654
STAT,1855,31,na,1886,1738.8051339261012
STAT,1897,62,na,1959,2397.499692134289
SIM,1833,52,na,1885,1334
SIM,1850,27,50-100,1877,1
SIM,1869,33,35-39,1902,8
STAT,1829,27,50-100,1856,0.9217956386424192
STAT,1942,23,na,1965,3615.7430951343385
SIM,1797,72,na,1869,557
SIM,1939,28,45-49,1967,3
SIM,1905,34,25-29,1939,8
SIM,1911,31,45-49,1942,1
STAT,1950,22,na,1972,4092.8984251669126
STAT,1944,14,na,1958,3991.9214614043176
SIM,1923,23,35-39,1946,12
STAT,1880,46,25-29,1926,0.057416864288741605
STAT,1915,30,25-29,1945,8.963287179640279
SIM,1867,20,20-24,1887,49
STAT,1932,15,35-39,1947,5.273521526768655
SIM,1940,15,35-39,1955,3
STAT,1929,37,na,1966,4563.174638298799
STAT,1867,20,50-100,1887,0.36847265480382185
STAT,1900,37,35-39,1937,2.000782616905774
STAT,1943,18,15-19,1961,45.44757411001649
SIM,1829,47,na,1876,1382
SIM,1825,33,na,1858,1556
STAT,1916,47,40-44,1963,0.15276276057025684
STAT,1852,98,na,1950,2.4681517623335756
STAT,1920,23,45-49,1943,1.1781045527490475
STAT,1909,26,15-19,1935,0.6448082174908476
STAT,1811,47,15-19,1858,0.001331815906154304
STAT,1928,39,30-34,1967,2.1715429526689363
STAT,1863,22,35-39,1885,4.942434713256726
STAT,1905,29,35-39,1934,13.078142168807016
STAT,1859,16,35-39,1875,0.48304709134835117
SIM,1910,27,45-49,1937,1
SIM,1951,18,15-19,1969,47
SIM,1927,18,25-29,1945,66
SIM,1906,30,25-29,1936,6
STAT,1890,48,35-39,1938,0.09006828761369585
STAT,1895,30,30-34,1925,21.697351562745837
STAT,1877,42,na,1919,2262.958071580029
SIM,1862,33,na,1895,2062
STAT,1826,50,na,1876,1342.6205093099504
STAT,1889,75,na,1964,1479.6487379550076
STAT,1849,47,na,1896,1614.1043129841119
STAT,1908,15,45-49,1923,0.0919440572502576
STAT,1899,22,15-19,1921,4.270960948858587
STAT,1878,30,30-34,1908,17.30882451348375
STAT,1908,43,na,1951,3225.829078604271
STAT,1800,69,na,1869,698.2836707807312
STAT,1852,48,15-19,1900,3.0009005996095594E-4
SIM,1910,22,na,1932,3325
STAT,1925,15,45-49,1940,0.5727890183826541
STAT,1847,41,50-100,1888,0.7917395213110934
SIM,1876,45,na,1921,2272
STAT,1761,112,na,1873,4.728036340619267E-4
SIM,1837,30,35-39,1867,13
SIM,1849,67,na,1916,1159
SIM,1930,25,20-24,1955,25
STAT,1889,23,na,1912,2749.766863662847
STAT,1914,26,25-29,1940,62.8877103668338
SIM,1923,30,25-29,1953,11
SIM,1902,15,15-19,1917,6
SIM,1821,51,na,1872,1290
SIM,1886,30,30-34,1916,5
STAT,1899,18,30-34,1917,2.0580386286404226
SIM,1898,24,15-19,1922,5
STAT,1918,42,45-49,1960,0.16716065637963953
STAT,1919,18,25-29,1937,45.121819081257854
SIM,1904,28,30-34,1932,43
STAT,1807,91,na,1898,20.786740599607505
STAT,1847,21,40-44,1868,1.8931995956980632
SIM,1913,29,35-39,1942,12
STAT,1874,1,na,1875,3356.6159319711933
STAT,1940,17,35-39,1957,4.024469049407255
SIM,1934,28,50-100,1962,2
SIM,1888,23,45-49,1911,4
STAT,1897,42,na,1939,2926.5329051078334
STAT,1825,88,na,1913,77.61933530219413
STAT,1832,78,na,1910,472.4394793301934
STAT,1775,108,na,1883,0.004549316393018196
SIM,1929,36,35-39,1965,2
STAT,1832,41,50-100,1873,0.7939448404545569
SIM,1866,24,20-24,1890,58
SIM,1867,16,35-39,1883,2
STAT,1840,97,na,1937,3.7413192833385853
STAT,1822,68,na,1890,789.3643770923093
SIM,1793,90,na,1883,16
STAT,1903,8,na,1911,3493.876070649515
SIM,1889,16,15-19,1905,5
STAT,1885,61,na,1946,1758.7212314159594
SIM,1925,43,40-44,1968,1
SIM,1853,72,na,1925,973
SIM,1817,46,na,1863,1410
STAT,1883,15,15-19,1898,5.5201341220035545
STAT,1933,32,40-44,1965,4.982088312650546
STAT,1858,24,20-24,1882,52.597702049028754
STAT,1904,37,20-24,1941,0.22541677018526282
STAT,1913,35,20-24,1948,0.2480351071262216
STAT,1926,41,40-44,1967,0.29175195630508494
STAT,1839,22,50-100,1861,0.3493634538613305
SIM,1901,34,40-44,1935,5
STAT,1903,38,15-19,1941,0.01620951079511951
SIM,1828,40,35-39,1868,4
SIM,1872,21,40-44,1893,3
STAT,1886,41,50-100,1927,1.0592413718114235
SIM,1922,27,35-39,1949,23
SIM,1785,71,na,1856,469
STAT,1920,38,15-19,1958,0.01984354957467907
STAT,1844,49,50-100,1893,0.16881359305321697
SIM,1890,43,50-100,1933,1
STAT,1795,105,na,1900,0.0056641613527937
STAT,1908,23,50-100,1931,0.5695615599199308
STAT,1914,27,35-39,1941,14.295589893176778
STAT,1784,89,na,1873,29.842670520427163
STAT,1780,75,na,1855,328.35477
SIM,1858,25,25-29,1883,37
STAT,1909,17,na,1926,3577.1499306649453
SIM,1878,31,35-39,1909,9
STAT,1750,123,na,1873,1.3923204041741566E-4
STAT,1923,22,30-34,1945,31.59490202718863
STAT,1870,36,15-19,1906,0.05223074994766141
STAT,1913,28,30-34,1941,36.744352183600284
STAT,1935,21,na,1956,4699.11720293275
STAT,1864,21,40-44,1885,1.8006028825297313
SIM,1866,21,15-19,1887,2
SIM,1921,28,30-34,1949,43
STAT,1813,87,na,1900,74.51168595935239
STAT,1923,24,25-29,1947,100.90491445140606
SIM,1836,80,na,1916,373
STAT,1913,32,15-19,1945,0.1207538679885702
SIM,1918,18,na,1936,3743
STAT,1808,96,na,1904,3.3375074951073116
STAT,1835,24,50-100,1859,0.33337230920761174
STAT,1871,53,20-24,1924,6.799973206648355E-4
SIM,1835,31,na,1866,1728
STAT,1860,45,45-49,1905,0.18299768231283495
STAT,1849,31,15-19,1880,0.12010155438690627
STAT,1858,17,30-34,1875,1.3808040497453484
SIM,1883,70,na,1953,1248
STAT,1792,76,na,1868,336.170723864227
STAT,1854,53,20-24,1907,5.228397503233613E-4
STAT,1922,25,20-24,1947,19.646838434382516
STAT,1858,83,na,1941,294.4173122731646
STAT,1911,28,50-100,1939,0.9135628569379752
STAT,1859,21,30-34,1880,15.421899222841484
SIM,1840,54,na,1894,1452
STAT,1908,48,45-49,1956,0.18512474916208535
STAT,1893,38,50-100,1931,1.4642930421137184
SIM,1930,22,na,1952,4378
STAT,1860,50,40-44,1910,0.008198856607482553
STAT,1810,54,45-49,1864,0.04731887763910891
SIM,1816,40,na,1856,1414
STAT,1923,17,35-39,1940,4.655175778704004
SIM,1901,29,45-49,1930,1
STAT,1940,24,25-29,1964,88.82263758005487
SIM,1906,26,40-44,1932,5
SIM,1931,17,35-39,1948,6
STAT,1892,43,na,1935,2714.460984053567
STAT,1904,29,20-24,1933,15.7804436584947
SIM,1898,24,na,1922,2973
STAT,1939,2,na,1941,3858.593869683354
STAT,1813,52,20-24,1865,0.002130399288972267
STAT,1896,57,na,1953,2509.089031968468
SIM,1936,15,na,1951,2765
SIM,1867,21,30-34,1888,20
STAT,1922,18,30-34,1940,13.292133237270562
STAT,1926,17,na,1943,4263.698181187232
STAT,1867,12,na,1879,2378.791802576375
SIM,1783,92,na,1875,8
SIM,1872,63,na,1935,1681
STAT,1852,16,50-100,1868,0.04528614972772809
SIM,1847,32,na,1879,1773
STAT,1932,18,40-44,1950,1.7451269539619985
SIM,1948,23,40-44,1971,3
STAT,1910,17,50-100,1927,0.07011031711735788
SIM,1854,22,35-39,1876,3
STAT,1927,39,50-100,1966,0.49214023013279334
SIM,1907,25,45-49,1932,1
STAT,1931,31,20-24,1962,3.0211580821583284
SIM,1913,34,30-34,1947,18
STAT,1848,35,15-19,1883,0.042564585350226745
STAT,1947,18,50-100,1965,0.3985899451261757
SIM,1870,20,na,1890,2197
SIM,1930,18,30-34,1948,20
STAT,1837,46,na,1883,1493.2798949683468
STAT,1833,32,na,1865,1693.6043957242198
STAT,1868,21,25-29,1889,52.007641821112145
STAT,1858,21,15-19,1879,2.827491708074774
SIM,1940,18,40-44,1958,1
STAT,1915,22,25-29,1937,90.19206806502184
STAT,1915,48,35-39,1963,0.12237963166315136
STAT,1845,96,na,1941,6.048281394231276
STAT,1841,82,na,1923,319.2317694269451
STAT,1896,4,na,1900,3284.4983814496836
SIM,1883,27,na,1910,2270
SIM,1923,22,25-29,1945,108
STAT,1881,47,na,1928,2042.6113503978847
SIM,1906,49,na,1955,3073
STAT,1941,30,25-29,1971,9.17697091010582
STAT,1834,20,15-19,1854,4.923727673002726
STAT,1846,22,35-39,1868,5.0766459723654265
STAT,1799,102,na,1901,0.09801726180785338
STAT,1902,35,45-49,1937,0.5790702052986476
SIM,1879,10,na,1889,2577
SIM,1875,51,na,1926,2079
SIM,1913,42,na,1955,3307
STAT,1830,99,na,1929,1.1313042624170062
SIM,1879,22,40-44,1901,2
SIM,1842,20,15-19,1862,2
STAT,1933,10,na,1943,5025.934155736015
SIM,1905,31,20-24,1936,2
STAT,1779,98,na,1877,0.5609812539943356
STAT,1923,25,35-39,1948,16.395800283485485
STAT,1919,49,30-34,1968,0.09080774670319641
STAT,1854,32,35-39,1886,7.467900639458614
STAT,1938,33,30-34,1971,14.954662203146121
STAT,1901,33,35-39,1934,13.334377721721316
STAT,1805,68,na,1873,734.9599932830059
STAT,1878,15,35-39,1893,0.5421365890646994
STAT,1883,38,na,1921,2170.5024202496925
STAT,1880,43,20-24,1923,0.15671955852475933
STAT,1854,44,50-100,1898,0.7504762768659522
STAT,1876,20,20-24,1896,67.60827860094892
SIM,1931,25,35-39,1956,23
STAT,1911,40,40-44,1951,0.22803162324976312
SIM,1876,77,na,1953,789
STAT,1819,42,50-100,1861,2.074009515918984
SIM,1895,31,35-39,1926,20
SIM,1939,25,40-44,1964,6
STAT,1917,43,40-44,1960,0.2461899398127411
SIM,1856,17,15-19,1873,8
STAT,1881,16,na,1897,2309.374388727651
STAT,1826,39,50-100,1865,1.2577151271976552
SIM,1928,37,30-34,1965,2
STAT,1838,63,na,1901,1216.9388874260915
STAT,1863,3,na,1866,2677.2223624322987
SIM,1929,39,40-44,1968,2
STAT,1884,15,30-34,1899,1.4948536226648077
SIM,1919,39,30-34,1958,4
STAT,1874,25,15-19,1899,0.44103607883362794
STAT,1932,4,na,1936,5049.040235438282
STAT,1923,21,20-24,1944,122.60398549535341
SIM,1912,57,na,1969,3029
SIM,1865,1,na,1866,2955
STAT,1887,31,35-39,1918,10.7429337707421
STAT,1914,19,35-39,1933,0.8154565378905017
STAT,1898,68,na,1966,2211.0896300154823
SIM,1818,83,na,1901,140
STAT,1924,19,45-49,1943,0.5590096584470836
STAT,1801,53,40-44,1854,0.03723342339482232
SIM,1858,30,20-24,1888,1
SIM,1866,79,na,1945,540
SIM,1899,10,na,1909,3357
SIM,1901,42,40-44,1943,2
STAT,1848,17,15-19,1865,5.299979087014092
STAT,1905,41,20-24,1946,0.01512346915159166
STAT,1930,19,20-24,1949,164.70452167673457
SIM,1857,9,na,1866,2328
SIM,1934,2,na,1936,5131
STAT,1848,52,50-100,1900,0.010822454332872461
SIM,1904,38,25-29,1942,4
STAT,1961,0,na,1961,4833.109797117121
SIM,1931,21,20-24,1952,133
STAT,1885,47,15-19,1932,3.747162979572752E-4
SIM,1854,30,50-100,1884,1
STAT,1862,13,na,1875,2193.2421549666606
SIM,1933,37,40-44,1970,3
STAT,1902,17,15-19,1919,7.911635398472355
SIM,1938,26,50-100,1964,5
STAT,1910,34,40-44,1944,3.5330340188649543
STAT,1875,95,na,1970,63.19958551873361
STAT,1902,27,45-49,1929,1.4801985555244646
SIM,1788,91,na,1879,14
STAT,1907,24,40-44,1931,2.8731165705870954
STAT,1781,92,na,1873,9.934235411415084
STAT,1931,16,30-34,1947,15.108935325111633
STAT,1860,65,na,1925,1297.485068714515
SIM,1858,23,30-34,1881,17
STAT,1916,19,na,1935,3850.2469580062434
STAT,1846,30,50-100,1876,0.7794542954827375
STAT,1911,1,na,1912,3934.0185950433156
STAT,1921,26,15-19,1947,0.7458871426120689
SIM,1829,34,45-49,1863,1
STAT,1907,42,40-44,1949,0.21644767240347654
STAT,1838,31,40-44,1869,3.7137450670005836
STAT,1953,15,20-24,1968,155.0186114314348
STAT,1867,18,35-39,1885,0.4946281832670041
STAT,1846,50,na,1896,1539.9555329588634
SIM,1910,17,15-19,1927,9
STAT,1899,25,20-24,1924,15.290733188645438
STAT,1836,34,50-100,1870,0.716323150653105
SIM,1896,25,45-49,1921,1
SIM,1879,30,40-44,1909,5
STAT,1769,88,na,1857,36.574442244633
SIM,1896,45,na,1941,2851
SIM,1857,42,na,1899,1850
STAT,1835,98,na,1933,2.026861560146166
SIM,1838,21,40-44,1859,2
SIM,1817,66,na,1883,890
STAT,1888,25,45-49,1913,1.2475160859044025
SIM,1813,52,na,1865,1203
SIM,1846,31,40-44,1877,2
STAT,1905,34,30-34,1939,13.569012956145173
STAT,1864,79,na,1943,590.2620885989451
SIM,1922,19,35-39,1941,5
SIM,1859,97,na,1956,6
SIM,1905,24,30-34,1929,32
SIM,1915,24,40-44,1939,2
SIM,1824,79,na,1903,380
STAT,1828,42,35-39,1870,1.597375623990388
SIM,1930,28,25-29,1958,82
SIM,1897,21,45-49,1918,5
STAT,1893,49,15-19,1942,2.648007364322201E-4
SIM,1854,30,35-39,1884,12
STAT,1951,20,40-44,1971,3.797805558296021
SIM,1913,26,30-34,1939,45
STAT,1915,15,35-39,1930,0.8334356156381452
STAT,1818,86,na,1904,106.9717267146486
STAT,1931,23,20-24,1954,135.82297701739287
SIM,1836,42,35-39,1878,2
SIM,1838,19,20-24,1857,16
SIM,1906,29,45-49,1935,2
STAT,1881,27,na,1908,2176.8528004190657
STAT,1836,35,50-100,1871,0.9716122325359594
SIM,1893,25,na,1918,3000
STAT,1901,40,25-29,1941,0.05955931941052958
SIM,1931,16,na,1947,4579
SIM,1909,27,20-24,1936,16
STAT,1821,47,30-34,1868,0.14781466054794448
STAT,1938,18,na,1956,3428.5441972311082
SIM,1844,35,50-100,1879,1
STAT,1916,17,45-49,1933,0.10012005823253232
SIM,1847,96,na,1943,1
STAT,1809,82,na,1891,196.00310373627454
STAT,1909,18,15-19,1927,8.383396856913915
SIM,1858,15,30-34,1873,2
SIM,1818,51,na,1869,1200
STAT,1857,97,na,1954,4.000981610881875
STAT,1931,24,30-34,1955,34.99545229916444
SIM,1887,32,40-44,1919,6
SIM,1800,89,na,1889,24
STAT,1853,83,na,1936,294.40866501061333
STAT,1889,36,15-19,1925,0.06580670747417307
STAT,1935,16,15-19,1951,58.75137689164052
STAT,1937,29,30-34,1966,36.041743079199136
STAT,1957,15,40-44,1972,1.7428043102557904
SIM,1871,2,na,1873,3006
SIM,1902,25,45-49,1927,1
SIM,1760,95,na,1855,1
SIM,1860,43,45-49,1903,1
SIM,1943,16,15-19,1959,39
SIM,1923,15,35-39,1938,3
STAT,1928,43,15-19,1971,0.0018467027006621075
STAT,1860,53,45-49,1913,0.010963148762935112
STAT,1863,50,na,1913,1813.7142936689813
SIM,1914,28,40-44,1942,4
STAT,1855,11,na,1866,2020.125267262801
STAT,1779,104,na,1883,0.03242367528820094
STAT,1889,21,45-49,1910,0.8157219517849584
STAT,1905,26,30-34,1931,34.49518045879728
STAT,1844,46,15-19,1890,2.816006889604545E-4
STAT,1858,25,30-34,1883,19.395693753656577
STAT,1844,102,na,1946,0.20581153382553732
STAT,1909,44,45-49,1953,0.14521429778833037
STAT,1869,23,na,1892,2156.0047599649647
STAT,1860,103,na,1963,0.42539336623761215
SIM,1841,16,na,1857,2083
SIM,1878,0,na,1878,3490
STAT,1857,66,na,1923,1220.6540777284883
STAT,1920,15,45-49,1935,0.10672381084805124
SIM,1900,31,40-44,1931,6
STAT,1906,28,40-44,1934,4.106219889205845
SIM,1862,32,35-39,1894,8
STAT,1778,93,na,1871,5.791602574607771
STAT,1911,31,na,1942,3492.580517061116
STAT,1940,16,25-29,1956,41.573866374820234
SIM,1889,43,na,1932,2682
SIM,1870,52,na,1922,2001
STAT,1887,23,35-39,1910,6.1461140461799255
STAT,1881,47,30-34,1928,0.08788389878604351
SIM,1922,18,25-29,1940,49
SIM,1935,25,20-24,1960,25
SIM,1824,40,50-100,1864,1
STAT,1915,40,25-29,1955,0.06809900232422267
SIM,1892,5,na,1897,3165
SIM,1905,55,na,1960,2859
STAT,1913,36,30-34,1949,1.7069346509747316
STAT,1915,31,50-100,1946,0.7986619881625872
STAT,1917,28,15-19,1945,0.6969075593872417
STAT,1875,31,na,1906,2325.470273085431
STAT,1843,30,na,1873,1919.1637838164277
STAT,1879,32,40-44,1911,4.282212998935885
STAT,1903,46,15-19,1949,3.0411938080405636E-4
STAT,1781,110,na,1891,0.0011345093717943313
STAT,1925,30,40-44,1955,4.395558533615326
STAT,1933,22,40-44,1955,4.21337053932954
STAT,1919,15,20-24,1934,28.52814629542881
STAT,1936,23,50-100,1959,0.5939820152110783
SIM,1877,62,na,1939,1759
STAT,1791,109,na,1900,1.3058889791309097E-4
STAT,1847,24,45-49,1871,0.61998785223397
SIM,1828,32,35-39,1860,14
SIM,1866,25,30-34,1891,32
SIM,1905,35,35-39,1940,13
STAT,1910,26,40-44,1936,4.2653368233360665
STAT,1850,51,50-100,1901,0.010683242498605201
STAT,1919,48,20-24,1967,0.011292051538087435
SIM,1921,36,30-34,1957,1
SIM,1923,40,na,1963,4020
STAT,1839,57,na,1896,1339.9658909972277
STAT,1833,52,50-100,1885,0.009470877499190128
STAT,1897,20,40-44,1917,2.648424390328148
SIM,1899,16,30-34,1915,2
STAT,1923,32,25-29,1955,10.010634933950433
SIM,1876,21,25-29,1897,67
STAT,1949,16,45-49,1965,0.5490492018380115
SIM,1931,32,25-29,1963,12
STAT,1935,34,45-49,1969,2.0538684863843177
SIM,1898,2,na,1900,3358
SIM,1912,29,20-24,1941,20
STAT,1914,18,25-29,1932,8.44475352850187
STAT,1927,25,20-24,1952,21.108756525847344
STAT,1903,44,na,1947,3075.0355419355747
STAT,1887,32,na,1919,2521.1293291609395
STAT,1821,54,20-24,1875,0.001040921940405773
STAT,1817,69,na,1886,726.5551505504351
SIM,1897,18,15-19,1915,3
STAT,1912,39,20-24,1951,0.2405550954311445
STAT,1922,28,25-29,1950,70.11775893567179
STAT,1889,18,15-19,1907,6.903166623375348
STAT,1905,33,20-24,1938,2.1099112854599587
SIM,1927,15,20-24,1942,160
SIM,1933,30,40-44,1963,7
STAT,1898,47,50-100,1945,0.17634125411718973
STAT,1872,20,35-39,1892,5.566229971037228
SIM,1895,23,35-39,1918,9
STAT,1929,37,25-29,1966,1.1942310092788566
SIM,1858,22,20-24,1880,49
STAT,1895,33,35-39,1928,12.431959620310144
STAT,1939,27,40-44,1966,4.426105424609421
STAT,1889,22,50-100,1911,0.47559453783501326
SIM,1913,33,20-24,1946,3
SIM,1935,10,na,1945,5127
SIM,1883,21,15-19,1904,6
STAT,1878,41,35-39,1919,1.7889073056456914
STAT,1908,38,15-19,1946,0.01689692472851766
SIM,1765,94,na,1859,6
SIM,1784,77,na,1861,259
STAT,1858,32,20-24,1890,2.004668415301237
STAT,1864,29,50-100,1893,0.5362389793369307
STAT,1911,48,15-19,1959,3.2846002025615085E-4
STAT,1851,20,15-19,1871,2.930968348142956
STAT,1838,34,45-49,1872,1.4475196662890881
SIM,1877,43,35-39,1920,9
STAT,1882,64,na,1946,1597.986093625651
STAT,1893,28,na,1921,2850.45592807917
SIM,1815,101,na,1916,1
SIM,1883,79,na,1962,856
SIM,1902,18,20-24,1920,26
STAT,1842,36,na,1878,1807.8577026875805
SIM,1930,36,25-29,1966,1
STAT,1922,22,15-19,1944,5.767270215680653
STAT,1915,45,30-34,1960,0.08525202902792738
STAT,1901,44,40-44,1945,0.2037459057196629
STAT,1823,49,35-39,1872,0.16225879864998913
STAT,1905,18,30-34,1923,2.17017870820725
STAT,1924,42,40-44,1966,0.28108713369804356
STAT,1933,19,na,1952,4629.797543122717
SIM,1924,25,45-49,1949,3
STAT,1953,7,na,1960,4491.940286098137
STAT,1931,15,20-24,1946,168.4231065534296
SIM,1837,22,35-39,1859,7
SIM,1868,45,50-100,1913,1
STAT,1819,48,na,1867,1329.0505348103918
STAT,1876,21,30-34,1897,17.42397143182717
SIM,1871,49,50-100,1920,4
SIM,1904,39,35-39,1943,8
STAT,1872,49,30-34,1921,0.08986956195812483
STAT,1785,74,na,1859,433.88740808135896
STAT,1927,43,20-24,1970,0.02089299340077816
SIM,1858,26,35-39,1884,11
STAT,1789,88,na,1877,41.4943368741056
STAT,1922,36,25-29,1958,1.0594338406885597
SIM,1941,22,40-44,1963,4
SIM,1913,18,30-34,1931,4
STAT,1876,23,25-29,1899,55.65657987018743
SIM,1857,11,na,1868,2287
SIM,1850,52,na,1902,1577
SIM,1842,16,30-34,1858,2
SIM,1900,32,30-34,1932,31
SIM,1930,17,20-24,1947,158
STAT,1905,37,35-39,1942,2.084084436680075
SIM,1889,20,na,1909,2829
SIM,1906,40,na,1946,3273
SIM,1921,24,15-19,1945,5
STAT,1835,48,15-19,1883,2.5971860852525035E-4
STAT,1773,108,na,1881,0.003482892834250276
STAT,1872,43,na,1915,2175.691798037486
STAT,1876,57,na,1933,1959.9034806113136
SIM,1829,78,na,1907,373
STAT,1931,34,25-29,1965,11.426572452925532
SIM,1859,13,na,1872,2299
STAT,1837,102,na,1939,0.1850689711968746
STAT,1922,17,20-24,1939,148.23612259562472
STAT,1793,70,na,1863,649.1508443635093
STAT,1910,30,25-29,1940,8.484151458184973
SIM,1822,33,50-100,1855,4
STAT,1860,42,40-44,1902,1.7247771839993002
STAT,1925,17,50-100,1942,0.4276050483702669
SIM,1906,20,30-34,1926,26
SIM,1923,31,50-100,1954,3
SIM,1930,22,15-19,1952,8
STAT,1911,17,45-49,1928,0.09441313555922279
STAT,1933,36,35-39,1969,3.1151594973413888
STAT,1814,49,40-44,1863,0.4495884148940422
SIM,1906,34,40-44,1940,4
SIM,1816,49,na,1865,1262
STAT,1872,21,50-100,1893,0.3878351898534775
SIM,1803,86,na,1889,51
SIM,1812,46,na,1858,1321
SIM,1838,51,na,1889,1374
SIM,1876,22,35-39,1898,10
SIM,1852,66,na,1918,1230
SIM,1947,24,35-39,1971,14
STAT,1825,44,na,1869,1506.4541490286915
SIM,1932,24,40-44,1956,4
STAT,1907,46,35-39,1953,0.10988166564736936
STAT,1923,16,25-29,1939,48.193849393740265
STAT,1910,25,na,1935,3438.4281383160005
SIM,1915,20,25-29,1935,98
STAT,1877,15,40-44,1892,0.18013604114677875
STAT,1905,0,na,1905,4008.555690114324
STAT,1934,28,15-19,1962,0.8967057168102974
STAT,1833,63,na,1896,1083.2333407255942
SIM,1884,46,50-100,1930,3
SIM,1899,27,35-39,1926,14
STAT,1829,58,na,1887,1236.9276945291033
STAT,1843,53,45-49,1896,0.010301951256453
STAT,1857,29,30-34,1886,19.040760123536476
STAT,1924,43,30-34,1967,0.14344454983431823
STAT,1849,34,20-24,1883,2.0108668927832207
STAT,1880,22,35-39,1902,5.8004579863550845
SIM,1858,33,25-29,1891,14
STAT,1953,8,na,1961,4491.356333860945
SIM,1912,38,30-34,1950,2
STAT,1861,38,15-19,1899,0.0438334454225071
STAT,1941,18,50-100,1959,0.3644132107532038
STAT,1927,32,45-49,1959,1.8288309063540302
STAT,1932,30,50-100,1962,1.0395122575615432
STAT,1868,22,35-39,1890,5.263469001257186
STAT,1844,15,na,1859,2072.738108379149
STAT,1850,32,na,1882,1757.4154392516677
STAT,1886,40,30-34,1926,1.1590904366301098
STAT,1914,39,na,1953,3512.2492368878948
SIM,1845,40,35-39,1885,6
STAT,1867,25,25-29,1892,37.77593805354197
SIM,1865,29,30-34,1894,20
STAT,1910,46,na,1956,3245.1725730130142
SIM,1898,28,30-34,1926,36
SIM,1846,34,45-49,1880,1
STAT,1840,46,30-34,1886,0.06885732264006586
STAT,1884,76,na,1960,1037.1927069724015
STAT,1939,24,35-39,1963,8.926178488359405
STAT,1806,85,na,1891,91.21782471534299
SIM,1931,16,25-29,1947,61
STAT,1905,44,25-29,1949,0.06005425734128986
SIM,1900,0,na,1900,3568
SIM,1879,33,45-49,1912,2
STAT,1880,62,na,1942,1816.7618701978429
STAT,1869,43,35-39,1912,1.6439130774894049
SIM,1867,32,na,1899,2051
SIM,1916,37,40-44,1953,1
SIM,1894,40,30-34,1934,2
STAT,1837,40,35-39,1877,1.3838971149242782
SIM,1875,39,na,1914,2232
STAT,1815,104,na,1919,0.028547701056115787
STAT,1870,46,15-19,1916,3.7131874322538893E-4
STAT,1909,41,40-44,1950,0.22222730970549162
SIM,1913,37,35-39,1950,9
STAT,1802,71,na,1873,597.2369968111259
STAT,1909,36,45-49,1945,0.6123567496472947
SIM,1888,39,50-100,1927,1
STAT,1904,45,20-24,1949,0.009262226024451828
STAT,1779,105,na,1884,0.020318944592856887
STAT,1942,15,45-49,1957,0.4934041604594097
STAT,1826,82,na,1908,254.66868726810455
SIM,1857,34,20-24,1891,1
STAT,1922,29,35-39,1951,15.935600786109868
SIM,1929,33,30-34,1962,31
STAT,1907,20,25-29,1927,79.90030259518268
SIM,1860,85,na,1945,195
STAT,1778,92,na,1870,9.460620364284642
STAT,1840,105,na,1945,0.020419405177493792
SIM,1930,29,35-39,1959,24
STAT,1910,23,35-39,1933,8.32511766048158
SIM,1864,99,na,1963,8
SIM,1832,67,na,1899,975
STAT,1943,28,45-49,1971,1.737257368974937
SIM,1857,27,30-34,1884,18
SIM,1861,47,na,1908,1927
STAT,1823,33,na,1856,1504.6579890101184
STAT,1868,0,na,1868,3395.6893809577646
STAT,1873,48,35-39,1921,0.13256034571624725
STAT,1911,15,15-19,1926,8.617287115664697
STAT,1855,95,na,1950,9.416389424474842
STAT,1908,37,40-44,1945,1.3237577670803504
STAT,1925,41,25-29,1966,0.08180109711830645
SIM,1887,35,45-49,1922,3
STAT,1926,28,45-49,1954,1.9498030460634317
STAT,1840,39,40-44,1879,3.531598667012564
STAT,1875,24,20-24,1899,66.46350139469233
SIM,1917,41,40-44,1958,1
STAT,1831,52,na,1883,1361.4634718682514
STAT,1925,37,40-44,1962,1.6975565549228173
SIM,1826,31,50-100,1857,1
STAT,1848,43,15-19,1891,0.009877057415624314
STAT,1879,13,na,1892,2546.099778621845
SIM,1820,34,na,1854,1538
STAT,1838,16,15-19,1854,5.378095369426805
STAT,1932,26,40-44,1958,5.770070454502868
SIM,1868,20,35-39,1888,6
STAT,1921,38,30-34,1959,1.9207197173755262
SIM,1906,61,na,1967,2838
SIM,1927,30,45-49,1957,2
STAT,1878,27,na,1905,2347.0323054668493
SIM,1940,26,40-44,1966,4
SIM,1824,48,na,1872,1320
SIM,1935,32,45-49,1967,1
STAT,1866,27,30-34,1893,21.933158548446613
SIM,1848,19,30-34,1867,1
SIM,1914,16,25-29,1930,8
SIM,1880,20,35-39,1900,9
SIM,1926,9,na,1935,4504
STAT,1920,27,50-100,1947,1.0315389427853638
STAT,1891,17,50-100,1908,0.057286533248567674
SIM,1943,8,na,1951,3881
STAT,1916,44,35-39,1960,0.19428786188043734
STAT,1936,30,45-49,1966,1.4452777996879598
SIM,1846,16,15-19,1862,4
STAT,1858,28,35-39,1886,7.27289747175242
STAT,1811,52,na,1863,1208.732387307624
STAT,1937,34,50-100,1971,0.7716468809363455
STAT,1838,62,na,1900,1246.5570837356504
STAT,1866,31,15-19,1897,0.12454241000727308
SIM,1883,58,na,1941,1839
STAT,1941,24,40-44,1965,3.2800613117447424
STAT,1924,24,40-44,1948,3.7249966604181153
STAT,1879,35,45-49,1914,1.987127171098925
STAT,1932,19,50-100,1951,0.46615913347349863
STAT,1943,25,50-100,1968,1.0022595766501088
STAT,1829,47,na,1876,1505.2969248947963
SIM,1895,60,na,1955,2362
STAT,1912,57,na,1969,3188.22476317879
STAT,1935,26,45-49,1961,2.2256050465654496
STAT,1912,32,20-24,1944,2.2668498658288008
STAT,1904,38,30-34,1942,1.5507804499197149
SIM,1858,31,30-34,1889,17
STAT,1924,38,na,1962,4187.119076049876
SIM,1913,25,20-24,1938,18
SIM,1873,28,na,1901,2270
SIM,1920,32,20-24,1952,2
STAT,1847,76,na,1923,697.0889041721812
SIM,1942,23,na,1965,3459
STAT,1919,30,45-49,1949,1.6167022721844457
SIM,1934,28,45-49,1962,2
SIM,1890,38,35-39,1928,18
SIM,1904,27,20-24,1931,13
SIM,1863,0,na,1863,3142
STAT,1862,44,15-19,1906,0.010978269519690964
STAT,1900,33,50-100,1933,1.195754357605672
SIM,1821,82,na,1903,213
STAT,1868,47,15-19,1915,3.5910848582175687E-4
SIM,1834,21,20-24,1855,61
STAT,1849,27,30-34,1876,21.516168115607872
STAT,1905,25,20-24,1930,16.123907072044606
STAT,1906,36,40-44,1942,1.305993773198502
STAT,1909,29,20-24,1938,16.35826374020187
SIM,1889,36,50-100,1925,1
SIM,1933,34,35-39,1967,11
STAT,1930,28,30-34,1958,47.046765181069425
SIM,1924,43,45-49,1967,1
SIM,1943,26,45-49,1969,2
SIM,1899,3,na,1902,3413
SIM,1845,84,na,1929,219
STAT,1848,51,50-100,1899,0.010932434625201989
SIM,1945,20,na,1965,3669
SIM,1849,98,na,1947,2
STAT,1846,81,na,1927,381.2781580936398
SIM,1849,21,15-19,1870,2
STAT,1945,20,45-49,1965,1.1657723167193623
SIM,1905,26,25-29,1931,58
STAT,1930,35,20-24,1965,0.3254064525376974
SIM,1838,32,45-49,1870,2
STAT,1877,20,35-39,1897,5.754752664084028
STAT,1878,28,na,1906,2338.7707517516055
SIM,1825,85,na,1910,105
SIM,1849,28,35-39,1877,8
SIM,1837,66,na,1903,1013
SIM,1942,27,40-44,1969,5
STAT,1917,38,45-49,1955,0.6655712664241549
STAT,1853,29,na,1882,1839.0845494451194
STAT,1916,25,45-49,1941,1.6988903292066997
STAT,1947,23,na,1970,3897.8851356202313
STAT,1934,27,40-44,1961,5.923328623484464
SIM,1849,35,25-29,1884,4
SIM,1886,41,35-39,1927,1
SIM,1832,66,na,1898,1011
SIM,1846,42,50-100,1888,3
SIM,1917,29,20-24,1946,18
STAT,1889,44,15-19,1933,0.015888616659616165
STAT,1829,26,50-100,1855,1.1723946593209311
SIM,1914,36,40-44,1950,2
SIM,1914,22,30-34,1936,41
STAT,1875,17,30-34,1892,1.546910898983342
SIM,1925,38,45-49,1963,1
SIM,1839,39,30-34,1878,6
STAT,1925,34,35-39,1959,10.239655928311276
STAT,1931,33,50-100,1964,1.0228419608684496
SIM,1925,20,na,1945,4060
SIM,1929,34,na,1963,4617
STAT,1799,87,na,1886,59.70421167709172
SIM,1922,15,20-24,1937,146
SIM,1851,26,na,1877,1890
SIM,1887,17,15-19,1904,6
STAT,1832,47,35-39,1879,0.10035450901899017
STAT,1857,41,15-19,1898,0.010331417968354498
STAT,1931,27,35-39,1958,18.311557960485846
STAT,1935,31,40-44,1966,5.117334996112956
SIM,1860,62,na,1922,1504
STAT,1831,48,30-34,1879,0.07026173281316095
STAT,1921,24,50-100,1945,0.6977568622342973
STAT,1862,44,na,1906,1837.344395312802
SIM,1786,89,na,1875,28
SIM,1860,40,40-44,1900,3
STAT,1916,43,45-49,1959,0.16086070183667875
STAT,1876,16,35-39,1892,0.5364458462414775
STAT,1876,39,20-24,1915,0.744208262250491
STAT,1906,22,30-34,1928,24.5027380492783
STAT,1914,15,20-24,1929,26.612140359918417
SIM,1845,85,na,1930,187
SIM,1841,71,na,1912,921
SIM,1859,25,40-44,1884,8
STAT,1897,23,45-49,1920,0.8782844793215927
STAT,1809,47,50-100,1856,0.8958997349670956
STAT,1811,50,50-100,1861,0.04992168520214446
STAT,1870,32,na,1902,2208.935338131492
STAT,1943,20,na,1963,3672.7613055978413
SIM,1868,58,na,1926,1767
STAT,1929,35,30-34,1964,2.2144271443753984
SIM,1864,44,na,1908,2039
SIM,1894,10,na,1904,3314
STAT,1853,36,15-19,1889,0.042079342458019045
STAT,1901,47,45-49,1948,0.17520702074935243
SIM,1821,71,na,1892,754
STAT,1810,51,40-44,1861,0.03645603519622011
STAT,1863,22,50-100,1885,0.34538331877957357
STAT,1899,29,35-39,1928,12.402352706008438
STAT,1935,19,20-24,1954,174.14152103314268
SIM,1900,35,35-39,1935,5
STAT,1837,77,na,1914,545.6542038277435
STAT,1858,35,25-29,1893,2.1555770767474667
STAT,1803,97,na,1900,1.7748677815144367
SIM,1864,22,45-49,1886,1
SIM,1881,8,na,1889,2181
STAT,1867,43,na,1910,2035.2615277162538
STAT,1822,37,na,1859,1477.57221297328
STAT,1883,16,50-100,1899,0.04547137409208494
STAT,1901,32,na,1933,3155.3879710900487
SIM,1921,17,na,1938,3869
STAT,1890,37,30-34,1927,6.155806312297795
STAT,1914,34,25-29,1948,8.712308941896818
SIM,1850,18,30-34,1868,1
STAT,1918,42,na,1960,3730.236772270404
STAT,1904,34,15-19,1938,0.1098360581724527
SIM,1834,78,na,1912,450
SIM,1843,20,30-34,1863,18
SIM,1938,25,25-29,1963,51
SIM,1930,33,20-24,1963,2
STAT,1918,35,20-24,1953,0.264970039686908
STAT,1892,27,50-100,1919,0.7567604372821357
STAT,1811,85,na,1896,118.74109471938374
STAT,1933,33,30-34,1966,20.045562760829267
STAT,1946,19,30-34,1965,12.763177353558094
STAT,1864,24,na,1888,1999.915691679607
STAT,1844,70,na,1914,984.9709728159781
SIM,1857,23,15-19,1880,2
SIM,1867,23,25-29,1890,54
STAT,1840,49,35-39,1889,0.095832017644216
STAT,1899,30,15-19,1929,0.18584482811241299
STAT,1916,40,40-44,1956,0.24280959050106948
STAT,1810,90,na,1900,35.7027007578951
STAT,1818,63,na,1881,955.4473945831706
STAT,1833,32,15-19,1865,0.11168194331258251
STAT,1872,98,na,1970,19.360233627574154
STAT,1896,56,na,1952,2546.5487642911908
STAT,1924,20,25-29,1944,103.59077086546291
SIM,1936,16,na,1952,2785
STAT,1926,26,15-19,1952,0.8023052612274285
SIM,1834,37,na,1871,1602
STAT,1842,18,30-34,1860,1.4489230418792636
STAT,1856,22,45-49,1878,0.599220743568829
STAT,1931,18,25-29,1949,53.44521726221201
STAT,1921,18,15-19,1939,48.746044800325485
SIM,1947,21,30-34,1968,35
STAT,1922,33,20-24,1955,2.592731290681823
STAT,1932,24,na,1956,4511.007583519551
STAT,1859,23,25-29,1882,44.45728081120574
SIM,1891,46,na,1937,2759
STAT,1849,23,15-19,1872,2.854317888267663
STAT,1886,43,35-39,1929,1.7943605918823446
STAT,1823,46,30-34,1869,0.1171495968427102
SIM,1874,65,na,1939,1580
STAT,1953,19,na,1972,4203.5760164470685
STAT,1933,25,45-49,1958,2.1689526781354447
STAT,1913,39,35-39,1952,2.2317448004191034
SIM,1849,32,20-24,1881,2
SIM,1908,35,40-44,1943,1
STAT,1911,33,45-49,1944,1.4411142222168933
STAT,1912,21,45-49,1933,1.0215187876716043
STAT,1902,21,35-39,1923,7.803046640539434
STAT,1939,21,30-34,1960,27.273902132167798
STAT,1854,14,na,1868,2037.7474820305026
STAT,1882,38,35-39,1920,6.469534712372089
STAT,1819,52,35-39,1871,0.01470348055365467
STAT,1843,38,50-100,1881,0.9312635622761608
STAT,1942,30,40-44,1972,3.942309766105337
STAT,1835,20,30-34,1855,19.803190752293265
STAT,1846,102,na,1948,0.20670960974960406
STAT,1841,51,na,1892,1480.2278039977266
STAT,1888,38,na,1926,2616.253145703575
SIM,1941,25,45-49,1966,1
SIM,1910,21,35-39,1931,8
SIM,1915,21,na,1936,3539
STAT,1815,47,35-39,1862,0.3406892518461791
STAT,1824,70,na,1894,740.7357462556892
SIM,1791,67,na,1858,696
SIM,1870,51,na,1921,2021
SIM,1921,39,35-39,1960,10
SIM,1920,21,45-49,1941,1
STAT,1907,16,40-44,1923,0.25439523370623246
STAT,1907,43,30-34,1950,0.109968706629321
SIM,1918,17,20-24,1935,136
SIM,1866,28,35-39,1894,10
STAT,1839,20,15-19,1859,2.8673777405093923
STAT,1869,40,30-34,1909,1.0619069184807877
STAT,1820,37,15-19,1857,0.1281789700459819
SIM,1932,20,25-29,1952,125
SIM,1888,20,40-44,1908,2
SIM,1926,26,45-49,1952,6
SIM,1834,24,25-29,1858,47
SIM,1942,7,na,1949,3758
STAT,1929,15,50-100,1944,0.4538194759183093
STAT,1873,83,na,1956,410.3821446541922
STAT,1924,46,35-39,1970,0.14537814519053938
SIM,1845,45,50-100,1890,2
SIM,1915,54,na,1969,3358
SIM,1921,27,20-24,1948,19
SIM,1904,58,na,1962,2783
STAT,1913,27,20-24,1940,17.178500812775244
STAT,1920,7,na,1927,4236.941583192403
SIM,1879,15,15-19,1894,5
SIM,1891,15,15-19,1906,6
SIM,1922,34,25-29,1956,14
STAT,1827,46,15-19,1873,3.5514405624018433E-4
STAT,1901,32,45-49,1933,2.3058333347102935
SIM,1899,32,30-34,1931,35
STAT,1910,20,30-34,1930,25.642536113346292
STAT,1850,55,na,1905,1455.6751417876878
STAT,1920,20,40-44,1940,3.552517328175109
STAT,1773,93,na,1866,4.544382885745521
SIM,1886,5,na,1891,2548
STAT,1802,52,45-49,1854,0.041364821516683734
STAT,1837,45,50-100,1882,0.1651187260108867
SIM,1812,67,na,1879,771
SIM,1881,47,na,1928,1870
SIM,1883,24,20-24,1907,57
SIM,1835,21,35-39,1856,5
STAT,1900,34,30-34,1934,22.686611737313683
STAT,1830,31,35-39,1861,8.611171402329454
STAT,1863,4,na,1867,2525.6915767186306
SIM,1877,40,30-34,1917,3
SIM,1839,20,45-49,1859,1
SIM,1847,20,15-19,1867,2
STAT,1902,58,na,1960,2737.6072113847217
SIM,1840,85,na,1925,151
SIM,1826,70,na,1896,724
SIM,1906,23,35-39,1929,9
SIM,1860,49,50-100,1909,1
SIM,1943,19,20-24,1962,113
STAT,1873,28,na,1901,2280.40163913737
SIM,1831,39,40-44,1870,3
STAT,1894,37,15-19,1931,0.0682401613112389
SIM,1796,66,na,1862,751
STAT,1867,76,na,1943,840.3474980747864
SIM,1842,33,na,1875,1761
STAT,1854,25,na,1879,1820.598103020276
STAT,1851,52,40-44,1903,0.007679000370268871
SIM,1880,33,50-100,1913,5
SIM,1928,39,25-29,1967,1
SIM,1938,29,40-44,1967,7
STAT,1922,34,50-100,1956,0.8782594470046243
SIM,1900,55,na,1955,2649
STAT,1893,15,25-29,1908,6.823789169412449
STAT,1947,7,na,1954,4191.866445903967
SIM,1928,29,30-34,1957,52
STAT,1817,104,na,1921,0.0295790145398529
SIM,1891,19,30-34,1910,2
STAT,1820,89,na,1909,55.96562715590199
STAT,1869,24,na,1893,2149.148664828276
STAT,1861,102,na,1963,0.8435465791564227
STAT,1883,19,30-34,1902,1.4677973616572695
SIM,1817,45,na,1862,1432
STAT,1865,10,na,1875,2349.711412222351
SIM,1883,17,30-34,1900,2
SIM,1934,25,40-44,1959,6
STAT,1936,29,15-19,1965,0.6374991354653512
STAT,1876,49,15-19,1925,3.8195680233607944E-4
STAT,1823,39,40-44,1862,6.198644106545107
SIM,1803,53,na,1856,1084
SIM,1820,39,30-34,1859,4
SIM,1854,14,na,1868,2219
STAT,1901,29,15-19,1930,0.5956371734258713
SIM,1773,93,na,1866,6
STAT,1856,48,35-39,1904,0.10228360755098022
STAT,1867,47,50-100,1914,0.2168317025720363
STAT,1939,31,25-29,1970,8.913028968017287
STAT,1922,40,45-49,1962,0.18097663459572405
STAT,1801,86,na,1887,75.41522539328798
SIM,1842,23,20-24,1865,61
SIM,1846,70,na,1916,947
SIM,1882,36,35-39,1918,14
STAT,1922,26,30-34,1948,42.03207288473416
STAT,1956,15,25-29,1971,54.19349052924412
SIM,1938,18,35-39,1956,6
SIM,1930,26,30-34,1956,55
STAT,1905,28,25-29,1933,57.54474100017351
STAT,1858,36,50-100,1894,0.9149128253787332
SIM,1913,28,25-29,1941,64
SIM,1925,32,35-39,1957,14
STAT,1879,17,15-19,1896,5.85996582297377
STAT,1845,42,35-39,1887,1.2988687984591316
STAT,1926,44,45-49,1970,0.19320360002079756
STAT,1830,34,50-100,1864,0.7421284656381831
STAT,1850,11,na,1861,2063.0579097944938
SIM,1875,47,50-100,1922,2
STAT,1892,21,15-19,1913,3.914550613371107
STAT,1887,19,15-19,1906,6.236208435293719
SIM,1842,39,50-100,1881,1
STAT,1863,30,35-39,1893,8.477251162768123
SIM,1839,77,na,1916,580
STAT,1884,51,40-44,1935,0.00987500210481767
STAT,1944,25,20-24,1969,18.653577490285127
SIM,1875,15,30-34,1890,2
SIM,1878,23,35-39,1901,8
SIM,1931,31,50-100,1962,3
STAT,1801,75,na,1876,431.1428143013864
STAT,1814,105,na,1919,0.012097590138939887
STAT,1914,24,30-34,1938,27.561040948357398
STAT,1880,47,15-19,1927,3.9574540745944647E-4
STAT,1926,25,40-44,1951,5.314906537692129
STAT,1821,35,50-100,1856,2.919378596485699
STAT,1861,28,20-24,1889,9.203353888448598
STAT,1946,26,20-24,1972,19.21823782097292
STAT,1919,45,15-19,1964,3.7922719687107336E-4
STAT,1908,5,na,1913,3671.595517748948
STAT,1876,46,50-100,1922,0.24020277492074613
STAT,1824,59,na,1883,1103.8894428413416
STAT,1867,22,20-24,1889,61.37722624023463
SIM,1884,31,50-100,1915,3
SIM,1895,19,15-19,1914,9
STAT,1824,48,na,1872,1352.4055572591506
STAT,1843,50,40-44,1893,0.007704376083492974
STAT,1864,47,30-34,1911,0.08134825590022847
STAT,1853,84,na,1937,246.70562901894363
STAT,1940,21,20-24,1961,107.03310981811661
SIM,1875,22,20-24,1897,60
STAT,1907,57,na,1964,2955.7874843467357
STAT,1794,88,na,1882,44.75302514114121
STAT,1903,15,45-49,1918,0.08820351705951436
STAT,1906,32,25-29,1938,8.090374723342403
SIM,1901,26,40-44,1927,5
STAT,1903,43,na,1946,3094.593372046912
STAT,1891,57,na,1948,2349.875042732202
STAT,1948,17,40-44,1965,1.5122851623226288
SIM,1856,25,na,1881,1980
SIM,1826,59,na,1885,1128
STAT,1825,30,15-19,1855,0.31472347133306283
STAT,1932,40,25-29,1972,0.09168574623787659
STAT,1883,50,na,1933,2022.1952623288191
SIM,1859,21,25-29,1880,47
SIM,1818,52,na,1870,1178
SIM,1933,31,30-34,1964,35
STAT,1881,32,50-100,1913,0.8357478631777069
STAT,1938,27,25-29,1965,61.59477977777801
SIM,1839,17,15-19,1856,5
SIM,1884,21,30-34,1905,24
SIM,1869,6,na,1875,2526
SIM,1889,64,na,1953,1985
STAT,1937,33,15-19,1970,0.12001380155594622
STAT,1885,30,50-100,1915,0.8692831062068342
SIM,1885,50,na,1935,2071
STAT,1846,18,15-19,1864,5.225351490553152
STAT,1906,25,35-39,1931,13.363202813332386
SIM,1875,25,25-29,1900,46
STAT,1836,29,na,1865,1742.3314263282996
STAT,1874,36,35-39,1910,6.861997666408408
SIM,1924,22,40-44,1946,7
STAT,1872,48,50-100,1920,0.22995235961067031
STAT,1929,42,20-24,1971,0.02160714092694993
SIM,1853,42,35-39,1895,4
SIM,1880,48,50-100,1928,2
STAT,1947,23,30-34,1970,30.67806277050242
SIM,1914,32,25-29,1946,12
STAT,1898,26,15-19,1924,0.5821981455268403
SIM,1854,18,15-19,1872,4
SIM,1902,30,40-44,1932,11
STAT,1871,17,na,1888,2380.616120452783
STAT,1941,27,45-49,1968,1.6881842190726668
STAT,1925,31,30-34,1956,17.68688360225505
STAT,1864,24,45-49,1888,0.5896641412783956
STAT,1928,38,20-24,1966,0.31443548484237116
STAT,1800,54,35-39,1854,0.02413746077345287
STAT,1815,89,na,1904,44.96303885808452
STAT,1952,16,15-19,1968,51.39438650693505
STAT,1930,24,15-19,1954,6.402207866669164
STAT,1874,54,35-39,1928,0.008083734836703388
SIM,1873,80,na,1953,552
SIM,1885,61,na,1946,1764
STAT,1916,22,40-44,1938,3.3283236283926807
SIM,1869,43,na,1912,2100
SIM,1820,86,na,1906,78
STAT,1834,23,20-24,1857,56.6393176395194
STAT,1918,53,na,1971,3614.6240294655704
SIM,1849,25,30-34,1874,30
SIM,1835,64,na,1899,1093
SIM,1842,31,20-24,1873,2
STAT,1877,19,50-100,1896,0.047770008462201446
STAT,1918,38,25-29,1956,0.9793884655298986
STAT,1919,22,45-49,1941,1.1639388912898798
STAT,1836,36,15-19,1872,0.04398058876005941
STAT,1869,24,45-49,1893,0.6336646625644838
STAT,1881,24,45-49,1905,0.6320758414181901
STAT,1884,25,25-29,1909,39.7579700859722
STAT,1888,41,45-49,1929,1.6778231939952286
STAT,1942,30,20-24,1972,2.4572265413276324
SIM,1822,33,45-49,1855,1
SIM,1839,21,20-24,1860,68
STAT,1884,23,30-34,1907,16.577091815514994
STAT,1946,16,na,1962,3857.87153406125
STAT,1837,31,50-100,1868,0.7327648030869611
STAT,1861,20,25-29,1881,46.80528938449276
SIM,1956,7,na,1963,4770
STAT,1833,35,35-39,1868,5.497084905050371
SIM,1825,34,25-29,1859,12
SIM,1910,20,25-29,1930,87
SIM,1887,43,45-49,1930,3
SIM,1878,20,30-34,1898,25
SIM,1883,25,30-34,1908,32
SIM,1924,33,30-34,1957,27
SIM,1843,23,35-39,1866,7
SIM,1894,75,na,1969,1660
SIM,1924,35,na,1959,4165
STAT,1841,34,15-19,1875,0.11578694244299026
STAT,1813,49,25-29,1862,0.16842440597841507
STAT,1898,38,30-34,1936,1.4637924245694576
SIM,1943,18,na,1961,3615
STAT,1939,20,20-24,1959,105.55578242357846
SIM,1907,36,35-39,1943,6
SIM,1918,24,45-49,1942,2
SIM,1846,24,15-19,1870,7
STAT,1897,73,na,1970,1886.6773121965248
STAT,1849,38,35-39,1887,5.162812863474144
STAT,1811,108,na,1919,7.934095160420783E-4
STAT,1841,52,30-34,1893,0.0040510032438084405
STAT,1873,37,30-34,1910,5.110576517329686
SIM,1927,22,45-49,1949,1
SIM,1881,37,30-34,1918,10
STAT,1925,33,25-29,1958,10.36342226190671
SIM,1841,35,35-39,1876,11
STAT,1840,66,na,1906,1141.4340488020553
SIM,1916,16,na,1932,3788
STAT,1823,31,45-49,1854,5.454960872831393
SIM,1857,38,35-39,1895,16
STAT,1911,19,30-34,1930,2.2913268071872563
STAT,1835,23,35-39,1858,4.805057499243637
STAT,1946,23,15-19,1969,5.594350394701825
SIM,1868,26,45-49,1894,5
SIM,1889,15,25-29,1904,8
STAT,1858,36,35-39,1894,5.270734845300582
SIM,1948,2,na,1950,4087
SIM,1872,39,30-34,1911,8
STAT,1903,42,20-24,1945,0.014804154618572034
SIM,1808,62,na,1870,914
STAT,1834,31,20-24,1865,2.1655783680820595
STAT,1919,38,na,1957,3814.3735452062465
SIM,1892,25,25-29,1917,60
STAT,1900,41,40-44,1941,0.20563290055365593
STAT,1828,32,na,1860,1631.8371185097042
STAT,1826,32,25-29,1858,13.553290879761281
STAT,1923,43,na,1966,4094.625029764036
STAT,1894,29,15-19,1923,0.5474079285813893
STAT,1847,22,15-19,1869,2.9757368521669245
SIM,1858,37,na,1895,1908
SIM,1865,84,na,1949,219
STAT,1830,48,15-19,1878,2.894074620101093E-4
SIM,1899,19,na,1918,3254
SIM,1901,2,na,1903,3572
STAT,1780,96,na,1876,1.2968632827478808
STAT,1842,67,na,1909,1128.853568680041
STAT,1920,19,25-29,1939,45.686548238899555
SIM,1942,24,35-39,1966,13
STAT,1827,38,15-19,1865,0.05474676702644291
STAT,1893,23,25-29,1916,68.403484987432
STAT,1838,24,15-19,1862,2.8774559017489083
STAT,1866,52,35-39,1918,0.007458478340866241
STAT,1934,24,35-39,1958,11.94564599488641
SIM,1947,20,20-24,1967,123
STAT,1889,54,na,1943,2442.1903571953353
STAT,1896,17,15-19,1913,7.409477791075181
STAT,1901,17,35-39,1918,0.7255509414525584
SIM,1882,29,45-49,1911,1
STAT,1951,21,30-34,1972,32.45174581871271
SIM,1881,13,na,1894,2154
SIM,1816,81,na,1897,188
STAT,1822,105,na,1927,0.015145092511187253
SIM,1938,22,20-24,1960,102
SIM,1859,33,40-44,1892,2
STAT,1836,51,na,1887,1403.2561389409589
STAT,1874,29,45-49,1903,1.0643706556631842
STAT,1931,30,45-49,1961,1.9501099322984492
SIM,1778,92,na,1870,6
STAT,1921,40,15-19,1961,0.0016386885960354613
STAT,1943,22,35-39,1965,9.463436760992659
SIM,1838,18,30-34,1856,1
STAT,1897,63,na,1960,2366.284246142701
SIM,1833,33,20-24,1866,1
STAT,1819,101,na,1920,0.2849619977038077
STAT,1820,66,na,1886,867.6904770751358
SIM,1851,24,25-29,1875,56
SIM,1835,54,na,1889,1350
STAT,1864,39,30-34,1903,4.454531203019614
STAT,1872,31,40-44,1903,4.128889162048852
SIM,1823,39,35-39,1862,12
SIM,1799,84,na,1883,72
SIM,1921,3,na,1924,4260
STAT,1902,28,20-24,1930,15.584710647658044
STAT,1944,28,25-29,1972,67.17055227563084
STAT,1926,37,20-24,1963,0.30438289392249823
STAT,1913,16,15-19,1929,8.785320739919914
SIM,1831,31,45-49,1862,1
SIM,1834,32,25-29,1866,15
SIM,1905,20,15-19,1925,4
STAT,1916,40,20-24,1956,0.01714388539850951
SIM,1874,27,30-34,1901,24
STAT,1859,24,na,1883,1823.5231624715204
SIM,1880,51,na,1931,2268
STAT,1777,105,na,1882,0.019116645937017923
SIM,1873,38,35-39,1911,11
STAT,1945,20,50-100,1965,0.6817382228880849
SIM,1899,35,35-39,1934,19
SIM,1827,35,na,1862,1566
STAT,1889,47,35-39,1936,0.09167304902547621
STAT,1890,22,45-49,1912,0.8054252538683252
STAT,1863,39,na,1902,1936.7447908838826
SIM,1841,28,45-49,1869,1
STAT,1849,24,na,1873,1836.627292547668
SIM,1922,38,40-44,1960,2
STAT,1828,53,50-100,1881,0.010958737009082
STAT,1917,32,35-39,1949,9.039682136363389
STAT,1902,20,25-29,1922,76.77223132990214
SIM,1850,31,na,1881,1852
SIM,1848,27,na,1875,1910
STAT,1833,28,30-34,1861,20.106955696943512
STAT,1846,44,45-49,1890,1.04099601130065
STAT,1937,25,15-19,1962,0.650573670731164
STAT,1865,38,35-39,1903,6.041597202855518
SIM,1855,40,45-49,1895,3
SIM,1836,81,na,1917,322
SIM,1890,51,na,1941,2563
STAT,1879,25,15-19,1904,0.4510398253015339
SIM,1841,28,30-34,1869,31
STAT,1812,47,na,1859,1316.167347523848
STAT,1850,96,na,1946,6.045026798121643
STAT,1815,39,35-39,1854,23.63434989947447
STAT,1877,37,15-19,1914,0.055049270295554655
STAT,1843,24,25-29,1867,51.09839484677781
STAT,1860,21,20-24,1881,54.93526560203881
STAT,1916,33,30-34,1949,15.301080012399538
SIM,1880,31,40-44,1911,3
SIM,1921,16,15-19,1937,41
STAT,1879,43,45-49,1922,1.4671550082101819
SIM,1933,33,25-29,1966,16
STAT,1833,28,45-49,1861,0.8865421559392891
SIM,1892,23,30-34,1915,33
STAT,1926,3,na,1929,4698.444475301309
STAT,1838,52,na,1890,1460.695078740832
STAT,1877,42,50-100,1919,1.0343826573943533
STAT,1851,19,35-39,1870,0.4834712959098212
SIM,1874,34,20-24,1908,2
STAT,1847,40,45-49,1887,1.1360934615031621
SIM,1852,12,na,1864,2271
STAT,1866,34,20-24,1900,2.334177653788647
SIM,1823,102,na,1925,1
STAT,1850,86,na,1936,156.20134751337628
STAT,1884,18,35-39,1902,0.5108997061930534
SIM,1822,102,na,1924,1
SIM,1825,54,na,1879,1188
SIM,1825,32,30-34,1857,20
STAT,1882,53,30-34,1935,0.00538402461395047
SIM,1827,45,na,1872,1419
STAT,1856,112,na,1968,2.2221352723605318E-4
SIM,1910,28,20-24,1938,15
STAT,1832,36,30-34,1868,4.130038703694236
SIM,1909,31,40-44,1940,4
SIM,1840,36,30-34,1876,5
SIM,1928,1,na,1929,4882
SIM,1926,23,40-44,1949,4
STAT,1898,27,na,1925,3051.9501969818593
STAT,1932,29,45-49,1961,2.1355933225370913
STAT,1918,23,40-44,1941,3.4151619036453984
SIM,1888,57,na,1945,2195
SIM,1940,29,45-49,1969,2
SIM,1842,12,na,1854,2109
STAT,1852,77,na,1929,656.7412500294552
SIM,1875,26,35-39,1901,9
STAT,1855,112,na,1967,1.7931653544329035E-4
SIM,1850,21,na,1871,1875
STAT,1867,33,25-29,1900,9.046855450146985
SIM,1933,18,na,1951,4656
STAT,1908,41,25-29,1949,0.06275844077329111
SIM,1833,29,35-39,1862,10
STAT,1838,42,45-49,1880,1.1937616656285581
SIM,1891,13,na,1904,3176
STAT,1850,27,35-39,1877,7.993847896813401
STAT,1905,40,45-49,1945,0.14331190448560402
SIM,1879,74,na,1953,1042
STAT,1922,49,50-100,1971,0.24404562250497286
STAT,1851,26,25-29,1877,36.583160075660366
STAT,1834,24,30-34,1858,14.534836556585644
SIM,1886,76,na,1962,1114
STAT,1874,33,15-19,1907,0.1369188532327983
SIM,1941,25,30-34,1966,41
STAT,1766,108,na,1874,0.004606612475371757
SIM,1852,28,20-24,1880,11
STAT,1836,20,50-100,1856,0.4131315552912769
STAT,1845,15,45-49,1860,0.058846260623795825
SIM,1902,29,25-29,1931,55
STAT,1878,53,50-100,1931,0.014614358897803801
STAT,1858,40,20-24,1898,0.11896889489507152
SIM,1837,44,45-49,1881,3
SIM,1875,33,25-29,1908,12
SIM,1926,16,na,1942,4173
STAT,1810,108,na,1918,8.294902237451027E-4
STAT,1890,29,30-34,1919,28.877892988201843
STAT,1853,28,15-19,1881,0.3521573208232196
STAT,1899,34,30-34,1933,22.41006247162436
SIM,1842,24,30-34,1866,17
STAT,1798,92,na,1890,11.55195857327822
STAT,1870,28,15-19,1898,0.41850027478457014
STAT,1933,25,30-34,1958,49.19228613762944
SIM,1955,15,30-34,1970,15
STAT,1862,2,na,1864,2764.011523656398
SIM,1884,75,na,1959,1044
STAT,1855,42,45-49,1897,1.0586706347769828
SIM,1843,30,25-29,1873,13
STAT,1897,49,35-39,1946,0.09769080258199771
SIM,1873,25,50-100,1898,1
STAT,1856,45,15-19,1901,2.9890791441628315E-4
STAT,1860,46,35-39,1906,0.10779152817823269
STAT,1899,36,25-29,1935,3.7453878597135257
SIM,1858,27,na,1885,2046
SIM,1953,18,na,1971,4113
STAT,1840,38,30-34,1878,4.344575109746268
SIM,1847,16,30-34,1863,5
STAT,1947,15,30-34,1962,12.978490792340653
STAT,1826,51,na,1877,1316.2917232048271
SIM,1898,39,35-39,1937,5
STAT,1874,51,30-34,1925,0.005774873229654626
STAT,1942,23,30-34,1965,28.457481371341558
SIM,1862,30,50-100,1892,5
SIM,1830,96,na,1926,4
SIM,1930,21,na,1951,4339
STAT,1772,87,na,1859,45.479847274614855
STAT,1917,29,50-100,1946,0.9790197029788441
SIM,1856,39,30-34,1895,4
STAT,1882,35,15-19,1917,0.05211032706632449
STAT,1887,45,45-49,1932,0.2518189243006045
STAT,1888,48,30-34,1936,0.06017210882375934
SIM,1876,56,na,1932,1996
STAT,1857,37,30-34,1894,3.9692071910627997
STAT,1868,25,40-44,1893,2.7202606197242534
STAT,1862,38,50-100,1900,0.9844543335695333
STAT,1913,43,na,1956,3415.2694516306533
STAT,1839,16,30-34,1855,1.3984653053763332
SIM,1851,17,35-39,1868,2
STAT,1860,24,25-29,1884,44.658796298489655
STAT,1829,26,15-19,1855,0.8315222192552285
STAT,1843,17,35-39,1860,0.5058935577116588
STAT,1840,23,45-49,1863,0.6131381137234436
STAT,1848,39,30-34,1887,3.875411218556087
SIM,1916,34,35-39,1950,10
SIM,1891,23,na,1914,2926
STAT,1833,50,30-34,1883,0.0038836461771724826
STAT,1927,21,40-44,1948,3.9257430596809826
STAT,1825,99,na,1924,1.070781288666912
STAT,1860,17,35-39,1877,0.4858671241709411
STAT,1885,29,20-24,1914,10.962484866966317
SIM,1946,24,20-24,1970,90
SIM,1901,22,25-29,1923,79
STAT,1858,62,na,1920,1355.4995409384935
STAT,1910,15,35-39,1925,0.7888840167679915
SIM,1888,17,30-34,1905,5
STAT,1815,44,15-19,1859,0.03533814061276067
STAT,1813,49,50-100,1862,0.7181429583352908
STAT,1825,36,25-29,1861,3.8392484184184568
SIM,1863,28,na,1891,2021
STAT,1938,17,30-34,1955,11.357230415932472
STAT,1817,47,50-100,1864,0.549504923333342
STAT,1835,30,25-29,1865,8.306926437773821
STAT,1924,35,30-34,1959,2.0339884254437965
STAT,1875,32,20-24,1907,2.6234212882021395
SIM,1884,31,25-29,1915,12
SIM,1911,19,25-29,1930,11
SIM,1947,16,35-39,1963,4
STAT,1830,66,na,1896,979.0651283247201
STAT,1871,49,15-19,1920,3.6679534703446394E-4
STAT,1839,23,20-24,1862,58.61502433789314
SIM,1925,31,25-29,1956,15
STAT,1889,44,na,1933,2659.1495787617646
SIM,1876,46,na,1922,2252
STAT,1814,48,30-34,1862,0.2583682784520418
STAT,1909,38,na,1947,3346.5443912056003
SIM,1839,48,50-100,1887,1
STAT,1843,22,30-34,1865,16.13034339876882
STAT,1928,27,15-19,1955,0.8217068448255632
SIM,1853,83,na,1936,280
STAT,1818,38,20-24,1856,2.3587087371827185
STAT,1876,31,25-29,1907,10.029977169627637
STAT,1881,39,30-34,1920,4.812415030330709
SIM,1851,22,30-34,1873,20
STAT,1934,31,25-29,1965,11.92804837287892
STAT,1944,21,40-44,1965,3.4306378369001824
SIM,1936,20,45-49,1956,1
SIM,1946,17,30-34,1963,19
SIM,1848,82,na,1930,312
SIM,1893,29,20-24,1922,14
SIM,1883,32,20-24,1915,1
SIM,1901,20,30-34,1921,28
STAT,1841,37,35-39,1878,5.701568206283158
SIM,1932,35,30-34,1967,1
STAT,1903,19,25-29,1922,7.5754258499129286
STAT,1859,35,40-44,1894,3.3316502306140943
STAT,1939,16,35-39,1955,3.968603603827019
SIM,1808,52,na,1860,1198
STAT,1875,25,30-34,1900,24.605800104924327
STAT,1825,29,35-39,1854,31.788948409133646
STAT,1866,36,50-100,1902,1.0744973267232456
STAT,1938,24,20-24,1962,103.88018863144458
STAT,1805,99,na,1904,0.6341205984891991
SIM,1826,30,25-29,1856,11
STAT,1908,34,35-39,1942,8.077190042993198
STAT,1928,20,45-49,1948,1.3351887967225893
STAT,1878,41,50-100,1919,1.0436713703975067
STAT,1904,60,na,1964,2764.7962457813323
SIM,1832,37,35-39,1869,8
STAT,1865,35,15-19,1900,0.04866340784009156
STAT,1917,39,20-24,1956,0.25707733450873055
SIM,1926,38,25-29,1964,1
SIM,1935,21,40-44,1956,3
STAT,1885,21,25-29,1906,54.04105167262079
SIM,1817,47,50-100,1864,2
STAT,1824,37,35-39,1861,10.62947220727967
STAT,1836,49,50-100,1885,0.15820247017562597
STAT,1839,49,30-34,1888,0.06409788851376291
SIM,1836,20,40-44,1856,2
SIM,1866,36,50-100,1902,1
STAT,1892,27,25-29,1919,50.04286798278514
STAT,1831,33,45-49,1864,1.413080751833825
STAT,1917,31,25-29,1948,9.180177963701857
STAT,1849,45,25-29,1894,0.04193146355468032
STAT,1866,81,na,1947,470.9999544029736
SIM,1845,64,na,1909,1220
SIM,1903,43,na,1946,3112
STAT,1910,22,25-29,1932,81.92190401434877
STAT,1919,37,15-19,1956,0.019489332679594306
SIM,1847,23,20-24,1870,54
STAT,1899,41,20-24,1940,0.014341991097470051
STAT,1823,38,30-34,1861,8.012660782661936
STAT,1876,24,35-39,1900,5.655456266982627
STAT,1907,35,30-34,1942,1.6112203627006512
STAT,1891,28,35-39,1919,11.242842318330792
STAT,1848,46,35-39,1894,0.1011456530876658
STAT,1869,44,na,1913,2084.9546283470486
SIM,1831,38,30-34,1869,3
SIM,1884,24,35-39,1908,11
SIM,1893,21,25-29,1914,74
STAT,1848,47,30-34,1895,0.06941188063089264
STAT,1870,26,50-100,1896,0.5941758095151887
SIM,1843,73,na,1916,816
SIM,1917,33,40-44,1950,5
STAT,1822,46,15-19,1868,5.66036709084224E-4
STAT,1898,15,25-29,1913,7.280434491752472
STAT,1919,0,na,1919,4703.2004961484745
STAT,1851,16,30-34,1867,1.4294794467177323
STAT,1926,22,35-39,1948,10.807805565078766
SIM,1938,23,30-34,1961,33
STAT,1855,34,45-49,1889,1.2316782673472697
SIM,1825,31,20-24,1856,2
STAT,1883,26,35-39,1909,8.96428335573001
STAT,1904,48,25-29,1952,0.04346671346948797
SIM,1853,20,40-44,1873,2
STAT,1908,31,30-34,1939,14.103253761572937
SIM,1842,97,na,1939,2
STAT,1918,31,40-44,1949,3.94442307875187
STAT,1916,41,na,1957,3600.5168947916413
STAT,1848,39,45-49,1887,1.4495671248529804
SIM,1892,22,20-24,1914,76
STAT,1837,21,45-49,1858,0.5804254038306451
SIM,1919,21,40-44,1940,4
STAT,1900,44,45-49,1944,0.13437069141344501
STAT,1905,22,15-19,1927,4.503680536317553
STAT,1884,22,20-24,1906,64.33255023637265
STAT,1878,29,15-19,1907,0.4430058697592066
SIM,1935,24,45-49,1959,1
STAT,1920,16,20-24,1936,144.05533054715573
SIM,1947,22,na,1969,3727
SIM,1876,25,40-44,1901,5
STAT,1839,36,50-100,1875,0.9884776330648348
STAT,1786,91,na,1877,17.62451528627401
STAT,1816,51,na,1867,1310.907168497723
SIM,1843,22,25-29,1865,52
SIM,1897,15,30-34,1912,5
SIM,1913,22,15-19,1935,5
STAT,1818,48,15-19,1866,8.417623515016517E-4
SIM,1856,39,45-49,1895,1
STAT,1870,18,20-24,1888,16.469509496403045
STAT,1899,44,25-29,1943,0.056951061659242894
STAT,1867,35,50-100,1902,1.0993508676739185
STAT,1877,29,15-19,1906,0.4415934318350381
STAT,1891,78,na,1969,1318.8931049180262
STAT,1909,33,40-44,1942,3.5120376712111843
STAT,1884,26,35-39,1910,9.038569861876963
SIM,1863,34,45-49,1897,2
SIM,1879,41,45-49,1920,6
STAT,1892,25,30-34,1917,29.992465874895984
STAT,1898,28,50-100,1926,0.8151762992890843
SIM,1901,23,35-39,1924,10
STAT,1920,42,20-24,1962,0.0184269537487432
SIM,1889,38,30-34,1927,8
STAT,1894,45,na,1939,2761.822824763298
STAT,1932,34,na,1966,4743.608728900395
SIM,1833,34,30-34,1867,18
SIM,1874,75,na,1949,953
SIM,1930,11,na,1941,4812
SIM,1807,90,na,1897,29
STAT,1943,21,25-29,1964,92.86623420295781
SIM,1824,35,35-39,1859,13
SIM,1893,58,na,1951,2436
SIM,1915,44,na,1959,3500
SIM,1868,27,na,1895,2166
SIM,1918,21,40-44,1939,3
SIM,1834,68,na,1902,944
SIM,1828,82,na,1910,268
SIM,1889,74,na,1963,1499
SIM,1916,31,30-34,1947,22
STAT,1811,75,na,1886,442.4207800710987
STAT,1845,20,40-44,1865,1.8486250684130225
SIM,1832,34,30-34,1866,21
SIM,1926,31,40-44,1957,6
STAT,1912,47,20-24,1959,0.010030911785408462
SIM,1891,26,35-39,1917,9
STAT,1812,92,na,1904,17.91334336736688
STAT,1825,34,30-34,1859,25.621820961118605
STAT,1930,16,50-100,1946,0.4587303577028668
STAT,1886,16,45-49,1902,0.0653601020944868
STAT,1909,37,20-24,1946,0.2356541793831746
SIM,1876,31,50-100,1907,1
STAT,1869,78,na,1947,714.4793736155345
SIM,1874,37,25-29,1911,3
SIM,1834,22,30-34,1856,16
SIM,1840,29,40-44,1869,2
STAT,1955,17,30-34,1972,15.28472558595008
STAT,1777,86,na,1863,62.37170865321747
SIM,1884,23,25-29,1907,59
SIM,1840,31,na,1871,1793
SIM,1802,91,na,1893,11
SIM,1850,25,35-39,1875,8
STAT,1897,31,45-49,1928,2.2121753075633395
SIM,1909,34,45-49,1943,1
SIM,1859,36,45-49,1895,1
SIM,1826,81,na,1907,263
STAT,1888,25,50-100,1913,0.7187465556843131
STAT,1870,86,na,1956,225.91556423691858
STAT,1945,27,15-19,1972,0.7316627602494882
SIM,1892,26,35-39,1918,13
STAT,1822,47,na,1869,1346.1584635282732
STAT,1832,29,40-44,1861,2.4028797286202006
STAT,1854,48,na,1902,1599.7407729886795
STAT,1948,21,25-29,1969,100.23253299942743
STAT,1938,21,15-19,1959,4.978046540790228
SIM,1813,43,45-49,1856,1
SIM,1951,1,na,1952,4437
SIM,1851,21,20-24,1872,73
SIM,1900,45,na,1945,2963
SIM,1873,28,40-44,1901,7
SIM,1830,39,25-29,1869,2
SIM,1825,35,35-39,1860,11
SIM,1914,0,na,1914,4382
STAT,1822,39,25-29,1861,4.700122358847468
STAT,1842,25,35-39,1867,8.620517724685836
SIM,1845,30,na,1875,1843
SIM,1940,21,na,1961,3349
STAT,1855,18,50-100,1873,0.04102655458972173
SIM,1943,23,40-44,1966,3
STAT,1912,17,25-29,1929,8.276304511277448
SIM,1946,21,15-19,1967,4
STAT,1838,49,30-34,1887,0.06620418161487521
STAT,1852,67,na,1919,1204.404673096856
SIM,1866,33,30-34,1899,16
SIM,1875,29,na,1904,2298
STAT,1893,20,20-24,1913,83.09245521540444
SIM,1938,17,na,1955,3373
SIM,1868,23,40-44,1891,2
STAT,1817,42,25-29,1859,1.623611255973275
STAT,1896,46,na,1942,2817.4976930762414
STAT,1865,35,30-34,1900,4.6185992570056875
STAT,1866,37,25-29,1903,2.5077491703231316
STAT,1928,35,15-19,1963,0.022968776320503433
STAT,1848,21,20-24,1869,60.886474406797596
STAT,1844,38,15-19,1882,0.04122685961673972
STAT,1883,52,35-39,1935,0.007928411865891504
STAT,1851,31,20-24,1882,2.0846466301704756
STAT,1843,21,20-24,1864,62.856685029832015
STAT,1889,15,30-34,1904,1.8675219650366213
SIM,1898,57,na,1955,2539
SIM,1934,22,35-39,1956,14
SIM,1920,17,25-29,1937,54
SIM,1854,41,40-44,1895,7
SIM,1938,30,20-24,1968,2
STAT,1767,108,na,1875,0.0035417249025024447
STAT,1839,19,35-39,1858,0.47298185016068117
STAT,1855,45,15-19,1900,2.8611880270447654E-4
SIM,1887,40,40-44,1927,5
SIM,1860,21,na,1881,2051
STAT,1858,33,30-34,1891,12.89400021505231
SIM,1873,35,30-34,1908,5
SIM,1885,29,na,1914,2237
STAT,1829,44,45-49,1873,1.2211954640162235
SIM,1923,18,na,1941,3982
SIM,1856,21,20-24,1877,50
STAT,1839,101,na,1940,0.3804758933708888
STAT,1883,19,45-49,1902,0.06015561734586178
SIM,1941,28,35-39,1969,21
STAT,1835,34,na,1869,1686.0874219236216
SIM,1839,24,25-29,1863,51
STAT,1862,102,na,1964,0.9943661938822727
SIM,1815,64,na,1879,851
STAT,1836,28,15-19,1864,0.36806864390735844
SIM,1848,37,30-34,1885,9
STAT,1859,20,50-100,1879,0.3556188399602288
STAT,1896,35,45-49,1931,2.512570053664191
STAT,1879,40,40-44,1919,2.243417887837313
STAT,1844,28,20-24,1872,10.00936121663594
STAT,1842,105,na,1947,0.020879618846563204
STAT,1855,49,30-34,1904,0.06712589694987477
STAT,1914,34,50-100,1948,0.7793539678981358
STAT,1846,41,40-44,1887,1.6257979170739423
STAT,1854,112,na,1966,1.5263698542945762E-4
SIM,1852,49,50-100,1901,1
SIM,1938,15,30-34,1953,13
SIM,1955,5,na,1960,4547
STAT,1851,24,30-34,1875,15.375431351940655
STAT,1937,33,na,1970,3532.158935494669
STAT,1842,51,35-39,1893,0.006159952080172736
SIM,1900,27,35-39,1927,12
STAT,1933,28,35-39,1961,18.82353437469568
SIM,1889,20,20-24,1909,70
STAT,1847,25,20-24,1872,10.525672355592643
STAT,1825,34,na,1859,1627.913323832869
STAT,1859,49,15-19,1908,2.9527302182965996E-4
STAT,1855,16,15-19,1871,5.028748517974992
SIM,1875,30,20-24,1905,2
STAT,1894,15,40-44,1909,0.22330018980863411
STAT,1884,33,25-29,1917,9.521526847308374
STAT,1850,24,30-34,1874,14.835675447056024
SIM,1863,16,15-19,1879,6
STAT,1874,29,30-34,1903,24.140142096087697
STAT,1899,37,35-39,1936,1.9763931236700265
STAT,1884,50,50-100,1934,0.014301625331178675
STAT,1947,18,35-39,1965,4.464208212524672
SIM,1829,28,30-34,1857,29
STAT,1877,30,50-100,1907,0.9054310198473425
STAT,1837,28,15-19,1865,0.3649687259126382
SIM,1825,64,na,1889,895
SIM,1878,20,45-49,1898,3
SIM,1775,94,na,1869,6
SIM,1866,35,25-29,1901,2
SIM,1928,17,na,1945,4407
STAT,1851,23,20-24,1874,59.91494550329934
SIM,1896,19,30-34,1915,1
STAT,1956,16,na,1972,4601.8789700306725
SIM,1908,32,35-39,1940,10
SIM,1858,34,35-39,1892,9
STAT,1863,47,15-19,1910,3.3061658280131404E-4
SIM,1844,78,na,1922,486
STAT,1888,19,30-34,1907,1.7692352834370375
SIM,1905,44,na,1949,3105
STAT,1901,22,30-34,1923,23.55294960183617
SIM,1879,23,15-19,1902,3
STAT,1860,96,na,1956,7.6410323570620236
SIM,1865,36,35-39,1901,13
STAT,1889,1,na,1890,3174.436678805556
STAT,1943,25,40-44,1968,4.693400547274843
SIM,1871,18,15-19,1889,4
SIM,1902,26,na,1928,3215
STAT,1949,14,na,1963,4314.6501533733435
SIM,1949,4,na,1953,4316
STAT,1830,38,20-24,1868,0.603543602159464
SIM,1882,29,30-34,1911,30
SIM,1830,55,na,1885,1341
SIM,1855,25,20-24,1880,13
STAT,1950,17,45-49,1967,0.5580365703724984
STAT,1841,40,50-100,1881,0.7705900961991732
STAT,1887,42,40-44,1929,2.373426426190681
STAT,1925,26,35-39,1951,16.811592255301296
STAT,1841,29,35-39,1870,8.08232480217335
STAT,1914,38,40-44,1952,1.404737807841501
STAT,1879,54,na,1933,2067.6403191046516
STAT,1899,33,20-24,1932,3.4846487264447026
STAT,1835,38,50-100,1873,0.9372569603278135
STAT,1889,48,30-34,1937,0.06288208549699985
STAT,1935,23,40-44,1958,4.323811737073496
STAT,1882,20,45-49,1902,0.6448375528970084
STAT,1887,63,na,1950,1885.1112337315249
STAT,1941,17,na,1958,3581.278309249849
STAT,1951,16,35-39,1967,4.722027481895392
SIM,1818,62,na,1880,870
STAT,1825,33,20-24,1858,4.325165766619678
STAT,1903,20,40-44,1923,2.817418577227778
SIM,1868,31,40-44,1899,3
STAT,1904,39,50-100,1943,0.3554112990234494
SIM,1768,92,na,1860,5
STAT,1934,15,na,1949,4724.993416855313
STAT,1863,18,15-19,1881,5.0872088980204015
STAT,1928,35,50-100,1963,0.5021809097179251
SIM,1897,22,20-24,1919,75
STAT,1848,52,na,1900,1542.934881725186
SIM,1869,30,30-34,1899,25
SIM,1902,26,20-24,1928,18
SIM,1798,67,na,1865,738
STAT,1884,45,na,1929,2121.254972348762
STAT,1839,26,25-29,1865,35.78944786111494
SIM,1835,24,40-44,1859,2
STAT,1782,77,na,1859,290.7351352541283
STAT,1832,47,na,1879,1455.2715781500215
SIM,1851,32,25-29,1883,17
STAT,1899,44,na,1943,2961.9676555777296
STAT,1856,81,na,1937,400.10840708256
STAT,1889,22,20-24,1911,80.37071243074313
STAT,1913,24,15-19,1937,5.0451261292152925
STAT,1920,39,50-100,1959,0.43336618288057627
SIM,1855,18,30-34,1873,1
STAT,1859,39,20-24,1898,0.5753127608183073
SIM,1838,40,45-49,1878,3
SIM,1901,30,25-29,1931,21
SIM,1933,26,35-39,1959,18
STAT,1940,28,40-44,1968,4.4875131219782896
SIM,1838,22,15-19,1860,2
SIM,1932,27,45-49,1959,4
SIM,1838,82,na,1920,272
STAT,1849,39,50-100,1888,0.8869218128341865
STAT,1892,24,20-24,1916,81.01359390900171
STAT,1873,15,20-24,1888,17.20208012302451
STAT,1930,38,25-29,1968,1.2120981931557147
STAT,1824,34,30-34,1858,31.364288909272556
SIM,1834,39,50-100,1873,3
STAT,1881,35,15-19,1916,0.0517074978089513
STAT,1924,27,45-49,1951,1.9004504097815205
STAT,1897,46,15-19,1943,2.8587771522592615E-4
SIM,1905,16,30-34,1921,3
STAT,1843,25,35-39,1868,8.691448671365576
STAT,1815,99,na,1914,0.8105774583610441
SIM,1911,20,40-44,1931,4
STAT,1835,22,25-29,1857,47.47813833249955
STAT,1911,42,na,1953,3347.9336900945495
SIM,1899,34,25-29,1933,18
STAT,1891,25,30-34,1916,29.645131743253046
STAT,1885,39,15-19,1924,0.05231958751789348
STAT,1906,39,45-49,1945,0.5859352445914587
SIM,1853,28,na,1881,1991
STAT,1853,22,40-44,1875,1.8259184850028791
STAT,1868,38,na,1906,2114.4971126919595
SIM,1797,102,na,1899,1
STAT,1862,26,15-19,1888,0.3696122997665851
STAT,1871,39,20-24,1910,0.7146675387074237
STAT,1861,15,50-100,1876,0.044699278828612465
STAT,1884,27,50-100,1911,0.5971782531061082
STAT,1924,31,15-19,1955,0.14172736049044954
SIM,1878,27,na,1905,2407
SIM,1926,20,35-39,1946,11
STAT,1927,24,45-49,1951,1.30154921503076
SIM,1841,36,30-34,1877,5
SIM,1861,22,40-44,1883,1
STAT,1934,21,30-34,1955,36.4998728397527
SIM,1881,15,20-24,1896,14
STAT,1907,38,35-39,1945,2.107639978010788
SIM,1865,29,na,1894,2017
SIM,1920,11,na,1931,4133
SIM,1895,42,40-44,1937,1
STAT,1843,32,25-29,1875,8.883696595070552
STAT,1833,84,na,1917,201.95651140538394
STAT,1892,17,30-34,1909,1.8855583704419945
STAT,1831,30,40-44,1861,3.6474004042314556
SIM,1899,31,50-100,1930,1
SIM,1915,38,35-39,1953,5
SIM,1866,46,na,1912,1994
SIM,1905,23,20-24,1928,89
STAT,1844,48,na,1892,1559.5635509648137
SIM,1902,19,30-34,1921,1
SIM,1942,21,30-34,1963,42
STAT,1847,18,30-34,1865,1.4550876703617959
STAT,1918,20,35-39,1938,9.65067316011585
SIM,1925,35,40-44,1960,1
STAT,1852,35,50-100,1887,0.9575471951292225
STAT,1891,18,40-44,1909,0.213309437322291
SIM,1896,12,na,1908,3296
STAT,1920,49,20-24,1969,0.011473345046793149
STAT,1833,36,30-34,1869,4.099028807410595
STAT,1871,27,na,1898,2235.0827135206587
SIM,1833,26,30-34,1859,28
STAT,1832,67,na,1899,958.5154727305498
SIM,1832,27,40-44,1859,4
SIM,1866,32,20-24,1898,2
SIM,1872,32,45-49,1904,1
STAT,1917,35,40-44,1952,1.4827645690295366
SIM,1851,25,35-39,1876,11
SIM,1838,37,50-100,1875,4
STAT,1845,65,na,1910,1190.3780719622928
STAT,1909,22,35-39,1931,8.265099959141066
SIM,1865,30,na,1895,2040
SIM,1929,27,50-100,1956,1
SIM,1827,76,na,1903,494
STAT,1874,45,na,1919,2193.949029599004
SIM,1897,18,35-39,1915,1
SIM,1909,33,50-100,1942,2
SIM,1931,20,45-49,1951,1
STAT,1793,93,na,1886,6.957283791416392
STAT,1897,38,30-34,1935,6.700072454261955
SIM,1903,21,45-49,1924,4
SIM,1906,22,25-29,1928,91
SIM,1896,26,20-24,1922,16
STAT,1823,53,na,1876,1243.9687103286578
STAT,1838,20,35-39,1858,5.238629916771418
STAT,1901,32,25-29,1933,13.543662076054481
SIM,1835,95,na,1930,5
SIM,1845,31,50-100,1876,5
STAT,1919,43,50-100,1962,0.12007957821854279
SIM,1893,25,40-44,1918,4
SIM,1833,37,35-39,1870,13
STAT,1950,21,15-19,1971,5.968141224269121
SIM,1853,23,45-49,1876,1
SIM,1934,33,40-44,1967,11
SIM,1856,38,35-39,1894,12
STAT,1797,105,na,1902,0.007139146589046762
STAT,1851,34,25-29,1885,7.65699876577667
SIM,1939,22,20-24,1961,98
SIM,1856,24,25-29,1880,47
STAT,1787,76,na,1863,356.4588088851785
SIM,1863,31,40-44,1894,4
STAT,1872,37,15-19,1909,0.053245884938760916
STAT,1897,24,20-24,1921,86.52006105390886
STAT,1899,26,30-34,1925,32.712704081763256
STAT,1900,15,40-44,1915,0.24082456411828623
SIM,1917,22,35-39,1939,9
STAT,1892,28,35-39,1920,11.374567921969735
SIM,1885,42,50-100,1927,2
STAT,1840,34,15-19,1874,0.11831183685084225
SIM,1882,25,30-34,1907,23
SIM,1820,55,na,1875,1145
SIM,1936,21,40-44,1957,2
STAT,1851,48,35-39,1899,0.10137432078173629
STAT,1841,19,40-44,1860,0.15950300328949985
STAT,1952,19,20-24,1971,153.3867874937317
STAT,1850,17,40-44,1867,0.15734777117132398
STAT,1859,24,35-39,1883,4.499329545354948
SIM,1938,26,35-39,1964,12
STAT,1845,23,45-49,1868,0.6053905189688494
STAT,1848,38,35-39,1886,5.196769060999706
STAT,1828,38,15-19,1866,0.05215616024664453
STAT,1916,7,na,1923,3993.2395863858833
STAT,1938,32,20-24,1970,2.3166702828185315
SIM,1937,32,na,1969,3398
SIM,1838,33,20-24,1871,2
SIM,1843,28,na,1871,1843
SIM,1881,77,na,1958,793
SIM,1875,23,30-34,1898,23
STAT,1923,20,45-49,1943,1.244268402605736
SIM,1861,18,20-24,1879,18
SIM,1835,20,25-29,1855,56
SIM,1948,20,20-24,1968,100
STAT,1853,18,20-24,1871,15.722573792340267
STAT,1929,34,20-24,1963,2.9233197777830533
STAT,1910,19,15-19,1929,8.447153532950901
STAT,1834,80,na,1914,382.8841235191089
SIM,1888,39,40-44,1927,3
SIM,1897,62,na,1959,2395
STAT,1787,86,na,1873,68.5505754596639
STAT,1855,31,40-44,1886,3.159984072077699
STAT,1902,27,na,1929,3181.5890467276827
SIM,1879,27,30-34,1906,32
STAT,1861,82,na,1943,366.0230265796366
STAT,1859,78,na,1937,589.0659043350389
STAT,1876,2,na,1878,3178.201449083766
STAT,1848,24,25-29,1872,49.4967418117928
STAT,1857,36,35-39,1893,5.292916826034747
STAT,1944,24,45-49,1968,1.1468625916486217
SIM,1864,23,20-24,1887,62
SIM,1900,20,15-19,1920,4
STAT,1924,38,35-39,1962,2.691931434067804
SIM,1844,68,na,1912,1050
SIM,1900,45,50-100,1945,3
STAT,1816,46,25-29,1862,0.15410489062727614
SIM,1928,22,45-49,1950,1
SIM,1820,65,na,1885,852
STAT,1845,49,20-24,1894,0.008276093132470973
SIM,1937,34,20-24,1971,1
STAT,1766,91,na,1857,16.038295433928
SIM,1932,38,35-39,1970,7
SIM,1849,33,30-34,1882,21
SIM,1900,33,50-100,1933,1
STAT,1895,29,15-19,1924,0.5553267983644765
STAT,1883,37,25-29,1920,2.665753974202776
STAT,1883,23,15-19,1906,3.045019573443972
STAT,1943,29,na,1972,3765.14496827423
SIM,1841,24,15-19,1865,5
STAT,1829,41,40-44,1870,1.9216913571896175
STAT,1874,55,na,1929,1996.4426458957375
SIM,1891,37,25-29,1928,2
STAT,1941,19,45-49,1960,0.48571422150592025
SIM,1792,73,na,1865,422
STAT,1804,73,na,1877,519.5715500697497
STAT,1841,26,30-34,1867,21.55431137169118
SIM,1803,63,na,1866,827
SIM,1865,29,45-49,1894,4
SIM,1948,17,na,1965,3778
STAT,1802,92,na,1894,14.208179687344648
STAT,1869,39,15-19,1908,0.05083298454522449
STAT,1839,38,40-44,1877,3.4519675832797243
SIM,1805,88,na,1893,33
STAT,1831,36,15-19,1867,0.0448681108992201
STAT,1867,23,30-34,1890,15.750683251097865
STAT,1889,39,35-39,1928,8.165928287038929
SIM,1867,35,40-44,1902,4
SIM,1833,25,35-39,1858,8
STAT,1882,74,na,1956,1052.098676369709
SIM,1891,23,15-19,1914,3
STAT,1805,53,50-100,1858,0.04318133370158857
STAT,1865,85,na,1950,235.32928552787013
STAT,1861,27,50-100,1888,0.5054696055074808
STAT,1902,24,40-44,1926,2.760634976721432
STAT,1907,27,45-49,1934,1.540508989235182
STAT,1928,21,40-44,1949,3.9782594551503485
STAT,1825,65,na,1890,955.49487595621
STAT,1929,20,45-49,1949,1.3522783614654836
STAT,1927,39,15-19,1966,0.022509535200353564
SIM,1946,25,30-34,1971,40
SIM,1897,39,35-39,1936,3
STAT,1914,16,30-34,1930,2.3873274622995178
SIM,1852,87,na,1939,107
STAT,1896,46,15-19,1942,2.825100477037375E-4
STAT,1922,20,50-100,1942,0.7171423612072031
STAT,1884,7,na,1891,2432.203479180448
STAT,1857,29,45-49,1886,0.8395321890130228
SIM,1884,20,20-24,1904,62
SIM,1915,27,45-49,1942,2
STAT,1896,32,40-44,1928,5.414530232902847
SIM,1803,76,na,1879,327
SIM,1922,16,30-34,1938,16
STAT,1825,37,35-39,1862,9.057377160392647
STAT,1856,30,45-49,1886,1.3334471654438136
STAT,1889,25,25-29,1914,49.669667514643926
SIM,1865,20,na,1885,2055
STAT,1947,25,25-29,1972,70.41146413328883
STAT,1926,33,40-44,1959,4.4679366204016135
STAT,1827,46,na,1873,1420.0686426005227
STAT,1888,26,20-24,1914,13.137348511167966
STAT,1839,45,30-34,1884,0.06746833021583185
STAT,1833,24,15-19,1857,2.6936711774322766
STAT,1856,19,35-39,1875,0.474414275339003
SIM,1769,87,na,1856,28
SIM,1846,20,35-39,1866,6
STAT,1867,30,20-24,1897,2.4168867733244697
STAT,1808,86,na,1894,86.2400094295273
SIM,1929,28,35-39,1957,22
SIM,1854,78,na,1932,536
STAT,1877,26,45-49,1903,1.0921842715604597
SIM,1862,97,na,1959,6
STAT,1889,18,35-39,1907,0.6382674589538898
STAT,1912,37,na,1949,3468.075873635026
STAT,1906,21,20-24,1927,95.08285032202316
STAT,1933,6,na,1939,5068.680836552903
STAT,1842,13,na,1855,2173.08918
SIM,1926,27,20-24,1953,22
STAT,1890,62,na,1952,2111.078839982495
STAT,1938,25,30-34,1963,36.6990955038831
STAT,1817,46,na,1863,1301.8149328452137
SIM,1847,38,40-44,1885,9
STAT,1953,18,25-29,1971,49.507874314322706
STAT,1869,42,50-100,1911,0.9648691003980814
STAT,1891,29,30-34,1920,29.23491318670354
STAT,1910,37,45-49,1947,0.6157516124769997
STAT,1892,74,na,1966,1621.7490470658222
SIM,1909,16,15-19,1925,8
SIM,1879,34,20-24,1913,3
STAT,1892,16,35-39,1908,0.6507209066342431
SIM,1852,97,na,1949,3
STAT,1873,22,45-49,1895,0.6686674628895699
STAT,1888,58,na,1946,2207.01887218403
STAT,1863,102,na,1965,1.170254085218018
SIM,1914,21,20-24,1935,109
SIM,1885,26,45-49,1911,1
STAT,1810,44,30-34,1854,4.251896069577761
STAT,1910,56,na,1966,3116.4984303114315
SIM,1870,38,50-100,1908,4
SIM,1914,17,35-39,1931,2
STAT,1861,24,40-44,1885,1.6553608497913104
SIM,1926,0,na,1926,4747
STAT,1935,27,20-24,1962,23.505137804687017
STAT,1898,48,25-29,1946,0.041028532375979906
SIM,1835,28,20-24,1863,11
SIM,1887,21,35-39,1908,8
SIM,1923,26,40-44,1949,4
STAT,1776,91,na,1867,14.772777693216936
STAT,1937,1,na,1938,3837.4204568711975
SIM,1885,19,20-24,1904,22
SIM,1856,46,na,1902,1802
SIM,1944,18,25-29,1962,48
STAT,1887,48,15-19,1935,4.1728829189358713E-4
SIM,1889,37,35-39,1926,13
STAT,1918,27,20-24,1945,18.351386200366775
STAT,1806,51,na,1857,1155.051242013073
SIM,1867,11,na,1878,2350
SIM,1938,33,25-29,1971,13
SIM,1864,30,45-49,1894,1
STAT,1921,37,20-24,1958,0.2780861110775292
STAT,1841,38,30-34,1879,4.251857477334549
SIM,1855,30,na,1885,1970
SIM,1910,24,40-44,1934,2
STAT,1865,28,40-44,1893,2.5624745835749327
STAT,1865,25,50-100,1890,0.5528661768890072
SIM,1918,32,45-49,1950,1
SIM,1860,26,40-44,1886,5
STAT,1833,53,na,1886,1320.5717690432768
SIM,1841,27,35-39,1868,9
STAT,1936,18,25-29,1954,39.084676198666564
STAT,1907,26,50-100,1933,0.8905979515555791
SIM,1889,23,25-29,1912,70
STAT,1833,27,35-39,1860,7.768160453922819
STAT,1898,37,35-39,1935,9.04504247536681
STAT,1911,22,40-44,1933,3.011809275982418
STAT,1915,45,50-100,1960,0.2163006020162307
STAT,1854,30,50-100,1884,0.6898361650356246
STAT,1894,19,20-24,1913,21.428534158382078
STAT,1902,37,na,1939,3165.65035470261
STAT,1851,15,35-39,1866,0.4950316023626181
STAT,1893,59,na,1952,2329.4672539275057
STAT,1826,36,40-44,1862,4.882650867863336
STAT,1814,52,50-100,1866,0.039189948191001744
STAT,1906,17,35-39,1923,0.7548092684932053
STAT,1851,82,na,1933,342.15256529161707
STAT,1905,55,na,1960,2914.420561089439
SIM,1854,68,na,1922,1119
STAT,1827,28,20-24,1855,21.15538453081729
STAT,1856,26,na,1882,1842.9789400860645
STAT,1856,37,30-34,1893,3.943322567796662
SIM,1896,33,45-49,1929,4
STAT,1831,29,25-29,1860,35.510050365057566
STAT,1850,53,35-39,1903,0.005963485011181179
SIM,1934,29,20-24,1963,24
SIM,1829,42,45-49,1871,1
SIM,1943,27,20-24,1970,19
SIM,1897,25,25-29,1922,54
SIM,1880,34,45-49,1914,1
SIM,1902,22,40-44,1924,2
STAT,1925,23,30-34,1948,32.40393914963437
STAT,1898,34,15-19,1932,0.18055557496943375
STAT,1882,33,na,1915,2184.359540074146
SIM,1774,88,na,1862,30
SIM,1891,77,na,1968,1400
STAT,1862,15,45-49,1877,0.0610043932548902
STAT,1879,21,35-39,1900,5.779536635050251
STAT,1888,33,45-49,1921,1.9379106354075624
STAT,1915,26,40-44,1941,4.506218335903524
STAT,1863,41,50-100,1904,0.8812615360742957
STAT,1842,18,45-49,1860,0.05938207980731004
STAT,1893,27,40-44,1920,3.5905308661586073
STAT,1830,35,na,1865,1643.3997375204608
STAT,1856,23,20-24,1879,58.79253989512015
STAT,1882,16,25-29,1898,5.221934263324225
SIM,1892,15,30-34,1907,1
STAT,1956,16,35-39,1972,5.246242150807031
SIM,1850,29,35-39,1879,11
STAT,1872,34,45-49,1906,1.639339648606084
STAT,1926,29,20-24,1955,20.526608977294728
SIM,1925,29,50-100,1954,1
STAT,1874,24,50-100,1898,0.3912696516455398
STAT,1930,16,15-19,1946,55.567548574159744
STAT,1882,43,50-100,1925,0.9641281482872991
STAT,1842,29,35-39,1871,8.375590165402262
STAT,1854,19,50-100,1873,0.041706151092920016
STAT,1851,27,35-39,1878,8.284682420691507
STAT,1857,44,20-24,1901,0.11667962307642067
STAT,1842,36,25-29,1878,2.4302760617822945
SIM,1887,62,na,1949,1872
SIM,1917,22,na,1939,3633
SIM,1952,17,20-24,1969,132
SIM,1929,35,25-29,1964,1
SIM,1895,20,30-34,1915,25
SIM,1848,22,25-29,1870,54
STAT,1901,42,na,1943,3062.901072185616
STAT,1833,39,35-39,1872,5.271532833495057
STAT,1853,25,45-49,1878,0.9677298367815372
STAT,1927,28,25-29,1955,75.33521011303974
STAT,1838,83,na,1921,270.7547845677785
STAT,1871,37,50-100,1908,1.1498344461630594
STAT,1852,26,40-44,1878,2.6700597772562342
SIM,1929,21,15-19,1950,5
STAT,1867,26,35-39,1893,8.587975051456317
SIM,1844,25,45-49,1869,4
STAT,1944,17,20-24,1961,137.82753104033188
SIM,1844,49,50-100,1893,2
SIM,1875,30,na,1905,2311
STAT,1889,36,50-100,1925,1.438773740655126
STAT,1917,24,35-39,1941,9.394312436530132
SIM,1907,26,50-100,1933,4
SIM,1824,39,35-39,1863,11
STAT,1951,20,20-24,1971,125.59513502342557
STAT,1816,39,35-39,1855,24.470986415160088
STAT,1847,32,45-49,1879,1.5065048804739958
SIM,1899,24,30-34,1923,28
SIM,1821,49,50-100,1870,1
SIM,1855,32,45-49,1887,1
STAT,1821,49,50-100,1870,0.36421133459181265
SIM,1825,47,50-100,1872,2
STAT,1897,17,30-34,1914,2.0137191483517602
STAT,1892,46,30-34,1938,0.06477942904344884
STAT,1887,20,30-34,1907,18.930897773857644
SIM,1935,28,25-29,1963,77
STAT,1836,25,45-49,1861,0.9204233334337912
SIM,1947,23,25-29,1970,105
SIM,1899,31,20-24,1930,4
SIM,1937,27,30-34,1964,35
STAT,1885,38,50-100,1923,1.149794738617318
STAT,1887,27,15-19,1914,0.4793351559130268
SIM,1850,36,25-29,1886,1
STAT,1851,72,na,1923,926.1015917882276
STAT,1926,28,50-100,1954,1.1233636499403539
SIM,1874,36,50-100,1910,2
SIM,1937,22,na,1959,3209
SIM,1925,24,35-39,1949,13
STAT,1880,39,15-19,1919,0.05525576707832367
STAT,1842,22,15-19,1864,2.963129837119628
STAT,1866,49,40-44,1915,0.1459999501953989
STAT,1835,65,na,1900,1054.417925669747
STAT,1912,28,15-19,1940,0.6547461149493721
STAT,1873,60,na,1933,1828.8104702107207
STAT,1843,24,50-100,1867,0.3640005711956755
SIM,1850,22,15-19,1872,2
SIM,1839,39,45-49,1878,1
SIM,1838,26,30-34,1864,28
SIM,1918,28,25-29,1946,78
SIM,1833,83,na,1916,231
SIM,1876,29,20-24,1905,11
STAT,1901,39,45-49,1940,0.5632229042341106
STAT,1901,25,35-39,1926,12.845211084105891
SIM,1861,25,45-49,1886,4
SIM,1848,36,35-39,1884,8
STAT,1813,48,15-19,1861,0.0011895931450604425
STAT,1861,27,na,1888,1885.773509189295
STAT,1929,27,30-34,1956,46.32868359033827
SIM,1841,39,35-39,1880,11
STAT,1844,20,25-29,1864,50.904382464677234
SIM,1882,28,35-39,1910,11
SIM,1931,37,na,1968,4694
SIM,1857,35,30-34,1892,9
STAT,1888,15,15-19,1903,6.65379044347531
STAT,1930,22,na,1952,4419.694913589379
STAT,1936,22,45-49,1958,1.016044501995174
SIM,1793,68,na,1861,638
SIM,1907,33,30-34,1940,21
STAT,1850,32,50-100,1882,0.6747754363630529
SIM,1913,36,25-29,1949,1
STAT,1908,45,40-44,1953,0.1366479078509548
STAT,1816,43,20-24,1859,0.45531169823095885
STAT,1921,38,50-100,1959,0.4424646435025629
STAT,1901,44,50-100,1945,0.09569646497841537
SIM,1877,21,40-44,1898,5
STAT,1817,49,45-49,1866,0.511589965303084
STAT,1939,23,25-29,1962,87.5957844480479
STAT,1903,28,50-100,1931,0.8567413329271345
STAT,1929,23,15-19,1952,6.340023687879615
STAT,1851,27,na,1878,1857.409232002151
SIM,1864,37,30-34,1901,5
STAT,1891,25,15-19,1916,0.5341166355021115
SIM,1911,28,50-100,1939,1
STAT,1870,96,na,1966,30.901535899000386
STAT,1855,20,35-39,1875,4.898342372272106
STAT,1898,58,na,1956,2549.8987814019065
SIM,1811,51,na,1862,1236
SIM,1883,28,35-39,1911,13
STAT,1865,20,45-49,1885,0.6146839111142062
STAT,1867,37,40-44,1904,3.882847103251956
STAT,1900,56,na,1956,2693.4745068076168
STAT,1834,34,25-29,1868,7.954264598907578
STAT,1843,46,35-39,1889,0.10182915477715744
STAT,1843,94,na,1937,14.419063440609028
STAT,1883,34,20-24,1917,2.481246302747506
STAT,1939,14,na,1953,3726.129394066903
STAT,1886,27,15-19,1913,0.452851462792577
SIM,1842,34,25-29,1876,13
SIM,1880,82,na,1962,692
STAT,1877,23,40-44,1900,2.0364809518682017
SIM,1779,87,na,1866,55
STAT,1847,47,30-34,1894,0.07089229474226523
STAT,1916,36,35-39,1952,2.3511305485584306
STAT,1824,34,15-19,1858,0.2558183116091116
SIM,1809,47,na,1856,1308
SIM,1865,37,30-34,1902,8
SIM,1836,49,na,1885,1436
SIM,1875,37,40-44,1912,5
STAT,1865,41,na,1906,1993.0492888466817
STAT,1926,36,45-49,1962,0.7878793602565625
SIM,1833,22,15-19,1855,3
STAT,1819,36,15-19,1855,0.1635166907785123
STAT,1874,28,35-39,1902,9.283551122424804
STAT,1924,15,na,1939,4160.389200796924
SIM,1852,20,25-29,1872,59
SIM,1785,94,na,1879,2
STAT,1908,22,na,1930,3313.506157367678
STAT,1850,28,30-34,1878,20.712656487396615
STAT,1900,18,45-49,1918,0.08538669003927457
SIM,1911,23,45-49,1934,1
SIM,1864,26,25-29,1890,42
SIM,1866,56,na,1922,1778
SIM,1904,24,15-19,1928,5
SIM,1914,24,25-29,1938,98
SIM,1909,37,na,1946,3357
STAT,1843,53,na,1896,1528.4726956618852
STAT,1905,36,25-29,1941,0.8524583143740794
SIM,1851,16,na,1867,2094
STAT,1911,18,20-24,1929,25.55659596978045
SIM,1826,50,na,1876,1361
STAT,1866,24,50-100,1890,0.35295748001905647
STAT,1847,97,na,1944,3.952835170110955
STAT,1864,32,45-49,1896,1.4723278470645782
STAT,1881,21,40-44,1902,1.9064721633141122
STAT,1889,36,30-34,1925,6.245654049649358
STAT,1879,36,20-24,1915,0.7648244302089393
STAT,1933,21,15-19,1954,6.6906213964243495
SIM,1888,24,20-24,1912,73
STAT,1806,49,35-39,1855,0.40048694151279296
STAT,1892,39,40-44,1931,5.1264950748411895
SIM,1866,15,na,1881,2321
STAT,1951,17,na,1968,4140.890543107947
SIM,1905,6,na,1911,3565
SIM,1770,95,na,1865,1
SIM,1891,27,30-34,1918,44
STAT,1883,5,na,1888,2450.6348094788927
SIM,1863,20,35-39,1883,5
SIM,1929,25,30-34,1954,55
SIM,1872,28,25-29,1900,40
SIM,1873,20,45-49,1893,1
SIM,1941,21,15-19,1962,6
STAT,1909,48,na,1957,3179.420211090595
STAT,1875,28,35-39,1903,9.331688355845877
STAT,1886,26,na,1912,2390.221040554273
SIM,1919,20,45-49,1939,2
STAT,1825,48,40-44,1873,0.17705750316608732
STAT,1828,49,20-24,1877,0.009844033866870957
SIM,1847,42,na,1889,1635
STAT,1938,28,35-39,1966,14.042988036881527
STAT,1892,33,na,1925,2811.1090160148037
SIM,1834,36,40-44,1870,10
SIM,1909,20,35-39,1929,8
STAT,1846,26,15-19,1872,0.38979034412144703
SIM,1844,22,40-44,1866,1
STAT,1856,26,25-29,1882,32.66703064046019
SIM,1890,27,30-34,1917,34
SIM,1880,27,20-24,1907,13
STAT,1941,22,50-100,1963,0.6423274228191007
STAT,1940,9,na,1949,3802.3628541777953
SIM,1904,38,na,1942,3150
STAT,1903,23,45-49,1926,0.9343272238271769
SIM,1849,36,35-39,1885,10
STAT,1889,29,40-44,1918,3.468672600626929
STAT,1906,24,25-29,1930,78.25460843524705
STAT,1879,29,30-34,1908,24.68769789212855
SIM,1948,23,25-29,1971,94
SIM,1824,36,30-34,1860,6
SIM,1922,5,na,1927,4409
STAT,1883,59,na,1942,1799.3895377948327
STAT,1862,67,na,1929,1277.4285011101213
STAT,1866,16,40-44,1882,0.16448405393413773
STAT,1943,29,20-24,1972,18.346481893324714
SIM,1926,16,15-19,1942,50
STAT,1810,47,35-39,1857,0.49776879291442994
STAT,1838,35,20-24,1873,0.6477091106592241
STAT,1856,16,30-34,1872,1.402700556504363
STAT,1915,55,na,1970,3387.124236069188
SIM,1891,34,20-24,1925,2
SIM,1893,48,na,1941,2752
STAT,1914,30,45-49,1944,1.508121394991073
STAT,1848,35,30-34,1883,4.039765626758098
STAT,1810,54,50-100,1864,0.049243713258808185
STAT,1854,49,15-19,1903,2.820234460273616E-4
STAT,1875,35,50-100,1910,1.2028875284764153
SIM,1840,39,35-39,1879,14
STAT,1857,33,15-19,1890,0.10561065994307903
SIM,1859,22,35-39,1881,5
STAT,1890,52,na,1942,2473.7952426299003
SIM,1898,36,30-34,1934,5
STAT,1832,39,35-39,1871,5.3062670753572
SIM,1849,23,na,1872,1881
SIM,1861,57,na,1918,1730
SIM,1933,23,30-34,1956,2
SIM,1885,23,40-44,1908,3
SIM,1883,48,na,1931,2094
STAT,1875,85,na,1960,388.4852321276729
SIM,1896,15,15-19,1911,4
SIM,1897,29,40-44,1926,4
SIM,1887,29,30-34,1916,23
STAT,1882,27,30-34,1909,23.14846311168931
STAT,1941,16,40-44,1957,1.3612929714567998
SIM,1898,47,na,1945,2846
STAT,1918,49,15-19,1967,3.681439576884856E-4
STAT,1931,26,25-29,1957,80.31499598783029
SIM,1822,36,na,1858,1578
SIM,1934,36,45-49,1970,1
STAT,1896,44,50-100,1940,0.0903586914421794
SIM,1842,27,35-39,1869,10
STAT,1839,48,35-39,1887,0.09389889068831217
STAT,1851,45,30-34,1896,0.07169272144566746
SIM,1944,22,45-49,1966,1
STAT,1817,91,na,1908,25.697725058050324
STAT,1916,43,25-29,1959,0.06901981694107712
STAT,1812,108,na,1920,7.878212632773916E-4
SIM,1906,8,na,1914,3658
SIM,1933,30,20-24,1963,3
STAT,1834,27,35-39,1861,7.8317480759829605
STAT,1799,64,na,1863,847.2997071230019
STAT,1839,30,45-49,1869,1.4609022310347088
STAT,1829,27,na,1856,1732.0315816346663
SIM,1924,36,35-39,1960,9
STAT,1829,30,35-39,1859,10.42694670197379
SIM,1856,35,30-34,1891,4
STAT,1880,18,15-19,1898,5.883478904291916
STAT,1896,21,35-39,1917,7.307781245450775
STAT,1947,22,20-24,1969,118.7270425702691
STAT,1864,102,na,1966,1.3525528237374669
SIM,1905,38,40-44,1943,2
STAT,1925,30,20-24,1955,2.7397347579383866
STAT,1860,86,na,1946,170.34758643441472
STAT,1888,2,na,1890,2974.903562275818
SIM,1879,37,25-29,1916,2
STAT,1915,29,45-49,1944,1.6526170951623356
STAT,1839,27,na,1866,1817.1106795588782
STAT,1864,25,20-24,1889,10.010859893521657
SIM,1810,55,na,1865,1149
SIM,1846,28,30-34,1874,29
STAT,1898,45,20-24,1943,0.008742679397296099
SIM,1867,31,25-29,1898,14
STAT,1884,47,35-39,1931,0.13008625151246894
STAT,1873,44,50-100,1917,0.9993663673132536
SIM,1780,95,na,1875,3
STAT,1844,24,40-44,1868,1.8003333153784145
STAT,1929,14,na,1943,4761.8273752150035
STAT,1824,38,30-34,1862,7.618259313586151
SIM,1934,18,15-19,1952,49
STAT,1876,26,na,1902,2335.456935153261
STAT,1888,30,40-44,1918,4.878722812065853
SIM,1900,24,30-34,1924,28
STAT,1864,45,na,1909,1918.502628453364
SIM,1903,17,25-29,1920,11
STAT,1769,98,na,1867,0.47253054702953423
STAT,1880,29,20-24,1909,11.577700420546577
STAT,1857,47,25-29,1904,0.04269765331777697
SIM,1861,16,na,1877,2302
SIM,1832,38,30-34,1870,3
STAT,1851,38,40-44,1889,3.2109557611516153
STAT,1901,36,40-44,1937,1.2553701328640758
SIM,1850,26,30-34,1876,25
SIM,1847,30,45-49,1877,2
STAT,1840,20,40-44,1860,1.8722831823650607
SIM,1854,44,45-49,1898,1
STAT,1929,41,45-49,1970,0.20391745505092856
SIM,1831,27,25-29,1858,45
SIM,1852,24,40-44,1876,1
STAT,1871,16,15-19,1887,5.62700310137023
SIM,1910,45,na,1955,3170
STAT,1848,17,35-39,1865,0.49003658305486425
STAT,1904,26,15-19,1930,0.6167961296343603
STAT,1907,26,na,1933,3322.585583945476
SIM,1881,44,50-100,1925,4
STAT,1856,71,na,1927,987.6109514909417
STAT,1917,9,na,1926,4033.50182995227
STAT,1926,18,15-19,1944,52.433144336514616
SIM,1896,30,40-44,1926,5
STAT,1824,80,na,1904,326.5802929152256
SIM,1923,29,45-49,1952,2
STAT,1890,8,na,1898,3002.5461278871944
STAT,1903,49,20-24,1952,0.008907804949523788
STAT,1819,54,50-100,1873,0.024785725534938893
STAT,1879,46,15-19,1925,3.9609390037210394E-4
STAT,1906,41,na,1947,3204.777984571042
STAT,1841,15,25-29,1856,5.059906933916773
STAT,1887,73,na,1960,1405.975444992501
STAT,1846,37,20-24,1883,0.5675711822014
SIM,1886,33,35-39,1919,15
STAT,1797,86,na,1883,72.30314554842826
SIM,1882,63,na,1945,1601
STAT,1863,18,50-100,1881,0.041996762811727005
SIM,1830,65,na,1895,1065
SIM,1819,42,35-39,1861,3
STAT,1905,42,50-100,1947,0.10002748444203687
STAT,1849,78,na,1927,563.1774481162304
SIM,1860,31,na,1891,1992
SIM,1922,23,20-24,1945,137
SIM,1939,21,25-29,1960,97
SIM,1823,36,30-34,1859,2
STAT,1918,16,15-19,1934,9.38515040104459
STAT,1861,27,45-49,1888,0.8773349365214879
STAT,1878,33,35-39,1911,9.917459594291264
STAT,1868,29,20-24,1897,10.50587167646778
STAT,1890,18,25-29,1908,6.528075949031365
SIM,1837,41,40-44,1878,5
SIM,1897,36,30-34,1933,4
STAT,1872,16,15-19,1888,5.679114530257913
SIM,1880,16,15-19,1896,5
SIM,1944,15,20-24,1959,115
SIM,1885,81,na,1966,758
STAT,1950,21,50-100,1971,0.7377184068405699
STAT,1883,27,30-34,1910,23.315092776925248
STAT,1838,28,30-34,1866,21.690585054229185
STAT,1850,24,15-19,1874,2.747724669553649
STAT,1936,15,20-24,1951,123.16841283885276
STAT,1836,22,40-44,1858,1.736660289543314
STAT,1892,49,35-39,1941,0.09147338678010396
SIM,1853,31,50-100,1884,4
STAT,1852,15,35-39,1867,0.5102101084624044
SIM,1940,11,na,1951,3626
STAT,1914,23,20-24,1937,106.96883124421133
SIM,1838,29,35-39,1867,6
SIM,1843,83,na,1926,272
SIM,1926,34,45-49,1960,1
SIM,1918,25,20-24,1943,25
STAT,1917,21,30-34,1938,28.94306379334655
STAT,1913,38,25-29,1951,0.9131681769609121
STAT,1816,61,na,1877,1056.8630262984989
SIM,1845,32,35-39,1877,13
STAT,1893,16,35-39,1909,0.6593068685775425
STAT,1854,0,na,1854,2898.59856188208
STAT,1945,21,na,1966,3782.204072408106
STAT,1849,42,20-24,1891,0.11433004434713856
SIM,1856,7,na,1863,2312
STAT,1842,33,20-24,1875,2.3012849144397918
SIM,1901,19,15-19,1920,8
SIM,1929,32,20-24,1961,3
STAT,1934,35,40-44,1969,1.954883113285382
SIM,1878,42,40-44,1920,4
STAT,1843,39,45-49,1882,1.4964733150374447
SIM,1872,18,30-34,1890,1
SIM,1834,25,35-39,1859,11
SIM,1899,20,15-19,1919,4
STAT,1842,26,30-34,1868,22.33640478024467
SIM,1874,34,na,1908,2259
SIM,1850,33,20-24,1883,2
SIM,1888,31,45-49,1919,1
STAT,1866,26,na,1892,2085.768902480132
STAT,1837,32,35-39,1869,8.01542892225122
STAT,1923,28,40-44,1951,5.038070750248996
STAT,1867,8,na,1875,2446.9600191320005
STAT,1864,18,30-34,1882,1.3839190839551723
SIM,1931,28,40-44,1959,6
STAT,1782,87,na,1869,49.747663184971955
SIM,1937,23,15-19,1960,4
STAT,1865,39,30-34,1904,4.5291016823527
SIM,1872,25,20-24,1897,7
SIM,1895,38,20-24,1933,1
STAT,1897,27,25-29,1924,53.44426514452139
STAT,1849,35,30-34,1884,4.013369402879563
STAT,1823,34,15-19,1857,0.28308148314141107
STAT,1948,22,20-24,1970,120.62050212388107
SIM,1896,22,na,1918,2988
STAT,1918,34,45-49,1952,1.5660989893625799
STAT,1885,25,40-44,1910,2.838490398157777
STAT,1854,28,15-19,1882,0.34003797128012914
SIM,1874,26,35-39,1900,6
SIM,1846,49,na,1895,1544
SIM,1925,21,30-34,1946,44
SIM,1867,24,35-39,1891,4
SIM,1873,39,30-34,1912,9
STAT,1859,31,25-29,1890,7.753708402743902
STAT,1852,22,25-29,1874,51.66840059745899
STAT,1875,35,25-29,1910,2.8209088088266587
STAT,1879,44,na,1923,2251.3869765058002
STAT,1940,20,45-49,1960,1.0834519411129224
STAT,1894,11,na,1905,3143.00048757868
STAT,1903,16,20-24,1919,23.886253545316215
SIM,1858,82,na,1940,323
STAT,1907,31,15-19,1938,0.11391750576879282
SIM,1860,22,25-29,1882,57
SIM,1911,16,20-24,1927,26
STAT,1869,21,40-44,1890,1.9112643782500573
SIM,1848,26,40-44,1874,2
STAT,1839,45,15-19,1884,2.787945180388427E-4
STAT,1833,24,30-34,1857,14.543826676770404
STAT,1845,26,15-19,1871,0.3917985147244069
STAT,1911,25,45-49,1936,1.60205223392016
SIM,1841,24,30-34,1865,23
SIM,1927,22,na,1949,4169
STAT,1850,50,30-34,1900,0.0042508294446707865
SIM,1838,36,25-29,1874,5
STAT,1903,23,na,1926,3168.881309357445
SIM,1826,34,40-44,1860,6
STAT,1848,93,na,1941,21.054661382818267
STAT,1890,25,15-19,1915,0.5275939403255525
STAT,1933,17,45-49,1950,0.6317293772488926
SIM,1870,31,na,1901,2211
STAT,1942,26,35-39,1968,14.892019358048358
STAT,1841,72,na,1913,864.0620582917185
STAT,1868,39,15-19,1907,0.05014035406197321
SIM,1851,39,45-49,1890,1
STAT,1860,16,45-49,1876,0.058184017452237696
STAT,1810,69,na,1879,750.2236014691804
STAT,1841,35,20-24,1876,0.634430314704665
STAT,1925,45,na,1970,4225.859348257976
SIM,1889,29,35-39,1918,14
SIM,1901,63,na,1964,2529
SIM,1859,67,na,1926,1316
SIM,1867,86,na,1953,158
STAT,1815,43,25-29,1858,1.7251930069951151
STAT,1910,48,15-19,1958,3.236836167419842E-4
STAT,1849,39,40-44,1888,3.162309601939355
SIM,1954,17,15-19,1971,60
STAT,1861,34,35-39,1895,7.876429735698459
SIM,1863,72,na,1935,1015
STAT,1847,14,na,1861,2172.427065688249
STAT,1877,41,35-39,1918,1.7832037231566162
STAT,1855,45,20-24,1900,0.008583571631529723
SIM,1892,7,na,1899,3150
STAT,1814,59,na,1873,1022.2990522271169
STAT,1865,27,50-100,1892,0.5491406265667488
STAT,1886,47,45-49,1933,0.2344591196249692
STAT,1864,35,15-19,1899,0.04786217750720754
STAT,1921,31,na,1952,3992.65551115668
SIM,1866,24,35-39,1890,5
STAT,1835,24,40-44,1859,1.7035323761124521
SIM,1843,24,40-44,1867,2
SIM,1907,22,25-29,1929,93
SIM,1892,61,na,1953,2226
STAT,1872,32,45-49,1904,1.6534962231933727
STAT,1890,44,50-100,1934,1.2037596485140696
STAT,1832,40,20-24,1872,0.12090755606466011
STAT,1845,26,20-24,1871,10.130790085216537
SIM,1880,32,45-49,1912,1
STAT,1946,17,15-19,1963,47.553768053660434
SIM,1848,44,40-44,1892,6
SIM,1857,39,40-44,1896,3
STAT,1885,18,45-49,1903,0.06131911527845664
SIM,1862,19,25-29,1881,9
STAT,1856,50,na,1906,1616.009577760348
STAT,1798,71,na,1869,600.173471475384
SIM,1885,41,35-39,1926,8
STAT,1853,20,50-100,1873,0.3625095750606978
STAT,1839,70,na,1909,935.5307406225417
STAT,1882,34,25-29,1916,9.334902871374718
SIM,1839,35,30-34,1874,4
STAT,1936,31,40-44,1967,3.5922887319939516
STAT,1877,52,45-49,1929,0.01415102949783729
STAT,1850,44,30-34,1894,0.7984441367503124
STAT,1945,24,45-49,1969,1.1641760285792158
STAT,1882,23,15-19,1905,3.0232572499132684
STAT,1884,31,25-29,1915,9.600953854539686
SIM,1848,33,30-34,1881,16
SIM,1922,33,na,1955,4022
STAT,1946,15,na,1961,3858.8362431220307
SIM,1933,29,50-100,1962,1
STAT,1892,41,30-34,1933,1.3662192957462127
STAT,1872,13,na,1885,2484.306912785217
STAT,1896,49,25-29,1945,0.039719311970434296
SIM,1909,30,35-39,1939,10
STAT,1912,27,50-100,1939,0.9264123082373257
STAT,1861,42,40-44,1903,1.7623320044325295
STAT,1824,38,25-29,1862,4.115611330724577
STAT,1875,44,35-39,1919,1.7337411661238766
SIM,1890,34,25-29,1924,19
STAT,1858,24,35-39,1882,4.4539505769419465
STAT,1856,16,25-29,1872,4.987060372803973
STAT,1817,40,25-29,1857,1.7579675098179735
STAT,1826,46,35-39,1872,0.13266858477043028
STAT,1926,15,50-100,1941,0.4360081562773491
STAT,1836,53,40-44,1889,0.006594715988749572
STAT,1810,45,na,1855,1360.308170422555
STAT,1852,41,30-34,1893,0.8774384497386466
STAT,1823,95,na,1918,6.996618798301914
SIM,1888,56,na,1944,2223
STAT,1833,27,40-44,1860,2.4116689400098266
SIM,1854,36,na,1890,1845
SIM,1857,37,45-49,1894,1
STAT,1866,35,25-29,1901,2.531565568066307
SIM,1821,41,na,1862,1467
SIM,1883,44,35-39,1927,4
STAT,1808,53,35-39,1861,0.030690364268166768
SIM,1841,27,40-44,1868,8
SIM,1874,35,25-29,1909,2
SIM,1891,32,20-24,1923,3
STAT,1893,37,35-39,1930,8.477716948103
SIM,1815,39,50-100,1854,3
STAT,1820,41,40-44,1861,4.185320025313838
STAT,1851,23,40-44,1874,1.8117366808435094
STAT,1874,28,40-44,1902,2.8821304641872056
STAT,1893,40,35-39,1933,2.192371227590889
SIM,1890,23,15-19,1913,2
SIM,1836,29,25-29,1865,36
STAT,1844,57,na,1901,1410.779410965694
SIM,1809,92,na,1901,17
STAT,1832,48,30-34,1880,0.06850361808168176
STAT,1879,37,30-34,1916,5.2625960828428475
STAT,1831,28,15-19,1859,0.38855486750184004
STAT,1880,39,20-24,1919,0.7585108890061718
STAT,1869,47,15-19,1916,3.6406915051445004E-4
STAT,1838,45,15-19,1883,2.879558645915775E-4
SIM,1855,29,35-39,1884,13
STAT,1843,30,25-29,1873,9.07011735742895
STAT,1889,77,na,1966,1351.3367875986853
SIM,1806,52,na,1858,1153
STAT,1883,32,20-24,1915,2.5026731915463887
SIM,1855,23,20-24,1878,57
STAT,1834,26,45-49,1860,0.9077174139644488
STAT,1841,33,25-29,1874,8.414846221113333
STAT,1871,79,na,1950,654.7424453890279
SIM,1935,20,35-39,1955,13
STAT,1833,47,35-39,1880,0.09978666157480381
SIM,1943,19,na,1962,3630
SIM,1869,77,na,1946,737
STAT,1919,34,45-49,1953,1.5900794283038917
STAT,1931,39,45-49,1970,0.8511174191591973
SIM,1838,26,25-29,1864,37
STAT,1849,54,35-39,1903,0.006034688400880263
SIM,1872,38,25-29,1910,1
STAT,1927,36,na,1963,4423.362873802652
STAT,1853,20,40-44,1873,1.852423793789306
STAT,1864,38,25-29,1902,2.4188797195434737
STAT,1847,29,35-39,1876,8.411225185482206
STAT,1889,21,na,1910,2766.617498370214
STAT,1831,31,15-19,1862,0.11830426041416003
STAT,1813,48,20-24,1861,0.035687825744013114
STAT,1841,22,15-19,1863,2.8593779425287367
STAT,1899,25,35-39,1924,12.576380081851323
STAT,1877,44,na,1921,2235.164239508238
STAT,1904,20,40-44,1924,2.840037148028395
SIM,1872,26,30-34,1898,23
SIM,1908,31,30-34,1939,14
STAT,1896,18,20-24,1914,22.076649723176736
STAT,1897,72,na,1969,1950.4774288957035
STAT,1881,89,na,1970,283.22756129674843
STAT,1864,26,30-34,1890,21.334312352264067
SIM,1882,28,40-44,1910,3
STAT,1845,46,45-49,1891,0.16670596701047846
STAT,1870,35,45-49,1905,1.862834956832982
STAT,1882,36,20-24,1918,0.7120134383683188
STAT,1836,23,45-49,1859,0.5769798100938865
STAT,1887,43,15-19,1930,0.014484641791709194
STAT,1898,26,30-34,1924,32.3138048463809
STAT,1828,29,25-29,1857,53.45216366757732
STAT,1866,51,30-34,1917,0.005209411703657854
STAT,1823,104,na,1927,0.03510010264883314
SIM,1853,26,20-24,1879,12
STAT,1881,35,20-24,1916,0.7098028351639379
SIM,1874,22,50-100,1896,1
STAT,1821,40,45-49,1861,2.652760640314956
SIM,1912,20,40-44,1932,6
STAT,1920,49,40-44,1969,0.1636863829730187
STAT,1847,23,20-24,1870,61.71312364120115
STAT,1880,26,15-19,1906,0.45252725233838087
SIM,1919,21,35-39,1940,9
SIM,1861,20,40-44,1881,5
STAT,1815,45,20-24,1860,0.030183779921985298
STAT,1829,27,20-24,1856,16.905001262116635
STAT,1871,33,40-44,1904,4.044383812451578
SIM,1837,27,20-24,1864,13
SIM,1851,30,25-29,1881,13
SIM,1889,34,30-34,1923,25
STAT,1909,47,50-100,1956,0.1962890241555245
SIM,1873,82,na,1955,406
SIM,1929,23,15-19,1952,6
STAT,1897,17,25-29,1914,7.1594317975665485
SIM,1905,53,na,1958,2898
STAT,1868,44,50-100,1912,0.9400330413631345
STAT,1879,15,50-100,1894,0.04860091541687886
STAT,1931,41,na,1972,4693.982588452659
STAT,1889,40,15-19,1929,0.016268533191904723
STAT,1865,39,25-29,1904,2.446756067839869
STAT,1934,29,50-100,1963,1.2636545477828058
STAT,1884,14,na,1898,2403.0699248089873
SIM,1858,38,45-49,1896,1
SIM,1855,61,na,1916,1424
STAT,1920,38,30-34,1958,1.8833330296786683
STAT,1874,25,30-34,1899,24.47887182592528
STAT,1761,94,na,1855,2.44872
STAT,1857,25,30-34,1882,19.59756947211541
SIM,1867,94,na,1961,30
STAT,1878,17,15-19,1895,5.836348942798898
SIM,1785,73,na,1858,379
STAT,1899,42,25-29,1941,0.057659237021074713
STAT,1891,45,30-34,1936,0.06448449763759681
STAT,1847,53,50-100,1900,0.01093401041243674
SIM,1912,47,na,1959,3180
STAT,1772,86,na,1858,56.19652449600254
STAT,1839,48,40-44,1887,0.11482492891976513
SIM,1850,31,20-24,1881,1
STAT,1903,49,40-44,1952,0.1270846790077358
SIM,1877,27,20-24,1904,13
SIM,1834,99,na,1933,4
SIM,1812,42,40-44,1854,4
STAT,1867,47,35-39,1914,0.12360113376327432
STAT,1814,44,20-24,1858,0.4514651847524775
STAT,1839,49,25-29,1888,0.0381408919711716
SIM,1830,85,na,1915,151
SIM,1926,15,na,1941,4179
STAT,1874,45,30-34,1919,0.09439524284512507
STAT,1878,50,40-44,1928,0.01050222681443999
STAT,1917,31,30-34,1948,15.648687363534329
STAT,1809,54,35-39,1863,0.028670161996169348
STAT,1843,49,45-49,1892,0.16670849995828527
STAT,1851,52,25-29,1903,0.0025835888895101465
STAT,1827,77,na,1904,479.69383765734614
SIM,1789,87,na,1876,41
SIM,1888,48,na,1936,2411
STAT,1867,50,35-39,1917,0.007745975621876895
STAT,1814,45,50-100,1859,0.6883018384614891
STAT,1825,33,40-44,1858,6.939182429861171
STAT,1886,18,50-100,1904,0.0487718594425223
STAT,1828,33,50-100,1861,0.9520787933319776
STAT,1862,41,45-49,1903,1.2115063638539023
STAT,1871,36,45-49,1907,1.8759728311891877
STAT,1834,43,35-39,1877,1.3340660273590528
SIM,1848,47,50-100,1895,2
SIM,1933,17,na,1950,4672
STAT,1825,51,50-100,1876,0.015571518875728522
SIM,1887,37,30-34,1924,5
SIM,1888,17,25-29,1905,6
SIM,1909,35,na,1944,3397
SIM,1833,33,40-44,1866,7
STAT,1834,28,40-44,1862,2.4139525492486404
STAT,1876,45,35-39,1921,0.13789695884464917
SIM,1842,26,45-49,1868,1
STAT,1873,19,35-39,1892,0.5233400689538543
SIM,1922,25,na,1947,4038
SIM,1865,25,30-34,1890,27
SIM,1934,21,30-34,1955,41
STAT,1845,46,15-19,1891,2.825522486387996E-4
STAT,1935,31,na,1966,4945.671346377826
STAT,1865,36,20-24,1901,0.6649161939598489
SIM,1913,40,na,1953,3344
STAT,1807,54,30-34,1861,0.020249729807322592
STAT,1876,25,40-44,1901,2.941259872033842
SIM,1843,44,35-39,1887,2
STAT,1849,37,45-49,1886,1.4703153304203467
STAT,1905,49,45-49,1954,0.17794000051990505
SIM,1946,23,15-19,1969,6
STAT,1890,28,25-29,1918,48.68729914891622
SIM,1811,46,50-100,1857,2
SIM,1810,97,na,1907,3
SIM,1856,38,40-44,1894,7
STAT,1868,31,40-44,1899,3.9276040313749165
SIM,1821,35,45-49,1856,2
STAT,1860,18,40-44,1878,0.16100179825833677
STAT,1884,19,40-44,1903,0.16983158716672042
STAT,1927,20,35-39,1947,11.025922527558677
STAT,1938,0,na,1938,4197.779687596646
STAT,1881,57,na,1938,1833.0728132995223
SIM,1821,49,na,1870,1336
STAT,1850,28,50-100,1878,0.5261608075185358
SIM,1892,53,na,1945,2564
SIM,1831,37,25-29,1868,2
SIM,1884,25,40-44,1909,3
STAT,1809,80,na,1889,280.6940486615965
STAT,1886,27,20-24,1913,11.709444872607264
STAT,1928,21,35-39,1949,11.140683029715866
SIM,1833,22,30-34,1855,18
STAT,1851,43,35-39,1894,1.3183070592241877
SIM,1894,27,20-24,1921,17
STAT,1938,23,15-19,1961,4.974761572182573
STAT,1926,21,30-34,1947,33.08946309510476
STAT,1823,37,25-29,1860,4.602212749398375
STAT,1903,38,30-34,1941,1.538429753230036
SIM,1936,21,35-39,1957,8
STAT,1881,22,15-19,1903,3.0091848995497226
STAT,1897,24,50-100,1921,0.5119833731205168
SIM,1876,79,na,1955,614
STAT,1819,36,20-24,1855,2.2446379273669015
SIM,1911,38,30-34,1949,2
STAT,1869,30,50-100,1899,0.844583392178392
STAT,1800,59,na,1859,996.2612433429294
STAT,1881,19,15-19,1900,5.3841350559961825
STAT,1877,24,45-49,1901,0.6793167459605913
STAT,1885,46,45-49,1931,0.2227489641281175
STAT,1886,47,15-19,1933,3.9738800387237707E-4
SIM,1842,28,40-44,1870,2
STAT,1850,28,25-29,1878,34.79383240874829
STAT,1844,17,45-49,1861,0.05829210881631539
SIM,1858,26,na,1884,1972
STAT,1835,44,35-39,1879,1.3195176950409286
SIM,1862,31,na,1893,2069
SIM,1868,30,50-100,1898,4
SIM,1878,28,20-24,1906,13
STAT,1846,100,na,1946,0.7485366755704352
STAT,1855,42,50-100,1897,0.7472969165246306
STAT,1861,17,45-49,1878,0.058899029381149964
STAT,1830,35,45-49,1865,1.625313389083765
STAT,1880,26,45-49,1906,1.1074269527424059
STAT,1826,52,na,1878,1290.4792445540481
STAT,1883,15,30-34,1898,1.4825676687444582
SIM,1854,44,na,1898,1792
STAT,1882,30,50-100,1912,0.8490289850043018
SIM,1872,33,na,1905,2209
STAT,1847,51,20-24,1898,5.45550568854846E-4
STAT,1858,24,50-100,1882,0.3112474562017549
STAT,1879,50,50-100,1929,0.015127244583003383
SIM,1829,69,na,1898,772
STAT,1825,53,35-39,1878,0.008530520315812692
STAT,1782,110,na,1892,6.994951686226838E-4
STAT,1851,59,na,1910,1425.174204488019
SIM,1809,49,na,1858,1278
STAT,1841,54,50-100,1895,0.010049018547294905
STAT,1943,21,30-34,1964,28.89583340777592
SIM,1879,27,25-29,1906,48
STAT,1923,33,50-100,1956,0.8949396739208281
STAT,1856,46,20-24,1902,0.00890393656841422
SIM,1841,44,30-34,1885,1
STAT,1891,29,25-29,1920,49.10981218277907
STAT,1848,50,25-29,1898,0.0025884191520672115
STAT,1944,20,35-39,1964,9.610588044917602
SIM,1880,84,na,1964,575
STAT,1840,67,na,1907,1103.9721833203714
STAT,1937,21,50-100,1958,0.6054368954668621
STAT,1885,31,na,1916,2255.12506686187
STAT,1850,27,40-44,1877,2.4817348712425686
STAT,1856,44,25-29,1900,0.468714791746811
STAT,1872,29,15-19,1901,0.42712706153890145
SIM,1842,43,35-39,1885,1
SIM,1898,38,45-49,1936,3
STAT,1901,11,na,1912,3419.9137950906693
SIM,1867,62,na,1929,1594
STAT,1871,19,25-29,1890,5.2786763324300425
STAT,1892,44,35-39,1936,0.1467511407436284
STAT,1854,19,25-29,1873,4.824012450036366
STAT,1950,20,na,1970,4095.723988146724
STAT,1838,36,30-34,1874,4.431940962830114
STAT,1870,52,35-39,1922,0.007926719602467614
STAT,1909,21,25-29,1930,81.32478388640267
STAT,1840,37,25-29,1877,2.3715675925084767
STAT,1905,25,na,1930,3280.0783108650976
SIM,1870,41,45-49,1911,1
STAT,1889,39,40-44,1928,5.053975814279992
STAT,1900,20,50-100,1920,0.5376346473077023
STAT,1830,65,na,1895,1009.501601613363
STAT,1879,49,25-29,1928,0.05568855807551362
STAT,1843,18,40-44,1861,0.16763795792495015
SIM,1884,66,na,1950,1551
STAT,1872,32,15-19,1904,0.1350312846869859
STAT,1896,23,na,1919,2943.7150881576226
SIM,1813,54,na,1867,1156
SIM,1913,1,na,1914,3817
STAT,1895,37,15-19,1932,0.06922733179815711
SIM,1939,30,20-24,1969,1
SIM,1870,30,35-39,1900,16
STAT,1918,1,na,1919,4293.929180174618
SIM,1846,36,30-34,1882,9
STAT,1866,34,40-44,1900,3.744893360700876
STAT,1824,54,30-34,1878,0.006472544956550245
STAT,1897,64,na,1961,2332.493707107783
SIM,1897,39,40-44,1936,3
SIM,1874,34,40-44,1908,3
STAT,1828,46,15-19,1874,3.4140580406066644E-4
SIM,1937,17,15-19,1954,40
STAT,1902,42,50-100,1944,0.09768225213979718
STAT,1805,98,na,1903,1.0877040746654298
STAT,1832,43,25-29,1875,0.47024890919943935
STAT,1855,48,25-29,1903,0.04028185531939764
SIM,1863,36,30-34,1899,7
STAT,1883,80,na,1963,803.1341039896823
STAT,1916,22,25-29,1938,91.43445325641636
STAT,1940,29,45-49,1969,1.662444508116594
SIM,1847,16,25-29,1863,7
SIM,1939,25,25-29,1964,58
STAT,1771,109,na,1880,0.0021547989035436456
STAT,1882,31,20-24,1913,2.4949413520807115
STAT,1848,109,na,1957,7.06263305787181E-4
STAT,1894,41,35-39,1935,2.210494509113152
STAT,1813,105,na,1918,0.01240051602203256
STAT,1940,31,50-100,1971,0.8087593050521139
SIM,1912,55,na,1967,3073
SIM,1930,12,na,1942,4799
STAT,1857,33,30-34,1890,12.948264842803724
SIM,1847,36,50-100,1883,4
SIM,1881,16,25-29,1897,9
SIM,1945,10,na,1955,3925
STAT,1918,43,na,1961,3724.342998170218
STAT,1939,13,na,1952,3732.4372129567996
STAT,1846,42,45-49,1888,1.068014587846007
STAT,1884,47,50-100,1931,0.22820845196036452
STAT,1961,2,na,1963,4801.7114360064115
STAT,1834,40,25-29,1874,0.4916283929176488
STAT,1762,112,na,1874,1.4472046435001516E-4
STAT,1897,32,na,1929,3014.902051402874
STAT,1862,11,na,1873,2213.293238053279
STAT,1839,16,25-29,1855,4.9720026664592165
STAT,1839,78,na,1917,520.9708521825169
STAT,1883,18,40-44,1901,0.16890024520208535
SIM,1856,70,na,1926,1074
STAT,1835,52,40-44,1887,0.006694092472614698
STAT,1794,65,na,1859,756.0518612244044
STAT,1918,49,30-34,1967,0.0890909128307517
SIM,1834,30,25-29,1864,11
SIM,1890,31,20-24,1921,2
STAT,1898,43,20-24,1941,0.014001411557010462
SIM,1862,16,20-24,1878,20
STAT,1849,51,30-34,1900,0.004311071701327926
STAT,1818,65,na,1883,886.7885244115708
STAT,1858,41,25-29,1899,0.47839755886286894
STAT,1890,49,30-34,1939,0.061751425277562104
SIM,1873,34,25-29,1907,10
SIM,1843,27,45-49,1870,5
SIM,1843,84,na,1927,210
STAT,1775,106,na,1881,0.011584260968705556
STAT,1878,29,50-100,1907,0.6246107484881284
STAT,1833,44,30-34,1877,0.8262482723143162
STAT,1827,50,35-39,1877,0.007576051538057914
STAT,1830,97,na,1927,3.2091168544428705
STAT,1858,5,na,1863,2178.4099176443005
STAT,1888,44,15-19,1932,0.015203878229309582
STAT,1863,52,na,1915,1778.5011521762556
STAT,1855,36,30-34,1891,3.792770441661842
STAT,1919,31,40-44,1950,4.004820919144582
STAT,1874,29,25-29,1903,40.55144056126892
SIM,1895,58,na,1953,2461
STAT,1788,93,na,1881,6.795141030164573
STAT,1815,40,20-24,1855,0.4920232823556168
SIM,1854,42,45-49,1896,1
SIM,1947,3,na,1950,4071
STAT,1860,30,25-29,1890,7.927069367971536
STAT,1822,38,20-24,1860,1.3261277423889009
SIM,1870,26,20-24,1896,13
STAT,1778,104,na,1882,0.028781162411863917
STAT,1862,43,40-44,1905,1.7994580987593167
STAT,1830,48,50-100,1878,0.17769633094636034
STAT,1862,26,20-24,1888,9.55711796019258
STAT,1834,47,na,1881,1476.8147685603562
STAT,1854,16,20-24,1870,15.361918334292362
SIM,1870,43,40-44,1913,6
STAT,1882,39,30-34,1921,4.849906335363538
STAT,1835,27,45-49,1862,0.9028656655966592
SIM,1890,39,30-34,1929,10
STAT,1904,23,45-49,1927,0.9418281136963252
SIM,1898,35,40-44,1933,6
STAT,1869,27,15-19,1896,0.4148822957953913
STAT,1860,87,na,1947,135.264501008247
SIM,1886,29,50-100,1915,1
STAT,1847,35,15-19,1882,0.04376874299709333
SIM,1817,44,na,1861,1439
SIM,1882,29,25-29,1911,48
STAT,1848,38,40-44,1886,3.216333063857319
STAT,1868,51,35-39,1919,0.007802327072663539
SIM,1939,16,35-39,1955,4
STAT,1826,30,25-29,1856,15.457993461071966
SIM,1898,26,na,1924,3030
STAT,1876,33,50-100,1909,0.8898025418333497
STAT,1891,28,40-44,1919,3.49040339439104
SIM,1830,29,30-34,1859,25
SIM,1872,23,20-24,1895,55
STAT,1834,23,40-44,1857,1.7126866841565156
STAT,1845,98,na,1943,2.2882118156031495
SIM,1810,65,na,1875,830
STAT,1826,60,na,1886,1101.4376672511949
SIM,1864,46,na,1910,2021
SIM,1906,9,na,1915,3652
STAT,1841,18,30-34,1859,1.3981900267990002
SIM,1832,37,40-44,1869,5
SIM,1872,41,na,1913,2168
STAT,1891,24,25-29,1915,66.51863715996805
STAT,1836,20,40-44,1856,2.111102093947738
STAT,1931,36,40-44,1967,1.8746642539925458
SIM,1883,27,45-49,1910,1
STAT,1871,31,45-49,1902,1.6398394023125777
SIM,1814,79,na,1893,300
STAT,1824,37,40-44,1861,6.5786881253194025
STAT,1875,41,30-34,1916,1.1208454493486486
STAT,1881,38,25-29,1919,2.613216203537253
SIM,1836,26,20-24,1862,9
SIM,1843,52,na,1895,1525
STAT,1838,48,25-29,1886,0.03990217811860889
STAT,1849,24,50-100,1873,0.35028729444605355
SIM,1798,91,na,1889,18
STAT,1820,44,45-49,1864,2.5403263514467462
STAT,1833,54,na,1887,1294.6753566599768
SIM,1832,33,na,1865,1677
STAT,1861,45,45-49,1906,0.1869822231350994
SIM,1876,23,na,1899,2368
STAT,1847,26,25-29,1873,37.68110046617267
STAT,1864,23,20-24,1887,58.69472430205539
STAT,1883,51,30-34,1934,0.005537639137368345
STAT,1808,50,30-34,1858,0.022535594673640802
STAT,1875,27,45-49,1902,1.0775913966428219
STAT,1815,48,25-29,1863,0.1378741469316194
STAT,1800,67,na,1867,752.3477081191656
STAT,1830,30,45-49,1860,1.5068492496544454
STAT,1842,31,20-24,1873,2.3495764430351977
STAT,1852,44,35-39,1896,1.3572354350332998
SIM,1831,25,30-34,1856,21
SIM,1877,64,na,1941,1665
SIM,1840,95,na,1935,7
STAT,1892,9,na,1901,3069.468560800489
STAT,1844,45,45-49,1889,0.16828683777256132
STAT,1876,28,45-49,1904,1.0790175550755698
SIM,1842,43,na,1885,1593
STAT,1836,36,20-24,1872,0.603733460656168
SIM,1875,35,50-100,1910,1
STAT,1841,30,20-24,1871,2.290973442055576
STAT,1814,47,25-29,1861,0.15625850723841886
STAT,1895,17,20-24,1912,21.85572974224155
SIM,1847,74,na,1921,757
STAT,1893,21,25-29,1914,68.82266311975509
SIM,1924,22,25-29,1946,104
STAT,1904,38,50-100,1942,0.35724396054102475
STAT,1861,31,30-34,1892,13.752714335861983
STAT,1888,36,15-19,1924,0.06297069081238027
STAT,1859,28,45-49,1887,0.8454196745773113
STAT,1886,80,na,1966,927.0336570710955
SIM,1855,26,25-29,1881,37
SIM,1926,30,35-39,1956,14
STAT,1832,32,15-19,1864,0.1127293563363942
STAT,1945,21,40-44,1966,3.482427939963443
STAT,1925,39,20-24,1964,0.29829194540663
STAT,1828,26,20-24,1854,27.91393796317561
SIM,1809,57,na,1866,1107
SIM,1824,38,na,1862,1498
STAT,1846,72,na,1918,890.4324130939215
SIM,1868,41,35-39,1909,5
STAT,1810,51,25-29,1861,0.012265581839690336
STAT,1824,33,25-29,1857,20.733526104922067
STAT,1914,39,45-49,1953,0.6364268834238545
STAT,1860,18,50-100,1878,0.04312547118930162
STAT,1905,33,na,1938,3271.5318152283053
STAT,1921,46,25-29,1967,0.056636916253722365
SIM,1779,77,na,1856,268
SIM,1871,35,50-100,1906,1
STAT,1890,16,30-34,1906,1.8454837002050828
SIM,1849,24,35-39,1873,8
SIM,1918,20,35-39,1938,16
SIM,1832,33,25-29,1865,14
SIM,1842,23,40-44,1865,2
STAT,1936,34,45-49,1970,1.4417833943332083
SIM,1867,28,45-49,1895,4
STAT,1863,39,20-24,1902,0.633680829679635
STAT,1902,68,na,1970,2373.8569390665907
STAT,1808,55,na,1863,1145.2105674404756
STAT,1826,49,45-49,1875,0.2148215051636839
STAT,1918,30,35-39,1948,9.24723468241195
STAT,1900,41,35-39,1941,0.16554789917265647
SIM,1862,16,15-19,1878,10
SIM,1896,43,na,1939,2894
STAT,1847,46,na,1893,1660.1074295425494
SIM,1884,28,45-49,1912,2
STAT,1843,51,30-34,1894,0.004315046443836543
STAT,1892,25,25-29,1917,50.38237523087498
STAT,1860,105,na,1965,0.13193267141444376
STAT,1905,46,40-44,1951,0.13220880503586302
SIM,1917,24,35-39,1941,10
STAT,1838,85,na,1923,186.9663478064009
SIM,1858,44,30-34,1902,1
STAT,1876,53,40-44,1929,0.010102296945650107
SIM,1792,75,na,1867,340
SIM,1805,54,50-100,1859,1
SIM,1858,35,40-44,1893,4
STAT,1854,24,na,1878,1783.1541775498038
STAT,1937,30,45-49,1967,1.4721777105270653
SIM,1930,20,na,1950,4370
SIM,1833,34,25-29,1867,14
SIM,1874,30,25-29,1904,18
STAT,1843,32,na,1875,1879.718651899072
STAT,1809,51,30-34,1860,0.02105843157139027
STAT,1858,38,na,1896,1738.596018811749
STAT,1913,20,na,1933,3513.403776430185
SIM,1885,30,50-100,1915,2
STAT,1892,15,50-100,1907,0.05822700505594611
STAT,1909,4,na,1913,3725.9825941140034
SIM,1838,39,30-34,1877,7
STAT,1886,42,45-49,1928,1.4919935558393376
STAT,1854,16,15-19,1870,5.142337076178934
STAT,1819,40,35-39,1859,3.801501292172336
STAT,1847,22,na,1869,1928.602389675005
STAT,1819,51,45-49,1870,0.025285034938149396
SIM,1839,43,30-34,1882,1
SIM,1885,51,na,1936,2053
STAT,1821,42,40-44,1863,3.7541211304177216
STAT,1850,23,25-29,1873,48.02412013255043
SIM,1844,20,40-44,1864,1
STAT,1855,17,20-24,1872,14.934107431984042
SIM,1817,37,45-49,1854,2
SIM,1853,30,35-39,1883,8
STAT,1825,34,25-29,1859,15.030837457030751
STAT,1913,38,50-100,1951,0.3893917478051035
STAT,1853,40,35-39,1893,1.3564641667599426
STAT,1898,34,30-34,1932,22.136793812376315
STAT,1912,27,na,1939,3486.6935690681016
STAT,1816,82,na,1898,217.4258243575663
STAT,1853,23,45-49,1876,0.6066345312708911
SIM,1800,87,na,1887,39
STAT,1849,34,40-44,1883,3.226182061941265
SIM,1890,38,na,1928,2802
STAT,1816,41,20-24,1857,0.4950638544253458
STAT,1871,49,50-100,1920,0.22521253226685778
SIM,1940,19,na,1959,3377
SIM,1920,42,na,1962,3814
SIM,1891,15,30-34,1906,5
STAT,1861,34,50-100,1895,0.7126194014830349
SIM,1884,42,30-34,1926,3
STAT,1864,51,20-24,1915,6.26014257869136E-4
STAT,1932,23,20-24,1955,137.40510202085795
STAT,1890,41,20-24,1931,0.18426333437747305
SIM,1873,38,40-44,1911,5
STAT,1917,34,35-39,1951,8.962287986552957
SIM,1863,17,20-24,1880,19
STAT,1832,24,15-19,1856,2.8555431267794438
STAT,1927,41,40-44,1968,0.2968040422333052
STAT,1849,88,na,1937,98.95275284020921
STAT,1828,26,15-19,1854,1.0795445707675688
SIM,1827,40,35-39,1867,2
STAT,1831,43,50-100,1874,0.7940403126263736
SIM,1937,20,45-49,1957,5
STAT,1898,45,40-44,1943,0.12472888788750558
SIM,1848,28,35-39,1876,9
STAT,1831,31,45-49,1862,1.448669086100697
STAT,1909,24,35-39,1933,8.213358996922475
SIM,1940,23,20-24,1963,90
STAT,1838,33,20-24,1871,2.267187043286303
STAT,1872,64,na,1936,1648.3154550566303
STAT,1840,34,20-24,1874,2.2456924997284333
SIM,1846,33,20-24,1879,4
SIM,1838,23,20-24,1861,56
STAT,1876,42,30-34,1918,1.119839744737052
SIM,1905,22,15-19,1927,3
STAT,1815,48,30-34,1863,0.2317051658265569
STAT,1865,38,40-44,1903,3.739205766883548
STAT,1947,17,30-34,1964,12.971613100715071
STAT,1810,52,50-100,1862,0.05126011971785568
STAT,1823,50,20-24,1873,8.812077751740154E-4
STAT,1860,53,50-100,1913,0.01140910733794406
SIM,1783,90,na,1873,17
SIM,1857,34,40-44,1891,6
SIM,1875,31,25-29,1906,11
STAT,1897,47,20-24,1944,0.008512187985085082
STAT,1877,54,40-44,1931,0.01003662842501918
STAT,1895,17,15-19,1912,7.3161129316505065
STAT,1888,28,na,1916,2654.0090589810025
SIM,1864,29,30-34,1893,35
SIM,1776,88,na,1864,45
STAT,1874,40,25-29,1914,0.626279118639711
SIM,1927,31,40-44,1958,8
SIM,1865,38,50-100,1903,4
STAT,1866,38,35-39,1904,6.129881275335376
STAT,1937,27,15-19,1964,0.6500077945960517
STAT,1892,42,15-19,1934,0.016317008474031804
SIM,1871,48,na,1919,2139
SIM,1894,31,35-39,1925,16
STAT,1842,50,30-34,1892,0.004299799974692988
STAT,1845,30,35-39,1875,8.6595260782339
SIM,1899,36,40-44,1935,1
STAT,1835,41,30-34,1876,0.8705748926629892
SIM,1948,19,40-44,1967,2
STAT,1886,31,35-39,1917,10.149377137793453
STAT,1881,49,na,1930,2009.3307870786848
STAT,1866,18,35-39,1884,0.4876563859933984
SIM,1826,45,50-100,1871,1
STAT,1852,36,35-39,1888,5.459363944444297
STAT,1910,28,20-24,1938,16.588504669784335
SIM,1840,24,15-19,1864,2
SIM,1879,24,20-24,1903,69
STAT,1880,64,na,1944,1727.925521251772
STAT,1851,24,25-29,1875,49.41398951021714
STAT,1929,17,15-19,1946,54.71844708829446
SIM,1909,27,na,1936,3382
SIM,1905,13,na,1918,3524
SIM,1827,97,na,1924,2
SIM,1823,83,na,1906,212
STAT,1864,77,na,1941,729.815593355549
STAT,1943,24,35-39,1967,9.457002717022128
STAT,1846,39,15-19,1885,0.04049644874548933
STAT,1887,29,50-100,1916,0.6710024810784366
STAT,1929,32,50-100,1961,0.9921861067802248
SIM,1865,33,30-34,1898,26
STAT,1805,90,na,1895,26.39806642412016
STAT,1887,43,45-49,1930,1.5697729439660213
STAT,1818,40,40-44,1858,5.838123782512151
STAT,1925,21,na,1946,4142.401196559142
STAT,1854,8,na,1862,2115.3058866856354
SIM,1842,40,30-34,1882,1
SIM,1895,43,45-49,1938,1
SIM,1860,36,35-39,1896,13
STAT,1856,49,30-34,1905,0.07012633098892627
SIM,1900,31,50-100,1931,1
STAT,1879,34,20-24,1913,2.646235264624203
STAT,1867,42,na,1909,2047.5468085676612
STAT,1875,41,25-29,1916,0.6260578211166132
SIM,1843,41,30-34,1884,3
SIM,1829,39,35-39,1868,9
STAT,1846,42,15-19,1888,0.009854806577430856
STAT,1929,35,na,1964,4571.079194365757
SIM,1825,31,na,1856,1591
SIM,1844,69,na,1913,1006
SIM,1859,99,na,1958,4
STAT,1847,43,15-19,1890,0.010087714943471495
SIM,1874,38,35-39,1912,15
STAT,1834,40,30-34,1874,0.8801734095255334
STAT,1896,46,20-24,1942,0.008475308886276041
STAT,1856,29,30-34,1885,19.03069929752428
STAT,1874,48,35-39,1922,0.13347594338016172
STAT,1873,16,25-29,1889,5.4660682385899015
STAT,1808,50,25-29,1858,0.013409609924496786
STAT,1891,41,15-19,1932,0.016220992171269336
SIM,1824,32,30-34,1856,16
STAT,1884,5,na,1889,2458.084424930003
SIM,1923,10,na,1933,4310
STAT,1844,20,50-100,1864,0.36261851960451685
STAT,1879,46,20-24,1925,0.011882827463693835
SIM,1934,21,25-29,1955,138
STAT,1855,39,35-39,1894,4.958886801863504
STAT,1863,42,15-19,1905,0.011453751261444269
SIM,1891,34,40-44,1925,5
SIM,1829,77,na,1906,422
STAT,1807,54,25-29,1861,0.012049425884920828
STAT,1859,25,40-44,1884,2.330761447185675
STAT,1883,23,30-34,1906,16.44084744811282
STAT,1894,36,45-49,1930,2.4341851854899588
SIM,1914,33,20-24,1947,2
STAT,1885,31,40-44,1916,4.098308173116728
SIM,1908,22,40-44,1930,2
SIM,1830,25,45-49,1855,3
STAT,1892,29,40-44,1921,3.518444420154756
STAT,1920,45,25-29,1965,0.055657485307087674
STAT,1839,44,25-29,1883,0.4398585988295696
SIM,1908,42,na,1950,3175
SIM,1850,34,30-34,1884,19
STAT,1825,38,40-44,1863,5.382728062231442
STAT,1825,67,na,1892,896.2728477733883
SIM,1841,26,na,1867,1912
SIM,1833,38,40-44,1871,7
STAT,1926,21,25-29,1947,106.34383809166088
STAT,1867,7,na,1874,2466.370353816537
STAT,1863,39,15-19,1902,0.04616218545346671
SIM,1891,23,30-34,1914,25
STAT,1920,34,15-19,1954,0.13184015755564218
STAT,1881,44,50-100,1925,0.9506289468890933
STAT,1852,44,na,1896,1732.3131383713285
STAT,1861,18,na,1879,2057.5297844247048
SIM,1887,34,20-24,1921,2
STAT,1916,18,40-44,1934,0.2796017502960494
STAT,1899,46,40-44,1945,0.12537715294191892
SIM,1824,43,40-44,1867,2
STAT,1897,26,15-19,1923,0.5751818826446242
SIM,1899,15,35-39,1914,3
STAT,1822,54,20-24,1876,9.519846457866154E-4
STAT,1936,35,50-100,1971,0.38998953442047063
SIM,1826,36,35-39,1862,12
SIM,1941,22,25-29,1963,88
STAT,1827,45,45-49,1872,0.2123410401192652
STAT,1836,81,na,1917,341.48685261745914
SIM,1817,43,30-34,1860,2
STAT,1925,29,50-100,1954,1.1028031135202634
STAT,1832,28,30-34,1860,20.42430920674572
STAT,1883,34,40-44,1917,3.980846440861392
STAT,1802,93,na,1895,9.969879686609739
STAT,1885,27,35-39,1912,9.081372295164469
STAT,1834,24,25-29,1858,46.71246254494128
SIM,1790,71,na,1861,502
SIM,1929,12,na,1941,4864
SIM,1924,18,40-44,1942,1
STAT,1861,80,na,1941,485.2743518110978
STAT,1870,54,na,1924,1938.3121123825165
SIM,1896,26,50-100,1922,4
STAT,1837,36,15-19,1873,0.043610178998803
SIM,1833,82,na,1915,264
STAT,1913,22,50-100,1935,0.6022009714822867
SIM,1840,28,30-34,1868,25
STAT,1940,26,40-44,1966,4.491689422936706
STAT,1874,45,25-29,1919,0.05616906958136964
STAT,1891,42,20-24,1933,0.18547251767293968
SIM,1872,29,35-39,1901,8
SIM,1893,30,35-39,1923,16
STAT,1885,30,35-39,1915,9.60800013614397
STAT,1795,95,na,1890,2.5684294333901425
SIM,1801,72,na,1873,528
STAT,1791,81,na,1872,193.28907098595414
SIM,1893,27,35-39,1920,11
SIM,1842,24,25-29,1866,53
STAT,1824,51,20-24,1875,8.517156231901418E-4
STAT,1874,47,na,1921,2162.164870524149
SIM,1848,59,na,1907,1411
SIM,1843,33,30-34,1876,20
STAT,1933,22,25-29,1955,115.74812868072357
STAT,1797,103,na,1900,0.03494376951269784
STAT,1863,26,15-19,1889,0.37948545751024243
SIM,1852,30,40-44,1882,4
SIM,1925,34,35-39,1959,14
STAT,1919,31,35-39,1950,9.352026080819359
STAT,1823,34,20-24,1857,5.373206776462468
STAT,1865,34,25-29,1899,8.717431095743656
STAT,1894,24,45-49,1918,0.8420944378897616
STAT,1920,47,20-24,1967,0.011540991527634947
SIM,1835,33,45-49,1868,1
STAT,1826,32,50-100,1858,1.2124008796822883
STAT,1866,39,40-44,1905,3.774383246176773
STAT,1812,52,40-44,1864,0.03313073946431685
STAT,1833,44,25-29,1877,0.4615080458836416
STAT,1849,45,50-100,1894,0.17879110280695146
STAT,1856,49,25-29,1905,0.041728064318514335
STAT,1823,53,25-29,1876,0.003984583395848634
STAT,1838,39,50-100,1877,0.9896457446438824
SIM,1850,22,30-34,1872,17
SIM,1876,44,50-100,1920,2
STAT,1829,51,50-100,1880,0.012008349122338202
SIM,1790,92,na,1882,7
STAT,1827,33,45-49,1860,1.943053670738141
STAT,1882,42,na,1924,2121.991573631773
STAT,1891,16,na,1907,2960.4613635766777
STAT,1904,46,25-29,1950,0.04414480454261963
SIM,1861,35,45-49,1896,2
STAT,1850,41,20-24,1891,0.11231063240540662
SIM,1922,36,40-44,1958,1
STAT,1811,43,35-39,1854,6.704367281626312
STAT,1870,65,na,1935,1564.3467421458863
SIM,1811,82,na,1893,184
STAT,1842,34,30-34,1876,14.71101106399973
STAT,1890,25,20-24,1915,13.642071776178373
STAT,1907,32,25-29,1939,8.160115122030994
SIM,1867,25,40-44,1892,4
STAT,1823,63,na,1886,968.3774478720312
SIM,1882,24,25-29,1906,48
SIM,1820,56,na,1876,1129
SIM,1867,37,35-39,1904,8
STAT,1843,34,40-44,1877,3.6840470241605163
STAT,1873,16,30-34,1889,1.5374301466196143
STAT,1884,54,na,1938,1954.8456034459105
STAT,1859,87,na,1946,132.82701724739815
STAT,1914,36,40-44,1950,1.4185348202209827
SIM,1867,40,35-39,1907,2
SIM,1831,34,20-24,1865,1
SIM,1794,85,na,1879,70
STAT,1908,41,30-34,1949,0.11235785318279347
STAT,1858,27,45-49,1885,0.8429453579249742
STAT,1906,33,20-24,1939,2.1260678711277383
STAT,1842,22,30-34,1864,15.99870360305635
STAT,1844,30,40-44,1874,3.7170082669182625
SIM,1898,4,na,1902,3320
STAT,1929,33,15-19,1962,0.15411514107508226
STAT,1785,96,na,1881,1.5587053971949039
STAT,1811,54,45-49,1865,0.04426743090014854
SIM,1908,50,na,1958,3031
STAT,1763,111,na,1874,4.241226189180539E-4
STAT,1876,34,30-34,1910,16.881899414415525
STAT,1874,79,na,1953,675.0081638067536
SIM,1831,28,35-39,1859,8
SIM,1884,34,30-34,1918,26
SIM,1851,34,40-44,1885,5
SIM,1881,16,30-34,1897,1
STAT,1871,49,20-24,1920,0.011003870090404462
STAT,1939,23,30-34,1962,27.255904326888505
STAT,1836,39,25-29,1875,2.1858412693061964
SIM,1819,70,na,1889,679
STAT,1861,29,na,1890,1858.7910177475917
STAT,1769,115,na,1884,1.5987175124822713E-4
STAT,1843,46,40-44,1889,0.1245225089831893
SIM,1903,33,45-49,1936,1
SIM,1833,85,na,1918,155
SIM,1864,29,50-100,1893,2
STAT,1944,22,50-100,1966,0.6711361988108728
SIM,1927,31,35-39,1958,11
STAT,1874,26,20-24,1900,11.365957707880613
SIM,1841,44,25-29,1885,3
STAT,1875,24,40-44,1899,2.0097550352845928
STAT,1842,33,40-44,1875,3.69212111305175
SIM,1850,33,40-44,1883,3
SIM,1882,26,20-24,1908,11
SIM,1863,100,na,1963,2
SIM,1865,39,na,1904,2005
STAT,1867,49,50-100,1916,0.21329883215806697
STAT,1853,112,na,1965,1.3060490743494778E-4
STAT,1848,39,na,1887,1713.1526591046847
STAT,1938,20,na,1958,3416.2570664909545
SIM,1874,13,na,1887,2503
STAT,1897,7,na,1904,3291.647034695811
STAT,1875,25,25-29,1900,41.33366889248812
STAT,1927,44,45-49,1971,0.1965491857755881
STAT,1859,6,na,1865,2183.2858365767042
STAT,1865,62,na,1927,1569.0063550311972
STAT,1799,88,na,1887,48.31861851027033
STAT,1857,45,30-34,1902,0.0728106002714665
STAT,1795,74,na,1869,437.6831048216831
STAT,1814,70,na,1884,690.3085472065267
SIM,1866,27,45-49,1893,3
STAT,1827,101,na,1928,0.31666717683785717
STAT,1945,21,35-39,1966,9.75216078547418
SIM,1857,7,na,1864,2364
SIM,1881,25,20-24,1906,7
SIM,1833,74,na,1907,658
STAT,1843,54,35-39,1897,0.0060402522917582194
STAT,1822,38,15-19,1860,0.09660534438148077
STAT,1846,80,na,1926,436.15520612876037
STAT,1863,35,50-100,1898,1.0292169083415734
SIM,1881,29,30-34,1910,24
STAT,1841,54,30-34,1895,0.0039606881021620145
STAT,1861,23,30-34,1884,14.252264593958476
STAT,1826,46,40-44,1872,0.16223472614513706
STAT,1882,39,25-29,1921,2.620064327710465
STAT,1916,17,na,1933,3871.006371620942
SIM,1820,34,45-49,1854,2
SIM,1844,77,na,1921,547
STAT,1828,46,45-49,1874,0.2014295939356681
SIM,1890,39,25-29,1929,2
SIM,1860,41,30-34,1901,4
STAT,1873,29,30-34,1902,23.974549277262
STAT,1893,37,40-44,1930,5.24694497795556
STAT,1873,33,15-19,1906,0.13597963842755997
STAT,1912,25,50-100,1937,0.932697393526091
STAT,1878,37,15-19,1915,0.05522534555269817
STAT,1884,35,40-44,1919,4.125383424565302
STAT,1836,73,na,1909,750.0527735289918
STAT,1890,44,25-29,1934,0.7316970458530209
STAT,1882,15,15-19,1897,5.480682505421644
SIM,1805,67,na,1872,756
SIM,1871,42,45-49,1913,2
SIM,1915,32,25-29,1947,13
STAT,1822,41,15-19,1863,0.021394574706873542
STAT,1930,36,25-29,1966,1.2144287802322684
SIM,1825,44,40-44,1869,4
SIM,1822,45,50-100,1867,1
STAT,1873,44,25-29,1917,0.60745799179314
STAT,1876,4,na,1880,2828.6106040817112
SIM,1875,34,35-39,1909,10
SIM,1871,4,na,1875,2688
SIM,1880,28,na,1908,2439
STAT,1898,49,35-39,1947,0.09888246798866607
STAT,1949,12,na,1961,4316.2470180176115
STAT,1867,34,35-39,1901,8.905806031614217
STAT,1835,33,30-34,1868,13.725823032948188
STAT,1817,44,40-44,1861,5.2452816174651415
STAT,1847,54,25-29,1901,0.002534505020349667
STAT,1890,33,15-19,1923,0.16379058482695755
SIM,1832,44,na,1876,1506
SIM,1841,18,na,1859,2051
STAT,1878,37,45-49,1915,1.9604995339694449
STAT,1847,26,30-34,1873,22.431437872497156
STAT,1934,31,30-34,1965,20.332753959927317
SIM,1872,35,20-24,1907,2
STAT,1870,20,40-44,1890,1.9404272929672868
STAT,1816,85,na,1901,127.74571135145835
SIM,1908,31,25-29,1939,12
STAT,1957,15,25-29,1972,53.995809879837516
SIM,1892,35,40-44,1927,5
SIM,1911,17,na,1928,3689
STAT,1918,47,50-100,1965,0.22737330804002517
STAT,1823,42,15-19,1865,0.017891423003663216
STAT,1827,37,na,1864,1559.3141040744383
STAT,1887,40,40-44,1927,2.400330355435697
SIM,1874,35,30-34,1909,7
SIM,1870,29,25-29,1899,50
STAT,1863,42,45-49,1905,1.2413002058099412
SIM,1890,19,30-34,1909,2
SIM,1769,86,na,1855,39
STAT,1806,53,25-29,1859,0.009802076086927139
SIM,1891,35,30-34,1926,7
STAT,1830,48,20-24,1878,0.008682231497483208
SIM,1810,57,na,1867,1091
SIM,1960,4,na,1964,4671
STAT,1893,24,35-39,1917,6.95071308294391
SIM,1855,26,30-34,1881,22
STAT,1857,44,40-44,1901,1.6525385489025675
STAT,1899,28,45-49,1927,1.4323536838855202
SIM,1842,99,na,1941,1
STAT,1868,46,45-49,1914,0.2134709476542001
STAT,1877,50,25-29,1927,0.0035221937142400697
SIM,1886,37,45-49,1923,2
STAT,1864,43,15-19,1907,0.01157556007537212
SIM,1865,44,40-44,1909,6
STAT,1816,43,40-44,1859,6.448599277700327
STAT,1826,33,35-39,1859,12.644507976155449
SIM,1881,69,na,1950,1225
STAT,1837,44,na,1881,1527.0233760274689
SIM,1883,25,na,1908,2281
STAT,1921,23,45-49,1944,1.1969705553236059
STAT,1933,16,50-100,1949,0.47496068661888585
SIM,1951,2,na,1953,4401
STAT,1863,84,na,1947,276.24803356618474
STAT,1866,35,30-34,1901,4.686089481505952
STAT,1894,67,na,1961,2071.253122186294
SIM,1810,89,na,1899,36
STAT,1862,29,25-29,1891,33.84445135828811
STAT,1842,53,35-39,1895,0.00603218572608356
STAT,1882,19,30-34,1901,1.4573072218432357
SIM,1869,10,na,1879,2440
STAT,1873,25,15-19,1898,0.43801072764856885
STAT,1885,39,na,1924,2195.0799684000635
SIM,1834,33,35-39,1867,10
SIM,1816,59,na,1875,1016
STAT,1902,23,35-39,1925,7.755520631388643
STAT,1853,53,40-44,1906,0.007682031349464303
SIM,1909,21,45-49,1930,5
STAT,1941,8,na,1949,3858.2621029174957
SIM,1827,40,50-100,1867,1
STAT,1912,35,na,1947,3501.0126104456517
STAT,1816,44,30-34,1860,3.160834923772809
STAT,1902,28,na,1930,3170.3898532832022
STAT,1883,35,30-34,1918,4.981344149815706
STAT,1851,28,40-44,1879,2.5535589315586615
SIM,1910,23,35-39,1933,8
STAT,1873,45,15-19,1918,3.873869667003666E-4
STAT,1856,25,15-19,1881,0.35290303867222655
STAT,1893,45,35-39,1938,0.09560038211257539
SIM,1887,31,na,1918,2509
STAT,1857,40,25-29,1897,0.483072633654412
SIM,1824,44,30-34,1868,2
SIM,1855,21,na,1876,2031
STAT,1846,29,na,1875,1818.7886623469474
SIM,1891,76,na,1967,1479
SIM,1931,33,50-100,1964,1
STAT,1841,38,25-29,1879,2.296980463652238
STAT,1826,54,35-39,1880,0.007465750491001653
STAT,1869,47,45-49,1916,0.21480097959786904
SIM,1874,15,30-34,1889,1
SIM,1948,15,25-29,1963,54
STAT,1833,62,na,1895,1109.5973743399104
STAT,1867,47,40-44,1914,0.15114652893909988
STAT,1868,34,45-49,1902,1.5594211324052518
SIM,1869,21,na,1890,2148
STAT,1823,55,na,1878,1195.72243236571
STAT,1864,54,25-29,1918,0.002908321189565015
STAT,1866,15,30-34,1881,1.4418535014087712
SIM,1820,64,na,1884,877
STAT,1883,18,35-39,1901,0.5067007062688877
STAT,1859,79,na,1938,527.0726085628195
STAT,1852,52,40-44,1904,0.00795603622591993
STAT,1907,30,50-100,1937,0.7358253312261137
SIM,1831,59,na,1890,1181
SIM,1830,34,na,1864,1700
SIM,1816,38,40-44,1854,3
STAT,1903,34,15-19,1937,0.10896130388976345
SIM,1931,33,20-24,1964,2
SIM,1829,36,30-34,1865,4
STAT,1916,18,50-100,1934,0.07489330775997229
STAT,1875,29,40-44,1904,2.8865295852542006
SIM,1830,41,45-49,1871,2
STAT,1818,43,45-49,1861,3.4533168020904923
SIM,1834,48,na,1882,1429
STAT,1888,27,30-34,1915,28.103255841098857
SIM,1822,90,na,1912,29
STAT,1824,35,20-24,1859,1.271374556545281
STAT,1843,16,45-49,1859,0.06058224178286609
STAT,1901,38,20-24,1939,0.2189121562457073
STAT,1838,39,35-39,1877,5.701264826666621
STAT,1811,51,40-44,1862,0.034106915809084926
STAT,1809,46,35-39,1855,0.5201966213373558
STAT,1871,24,50-100,1895,0.3795225928530474
SIM,1917,21,25-29,1938,98
SIM,1818,85,na,1903,101
STAT,1837,47,na,1884,1474.270441905399
STAT,1807,51,20-24,1858,0.002665806849516368
STAT,1858,45,40-44,1903,0.12823279636772886
STAT,1898,29,35-39,1927,12.251118219278032
SIM,1925,22,40-44,1947,4
SIM,1826,43,45-49,1869,1
SIM,1857,95,na,1952,9
STAT,1854,36,15-19,1890,0.04063119917194448
SIM,1839,19,30-34,1858,1
STAT,1845,95,na,1940,9.36512920463787
STAT,1835,88,na,1923,85.65531912382015
STAT,1874,42,20-24,1916,0.15315020444734062
SIM,1896,27,30-34,1923,42
SIM,1897,35,50-100,1932,1
SIM,1900,22,na,1922,3056
SIM,1876,31,40-44,1907,6
STAT,1824,54,25-29,1878,0.0038514316725632445
SIM,1846,39,35-39,1885,15
STAT,1923,33,20-24,1956,2.6402032761859853
STAT,1831,107,na,1938,0.00287609536709913
SIM,1854,27,20-24,1881,10
SIM,1907,25,na,1932,3369
SIM,1919,30,50-100,1949,4
SIM,1849,6,na,1855,2228
STAT,1840,22,20-24,1862,61.03130583124432
SIM,1893,34,45-49,1927,3
STAT,1884,47,40-44,1931,0.1590769014826839
STAT,1833,43,40-44,1876,1.6374181393650804
SIM,1913,16,15-19,1929,8
STAT,1898,30,15-19,1928,0.1835786333139483
STAT,1859,47,na,1906,1688.302363667875
STAT,1816,47,35-39,1863,0.36861985327493146
STAT,1901,43,na,1944,3044.523665752502
STAT,1822,70,na,1892,724.7340491623809
STAT,1889,35,50-100,1924,1.4454807714345823
STAT,1905,16,15-19,1921,8.121481791236732
STAT,1813,85,na,1898,115.9389698582784
STAT,1771,93,na,1864,4.486448068764977
STAT,1801,54,30-34,1855,0.020633516469142712
SIM,1867,34,30-34,1901,16
STAT,1891,26,20-24,1917,13.764740304800661
STAT,1833,32,30-34,1865,13.692627060087574
STAT,1903,45,25-29,1948,0.04410460583210917
SIM,1841,43,40-44,1884,10
STAT,1837,49,15-19,1886,2.5548849891854765E-4
SIM,1938,17,30-34,1955,14
SIM,1832,89,na,1921,47
SIM,1889,26,30-34,1915,29
STAT,1861,40,na,1901,1831.4086193611572
STAT,1885,34,45-49,1919,1.627197732056031
SIM,1841,32,30-34,1873,24
STAT,1845,29,25-29,1874,35.74852125812289
SIM,1856,34,25-29,1890,14
STAT,1898,41,25-29,1939,0.05728437885594595
STAT,1854,111,na,1965,4.1218704714822066E-4
STAT,1886,24,na,1910,2345.8342920136974
STAT,1885,24,30-34,1909,16.659604217988154
STAT,1832,44,15-19,1876,0.009982703515699583
SIM,1884,37,35-39,1921,16
STAT,1850,44,25-29,1894,0.44597780793750313
STAT,1847,18,50-100,1865,0.04472604634818333
STAT,1876,40,35-39,1916,1.7838255515187897
SIM,1780,93,na,1873,6
SIM,1868,36,na,1904,2133
STAT,1843,23,50-100,1866,0.3666329961077291
STAT,1848,34,25-29,1882,7.669821739135239
STAT,1866,54,35-39,1920,0.007292195203756517
SIM,1849,44,35-39,1893,3
SIM,1895,28,20-24,1923,12
SIM,1948,20,15-19,1968,5
SIM,1853,29,25-29,1882,44
SIM,1810,86,na,1896,70
STAT,1846,27,20-24,1873,10.00649828413467
STAT,1870,62,na,1932,1691.8749547260547
SIM,1836,26,na,1862,1762
SIM,1891,68,na,1959,1851
STAT,1858,24,40-44,1882,1.5904743854779215
STAT,1874,76,na,1950,914.7481015405023
STAT,1895,37,45-49,1932,2.457569986569404
STAT,1862,30,35-39,1892,8.226370371409123
SIM,1826,33,30-34,1859,15
SIM,1869,13,na,1882,2415
SIM,1883,28,na,1911,2267
SIM,1840,15,30-34,1855,1
STAT,1812,60,na,1872,1041.4737273798366
STAT,1887,28,20-24,1915,12.350609787504409
SIM,1886,17,15-19,1903,7
STAT,1842,17,35-39,1859,0.5017649584039406
SIM,1893,24,30-34,1917,35
SIM,1848,25,30-34,1873,33
STAT,1864,69,na,1933,1239.0626770659696
STAT,1876,37,35-39,1913,6.897904843965612
STAT,1822,41,45-49,1863,2.3186368710707916
SIM,1783,93,na,1876,6
SIM,1821,39,30-34,1860,5
SIM,1884,40,35-39,1924,4
STAT,1935,23,na,1958,4696.016297312678
SIM,1906,22,30-34,1928,36
STAT,1860,55,na,1915,1587.507092503618
SIM,1860,29,50-100,1889,2
STAT,1864,35,20-24,1899,0.6570170812994632
STAT,1891,45,25-29,1936,0.03837094037321921
SIM,1859,46,50-100,1905,1
STAT,1917,22,40-44,1939,3.375775757542167
SIM,1883,25,25-29,1908,41
STAT,1833,41,20-24,1874,0.11862065286133291
SIM,1902,23,50-100,1925,1
STAT,1867,52,30-34,1919,0.0052518065743238996
STAT,1801,110,na,1911,1.0515205992083054E-4
STAT,1842,37,35-39,1879,5.908448344351906
STAT,1884,17,45-49,1901,0.06098115294637433
SIM,1831,48,na,1879,1442
STAT,1864,29,35-39,1893,8.088468194851517
STAT,1844,33,45-49,1877,1.4487915753648735
SIM,1878,57,na,1935,2035
STAT,1837,36,na,1873,1663.2910188302694
SIM,1868,28,na,1896,2158
STAT,1889,44,30-34,1933,1.3227272431592905
STAT,1852,23,35-39,1875,5.229135860931598
SIM,1925,31,30-34,1956,28
STAT,1881,23,20-24,1904,62.663884715142444
SIM,1860,23,35-39,1883,1
STAT,1936,16,na,1952,3336.6284273585666
SIM,1839,38,35-39,1877,12
SIM,1850,37,35-39,1887,11
SIM,1883,29,40-44,1912,4
SIM,1947,23,30-34,1970,38
STAT,1883,83,na,1966,635.5321061381514
SIM,1839,47,50-100,1886,3
SIM,1852,33,45-49,1885,2
STAT,1872,33,50-100,1905,0.8651198682711049
STAT,1946,20,45-49,1966,1.183696442558973
STAT,1903,21,na,1924,3188.300287046288
STAT,1908,44,35-39,1952,0.17379687405923314
STAT,1812,71,na,1883,652.4554546632795
STAT,1833,22,na,1855,1736.2894942689932
STAT,1885,15,40-44,1900,0.17294439217940114
STAT,1872,17,20-24,1889,16.865529507044442
SIM,1841,23,25-29,1864,49
STAT,1849,35,25-29,1884,2.1681420793090824
SIM,1845,16,15-19,1861,5
STAT,1914,47,50-100,1961,0.21187225532719683
STAT,1888,23,15-19,1911,3.670367728424503
SIM,1939,29,40-44,1968,8
STAT,1836,51,45-49,1887,0.009458158642399022
STAT,1857,48,35-39,1905,0.10295501411289334
SIM,1900,44,40-44,1944,2
SIM,1918,41,40-44,1959,1
SIM,1827,39,25-29,1866,2
STAT,1914,22,15-19,1936,5.136754498477176
STAT,1861,26,35-39,1887,7.679490918271658
SIM,1891,30,25-29,1921,19
STAT,1855,33,20-24,1888,1.9291240556239635
STAT,1922,45,35-39,1967,0.14059277566865785
STAT,1926,2,na,1928,4737.576860166282
SIM,1873,39,25-29,1912,5
STAT,1852,29,50-100,1881,0.5077693938246032
STAT,1847,39,30-34,1886,3.9850471051782517
SIM,1896,23,15-19,1919,4
STAT,1853,35,45-49,1888,1.5094086711816703
SIM,1939,18,30-34,1957,12
STAT,1917,0,na,1917,4564.698827029815
SIM,1858,58,na,1916,1623
SIM,1863,33,20-24,1896,1
SIM,1922,22,15-19,1944,5
STAT,1898,46,30-34,1944,0.0700263764597611
STAT,1893,42,30-34,1935,1.3763141994372188
SIM,1877,61,na,1938,1811
STAT,1819,39,25-29,1858,6.355734885628802
STAT,1883,30,25-29,1913,9.55951852025901
STAT,1870,23,45-49,1893,0.6434947438518415
STAT,1830,108,na,1938,0.0010941827956136338
STAT,1851,40,30-34,1891,0.8515774988603367
STAT,1902,36,na,1938,3180.886802486522
STAT,1826,51,30-34,1877,0.005478657068805069
STAT,1839,46,20-24,1885,0.008257371178184893
STAT,1833,23,25-29,1856,47.6762312947256
SIM,1809,45,50-100,1854,2
STAT,1916,49,20-24,1965,0.010644908504459639
STAT,1834,39,50-100,1873,0.925863847771167
STAT,1894,75,na,1969,1634.502453659767
SIM,1857,35,25-29,1892,2
SIM,1921,2,na,1923,4288
STAT,1878,53,45-49,1931,0.01404311362193033
STAT,1923,31,50-100,1954,0.8991544393149022
SIM,1879,20,na,1899,2370
STAT,1916,9,na,1925,3976.8042695968584
STAT,1890,19,35-39,1909,0.6303750837151728
STAT,1850,66,na,1916,1153.866939973358
STAT,1950,12,na,1962,4388.128201024269
SIM,1862,36,45-49,1898,2
STAT,1838,45,20-24,1883,0.008638683536621018
STAT,1854,49,20-24,1903,0.008460710823143818
SIM,1877,72,na,1949,1184
SIM,1891,38,35-39,1929,17
SIM,1891,79,na,1970,1237
STAT,1894,21,40-44,1915,2.539931918796911
SIM,1866,24,40-44,1890,1
STAT,1895,38,na,1933,2890.042089473636
STAT,1854,36,45-49,1890,1.4424073990665143
STAT,1860,34,40-44,1894,3.3010497142795283
STAT,1848,52,20-24,1900,5.287844345942222E-4
STAT,1890,18,50-100,1908,0.05643868557476604
STAT,1827,30,40-44,1857,5.519719324401663
STAT,1786,81,na,1867,193.30904761998866
SIM,1855,39,30-34,1894,5
STAT,1934,38,na,1972,4899.525258187485
STAT,1883,38,35-39,1921,6.516104387350228
SIM,1904,19,35-39,1923,4
STAT,1900,58,na,1958,2653.998645460173
SIM,1897,35,25-29,1932,4
SIM,1892,31,25-29,1923,16
STAT,1921,20,40-44,1941,3.609406846939063
STAT,1825,50,30-34,1875,0.006260449896853121
SIM,1886,34,40-44,1920,2
SIM,1835,30,40-44,1865,3
STAT,1835,36,35-39,1871,5.512762924388722
STAT,1850,25,20-24,1875,9.860240367652679
STAT,1871,28,na,1899,2227.215222369066
SIM,1912,0,na,1912,3821
SIM,1844,40,35-39,1884,2
STAT,1829,43,20-24,1872,0.13158041298136833
STAT,1841,52,50-100,1893,0.010278165228400924
STAT,1848,43,30-34,1891,0.8222649715692987
SIM,1963,8,na,1971,4681
STAT,1923,46,35-39,1969,0.14285058023917352
SIM,1855,22,15-19,1877,2
SIM,1779,85,na,1864,82
STAT,1934,34,35-39,1968,11.771457838854042
STAT,1860,95,na,1955,10.207778180565123
SIM,1865,28,35-39,1893,9
STAT,1837,52,45-49,1889,0.009194588500145224
STAT,1888,38,50-100,1926,1.3633773321980371
SIM,1928,30,45-49,1958,1
STAT,1889,35,25-29,1924,3.389817704980317
SIM,1908,10,na,1918,3564
STAT,1934,6,na,1940,5121.365021228642
STAT,1873,49,30-34,1922,0.09088426681734656
SIM,1880,17,20-24,1897,13
SIM,1843,36,35-39,1879,11
STAT,1896,34,20-24,1930,3.345961736896763
STAT,1878,34,40-44,1912,4.228439950207985
SIM,1822,34,na,1856,1588
SIM,1847,66,na,1913,1140
SIM,1932,24,na,1956,4354
STAT,1884,46,na,1930,2106.278912243979
STAT,1774,107,na,1881,0.007473970516046492
SIM,1910,20,30-34,1930,32
SIM,1860,44,35-39,1904,4
STAT,1931,5,na,1936,4971.838765290875
STAT,1857,28,35-39,1885,7.348595790205745
STAT,1881,50,45-49,1931,0.013427638230068172
STAT,1915,46,na,1961,3505.5632705603252
SIM,1768,93,na,1861,5
SIM,1923,23,15-19,1946,5
SIM,1919,17,20-24,1936,156
STAT,1899,25,40-44,1924,3.9044076652462554
STAT,1915,23,15-19,1938,5.181644055791593
STAT,1873,41,20-24,1914,0.15297620196287076
SIM,1898,36,25-29,1934,5
STAT,1828,54,50-100,1882,0.010743583481965151
STAT,1871,16,20-24,1887,16.80978139501711
STAT,1806,50,20-24,1856,0.0021689303659755354
STAT,1836,40,35-39,1876,1.3956514578715205
STAT,1902,20,30-34,1922,23.88809695894216
STAT,1915,44,50-100,1959,0.11135199157416634
SIM,1919,13,na,1932,4119
SIM,1819,43,40-44,1862,6
SIM,1890,15,15-19,1905,7
STAT,1846,26,45-49,1872,0.9538968775211961
SIM,1920,21,na,1941,3790
SIM,1875,92,na,1967,143
SIM,1845,31,45-49,1876,1
STAT,1821,83,na,1904,214.372454135779
STAT,1835,43,45-49,1878,1.1046453973119374
SIM,1922,22,na,1944,3956
SIM,1834,70,na,1904,845
SIM,1942,22,40-44,1964,4
STAT,1834,27,50-100,1861,0.5192192753335256
SIM,1860,20,30-34,1880,20
STAT,1831,28,na,1859,1731.684547693016
STAT,1925,44,35-39,1969,0.22957174302271827
STAT,1850,32,30-34,1882,12.858330812753147
STAT,1875,45,40-44,1920,0.16781261442992237
STAT,1946,18,20-24,1964,142.01389855182973
STAT,1849,26,na,1875,1861.7301905694535
STAT,1946,21,20-24,1967,116.93616165160746
STAT,1852,40,40-44,1892,1.726181381749597
STAT,1904,62,na,1966,2702.6093803039494
SIM,1848,29,25-29,1877,56
STAT,1845,33,50-100,1878,0.7594401967110432
SIM,1818,42,40-44,1860,3
STAT,1888,26,50-100,1914,0.7163531296538843
STAT,1921,46,30-34,1967,0.09518148517707328
STAT,1849,30,25-29,1879,8.728411768711311
SIM,1865,26,20-24,1891,9
SIM,1918,33,50-100,1951,4
STAT,1906,16,50-100,1922,0.06755919222139037
STAT,1813,88,na,1901,58.060995933246595
SIM,1884,3,na,1887,2736
STAT,1929,29,50-100,1958,1.1757164503314723
STAT,1929,24,25-29,1953,109.66406612303788
SIM,1904,45,50-100,1949,1
STAT,1782,85,na,1867,75.95451667301629
STAT,1859,21,50-100,1880,0.35306549668931436
STAT,1873,48,40-44,1921,0.16210236524489854
SIM,1854,26,45-49,1880,1
STAT,1822,45,30-34,1867,0.13895551971769157
STAT,1887,65,na,1952,1785.4395212570898
SIM,1867,97,na,1964,14
STAT,1898,27,20-24,1925,15.002495886040338
SIM,1836,22,35-39,1858,4
STAT,1837,31,45-49,1868,1.3946168919034683
STAT,1853,16,35-39,1869,0.4924069710102549
STAT,1874,38,50-100,1912,1.1795446458981322
SIM,1843,43,45-49,1886,1
SIM,1897,32,20-24,1929,4
STAT,1793,108,na,1901,3.331659560128343E-4
STAT,1908,32,40-44,1940,3.48876693202361
SIM,1938,33,30-34,1971,21
STAT,1889,32,20-24,1921,3.152501740766601
SIM,1928,15,15-19,1943,49
SIM,1869,98,na,1967,16
STAT,1908,52,na,1960,3085.183313324741
STAT,1759,99,na,1858,0.14044831982979133
SIM,1852,32,na,1884,1889
STAT,1863,23,40-44,1886,1.7522365865924014
SIM,1871,23,40-44,1894,2
STAT,1917,22,50-100,1939,0.6606215270337891
SIM,1825,34,na,1859,1535
SIM,1922,32,25-29,1954,11
STAT,1903,29,50-100,1932,0.8536227944752793
STAT,1878,80,na,1958,714.046222529911
STAT,1885,44,50-100,1929,0.9808893833601823
STAT,1852,97,na,1949,4.081681129725274
STAT,1877,33,na,1910,2329.469218383143
STAT,1857,21,na,1878,1851.5967573293535
STAT,1899,32,50-100,1931,1.186183835781613
SIM,1908,29,20-24,1937,20
STAT,1905,32,15-19,1937,0.11162942926310476
SIM,1846,39,50-100,1885,1
STAT,1846,43,20-24,1889,0.1118875751884067
STAT,1807,70,na,1877,693.1635215704773
SIM,1920,35,25-29,1955,1
STAT,1899,44,50-100,1943,0.09369368149561227
STAT,1827,49,25-29,1876,0.04914036522049297
SIM,1924,37,na,1961,4155
SIM,1859,43,40-44,1902,3
STAT,1837,33,40-44,1870,3.39699231557078
STAT,1857,26,20-24,1883,9.06433569808523
STAT,1914,32,25-29,1946,8.787544388967433
STAT,1889,16,15-19,1905,6.938299263699328
STAT,1847,11,na,1858,2202.2862323264153
SIM,1937,24,25-29,1961,89
STAT,1861,33,45-49,1894,1.36221490041869
STAT,1859,34,30-34,1893,13.050610497919074
STAT,1914,43,20-24,1957,0.016502535891375087
SIM,1894,65,na,1959,2290
STAT,1858,25,25-29,1883,32.581553135242245
SIM,1845,33,40-44,1878,4
STAT,1911,39,25-29,1950,0.8891647753061263
SIM,1877,23,35-39,1900,4
STAT,1929,8,na,1937,4808.809650155951
STAT,1845,45,50-100,1890,0.17472075493036537
STAT,1870,27,50-100,1897,0.5921437282466467
STAT,1889,3,na,1892,3083.2051749111533
STAT,1844,46,20-24,1890,0.008448028099980456
SIM,1897,16,15-19,1913,7
SIM,1842,44,40-44,1886,7
STAT,1845,10,na,1855,2151.9299699999997
STAT,1852,20,30-34,1872,16.310278375695788
STAT,1863,21,45-49,1884,0.5948766670789388
STAT,1910,27,15-19,1937,0.6438105979430946
STAT,1831,38,35-39,1869,5.520352444445587
STAT,1912,35,25-29,1947,0.9162519856634813
SIM,1943,21,45-49,1964,1
STAT,1920,40,40-44,1960,0.2617061679132518
STAT,1934,22,40-44,1956,4.26860822188052
SIM,1932,32,na,1964,4604
STAT,1827,36,50-100,1863,1.2580342745189452
STAT,1904,29,40-44,1933,4.029452637821581
STAT,1887,27,45-49,1914,1.1730313883021966
STAT,1877,53,35-39,1930,0.00830409994605883
STAT,1930,33,20-24,1963,2.9720473123327196
STAT,1952,15,40-44,1967,1.5843728471299656
SIM,1876,24,30-34,1900,27
STAT,1927,25,na,1952,4332.031006377164
STAT,1930,39,35-39,1969,2.9742573922695636
SIM,1841,20,20-24,1861,68
SIM,1866,25,25-29,1891,38
SIM,1914,27,na,1941,3843
STAT,1925,41,50-100,1966,0.13457599763902525
SIM,1907,21,35-39,1928,9
STAT,1894,13,na,1907,3133.453024856067
SIM,1928,27,na,1955,4354
STAT,1875,20,25-29,1895,55.8905395991705
SIM,1869,66,na,1935,1451
STAT,1870,50,50-100,1920,0.014181055153202473
STAT,1856,29,50-100,1885,0.4834342768210689
STAT,1841,54,25-29,1895,0.0023567730628697684
STAT,1935,18,45-49,1953,0.6434108168123508
STAT,1843,42,25-29,1885,0.4770070126702256
STAT,1845,101,na,1946,0.4019366141515798
STAT,1903,43,45-49,1946,0.1386759851666449
STAT,1860,102,na,1962,0.715909401275012
STAT,1935,21,45-49,1956,1.4478670444777852
STAT,1833,46,45-49,1879,0.1703813743687875
STAT,1813,48,50-100,1861,0.7304108046419273
SIM,1836,71,na,1907,820
SIM,1912,29,40-44,1941,3
STAT,1877,3,na,1880,3005.2724272224
STAT,1920,5,na,1925,4261.794370029213
SIM,1932,17,30-34,1949,18
STAT,1857,13,na,1870,2080.1546284785077
STAT,1899,23,20-24,1922,88.93936845229992
SIM,1835,23,30-34,1858,18
STAT,1864,15,na,1879,2229.35698087015
SIM,1882,62,na,1944,1647
STAT,1858,41,30-34,1899,0.8564859486534092
STAT,1796,99,na,1895,0.4412188831122951
STAT,1907,42,35-39,1949,0.17425449600102838
SIM,1911,40,40-44,1951,2
SIM,1856,15,15-19,1871,4
SIM,1875,60,na,1935,1833
STAT,1853,39,25-29,1892,2.1137449862490385
STAT,1883,16,20-24,1899,16.454577879860885
SIM,1852,23,30-34,1875,20
STAT,1854,70,na,1924,1010.3456344880902
STAT,1872,10,na,1882,2526.9057193846106
SIM,1822,32,20-24,1854,2
STAT,1909,28,45-49,1937,1.553855900126286
SIM,1915,17,30-34,1932,1
STAT,1832,47,40-44,1879,0.12271922788878903
STAT,1871,32,35-39,1903,9.484437361484726
STAT,1924,42,35-39,1966,0.2262934790244459
STAT,1780,76,na,1856,298.6616481489
STAT,1858,60,na,1918,1414.420926511441
STAT,1834,44,40-44,1878,1.6359958316953405
STAT,1871,52,45-49,1923,0.013519151779927423
SIM,1934,19,20-24,1953,155
STAT,1926,19,20-24,1945,156.2049738833875
STAT,1868,27,35-39,1895,8.703111852562131
STAT,1858,50,20-24,1908,5.55127267604382E-4
SIM,1836,28,na,1864,1744
SIM,1816,73,na,1889,476
SIM,1918,49,na,1967,3641
SIM,1861,92,na,1953,23
SIM,1880,46,50-100,1926,3
STAT,1915,42,25-29,1957,0.06791049851099384
STAT,1935,20,na,1955,4700.809494350718
STAT,1909,31,45-49,1940,1.423993869703276
SIM,1873,15,15-19,1888,7
SIM,1895,27,45-49,1922,1
STAT,1907,17,30-34,1924,2.2114413244704036
STAT,1885,84,na,1969,616.2066304859741
STAT,1841,20,na,1861,1880.0902847622654
STAT,1865,15,15-19,1880,5.83754555289468
SIM,1828,36,45-49,1864,1
SIM,1880,39,35-39,1919,18
STAT,1904,43,20-24,1947,0.014833466104511518
STAT,1812,49,na,1861,1282.8923273152234
STAT,1915,32,na,1947,3638.500063656044
STAT,1839,25,15-19,1864,0.38663461768531154
STAT,1859,44,45-49,1903,1.1131231082758657
STAT,1932,26,na,1958,4637.492020829247
STAT,1854,78,na,1932,562.6331699671176
SIM,1920,25,50-100,1945,1
SIM,1926,21,45-49,1947,1
STAT,1821,41,35-39,1862,3.1159700521535583
STAT,1848,31,20-24,1879,2.2946568756685974
STAT,1878,82,na,1960,616.0170996587666
STAT,1875,50,20-24,1925,7.264706124857971E-4
SIM,1898,31,25-29,1929,18
STAT,1803,64,na,1867,826.039928914825
STAT,1929,38,na,1967,4558.56583191412
SIM,1878,27,45-49,1905,1
STAT,1817,105,na,1922,0.013002639001573935
SIM,1879,19,30-34,1898,3
STAT,1865,43,30-34,1908,0.9797974172001861
STAT,1924,17,30-34,1941,13.713380487539425
SIM,1827,65,na,1892,889
SIM,1867,44,45-49,1911,2
SIM,1873,43,30-34,1916,4
STAT,1872,39,35-39,1911,6.639061896129062
SIM,1878,35,na,1913,2407
STAT,1791,68,na,1859,663.9313819753279
SIM,1882,40,na,1922,2127
STAT,1881,43,15-19,1924,0.012505558217541478
SIM,1927,19,15-19,1946,45
STAT,1874,33,30-34,1907,16.786767307265798
SIM,1869,37,45-49,1906,2
STAT,1821,85,na,1906,148.03223102426242
SIM,1887,4,na,1891,2736
STAT,1861,50,35-39,1911,0.006850658155316694
SIM,1887,18,na,1905,2639
STAT,1809,53,45-49,1862,0.04931324086968415
STAT,1954,7,na,1961,4590.270194999499
SIM,1857,30,25-29,1887,18
STAT,1859,15,30-34,1874,1.4114502564695872
SIM,1929,24,20-24,1953,132
SIM,1876,0,na,1876,3482
SIM,1916,32,40-44,1948,3
STAT,1899,21,25-29,1920,74.33468738364964
STAT,1870,94,na,1964,53.812680163060726
SIM,1827,43,na,1870,1448
SIM,1901,33,35-39,1934,14
SIM,1815,42,30-34,1857,6
SIM,1872,3,na,1875,2797
SIM,1931,39,na,1970,4680
STAT,1860,51,30-34,1911,0.004591993779151503
SIM,1829,91,na,1920,22
STAT,1824,42,30-34,1866,1.4543025951626374
SIM,1910,43,na,1953,3210
SIM,1917,31,45-49,1948,2
STAT,1857,35,na,1892,1771.279624479445
SIM,1892,64,na,1956,2083
STAT,1923,41,na,1964,4107.018882499824
SIM,1903,33,na,1936,3224
SIM,1766,89,na,1855,32
SIM,1856,31,20-24,1887,3
STAT,1933,32,35-39,1965,11.634133155398432
SIM,1816,51,na,1867,1212
SIM,1906,27,30-34,1933,45
SIM,1891,29,50-100,1920,5
STAT,1891,33,30-34,1924,20.32961044553439
STAT,1820,58,na,1878,1129.0865490680999
STAT,1876,44,45-49,1920,1.4399044667505065
STAT,1808,54,40-44,1862,0.036785041278462195
STAT,1904,49,35-39,1953,0.10475870459688875
STAT,1919,19,15-19,1938,47.12442816385583
STAT,1891,0,na,1891,3433.4780163613746
SIM,1863,39,35-39,1902,13
SIM,1882,33,30-34,1915,19
STAT,1868,30,35-39,1898,9.207804409562392
STAT,1819,40,50-100,1859,2.217844407392228
STAT,1884,15,25-29,1899,5.314694736638851
SIM,1898,55,na,1953,2618
STAT,1910,33,35-39,1943,8.286441936020921
SIM,1870,42,35-39,1912,3
STAT,1854,56,na,1910,1468.7286790930486
STAT,1855,110,na,1965,0.0012282710424354054
STAT,1908,16,35-39,1924,0.7706465441082555
SIM,1849,78,na,1927,504
SIM,1857,87,na,1944,110
SIM,1884,44,45-49,1928,2
SIM,1832,42,30-34,1874,4
STAT,1838,42,50-100,1880,0.8426552909701274
SIM,1907,57,na,1964,2986
STAT,1885,47,20-24,1932,0.011241498827114952
SIM,1831,45,50-100,1876,2
STAT,1862,42,35-39,1904,1.4574257093473002
STAT,1867,31,30-34,1898,15.550066514054404
SIM,1770,94,na,1864,2
STAT,1848,15,15-19,1863,5.362968806909337
STAT,1923,43,30-34,1966,0.14095060264472878
STAT,1803,86,na,1889,71.92161192364725
STAT,1938,30,50-100,1968,0.7861610355039444
STAT,1884,40,20-24,1924,0.14975425273190152
STAT,1844,23,30-34,1867,15.500443163994387
SIM,1877,10,na,1887,2554
SIM,1911,30,na,1941,3533
STAT,1883,37,45-49,1920,1.84570377822885
STAT,1810,91,na,1901,26.2414850570529
SIM,1822,38,35-39,1860,13
STAT,1881,29,35-39,1910,8.738308059638017
STAT,1905,42,25-29,1947,0.0608010203371524
STAT,1936,24,50-100,1960,0.5937741215057547
SIM,1909,38,na,1947,3331
STAT,1850,35,35-39,1885,5.164348277679095
STAT,1927,24,50-100,1951,0.7611399208324626
SIM,1854,23,40-44,1877,2
SIM,1851,17,na,1868,2070
STAT,1863,26,45-49,1889,0.9286787075231847
SIM,1942,25,45-49,1967,2
SIM,1847,63,na,1910,1241
STAT,1834,58,na,1892,1224.0465873362286
STAT,1855,1,na,1856,2674.134955405642
STAT,1896,17,45-49,1913,0.08155725142238766
STAT,1905,22,na,1927,3228.658925435482
STAT,1894,23,50-100,1917,0.49402390242841854
SIM,1948,22,35-39,1970,9
STAT,1898,42,15-19,1940,0.0012248632939584345
SIM,1779,88,na,1867,46
STAT,1950,22,25-29,1972,103.52672403772948
SIM,1880,81,na,1961,743
SIM,1866,35,50-100,1901,1
STAT,1829,26,45-49,1855,2.0349053292349515
SIM,1835,42,40-44,1877,6
SIM,1871,26,45-49,1897,1
STAT,1925,38,15-19,1963,0.021754244305284737
STAT,1793,106,na,1899,0.002208410543631497
STAT,1846,23,40-44,1869,1.7998183741498828
STAT,1890,31,na,1921,2767.5175242916257
STAT,1820,49,15-19,1869,6.404703244202342E-4
STAT,1864,19,15-19,1883,5.122479695112372
STAT,1868,47,20-24,1915,0.0107732640511745
STAT,1867,22,50-100,1889,0.3632003831305286
SIM,1880,33,20-24,1913,2
SIM,1928,41,na,1969,4475
SIM,1937,21,20-24,1958,91
SIM,1849,44,na,1893,1689
STAT,1825,54,40-44,1879,0.01022642146458244
STAT,1921,29,40-44,1950,4.872788219499831
STAT,1864,22,15-19,1886,2.8301930582686725
STAT,1912,33,45-49,1945,1.4562397220722614
SIM,1819,56,na,1875,1144
SIM,1849,46,na,1895,1670
SIM,1933,16,35-39,1949,5
STAT,1869,23,35-39,1892,5.319688894594869
STAT,1898,57,na,1955,2569.9702490469645
SIM,1878,89,na,1967,331
STAT,1816,46,45-49,1862,0.6314019879224656
STAT,1925,16,35-39,1941,4.800939731409506
SIM,1872,19,15-19,1891,4
STAT,1894,33,40-44,1927,5.247826086300183
SIM,1891,37,45-49,1928,2
STAT,1857,29,25-29,1886,31.985323421774925
STAT,1929,21,20-24,1950,133.2467466565804
STAT,1892,45,40-44,1937,0.11538318203883996
STAT,1942,9,na,1951,3901.424238057978
STAT,1868,43,40-44,1911,2.0141395862949247
SIM,1882,21,20-24,1903,61
STAT,1859,40,35-39,1899,1.3789924876124127
SIM,1937,18,20-24,1955,101
STAT,1931,35,35-39,1966,3.031462276778763
STAT,1929,18,20-24,1947,163.0344302022891
STAT,1859,37,35-39,1896,5.332449101872644
STAT,1901,40,30-34,1941,0.10663039399225105
STAT,1934,25,45-49,1959,2.197387850970257
STAT,1836,59,na,1895,1227.2762892954906
STAT,1870,53,40-44,1923,0.009588655542246293
SIM,1865,29,25-29,1894,40
SIM,1900,21,25-29,1921,72
SIM,1898,23,na,1921,2982
SIM,1872,86,na,1958,221
STAT,1865,101,na,1966,2.51637860310359
STAT,1937,35,na,1972,3559.6281293468855
SIM,1854,47,na,1901,1755
STAT,1865,64,na,1929,1492.2847998617378
STAT,1880,47,50-100,1927,0.2429878842998166
SIM,1903,39,40-44,1942,2
STAT,1931,32,25-29,1963,11.441327012043823
SIM,1874,11,na,1885,2532
STAT,1872,33,20-24,1905,2.552230476604197
SIM,1908,49,50-100,1957,1
STAT,1830,46,50-100,1876,0.18234607686476179
STAT,1918,21,45-49,1939,1.1498462358472237
SIM,1879,76,na,1955,882
STAT,1816,53,na,1869,1259.997560368213
SIM,1839,39,25-29,1878,1
SIM,1856,48,na,1904,1774
STAT,1914,46,25-29,1960,0.0498134470422856
SIM,1866,22,20-24,1888,62
SIM,1773,83,na,1856,117
SIM,1872,22,15-19,1894,3
SIM,1920,33,45-49,1953,2
SIM,1962,9,na,1971,4679
SIM,1846,89,na,1935,64
STAT,1837,36,45-49,1873,1.5481611703432823
STAT,1952,18,45-49,1970,0.5653664731563198
SIM,1884,33,50-100,1917,1
SIM,1859,30,35-39,1889,10
STAT,1831,42,na,1873,1562.8641830271597
STAT,1818,62,na,1880,991.745271520833
STAT,1842,30,15-19,1872,0.12507689232593128
STAT,1838,29,20-24,1867,10.032404513179706
STAT,1865,31,20-24,1896,2.3299095474661478
SIM,1809,46,na,1855,1331
SIM,1846,29,20-24,1875,12
STAT,1906,16,25-29,1922,7.814348144096968
STAT,1822,48,35-39,1870,0.19252563357938318
SIM,1861,78,na,1939,584
STAT,1832,77,na,1909,522.6620784482897
SIM,1841,40,na,1881,1713
STAT,1908,35,45-49,1943,0.608555954410022
SIM,1892,15,25-29,1907,7
SIM,1943,15,40-44,1958,1
SIM,1850,36,45-49,1886,1
STAT,1868,15,40-44,1883,0.16995756091298
STAT,1918,18,45-49,1936,0.512291817380481
STAT,1884,20,50-100,1904,0.3829599486802893
STAT,1935,15,40-44,1950,1.8146754422329088
SIM,1848,26,20-24,1874,11
SIM,1861,32,40-44,1893,3
STAT,1946,24,25-29,1970,97.04079722651758
STAT,1850,54,40-44,1904,0.007207678564105375
STAT,1840,42,15-19,1882,0.010032346226437044
STAT,1941,17,30-34,1958,11.85937386650216
SIM,1837,26,45-49,1863,2
STAT,1889,74,na,1963,1540.3059877527094
SIM,1785,70,na,1855,517
SIM,1896,14,na,1910,3284
STAT,1851,44,40-44,1895,1.627166723292735
SIM,1830,88,na,1918,70
STAT,1858,22,20-24,1880,58.63870162034787
STAT,1831,35,30-34,1866,4.308363877629394
SIM,1811,50,na,1861,1256
STAT,1915,54,na,1969,3405.616734939913
SIM,1834,45,na,1879,1488
SIM,1844,39,25-29,1883,4
STAT,1924,32,25-29,1956,10.187760780815086
STAT,1926,40,35-39,1966,0.23519216250674735
SIM,1845,62,na,1907,1292
STAT,1848,36,20-24,1884,0.5782598245837367
SIM,1917,19,20-24,1936,145
SIM,1866,16,na,1882,2295
SIM,1864,35,na,1899,2127
STAT,1841,52,na,1893,1465.336712289509
STAT,1921,36,50-100,1957,0.44331540162249244
STAT,1839,48,na,1887,1508.982518925888
SIM,1902,20,45-49,1922,5
STAT,1844,49,25-29,1893,0.039591461283667286
STAT,1853,32,40-44,1885,3.311961100012971
SIM,1932,32,25-29,1964,16
SIM,1845,36,45-49,1881,1
STAT,1870,16,35-39,1886,0.5157998551801577
STAT,1849,77,na,1926,623.0459316925694
STAT,1931,22,15-19,1953,6.522360579950815
SIM,1917,25,40-44,1942,6
STAT,1895,52,na,1947,2640.366166118383
SIM,1841,58,na,1899,1374
STAT,1830,39,30-34,1869,4.11707394336746
STAT,1870,7,na,1877,2541.7306971848266
STAT,1948,18,30-34,1966,13.174267345569907
STAT,1844,17,na,1861,2048.3931611001713
SIM,1871,70,na,1941,1259
SIM,1872,19,20-24,1891,20
SIM,1852,26,35-39,1878,8
STAT,1832,106,na,1938,0.00734157626248234
STAT,1889,37,20-24,1926,0.8990194773574532
SIM,1897,37,20-24,1934,1
STAT,1831,32,20-24,1863,2.2178507461172887
STAT,1940,21,na,1961,3515.125797006074
STAT,1844,26,35-39,1870,8.352042037341848
STAT,1905,45,35-39,1950,0.1088833940264602
STAT,1917,8,na,1925,4041.1395837655864
STAT,1902,46,20-24,1948,0.009049700355187753
SIM,1864,40,45-49,1904,3
SIM,1791,88,na,1879,47
SIM,1867,41,40-44,1908,8
STAT,1829,71,na,1900,818.1642272018959
STAT,1806,75,na,1881,414.47856636944584
STAT,1867,19,40-44,1886,0.16390495057908827
STAT,1858,53,25-29,1911,0.0025846845723742047
STAT,1947,17,25-29,1964,46.11833749259639
SIM,1895,24,40-44,1919,3
STAT,1839,53,30-34,1892,0.0039052674985534776
SIM,1901,30,30-34,1931,23
SIM,1875,31,30-34,1906,29
STAT,1850,40,15-19,1890,0.00982025206465026
STAT,1891,36,35-39,1927,8.310220597140729
STAT,1892,12,na,1904,3055.1258216474134
STAT,1842,50,25-29,1892,0.0025585586379682133
SIM,1823,53,na,1876,1197
SIM,1828,33,40-44,1861,3
SIM,1863,59,na,1922,1669
STAT,1914,48,40-44,1962,0.14727887827655256
SIM,1858,29,na,1887,1947
SIM,1854,98,na,1952,1
STAT,1867,51,40-44,1918,0.009382709101685448
STAT,1875,40,na,1915,2265.7802209968695
SIM,1872,30,na,1902,2243
SIM,1890,30,45-49,1920,3
STAT,1915,22,30-34,1937,28.063752082526577
SIM,1913,11,na,1924,3697
STAT,1899,26,25-29,1925,54.951924884692
SIM,1935,24,15-19,1959,10
STAT,1840,28,35-39,1868,8.318296440400978
STAT,1887,24,40-44,1911,2.187754789553719
SIM,1844,23,na,1867,1929
STAT,1809,51,na,1860,1256.4450532745393
STAT,1927,24,15-19,1951,6.15762125065
STAT,1802,53,35-39,1855,0.024050929000549108
STAT,1937,31,20-24,1968,2.280733775500561
SIM,1885,20,35-39,1905,9
STAT,1890,40,45-49,1930,1.7461026376824476
STAT,1824,45,35-39,1869,0.16924285200644448
STAT,1840,56,na,1896,1420.4352058905354
SIM,1923,22,30-34,1945,42
STAT,1848,92,na,1940,30.00521787490134
SIM,1899,16,25-29,1915,7
STAT,1827,45,na,1872,1438.3787866852729
STAT,1829,49,35-39,1878,0.1100506269710355
STAT,1937,28,20-24,1965,16.799276743116113
STAT,1918,40,45-49,1958,0.16762465564102466
STAT,1818,36,35-39,1854,26.366079362248698
SIM,1929,27,25-29,1956,91
SIM,1799,76,na,1875,340
SIM,1813,47,50-100,1860,3
STAT,1880,53,na,1933,2105.881356617462
STAT,1857,47,45-49,1904,0.17494177553179424
SIM,1800,98,na,1898,1
SIM,1876,43,40-44,1919,6
SIM,1834,30,30-34,1864,21
SIM,1906,23,15-19,1929,4
STAT,1827,42,40-44,1869,2.0691955230472536
STAT,1893,21,30-34,1914,21.414545612366247
STAT,1836,52,35-39,1888,0.005500744843257613
STAT,1818,45,50-100,1863,0.5414800669249374
STAT,1855,16,45-49,1871,0.05535220143509361
STAT,1872,36,30-34,1908,5.077840798975114
STAT,1833,25,20-24,1858,9.610710324207654
STAT,1865,52,20-24,1917,6.300908359044877E-4
STAT,1824,40,na,1864,1488.1861917699803
SIM,1819,41,45-49,1860,2
STAT,1878,32,45-49,1910,1.71496633779227
STAT,1956,14,na,1970,4907.985700982449
STAT,1884,43,25-29,1927,0.5951485939617275
STAT,1775,97,na,1872,0.833676373858895
STAT,1898,35,na,1933,3041.5008125283766
SIM,1841,25,20-24,1866,11
STAT,1914,35,50-100,1949,0.39970609063656926
SIM,1935,21,na,1956,4685
STAT,1816,40,50-100,1856,3.4196130328044716
STAT,1887,44,20-24,1931,0.16552062789932143
STAT,1864,50,45-49,1914,0.01242906796311525
STAT,1865,46,35-39,1911,0.1205234967837479
STAT,1817,52,25-29,1869,0.007590606366248276
SIM,1889,27,20-24,1916,16
SIM,1869,34,40-44,1903,6
STAT,1852,46,na,1898,1714.2200159816794
SIM,1900,31,35-39,1931,18
STAT,1872,75,na,1947,976.1383146868255
STAT,1933,21,35-39,1954,11.834708528923105
SIM,1886,32,45-49,1918,4
STAT,1910,40,50-100,1950,0.10604503275093405
SIM,1823,75,na,1898,555
SIM,1819,100,na,1919,1
SIM,1837,18,15-19,1855,7
STAT,1826,30,30-34,1856,26.34995834463425
SIM,1854,76,na,1930,652
STAT,1909,25,40-44,1934,4.2715604350601915
SIM,1873,18,na,1891,2418
STAT,1887,43,na,1930,2424.1776325837204
STAT,1835,32,na,1867,1721.469281179409
STAT,1945,22,na,1967,3780.9559450642137
STAT,1851,42,50-100,1893,0.773759734440874
STAT,1862,46,15-19,1908,3.232500300751373E-4
STAT,1822,99,na,1921,0.9782447098245192
STAT,1837,98,na,1935,2.0506666586601145
STAT,1848,19,30-34,1867,1.406720887406115
SIM,1852,10,na,1862,2292
STAT,1829,89,na,1918,64.39241379364961
SIM,1879,23,45-49,1902,1
STAT,1842,103,na,1945,0.10219885239598454
SIM,1880,36,30-34,1916,10
STAT,1883,31,15-19,1914,0.13238940654934028
STAT,1838,32,15-19,1870,0.12069099115138654
STAT,1862,31,50-100,1893,0.7413626761823907
STAT,1869,18,50-100,1887,0.04515281920074718
STAT,1893,41,40-44,1934,2.7082168878225814
STAT,1838,29,15-19,1867,0.38799354781954587
SIM,1893,31,40-44,1924,6
STAT,1816,40,15-19,1856,0.04470082722467534
SIM,1826,40,40-44,1866,4
SIM,1915,20,na,1935,3511
STAT,1883,51,25-29,1934,0.0032951240830397617
SIM,1840,40,50-100,1880,2
STAT,1864,19,20-24,1883,15.302597550423386
SIM,1856,19,30-34,1875,1
STAT,1826,50,40-44,1876,0.009883716919794444
STAT,1916,39,50-100,1955,0.40207483927976645
SIM,1852,64,na,1916,1309
STAT,1844,49,na,1893,1546.4320258656899
STAT,1856,41,20-24,1897,0.11803648913003699
STAT,1887,11,na,1898,2732.483311402952
STAT,1910,23,na,1933,3374.0682319794955
STAT,1935,30,35-39,1965,11.956536234010333
SIM,1925,11,na,1936,4432
SIM,1831,81,na,1912,283
SIM,1906,29,50-100,1935,5
STAT,1899,45,35-39,1944,0.10325704057296041
STAT,1810,99,na,1909,0.857631676825808
STAT,1936,35,20-24,1971,0.24485829410136722
STAT,1904,32,50-100,1936,0.7127835859701185
STAT,1927,45,50-100,1972,0.26950281864513115
STAT,1866,37,45-49,1903,1.736305061647669
STAT,1922,42,25-29,1964,0.07743593041924159
SIM,1861,40,35-39,1901,1
STAT,1928,21,na,1949,4320.718008173249
SIM,1796,97,na,1893,2
STAT,1912,30,40-44,1942,3.666108138374612
SIM,1862,44,50-100,1906,3
SIM,1870,31,50-100,1901,4
STAT,1863,43,20-24,1906,0.13092782359804395
SIM,1891,19,25-29,1910,12
STAT,1863,81,na,1944,449.0581905761356
SIM,1903,19,na,1922,3343
STAT,1872,48,25-29,1920,0.05393019470738825
SIM,1825,87,na,1912,69
SIM,1837,23,40-44,1860,2
STAT,1850,31,na,1881,1775.7590300318968
STAT,1867,96,na,1963,21.718748707160614
STAT,1901,43,35-39,1944,0.1650720002770946
STAT,1800,81,na,1881,211.01306518456965
STAT,1905,23,25-29,1928,77.90767614191255
SIM,1874,37,45-49,1911,3
STAT,1842,54,40-44,1896,0.007290712674061582
STAT,1832,91,na,1923,35.03864129605485
STAT,1872,54,50-100,1926,0.013926658640445335
SIM,1865,31,na,1896,2034
STAT,1892,20,25-29,1912,68.12601478145675
SIM,1792,72,na,1864,463
STAT,1859,18,35-39,1877,0.4773735545302653
STAT,1829,57,na,1886,1261.6690240915382
STAT,1881,26,30-34,1907,23.048343528542038
STAT,1797,106,na,1903,0.002956320602524264
STAT,1911,48,30-34,1959,0.07948739187996981
STAT,1870,47,20-24,1917,0.011056248096225879
SIM,1850,86,na,1936,132
STAT,1841,37,40-44,1878,3.52875837322247
STAT,1853,52,35-39,1905,0.006350557512081013
SIM,1822,35,30-34,1857,10
STAT,1910,21,40-44,1931,2.9910585270100953
STAT,1868,18,45-49,1886,0.05963286572635231
SIM,1873,50,50-100,1923,1
SIM,1801,74,na,1875,442
STAT,1865,96,na,1961,16.60857663963176
SIM,1882,38,50-100,1920,4
STAT,1918,15,40-44,1933,0.2898826011490671
STAT,1856,0,na,1856,2943.930857015849
STAT,1845,41,45-49,1886,1.0873589989147219
STAT,1876,59,na,1935,1895.373902324179
SIM,1803,84,na,1887,80
SIM,1852,42,40-44,1894,5
SIM,1835,94,na,1929,12
STAT,1962,1,na,1963,4764.763232921458
STAT,1865,19,na,1884,2207.939736308495
SIM,1937,21,na,1958,3235
SIM,1856,39,25-29,1895,2
STAT,1849,51,25-29,1900,0.0025652657810251874
STAT,1768,95,na,1863,1.4384621993979096
STAT,1878,69,na,1947,1443.2592481487654
STAT,1925,35,45-49,1960,0.7743954942779437
SIM,1807,77,na,1884,310
SIM,1832,30,20-24,1862,4
STAT,1933,7,na,1940,5055.096771910941
STAT,1876,56,na,1932,1989.1640842912373
STAT,1808,87,na,1895,68.47887948751617
STAT,1860,42,25-29,1902,0.4924152833844674
STAT,1793,91,na,1884,18.564422541423106
STAT,1878,37,na,1915,2316.991695113045
STAT,1866,49,na,1915,1918.671970290108
SIM,1788,68,na,1856,672
SIM,1914,32,30-34,1946,23
STAT,1860,49,45-49,1909,0.1774081472132407
STAT,1843,33,35-39,1876,8.692753567041281
STAT,1859,41,40-44,1900,1.7034572868556692
SIM,1849,29,40-44,1878,2
SIM,1859,22,na,1881,2061
STAT,1909,40,35-39,1949,0.17989872302102222
SIM,1829,29,20-24,1858,13
SIM,1871,56,na,1927,1935
STAT,1844,42,40-44,1886,1.6171720361153104
STAT,1920,46,15-19,1966,3.8565580559101566E-4
STAT,1813,51,45-49,1864,0.042747104837992454
STAT,1860,30,30-34,1890,13.512617156107328
STAT,1891,21,20-24,1912,80.82312016090073
STAT,1841,45,35-39,1886,0.09871843437532464
STAT,1879,33,15-19,1912,0.14002449823590027
SIM,1763,92,na,1855,2
STAT,1880,42,45-49,1922,1.4858264263863707
SIM,1850,54,na,1904,1543
STAT,1821,45,15-19,1866,6.289649435562358E-4
STAT,1821,51,na,1872,1324.6619036708041
STAT,1921,43,20-24,1964,0.01876306095541734
STAT,1853,36,20-24,1889,0.5776345374299975
STAT,1848,39,25-29,1887,2.0936129456583905
STAT,1824,30,20-24,1854,8.884330580480091
STAT,1856,53,30-34,1909,0.004333540544258872
STAT,1874,44,na,1918,2201.4527949752614
STAT,1922,49,45-49,1971,0.2345063803166264
STAT,1793,94,na,1887,4.259109991429287
STAT,1906,32,30-34,1938,13.790990240059953
STAT,1902,49,25-29,1951,0.04241118246778022
STAT,1844,46,na,1890,1583.8931134617133
SIM,1917,47,50-100,1964,1
STAT,1893,29,na,1922,2840.0802685009635
STAT,1910,43,45-49,1953,0.14765533650867882
STAT,1940,25,35-39,1965,14.47413632690546
STAT,1843,39,50-100,1882,0.9216436096778479
SIM,1803,52,na,1855,1117
STAT,1891,48,na,1939,2598.181415306213
SIM,1859,24,30-34,1883,13
SIM,1929,26,na,1955,4481
STAT,1776,90,na,1866,24.131428163639672
SIM,1866,41,30-34,1907,4
SIM,1913,23,25-29,1936,91
STAT,1879,14,na,1893,2541.7968699959742
STAT,1892,27,45-49,1919,1.3134961290863807
SIM,1803,87,na,1890,41
SIM,1920,30,40-44,1950,3
SIM,1898,16,30-34,1914,1
STAT,1822,42,20-24,1864,0.23951847996796116
STAT,1909,19,20-24,1928,24.97520039393005
STAT,1799,85,na,1884,91.15613178483638
STAT,1846,27,na,1873,1845.1904735497544
STAT,1866,22,50-100,1888,0.35808106416217306
SIM,1835,36,50-100,1871,2
SIM,1786,87,na,1873,43
STAT,1834,51,50-100,1885,0.009777222151461772
STAT,1912,39,40-44,1951,1.3660661953962334
STAT,1851,40,25-29,1891,0.47565590221047577
STAT,1825,36,45-49,1861,2.658203037492707
STAT,1880,21,45-49,1901,0.695229183494341
SIM,1920,39,40-44,1959,1
STAT,1900,33,40-44,1933,5.65967019949639
SIM,1949,5,na,1954,4305
STAT,1910,22,45-49,1932,0.9979089981485109
SIM,1889,41,na,1930,2717
SIM,1940,25,35-39,1965,18
STAT,1847,50,45-49,1897,0.01083151863137041
SIM,1796,65,na,1861,778
STAT,1815,52,30-34,1867,0.013844806041495572
STAT,1851,19,na,1870,2022.5295636749465
SIM,1847,12,na,1859,2127
STAT,1842,18,25-29,1860,5.151396462981438
SIM,1850,18,25-29,1868,8
STAT,1817,43,35-39,1860,4.396680221968755
STAT,1913,49,50-100,1962,0.20728205961544388
STAT,1937,34,25-29,1971,8.626152297523435
STAT,1920,43,45-49,1963,0.1733796336406571
STAT,1823,45,50-100,1868,0.3015501529647233
SIM,1934,4,na,1938,5092
STAT,1850,34,na,1884,1721.2947681450926
STAT,1883,52,50-100,1935,0.01390869963107407
SIM,1928,34,25-29,1962,11
STAT,1901,42,50-100,1943,0.0968864318857507
SIM,1902,56,na,1958,2799
STAT,1892,63,na,1955,2110.844034606274
SIM,1928,19,30-34,1947,18
SIM,1960,10,na,1970,4667
STAT,1854,45,50-100,1899,0.17861831163635525
SIM,1878,19,15-19,1897,5
STAT,1943,10,na,1953,3946.879709599173
STAT,1840,25,30-34,1865,22.183611268656318
SIM,1939,11,na,1950,3680
STAT,1921,18,na,1939,3953.489505754556
STAT,1921,24,20-24,1945,117.91391965200529
SIM,1805,65,na,1870,821
STAT,1847,29,50-100,1876,0.5576367118939832
STAT,1890,45,15-19,1935,4.666164623168627E-4
STAT,1831,47,25-29,1878,0.04234970168285084
STAT,1910,26,na,1936,3428.11507074993
STAT,1842,36,45-49,1878,1.6826645492340209
STAT,1887,47,30-34,1934,0.10179208085162345
STAT,1921,25,25-29,1946,69.77590525207998
STAT,1852,12,na,1864,2193.670278306944
STAT,1893,44,45-49,1937,0.12289039354617994
STAT,1897,42,20-24,1939,0.013916172941755074
STAT,1879,18,20-24,1897,17.459855675578794
SIM,1879,34,na,1913,2316
SIM,1915,23,na,1938,3478
SIM,1857,15,30-34,1872,2
SIM,1860,61,na,1921,1547
STAT,1827,46,20-24,1873,0.010654331059109911
SIM,1861,49,na,1910,1885
STAT,1867,54,45-49,1921,0.01251853248306696
SIM,1851,33,35-39,1884,11
SIM,1868,81,na,1949,432
STAT,1890,63,na,1953,2060.9196067445114
STAT,1906,35,35-39,1941,2.1199876192403804
STAT,1927,37,50-100,1964,0.493190167292409
STAT,1936,19,15-19,1955,40.81934313230448
STAT,1850,20,20-24,1870,59.074986642107554
SIM,1837,75,na,1912,603
SIM,1935,3,na,1938,5209
STAT,1861,26,na,1887,1899.4112821954577
STAT,1936,36,25-29,1972,0.9138201074879696
SIM,1869,17,15-19,1886,5
SIM,1947,24,15-19,1971,5
STAT,1900,31,25-29,1931,13.478708301458058
STAT,1892,41,na,1933,2746.5839866596243
STAT,1915,44,40-44,1959,0.2370778521660547
STAT,1939,4,na,1943,3807.9709470866023
STAT,1877,37,20-24,1914,0.7556762517084393
SIM,1938,18,na,1956,3369
STAT,1826,53,45-49,1879,0.012837344936482408
SIM,1849,22,20-24,1871,51
SIM,1944,19,15-19,1963,46
SIM,1922,32,30-34,1954,28
SIM,1895,69,na,1964,2045
STAT,1912,46,15-19,1958,3.351947149559052E-4
STAT,1779,87,na,1866,53.65208839597781
STAT,1883,29,50-100,1912,0.5880370785259547
STAT,1939,24,15-19,1963,5.046316150208946
SIM,1847,34,na,1881,1758
STAT,1825,64,na,1889,991.7945567326243
SIM,1897,70,na,1967,2063
STAT,1768,107,na,1875,0.004694252770500965
STAT,1849,15,30-34,1864,1.4309456272672996
SIM,1794,87,na,1881,48
STAT,1829,46,30-34,1875,0.07913508769773638
SIM,1890,43,30-34,1933,5
STAT,1812,51,35-39,1863,0.027640959276441664
STAT,1883,19,25-29,1902,5.218500857994364
SIM,1860,93,na,1953,20
SIM,1903,32,20-24,1935,1
STAT,1851,26,45-49,1877,0.9602135346370888
SIM,1812,66,na,1878,771
STAT,1896,37,30-34,1933,6.6541495253013965
STAT,1893,26,na,1919,2870.3415440754115
SIM,1902,34,na,1936,3203
SIM,1922,29,30-34,1951,44
SIM,1885,2,na,1887,2814
STAT,1943,18,na,1961,3685.9709960458763
STAT,1932,25,35-39,1957,18.593624471862935
STAT,1855,86,na,1941,157.1408765954426
SIM,1856,57,na,1913,1568
SIM,1900,2,na,1902,3451
STAT,1874,18,50-100,1892,0.04717926927867958
STAT,1914,32,30-34,1946,14.979397499684204
STAT,1882,43,30-34,1925,1.0491982813208927
STAT,1898,48,45-49,1946,0.16810301605801056
SIM,1825,43,35-39,1868,7
SIM,1899,45,50-100,1944,2
STAT,1831,54,30-34,1885,0.003700475115947237
SIM,1923,44,40-44,1967,3
STAT,1901,19,50-100,1920,0.06443391310581074
SIM,1814,92,na,1906,11
SIM,1887,63,na,1950,1814
STAT,1836,19,45-49,1855,0.07764232395183411
STAT,1855,16,50-100,1871,0.04151415107632022
STAT,1882,34,na,1916,2174.83573247942
STAT,1897,49,40-44,1946,0.11946189545335006
STAT,1884,34,35-39,1918,9.373076832520624
STAT,1820,106,na,1926,0.006468296128347055
SIM,1892,34,35-39,1926,15
STAT,1870,40,35-39,1910,1.6931286867721826
STAT,1833,28,25-29,1861,33.77635539870397
STAT,1854,52,45-49,1906,0.010394673223550543
SIM,1841,28,25-29,1869,45
SIM,1907,42,40-44,1949,2
STAT,1846,46,30-34,1892,0.06844479116341516
SIM,1812,43,50-100,1855,5
SIM,1866,44,35-39,1910,7
STAT,1907,59,na,1966,2907.100288788847
SIM,1913,17,20-24,1930,30
STAT,1841,51,20-24,1892,5.072938797860408E-4
SIM,1839,68,na,1907,1085
SIM,1873,19,30-34,1892,4
STAT,1830,35,15-19,1865,0.04578348119361338
STAT,1934,36,na,1970,4908.945922546581
STAT,1820,36,na,1856,1509.674815169443
SIM,1875,15,25-29,1890,6
STAT,1874,41,15-19,1915,0.013394158328886805
SIM,1876,30,35-39,1906,10
STAT,1830,68,na,1898,912.8710591901557
SIM,1933,33,45-49,1966,3
STAT,1921,23,50-100,1944,0.6999828075623455
SIM,1772,84,na,1856,68
SIM,1903,34,20-24,1937,3
STAT,1839,41,20-24,1880,0.1242249204030089
SIM,1917,33,na,1950,3685
SIM,1876,27,35-39,1903,9
STAT,1799,56,na,1855,1064.6699519954623
STAT,1840,18,15-19,1858,5.319489012408869
STAT,1883,17,50-100,1900,0.04535996922555932
SIM,1913,20,20-24,1933,95
SIM,1909,19,20-24,1928,25
STAT,1830,43,na,1873,1512.647672004335
STAT,1835,104,na,1939,0.04161614133980354
STAT,1869,55,na,1924,1890.7933634963633
SIM,1887,18,20-24,1905,16
STAT,1816,50,na,1866,1337.1282222732304
SIM,1843,40,40-44,1883,4
STAT,1925,18,50-100,1943,0.42648472314353686
STAT,1901,37,15-19,1938,0.0160267377961005
STAT,1858,44,35-39,1902,1.3248257806194452
SIM,1862,31,45-49,1893,1
STAT,1827,90,na,1917,43.75251941377873
SIM,1906,44,40-44,1950,1
STAT,1866,30,25-29,1896,8.992905898241233
STAT,1839,29,30-34,1868,20.849713209798697
STAT,1881,45,30-34,1926,0.08917580573412788
STAT,1925,33,45-49,1958,1.7643916674082207
STAT,1856,16,50-100,1872,0.043115787028308455
STAT,1863,46,25-29,1909,0.04796762541901588
STAT,1865,19,30-34,1884,1.3933952879827154
STAT,1867,15,25-29,1882,5.199549719030344
STAT,1805,54,20-24,1859,0.002067725559773838
SIM,1891,16,20-24,1907,14
SIM,1924,21,35-39,1945,12
SIM,1863,27,na,1890,2049
SIM,1781,80,na,1861,196
STAT,1843,30,30-34,1873,15.461076183727599
SIM,1864,51,50-100,1915,1
STAT,1835,35,na,1870,1686.7056911366187
SIM,1826,80,na,1906,300
STAT,1940,22,30-34,1962,27.656449537003056
STAT,1835,40,40-44,1875,1.7252037150566777
STAT,1872,45,20-24,1917,0.011491866144266134
STAT,1843,83,na,1926,286.4084061750976
STAT,1881,33,50-100,1914,0.8322210071950973
STAT,1814,54,30-34,1868,0.014839858423496968
STAT,1813,107,na,1920,0.001994506201683526
SIM,1857,41,na,1898,1858
STAT,1952,8,na,1960,4449.414384710755
STAT,1915,47,45-49,1962,0.20687219779730598
STAT,1845,42,na,1887,1657.816637049511
STAT,1856,51,50-100,1907,0.01122789899809573
STAT,1931,26,50-100,1957,1.2145429295733332
STAT,1921,49,35-39,1970,0.1365129023202877
SIM,1862,42,na,1904,2014
STAT,1894,37,20-24,1931,0.9367511874143853
SIM,1830,32,na,1862,1748
STAT,1829,30,50-100,1859,0.9433772365642968
SIM,1787,83,na,1870,108
STAT,1841,42,30-34,1883,0.8173689048012955
SIM,1841,72,na,1913,866
STAT,1836,47,50-100,1883,0.16230854311318144
STAT,1822,45,25-29,1867,0.08268427539875206
SIM,1844,47,50-100,1891,3
STAT,1860,46,40-44,1906,0.13181363986826147
STAT,1860,33,35-39,1893,7.742341749113323
SIM,1828,28,na,1856,1625
STAT,1834,52,25-29,1886,0.0022480629789458704
STAT,1930,36,30-34,1966,2.247985201280586
STAT,1916,21,35-39,1937,9.3487481493197
SIM,1803,55,na,1858,1039
SIM,1933,32,40-44,1965,7
STAT,1904,48,na,1952,3010.3959504099544
STAT,1814,72,na,1886,571.1044001107311
STAT,1816,53,50-100,1869,0.0373142991870247
STAT,1911,36,20-24,1947,0.24163424624575477
SIM,1898,58,na,1956,2519
SIM,1914,35,35-39,1949,7
STAT,1886,48,50-100,1934,0.24205910761618732
STAT,1910,40,40-44,1950,0.22577888587403647
STAT,1867,45,na,1912,2015.5052246867074
STAT,1909,37,na,1946,3363.225992126548
STAT,1827,79,na,1906,387.96798681955124
STAT,1821,49,30-34,1870,0.14354909315782427
STAT,1870,32,40-44,1902,4.014366157859378
SIM,1866,29,40-44,1895,3
SIM,1813,62,na,1875,917
STAT,1858,29,40-44,1887,2.241699965579811
SIM,1890,38,40-44,1928,4
STAT,1894,35,50-100,1929,1.5061473784818
STAT,1925,32,40-44,1957,4.390592954655513
SIM,1775,95,na,1870,4
STAT,1903,40,40-44,1943,0.21204861381064383
SIM,1907,23,na,1930,3314
STAT,1876,88,na,1964,282.56844838806927
SIM,1849,25,25-29,1874,42
STAT,1940,19,30-34,1959,11.682293518248928
SIM,1861,39,25-29,1900,1
SIM,1884,74,na,1958,1087
STAT,1915,46,40-44,1961,0.15044309986477522
SIM,1839,18,25-29,1857,3
SIM,1861,46,na,1907,1943
STAT,1853,93,na,1946,21.673780869482492
STAT,1905,17,20-24,1922,24.20220075301343
SIM,1926,26,50-100,1952,1
SIM,1901,21,40-44,1922,2
STAT,1892,24,40-44,1916,2.4497276680960387
STAT,1777,87,na,1864,50.4774238130489
STAT,1843,61,na,1904,1348.1371997617086
STAT,1861,30,40-44,1891,3.4293990590598034
STAT,1838,31,na,1869,1855.8852547728673
STAT,1925,41,30-34,1966,0.14645035069325105
STAT,1918,34,15-19,1952,0.1278940680446224
STAT,1899,42,30-34,1941,0.10322863359924207
SIM,1838,38,na,1876,1582
STAT,1877,50,30-34,1927,0.005919242271257808
STAT,1831,44,20-24,1875,0.11779348670417078
STAT,1854,31,45-49,1885,1.2993515980078791
STAT,1843,86,na,1929,160.07376804325327
STAT,1818,94,na,1912,9.635758142666019
STAT,1840,21,15-19,1861,2.9428603704100085
STAT,1850,47,35-39,1897,0.09810083125186687
SIM,1950,18,na,1968,4024
STAT,1905,20,20-24,1925,94.63757719285069
SIM,1911,43,45-49,1954,1
SIM,1894,33,na,1927,3035
STAT,1921,22,20-24,1943,118.65673141319182
STAT,1830,51,45-49,1881,0.00954238913759145
STAT,1819,79,na,1898,349.12406670373605
SIM,1849,12,na,1861,2147
SIM,1836,79,na,1915,426
SIM,1894,48,50-100,1942,1
STAT,1852,43,45-49,1895,1.128891622485249
SIM,1850,15,20-24,1865,15
STAT,1868,24,30-34,1892,15.965692652614786
STAT,1838,17,20-24,1855,15.97157896032916
STAT,1929,43,30-34,1972,0.15616977013844913
SIM,1855,19,20-24,1874,15
STAT,1873,40,45-49,1913,1.4496218178860167
STAT,1891,48,35-39,1939,0.09118181060983993
SIM,1874,96,na,1970,29
STAT,1909,15,na,1924,3593.7698909349865
STAT,1797,75,na,1872,413.3513026318762
STAT,1878,54,20-24,1932,7.057521730804735E-4
STAT,1897,45,25-29,1942,0.041459126718224784
STAT,1910,30,30-34,1940,14.46222875405711
SIM,1904,60,na,1964,2725
SIM,1905,45,na,1950,3084
STAT,1892,41,25-29,1933,0.7631134836291683
STAT,1900,36,45-49,1936,0.5666301534697038
SIM,1812,69,na,1881,715
STAT,1817,40,30-34,1857,3.1473289159903857
STAT,1937,32,na,1969,3534.350232638906
SIM,1915,52,na,1967,3395
STAT,1805,76,na,1881,386.2724639179174
SIM,1835,26,35-39,1861,7
SIM,1916,37,na,1953,3548
STAT,1882,38,40-44,1920,4.004060630543415
SIM,1940,22,30-34,1962,37
STAT,1855,32,15-19,1887,0.10269461225826039
STAT,1816,39,na,1855,1453.914149805956
SIM,1851,39,50-100,1890,3
SIM,1938,17,25-29,1955,47
STAT,1859,53,40-44,1912,0.007809615454728831
STAT,1884,31,30-34,1915,16.365949097660728
SIM,1885,59,na,1944,1839
STAT,1922,46,40-44,1968,0.17154492558021509
STAT,1815,47,40-44,1862,0.41661428415399554
STAT,1806,50,50-100,1856,0.04439077306608579
STAT,1868,59,na,1927,1752.9600274933555
SIM,1874,67,na,1941,1467
STAT,1839,16,na,1855,2014.0272022851398
STAT,1918,26,50-100,1944,1.0040981089716643
STAT,1856,82,na,1938,345.2215357989744
STAT,1833,40,15-19,1873,0.010448181902608763
SIM,1846,17,20-24,1863,21
STAT,1847,19,20-24,1866,16.089539683557785
STAT,1821,34,50-100,1855,2.4915552014416305
STAT,1825,50,25-29,1875,0.0037252263490011434
STAT,1859,45,na,1904,1713.1206703681698
SIM,1884,41,40-44,1925,7
SIM,1838,20,na,1858,1794
STAT,1829,39,15-19,1868,0.048341026900767456
SIM,1842,57,na,1899,1370
STAT,1858,35,50-100,1893,0.9191778104190774
SIM,1892,31,30-34,1923,29
STAT,1911,44,15-19,1955,0.0013673458272945688
SIM,1854,90,na,1944,49
STAT,1840,36,50-100,1876,1.021835711711132
STAT,1863,30,na,1893,1997.5536957029672
SIM,1885,5,na,1890,2486
STAT,1858,111,na,1969,8.306535785966392E-4
SIM,1881,15,na,1896,2118
STAT,1865,30,na,1895,2064.9826611008853
SIM,1877,42,45-49,1919,2
STAT,1839,102,na,1941,0.19548090449609523
STAT,1829,42,15-19,1871,0.011618563855429078
STAT,1871,36,15-19,1907,0.052844311388401004
STAT,1869,42,45-49,1911,1.3668978961476368
SIM,1903,35,25-29,1938,1
STAT,1876,70,na,1946,1368.3556925470962
STAT,1926,40,na,1966,4337.7926210945625
SIM,1951,14,na,1965,4347
SIM,1820,38,25-29,1858,1
STAT,1862,103,na,1965,0.5908523924048465
STAT,1849,18,35-39,1867,0.4839671800667881
SIM,1847,29,30-34,1876,32
STAT,1955,9,na,1964,4927.758550635666
SIM,1939,32,35-39,1971,13
SIM,1927,9,na,1936,4591
STAT,1866,51,25-29,1917,0.0030998151987472835
STAT,1896,33,15-19,1929,0.17705024930654664
SIM,1814,47,na,1861,1314
SIM,1882,41,50-100,1923,3
SIM,1926,15,40-44,1941,2
STAT,1859,4,na,1863,2332.6315398953643
STAT,1900,35,40-44,1935,5.791595361651887
SIM,1922,35,35-39,1957,6
SIM,1872,19,na,1891,2337
STAT,1838,18,50-100,1856,0.04387666682353187
SIM,1893,43,40-44,1936,2
SIM,1762,99,na,1861,1
STAT,1842,68,na,1910,1088.2487058146194
STAT,1894,22,na,1916,2874.0549885661117
STAT,1828,41,45-49,1869,1.3425465319947514
STAT,1855,29,15-19,1884,0.3301393640851725
STAT,1872,16,45-49,1888,0.06251087926313484
SIM,1845,53,na,1898,1497
SIM,1885,37,na,1922,2232
SIM,1865,82,na,1947,331
STAT,1922,32,15-19,1954,0.1371740680311639
STAT,1928,40,45-49,1968,0.2010095184348616
STAT,1809,50,40-44,1859,0.03800179538506676
STAT,1900,47,50-100,1947,0.18072109264490643
SIM,1851,30,30-34,1881,26
STAT,1876,41,40-44,1917,2.2035440087677123
STAT,1895,32,45-49,1927,2.149783627441971
STAT,1846,49,35-39,1895,0.09664915155357763
SIM,1935,29,na,1964,4785
STAT,1936,33,20-24,1969,2.236373708053737
STAT,1939,28,30-34,1967,37.18974023929484
STAT,1774,98,na,1872,0.5254371480960338
STAT,1918,29,na,1947,3739.2340620907166
STAT,1914,35,35-39,1949,2.302672737071907
SIM,1889,44,na,1933,2680
SIM,1883,20,25-29,1903,51
STAT,1930,22,50-100,1952,0.7963584702070334
STAT,1939,1,na,1940,3939.9539180919533
STAT,1817,102,na,1919,0.13001232285302441
STAT,1901,18,40-44,1919,0.24121667996147558
STAT,1818,52,40-44,1870,0.021572110910381134
STAT,1875,53,25-29,1928,0.0033824628944608844
STAT,1867,74,na,1941,984.3829995520953
STAT,1894,20,35-39,1914,7.133704915523421
SIM,1928,28,20-24,1956,17
STAT,1842,15,20-24,1857,16.40446259032495
STAT,1882,52,20-24,1934,6.747213357595155E-4
STAT,1856,48,40-44,1904,0.12507823980246818
STAT,1910,24,45-49,1934,0.9916619143835171
SIM,1878,24,40-44,1902,2
STAT,1882,46,35-39,1928,0.12906039908294253
STAT,1932,22,30-34,1954,35.62612022515222
STAT,1844,50,35-39,1894,0.006130488213187386
STAT,1944,24,15-19,1968,5.425799796394324
STAT,1860,54,35-39,1914,0.006427926398770887
SIM,1836,41,45-49,1877,2
SIM,1928,31,20-24,1959,3
STAT,1916,48,15-19,1964,3.559297944262323E-4
SIM,1874,45,na,1919,2178
SIM,1822,76,na,1898,494
STAT,1871,6,na,1877,2584.1114339361925
SIM,1950,9,na,1959,4277
SIM,1850,83,na,1933,267
SIM,1851,3,na,1854,2443
STAT,1904,46,30-34,1950,0.07418779723802486
STAT,1900,16,na,1916,3318.1624409736387
STAT,1837,53,20-24,1890,4.583533709365399E-4
STAT,1907,37,na,1944,3294.634229978018
SIM,1827,68,na,1895,828
SIM,1873,31,20-24,1904,3
STAT,1857,67,na,1924,1180.5922108974396
STAT,1874,41,50-100,1915,1.0246530372848266
STAT,1894,17,35-39,1911,0.666802469121332
STAT,1789,97,na,1886,0.8757131444300967
STAT,1836,22,50-100,1858,0.33985526729783533
STAT,1885,43,40-44,1928,2.101679462178574
STAT,1949,17,35-39,1966,4.610722785973741
STAT,1918,11,na,1929,4080.162930147524
STAT,1919,39,na,1958,3810.1014468356157
STAT,1909,35,50-100,1944,0.3788945552190052
SIM,1859,27,40-44,1886,3
STAT,1847,16,15-19,1863,5.482206379198494
SIM,1854,22,na,1876,1954
SIM,1942,25,40-44,1967,6
STAT,1913,15,25-29,1928,8.407172697415314
STAT,1765,109,na,1874,0.002853652133884807
STAT,1831,39,40-44,1870,3.376820037439088
STAT,1923,37,30-34,1960,1.995169085347299
STAT,1889,43,na,1932,2676.06229245005
STAT,1927,34,na,1961,4389.8872742477015
STAT,1878,91,na,1969,190.69209966342564
SIM,1920,34,20-24,1954,2
SIM,1872,6,na,1878,2583
STAT,1878,16,45-49,1894,0.06439936084220296
STAT,1882,42,50-100,1924,0.9699478352990937
SIM,1869,75,na,1944,867
STAT,1811,107,na,1918,0.0020427113515153533
STAT,1912,34,20-24,1946,2.247442002204041
SIM,1850,32,na,1882,1798
STAT,1885,53,na,1938,1994.033732371229
STAT,1937,31,15-19,1968,0.12015794788460965
SIM,1869,30,25-29,1899,12
STAT,1853,20,na,1873,1900.7111874246739
STAT,1916,41,25-29,1957,0.06922873019706528
STAT,1893,15,30-34,1908,1.919313613607124
STAT,1812,46,na,1858,1333.1270505567195
SIM,1918,30,45-49,1948,2
STAT,1946,24,20-24,1970,116.81809587048367
SIM,1928,2,na,1930,4844
SIM,1921,15,25-29,1936,53
SIM,1846,27,na,1873,1858
SIM,1933,32,35-39,1965,17
STAT,1955,17,25-29,1972,54.34221076295519
STAT,1902,27,15-19,1929,0.6048527025534052
STAT,1899,73,na,1972,1964.6887912032093
STAT,1906,38,40-44,1944,1.2932913622322784
SIM,1920,44,na,1964,3794
STAT,1865,50,50-100,1915,0.013151188032111577
STAT,1871,36,50-100,1907,1.1553686620542993
SIM,1855,16,15-19,1871,7
STAT,1929,25,30-34,1954,46.504400537525946
SIM,1880,30,na,1910,2449
SIM,1882,65,na,1947,1530
SIM,1940,28,40-44,1968,3
SIM,1950,0,na,1950,4459
STAT,1927,28,30-34,1955,44.84680819710183
STAT,1864,45,30-34,1909,0.08254408788383111
SIM,1919,29,30-34,1948,50
SIM,1900,25,35-39,1925,14
STAT,1822,48,30-34,1870,0.13311772372884775
STAT,1932,28,40-44,1960,5.764705535315398
STAT,1908,35,40-44,1943,1.3363296549986066
SIM,1907,54,na,1961,3029
SIM,1929,30,20-24,1959,2
SIM,1914,38,40-44,1952,3
SIM,1938,27,50-100,1965,5
SIM,1905,29,30-34,1934,45
STAT,1914,44,25-29,1958,0.06661087089595297
STAT,1925,32,35-39,1957,10.252877881733239
SIM,1883,36,50-100,1919,1
STAT,1926,27,50-100,1953,1.1273318580807983
SIM,1890,60,na,1950,2230
SIM,1935,28,30-34,1963,60
STAT,1901,34,45-49,1935,2.2860917101871716
SIM,1875,46,50-100,1921,3
SIM,1937,27,25-29,1964,56
SIM,1855,63,na,1918,1355
SIM,1871,14,na,1885,2520
STAT,1805,49,40-44,1854,0.5067071060565522
STAT,1933,27,45-49,1960,2.1670660992375232
SIM,1868,30,35-39,1898,12
SIM,1902,20,40-44,1922,2
STAT,1868,81,na,1949,487.7571641969471
STAT,1859,33,25-29,1892,7.689563333128456
STAT,1884,12,na,1896,2410.8748440169484
SIM,1859,45,na,1904,1902
SIM,1903,19,25-29,1922,9
STAT,1859,31,30-34,1890,13.217103108709294
STAT,1938,2,na,1940,3810.8211190218053
STAT,1904,42,45-49,1946,0.14063309098403143
STAT,1928,28,20-24,1956,21.236792547258556
STAT,1842,76,na,1918,674.6580658834479
STAT,1902,45,45-49,1947,0.17924288835619334
STAT,1913,22,na,1935,3492.565143760116
STAT,1869,23,40-44,1892,1.8996234420215876
STAT,1875,31,15-19,1906,0.13877688411221756
STAT,1902,50,na,1952,2911.821497846301
SIM,1942,23,45-49,1965,1
SIM,1863,50,na,1913,1887
STAT,1930,30,20-24,1960,2.9772544726400203
SIM,1839,15,20-24,1854,18
STAT,1900,32,50-100,1932,1.2008218257101693
SIM,1808,61,na,1869,959
STAT,1850,50,25-29,1900,0.002529419149310224
SIM,1941,27,45-49,1968,1
STAT,1900,31,20-24,1931,3.5570777865383088
SIM,1804,71,na,1875,551
SIM,1937,25,30-34,1962,47
STAT,1937,33,50-100,1970,0.7721642309710958
SIM,1936,28,20-24,1964,18
SIM,1844,91,na,1935,26
STAT,1827,99,na,1926,1.051000226695595
STAT,1904,22,20-24,1926,93.36423943531742
STAT,1929,27,25-29,1956,77.82451534118812
SIM,1910,30,45-49,1940,1
STAT,1899,53,na,1952,2742.8384448588395
SIM,1886,55,na,1941,1987
STAT,1934,25,40-44,1959,5.928485285198866
STAT,1853,32,50-100,1885,0.699738991489889
SIM,1893,9,na,1902,3228
STAT,1865,30,45-49,1895,1.509008052002019
SIM,1863,19,na,1882,2218
SIM,1838,83,na,1921,222
SIM,1879,73,na,1952,1113
STAT,1912,18,15-19,1930,8.644752522320799
SIM,1943,24,45-49,1967,1
STAT,1794,107,na,1901,8.473477819071743E-4
STAT,1913,33,25-29,1946,8.64851322652058
SIM,1781,89,na,1870,27
STAT,1788,79,na,1867,270.16527787758946
SIM,1867,31,30-34,1898,18
SIM,1920,18,15-19,1938,48
SIM,1905,16,25-29,1921,11
STAT,1945,26,25-29,1971,68.24803825026673
SIM,1880,50,na,1930,2289
STAT,1784,97,na,1881,0.7782178423590955
SIM,1900,23,40-44,1923,2
SIM,1925,28,45-49,1953,3
STAT,1917,28,45-49,1945,1.705475661073026
SIM,1921,33,25-29,1954,8
SIM,1889,34,50-100,1923,2
STAT,1876,17,na,1893,2463.11101230274
STAT,1848,53,na,1901,1526.28661435137
STAT,1935,24,45-49,1959,1.4464051908376863
STAT,1944,27,20-24,1971,18.63735240339473
STAT,1943,19,50-100,1962,0.3750549664203118
STAT,1833,53,50-100,1886,0.009285151596598826
SIM,1877,19,na,1896,2458
STAT,1859,54,50-100,1913,0.01107321688670765
STAT,1919,47,na,1966,3764.34921356418
STAT,1937,19,30-34,1956,11.167084776430096
SIM,1901,21,35-39,1922,10
SIM,1825,65,na,1890,869
STAT,1902,30,45-49,1932,2.3434601915947666
SIM,1852,20,30-34,1872,18
STAT,1867,20,na,1887,2137.0187222197724
STAT,1913,45,20-24,1958,0.010235449611144962
SIM,1932,21,na,1953,4370
SIM,1872,55,na,1927,1974
SIM,1849,35,30-34,1884,7
SIM,1835,20,30-34,1855,21
STAT,1896,25,na,1921,2999.866065058299
SIM,1932,36,35-39,1968,6
STAT,1868,24,35-39,1892,5.2305187705184055
STAT,1904,42,15-19,1946,0.0012976526030688397
SIM,1843,50,na,1893,1552
SIM,1921,17,20-24,1938,138
STAT,1860,20,15-19,1880,2.9108969600349544
STAT,1934,23,45-49,1957,1.4279670326107325
SIM,1805,96,na,1901,3
STAT,1934,38,15-19,1972,0.02500857171848571
STAT,1810,109,na,1919,3.221822978048354E-4
SIM,1857,98,na,1955,1
STAT,1912,1,na,1913,3975.3088666768895
SIM,1928,16,na,1944,4392
SIM,1914,36,na,1950,3825
STAT,1770,101,na,1871,0.09501898292359451
STAT,1910,21,35-39,1931,8.376134173352693
SIM,1852,22,25-29,1874,61
STAT,1845,33,na,1878,1796.3511234740572
SIM,1915,34,40-44,1949,10
SIM,1921,30,20-24,1951,2
STAT,1909,34,45-49,1943,1.406056167684446
SIM,1867,15,25-29,1882,8
SIM,1894,42,na,1936,2974
STAT,1840,44,30-34,1884,0.8140641017872987
STAT,1907,34,40-44,1941,3.4254107576386454
STAT,1902,8,na,1910,3465.580262289331
SIM,1912,22,20-24,1934,90
STAT,1877,17,40-44,1894,0.17930297338286505
SIM,1891,14,na,1905,3171
SIM,1867,40,na,1907,2016
SIM,1875,83,na,1958,508
STAT,1864,32,50-100,1896,0.7735959826653249
STAT,1839,22,15-19,1861,2.826350016359908
STAT,1913,17,20-24,1930,26.180455942975893
STAT,1853,26,50-100,1879,0.5535467061029856
SIM,1840,22,na,1862,1829
STAT,1928,26,25-29,1954,76.87559358861608
STAT,1844,22,25-29,1866,50.17601977557104
STAT,1858,35,30-34,1893,3.990110780988898
STAT,1922,33,50-100,1955,0.8788482753491083
SIM,1886,75,na,1961,1180
STAT,1912,16,20-24,1928,25.956261921148762
STAT,1907,36,35-39,1943,2.1283407341987264
SIM,1888,41,45-49,1929,2
STAT,1947,20,20-24,1967,118.80900667036167
SIM,1837,20,35-39,1857,8
STAT,1915,45,25-29,1960,0.050728479593819875
SIM,1932,34,40-44,1966,7
STAT,1843,104,na,1947,0.04812110389562199
STAT,1924,34,40-44,1958,4.307933135501674
STAT,1933,29,40-44,1962,5.8408913453660505
SIM,1874,42,na,1916,2213
SIM,1903,44,na,1947,3096
STAT,1927,45,20-24,1972,0.013167890683165456
SIM,1847,22,15-19,1869,3
SIM,1941,29,40-44,1970,6
STAT,1917,38,15-19,1955,0.018748488607798753
STAT,1930,32,15-19,1962,0.15667617967091055
SIM,1920,16,20-24,1936,128
SIM,1936,26,25-29,1962,56
STAT,1885,20,20-24,1905,65.24600273149933
STAT,1904,40,20-24,1944,0.015092163553311099
SIM,1926,24,45-49,1950,1
SIM,1858,49,50-100,1907,2
SIM,1915,36,35-39,1951,2
STAT,1819,43,50-100,1862,2.00505369075742
STAT,1869,25,35-39,1894,8.883195590332802
STAT,1918,39,15-19,1957,0.019080156695038684
STAT,1861,51,50-100,1912,0.011904441488281209
SIM,1808,53,na,1861,1174
STAT,1928,44,25-29,1972,0.08572139442339247
STAT,1846,58,na,1904,1394.3495141662463
STAT,1889,31,45-49,1920,2.042082279385944
SIM,1819,45,na,1864,1391
STAT,1839,16,50-100,1855,0.04298560515534864
STAT,1904,24,15-19,1928,4.44161356514827
STAT,1918,37,20-24,1955,0.26247726133077454
SIM,1856,17,na,1873,2156
STAT,1923,19,30-34,1942,13.44966083989216
SIM,1893,20,20-24,1913,82
STAT,1812,109,na,1921,3.059976568695718E-4
STAT,1953,18,30-34,1971,13.924981383973746
SIM,1836,21,30-34,1857,18
SIM,1878,28,50-100,1906,1
SIM,1916,35,40-44,1951,5
STAT,1919,36,25-29,1955,1.0001812815018463
STAT,1940,24,na,1964,3511.576714608378
STAT,1928,29,30-34,1957,45.56214130636242
SIM,1897,31,45-49,1928,1
SIM,1848,81,na,1929,371
STAT,1943,18,45-49,1961,0.5002483754918381
SIM,1941,26,35-39,1967,16
SIM,1915,18,35-39,1933,3
STAT,1811,84,na,1895,144.09277809793423
SIM,1931,19,30-34,1950,19
STAT,1851,30,15-19,1881,0.1109736705406448
STAT,1943,28,15-19,1971,0.7098945007975599
SIM,1831,44,30-34,1875,3
SIM,1890,80,na,1970,1093
SIM,1945,19,30-34,1964,18
SIM,1879,0,na,1879,3440
STAT,1844,20,30-34,1864,15.839175218522794
STAT,1916,42,50-100,1958,0.11372842128849113
STAT,1946,3,na,1949,4195.350274475096
SIM,1835,63,na,1898,1119
SIM,1880,7,na,1887,2714
SIM,1931,37,30-34,1968,4
STAT,1862,96,na,1958,10.613052781107902
SIM,1828,81,na,1909,268
STAT,1908,33,45-49,1941,1.3969360483481943
SIM,1900,22,30-34,1922,31
STAT,1907,18,35-39,1925,0.7593212045392462
SIM,1839,45,na,1884,1620
SIM,1956,6,na,1962,4770
SIM,1930,36,30-34,1966,2
STAT,1839,40,45-49,1879,1.1857798056755955
SIM,1829,39,50-100,1868,3
STAT,1866,100,na,1966,4.481538174881246
STAT,1858,51,na,1909,1604.4932605827637
SIM,1934,36,na,1970,4842
STAT,1860,10,na,1870,2140.3190919987887
STAT,1876,30,20-24,1906,2.657362561945426
STAT,1868,100,na,1968,5.824739460828611
SIM,1903,64,na,1967,2575
SIM,1916,33,45-49,1949,1
STAT,1868,9,na,1877,2458.56471349357
SIM,1863,9,na,1872,2369
STAT,1924,36,35-39,1960,2.697107401367015
STAT,1938,18,35-39,1956,3.908614981088652
STAT,1868,32,50-100,1900,0.8264324458103605
SIM,1859,40,50-100,1899,3
SIM,1946,18,35-39,1964,5
STAT,1810,49,20-24,1859,0.041249429565441725
STAT,1865,33,na,1898,2039.8716560103217
SIM,1927,36,25-29,1963,1
STAT,1834,30,15-19,1864,0.1152819748303495
SIM,1847,40,45-49,1887,2
STAT,1890,35,30-34,1925,6.214268750765972
STAT,1922,36,30-34,1958,1.9610796733162388
STAT,1938,30,20-24,1968,2.319290341050299
SIM,1912,24,15-19,1936,4
STAT,1771,90,na,1861,19.555333820048762
STAT,1880,45,15-19,1925,4.015629263523445E-4
STAT,1886,27,na,1913,2382.0464845955785
STAT,1849,15,na,1864,2060.8043740718786
STAT,1823,44,30-34,1867,1.407946549725258
STAT,1807,79,na,1886,295.3662363921161
STAT,1867,25,30-34,1892,22.48789438312804
SIM,1887,60,na,1947,1965
SIM,1925,25,40-44,1950,7
STAT,1904,0,na,1904,3978.216553849731
STAT,1906,37,30-34,1943,1.582421622946346
STAT,1888,49,35-39,1937,0.0862930202193214
STAT,1915,32,50-100,1947,0.7954114338707654
STAT,1905,23,20-24,1928,93.78556896382925
STAT,1852,15,na,1867,2134.3873706278728
STAT,1920,40,35-39,1960,0.2106905372725632
STAT,1840,47,40-44,1887,0.12023045059946473
STAT,1860,2,na,1862,2651.8441674428354
SIM,1858,83,na,1941,271
STAT,1927,29,15-19,1956,0.8075933096595745
SIM,1946,15,30-34,1961,15
SIM,1915,39,40-44,1954,1
STAT,1916,42,35-39,1958,0.19493646129724168
SIM,1936,29,30-34,1965,35
SIM,1939,0,na,1939,3908
SIM,1902,59,na,1961,2744
SIM,1876,24,35-39,1900,6
SIM,1839,16,30-34,1855,1
SIM,1869,35,na,1904,2161
STAT,1844,71,na,1915,937.0422852787527
STAT,1859,48,50-100,1907,0.18283727757814275
STAT,1930,15,25-29,1945,53.175745207821905
SIM,1822,39,40-44,1861,3
STAT,1879,27,50-100,1906,0.631652786672624
SIM,1931,36,na,1967,4698
SIM,1914,37,30-34,1951,3
STAT,1905,47,na,1952,3057.63177730412
STAT,1942,17,45-49,1959,0.49314269079265743
SIM,1895,20,25-29,1915,76
SIM,1879,65,na,1944,1628
SIM,1851,93,na,1944,17
STAT,1762,110,na,1872,3.685124272991224E-4
STAT,1826,38,na,1864,1533.2558130992686
STAT,1860,41,na,1901,1782.5057711758425
SIM,1922,4,na,1926,4421
STAT,1878,51,na,1929,2127.6698184708443
STAT,1937,24,na,1961,3356.7102906388404
STAT,1839,110,na,1949,1.8425452777678336E-4
STAT,1933,26,35-39,1959,18.84105248383831
SIM,1851,24,30-34,1875,22
STAT,1900,55,na,1955,2709.923743933291
STAT,1914,43,15-19,1957,0.001435003198494903
STAT,1801,54,na,1855,1132.145905347605
STAT,1893,18,35-39,1911,0.6559684148446437
STAT,1922,23,25-29,1945,99.76609498895093
SIM,1930,23,25-29,1953,129
STAT,1903,28,15-19,1931,0.6076447455807125
STAT,1907,34,na,1941,3310.5035817463395
STAT,1843,24,30-34,1867,15.899543225477522
SIM,1824,71,na,1895,726
SIM,1908,41,40-44,1949,1
STAT,1919,38,20-24,1957,0.26726514060035433
STAT,1873,20,na,1893,2281.39617588598
STAT,1887,20,25-29,1907,60.840646522630685
STAT,1924,14,na,1938,4443.44198941932
SIM,1826,30,30-34,1856,22
STAT,1889,23,50-100,1912,0.47412495071310296
SIM,1866,55,na,1921,1791
SIM,1843,49,50-100,1892,2
STAT,1852,17,35-39,1869,0.5042175336448214
STAT,1828,61,na,1889,1076.9773903314658
STAT,1832,37,35-39,1869,5.422159978112961
SIM,1933,35,40-44,1968,1
STAT,1916,27,45-49,1943,1.6874421674669584
SIM,1822,37,na,1859,1559
STAT,1908,32,35-39,1940,8.146940898709142
STAT,1885,21,30-34,1906,16.815166887248715
STAT,1901,15,35-39,1916,0.728921956941023
STAT,1953,19,15-19,1972,51.82958106276653
STAT,1862,47,20-24,1909,0.00962497206195118
STAT,1897,10,na,1907,3272.6576773427405
STAT,1907,39,40-44,1946,1.2977479766182045
SIM,1893,49,na,1942,2736
STAT,1881,48,40-44,1929,0.154196904960167
SIM,1947,17,40-44,1964,1
STAT,1925,35,40-44,1960,1.7004971460745562
STAT,1939,17,40-44,1956,1.3224975415103462
SIM,1924,27,45-49,1951,1
STAT,1866,27,na,1893,2078.6355728336507
STAT,1893,37,50-100,1930,1.4715921391237718
STAT,1922,38,25-29,1960,1.0574007014400801
SIM,1858,41,30-34,1899,3
STAT,1822,49,40-44,1871,0.2320891891529378
SIM,1869,7,na,1876,2501
SIM,1925,28,50-100,1953,1
SIM,1930,38,25-29,1968,1
STAT,1954,16,25-29,1970,50.62198506350813
SIM,1893,21,30-34,1914,23
STAT,1888,81,na,1969,998.4529580074611
SIM,1891,22,na,1913,2927
STAT,1917,25,40-44,1942,4.648902236157933
STAT,1871,81,na,1952,506.449456515364
STAT,1901,30,25-29,1931,13.652527956535172
STAT,1905,36,50-100,1941,0.36350394301938516
STAT,1794,87,na,1881,55.29843709519488
SIM,1860,17,35-39,1877,1
SIM,1913,23,20-24,1936,94
STAT,1859,15,25-29,1874,5.018168424888327
STAT,1959,5,na,1964,4857.543179101039
SIM,1856,8,na,1864,2294
SIM,1901,24,40-44,1925,2
SIM,1879,45,na,1924,2237
SIM,1921,32,45-49,1953,3
STAT,1911,20,40-44,1931,3.029779445353958
STAT,1921,49,na,1970,3889.8688607506974
SIM,1916,32,35-39,1948,8
SIM,1899,26,30-34,1925,39
STAT,1904,25,25-29,1929,57.69975890789729
STAT,1921,42,45-49,1963,0.17710127201914277
SIM,1861,24,na,1885,2060
STAT,1831,84,na,1915,202.87965365859327
STAT,1869,26,45-49,1895,1.0187862760809139
STAT,1913,42,na,1955,3420.6741167350956
SIM,1912,25,25-29,1937,66
STAT,1883,6,na,1889,2431.3483135282936
SIM,1904,15,25-29,1919,7
SIM,1855,83,na,1938,280
STAT,1899,36,30-34,1935,6.932952033697411
SIM,1835,22,25-29,1857,59
STAT,1798,104,na,1902,0.018500046930235506
SIM,1892,25,30-34,1917,35
STAT,1930,14,na,1944,4823.87221290958
STAT,1852,35,na,1887,1837.4853404505425
SIM,1921,18,30-34,1939,22
STAT,1934,22,35-39,1956,11.953773179988001
SIM,1928,34,20-24,1962,3
SIM,1909,38,30-34,1947,4
STAT,1926,31,40-44,1957,4.4733029753723095
STAT,1924,37,45-49,1961,0.7594817817257072
SIM,1932,33,30-34,1965,24
SIM,1835,23,35-39,1858,4
SIM,1900,28,40-44,1928,3
STAT,1916,45,45-49,1961,0.2115753080757591
SIM,1814,61,na,1875,967
SIM,1846,78,na,1924,503
SIM,1930,39,35-39,1969,8
SIM,1896,17,15-19,1913,6
SIM,1879,20,40-44,1899,1
SIM,1838,91,na,1929,35
STAT,1855,94,na,1949,14.154875570432987
STAT,1862,3,na,1865,2607.568471417446
SIM,1910,46,na,1956,3165
STAT,1790,97,na,1887,0.9315184330217134
STAT,1863,49,30-34,1912,0.07870567763184359
SIM,1904,33,25-29,1937,12
STAT,1931,39,na,1970,4697.061962344877
SIM,1897,39,na,1936,3013
SIM,1898,15,25-29,1913,10
SIM,1840,37,35-39,1877,12
STAT,1900,19,35-39,1919,0.7152758963135946
STAT,1859,25,na,1884,1856.884561444567
SIM,1932,32,20-24,1964,3
STAT,1872,35,na,1907,2255.159010585317
STAT,1924,33,30-34,1957,17.35546309360436
STAT,1936,35,15-19,1971,0.017837361417168428
SIM,1861,32,50-100,1893,4
STAT,1936,20,45-49,1956,1.0167459359015296
SIM,1773,94,na,1867,2
STAT,1945,23,20-24,1968,115.08945892179337
SIM,1825,34,30-34,1859,17
STAT,1840,47,35-39,1887,0.09831929394125113
STAT,1783,95,na,1878,2.0798745747555096
STAT,1815,43,50-100,1858,2.8382207356028193
SIM,1814,44,50-100,1858,3
SIM,1877,25,35-39,1902,12
STAT,1868,21,30-34,1889,16.182460362393712
SIM,1951,15,40-44,1966,2
STAT,1913,18,30-34,1931,2.3475661836880697
SIM,1862,65,na,1927,1434
SIM,1837,21,45-49,1858,1
STAT,1850,45,50-100,1895,0.17462673723307168
SIM,1853,37,na,1890,1874
SIM,1921,38,na,1959,3867
STAT,1862,68,na,1930,1231.4793979251897
STAT,1810,46,45-49,1856,0.8533790408800567
STAT,1844,48,50-100,1892,0.1702470734113404
STAT,1835,22,50-100,1857,0.33821159205017426
STAT,1943,15,40-44,1958,1.4018870601317057
STAT,1895,63,na,1958,2268.363555159498
STAT,1861,101,na,1962,1.3641012615928825
STAT,1872,66,na,1938,1554.1131982513
STAT,1877,19,na,1896,2462.6168541251345
SIM,1876,21,30-34,1897,26
SIM,1849,38,35-39,1887,16
SIM,1903,18,15-19,1921,9
STAT,1912,17,30-34,1929,2.32785971613197
STAT,1836,28,na,1864,1754.9318369173668
STAT,1895,20,50-100,1915,0.5057234665918507
STAT,1895,15,35-39,1910,0.6795913933266364
STAT,1806,86,na,1892,73.82897078985714
STAT,1890,7,na,1897,3009.256770485377
SIM,1944,20,45-49,1964,2
SIM,1938,26,na,1964,3422
SIM,1877,22,30-34,1899,17
SIM,1881,38,35-39,1919,10
STAT,1857,26,50-100,1883,0.49425995207761303
STAT,1918,21,40-44,1939,3.4360900944914365
SIM,1860,30,na,1890,2020
STAT,1879,45,na,1924,2243.7130078967875
SIM,1920,17,30-34,1937,14
SIM,1815,55,na,1870,1088
SIM,1930,20,15-19,1950,6
STAT,1938,33,25-29,1971,8.773033624011283
STAT,1835,63,na,1898,1113.280541324882
STAT,1928,25,15-19,1953,0.8272815738702554
STAT,1869,22,30-34,1891,16.28820707362671
STAT,1946,25,30-34,1971,41.269837044124685
STAT,1901,16,45-49,1917,0.08658723479969277
SIM,1881,24,na,1905,1968
SIM,1844,12,na,1856,2203
SIM,1926,21,40-44,1947,9
STAT,1817,38,na,1855,1362.1378861305234
STAT,1867,28,35-39,1895,8.528477890078069
STAT,1948,19,35-39,1967,4.533816039416878
STAT,1835,43,na,1878,1551.7145042206973
STAT,1888,17,15-19,1905,6.623018931616782
SIM,1863,39,30-34,1902,5
SIM,1934,31,40-44,1965,7
STAT,1906,40,na,1946,3222.5341477250067
STAT,1938,15,30-34,1953,11.409997764785366
SIM,1927,33,20-24,1960,2
SIM,1886,47,na,1933,2174
SIM,1915,0,na,1915,4054
STAT,1848,61,na,1909,1346.209041316502
STAT,1884,25,30-34,1909,23.66779167505214
STAT,1914,16,na,1930,3782.900095221948
STAT,1922,39,35-39,1961,2.5946593028582727
SIM,1807,68,na,1875,683
SIM,1938,23,25-29,1961,84
STAT,1790,107,na,1897,9.493340718637358E-4
SIM,1942,22,35-39,1964,9
SIM,1922,29,35-39,1951,20
SIM,1856,48,50-100,1904,1
STAT,1832,40,50-100,1872,0.8042980750111131
STAT,1840,29,40-44,1869,2.5639196642815407
STAT,1919,33,20-24,1952,2.4755389650883295
STAT,1877,10,na,1887,2571.097231470458
STAT,1883,58,na,1941,1830.9924677888685
STAT,1891,25,na,1916,2809.509869121429
STAT,1881,48,35-39,1929,0.1260956001413948
STAT,1830,39,25-29,1869,2.2241663709892587
STAT,1890,60,na,1950,2202.844042809034
STAT,1902,17,45-49,1919,0.08708457674745801
STAT,1914,47,na,1961,3441.3989689585437
SIM,1944,26,na,1970,3773
STAT,1824,71,na,1895,704.6915448428873
STAT,1873,38,35-39,1911,6.7486431700144704
SIM,1890,29,na,1919,2819
STAT,1922,20,15-19,1942,5.8016810342586
SIM,1836,24,35-39,1860,5
STAT,1950,22,20-24,1972,124.62588024258122
SIM,1900,21,20-24,1921,83
STAT,1925,0,na,1925,5141.841439364327
STAT,1851,73,na,1924,870.998547076828
STAT,1903,29,25-29,1932,56.44815810461891
STAT,1766,92,na,1858,9.818323698742041
STAT,1863,45,15-19,1908,3.3547669786645004E-4
STAT,1954,15,15-19,1969,53.02775083334223
STAT,1839,25,20-24,1864,9.997266462847673
STAT,1866,25,50-100,1891,0.5609450467628649
STAT,1878,17,50-100,1895,0.04818118680610468
STAT,1893,30,20-24,1923,3.2659725145914837
STAT,1952,18,15-19,1970,51.363554479967945
SIM,1876,32,50-100,1908,4
STAT,1929,40,20-24,1969,0.02166711734513281
SIM,1822,38,30-34,1860,6
STAT,1953,15,50-100,1968,0.42838590713783287
STAT,1904,9,na,1913,3515.2688836516954
SIM,1867,19,40-44,1886,1
STAT,1931,26,30-34,1957,47.81125870642234
STAT,1886,42,50-100,1928,1.0531719187509447
STAT,1886,78,na,1964,1047.2362839045804
STAT,1888,46,30-34,1934,0.10833649975535564
STAT,1904,17,na,1921,3421.749556700207
SIM,1950,16,35-39,1966,4
STAT,1905,24,30-34,1929,24.16430914044388
STAT,1905,26,25-29,1931,57.9461899792158
SIM,1880,36,25-29,1916,3
SIM,1846,58,na,1904,1378
SIM,1925,41,40-44,1966,2
SIM,1929,15,30-34,1944,15
SIM,1878,22,45-49,1900,3
STAT,1927,45,15-19,1972,4.3892930334167796E-4
STAT,1852,22,50-100,1874,0.3680610200503787
STAT,1804,71,na,1875,628.0194686452263
STAT,1860,24,30-34,1884,13.895827144370793
SIM,1868,50,na,1918,1966
STAT,1894,17,40-44,1911,0.22226750257613384
STAT,1892,48,45-49,1940,0.1555073666702872
STAT,1897,23,15-19,1920,4.155158415472516
STAT,1922,20,20-24,1942,121.1898747762384
SIM,1927,23,na,1950,4145
SIM,1830,63,na,1893,1138
STAT,1797,84,na,1881,110.39212944837567
STAT,1804,82,na,1886,175.2739352743198
STAT,1858,31,15-19,1889,0.10671612590987829
SIM,1868,32,30-34,1900,19
STAT,1913,25,50-100,1938,0.9430639593168026
STAT,1872,54,25-29,1926,0.0032661870196686454
SIM,1911,29,25-29,1940,55
SIM,1856,18,25-29,1874,5
SIM,1893,24,35-39,1917,9
SIM,1938,27,40-44,1965,5
SIM,1911,40,35-39,1951,3
STAT,1916,24,40-44,1940,3.3074877440162953
STAT,1764,110,na,1874,0.0013810532116810773
SIM,1906,28,40-44,1934,3
SIM,1934,27,50-100,1961,2
SIM,1884,15,30-34,1899,5
STAT,1858,20,na,1878,1845.776021812378
SIM,1941,25,25-29,1966,69
STAT,1859,76,na,1935,714.2708694629503
SIM,1826,33,35-39,1859,9
STAT,1876,15,30-34,1891,1.5616518873459422
STAT,1882,30,45-49,1912,1.615893884660473
SIM,1901,27,45-49,1928,1
SIM,1858,25,30-34,1883,26
STAT,1911,20,45-49,1931,1.013879262442086
STAT,1902,19,50-100,1921,0.06496317001102472
SIM,1782,74,na,1856,385
STAT,1840,30,50-100,1870,0.7934965844864907
STAT,1933,25,25-29,1958,82.63489334250048
SIM,1850,63,na,1913,1314
SIM,1848,50,na,1898,1618
STAT,1848,18,25-29,1866,5.030986477633055
STAT,1863,101,na,1964,1.892420778502269
STAT,1920,26,20-24,1946,18.982526702763433
STAT,1881,29,30-34,1910,22.805350747250433
STAT,1841,104,na,1945,0.04563560632155617
SIM,1873,15,20-24,1888,16
STAT,1845,24,35-39,1869,5.029787318303242
STAT,1875,36,50-100,1911,1.1973061303442851
STAT,1903,40,35-39,1943,0.1707129668662446
STAT,1920,44,20-24,1964,0.01836564294328701
SIM,1897,19,25-29,1916,9
SIM,1924,24,40-44,1948,8
STAT,1880,61,na,1941,1857.4208117674318
STAT,1840,33,na,1873,1819.340252153085
STAT,1831,53,25-29,1884,0.0022459853513419315
SIM,1899,42,na,1941,2989
STAT,1903,47,25-29,1950,0.043465653974618775
STAT,1787,77,na,1864,324.2242387976918
STAT,1942,16,35-39,1958,4.1435595668250205
STAT,1899,32,15-19,1931,0.18436289297852035
STAT,1921,39,50-100,1960,0.44196908310184
STAT,1859,37,40-44,1896,3.3003068168647696
STAT,1904,27,20-24,1931,15.894041347368885
SIM,1867,34,35-39,1901,11
STAT,1907,35,25-29,1942,0.870429386565928
STAT,1924,32,20-24,1956,2.6885853419710406
STAT,1849,45,30-34,1894,0.07046815470855518
SIM,1847,25,20-24,1872,14
SIM,1857,10,na,1867,2301
SIM,1912,27,20-24,1939,15
STAT,1904,43,25-29,1947,0.05997879696060289
STAT,1891,49,40-44,1940,0.11056347854276553
SIM,1933,38,45-49,1971,1
SIM,1878,80,na,1958,747
SIM,1932,37,45-49,1969,3
SIM,1870,29,na,1899,2192
STAT,1924,39,40-44,1963,1.6641976677561159
SIM,1780,96,na,1876,3
SIM,1928,35,30-34,1963,2
SIM,1930,20,20-24,1950,132
STAT,1876,25,na,1901,2343.2599909230353
SIM,1933,31,na,1964,4807
STAT,1796,107,na,1903,0.0010986874068253782
STAT,1889,19,25-29,1908,6.573504321135132
SIM,1913,26,25-29,1939,74
STAT,1871,25,na,1896,2250.2462485439055
SIM,1833,29,na,1862,1691
STAT,1866,35,na,1901,2071.518660421157
STAT,1922,35,20-24,1957,0.2838755251921129
STAT,1872,36,25-29,1908,2.743201336112039
STAT,1900,16,30-34,1916,2.0940389966186523
STAT,1923,22,25-29,1945,101.54057610557912
SIM,1866,35,30-34,1901,4
STAT,1868,23,25-29,1891,51.474677191552296
SIM,1835,26,40-44,1861,2
SIM,1890,42,50-100,1932,4
STAT,1888,50,na,1938,2437.5553137153565
SIM,1932,39,40-44,1971,3
SIM,1821,48,50-100,1869,4
SIM,1889,24,15-19,1913,4
STAT,1841,74,na,1915,759.3079958107159
STAT,1909,60,na,1969,2968.975666621538
STAT,1853,51,na,1904,1604.4461353835725
STAT,1859,19,40-44,1878,0.15818728392354908
STAT,1841,16,50-100,1857,0.0434879227682329
STAT,1925,38,45-49,1963,0.7722755809951546
STAT,1828,84,na,1912,188.8450769833573
SIM,1862,88,na,1950,96
SIM,1865,21,20-24,1886,59
STAT,1924,18,40-44,1942,1.5695436693667566
SIM,1843,81,na,1924,352
STAT,1851,81,na,1932,396.5515000714135
STAT,1811,53,na,1864,1185.029196365099
SIM,1923,25,35-39,1948,20
STAT,1856,25,na,1881,1856.3072259685166
STAT,1807,48,na,1855,1255.1647089003743
STAT,1843,20,15-19,1863,3.030878085766583
STAT,1832,52,30-34,1884,0.003753930429080705
SIM,1876,23,25-29,1899,56
SIM,1848,23,15-19,1871,5
SIM,1915,35,25-29,1950,3
STAT,1872,46,50-100,1918,0.23353967113830648
STAT,1810,100,na,1910,0.48076258907824326
STAT,1831,35,25-29,1866,2.3275069096209604
SIM,1827,31,30-34,1858,18
SIM,1851,25,na,1876,1904
STAT,1852,52,50-100,1904,0.011413565979316028
SIM,1887,49,na,1936,2294
SIM,1924,42,40-44,1966,3
STAT,1926,31,45-49,1957,1.7987445115477159
SIM,1838,38,50-100,1876,2
STAT,1921,36,15-19,1957,0.02027638267854633
STAT,1897,41,45-49,1938,0.13190059196893048
STAT,1921,42,15-19,1963,0.0016341525670408427
STAT,1911,35,45-49,1946,0.6278015675463916
STAT,1902,30,40-44,1932,5.827957989824476
SIM,1872,95,na,1967,47
STAT,1840,28,30-34,1868,21.709198925954023
SIM,1828,30,na,1858,1651
STAT,1848,48,50-100,1896,0.1747128122899606
STAT,1857,21,20-24,1878,59.67751391462177
STAT,1873,35,30-34,1908,5.159112281780952
STAT,1815,66,na,1881,821.5768350715173
STAT,1830,54,20-24,1884,4.572094426483091E-4
STAT,1930,33,25-29,1963,11.261873139988387
STAT,1906,34,25-29,1940,8.02110816463874
SIM,1859,27,35-39,1886,11
SIM,1932,18,40-44,1950,1
STAT,1923,46,50-100,1969,0.25060073143007666
STAT,1851,47,45-49,1898,0.17225585197278562
STAT,1905,42,30-34,1947,0.10885343919049635
STAT,1825,33,na,1858,1639.3132526836266
SIM,1904,30,20-24,1934,3
STAT,1921,27,20-24,1948,19.220550382141415
SIM,1948,16,na,1964,3742
SIM,1814,44,30-34,1858,5
SIM,1910,30,40-44,1940,6
SIM,1925,23,45-49,1948,1
STAT,1821,46,20-24,1867,0.0185945137440123
STAT,1855,66,na,1921,1160.8072869306543
SIM,1876,27,40-44,1903,4
STAT,1880,49,35-39,1929,0.1362542293985429
SIM,1818,44,50-100,1862,1
SIM,1883,50,na,1933,2061
SIM,1934,31,45-49,1965,5
STAT,1916,42,40-44,1958,0.24213747296430926
SIM,1894,22,30-34,1916,29
STAT,1946,21,15-19,1967,5.598044494441111
SIM,1825,96,na,1921,2
SIM,1852,33,50-100,1885,4
STAT,1917,23,45-49,1940,1.1261721102307038
SIM,1839,15,15-19,1854,5
STAT,1932,27,30-34,1959,48.48367616514962
STAT,1776,93,na,1869,5.53631046534761
STAT,1920,24,na,1944,3811.4319601134894
SIM,1904,32,45-49,1936,1
STAT,1886,22,30-34,1908,17.77886999352214
SIM,1860,42,35-39,1902,1
SIM,1859,23,25-29,1882,53
STAT,1884,43,na,1927,2142.0478512375626
STAT,1847,99,na,1946,1.3934859587264015
STAT,1910,57,na,1967,3094.9945911422824
SIM,1914,34,25-29,1948,10
SIM,1896,20,40-44,1916,4
STAT,1869,86,na,1955,202.8917460833835
STAT,1921,24,15-19,1945,5.6448523656224
SIM,1805,56,na,1861,1082
SIM,1924,26,35-39,1950,15
SIM,1815,63,na,1878,878
STAT,1865,15,20-24,1880,17.438743654454136
STAT,1877,17,35-39,1894,0.5379088890043103
STAT,1915,46,35-39,1961,0.12302589970584112
SIM,1839,35,50-100,1874,4
STAT,1926,28,15-19,1954,0.7967469211861665
STAT,1931,16,25-29,1947,53.71721875044965
STAT,1867,40,20-24,1907,0.14228863702603314
SIM,1853,21,30-34,1874,25
SIM,1907,26,35-39,1933,20
STAT,1829,49,30-34,1878,0.07609214775691864
STAT,1915,27,30-34,1942,37.75150760583945
STAT,1896,27,50-100,1923,0.7986765513500003
STAT,1905,36,30-34,1941,1.5779547608012179
STAT,1887,47,25-29,1934,0.06057049380727899
STAT,1926,46,45-49,1972,0.2539978645767572
SIM,1859,14,na,1873,2289
SIM,1864,22,15-19,1886,4
STAT,1832,34,30-34,1866,13.519735938567393
STAT,1850,48,40-44,1898,0.1190107933225165
STAT,1840,19,50-100,1859,0.043655664436181955
STAT,1901,45,50-100,1946,0.1850144250511948
SIM,1839,31,20-24,1870,2
SIM,1881,35,30-34,1916,7
SIM,1905,32,25-29,1937,5
SIM,1855,32,na,1887,1955
SIM,1913,24,30-34,1937,34
SIM,1801,83,na,1884,117
STAT,1822,44,15-19,1866,0.019747194590567965
SIM,1914,33,50-100,1947,4
STAT,1897,19,na,1916,3173.777507709779
SIM,1851,20,15-19,1871,3
SIM,1840,34,30-34,1874,21
STAT,1794,104,na,1898,0.011984454182254816
STAT,1931,16,na,1947,4562.576655797788
STAT,1791,99,na,1890,0.34762051253319226
STAT,1917,41,45-49,1958,0.1643075600079858
STAT,1916,26,35-39,1942,14.714796313771403
STAT,1856,22,15-19,1878,2.834909615263773
STAT,1931,32,30-34,1963,19.503080456975848
STAT,1850,15,50-100,1865,0.04264762364274843
SIM,1842,88,na,1930,65
SIM,1909,24,45-49,1933,7
STAT,1804,74,na,1878,472.5866947969424
STAT,1857,23,15-19,1880,2.8160429152128517
SIM,1934,28,15-19,1962,1
STAT,1853,19,45-49,1872,0.05759014255746787
STAT,1845,21,30-34,1866,15.688487259433112
SIM,1849,20,25-29,1869,42
STAT,1827,48,na,1875,1384.1446333136744
STAT,1888,20,40-44,1908,2.3394273915612813
SIM,1879,17,15-19,1896,6
STAT,1866,58,na,1924,1722.465721293217
STAT,1882,65,na,1947,1553.4981607791133
STAT,1915,25,35-39,1940,14.56335183297604
STAT,1814,81,na,1895,223.1172451830717
STAT,1930,17,20-24,1947,165.59256063293407
STAT,1776,82,na,1858,131.13140131672967
STAT,1917,44,45-49,1961,0.16352505449055577
SIM,1944,18,30-34,1962,11
STAT,1878,30,25-29,1908,10.154084217091693
STAT,1952,18,50-100,1970,0.4240248548672397
SIM,1880,39,na,1919,2395
SIM,1922,26,30-34,1948,54
STAT,1787,85,na,1872,84.70354066435672
SIM,1866,1,na,1867,2985
SIM,1884,30,20-24,1914,1
SIM,1911,39,na,1950,3457
STAT,1900,32,30-34,1932,22.88252276250315
STAT,1933,4,na,1937,5104.246865287852
STAT,1783,92,na,1875,9.065666422473994
STAT,1863,49,35-39,1912,0.11383052555218548
STAT,1912,34,15-19,1946,0.11840400746257526
SIM,1873,29,na,1902,2256
SIM,1923,27,30-34,1950,53
STAT,1906,19,30-34,1925,2.1807830987784955
STAT,1909,47,20-24,1956,0.009590669312400027
SIM,1914,19,30-34,1933,2
STAT,1936,18,30-34,1954,10.99326917188243
STAT,1898,22,20-24,1920,88.12715327832636
STAT,1951,16,na,1967,4142.05031719676
SIM,1865,23,15-19,1888,2
SIM,1852,95,na,1947,6
SIM,1908,23,45-49,1931,3
SIM,1886,30,25-29,1916,2
STAT,1864,100,na,1964,3.4068262486477625
SIM,1856,88,na,1944,74
STAT,1828,100,na,1928,0.6026709409804097
STAT,1904,26,50-100,1930,0.8696442157863572
STAT,1922,36,50-100,1958,0.45176212368956675
SIM,1911,26,20-24,1937,16
SIM,1892,21,15-19,1913,4
STAT,1893,33,25-29,1926,12.225140858799978
STAT,1937,15,15-19,1952,41.89666120914353
STAT,1933,22,20-24,1955,139.3380555344298
STAT,1942,15,50-100,1957,0.3700531203445572
STAT,1875,48,45-49,1923,0.22616899016764055
STAT,1920,29,25-29,1949,67.72581977461441
SIM,1877,20,35-39,1897,7
SIM,1856,5,na,1861,2342
SIM,1872,29,30-34,1901,23
STAT,1934,28,45-49,1962,2.19442271010757
SIM,1828,31,45-49,1859,1
STAT,1862,65,na,1927,1361.8357292016844
STAT,1855,39,30-34,1894,3.7366133702776327
SIM,1835,29,45-49,1864,4
SIM,1929,18,35-39,1947,7
STAT,1826,42,25-29,1868,0.6326342936025883
SIM,1900,47,na,1947,2909
STAT,1927,30,45-49,1957,1.8308992384366074
STAT,1898,40,20-24,1938,0.014245597873537656
SIM,1873,18,25-29,1891,8
STAT,1916,42,na,1958,3595.332150463141
STAT,1887,22,45-49,1909,0.7367178171479576
STAT,1901,31,40-44,1932,5.757817968758003
STAT,1860,41,50-100,1901,0.8147711968530984
SIM,1836,48,na,1884,1461
SIM,1942,28,45-49,1970,3
STAT,1896,5,na,1901,3271.9515976325456
SIM,1947,23,na,1970,3717
STAT,1830,36,20-24,1866,0.6201149670580677
STAT,1848,84,na,1932,239.65839239164853
STAT,1893,68,na,1961,1979.7086859849312
STAT,1862,76,na,1938,763.4537071722011
SIM,1847,88,na,1935,82
STAT,1893,57,na,1950,2408.7759008099515
STAT,1884,21,15-19,1905,3.0890680614648285
STAT,1856,28,na,1884,1816.6087724939398
STAT,1939,29,40-44,1968,4.421724663749666
STAT,1876,18,35-39,1894,0.5337295092469202
STAT,1880,20,50-100,1900,0.40776153074975374
SIM,1802,68,na,1870,756
SIM,1840,30,na,1870,1806
STAT,1889,16,20-24,1905,20.72707119134039
STAT,1941,15,35-39,1956,4.084899902894405
SIM,1842,96,na,1938,3
SIM,1903,31,45-49,1934,2
STAT,1829,28,50-100,1857,0.7834001397444712
STAT,1855,54,25-29,1909,0.0024395994430623227
STAT,1869,41,50-100,1910,0.9704296623634237
STAT,1769,89,na,1858,29.599696108581487
STAT,1856,40,45-49,1896,1.1185286845538074
SIM,1900,24,25-29,1924,74
STAT,1931,29,35-39,1960,18.293434000774344
STAT,1929,24,20-24,1953,132.0140369416443
STAT,1859,34,35-39,1893,7.569675440270496
STAT,1864,48,35-39,1912,0.11671827592865106
SIM,1940,27,30-34,1967,47
STAT,1880,35,50-100,1915,1.2319644142004869
SIM,1770,97,na,1867,1
SIM,1897,16,20-24,1913,20
STAT,1914,16,25-29,1930,8.48773184621144
STAT,1869,20,35-39,1889,5.3909954178302275
SIM,1910,54,na,1964,3080
STAT,1835,74,na,1909,692.4301312323215
STAT,1873,53,30-34,1926,0.0056163020299808035
STAT,1827,29,45-49,1856,1.6065774338383016
SIM,1866,20,25-29,1886,47
SIM,1922,16,25-29,1938,66
STAT,1899,38,50-100,1937,0.3413676957118733
STAT,1814,53,25-29,1867,0.00900892213902692
STAT,1803,89,na,1892,34.70731611516198
SIM,1848,73,na,1921,836
STAT,1876,28,na,1904,2319.2769791880664
STAT,1845,73,na,1918,836.6308169206353
STAT,1908,38,45-49,1946,0.5998407565266415
STAT,1849,41,15-19,1890,0.009999038011475633
SIM,1854,21,45-49,1875,1
STAT,1811,52,50-100,1863,0.047956214652109926
STAT,1773,100,na,1873,0.14642959960875643
STAT,1903,44,20-24,1947,0.014622328807214365
SIM,1858,80,na,1938,448
SIM,1929,28,50-100,1957,1
STAT,1851,25,50-100,1876,0.5572202980175864
STAT,1913,30,20-24,1943,2.310468796730883
SIM,1815,86,na,1901,78
STAT,1862,22,40-44,1884,1.718990609281789
SIM,1860,22,na,1882,2049
SIM,1941,24,40-44,1965,4
STAT,1918,24,45-49,1942,1.139208628091856
STAT,1858,20,25-29,1878,49.41827067572641
STAT,1879,53,na,1932,2091.969929383381
STAT,1767,109,na,1876,0.002219492744651207
SIM,1939,19,35-39,1958,6
STAT,1831,46,50-100,1877,0.18291134722722388
STAT,1835,66,na,1901,1022.6272252108038
STAT,1875,35,30-34,1910,5.221682291810923
STAT,1922,22,45-49,1944,1.219039904621782
SIM,1870,37,50-100,1907,2
SIM,1930,22,45-49,1952,1
STAT,1935,37,20-24,1972,0.3482056198436006
SIM,1853,29,na,1882,1957
SIM,1918,28,30-34,1946,47
SIM,1870,22,40-44,1892,2
SIM,1900,44,na,1944,2983
STAT,1852,32,25-29,1884,8.057380994123864
SIM,1927,17,20-24,1944,147
STAT,1919,17,20-24,1936,141.53580004142165
STAT,1772,101,na,1873,0.1116806399243507
STAT,1810,49,15-19,1859,0.0013749797760356645
STAT,1911,17,15-19,1928,8.577435101249659
SIM,1931,34,25-29,1965,17
STAT,1915,43,30-34,1958,0.12138959936610055
STAT,1846,46,25-29,1892,0.040727478646861964
SIM,1860,32,25-29,1892,9
SIM,1900,26,45-49,1926,2
STAT,1848,15,20-24,1863,16.021020718913274
STAT,1872,26,15-19,1898,0.43167813351312934
STAT,1814,41,na,1855,1343.1398212723373
STAT,1923,38,40-44,1961,1.6370972411249962
SIM,1873,40,na,1913,2239
SIM,1888,23,15-19,1911,3
SIM,1831,28,30-34,1859,27
SIM,1846,47,na,1893,1573
STAT,1903,26,20-24,1929,15.821568083024973
STAT,1911,32,40-44,1943,3.5990993644155975
STAT,1846,21,45-49,1867,0.6110304761093154
SIM,1941,22,20-24,1963,101
STAT,1834,47,45-49,1881,0.15492358949764776
STAT,1881,44,25-29,1925,0.5778332850745896
STAT,1923,34,25-29,1957,9.997725373303386
STAT,1897,37,50-100,1934,1.55114907350106
STAT,1839,28,25-29,1867,35.27735642176123
SIM,1856,15,20-24,1871,16
SIM,1917,24,na,1941,3614
STAT,1871,37,20-24,1908,0.7219334780479653
STAT,1847,22,45-49,1869,0.6289876896321162
SIM,1868,35,35-39,1903,9
SIM,1855,22,45-49,1877,1
SIM,1932,35,25-29,1967,4
STAT,1913,48,25-29,1961,0.04876406267035123
STAT,1924,35,25-29,1959,1.098821327253901
STAT,1868,27,40-44,1895,2.701929840501208
SIM,1931,38,40-44,1969,2
SIM,1918,24,15-19,1942,4
STAT,1874,21,20-24,1895,66.7380673536836
STAT,1770,97,na,1867,0.6608974279825616
STAT,1822,48,na,1870,1329.023834169583
STAT,1858,91,na,1949,42.97581704075369
SIM,1915,18,40-44,1933,1
STAT,1861,21,50-100,1882,0.3310245922554955
SIM,1886,24,na,1910,2275
STAT,1891,20,45-49,1911,0.8202478427589676
STAT,1869,46,na,1915,2063.1783464312884
STAT,1866,8,na,1874,2412.470053199756
STAT,1890,19,30-34,1909,1.8310895619089012
SIM,1847,28,25-29,1875,35
STAT,1906,32,na,1938,3310.55401501254
STAT,1933,24,40-44,1957,4.210505934007091
STAT,1798,69,na,1867,684.9108172296732
STAT,1907,37,45-49,1944,0.596994590527513
STAT,1863,46,30-34,1909,0.08061226016166435
STAT,1836,32,40-44,1868,3.4616035569008177
STAT,1906,31,20-24,1937,2.1438031788028966
STAT,1921,21,45-49,1942,1.2043056184701475
STAT,1812,106,na,1918,0.005222120546589864
STAT,1842,99,na,1941,1.3486465443981368
SIM,1925,21,25-29,1946,109
STAT,1930,19,40-44,1949,1.699236109490817
STAT,1901,40,na,1941,3097.6205279147853
STAT,1880,49,30-34,1929,0.09421006714144163
STAT,1940,22,25-29,1962,88.8830678001647
SIM,1922,47,50-100,1969,1
STAT,1852,66,na,1918,1245.2745849757607
SIM,1859,20,20-24,1879,67
SIM,1936,23,20-24,1959,83
SIM,1839,22,na,1861,1892
STAT,1833,27,50-100,1860,0.5150036240222307
STAT,1886,25,35-39,1911,9.696167221699671
SIM,1852,23,35-39,1875,5
SIM,1927,31,na,1958,4300
SIM,1904,18,30-34,1922,1
STAT,1844,23,35-39,1867,5.078098437987167
STAT,1887,16,50-100,1903,0.05188687235559764
STAT,1905,20,15-19,1925,4.530552059251731
SIM,1908,20,40-44,1928,3
STAT,1915,57,na,1972,3343.3350976517513
SIM,1829,55,na,1884,1167
STAT,1822,47,50-100,1869,0.3426100532505491
STAT,1823,47,35-39,1870,0.16700510133357532
SIM,1913,39,35-39,1952,6
SIM,1787,74,na,1861,404
STAT,1868,50,na,1918,1970.0167129976069
STAT,1937,35,30-34,1972,1.7244367945372423
SIM,1899,29,35-39,1928,14
STAT,1870,40,na,1910,2161.0318986233096
SIM,1915,37,45-49,1952,1
STAT,1917,21,25-29,1938,93.01802453154956
SIM,1869,32,45-49,1901,1
SIM,1819,48,na,1867,1341
STAT,1788,70,na,1858,634.0220795280273
SIM,1844,32,40-44,1876,4
STAT,1900,35,35-39,1935,9.357732234722661
STAT,1890,38,35-39,1928,8.128895063903116
SIM,1827,34,35-39,1861,10
SIM,1835,55,na,1890,1325
SIM,1915,32,20-24,1947,2
STAT,1855,29,20-24,1884,8.536460631471128
STAT,1955,0,na,1955,4967.030162271339
SIM,1878,21,35-39,1899,4
STAT,1821,49,25-29,1870,0.08541764138637148
STAT,1920,47,25-29,1967,0.05539675674854289
SIM,1913,20,15-19,1933,3
SIM,1795,92,na,1887,7
STAT,1893,43,35-39,1936,0.1496331357125248
STAT,1864,91,na,1955,48.92596544170841
STAT,1915,19,45-49,1934,0.09823002773882447
SIM,1848,25,35-39,1873,12
STAT,1875,94,na,1969,82.38337919901663
SIM,1845,22,na,1867,1861
SIM,1862,101,na,1963,1
SIM,1847,49,50-100,1896,2
STAT,1937,33,45-49,1970,1.469602900274869
SIM,1771,90,na,1861,17
SIM,1829,32,45-49,1861,2
STAT,1857,98,na,1955,2.419353570284161
STAT,1907,32,20-24,1939,2.1534826325332586
STAT,1839,25,na,1864,1843.4881329098405
STAT,1866,15,35-39,1881,0.4963757866152856
STAT,1868,61,na,1929,1685.4663697290603
STAT,1790,74,na,1864,423.5701273691524
SIM,1866,47,na,1913,1971
SIM,1896,38,50-100,1934,2
STAT,1831,31,50-100,1862,0.7611651083373092
STAT,1926,43,40-44,1969,0.29087152919109466
SIM,1822,45,na,1867,1446
SIM,1873,30,45-49,1903,2
STAT,1888,23,45-49,1911,0.7758132631656853
SIM,1853,24,35-39,1877,9
STAT,1842,53,30-34,1895,0.004170825557287657
SIM,1858,28,35-39,1886,9
SIM,1909,49,50-100,1958,3
STAT,1796,104,na,1900,0.015539273446946418
STAT,1865,18,25-29,1883,4.983328899569294
STAT,1874,13,na,1887,2512.7209384954417
SIM,1937,24,20-24,1961,100
STAT,1821,74,na,1895,599.2843672142561
STAT,1885,24,35-39,1909,5.457851060243447
STAT,1786,92,na,1878,10.789375767951224
STAT,1828,33,na,1861,1616.2490810361198
STAT,1857,10,na,1867,2115.823371442333
STAT,1928,23,20-24,1951,130.76151682755673
SIM,1874,15,35-39,1889,3
SIM,1894,25,35-39,1919,14
STAT,1899,45,na,1944,2942.259229355926
STAT,1850,88,na,1938,96.6479656841427
SIM,1885,43,50-100,1928,1
SIM,1943,16,na,1959,3626
SIM,1769,89,na,1858,22
SIM,1906,6,na,1912,3669
SIM,1914,31,20-24,1945,2
SIM,1817,100,na,1917,1
STAT,1929,43,25-29,1972,0.08722996205585454
SIM,1945,15,15-19,1960,43
STAT,1928,41,20-24,1969,0.021301361557627307
STAT,1891,15,50-100,1906,0.057552694836718564
STAT,1894,53,na,1947,2574.631679652397
STAT,1905,39,35-39,1944,2.0631090538256465
STAT,1867,43,25-29,1910,0.5654789811837817
SIM,1909,21,40-44,1930,4
SIM,1901,18,na,1919,3401
STAT,1900,47,na,1947,2935.416819615116
SIM,1935,30,45-49,1965,3
STAT,1834,34,30-34,1868,13.558974608912703
SIM,1842,34,30-34,1876,24
SIM,1893,57,na,1950,2489
SIM,1838,16,15-19,1854,4
STAT,1917,41,40-44,1958,0.2469351220545562
SIM,1912,26,50-100,1938,4
STAT,1876,1,na,1877,3368.8800605085494
SIM,1889,75,na,1964,1431
STAT,1842,26,50-100,1868,0.5674086654884508
STAT,1853,16,40-44,1869,0.1641356665066776
SIM,1798,66,na,1864,761
SIM,1885,33,40-44,1918,4
STAT,1846,36,15-19,1882,0.041777815092949144
STAT,1887,40,45-49,1927,1.597149974589707
STAT,1910,54,na,1964,3152.6499935785314
STAT,1877,33,40-44,1910,4.233416087209963
SIM,1877,39,na,1916,2282
SIM,1903,17,30-34,1920,3
SIM,1832,24,30-34,1856,18
SIM,1886,44,na,1930,2227
STAT,1870,41,45-49,1911,1.3916627334302996
SIM,1833,51,na,1884,1358
SIM,1922,25,20-24,1947,19
STAT,1895,60,na,1955,2351.1706949864874
STAT,1847,19,15-19,1866,5.385905240019146
SIM,1921,5,na,1926,4235
SIM,1882,54,na,1936,1882
SIM,1926,18,15-19,1944,45
SIM,1852,29,45-49,1881,3
STAT,1927,41,35-39,1968,0.23894661566987518
SIM,1862,30,35-39,1892,12
STAT,1829,39,20-24,1868,0.6635903766931247
STAT,1949,18,45-49,1967,0.5487198215117173
STAT,1858,48,45-49,1906,0.17282539908805916
SIM,1868,36,45-49,1904,2
STAT,1859,22,na,1881,1849.9937003939358
SIM,1873,19,35-39,1892,1
STAT,1912,37,20-24,1949,0.24300079029874985
STAT,1924,15,35-39,1939,4.742934208206204
SIM,1878,49,na,1927,2230
STAT,1920,22,40-44,1942,3.5314467059618218
SIM,1887,30,40-44,1917,4
STAT,1897,16,50-100,1913,0.06204911271165665
SIM,1874,25,50-100,1899,2
SIM,1899,22,15-19,1921,4
STAT,1879,30,40-44,1909,4.316634035574065
SIM,1863,42,50-100,1905,1
STAT,1879,53,50-100,1932,0.01467349613690734
SIM,1844,15,na,1859,2148
STAT,1868,42,30-34,1910,1.035697656971677
STAT,1844,29,45-49,1873,0.9405171059045891
SIM,1885,35,35-39,1920,14
SIM,1914,26,40-44,1940,5
STAT,1828,40,35-39,1868,1.6518730834945594
SIM,1941,6,na,1947,3743
STAT,1865,19,35-39,1884,0.47969345114650974
SIM,1869,17,20-24,1886,14
STAT,1828,30,na,1858,1663.269757005377
SIM,1919,40,40-44,1959,3
STAT,1856,28,25-29,1884,32.19961614429357
STAT,1850,47,30-34,1897,0.06782971757769488
STAT,1879,22,na,1901,2335.32486751459
STAT,1930,26,15-19,1956,0.8484308968945594
SIM,1883,38,35-39,1921,17
SIM,1855,19,15-19,1874,9
STAT,1860,19,na,1879,2008.6792005831214
STAT,1922,27,35-39,1949,16.050315394855957
STAT,1877,18,15-19,1895,5.802498399928398
STAT,1891,70,na,1961,1799.0676044920306
SIM,1917,43,40-44,1960,2
SIM,1965,0,na,1965,4566
STAT,1877,35,35-39,1912,6.9995552365936735
STAT,1930,37,40-44,1967,1.8447252351926395
SIM,1822,99,na,1921,2
STAT,1898,25,25-29,1923,54.463202701089436
STAT,1903,25,45-49,1928,1.5024082425023964
STAT,1892,44,30-34,1936,0.09317088621215065
STAT,1936,32,45-49,1968,1.4436450968179306
SIM,1830,27,30-34,1857,23
SIM,1859,42,na,1901,1920
SIM,1901,40,na,1941,3160
STAT,1848,15,50-100,1863,0.04427326132373004
STAT,1865,28,35-39,1893,8.253916362263235
SIM,1863,29,20-24,1892,9
SIM,1880,53,na,1933,2221
STAT,1875,47,35-39,1922,0.13524186561472545
STAT,1829,46,25-29,1875,0.04708864677126576
SIM,1905,26,30-34,1931,34
STAT,1894,32,30-34,1926,21.21740236455951
STAT,1880,27,20-24,1907,11.66104408557363
STAT,1896,37,25-29,1933,3.5947704134758043
STAT,1901,37,45-49,1938,0.5689491240996027
STAT,1911,10,na,1921,3743.8980696233157
STAT,1818,103,na,1921,0.06919196692356053
STAT,1891,15,30-34,1906,1.8723813860288971
STAT,1798,60,na,1858,958.0192761734966
STAT,1873,25,20-24,1898,11.325705866960448
SIM,1853,51,na,1904,1743
STAT,1868,84,na,1952,300.05455928629925
STAT,1923,2,na,1925,4537.250520339055
SIM,1799,62,na,1861,861
SIM,1914,13,na,1927,4164
SIM,1894,26,45-49,1920,1
STAT,1927,11,na,1938,4661.598172606993
SIM,1888,36,30-34,1924,5
STAT,1870,23,na,1893,2182.488548400729
SIM,1818,60,na,1878,965
STAT,1890,49,25-29,1939,0.03674464939779815
SIM,1864,28,25-29,1892,42
SIM,1843,36,40-44,1879,9
STAT,1884,38,45-49,1922,1.851768465286582
SIM,1836,40,35-39,1876,5
STAT,1921,28,30-34,1949,41.11224140577033
STAT,1919,47,15-19,1966,3.774506997861686E-4
SIM,1865,62,na,1927,1552
SIM,1910,23,na,1933,3319
SIM,1876,42,30-34,1918,1
STAT,1814,50,20-24,1864,0.0019930564394588283
STAT,1866,54,30-34,1920,0.005042032110026722
STAT,1895,31,35-39,1926,12.53566497791681
STAT,1882,16,30-34,1898,1.4687630687485977
STAT,1761,111,na,1872,7.544698710037607E-4
STAT,1840,64,na,1904,1210.6218425307152
STAT,1929,37,30-34,1966,2.210597837821165
STAT,1931,32,50-100,1963,1.0234765163085606
STAT,1881,41,20-24,1922,0.14551580934429598
SIM,1892,38,45-49,1930,2
STAT,1946,6,na,1952,4145.703397346382
SIM,1907,23,30-34,1930,32
SIM,1890,15,20-24,1905,18
SIM,1911,25,45-49,1936,1
STAT,1833,48,40-44,1881,0.10962868459961522
SIM,1919,8,na,1927,4152
STAT,1875,22,20-24,1897,66.88219556304252
STAT,1923,21,na,1944,4026.496408100522
SIM,1869,52,na,1921,1966
STAT,1847,35,20-24,1882,0.6008253964576958
SIM,1859,76,na,1935,762
STAT,1812,69,na,1881,744.5743937346172
STAT,1817,47,45-49,1864,0.5280259043959766
SIM,1918,45,50-100,1963,2
SIM,1940,21,20-24,1961,97
SIM,1855,52,na,1907,1697
SIM,1863,36,25-29,1899,2
STAT,1849,18,40-44,1867,0.1613224026959707
SIM,1818,44,35-39,1862,2
STAT,1914,25,20-24,1939,17.498917500739662
SIM,1910,33,45-49,1943,1
SIM,1921,25,50-100,1946,1
STAT,1906,63,na,1969,2739.0191364849466
STAT,1887,46,15-19,1933,4.2379808854186646E-4
STAT,1904,47,40-44,1951,0.13022673296648676
STAT,1906,26,40-44,1932,4.134866082647572
SIM,1901,60,na,1961,2635
STAT,1835,36,40-44,1871,3.4119048698899297
SIM,1886,39,30-34,1925,5
STAT,1875,32,na,1907,2316.005609073974
SIM,1923,24,25-29,1947,86
STAT,1913,36,25-29,1949,0.92213710523475
STAT,1913,11,na,1924,3819.3889794763195
STAT,1845,47,20-24,1892,0.008413170135074038
SIM,1826,39,45-49,1865,2
STAT,1818,39,45-49,1857,5.532234819941299
STAT,1957,15,50-100,1972,0.4668224695846526
STAT,1868,47,50-100,1915,0.22049279551748466
SIM,1865,24,25-29,1889,56
SIM,1834,38,50-100,1872,3
STAT,1889,34,15-19,1923,0.16466412057819999
STAT,1909,20,50-100,1929,0.5810213295341635
SIM,1888,27,30-34,1915,26
STAT,1919,16,na,1935,4055.2592116951428
SIM,1873,26,na,1899,2296
STAT,1902,33,45-49,1935,2.3149627896992486
SIM,1903,41,na,1944,3148
SIM,1889,37,50-100,1926,1
STAT,1915,24,25-29,1939,89.6274500435534
STAT,1932,21,20-24,1953,138.24712365246558
SIM,1838,38,25-29,1876,5
STAT,1937,30,40-44,1967,3.6611630448345758
STAT,1891,48,30-34,1939,0.06304570902166137
STAT,1895,38,20-24,1933,0.9455888445843866
SIM,1788,90,na,1878,18
STAT,1935,36,45-49,1971,0.9013122172035372
SIM,1906,25,35-39,1931,15
STAT,1808,95,na,1903,5.167780213225325
STAT,1876,37,40-44,1913,4.2691832483932295
SIM,1857,32,20-24,1889,2
STAT,1873,37,na,1910,2259.1661262423
STAT,1874,48,30-34,1922,0.09228908080960291
SIM,1872,22,45-49,1894,1
STAT,1911,2,na,1913,3852.781111055671
STAT,1943,19,20-24,1962,135.71991780353665
SIM,1835,32,na,1867,1699
SIM,1840,33,na,1873,1772
SIM,1894,40,25-29,1934,2
STAT,1819,35,45-49,1854,6.056471172692966
STAT,1881,26,25-29,1907,38.71739979462896
STAT,1822,45,na,1867,1381.0932732672807
STAT,1813,96,na,1909,3.6315329956261406
STAT,1874,24,25-29,1898,54.92642796045843
STAT,1904,21,45-49,1925,0.9475996580809595
STAT,1899,42,na,1941,2998.799146600207
STAT,1834,46,35-39,1880,0.10229537550018253
STAT,1859,21,25-29,1880,49.56332924792576
SIM,1847,38,35-39,1885,14
STAT,1849,46,na,1895,1626.2688036353043
STAT,1862,14,na,1876,2183.284835583112
SIM,1829,38,na,1867,1537
STAT,1815,97,na,1912,2.29932642338004
SIM,1822,35,25-29,1857,1
SIM,1874,49,50-100,1923,3
SIM,1897,16,na,1913,3245
STAT,1897,29,25-29,1926,53.062288976767064
STAT,1845,49,15-19,1894,2.75869528418129E-4
SIM,1842,37,35-39,1879,15
SIM,1808,84,na,1892,113
SIM,1921,33,20-24,1954,1
STAT,1878,39,30-34,1917,5.188634500838092
STAT,1931,30,na,1961,4687.047243358429
STAT,1822,32,50-100,1854,2.7863781211875636
STAT,1874,23,15-19,1897,3.1754691091721567
STAT,1949,23,25-29,1972,101.79726616171396
SIM,1768,90,na,1858,15
SIM,1884,37,40-44,1921,4
STAT,1869,40,25-29,1909,0.5931372001368072
SIM,1787,97,na,1884,1
SIM,1867,21,25-29,1888,50
STAT,1877,41,na,1918,2275.9995489957764
STAT,1919,36,na,1955,3821.7077114807303
STAT,1859,33,50-100,1892,0.6878649202002384
SIM,1912,58,na,1970,2999
STAT,1831,34,15-19,1865,0.11396622730143263
STAT,1864,22,45-49,1886,0.59822379510371
STAT,1834,37,35-39,1871,5.44575085496253
STAT,1870,19,45-49,1889,0.06032608988049428
STAT,1886,26,45-49,1912,1.1120234824958017
STAT,1828,47,20-24,1875,0.010107701185728082
STAT,1917,28,50-100,1945,0.9825963537063349
SIM,1863,81,na,1944,407
STAT,1831,81,na,1912,329.79337083611733
STAT,1808,47,35-39,1855,0.5329582711366394
STAT,1776,99,na,1875,0.2914038321482061
STAT,1859,22,35-39,1881,4.5646424932828165
STAT,1766,110,na,1876,0.001809087149115964
STAT,1932,16,40-44,1948,1.7540085181684342
SIM,1888,29,25-29,1917,46
SIM,1902,32,40-44,1934,12
STAT,1809,46,40-44,1855,0.6361261526255573
STAT,1827,41,30-34,1868,1.0763990583444503
STAT,1849,32,20-24,1881,2.053064117231646
STAT,1929,39,25-29,1968,1.1916886481432098
STAT,1840,18,20-24,1858,15.891131712725391
STAT,1881,25,15-19,1906,0.41664967960660576
SIM,1880,59,na,1939,2022
STAT,1913,45,na,1958,3402.6318160151804
STAT,1835,97,na,1932,3.351901900388904
STAT,1851,46,35-39,1897,0.10295578430819162
STAT,1889,12,na,1901,3011.908094472644
STAT,1923,16,30-34,1939,13.55538820691637
STAT,1918,36,45-49,1954,0.6820575939945012
STAT,1843,37,45-49,1880,1.6789848261890155
SIM,1951,19,20-24,1970,150
STAT,1850,17,35-39,1867,0.47204328618322716
STAT,1852,50,25-29,1902,0.0027297960208997386
STAT,1893,51,na,1944,2593.2405957574283
SIM,1827,35,45-49,1862,2
SIM,1940,16,40-44,1956,2
SIM,1906,24,25-29,1930,94
STAT,1866,89,na,1955,91.50046555028146
STAT,1938,20,45-49,1958,1.0525989900719217
SIM,1831,25,25-29,1856,39
SIM,1888,79,na,1967,1134
STAT,1873,43,50-100,1916,1.0057225337264046
STAT,1869,48,20-24,1917,0.010835362774926858
STAT,1875,38,35-39,1913,6.8304911019402255
STAT,1832,69,na,1901,887.3626160074393
STAT,1872,35,15-19,1907,0.053751567560011856
SIM,1867,22,35-39,1889,6
STAT,1909,46,45-49,1955,0.18908542116363736
SIM,1883,81,na,1964,746
SIM,1852,48,50-100,1900,3
SIM,1931,16,30-34,1947,16
SIM,1949,21,40-44,1970,3
STAT,1928,40,40-44,1968,0.30209389005854403
STAT,1837,38,30-34,1875,4.053931845665619
STAT,1948,19,na,1967,3976.955711541214
STAT,1818,54,na,1872,1203.2384081135542
STAT,1919,44,50-100,1963,0.11986943895666032
SIM,1866,23,30-34,1889,20
SIM,1845,38,30-34,1883,7
SIM,1915,15,35-39,1930,2
STAT,1906,33,50-100,1939,0.72066514896127
SIM,1932,15,35-39,1947,9
STAT,1848,33,15-19,1881,0.1077501444331076
STAT,1841,17,25-29,1858,5.000476769032577
STAT,1931,20,50-100,1951,0.811035531893953
SIM,1866,24,na,1890,2076
STAT,1954,13,na,1967,4586.599196886664
SIM,1926,38,na,1964,4195
STAT,1844,41,30-34,1885,0.8372402437996298
STAT,1858,23,30-34,1881,13.693607514399392
STAT,1862,0,na,1862,3105.618502982615
STAT,1890,16,25-29,1906,6.561299621128217
STAT,1881,19,20-24,1900,16.08425153888842
STAT,1886,48,20-24,1934,0.011826992697065513
SIM,1868,59,na,1927,1741
SIM,1946,20,45-49,1966,1
SIM,1867,37,40-44,1904,5
STAT,1864,53,50-100,1917,0.012546676338809192
SIM,1904,29,na,1933,3127
STAT,1852,69,na,1921,1114.9988830188113
STAT,1860,37,45-49,1897,1.5305187025623155
SIM,1823,61,na,1884,1004
SIM,1941,15,na,1956,3476
STAT,1892,47,35-39,1939,0.09298846128169114
SIM,1907,8,na,1915,3664
STAT,1839,38,35-39,1877,5.57749399088906
STAT,1940,18,25-29,1958,41.548925780013754
STAT,1922,42,30-34,1964,0.13863529421561008
SIM,1823,100,na,1923,3
STAT,1853,31,30-34,1884,13.473207527496239
STAT,1879,15,15-19,1894,5.887192078805747
STAT,1838,54,na,1892,1428.1295943412943
STAT,1928,34,50-100,1962,0.9754768006247269
STAT,1824,54,50-100,1878,0.016422076830808444
SIM,1894,73,na,1967,1820
STAT,1855,51,20-24,1906,5.251222046334702E-4
SIM,1793,91,na,1884,7
STAT,1857,110,na,1967,0.0018058012830272033
STAT,1899,49,45-49,1948,0.16874527119141236
STAT,1840,98,na,1938,2.2623383574420086
STAT,1861,29,45-49,1890,0.8647816355546212
STAT,1904,36,15-19,1940,0.016500126892641798
SIM,1889,49,50-100,1938,1
STAT,1903,7,na,1910,3501.6848278155435
STAT,1907,15,35-39,1922,0.7648530365508361
STAT,1865,33,15-19,1898,0.12173324066376581
STAT,1839,29,35-39,1868,7.9889679839408485
SIM,1847,29,35-39,1876,10
STAT,1880,42,15-19,1922,0.013710048726211075
STAT,1886,40,25-29,1926,0.6474198861720396
STAT,1840,25,25-29,1865,37.26479281747901
STAT,1854,30,35-39,1884,7.6246114991245255
STAT,1918,18,15-19,1936,46.54172102700674
STAT,1940,13,na,1953,3778.7293888395943
SIM,1846,24,na,1870,1835
SIM,1888,59,na,1947,2121
STAT,1914,26,30-34,1940,37.43685164671918
STAT,1853,31,na,1884,1841.4538613036264
SIM,1861,31,30-34,1892,15
SIM,1879,39,25-29,1918,3
SIM,1871,28,30-34,1899,23
SIM,1909,18,15-19,1927,8
STAT,1846,39,20-24,1885,0.5559057264736434
SIM,1840,84,na,1924,184
STAT,1830,38,15-19,1868,0.04396675800690376
STAT,1839,43,15-19,1882,0.009581295226005211
STAT,1865,25,30-34,1890,21.763930421592374
SIM,1843,42,35-39,1885,4
SIM,1943,26,50-100,1969,1
SIM,1891,45,na,1936,2783
STAT,1899,22,na,1921,3061.8237853508313
SIM,1868,33,40-44,1901,4
STAT,1906,29,45-49,1935,1.5164268273344035
STAT,1891,18,35-39,1909,0.6399282749157869
SIM,1890,69,na,1959,1824
STAT,1875,2,na,1877,3171.2162238412748
STAT,1802,79,na,1881,279.7922784682819
STAT,1914,28,25-29,1942,62.452026724300474
STAT,1935,26,50-100,1961,1.2822647977102906
STAT,1765,100,na,1865,0.19144802438200725
SIM,1931,26,40-44,1957,5
STAT,1832,24,20-24,1856,59.64873144681116
SIM,1879,42,na,1921,2270
STAT,1877,36,45-49,1913,1.9636547694297766
SIM,1832,27,35-39,1859,9
STAT,1886,21,50-100,1907,0.4082543015302509
SIM,1858,31,25-29,1889,9
SIM,1848,28,40-44,1876,2
STAT,1834,21,20-24,1855,57.46150253759586
STAT,1879,76,na,1955,935.496762543498
STAT,1846,83,na,1929,279.9045958245088
STAT,1767,88,na,1855,30.753399999999996
STAT,1822,79,na,1901,361.1108932685496
SIM,1885,36,45-49,1921,2
STAT,1840,15,15-19,1855,5.414602615214325
SIM,1873,25,30-34,1898,29
STAT,1858,47,35-39,1905,0.1033440940818365
SIM,1837,67,na,1904,986
SIM,1898,33,20-24,1931,3
STAT,1916,23,30-34,1939,28.36241547556898
STAT,1923,26,40-44,1949,5.0732178084141255
SIM,1874,37,50-100,1911,1
STAT,1860,52,40-44,1912,0.008039676355771673
STAT,1881,80,na,1961,745.9717039125336
SIM,1857,45,50-100,1902,3
STAT,1917,16,50-100,1933,0.0763476591368414
SIM,1922,28,25-29,1950,78
SIM,1824,60,na,1884,1038
STAT,1839,26,30-34,1865,21.305343162901476
STAT,1912,4,na,1916,3842.141554115524
SIM,1867,48,50-100,1915,1
SIM,1906,38,na,1944,3301
STAT,1895,30,25-29,1925,12.728578701825667
STAT,1891,41,50-100,1932,1.2409058104247366
STAT,1837,78,na,1915,493.2222913819357
STAT,1848,19,35-39,1867,0.48428095250462105
STAT,1865,16,30-34,1881,1.4183094941523349
SIM,1892,47,50-100,1939,2
STAT,1789,106,na,1895,0.0026789684358131585
SIM,1924,23,30-34,1947,34
STAT,1866,37,50-100,1903,1.0693504845282416
STAT,1824,103,na,1927,0.07576698762297175
STAT,1949,15,40-44,1964,1.5377225696310268
STAT,1920,25,45-49,1945,1.8025713021677232
STAT,1872,51,20-24,1923,7.030446466903082E-4
SIM,1844,17,15-19,1861,5
SIM,1840,53,na,1893,1457
SIM,1852,26,40-44,1878,5
STAT,1911,38,15-19,1949,0.017431290835960764
SIM,1845,30,35-39,1875,15
SIM,1873,16,30-34,1889,1
SIM,1864,15,na,1879,2356
SIM,1928,16,25-29,1944,54
STAT,1934,13,na,1947,5055.002103136535
STAT,1863,28,30-34,1891,20.83778350428075
STAT,1896,36,15-19,1932,0.0704482260854861
SIM,1798,69,na,1867,697
SIM,1889,72,na,1961,1612
STAT,1852,36,40-44,1888,3.378855699769896
SIM,1840,24,20-24,1864,52
STAT,1844,26,40-44,1870,2.592938249227601
SIM,1930,8,na,1938,4829
STAT,1837,32,50-100,1869,0.7251953426710727
STAT,1917,29,20-24,1946,17.95444523785013
SIM,1826,36,40-44,1862,5
SIM,1905,22,na,1927,3224
STAT,1876,43,35-39,1919,1.7532486817644077
SIM,1955,7,na,1962,4547
STAT,1824,42,50-100,1866,1.3363861655952627
STAT,1854,33,40-44,1887,3.164946172158437
SIM,1839,48,na,1887,1563
STAT,1860,36,35-39,1896,5.456440227101583
STAT,1915,21,20-24,1936,108.90136169152873
STAT,1898,24,15-19,1922,4.192469855978369
STAT,1903,47,20-24,1950,0.009055345000452254
STAT,1835,49,50-100,1884,0.15743734010595245
SIM,1886,31,35-39,1917,13
SIM,1918,6,na,1924,4088
STAT,1871,50,na,1921,2045.513560557284
STAT,1908,38,50-100,1946,0.36942817123556376
STAT,1885,27,40-44,1912,2.819362914401962
SIM,1860,36,40-44,1896,6
STAT,1817,78,na,1895,346.49231241060494
STAT,1871,70,na,1941,1314.039959609815
STAT,1792,75,na,1867,369.59302072872566
SIM,1846,32,45-49,1878,1
STAT,1873,51,na,1924,2074.569188942611
STAT,1850,22,15-19,1872,2.7876110562816367
SIM,1860,39,na,1899,1950
STAT,1913,33,20-24,1946,2.282372583232719
SIM,1819,40,35-39,1859,5
SIM,1888,39,35-39,1927,13
SIM,1849,23,30-34,1872,19
SIM,1870,24,35-39,1894,8
SIM,1947,20,na,1967,3703
STAT,1944,26,45-49,1970,1.7646944216316345
SIM,1923,16,40-44,1939,2
SIM,1832,58,na,1890,1234
STAT,1862,24,35-39,1886,4.744967620185271
STAT,1932,24,25-29,1956,114.10247426604252
SIM,1878,40,40-44,1918,5
SIM,1893,27,40-44,1920,3
STAT,1830,29,15-19,1859,0.39806471868344423
SIM,1842,21,20-24,1863,58
SIM,1832,75,na,1907,615
STAT,1868,20,20-24,1888,63.05977429373026
STAT,1921,47,40-44,1968,0.16792002539199913
STAT,1915,49,40-44,1964,0.14919037920269737
SIM,1866,38,35-39,1904,15
STAT,1940,16,30-34,1956,11.69339874408025
STAT,1818,36,40-44,1854,16.31823385293422
STAT,1915,16,40-44,1931,0.27720625804859644
SIM,1884,43,35-39,1927,4
SIM,1925,29,20-24,1954,19
SIM,1928,38,35-39,1966,5
STAT,1901,34,40-44,1935,5.685288145983021
SIM,1869,39,30-34,1908,10
STAT,1884,23,na,1907,2201.044504207181
SIM,1887,71,na,1958,1380
SIM,1864,43,na,1907,2045
STAT,1860,27,35-39,1887,7.487433148154139
STAT,1875,60,na,1935,1850.9903886180211
STAT,1860,33,na,1893,1824.3818753727453
STAT,1931,17,35-39,1948,5.18869313765415
SIM,1862,33,40-44,1895,3
SIM,1844,35,45-49,1879,1
SIM,1900,46,50-100,1946,1
STAT,1858,29,na,1887,1785.9305432146034
SIM,1908,22,35-39,1930,10
STAT,1890,46,20-24,1936,0.007840575229401466
STAT,1840,24,15-19,1864,2.87992520328758
STAT,1876,21,25-29,1897,55.99764467420674
STAT,1800,98,na,1898,1.2948928945525748
STAT,1836,35,45-49,1871,1.5776073997434323
STAT,1857,24,25-29,1881,44.147681204200666
STAT,1897,41,na,1938,2943.398578965305
SIM,1931,22,25-29,1953,124
STAT,1873,31,50-100,1904,0.8821859876149684
SIM,1914,29,45-49,1943,5
STAT,1934,21,25-29,1955,117.30430791459729
STAT,1809,52,35-39,1861,0.029848952598806076
STAT,1878,31,35-39,1909,10.00018940722401
STAT,1831,50,20-24,1881,4.965610275205138E-4
STAT,1908,17,45-49,1925,0.09151884733839868
STAT,1809,49,na,1858,1294.9426941499362
SIM,1920,13,na,1933,4119
SIM,1853,26,na,1879,1977
SIM,1888,26,20-24,1914,12
SIM,1942,21,25-29,1963,86
STAT,1836,34,35-39,1870,7.917366482629569
SIM,1839,76,na,1915,639
SIM,1842,34,na,1876,1732
STAT,1906,33,15-19,1939,0.11200954499919313
STAT,1820,44,na,1864,1414.0735104242342
SIM,1876,20,20-24,1896,61
STAT,1810,45,35-39,1855,0.5148568444664282
STAT,1949,20,20-24,1969,122.66903191732823
STAT,1908,22,25-29,1930,80.20287029878446
SIM,1883,22,20-24,1905,69
STAT,1815,49,35-39,1864,0.3296292361343026
STAT,1880,46,30-34,1926,0.0964922311930023
SIM,1912,20,35-39,1932,12
STAT,1920,47,na,1967,3836.640934418072
STAT,1855,36,25-29,1891,2.0489679285008253
SIM,1804,94,na,1898,10
SIM,1888,25,na,1913,2587
STAT,1829,36,15-19,1865,0.051016102408371115
STAT,1848,50,50-100,1898,0.011036731740146372
SIM,1919,23,20-24,1942,101
SIM,1940,24,25-29,1964,76
SIM,1827,32,40-44,1859,7
STAT,1817,48,50-100,1865,0.5408831932434822
STAT,1826,38,50-100,1864,1.293236760328294
SIM,1824,49,na,1873,1300
SIM,1910,18,20-24,1928,25
STAT,1945,22,45-49,1967,1.164968072314577
STAT,1855,35,15-19,1890,0.04014843408949529
STAT,1902,18,20-24,1920,23.572835813064092
STAT,1808,64,na,1872,893.5241163717727
STAT,1880,84,na,1964,564.4474697619229
STAT,1838,47,15-19,1885,2.8067117236200496E-4
STAT,1870,16,40-44,1886,0.17193329501478527
SIM,1849,24,40-44,1873,2
STAT,1851,43,30-34,1894,0.8369804581092132
STAT,1939,25,25-29,1964,62.55701816277467
SIM,1836,43,40-44,1879,8
STAT,1861,32,35-39,1893,7.9444469187939655
STAT,1925,3,na,1928,4629.301126917442
SIM,1870,25,45-49,1895,4
SIM,1893,71,na,1964,1855
SIM,1874,39,40-44,1913,9
STAT,1899,27,35-39,1926,12.49163274366103
SIM,1872,72,na,1944,1148
SIM,1784,86,na,1870,44
STAT,1871,39,15-19,1910,0.052061880230878224
SIM,1923,21,20-24,1944,91
SIM,1921,19,40-44,1940,3
STAT,1908,31,25-29,1939,8.273561634325205
SIM,1894,23,40-44,1917,2
SIM,1835,86,na,1921,114
STAT,1838,32,45-49,1870,1.4778952781563508
STAT,1874,49,40-44,1923,0.16184768105817066
SIM,1916,22,25-29,1938,91
STAT,1878,50,45-49,1928,0.014477368752735451
STAT,1862,99,na,1961,3.7666312899362238
STAT,1822,90,na,1912,40.72375016758211
STAT,1843,21,na,1864,1950.2359690153492
STAT,1921,40,na,1961,3963.034404187418
STAT,1841,20,15-19,1861,2.9008851050479367
SIM,1858,21,15-19,1879,2
SIM,1887,15,15-19,1902,8
STAT,1898,22,50-100,1920,0.5214933582956355
STAT,1828,43,40-44,1871,1.951271568623357
STAT,1939,26,35-39,1965,14.263224828670172
STAT,1845,87,na,1932,124.09845769914368
STAT,1935,33,40-44,1968,5.111196034311287
STAT,1895,34,40-44,1929,5.300530263632352
SIM,1868,25,na,1893,2159
STAT,1866,18,40-44,1884,0.16255213807604102
STAT,1913,19,40-44,1932,0.2686520211487708
SIM,1847,35,30-34,1882,3
STAT,1848,27,50-100,1875,0.5501671505792372
STAT,1886,23,40-44,1909,2.073473038480284
STAT,1829,45,15-19,1874,3.3130678738999014E-4
SIM,1909,60,na,1969,2919
STAT,1847,45,30-34,1892,0.07193442247451515
SIM,1828,84,na,1912,182
SIM,1920,3,na,1923,4195
STAT,1946,18,na,1964,3855.5571568061027
STAT,1900,38,40-44,1938,1.2321626572381992
STAT,1849,48,35-39,1897,0.09964276953464442
STAT,1891,18,50-100,1909,0.057136442531456444
STAT,1929,36,20-24,1965,0.3200232812044062
STAT,1862,25,45-49,1887,0.9110584663551763
SIM,1917,47,na,1964,3562
STAT,1825,53,30-34,1878,0.00589824547283183
SIM,1913,27,35-39,1940,14
STAT,1839,35,30-34,1874,4.335726341379696
STAT,1858,26,35-39,1884,7.378471951031828
STAT,1880,33,na,1913,2361.979626693862
STAT,1932,23,15-19,1955,6.577947009819687
SIM,1886,78,na,1964,998
STAT,1888,36,20-24,1924,0.8644157378491754
STAT,1793,71,na,1864,590.4481335077171
STAT,1841,46,50-100,1887,0.17097575292460548
STAT,1830,88,na,1918,82.00655521602269
STAT,1855,26,15-19,1881,0.33735391813979687
SIM,1907,20,25-29,1927,91
STAT,1906,19,35-39,1925,0.7507613811221764
SIM,1847,26,30-34,1873,21
STAT,1906,49,na,1955,3030.845583895408
SIM,1873,57,na,1930,1919
SIM,1896,54,na,1950,2646
STAT,1932,19,45-49,1951,0.6215455112979981
SIM,1920,30,35-39,1950,14
SIM,1928,19,na,1947,4389
SIM,1905,36,40-44,1941,3
STAT,1842,52,50-100,1894,0.010697604364143699
STAT,1785,73,na,1858,477.0247568426388
SIM,1857,33,na,1890,1890
SIM,1903,38,30-34,1941,1
STAT,1883,27,na,1910,2209.6033785095683
SIM,1940,23,15-19,1963,3
SIM,1916,31,25-29,1947,12
STAT,1909,43,40-44,1952,0.21962822353755393
STAT,1896,27,15-19,1923,0.566462234509266
STAT,1891,23,15-19,1914,3.8456510887213122
SIM,1914,19,35-39,1933,4
STAT,1896,48,na,1944,2774.2192132179966
SIM,1830,29,25-29,1859,44
SIM,1887,33,45-49,1920,1
STAT,1835,42,35-39,1877,1.3537651748193307
SIM,1839,34,25-29,1873,17
STAT,1871,21,50-100,1892,0.3830664674143145
STAT,1940,15,20-24,1955,130.09762325873334
STAT,1891,56,na,1947,2384.9577715517275
STAT,1824,32,15-19,1856,0.32985167273601956
STAT,1924,31,50-100,1955,0.9118684426445374
STAT,1928,43,45-49,1971,0.20013639113309994
SIM,1890,21,15-19,1911,4
STAT,1910,27,45-49,1937,1.5755365117552214
STAT,1814,106,na,1920,0.005009612076535007
STAT,1912,30,35-39,1942,8.561066678733484
STAT,1928,44,20-24,1972,0.02119991502073758
SIM,1815,66,na,1881,791
SIM,1873,28,35-39,1901,12
SIM,1902,48,na,1950,2969
STAT,1905,27,35-39,1932,13.172286969631088
SIM,1932,31,50-100,1963,4
STAT,1919,32,45-49,1951,1.6038106145444238
SIM,1866,26,35-39,1892,7
STAT,1844,44,35-39,1888,1.268992852889059
STAT,1849,15,35-39,1864,0.4926206168965982
SIM,1881,55,na,1936,1723
STAT,1904,20,35-39,1924,7.953215222762999
SIM,1927,32,45-49,1959,3
STAT,1879,33,45-49,1912,1.7146395335296887
STAT,1882,21,15-19,1903,3.0417838400100115
SIM,1838,19,15-19,1857,3
SIM,1844,34,35-39,1878,10
STAT,1825,36,na,1861,1631.3612314191253
STAT,1802,70,na,1872,656.6146605661202
STAT,1884,77,na,1961,989.1603127125097
STAT,1876,33,25-29,1909,9.9470009277613
STAT,1872,29,20-24,1901,11.044285359809765
SIM,1895,21,35-39,1916,8
STAT,1922,23,20-24,1945,120.09882010592467
STAT,1896,33,45-49,1929,2.1680303140301453
STAT,1891,44,15-19,1935,0.015929959936310863
SIM,1877,44,40-44,1921,3
STAT,1832,27,25-29,1859,34.73028723003452
STAT,1923,29,45-49,1952,1.860559309979843
SIM,1822,68,na,1890,805
STAT,1852,27,45-49,1879,0.9825495803782853
STAT,1799,96,na,1895,2.870779195014965
STAT,1841,27,35-39,1868,8.199649050957364
SIM,1839,30,45-49,1869,2
SIM,1854,28,30-34,1882,21
STAT,1848,100,na,1948,0.764834070147648
STAT,1857,28,40-44,1885,2.281412739225358
STAT,1879,48,15-19,1927,3.900096569204218E-4
STAT,1881,16,15-19,1897,5.426459574803736
SIM,1826,42,35-39,1868,1
SIM,1898,34,30-34,1932,25
STAT,1846,31,50-100,1877,0.7714025326104013
STAT,1854,15,45-49,1869,0.05693785195679698
STAT,1931,28,25-29,1959,80.24032038960071
SIM,1930,16,15-19,1946,48
SIM,1884,12,na,1896,2528
SIM,1899,65,na,1964,2393
SIM,1880,29,20-24,1909,12
STAT,1925,17,45-49,1942,0.5701400644936893
SIM,1918,27,20-24,1945,22
STAT,1847,68,na,1915,1124.430487330989
SIM,1866,44,30-34,1910,1
SIM,1828,30,35-39,1858,8
SIM,1837,42,45-49,1879,3
STAT,1931,19,na,1950,4526.990126714285
STAT,1857,75,na,1932,766.692680809997
STAT,1846,28,30-34,1874,21.325017252940906
STAT,1914,29,35-39,1943,14.193416636075819
STAT,1806,83,na,1889,136.7764529881672
STAT,1869,44,40-44,1913,2.02905737093654
STAT,1835,25,50-100,1860,0.5277299297905444
SIM,1956,14,na,1970,4762
STAT,1829,42,45-49,1871,1.2591617694290218
STAT,1898,21,45-49,1919,0.894445890838595
STAT,1789,89,na,1878,33.58136683221366
STAT,1845,56,na,1901,1436.6801547282398
SIM,1927,18,30-34,1945,16
SIM,1884,33,25-29,1917,17
SIM,1842,68,na,1910,1046
STAT,1853,85,na,1938,203.30024064935074
STAT,1887,21,35-39,1908,6.183777574688682
SIM,1931,7,na,1938,4930
STAT,1914,17,35-39,1931,0.8198532427615168
STAT,1843,27,35-39,1870,8.567087533483253
SIM,1931,29,45-49,1960,2
SIM,1859,11,na,1870,2312
STAT,1863,27,20-24,1890,9.741956507386371
STAT,1919,39,30-34,1958,1.845776830359078
STAT,1900,27,na,1927,3127.7523632096836
STAT,1818,42,35-39,1860,4.343833088210102
STAT,1851,50,na,1901,1601.643481733703
SIM,1871,45,na,1916,2189
SIM,1871,27,20-24,1898,9
SIM,1826,58,na,1884,1163
SIM,1831,70,na,1901,831
STAT,1851,21,20-24,1872,60.78467991068413
STAT,1895,32,50-100,1927,1.129547322700238
STAT,1928,10,na,1938,4731.197157955908
SIM,1859,52,50-100,1911,1
SIM,1889,22,20-24,1911,68
SIM,1922,17,35-39,1939,7
SIM,1884,21,25-29,1905,72
STAT,1884,26,50-100,1910,0.5992276115375668
STAT,1910,24,40-44,1934,2.963387255502878
SIM,1902,17,15-19,1919,9
STAT,1863,92,na,1955,34.58623898770372
STAT,1885,33,35-39,1918,9.491163058102728
STAT,1826,83,na,1909,216.68230587519415
SIM,1893,33,35-39,1926,16
STAT,1908,39,20-24,1947,0.23075876816724464
STAT,1827,68,na,1895,848.0721959828084
STAT,1913,3,na,1916,3903.9749280190713
STAT,1906,18,na,1924,3465.1441478279617
STAT,1889,17,30-34,1906,1.8588853127733178
STAT,1862,21,30-34,1883,14.800101742833043
STAT,1905,38,25-29,1943,0.8441670988545485
SIM,1843,32,25-29,1875,11
SIM,1886,17,20-24,1903,17
SIM,1863,32,45-49,1895,1
SIM,1937,21,15-19,1958,4
STAT,1940,19,35-39,1959,4.021773105884686
STAT,1911,23,45-49,1934,1.0047514561260544
SIM,1945,16,25-29,1961,51
SIM,1831,28,na,1859,1687
SIM,1897,17,30-34,1914,4
STAT,1880,23,40-44,1903,2.0649023736838483
STAT,1902,16,50-100,1918,0.06547384347711241
STAT,1855,54,50-100,1909,0.010402181031996244
STAT,1860,33,30-34,1893,13.348298392281512
STAT,1908,17,50-100,1925,0.06863913550379905
STAT,1936,17,20-24,1953,122.59880092990187
STAT,1823,36,15-19,1859,0.09516259506574316
SIM,1851,27,35-39,1878,8
STAT,1929,21,15-19,1950,6.378875499141247
STAT,1939,17,50-100,1956,0.35424032676214795
STAT,1922,16,15-19,1938,49.7432850322095
STAT,1899,39,35-39,1938,1.956501605979949
STAT,1841,39,35-39,1880,5.584382215212917
STAT,1826,37,45-49,1863,2.1604659621606
STAT,1832,38,na,1870,1608.0072669145702
STAT,1909,21,30-34,1930,25.30464842548794
STAT,1837,49,20-24,1886,0.00766466170964809
STAT,1875,15,50-100,1890,0.04776939825792153
STAT,1873,46,20-24,1919,0.011539570592054403
STAT,1890,27,15-19,1917,0.5240386897847041
SIM,1927,39,30-34,1966,5
STAT,1867,31,25-29,1898,9.122322826837992
STAT,1869,27,20-24,1896,10.727670705266199
STAT,1821,48,15-19,1869,6.019248477338895E-4
STAT,1859,43,35-39,1902,1.3553549331160688
STAT,1934,29,20-24,1963,23.174422648179263
SIM,1857,33,30-34,1890,22
SIM,1897,30,na,1927,3064
SIM,1930,23,20-24,1953,134
SIM,1917,21,30-34,1938,35
STAT,1872,18,30-34,1890,1.5073510480936985
SIM,1836,25,45-49,1861,1
SIM,1845,16,20-24,1861,15
STAT,1920,28,15-19,1948,0.7290448423475375
STAT,1937,16,25-29,1953,39.91867992179597
SIM,1929,27,30-34,1956,59
STAT,1897,32,15-19,1929,0.17992004345946452
STAT,1897,4,na,1901,3323.6513199585784
STAT,1903,52,na,1955,2878.6015713913916
STAT,1944,23,40-44,1967,3.42837398952429
STAT,1843,15,35-39,1858,0.511906051907182
STAT,1858,44,30-34,1902,0.8411191315552157
STAT,1895,16,45-49,1911,0.08072735219661502
STAT,1944,25,50-100,1969,1.0171419752659825
SIM,1845,93,na,1938,17
SIM,1925,22,na,1947,4025
STAT,1875,18,na,1893,2444.774643880668
STAT,1880,30,na,1910,2391.055810116949
SIM,1942,29,20-24,1971,16
SIM,1859,21,30-34,1880,19
STAT,1930,29,50-100,1959,1.1945130915603375
STAT,1862,46,45-49,1908,0.19071767826816804
SIM,1913,38,25-29,1951,4
STAT,1855,63,na,1918,1263.7099158998346
STAT,1845,22,40-44,1867,1.8221741134895886
STAT,1930,18,30-34,1948,14.848461633323444
STAT,1884,50,35-39,1934,0.008152392314513972
STAT,1857,20,45-49,1877,0.6082405068066626
SIM,1843,20,25-29,1863,48
SIM,1834,37,45-49,1871,1
STAT,1859,56,na,1915,1537.7301477325234
STAT,1910,40,45-49,1950,0.15023046349432795
SIM,1899,30,50-100,1929,1
SIM,1880,18,30-34,1898,1
STAT,1899,20,15-19,1919,4.296443934199746
SIM,1877,33,na,1910,2332
STAT,1825,31,20-24,1856,5.269057255923747
STAT,1855,32,45-49,1887,1.2575245351843038
SIM,1901,20,25-29,1921,93
STAT,1837,37,20-24,1874,0.5924647039414629
STAT,1835,32,25-29,1867,8.136191760551972
SIM,1865,28,40-44,1893,3
SIM,1853,22,40-44,1875,2
STAT,1892,22,20-24,1914,81.52394799229563
SIM,1944,17,20-24,1961,146
SIM,1919,26,25-29,1945,64
SIM,1825,37,35-39,1862,15
STAT,1913,32,45-49,1945,1.4786652227884451
SIM,1914,22,25-29,1936,107
STAT,1872,89,na,1961,180.60967796374283
STAT,1941,18,40-44,1959,1.3604763176457757
SIM,1844,31,30-34,1875,20
STAT,1853,82,na,1935,346.0211849591148
STAT,1846,20,35-39,1866,5.150339332831466
SIM,1938,20,20-24,1958,95
SIM,1881,28,25-29,1909,44
STAT,1838,36,25-29,1874,2.3942669437882125
STAT,1916,45,40-44,1961,0.15348174876921586
SIM,1855,38,25-29,1893,1
STAT,1862,45,na,1907,1831.081712193146
SIM,1831,73,na,1904,685
STAT,1877,95,na,1972,71.37526161228752
STAT,1878,38,20-24,1916,0.7543331417886527
SIM,1794,76,na,1870,355
SIM,1848,21,20-24,1869,60
STAT,1863,20,35-39,1883,5.014179842794325
STAT,1860,30,na,1890,1846.8401817199285
SIM,1868,21,40-44,1889,1
SIM,1887,40,na,1927,2432
STAT,1849,33,30-34,1882,13.124254521543188
SIM,1875,28,35-39,1903,13
STAT,1866,32,20-24,1898,2.3543345261512107
SIM,1918,40,na,1958,3699
STAT,1909,49,15-19,1958,3.178148694160045E-4
STAT,1820,37,50-100,1857,2.802458036344663
STAT,1886,58,na,1944,1973.887808842599
STAT,1904,37,na,1941,3217.1190111403635
STAT,1817,50,50-100,1867,0.03368610971905187
STAT,1951,21,25-29,1972,104.29432454730467
STAT,1835,20,25-29,1855,63.64404599153815
STAT,1900,24,na,1924,3080.203849082256
SIM,1949,20,30-34,1969,38
SIM,1837,64,na,1901,1090
SIM,1943,7,na,1950,3885
STAT,1873,28,25-29,1901,40.420402316033744
STAT,1820,98,na,1918,1.7306097094218769
STAT,1893,28,45-49,1921,1.3261425926986048
STAT,1877,21,40-44,1898,2.048960554070816
SIM,1915,12,na,1927,3856
STAT,1906,22,25-29,1928,78.74758198480164
STAT,1921,40,20-24,1961,0.01884491783657742
STAT,1857,38,50-100,1895,0.9098271388076927
SIM,1841,80,na,1921,381
SIM,1895,29,30-34,1924,37
SIM,1838,60,na,1898,1210
STAT,1926,34,45-49,1960,1.7953829518968607
SIM,1828,39,na,1867,1488
SIM,1859,24,35-39,1883,8
SIM,1829,36,25-29,1865,2
SIM,1867,43,35-39,1910,1
STAT,1835,37,50-100,1872,0.9470398823120977
STAT,1831,53,na,1884,1334.7651732867744
STAT,1861,22,25-29,1883,46.1355783539319
SIM,1904,33,20-24,1937,5
STAT,1832,48,25-29,1880,0.04076248309375761
SIM,1846,36,25-29,1882,4
STAT,1873,82,na,1955,447.4097778707777
SIM,1839,38,40-44,1877,5
STAT,1842,45,na,1887,1643.9973950667381
STAT,1837,110,na,1947,1.7444054692665088E-4
STAT,1816,103,na,1919,0.06687751111526789
SIM,1860,20,25-29,1880,50
STAT,1840,19,30-34,1859,1.4202645717447917
STAT,1898,29,40-44,1927,3.8034282974807967
STAT,1866,49,50-100,1915,0.20944852652922177
SIM,1942,8,na,1950,3751
SIM,1896,27,25-29,1923,57
SIM,1849,27,45-49,1876,1
STAT,1877,39,15-19,1916,0.05449522387594533
STAT,1888,27,25-29,1915,47.208815270526046
SIM,1899,32,25-29,1931,16
STAT,1797,61,na,1858,928.7073743603424
SIM,1952,1,na,1953,4447
SIM,1828,38,30-34,1866,8
SIM,1937,28,35-39,1965,15
STAT,1857,42,20-24,1899,0.11813051146872039
STAT,1900,34,25-29,1934,13.308920314125883
SIM,1934,34,45-49,1968,3
STAT,1852,20,25-29,1872,52.418426912206726
STAT,1821,45,45-49,1866,0.3710896290380299
STAT,1936,31,35-39,1967,8.388684185812922
SIM,1821,80,na,1901,311
STAT,1882,15,20-24,1897,16.372671767178918
SIM,1870,21,30-34,1891,20
SIM,1875,35,40-44,1910,5
STAT,1846,49,30-34,1895,0.06682598475818975
SIM,1938,32,20-24,1970,1
SIM,1964,1,na,1965,4491
STAT,1919,18,30-34,1937,12.691324348292069
STAT,1888,39,25-29,1927,3.1808737265413387
STAT,1852,39,45-49,1891,1.4993523378813918
STAT,1855,97,na,1952,3.8048196401636716
STAT,1875,48,50-100,1923,0.23536908429637965
SIM,1907,24,40-44,1931,2
STAT,1888,36,na,1924,2641.949383704454
SIM,1879,34,50-100,1913,2
STAT,1875,23,30-34,1898,17.234079678143033
STAT,1878,29,na,1907,2330.25762621523
STAT,1897,39,35-39,1936,1.9093530606369729
SIM,1875,38,na,1913,2230
SIM,1773,91,na,1864,10
STAT,1856,31,15-19,1887,0.10776988277128913
SIM,1815,103,na,1918,1
STAT,1781,83,na,1864,116.5760646554729
STAT,1929,28,35-39,1957,17.743203918503113
SIM,1894,8,na,1902,3322
SIM,1921,15,na,1936,3907
STAT,1882,25,30-34,1907,23.305509886291908
STAT,1909,28,15-19,1937,0.6349512618169855
SIM,1929,1,na,1930,5009
STAT,1887,29,30-34,1916,26.414441543669895
SIM,1777,84,na,1861,73
STAT,1837,30,35-39,1867,8.183629440394169
SIM,1860,39,45-49,1899,2
SIM,1824,46,na,1870,1350
STAT,1939,22,20-24,1961,105.48296147373316
SIM,1834,27,35-39,1861,12
SIM,1942,14,na,1956,3719
STAT,1914,47,30-34,1961,0.08350665459549322
STAT,1791,90,na,1881,28.78678487020018
SIM,1871,20,35-39,1891,6
STAT,1869,15,na,1884,2369.3164691797037
SIM,1877,26,45-49,1903,1
STAT,1884,16,35-39,1900,0.5134998542987833
STAT,1902,59,na,1961,2713.7079004293337
SIM,1830,26,20-24,1856,8
STAT,1833,31,na,1864,1711.276826496793
STAT,1868,30,na,1898,2169.699042115609
SIM,1834,20,15-19,1854,2
STAT,1817,37,35-39,1854,24.527031511941832
SIM,1828,53,na,1881,1211
STAT,1864,37,15-19,1901,0.04741190093892698
STAT,1867,35,40-44,1902,3.919722972689516
STAT,1853,50,40-44,1903,0.00791958276564747
STAT,1856,38,35-39,1894,5.2072553505626535
SIM,1860,27,45-49,1887,3
SIM,1854,20,35-39,1874,5
STAT,1836,38,15-19,1874,0.043076642916524514
STAT,1836,31,30-34,1867,14.08195980920827
STAT,1879,37,25-29,1916,2.8430116613317704
SIM,1840,27,25-29,1867,41
SIM,1947,22,20-24,1969,110
STAT,1893,37,na,1930,2823.911966445969
STAT,1847,48,35-39,1895,0.1017160887762774
SIM,1889,29,40-44,1918,3
STAT,1831,28,20-24,1859,10.046918636276942
STAT,1836,103,na,1939,0.09062816112317353
STAT,1857,45,25-29,1902,0.043325315446449984
SIM,1929,20,45-49,1949,1
SIM,1859,31,40-44,1890,7
STAT,1838,103,na,1941,0.09788073408744519
STAT,1924,37,na,1961,4191.352341915208
STAT,1800,92,na,1892,16.601768897249215
STAT,1855,19,50-100,1874,0.04078490818318826
SIM,1823,34,30-34,1857,15
SIM,1840,15,25-29,1855,3
SIM,1893,6,na,1899,3248
SIM,1948,21,25-29,1969,101
STAT,1859,110,na,1969,0.0024956874501252586
SIM,1892,28,35-39,1920,13
STAT,1906,16,30-34,1922,2.197926167130142
STAT,1884,28,35-39,1912,8.975950996954964
SIM,1864,97,na,1961,14
SIM,1914,16,30-34,1930,3
STAT,1861,104,na,1965,0.28547860916100476
SIM,1890,25,30-34,1915,36
SIM,1890,30,50-100,1920,1
STAT,1842,17,40-44,1859,0.1672549958185116
SIM,1887,37,25-29,1924,5
STAT,1854,16,na,1870,1989.0196407848994
STAT,1896,48,15-19,1944,2.7817052137889107E-4
STAT,1927,27,20-24,1954,20.96651281848244
SIM,1837,28,30-34,1865,21
SIM,1942,5,na,1947,3783
STAT,1775,83,na,1858,113.78283539215072
STAT,1860,64,na,1924,1334.6414877330014
SIM,1879,11,na,1890,2560
STAT,1864,23,na,1887,2014.3789324143427
STAT,1928,22,50-100,1950,0.7761810533762468
SIM,1894,44,40-44,1938,3
STAT,1852,24,40-44,1876,1.853880466485541
STAT,1871,15,45-49,1886,0.062304252871794294
SIM,1875,52,na,1927,2049
STAT,1895,69,na,1964,2029.2655797066413
SIM,1850,38,40-44,1888,1
SIM,1856,30,45-49,1886,2
STAT,1896,30,40-44,1926,5.458052996383224
STAT,1933,11,na,1944,5018.244476477738
STAT,1842,38,40-44,1880,3.6190238588918553
STAT,1935,18,15-19,1953,58.45388453588819
STAT,1856,25,20-24,1881,9.125064212502657
SIM,1828,50,na,1878,1289
SIM,1943,18,15-19,1961,44
SIM,1883,44,30-34,1927,1
STAT,1820,50,45-49,1870,0.023936345585480388
STAT,1924,1,na,1925,4698.4296100675365
STAT,1841,24,30-34,1865,15.217619057807797
SIM,1872,16,15-19,1888,6
SIM,1929,33,25-29,1962,12
STAT,1893,25,50-100,1918,0.771947395395646
STAT,1860,15,35-39,1875,0.49164160621235553
STAT,1864,16,15-19,1880,5.729748086083998
SIM,1857,19,na,1876,2157
SIM,1936,14,na,1950,2979
STAT,1881,18,na,1899,2297.6806844510033
STAT,1854,37,20-24,1891,0.5550838333357471
STAT,1882,18,25-29,1900,5.195492576205206
STAT,1931,25,20-24,1956,22.28311341093058
SIM,1899,11,na,1910,3356
SIM,1931,19,35-39,1950,4
STAT,1850,29,35-39,1879,7.879468343059477
STAT,1929,15,20-24,1944,164.22217403795815
STAT,1953,17,na,1970,4206.393829196521
STAT,1801,77,na,1878,356.69203187481224
SIM,1835,44,35-39,1879,2
SIM,1935,27,20-24,1962,28
STAT,1867,17,45-49,1884,0.05923318005243468
STAT,1913,26,15-19,1939,0.6666418302727323
SIM,1824,91,na,1915,21
SIM,1845,19,25-29,1864,6
STAT,1837,19,25-29,1856,4.798797272803161
STAT,1834,25,35-39,1859,7.945434915125243
SIM,1875,38,45-49,1913,2
SIM,1933,31,25-29,1964,15
SIM,1802,99,na,1901,1
STAT,1830,32,40-44,1862,3.628234522114348
STAT,1922,26,25-29,1948,70.606920972866
STAT,1938,27,30-34,1965,36.66717422692375
SIM,1930,26,25-29,1956,89
STAT,1839,31,15-19,1870,0.11807086644225892
SIM,1890,18,25-29,1908,6
STAT,1824,39,35-39,1863,9.62346234583127
SIM,1791,65,na,1856,750
SIM,1860,24,40-44,1884,2
SIM,1813,51,na,1864,1231
SIM,1937,15,20-24,1952,117
STAT,1849,54,30-34,1903,0.0041725559781463075
STAT,1844,36,50-100,1880,1.011300889851668
SIM,1819,79,na,1898,312
STAT,1848,30,na,1878,1859.0085772155178
STAT,1848,30,45-49,1878,1.495801844661201
STAT,1870,50,40-44,1920,0.009885165488604688
SIM,1877,30,na,1907,2368
STAT,1840,36,15-19,1876,0.04673677442613002
STAT,1877,32,30-34,1909,17.116057396303535
SIM,1870,60,na,1930,1757
SIM,1908,34,35-39,1942,12
STAT,1873,49,25-29,1922,0.05407989378332257
SIM,1901,28,20-24,1929,16
STAT,1935,21,40-44,1956,4.326666866031054
STAT,1837,75,na,1912,649.8558694714214
STAT,1923,19,35-39,1942,4.63021102531385
SIM,1836,22,40-44,1858,1
STAT,1808,53,30-34,1861,0.021220194712944538
STAT,1826,34,40-44,1860,5.123593395257669
STAT,1845,25,45-49,1870,0.9657453341527684
STAT,1883,35,25-29,1918,2.6910709627143823
STAT,1953,17,20-24,1970,154.93646241867893
STAT,1835,39,45-49,1874,1.5061042730325949
SIM,1826,32,25-29,1858,15
STAT,1948,10,na,1958,4248.244149176724
SIM,1903,16,20-24,1919,25
STAT,1796,68,na,1864,764.6200232117582
STAT,1925,31,25-29,1956,10.37586957423309
SIM,1860,53,na,1913,1770
SIM,1893,23,25-29,1916,74
STAT,1885,23,25-29,1908,53.711903887835305
STAT,1875,63,na,1938,1731.7351159068076
STAT,1832,45,20-24,1877,0.008825342011039416
STAT,1814,95,na,1909,5.485685285186697
STAT,1875,44,30-34,1919,1.100735572423565
STAT,1905,35,20-24,1940,0.2292930065671596
SIM,1839,79,na,1918,478
SIM,1878,29,30-34,1907,28
SIM,1923,41,na,1964,4022
STAT,1816,44,25-29,1860,1.7655114060876722
SIM,1843,39,45-49,1882,1
STAT,1897,36,30-34,1933,6.765879028327844
STAT,1781,111,na,1892,4.4065478509863623E-4
SIM,1824,44,25-29,1868,2
SIM,1885,32,30-34,1917,23
STAT,1901,19,15-19,1920,7.805096253624183
STAT,1918,15,45-49,1933,0.10352947523459592
STAT,1860,15,50-100,1875,0.043896563850256275
STAT,1911,27,50-100,1938,0.9167899575886874
SIM,1834,34,40-44,1868,4
SIM,1898,48,50-100,1946,2
SIM,1911,22,40-44,1933,4
STAT,1878,17,20-24,1895,17.435168971134654
STAT,1881,22,45-49,1903,0.636057672997981
SIM,1891,35,25-29,1926,3
STAT,1918,51,na,1969,3646.1312971733532
STAT,1885,70,na,1955,1320.5444821418273
STAT,1853,47,50-100,1900,0.18128974257772656
SIM,1817,98,na,1915,3
STAT,1831,38,30-34,1869,4.159688167273467
STAT,1867,34,na,1901,2098.5370623200615
SIM,1864,25,20-24,1889,9
STAT,1862,28,15-19,1890,0.36432372154305953
SIM,1861,47,50-100,1908,1
STAT,1830,57,na,1887,1208.9961884391653
SIM,1891,39,40-44,1930,10
STAT,1908,44,na,1952,3205.4418388274926
STAT,1870,22,35-39,1892,5.401725869547339
STAT,1899,24,30-34,1923,22.915661948653252
SIM,1888,70,na,1958,1606
STAT,1915,28,40-44,1943,4.474999428311171
STAT,1862,42,na,1904,1860.191415088228
SIM,1923,28,40-44,1951,5
SIM,1898,37,35-39,1935,5
STAT,1816,48,40-44,1864,0.44362312680176325
STAT,1921,43,25-29,1964,0.07586802811125257
STAT,1847,38,25-29,1885,2.1753125059477694
STAT,1903,22,40-44,1925,2.8007079585387027
STAT,1819,50,na,1869,1296.961925945213
SIM,1900,13,na,1913,3352
STAT,1883,39,40-44,1922,4.012194384402344
SIM,1907,34,na,1941,3354
SIM,1902,23,45-49,1925,4
STAT,1893,25,40-44,1918,3.6148902065139703
STAT,1868,45,35-39,1913,0.12753571022116036
STAT,1928,37,15-19,1965,0.02292905747676986
STAT,1774,87,na,1861,50.252660165474154
SIM,1926,33,40-44,1959,9
SIM,1875,25,30-34,1900,25
STAT,1809,49,45-49,1858,0.829932819825629
SIM,1837,24,15-19,1861,2
STAT,1834,43,30-34,1877,0.8469856752371637
SIM,1833,31,20-24,1864,2
STAT,1858,38,35-39,1896,5.219470404785647
SIM,1865,93,na,1958,28
STAT,1853,34,35-39,1887,7.575104824681967
STAT,1763,95,na,1858,0.8426899189787482
STAT,1928,22,45-49,1950,1.3272695507006123
STAT,1947,23,25-29,1970,98.59401256694193
STAT,1853,9,na,1862,2173.4570613489695
STAT,1842,90,na,1932,56.14336002726226
STAT,1916,48,45-49,1964,0.20999875546386992
STAT,1896,15,15-19,1911,7.443903305492053
STAT,1917,22,35-39,1939,9.453492945385316
SIM,1890,28,35-39,1918,13
SIM,1842,65,na,1907,1167
STAT,1857,49,40-44,1906,0.12483920222256041
SIM,1915,33,30-34,1948,20
STAT,1849,36,35-39,1885,5.271152393040774
STAT,1918,33,40-44,1951,3.9117915584731624
SIM,1861,34,35-39,1895,13
STAT,1845,43,40-44,1888,1.5928326609177372
STAT,1846,43,50-100,1889,0.7442955946737562
STAT,1792,107,na,1899,7.941710682496315E-4
STAT,1874,20,45-49,1894,0.6773031734951965
STAT,1888,24,20-24,1912,76.42559156615755
SIM,1873,71,na,1944,1242
STAT,1839,56,na,1895,1359.9710653688028
STAT,1930,32,45-49,1962,1.9185440762912696
SIM,1893,26,na,1919,2977
STAT,1790,101,na,1891,0.11486805115736545
STAT,1804,51,na,1855,1197.886860904465
SIM,1934,24,35-39,1958,15
STAT,1919,20,45-49,1939,1.1708836135806957
SIM,1862,34,na,1896,2056
SIM,1934,33,na,1967,4801
STAT,1919,35,15-19,1954,0.01959801893400287
STAT,1879,27,15-19,1906,0.44800044319290294
STAT,1824,57,na,1881,1148.491629689743
SIM,1924,26,na,1950,4083
STAT,1921,20,35-39,1941,10.107751407459316
SIM,1853,25,45-49,1878,3
SIM,1853,43,40-44,1896,10
STAT,1859,30,20-24,1889,2.067588683357172
STAT,1907,33,30-34,1940,13.851171253587468
STAT,1917,49,50-100,1966,0.22186257876937618
STAT,1937,34,20-24,1971,2.2764714566526965
SIM,1943,21,40-44,1964,3
STAT,1898,6,na,1904,3340.7528747405563
STAT,1829,49,na,1878,1467.2163928251432
STAT,1882,28,35-39,1910,8.838556531613744
SIM,1891,48,na,1939,2708
STAT,1867,38,45-49,1905,1.7594532790005215
SIM,1878,43,45-49,1921,2
SIM,1925,22,35-39,1947,11
STAT,1915,42,20-24,1957,0.01679506973881094
SIM,1855,86,na,1941,137
SIM,1908,19,na,1927,3447
STAT,1842,34,25-29,1876,8.630097621363875
STAT,1910,20,25-29,1930,82.41069674837627
SIM,1850,34,25-29,1884,9
STAT,1839,47,30-34,1886,0.06576151996710639
STAT,1861,51,45-49,1912,0.01143912131860105
STAT,1815,43,na,1858,1347.1053979475348
STAT,1833,22,15-19,1855,2.868547383794204
SIM,1848,24,25-29,1872,71
SIM,1857,36,35-39,1893,10
STAT,1850,43,15-19,1893,0.009651921384511524
SIM,1841,22,15-19,1863,1
SIM,1939,25,na,1964,3489
SIM,1869,31,35-39,1900,9
SIM,1872,26,25-29,1898,44
SIM,1907,27,45-49,1934,1
STAT,1897,26,20-24,1923,14.872559989134002
SIM,1864,38,35-39,1902,13
STAT,1864,26,25-29,1890,35.83811130128315
STAT,1904,28,30-34,1932,33.99692786078912
SIM,1867,30,20-24,1897,3
SIM,1920,19,25-29,1939,59
SIM,1882,23,15-19,1905,6
STAT,1876,48,na,1924,2166.5995463303548
STAT,1846,45,15-19,1891,2.848404508149596E-4
STAT,1838,26,15-19,1864,0.39647239259876893
SIM,1821,39,25-29,1860,1
STAT,1827,44,35-39,1871,1.608528646701419
SIM,1832,39,35-39,1871,12
SIM,1901,49,na,1950,2940
SIM,1927,20,45-49,1947,1
SIM,1831,29,40-44,1860,2
STAT,1831,50,na,1881,1416.4728283890931
STAT,1872,39,30-34,1911,5.002656531271125
SIM,1822,65,na,1887,892
STAT,1912,19,25-29,1931,8.231920386825898
SIM,1919,5,na,1924,4185
STAT,1769,106,na,1875,0.010725599861149826
SIM,1850,94,na,1944,8
SIM,1859,42,30-34,1901,1
SIM,1906,21,20-24,1927,88
STAT,1840,21,45-49,1861,0.6220385192817685
SIM,1875,21,15-19,1896,7
STAT,1948,16,35-39,1964,4.538125899541238
SIM,1874,32,20-24,1906,2
STAT,1886,55,na,1941,2063.834849487296
SIM,1839,90,na,1929,50
STAT,1789,86,na,1875,63.35337381017094
SIM,1853,20,na,1873,2023
STAT,1894,35,35-39,1929,8.676786738273087
SIM,1867,33,25-29,1900,12
SIM,1840,87,na,1927,90
STAT,1863,2,na,1865,2837.8443528008256
SIM,1917,31,40-44,1948,7
STAT,1921,49,30-34,1970,0.09438892099010988
STAT,1926,24,35-39,1950,10.740146823844764
SIM,1912,28,30-34,1940,46
STAT,1813,65,na,1878,855.2450334955496
STAT,1911,19,na,1930,3630.7798297365666
STAT,1926,18,na,1944,4252.527291952522
STAT,1955,15,30-34,1970,15.29282971520106
SIM,1826,72,na,1898,639
SIM,1834,24,30-34,1858,16
SIM,1823,37,35-39,1860,11
SIM,1859,34,45-49,1893,2
STAT,1900,17,40-44,1917,0.23971083263041557
SIM,1842,43,30-34,1885,4
STAT,1844,32,35-39,1876,8.501527163469706
STAT,1867,21,15-19,1888,2.9595402603299203
SIM,1896,24,20-24,1920,85
SIM,1851,79,na,1930,438
SIM,1866,78,na,1944,607
STAT,1848,16,30-34,1864,1.4318733581473402
SIM,1905,29,35-39,1934,13
STAT,1861,26,40-44,1887,2.3841409858276985
SIM,1864,35,30-34,1899,4
SIM,1882,85,na,1967,505
SIM,1868,18,15-19,1886,4
STAT,1933,23,30-34,1956,36.003774047307154
SIM,1864,12,na,1876,2420
STAT,1779,103,na,1882,0.051739632163979345
STAT,1828,64,na,1892,986.8252213319297
STAT,1947,5,na,1952,4216.454833820785
SIM,1856,16,30-34,1872,4
SIM,1916,48,na,1964,3467
SIM,1941,23,30-34,1964,35
STAT,1886,44,40-44,1930,2.2147524920461543
SIM,1877,23,40-44,1900,2
STAT,1856,35,30-34,1891,3.9807727800490214
STAT,1919,23,50-100,1942,0.6785627861568178
SIM,1829,33,20-24,1862,1
SIM,1880,39,30-34,1919,5
STAT,1920,26,50-100,1946,1.0350789126666835
SIM,1889,25,25-29,1914,52
STAT,1862,49,15-19,1911,3.156047555366325E-4
STAT,1898,46,25-29,1944,0.04166858724388185
SIM,1811,73,na,1884,478
SIM,1852,32,35-39,1884,9
STAT,1816,106,na,1922,0.005657986150686111
STAT,1909,31,40-44,1940,3.5413345104662004
SIM,1845,44,50-100,1889,1
SIM,1795,72,na,1867,504
STAT,1819,53,40-44,1872,0.01762529717693566
STAT,1945,25,15-19,1970,0.7322997226035053
STAT,1942,25,na,1967,3717.3854608639035
STAT,1923,33,15-19,1956,0.1390962027539164
STAT,1837,44,50-100,1881,0.6980152791697709
STAT,1821,43,na,1864,1464.1413847189638
STAT,1778,94,na,1872,3.545503264123385
SIM,1860,23,30-34,1883,20
STAT,1883,52,na,1935,1982.934476797788
SIM,1856,23,na,1879,1947
STAT,1819,43,40-44,1862,4.268929686504792
STAT,1928,43,50-100,1971,0.14127274627735303
SIM,1841,18,25-29,1859,8
STAT,1908,26,40-44,1934,4.2112801405563225
STAT,1938,4,na,1942,3760.8249522694496
SIM,1881,34,30-34,1915,19
STAT,1925,30,25-29,1955,10.3815794429267
STAT,1859,52,25-29,1911,0.0026561944897739924
STAT,1845,39,25-29,1884,2.0870603841115485
SIM,1819,39,na,1858,1462
STAT,1886,47,50-100,1933,0.24399643934458326
STAT,1881,53,20-24,1934,6.622815624729348E-4
STAT,1854,87,na,1941,126.86676519759209
STAT,1858,45,45-49,1903,0.17676950917280673
STAT,1929,18,25-29,1947,52.112147497689904
SIM,1823,44,na,1867,1363
STAT,1846,41,50-100,1887,0.7636134472675798
STAT,1879,47,na,1926,2211.20790855346
STAT,1926,17,45-49,1943,0.5786556896444638
STAT,1841,51,25-29,1892,0.0024350105093865182
SIM,1885,36,40-44,1921,2
SIM,1888,37,20-24,1925,4
STAT,1903,49,50-100,1952,0.18231306741533548
STAT,1875,33,na,1908,2306.2320654036785
SIM,1843,26,35-39,1869,13
SIM,1868,39,45-49,1907,2
SIM,1883,42,40-44,1925,5
STAT,1909,8,na,1917,3681.8752262446774
SIM,1924,32,25-29,1956,16
STAT,1905,30,50-100,1935,1.2608718330935191
STAT,1835,35,50-100,1870,0.966913129327579
SIM,1897,22,15-19,1919,3
STAT,1835,26,35-39,1861,7.902966576093961
STAT,1874,40,50-100,1914,1.0303301564468483
SIM,1912,27,na,1939,3357
STAT,1890,38,na,1928,2707.720036592646
SIM,1808,87,na,1895,63
STAT,1866,30,20-24,1896,2.373259001650988
STAT,1873,52,50-100,1925,0.01440505633262284
STAT,1875,42,40-44,1917,2.1803200860034573
SIM,1937,18,25-29,1955,41
STAT,1813,89,na,1902,44.430015917998276
STAT,1862,48,15-19,1910,3.1828471281856465E-4
SIM,1864,37,35-39,1901,11
STAT,1882,18,20-24,1900,16.254255724529248
STAT,1862,36,20-24,1898,0.6241689655785749
SIM,1814,43,30-34,1857,7
STAT,1894,40,25-29,1934,0.7882363758763065
STAT,1903,45,20-24,1948,0.009188459976972197
SIM,1931,22,15-19,1953,5
SIM,1827,43,40-44,1870,4
SIM,1834,28,35-39,1862,7
SIM,1836,36,45-49,1872,2
STAT,1874,3,na,1877,2987.40012900708
STAT,1852,23,30-34,1875,15.961471444280013
STAT,1837,29,50-100,1866,0.5108885172482448
SIM,1889,16,30-34,1905,1
STAT,1873,34,30-34,1907,16.598927787341143
SIM,1916,26,40-44,1942,7
SIM,1890,74,na,1964,1559
SIM,1891,16,na,1907,3129
SIM,1853,39,25-29,1892,3
SIM,1886,69,na,1955,1430
SIM,1921,6,na,1927,4228
SIM,1878,18,20-24,1896,15
SIM,1882,55,na,1937,1867
SIM,1865,105,na,1970,1
SIM,1920,46,na,1966,3782
STAT,1815,49,40-44,1864,0.4030894649718052
STAT,1895,27,45-49,1922,1.368781452640493
STAT,1927,32,na,1959,4395.555715206474
STAT,1854,37,25-29,1891,2.073293264618345
SIM,1821,33,20-24,1854,2
SIM,1950,2,na,1952,4335
SIM,1811,59,na,1870,1054
STAT,1831,27,na,1858,1742.834253731865
SIM,1827,30,35-39,1857,6
STAT,1848,35,50-100,1883,0.930616498444556
SIM,1872,36,30-34,1908,10
STAT,1916,32,25-29,1948,9.014297210443422
SIM,1853,33,40-44,1886,4
STAT,1895,6,na,1901,3220.513522146966
SIM,1928,26,na,1954,4373
STAT,1944,28,na,1972,3823.0027593996438
STAT,1899,47,50-100,1946,0.17851810675859534
STAT,1932,20,15-19,1952,6.637705297201778
STAT,1940,14,na,1954,3772.3433361724556
STAT,1838,49,35-39,1887,0.09574984948639288
STAT,1886,21,35-39,1907,5.842118371116958
SIM,1924,12,na,1936,4445
SIM,1894,21,35-39,1915,6
STAT,1863,41,35-39,1904,1.5105283567061976
STAT,1849,52,40-44,1901,0.00754783714702828
STAT,1865,39,na,1904,2002.121104807276
STAT,1917,24,40-44,1941,3.3546428145901266
STAT,1880,24,20-24,1904,68.0700951859863
STAT,1847,47,35-39,1894,0.10253017839271557
SIM,1834,20,25-29,1854,51
STAT,1917,37,50-100,1954,0.4119533742157604
STAT,1923,22,15-19,1945,5.851711439903742
STAT,1866,44,40-44,1910,1.9326504939179303
STAT,1956,13,na,1969,4908.967494481345
SIM,1943,15,na,1958,3631
STAT,1934,16,40-44,1950,1.7916176107616133
SIM,1887,31,45-49,1918,2
SIM,1787,76,na,1863,333
STAT,1841,21,na,1862,1866.591236517672
STAT,1864,36,30-34,1900,4.521477767184096
STAT,1833,93,na,1926,17.7424454835983
SIM,1877,37,45-49,1914,2
SIM,1920,38,25-29,1958,1
SIM,1898,54,na,1952,2646
SIM,1873,19,na,1892,2407
SIM,1894,29,45-49,1923,1
STAT,1890,46,25-29,1936,0.03763475934557003
SIM,1892,35,45-49,1927,2
STAT,1849,49,na,1898,1587.8054770447172
SIM,1899,38,35-39,1937,5
SIM,1871,41,35-39,1912,3
STAT,1866,72,na,1938,1099.9676143608683
STAT,1796,60,na,1856,1030.3683998512001
STAT,1858,31,25-29,1889,7.675506687322775
STAT,1850,54,30-34,1904,0.004075369662956787
STAT,1825,41,15-19,1866,0.015774105458518588
SIM,1825,44,45-49,1869,5
STAT,1870,53,45-49,1923,0.013218006483843239
STAT,1912,38,25-29,1950,0.9031302385041108
STAT,1901,43,45-49,1944,0.1364322442247487
STAT,1907,19,50-100,1926,0.06761008311870555
SIM,1874,44,40-44,1918,12
STAT,1856,23,15-19,1879,2.814554964226179
SIM,1869,73,na,1942,1013
SIM,1942,16,40-44,1958,3
SIM,1844,38,na,1882,1781
STAT,1914,46,35-39,1960,0.12107435167176485
SIM,1890,18,20-24,1908,20
STAT,1786,98,na,1884,0.5678990484632395
SIM,1894,40,na,1934,2985
STAT,1857,36,na,1893,1763.0608870218605
SIM,1861,18,na,1879,2266
SIM,1832,96,na,1928,2
STAT,1874,16,na,1890,2444.5414812869144
SIM,1820,95,na,1915,4
SIM,1842,41,40-44,1883,4
STAT,1845,35,na,1880,1778.4457927523802
STAT,1858,39,35-39,1897,5.192694521609099
STAT,1929,31,50-100,1960,0.9927619086872632
SIM,1938,27,30-34,1965,44
SIM,1927,8,na,1935,4598
STAT,1850,15,20-24,1865,15.432756511810627
STAT,1896,47,30-34,1943,0.06785610033352939
STAT,1845,44,20-24,1889,0.11103234471229922
SIM,1825,35,30-34,1860,4
STAT,1819,110,na,1929,1.3799964527597922E-4
STAT,1869,37,45-49,1906,1.8229175914723001
SIM,1919,27,20-24,1946,23
STAT,1817,44,45-49,1861,3.490145172342192
SIM,1887,3,na,1890,2749
SIM,1835,61,na,1896,1175
STAT,1889,22,15-19,1911,3.847559368142185
SIM,1933,30,25-29,1963,17
STAT,1851,36,45-49,1887,1.492933354162233
SIM,1799,77,na,1876,313
STAT,1892,32,15-19,1924,0.16846924469728478
STAT,1884,35,45-49,1919,1.8786731536285786
STAT,1801,54,35-39,1855,0.029841862675506876
STAT,1886,34,40-44,1920,4.29152189139252
STAT,1875,23,25-29,1898,55.38736526741531
STAT,1912,43,20-24,1955,0.015990575959825695
STAT,1859,40,30-34,1899,0.8755090522614901
STAT,1884,26,30-34,1910,23.588977928774224
STAT,1909,23,50-100,1932,0.575790479710194
SIM,1949,20,35-39,1969,17
STAT,1854,71,na,1925,961.1822159138995
SIM,1894,34,40-44,1928,6
STAT,1858,85,na,1943,203.30621190891804
STAT,1862,90,na,1952,63.53271162598362
STAT,1882,27,35-39,1909,8.86977815070422
STAT,1872,41,50-100,1913,1.0062627068405816
SIM,1877,92,na,1969,119
STAT,1826,39,15-19,1865,0.05752543928390859
STAT,1828,47,25-29,1875,0.048516963428313194
SIM,1853,20,35-39,1873,10
STAT,1874,50,25-29,1924,0.0034690708895575625
STAT,1927,32,50-100,1959,0.9609111482543394
STAT,1942,22,25-29,1964,91.48763713968745
SIM,1823,36,35-39,1859,10
SIM,1892,26,30-34,1918,39
STAT,1832,33,30-34,1865,13.66962398690108
SIM,1840,33,30-34,1873,13
SIM,1791,81,na,1872,176
STAT,1867,17,40-44,1884,0.16585294447810522
SIM,1858,7,na,1865,2318
SIM,1875,29,35-39,1904,12
SIM,1839,17,30-34,1856,1
SIM,1863,19,15-19,1882,5
SIM,1866,31,25-29,1897,11
STAT,1875,51,50-100,1926,0.014727924604598026
SIM,1890,27,35-39,1917,12
STAT,1908,49,15-19,1957,3.128009463598028E-4
STAT,1875,37,45-49,1912,1.934754645503196
STAT,1848,17,30-34,1865,1.4234396240678524
STAT,1948,18,35-39,1966,4.535403430617593
STAT,1865,21,15-19,1886,2.887185852666881
SIM,1870,54,na,1924,1943
STAT,1888,18,50-100,1906,0.054532184523835306
SIM,1866,49,na,1915,1935
STAT,1892,37,45-49,1929,2.358308302680961
STAT,1925,25,na,1950,4208.807125338489
STAT,1881,48,25-29,1929,0.05187933210608644
STAT,1848,21,15-19,1869,2.914797168171096
SIM,1868,44,40-44,1912,1
STAT,1895,35,20-24,1930,0.9593274807260677
STAT,1834,41,40-44,1875,1.7000996253562937
STAT,1810,65,na,1875,870.8917063146347
STAT,1871,26,45-49,1897,1.043415600337199
STAT,1916,26,50-100,1942,0.9755428551317266
STAT,1922,45,30-34,1967,0.09720986198970451
SIM,1862,26,45-49,1888,5
STAT,1825,46,45-49,1871,0.25088912271263963
STAT,1879,79,na,1958,798.8619844982414
STAT,1899,37,30-34,1936,1.489248951610465
STAT,1844,37,50-100,1881,0.9107772824779472
STAT,1890,26,30-34,1916,29.185589178136155
SIM,1847,23,15-19,1870,6
SIM,1856,21,15-19,1877,2
STAT,1829,40,45-49,1869,1.2985039231677329
STAT,1810,51,50-100,1861,0.05229907849096231
SIM,1863,30,45-49,1893,5
STAT,1854,26,45-49,1880,0.9277166346260373
STAT,1818,51,25-29,1869,0.007404352929526379
STAT,1886,17,na,1903,2520.868476832175
SIM,1841,89,na,1930,51
STAT,1877,45,50-100,1922,0.24316618160667722
SIM,1898,34,25-29,1932,14
STAT,1845,30,50-100,1875,0.7834699855226414
STAT,1849,46,30-34,1895,0.06997064953631281
STAT,1882,52,25-29,1934,0.003238662260571076
SIM,1856,17,30-34,1873,2
STAT,1949,22,35-39,1971,10.380394189733936
STAT,1840,35,30-34,1875,4.482043764704826
STAT,1886,29,45-49,1915,1.100299703798273
STAT,1839,39,25-29,1878,2.246994909065843
STAT,1828,44,20-24,1872,0.13549637155585398
STAT,1854,55,na,1909,1488.9486010959317
SIM,1876,1,na,1877,3293
STAT,1879,31,45-49,1910,1.728942773841114
STAT,1938,33,15-19,1971,0.12197555144833572
STAT,1819,38,45-49,1857,4.7654693192932225
SIM,1837,40,45-49,1877,2
STAT,1897,24,15-19,1921,4.1419450117113135
SIM,1851,34,45-49,1885,1
SIM,1857,88,na,1945,84
SIM,1853,74,na,1927,844
STAT,1830,28,25-29,1858,38.79789406007783
STAT,1888,45,30-34,1933,0.10910679371901184
SIM,1925,24,40-44,1949,8
STAT,1857,37,50-100,1894,0.914362376193613
STAT,1843,34,45-49,1877,1.4813795089390056
STAT,1844,100,na,1944,0.7452845637434858
STAT,1883,84,na,1967,577.4953142056153
STAT,1844,41,25-29,1885,0.46764770565731545
SIM,1847,39,25-29,1886,1
SIM,1906,19,35-39,1925,2
STAT,1820,54,45-49,1874,0.022102805156041367
SIM,1827,38,45-49,1865,2
STAT,1795,59,na,1854,946.9999999999999
STAT,1834,24,50-100,1858,0.3327572832630267
SIM,1862,37,25-29,1899,1
STAT,1829,29,15-19,1858,0.49664537687123284
STAT,1869,45,20-24,1914,0.011082640454122102
STAT,1819,49,25-29,1868,0.09941099666103742
STAT,1828,36,45-49,1864,1.9359032597264627
STAT,1866,40,na,1906,2033.3770359160192
STAT,1859,18,45-49,1877,0.056830174533846464
STAT,1937,17,20-24,1954,124.58082529871628
STAT,1891,1,na,1892,3182.6967820463396
STAT,1907,12,na,1919,3583.146297329399
STAT,1838,54,30-34,1892,0.0039482263232924865
STAT,1881,36,30-34,1917,4.884740183513103
STAT,1915,31,na,1946,3653.3692766118543
SIM,1932,31,na,1963,4624
STAT,1881,40,15-19,1921,0.012723656670317034
STAT,1960,2,na,1962,4840.702902371573
SIM,1888,24,15-19,1912,2
STAT,1838,30,45-49,1868,1.5089083098927862
STAT,1860,25,30-34,1885,19.824458253028823
STAT,1845,36,45-49,1881,1.490753142488843
STAT,1874,91,na,1965,149.5650042029896
SIM,1832,25,20-24,1857,13
SIM,1929,21,20-24,1950,133
STAT,1855,30,45-49,1885,1.2839131764469445
STAT,1899,24,25-29,1923,73.64699260990233
STAT,1819,54,20-24,1873,0.0012110289828796716
STAT,1843,25,30-34,1868,22.68305650240791
STAT,1808,51,40-44,1859,0.039065272266456494
STAT,1865,29,25-29,1894,36.05389730159411
STAT,1927,2,na,1929,4804.521421018889
STAT,1918,40,35-39,1958,0.20281229968511913
STAT,1885,42,25-29,1927,0.6036408490285355
SIM,1851,25,30-34,1876,29
STAT,1815,96,na,1911,3.6751001732279094
STAT,1866,42,15-19,1908,0.012013401459089076
SIM,1861,93,na,1954,15
STAT,1886,45,20-24,1931,0.012096900716458919
STAT,1954,17,20-24,1971,158.32806766380597
STAT,1891,16,20-24,1907,20.781004460528795
STAT,1814,45,30-34,1859,0.271285090126987
STAT,1929,43,15-19,1972,0.001875913287779297
STAT,1845,19,na,1864,2019.575953889078
SIM,1906,24,30-34,1930,37
STAT,1807,61,na,1868,969.5627496304205
STAT,1820,59,na,1879,1106.9451618408739
STAT,1896,31,45-49,1927,2.186115665486023
SIM,1904,8,na,1912,3476
SIM,1945,17,20-24,1962,121
STAT,1835,51,25-29,1886,0.002297267424837158
SIM,1853,36,45-49,1889,1
SIM,1883,37,45-49,1920,1
SIM,1886,85,na,1971,521
SIM,1882,71,na,1953,1185
STAT,1823,35,30-34,1858,9.525803384717381
STAT,1790,71,na,1861,562.8814548802803
STAT,1853,39,50-100,1892,0.9013398357234027
STAT,1788,107,na,1895,0.0013831614110419502
STAT,1846,52,na,1898,1510.0573994634883
SIM,1873,21,15-19,1894,3
SIM,1884,27,35-39,1911,11
STAT,1860,34,45-49,1894,1.3273737747245398
STAT,1808,46,45-49,1854,0.9134834060515541
STAT,1849,33,25-29,1882,7.699239517650741
STAT,1938,21,20-24,1959,103.98517832095003
SIM,1896,47,na,1943,2820
SIM,1892,33,na,1925,2845
SIM,1900,42,40-44,1942,1
STAT,1929,39,na,1968,4553.460238182377
STAT,1939,28,35-39,1967,14.24996311043607
STAT,1866,39,50-100,1905,1.058587947548561
STAT,1848,29,25-29,1877,35.86075777391121
STAT,1817,106,na,1923,0.0053843928105517655
SIM,1856,29,25-29,1885,42
SIM,1883,20,20-24,1903,53
STAT,1899,46,45-49,1945,0.17283299136260935
STAT,1881,43,50-100,1924,0.9566751337342941
SIM,1831,35,30-34,1866,3
SIM,1812,76,na,1888,364
SIM,1846,30,45-49,1876,1
SIM,1878,34,na,1912,2393
STAT,1918,25,50-100,1943,1.0074529272193045
STAT,1936,34,50-100,1970,0.7575472025157082
SIM,1799,61,na,1860,890
STAT,1884,48,50-100,1932,0.22639647685179928
STAT,1890,22,na,1912,2731.6950292994034
SIM,1881,38,na,1919,1942
SIM,1946,21,20-24,1967,105
STAT,1876,27,35-39,1903,9.410169550724126
SIM,1857,33,25-29,1890,14
STAT,1875,45,45-49,1920,0.23133047337372217
STAT,1943,17,45-49,1960,0.5004085062138263
STAT,1836,43,40-44,1879,1.6682215318448341
STAT,1864,20,45-49,1884,0.6069077021580754
STAT,1885,17,35-39,1902,0.5164337201179295
SIM,1855,44,30-34,1899,3
SIM,1778,99,na,1877,1
SIM,1815,41,na,1856,1370
STAT,1871,18,45-49,1889,0.061209808388631826
SIM,1869,9,na,1878,2461
STAT,1902,15,50-100,1917,0.06561688829359244
SIM,1899,12,na,1911,3350
SIM,1843,23,30-34,1866,18
STAT,1876,52,25-29,1928,0.0034359778194774358
SIM,1819,55,na,1874,1172
SIM,1866,42,40-44,1908,6
SIM,1931,34,50-100,1965,1
SIM,1929,37,30-34,1966,3
STAT,1913,21,50-100,1934,0.6040190688796144
STAT,1925,26,40-44,1951,5.219253015525146
STAT,1873,37,35-39,1910,6.782283295158457
STAT,1942,30,25-29,1972,9.311081108908756
SIM,1893,30,30-34,1923,21
SIM,1868,31,35-39,1899,10
STAT,1909,17,45-49,1926,0.09251972871713572
STAT,1899,45,30-34,1944,0.07139486802094962
SIM,1938,22,25-29,1960,96
STAT,1847,42,na,1889,1710.068634728618
STAT,1857,54,40-44,1911,0.007624867240268258
SIM,1888,28,na,1916,2579
STAT,1894,68,na,1962,2027.7153815579388
STAT,1847,44,30-34,1891,0.8344946595553895
STAT,1830,33,20-24,1863,2.225040686958149
STAT,1890,34,30-34,1924,19.993788196733536
STAT,1898,16,30-34,1914,2.0432892333137533
STAT,1828,39,na,1867,1543.6279745234044
STAT,1885,30,30-34,1915,16.564814228849905
STAT,1813,50,35-39,1863,0.0258724605395931
STAT,1888,83,na,1971,847.4732706293015
SIM,1875,21,25-29,1896,64
SIM,1893,17,35-39,1910,1
SIM,1874,20,na,1894,2280
STAT,1910,38,15-19,1948,0.017259086122361367
STAT,1835,23,30-34,1858,14.667010018867071
STAT,1843,26,50-100,1869,0.5720773913217186
SIM,1876,20,50-100,1896,1
STAT,1808,54,45-49,1862,0.05070835134132355
STAT,1902,28,15-19,1930,0.6027236210404175
SIM,1821,36,25-29,1857,1
SIM,1942,20,25-29,1962,82
STAT,1823,43,30-34,1866,1.4478993523704826
STAT,1867,29,35-39,1896,8.497434230558186
SIM,1838,69,na,1907,912
SIM,1912,1,na,1913,3740
STAT,1854,34,20-24,1888,1.9523208192061263
SIM,1877,34,40-44,1911,5
STAT,1861,52,40-44,1913,0.008214730040782851
SIM,1881,37,35-39,1918,11
SIM,1866,23,25-29,1889,58
STAT,1869,34,40-44,1903,3.931700791640445
SIM,1831,43,30-34,1874,1
STAT,1828,32,50-100,1860,0.9866579855470116
SIM,1839,25,30-34,1864,29
STAT,1928,27,20-24,1955,21.24699110298799
SIM,1875,35,45-49,1910,2
SIM,1903,38,25-29,1941,4
STAT,1923,34,50-100,1957,0.8943400643393009
SIM,1928,17,20-24,1945,148
SIM,1899,26,40-44,1925,4
SIM,1911,53,na,1964,3269
SIM,1936,27,20-24,1963,15
STAT,1868,20,50-100,1888,0.373156878969445
STAT,1903,48,25-29,1951,0.043120536682060305
STAT,1841,25,20-24,1866,10.114091688567697
SIM,1833,22,na,1855,1725
STAT,1774,81,na,1855,178.8553
STAT,1858,23,25-29,1881,44.00889721953434
STAT,1867,21,25-29,1888,51.35479186350633
SIM,1841,15,20-24,1856,13
STAT,1853,53,45-49,1906,0.01058971612223736
SIM,1891,44,40-44,1935,4
STAT,1866,33,25-29,1899,8.88354860917358
STAT,1834,22,25-29,1856,47.39054771363717
STAT,1829,43,50-100,1872,0.8752957740166802
STAT,1774,97,na,1871,0.8583049888856772
STAT,1877,40,na,1917,2288.609788932796
STAT,1894,43,50-100,1937,0.08850720695803628
SIM,1899,35,30-34,1934,7
STAT,1926,15,na,1941,4283.507944755516
SIM,1849,39,35-39,1888,14
STAT,1930,39,30-34,1969,2.2411582241452113
SIM,1873,27,35-39,1900,9
SIM,1900,3,na,1903,3435
STAT,1820,40,25-29,1860,1.2313959178237002
STAT,1875,20,20-24,1895,67.28125283130741
STAT,1825,90,na,1915,44.575993354071095
STAT,1874,75,na,1949,993.9780955356485
SIM,1898,70,na,1968,2119
STAT,1904,31,na,1935,3246.2415677040626
STAT,1862,25,40-44,1887,2.458007906686846
STAT,1812,52,45-49,1864,0.04567087920975323
STAT,1895,24,40-44,1919,2.552837211969879
STAT,1871,38,15-19,1909,0.05233033484865179
STAT,1870,61,na,1931,1729.7389401253995
STAT,1901,35,45-49,1936,0.5743525028727045
STAT,1892,39,50-100,1931,1.4378099799195039
STAT,1810,44,35-39,1854,6.697055527765418
SIM,1857,44,40-44,1901,8
STAT,1845,28,45-49,1873,0.9450921816574147
SIM,1890,24,30-34,1914,31
SIM,1836,33,40-44,1869,2
STAT,1846,29,15-19,1875,0.3814543997128528
SIM,1893,23,na,1916,2951
SIM,1840,28,35-39,1868,10
SIM,1870,25,40-44,1895,2
STAT,1841,80,na,1921,423.2383722789236
SIM,1906,16,30-34,1922,2
SIM,1862,34,20-24,1896,4
STAT,1828,33,40-44,1861,4.506320165107393
STAT,1917,1,na,1918,4231.293224703558
SIM,1840,36,35-39,1876,13
STAT,1832,28,35-39,1860,7.8259662713305636
STAT,1903,46,na,1949,3033.0094833786948
STAT,1871,34,20-24,1905,2.509858001302824
SIM,1858,25,40-44,1883,3
SIM,1803,56,na,1859,1023
SIM,1933,26,40-44,1959,7
STAT,1882,24,30-34,1906,16.271438796840467
STAT,1870,37,50-100,1907,1.1364840199608042
STAT,1834,44,45-49,1878,1.0885712856582166
STAT,1889,27,20-24,1916,13.682063220540845
SIM,1844,43,40-44,1887,4
STAT,1821,35,20-24,1856,1.8329570408441453
SIM,1916,30,25-29,1946,11
STAT,1916,32,na,1948,3688.6199765813726
STAT,1845,94,na,1939,14.077820342489737
SIM,1842,22,25-29,1864,52
STAT,1856,28,20-24,1884,8.929918208638147
STAT,1916,40,25-29,1956,0.06932092703001522
STAT,1839,23,15-19,1862,2.806056823242443
STAT,1868,7,na,1875,2497.7241909659306
SIM,1908,24,40-44,1932,6
STAT,1852,26,35-39,1878,8.600456068902778
SIM,1860,26,35-39,1886,6
SIM,1842,44,45-49,1886,5
SIM,1878,41,45-49,1919,4
STAT,1821,104,na,1925,0.036017934234516255
SIM,1897,27,20-24,1924,21
SIM,1939,26,na,1965,3503
STAT,1895,38,25-29,1933,3.531868277974576
STAT,1824,73,na,1897,627.0593875485299
SIM,1845,87,na,1932,113
STAT,1844,16,35-39,1860,0.49255495345408684
SIM,1853,58,na,1911,1571
SIM,1845,23,na,1868,1836
SIM,1774,85,na,1859,55
STAT,1807,77,na,1884,357.0167512247648
STAT,1897,37,20-24,1934,0.9739023294529964
STAT,1873,46,25-29,1919,0.055389936258074444
SIM,1841,73,na,1914,808
SIM,1864,28,20-24,1892,9
STAT,1890,45,50-100,1935,0.2865027485365279
STAT,1908,30,25-29,1938,8.306121631119195
STAT,1906,26,30-34,1932,34.75932632220334
STAT,1923,30,15-19,1953,0.14030126458289693
SIM,1850,43,40-44,1893,2
STAT,1873,29,35-39,1902,9.186308928002154
STAT,1872,19,15-19,1891,5.596977449651543
STAT,1843,87,na,1930,127.10657551474529
STAT,1900,44,50-100,1944,0.09484989954945078
STAT,1852,18,35-39,1870,0.5012476923716532
STAT,1812,49,15-19,1861,0.0012740266867347636
STAT,1817,43,30-34,1860,2.7914099379159345
STAT,1922,48,35-39,1970,0.13954514912986635
SIM,1883,34,40-44,1917,9
STAT,1851,31,15-19,1882,0.10982731252395989
SIM,1898,31,20-24,1929,2
STAT,1832,30,50-100,1862,0.741411180545768
STAT,1901,21,25-29,1922,75.92365562264742
STAT,1881,45,20-24,1926,0.011054852359644787
SIM,1932,17,35-39,1949,7
STAT,1894,52,na,1946,2602.714974224276
SIM,1862,23,40-44,1885,4
SIM,1867,66,na,1933,1418
STAT,1767,115,na,1882,1.344272014307669E-4
STAT,1854,51,35-39,1905,0.0062289952743490775
STAT,1836,35,40-44,1871,3.4642723268827975
STAT,1933,28,na,1961,4696.807202906381
STAT,1810,81,na,1891,244.88349125230476
STAT,1924,17,35-39,1941,4.720999754833816
STAT,1859,41,50-100,1900,0.8000889147588792
STAT,1899,24,50-100,1923,0.5246260172600822
STAT,1849,49,35-39,1898,0.09880377741516273
STAT,1856,36,20-24,1892,0.5730915670837347
SIM,1853,28,45-49,1881,5
STAT,1845,20,35-39,1865,5.176873494591606
SIM,1869,38,25-29,1907,1
STAT,1875,34,40-44,1909,4.172912920990118
STAT,1884,34,30-34,1918,16.159791245148096
STAT,1870,100,na,1970,7.292590742534097
STAT,1820,51,40-44,1871,0.017021466617515843
SIM,1866,36,30-34,1902,8
STAT,1840,38,35-39,1878,5.765717251561591
STAT,1872,42,15-19,1914,0.013078390779610712
SIM,1919,22,15-19,1941,5
STAT,1826,33,50-100,1859,1.1440109298729497
STAT,1840,52,20-24,1892,5.111636390018071E-4
STAT,1842,43,40-44,1885,1.6360755642318339
SIM,1877,37,20-24,1914,3
SIM,1823,33,30-34,1856,16
SIM,1832,26,35-39,1858,8
SIM,1844,35,40-44,1879,3
SIM,1925,27,45-49,1952,2
STAT,1816,53,40-44,1869,0.026010618996270406
STAT,1913,16,20-24,1929,26.244755594181637
SIM,1892,34,30-34,1926,23
STAT,1863,34,50-100,1897,0.754348549850609
STAT,1832,36,35-39,1868,5.481004425516228
STAT,1838,48,20-24,1886,0.008312954162486392
STAT,1858,27,40-44,1885,2.274240821199727
STAT,1938,24,25-29,1962,86.29327713073491
STAT,1877,47,20-24,1924,0.01170896072288972
STAT,1849,41,25-29,1890,0.4649552364803567
STAT,1873,23,15-19,1896,3.153686516559874
SIM,1879,51,na,1930,2125
SIM,1838,40,50-100,1878,2
SIM,1856,26,20-24,1882,8
STAT,1861,35,50-100,1896,0.9722825573984883
STAT,1910,3,na,1913,3783.2096861786986
STAT,1857,15,30-34,1872,1.4117573632159557
SIM,1849,31,25-29,1880,7
SIM,1860,18,35-39,1878,3
STAT,1915,47,na,1962,3496.869473649335
STAT,1897,29,20-24,1926,14.715762399224314
STAT,1903,26,50-100,1929,0.8627182115685017
STAT,1911,33,na,1944,3463.6870110420937
STAT,1881,20,45-49,1901,0.6398527553111241
SIM,1816,43,40-44,1859,4
SIM,1825,43,30-34,1868,2
SIM,1866,27,40-44,1893,2
STAT,1867,35,45-49,1902,1.7850167028362809
SIM,1880,19,15-19,1899,6
SIM,1867,40,30-34,1907,1
SIM,1840,30,50-100,1870,4
SIM,1897,4,na,1901,3357
SIM,1807,49,50-100,1856,2
SIM,1808,55,na,1863,1123
STAT,1891,17,35-39,1908,0.6416092912588851
STAT,1869,21,na,1890,2169.216806817956
STAT,1923,49,40-44,1972,0.17323126501139313
STAT,1826,28,35-39,1854,29.392963252931803
STAT,1897,25,50-100,1922,0.8136802686867319
SIM,1862,35,na,1897,2067
STAT,1876,24,30-34,1900,17.262776510407146
STAT,1919,36,50-100,1955,0.42649573994366535
STAT,1939,25,30-34,1964,37.23999164161051
SIM,1921,16,20-24,1937,120
STAT,1860,28,35-39,1888,7.433673378150393
SIM,1864,3,na,1867,2696
SIM,1891,7,na,1898,3206
STAT,1860,31,40-44,1891,3.3431627162242545
STAT,1862,33,40-44,1895,3.4799426294389755
SIM,1928,10,na,1938,4733
SIM,1857,72,na,1929,974
STAT,1860,24,na,1884,1845.0361684613806
STAT,1883,44,40-44,1927,2.054420272918614
STAT,1951,16,40-44,1967,1.574009251765055
SIM,1921,31,na,1952,3894
SIM,1933,4,na,1937,5104
STAT,1931,6,na,1937,4956.127754792556
STAT,1855,72,na,1927,894.4286360829989
SIM,1865,15,30-34,1880,1
STAT,1843,33,30-34,1876,14.98686989330134
STAT,1859,86,na,1945,167.27790094754505
SIM,1857,30,20-24,1887,2
SIM,1833,38,na,1871,1581
SIM,1850,93,na,1943,15
SIM,1903,50,na,1953,2950
SIM,1884,24,30-34,1908,20
STAT,1830,37,15-19,1867,0.04456618633625911
SIM,1879,39,20-24,1918,4
SIM,1821,96,na,1917,2
STAT,1880,41,35-39,1921,1.8080903714469296
SIM,1907,64,na,1971,2748
SIM,1798,76,na,1874,358
SIM,1794,62,na,1856,885
STAT,1934,20,25-29,1954,117.64901954185487
SIM,1828,75,na,1903,537
SIM,1869,14,na,1883,2404
STAT,1852,29,15-19,1881,0.36013600869477963
SIM,1946,24,25-29,1970,90
STAT,1816,38,na,1854,1464.3816171036
STAT,1893,19,35-39,1912,0.6541645017038211
SIM,1842,33,40-44,1875,4
SIM,1851,33,30-34,1884,20
STAT,1861,41,25-29,1902,0.5060365869497172
STAT,1917,27,45-49,1944,1.7115001415713573
SIM,1883,23,25-29,1906,54
STAT,1804,96,na,1900,2.9098389543359913
STAT,1869,48,25-29,1917,0.05200973889353905
STAT,1939,0,na,1939,4250.40338104336
STAT,1848,26,20-24,1874,10.162596843687403
SIM,1867,27,35-39,1894,10
SIM,1918,21,45-49,1939,1
STAT,1880,27,25-29,1907,42.04754563529404
STAT,1959,7,na,1966,4856.086024956275
SIM,1888,38,35-39,1926,14
STAT,1857,40,20-24,1897,0.11946957759150431
STAT,1870,18,na,1888,2346.245901335982
STAT,1849,107,na,1956,0.004323124608281638
STAT,1888,48,35-39,1936,0.0870257772638833
STAT,1921,36,25-29,1957,1.0396253115279812
SIM,1882,19,25-29,1901,7
STAT,1904,49,30-34,1953,0.07243316143130955
SIM,1788,93,na,1881,5
STAT,1938,28,50-100,1966,0.9310041642410535
STAT,1915,20,15-19,1935,5.017481307283168
STAT,1841,39,40-44,1880,3.4562307751560675
STAT,1831,41,15-19,1872,0.010658659075676433
SIM,1940,16,30-34,1956,15
STAT,1849,30,20-24,1879,2.3034580851403974
STAT,1899,28,40-44,1927,3.8644464764680437
STAT,1881,39,35-39,1920,6.386591015495771
STAT,1864,44,30-34,1908,0.9575749432245946
SIM,1885,6,na,1891,2483
STAT,1932,16,30-34,1948,15.28493076328064
STAT,1940,30,na,1970,3701.59393883101
STAT,1952,9,na,1961,4448.88045498459
STAT,1868,50,25-29,1918,0.0032407251011369485
SIM,1906,27,35-39,1933,20
STAT,1861,41,na,1902,1821.3175578684775
STAT,1836,46,20-24,1882,0.008032640672408026
STAT,1850,41,na,1891,1634.4804715811724
STAT,1865,55,na,1920,1775.0180296281765
SIM,1954,7,na,1961,4435
STAT,1857,20,na,1877,1864.987366621698
STAT,1877,36,40-44,1913,4.311994782981697
STAT,1786,82,na,1868,156.44501223885678
STAT,1814,48,35-39,1862,0.3736731301619619
STAT,1876,15,40-44,1891,0.17920596142960118
STAT,1814,54,20-24,1868,0.0018396519387657928
SIM,1862,102,na,1964,1
STAT,1841,17,20-24,1858,15.644142871201934
STAT,1854,23,40-44,1877,1.7504213341628574
SIM,1881,29,35-39,1910,7
SIM,1923,20,15-19,1943,6
STAT,1854,18,45-49,1872,0.05593767435920238
STAT,1850,16,35-39,1866,0.4748400943388831
STAT,1851,35,30-34,1886,4.033011648795029
STAT,1897,3,na,1900,3340.0174052442753
STAT,1857,19,25-29,1876,4.902047193275599
STAT,1874,16,20-24,1890,17.159496844504325
SIM,1819,71,na,1890,616
STAT,1948,5,na,1953,4274.701942364826
SIM,1854,27,25-29,1881,40
STAT,1920,48,25-29,1968,0.05524275376478195
STAT,1872,46,30-34,1918,0.09204658071900115
STAT,1894,39,45-49,1933,2.3981437974527635
STAT,1853,31,25-29,1884,7.903950022832323
STAT,1899,48,35-39,1947,0.10095315266293134
STAT,1887,41,45-49,1928,1.5883496782297182
SIM,1864,40,50-100,1904,1
SIM,1869,102,na,1971,1
SIM,1801,97,na,1898,1
STAT,1858,21,na,1879,1832.5233499757655
STAT,1895,27,20-24,1922,14.462530656566248
SIM,1858,29,35-39,1887,7
STAT,1931,25,50-100,1956,1.2150532519391475
STAT,1806,60,na,1866,966.6183125888622
STAT,1839,28,20-24,1867,9.783467792026215
STAT,1886,49,15-19,1935,3.909133034245463E-4
SIM,1921,39,30-34,1960,1
STAT,1942,26,40-44,1968,4.623310853690452
STAT,1879,49,20-24,1928,0.011601783473589622
SIM,1849,36,50-100,1885,4
STAT,1884,53,na,1937,1977.8479753998104
STAT,1919,24,15-19,1943,5.472115468092373
SIM,1870,43,45-49,1913,2
SIM,1871,34,50-100,1905,5
SIM,1849,35,40-44,1884,3
SIM,1852,19,15-19,1871,5
SIM,1824,45,na,1869,1376
STAT,1859,27,35-39,1886,7.4001301473141865
STAT,1800,82,na,1882,170.77287365387224
STAT,1888,67,na,1955,1769.1191988584444
STAT,1899,43,40-44,1942,0.20075055299372352
SIM,1947,16,40-44,1963,1
STAT,1812,45,20-24,1857,0.04079408258850941
SIM,1811,47,50-100,1858,1
SIM,1889,34,na,1923,2752
SIM,1885,20,na,1905,2266
STAT,1827,48,45-49,1875,0.2040346324816528
STAT,1842,52,30-34,1894,0.004216319646270921
STAT,1840,31,15-19,1871,0.12205539488971148
SIM,1865,19,25-29,1884,5
STAT,1846,27,25-29,1873,36.08156269404472
STAT,1873,90,na,1963,166.52671862395638
SIM,1960,3,na,1963,4672
SIM,1872,18,na,1890,2350
STAT,1855,49,35-39,1904,0.097082908855798
STAT,1872,68,na,1940,1449.040436989736
STAT,1849,42,15-19,1891,0.009941743523669876
SIM,1873,18,20-24,1891,14
SIM,1805,63,na,1868,877
STAT,1814,41,15-19,1855,0.044992556356981926
SIM,1788,77,na,1865,287
STAT,1834,38,35-39,1872,5.38949624863077
STAT,1859,101,na,1960,0.9808341838054478
STAT,1844,45,40-44,1889,0.12207926525587488
STAT,1864,2,na,1866,2874.450296972038
SIM,1809,77,na,1886,356
STAT,1902,16,45-49,1918,0.08729845796948323
STAT,1843,16,40-44,1859,0.16963031824187602
SIM,1855,22,na,1877,2014
STAT,1943,29,15-19,1972,0.7095324546021531
SIM,1892,17,na,1909,3050
STAT,1833,54,30-34,1887,0.0035878541004528406
SIM,1842,38,35-39,1880,3
SIM,1859,36,na,1895,1974
SIM,1882,16,20-24,1898,16
SIM,1891,75,na,1966,1479
STAT,1827,40,35-39,1867,1.7255064414655916
STAT,1886,48,25-29,1934,0.05676956229777204
STAT,1836,46,45-49,1882,0.15797526056215216
STAT,1920,19,50-100,1939,0.3949844871878719
STAT,1910,30,40-44,1940,3.59218792742741
STAT,1899,21,20-24,1920,89.48439095173373
STAT,1900,17,na,1917,3310.0329429932535
SIM,1847,37,35-39,1884,8
STAT,1865,18,20-24,1883,15.590495242743454
STAT,1793,95,na,1888,2.6073419545531804
STAT,1894,31,35-39,1925,12.356908435108336
STAT,1847,20,45-49,1867,0.638118170030607
SIM,1863,101,na,1964,1
STAT,1901,32,40-44,1933,5.734383649625159
SIM,1881,54,na,1935,1743
STAT,1939,16,40-44,1955,1.3228679445348155
STAT,1882,19,35-39,1901,0.5016959197836656
STAT,1843,31,40-44,1874,3.8006156128999105
STAT,1816,81,na,1897,251.99441871719046
SIM,1803,83,na,1886,96
SIM,1913,17,na,1930,3599
STAT,1898,41,20-24,1939,0.014167104629254454
STAT,1850,29,40-44,1879,2.4462250978803013
SIM,1780,97,na,1877,2
SIM,1845,29,25-29,1874,36
STAT,1853,30,35-39,1883,7.896361537922494
SIM,1882,15,30-34,1897,1
SIM,1943,5,na,1948,3905
STAT,1921,5,na,1926,4330.042152765979
SIM,1887,54,na,1941,2164
SIM,1888,36,50-100,1924,1
SIM,1933,32,na,1965,4815
STAT,1917,39,15-19,1956,0.01872749030055801
STAT,1882,17,50-100,1899,0.04503578795124556
SIM,1927,24,15-19,1951,4
STAT,1843,36,35-39,1879,6.019242744286156
SIM,1828,37,25-29,1865,4
STAT,1888,47,20-24,1935,0.013329687609503297
SIM,1836,102,na,1938,1
STAT,1823,37,20-24,1860,1.2321527004202921
STAT,1818,88,na,1906,66.18764778457178
SIM,1884,40,30-34,1924,5
STAT,1876,40,30-34,1916,1.1325336664553323
STAT,1940,32,50-100,1972,0.808290224655184
SIM,1925,20,25-29,1945,108
STAT,1904,7,na,1911,3529.796769306796
SIM,1894,30,25-29,1924,14
STAT,1841,18,35-39,1859,0.48134409890595464
SIM,1883,40,na,1923,2211
SIM,1917,23,50-100,1940,1
STAT,1821,39,15-19,1860,0.10329675516868105
SIM,1847,28,20-24,1875,11
SIM,1861,38,45-49,1899,1
SIM,1921,47,na,1968,3816
STAT,1884,17,40-44,1901,0.17074726977131374
STAT,1916,16,na,1932,3880.5136300144763
STAT,1919,37,20-24,1956,0.26753535130517264
STAT,1837,29,25-29,1866,33.78391015576189
SIM,1903,18,na,1921,3366
SIM,1860,92,na,1952,33
STAT,1890,28,20-24,1918,13.502446651879426
SIM,1862,26,20-24,1888,10
STAT,1847,46,20-24,1893,0.008854533234954172
STAT,1874,15,30-34,1889,1.5518512511309601
SIM,1861,31,25-29,1892,12
SIM,1914,50,na,1964,3696
STAT,1939,17,30-34,1956,11.524620973735402
STAT,1854,26,20-24,1880,9.802244356104316
SIM,1914,26,30-34,1940,43
SIM,1916,34,40-44,1950,10
STAT,1827,100,na,1927,0.5891591970787499
SIM,1851,31,40-44,1882,3
STAT,1853,38,45-49,1891,1.471052564011354
STAT,1892,36,30-34,1928,6.335272644997967
STAT,1925,44,45-49,1969,0.18974137381627681
STAT,1823,46,35-39,1869,0.1694312351798753
STAT,1906,49,40-44,1955,0.13007033953200012
STAT,1840,36,na,1876,1782.5993190674037
SIM,1884,16,30-34,1900,4
STAT,1895,19,45-49,1914,0.08009770660739986
SIM,1858,21,25-29,1879,45
STAT,1862,43,45-49,1905,1.1973370457946855
SIM,1836,28,45-49,1864,4
SIM,1879,35,na,1914,2337
STAT,1896,43,15-19,1939,0.0011886718577094552
SIM,1947,17,30-34,1964,17
SIM,1837,95,na,1932,6
STAT,1884,22,15-19,1906,3.0797699665998195
SIM,1833,81,na,1914,301
SIM,1820,34,40-44,1854,2
STAT,1910,49,30-34,1959,0.07808945691668065
SIM,1859,42,25-29,1901,3
STAT,1814,108,na,1922,7.55761740743947E-4
SIM,1892,22,15-19,1914,7
STAT,1920,21,na,1941,3847.0220330625275
STAT,1887,28,25-29,1915,44.53399068324119
STAT,1825,45,30-34,1870,0.10433411674599864
SIM,1895,28,25-29,1923,56
SIM,1862,62,na,1924,1555
STAT,1920,16,15-19,1936,48.22191155906665
SIM,1861,30,35-39,1891,9
STAT,1808,48,35-39,1856,0.5241719396815513
STAT,1845,48,15-19,1893,2.782120740818986E-4
STAT,1759,104,na,1863,0.013260237530154737
STAT,1890,37,35-39,1927,8.1694153641091
STAT,1828,28,45-49,1856,1.61504309170245
STAT,1947,23,15-19,1970,5.681903071380027
STAT,1875,39,35-39,1914,6.795450682587271
SIM,1885,32,25-29,1917,9
STAT,1847,39,35-39,1886,5.288585019756676
STAT,1821,42,45-49,1863,2.4979455242380566
STAT,1882,17,30-34,1899,1.4651645992301636
SIM,1891,30,20-24,1921,6
STAT,1908,34,40-44,1942,3.4588975022673822
STAT,1887,17,45-49,1904,0.06901299935776856
STAT,1893,15,40-44,1908,0.22024911198099387
STAT,1817,41,40-44,1858,5.920354681519047
STAT,1832,35,20-24,1867,0.6038217483854662
SIM,1885,45,50-100,1930,4
STAT,1882,26,20-24,1908,10.82114574608973
SIM,1924,36,40-44,1960,1
STAT,1866,53,30-34,1919,0.00510136093773255
SIM,1876,41,35-39,1917,2
STAT,1838,19,15-19,1857,5.283623057575114
STAT,1825,74,na,1899,627.467938701748
SIM,1834,24,40-44,1858,4
SIM,1883,39,35-39,1922,12
STAT,1911,18,15-19,1929,8.554962221284384
STAT,1817,46,35-39,1863,0.3182308987409632
STAT,1824,89,na,1913,55.46171299568678
STAT,1941,17,35-39,1958,4.082735191888863
STAT,1806,52,20-24,1858,0.0020835299344775485
SIM,1836,20,35-39,1856,9
SIM,1875,69,na,1944,1350
STAT,1901,48,15-19,1949,2.946029334012292E-4
SIM,1928,16,30-34,1944,16
STAT,1868,36,na,1904,2135.2652180831105
STAT,1845,47,25-29,1892,0.04038321476459058
STAT,1868,41,35-39,1909,1.6407027934638534
STAT,1873,30,15-19,1903,0.13765356010920435
SIM,1843,15,30-34,1858,1
STAT,1894,32,25-29,1926,12.447020322484937
SIM,1896,21,45-49,1917,1
STAT,1837,43,na,1880,1546.1452958689706
STAT,1865,27,35-39,1892,8.283072778443358
SIM,1867,45,50-100,1912,1
SIM,1846,19,15-19,1865,10
SIM,1856,87,na,1943,99
SIM,1852,73,na,1925,872
SIM,1938,16,15-19,1954,40
SIM,1829,30,45-49,1859,1
STAT,1877,13,na,1890,2527.753440338306
SIM,1820,37,45-49,1857,2
SIM,1825,41,40-44,1866,7
STAT,1873,43,20-24,1916,0.1511870504356697
SIM,1880,17,25-29,1897,5
SIM,1835,88,na,1923,82
SIM,1831,74,na,1905,631
SIM,1839,21,15-19,1860,3
SIM,1947,21,15-19,1968,3
STAT,1921,28,25-29,1949,69.06175643335692
SIM,1881,38,25-29,1919,2
STAT,1867,37,35-39,1904,6.273684750351226
STAT,1884,32,40-44,1916,4.048497104878889
SIM,1839,29,25-29,1868,41
SIM,1834,44,na,1878,1485
STAT,1868,20,na,1888,2164.185662861106
STAT,1880,16,20-24,1896,17.665412520838284
STAT,1842,46,45-49,1888,0.17025398467989725
STAT,1868,42,25-29,1910,0.5784977927474968
SIM,1875,37,35-39,1912,13
STAT,1916,36,40-44,1952,1.4551385355035897
SIM,1813,46,50-100,1859,2
SIM,1838,39,35-39,1877,15
STAT,1806,92,na,1898,13.858780625780756
STAT,1872,17,25-29,1889,5.3908794615175815
SIM,1851,36,35-39,1887,12
STAT,1864,38,20-24,1902,0.6476078661980561
SIM,1830,30,na,1860,1780
SIM,1898,49,50-100,1947,2
SIM,1828,26,45-49,1854,1
SIM,1892,32,40-44,1924,4
STAT,1909,37,15-19,1946,0.017166862909629568
SIM,1902,33,na,1935,3249
STAT,1868,49,45-49,1917,0.20842208810596816
STAT,1873,38,25-29,1911,2.747192154078006
SIM,1868,72,na,1940,1073
SIM,1843,37,na,1880,1761
STAT,1856,35,na,1891,1759.7284749496662
STAT,1852,21,na,1873,1943.7748422224577
STAT,1893,20,15-19,1913,3.9778564207883362
SIM,1854,40,45-49,1894,2
SIM,1847,73,na,1920,824
SIM,1923,24,30-34,1947,30
STAT,1875,17,na,1892,2451.1967794428087
SIM,1890,16,30-34,1906,1
SIM,1875,27,45-49,1902,1
SIM,1892,37,35-39,1929,19
STAT,1939,21,15-19,1960,5.051416363952648
STAT,1892,43,30-34,1935,1.3502405140264973
STAT,1871,24,na,1895,2201.1046840481636
STAT,1887,2,na,1889,2960.5661926110893
SIM,1942,24,40-44,1966,4
SIM,1864,29,35-39,1893,10
STAT,1856,29,35-39,1885,7.291977873752007
STAT,1870,45,45-49,1915,0.22063593258144812
SIM,1850,77,na,1927,612
STAT,1827,41,25-29,1868,0.6012319089226029
STAT,1934,24,40-44,1958,4.26570606131389
SIM,1871,76,na,1947,802
STAT,1883,47,45-49,1930,0.2174859584798017
SIM,1835,40,35-39,1875,3
SIM,1875,32,40-44,1907,5
STAT,1846,16,45-49,1862,0.05819981506881415
STAT,1893,27,35-39,1920,11.56536016214932
STAT,1873,15,50-100,1888,0.04753705784172194
STAT,1915,24,30-34,1939,27.888068117009844
SIM,1822,38,na,1860,1538
SIM,1929,0,na,1929,5126
STAT,1773,96,na,1869,1.0425870511389086
SIM,1890,26,20-24,1916,12
STAT,1862,36,45-49,1898,1.614158826080195
STAT,1910,15,40-44,1925,0.2629613541478126
SIM,1899,27,30-34,1926,38
SIM,1820,49,50-100,1869,3
SIM,1856,35,50-100,1891,1
SIM,1877,29,45-49,1906,1
SIM,1937,30,45-49,1967,1
STAT,1826,36,35-39,1862,7.889111128107087
SIM,1868,51,na,1919,1945
STAT,1864,47,35-39,1911,0.11765243627265597
STAT,1877,32,25-29,1909,10.040998921171738
SIM,1918,30,35-39,1948,12
STAT,1884,37,35-39,1921,6.602853125175979
STAT,1883,30,20-24,1913,2.522790034319277
SIM,1855,39,35-39,1894,9
STAT,1803,54,45-49,1857,0.03996261764855583
SIM,1792,82,na,1874,111
STAT,1935,27,15-19,1962,0.9090384859229896
SIM,1939,18,35-39,1957,8
SIM,1822,59,na,1881,1123
SIM,1926,25,50-100,1951,3
STAT,1900,39,20-24,1939,0.21586249566359758
STAT,1888,21,45-49,1909,0.780567464720548
STAT,1904,47,na,1951,3034.48979941733
STAT,1858,42,40-44,1900,1.6660758343748059
STAT,1867,28,45-49,1895,0.9813727695244808
SIM,1796,96,na,1892,3
SIM,1834,36,35-39,1870,16
STAT,1945,27,20-24,1972,18.91870836333198
SIM,1871,55,na,1926,1962
SIM,1802,98,na,1900,1
SIM,1892,48,50-100,1940,1
STAT,1821,60,na,1881,1108.4698157201292
STAT,1836,74,na,1910,700.8193094745483
SIM,1907,36,40-44,1943,1
SIM,1819,39,25-29,1858,2
STAT,1831,45,30-34,1876,0.07302508799500036
STAT,1847,53,20-24,1900,5.342350575900404E-4
STAT,1846,8,na,1854,2175.0
SIM,1889,50,na,1939,2552
SIM,1924,26,50-100,1950,2
STAT,1900,33,na,1933,3114.2763301152822
SIM,1821,33,50-100,1854,3
SIM,1902,65,na,1967,2534
STAT,1876,19,35-39,1895,0.5322617530964913
STAT,1877,54,45-49,1931,0.013835539196640097
STAT,1933,19,50-100,1952,0.47125615657742187
STAT,1846,40,45-49,1886,1.0957344192190597
STAT,1869,54,50-100,1923,0.013430729918165523
SIM,1877,65,na,1942,1621
STAT,1912,28,50-100,1940,0.9231513369123304
STAT,1912,49,40-44,1961,0.1422688565487067
STAT,1834,35,30-34,1869,4.189584227276001
STAT,1906,22,15-19,1928,4.538167341950927
SIM,1849,38,45-49,1887,1
STAT,1830,26,50-100,1856,0.6749576799536949
STAT,1860,16,40-44,1876,0.16291528848318915
SIM,1823,60,na,1883,1036
SIM,1875,21,na,1896,2271
STAT,1857,16,20-24,1873,15.610417558806084
STAT,1828,39,25-29,1867,2.6161675013466534
STAT,1860,40,na,1900,1792.3817948655515
SIM,1830,89,na,1919,57
STAT,1852,51,25-29,1903,0.002703999448502236
SIM,1864,27,30-34,1891,29
SIM,1837,27,25-29,1864,37
STAT,1819,46,45-49,1865,0.42595944077437925
STAT,1930,18,25-29,1948,52.79114937630466
STAT,1894,36,40-44,1930,5.3452337875521865
SIM,1886,27,20-24,1913,12
SIM,1860,55,na,1915,1718
STAT,1841,32,50-100,1873,0.7606016474008882
SIM,1829,92,na,1921,19
STAT,1838,22,na,1860,1891.933565237343
STAT,1814,74,na,1888,472.48471302537354
STAT,1878,27,20-24,1905,11.537325393445599
STAT,1864,53,20-24,1917,6.130298128126194E-4
STAT,1922,41,15-19,1963,0.0016676904116337018
SIM,1833,59,na,1892,1173
STAT,1862,10,na,1872,2230.8500277718435
STAT,1893,17,45-49,1910,0.07829660058273065
STAT,1844,40,35-39,1884,1.3357199562332873
STAT,1935,31,45-49,1966,2.057714017737224
STAT,1874,19,25-29,1893,5.442062972359547
SIM,1836,39,25-29,1875,1
SIM,1905,36,30-34,1941,1
STAT,1910,33,45-49,1943,1.4268773728500685
STAT,1942,29,45-49,1971,1.7111596582758302
STAT,1930,28,50-100,1958,1.1951226040884226
STAT,1775,82,na,1857,140.59413739299484
SIM,1842,35,30-34,1877,2
STAT,1848,108,na,1956,0.0015923328353410764
SIM,1879,37,30-34,1916,3
STAT,1875,32,15-19,1907,0.13821206219388082
STAT,1851,33,40-44,1884,3.275810778287284
STAT,1829,27,25-29,1856,60.95627516861295
SIM,1872,40,na,1912,2186
SIM,1923,27,35-39,1950,22
STAT,1872,49,35-39,1921,0.12997663925453742
SIM,1912,54,na,1966,3098
STAT,1856,27,30-34,1883,19.306951805752618
SIM,1893,45,50-100,1938,1
STAT,1862,40,40-44,1902,1.8308408663532778
STAT,1868,46,40-44,1914,0.15485689069944097
SIM,1870,40,40-44,1910,3
STAT,1866,47,45-49,1913,0.20459511163169602
STAT,1810,60,na,1870,1049.3755589302727
STAT,1920,45,20-24,1965,0.011595309979865576
STAT,1880,17,na,1897,2510.448510760821
STAT,1847,49,25-29,1896,0.041496536896869954
SIM,1920,28,50-100,1948,5
SIM,1838,37,30-34,1875,7
STAT,1896,18,25-29,1914,7.056556245214937
STAT,1900,21,50-100,1921,0.5360593777910911
STAT,1905,32,na,1937,3285.3961871380266
STAT,1921,33,20-24,1954,2.5536836831662755
SIM,1884,38,50-100,1922,1
STAT,1850,25,na,1875,1818.2206279043792
SIM,1884,20,15-19,1904,3
SIM,1876,17,35-39,1893,2
STAT,1912,46,25-29,1958,0.04826807916029019
SIM,1898,38,40-44,1936,1
STAT,1835,29,15-19,1864,0.3636585659927441
STAT,1888,41,15-19,1929,0.015481645322183832
STAT,1855,42,15-19,1897,0.009768587857937959
STAT,1841,15,30-34,1856,1.423189963925533
SIM,1894,37,45-49,1931,3
STAT,1886,19,50-100,1905,0.04863773682905536
STAT,1834,26,40-44,1860,2.448993849415729
STAT,1908,13,na,1921,3612.566889982495
SIM,1900,69,na,1969,2179
SIM,1852,40,35-39,1892,3
SIM,1878,28,25-29,1906,45
SIM,1911,16,15-19,1927,8
STAT,1868,17,35-39,1885,0.5038840419160856
SIM,1858,73,na,1931,938
STAT,1828,48,15-19,1876,3.3249946039698767E-4
STAT,1925,41,40-44,1966,0.2865237345316248
STAT,1942,21,35-39,1963,9.329108460424186
SIM,1839,26,20-24,1865,16
STAT,1812,48,25-29,1860,0.18647199023467306
SIM,1798,92,na,1890,10
STAT,1763,97,na,1860,0.315810141760079
SIM,1861,77,na,1938,656
STAT,1858,48,50-100,1906,0.17985558451829217
STAT,1895,39,15-19,1934,0.06853058949592584
SIM,1832,37,na,1869,1643
STAT,1897,28,30-34,1925,31.70320958838397
STAT,1903,16,15-19,1919,7.995822171694172
STAT,1825,48,35-39,1873,0.14479001460523547
STAT,1852,17,45-49,1869,0.06002588574110902
STAT,1930,16,20-24,1946,165.9992588170358
STAT,1805,97,na,1902,1.7987796634067548
SIM,1858,26,30-34,1884,26
STAT,1860,106,na,1966,0.06851395559223478
STAT,1904,28,25-29,1932,57.10920813659857
STAT,1886,37,45-49,1923,1.9897472276225352
SIM,1866,48,50-100,1914,4
STAT,1954,6,na,1960,4590.912922808692
SIM,1914,22,15-19,1936,8
STAT,1832,37,25-29,1869,2.207216321083955
STAT,1844,48,45-49,1892,0.16359246494732305
STAT,1869,29,45-49,1898,1.008045473365089
SIM,1896,20,na,1916,3017
SIM,1861,35,40-44,1896,7
SIM,1944,20,35-39,1964,15
STAT,1864,54,na,1918,1767.950434363621
STAT,1911,17,na,1928,3650.355940321544
SIM,1863,36,na,1899,2025
SIM,1901,30,40-44,1931,8
SIM,1827,46,45-49,1873,1
STAT,1826,37,na,1863,1548.7992022512103
SIM,1862,29,25-29,1891,38
STAT,1854,29,25-29,1883,31.476155230969685
STAT,1823,52,20-24,1875,8.468124501125569E-4
STAT,1879,20,na,1899,2349.2587456460687
SIM,1811,75,na,1886,374
STAT,1785,81,na,1866,198.8398163975486
STAT,1836,58,na,1894,1248.8311143288054
STAT,1832,44,na,1876,1506.808295314294
SIM,1865,100,na,1965,1
SIM,1842,26,40-44,1868,1
STAT,1855,46,30-34,1901,0.06875196848974291
STAT,1890,43,20-24,1933,0.1821082604386612
STAT,1936,20,35-39,1956,8.508557423506561
SIM,1882,39,na,1921,2112
SIM,1840,37,25-29,1877,1
STAT,1853,35,40-44,1888,3.314514555637858
STAT,1861,25,na,1886,1913.1476825562117
SIM,1797,81,na,1878,192
STAT,1834,31,15-19,1865,0.11409111203035198
STAT,1876,16,30-34,1892,1.5582474862315279
STAT,1897,27,30-34,1924,31.815199089177863
SIM,1812,60,na,1872,988
SIM,1912,28,25-29,1940,64
STAT,1871,51,35-39,1922,0.008101335245400978
STAT,1852,16,45-49,1868,0.06038153297030413
SIM,1888,29,20-24,1917,14
SIM,1944,6,na,1950,3991
SIM,1889,13,na,1902,3048
STAT,1880,39,na,1919,2318.2680370086296
SIM,1833,43,40-44,1876,4
STAT,1931,20,20-24,1951,137.05688000894637
STAT,1867,25,40-44,1892,2.675093035262912
STAT,1940,30,15-19,1970,0.12577077320937222
SIM,1883,36,30-34,1919,6
STAT,1855,19,15-19,1874,4.9404128776450404
SIM,1856,27,35-39,1883,7
STAT,1914,32,50-100,1946,0.7860841062107368
STAT,1923,26,30-34,1949,42.647483565747685
SIM,1826,41,na,1867,1543
SIM,1899,22,25-29,1921,78
STAT,1908,37,45-49,1945,0.6028307972811561
STAT,1825,40,25-29,1865,0.7499181424220905
STAT,1869,21,35-39,1890,5.352288070730205
STAT,1916,31,35-39,1947,8.94903698639291
STAT,1832,38,25-29,1870,2.183499941180208
STAT,1816,52,50-100,1868,0.03806835765819313
STAT,1855,43,50-100,1898,0.7428131350254827
STAT,1831,54,20-24,1885,4.5873660159910864E-4
SIM,1864,23,15-19,1887,3
STAT,1892,39,35-39,1931,8.283100806839792
STAT,1867,34,30-34,1901,15.354186134625376
STAT,1871,23,40-44,1894,1.9455471483148934
STAT,1824,39,40-44,1863,5.956058421754981
SIM,1838,36,30-34,1874,3
STAT,1811,82,na,1893,202.09978191324316
STAT,1899,67,na,1966,2304.5693538958762
STAT,1925,22,25-29,1947,104.46347427824519
SIM,1914,45,50-100,1959,3
STAT,1916,39,45-49,1955,0.6528491721875622
STAT,1841,16,30-34,1857,1.414807375038012
SIM,1897,26,30-34,1923,43
SIM,1909,50,na,1959,3142
STAT,1849,37,40-44,1886,3.228669383647109
SIM,1898,27,na,1925,3023
SIM,1869,39,50-100,1908,4
SIM,1875,34,30-34,1909,26
SIM,1877,21,35-39,1898,5
SIM,1933,22,25-29,1955,123
STAT,1880,28,15-19,1908,0.44939216091122725
STAT,1914,46,na,1960,3449.9548570039146
SIM,1869,27,45-49,1896,4
STAT,1830,25,45-49,1855,1.312864631786753
STAT,1910,32,na,1942,3444.0027416272587
SIM,1840,38,25-29,1878,1
STAT,1914,43,30-34,1957,0.11946400780719582
STAT,1895,53,na,1948,2611.876615185966
STAT,1875,36,30-34,1911,5.197453685976921
SIM,1814,56,na,1870,1117
STAT,1834,106,na,1940,0.007515176466168369
SIM,1832,39,40-44,1871,10
STAT,1889,26,30-34,1915,29.46973118091574
SIM,1877,30,25-29,1907,9
STAT,1888,49,25-29,1937,0.03550341367482617
STAT,1900,16,35-39,1916,0.7208986579663502
SIM,1785,96,na,1881,2
STAT,1894,47,20-24,1941,0.008187476260583025
STAT,1813,109,na,1922,3.008958489958649E-4
SIM,1878,50,na,1928,2212
STAT,1831,59,na,1890,1185.2508560480626
SIM,1781,82,na,1863,130
SIM,1809,56,na,1865,1129
STAT,1944,20,30-34,1964,29.335463969827376
SIM,1839,37,50-100,1876,4
STAT,1917,20,25-29,1937,93.29136824049417
SIM,1924,31,35-39,1955,12
STAT,1848,50,20-24,1898,5.392540151687033E-4
SIM,1880,91,na,1971,181
STAT,1871,37,25-29,1908,2.6964932639895536
STAT,1909,41,45-49,1950,0.14786728886942715
SIM,1825,30,na,1855,1625
SIM,1904,26,25-29,1930,68
STAT,1837,26,20-24,1863,9.574038030120478
SIM,1931,26,30-34,1957,55
SIM,1890,19,35-39,1909,3
STAT,1811,50,25-29,1861,0.011708017293803259
STAT,1840,37,20-24,1877,0.6349409669773668
STAT,1898,17,20-24,1915,22.671723457714506
SIM,1857,37,40-44,1894,3
SIM,1909,28,na,1937,3353
STAT,1915,27,35-39,1942,14.465215064292128
SIM,1929,24,25-29,1953,123
STAT,1867,30,15-19,1897,0.12733101867112356
SIM,1905,14,na,1919,3512
STAT,1881,32,15-19,1913,0.12989630208080694
STAT,1893,24,30-34,1917,21.216432569611513
STAT,1858,20,20-24,1878,59.48990987857417
SIM,1906,20,15-19,1926,4
SIM,1864,26,30-34,1890,29
STAT,1860,21,15-19,1881,2.6298970037206293
SIM,1834,33,30-34,1867,25
SIM,1929,27,na,1956,4492
STAT,1851,30,25-29,1881,7.981728563411312
STAT,1840,63,na,1903,1242.6192892283455
STAT,1810,97,na,1907,2.4328028810973468
STAT,1831,48,35-39,1879,0.10161820866012668
STAT,1889,28,35-39,1917,11.213663592040204
STAT,1824,102,na,1926,0.15477812474050448
SIM,1845,26,20-24,1871,9
STAT,1922,16,25-29,1938,47.4984036793327
STAT,1914,40,15-19,1954,0.0014473214923034277
STAT,1829,88,na,1917,84.14779059060625
STAT,1845,33,40-44,1878,3.5945351336470694
STAT,1853,46,20-24,1899,0.00892456107951952
STAT,1905,30,20-24,1935,3.719756807740584
STAT,1846,36,na,1882,1752.797554122361
STAT,1885,50,25-29,1935,0.0033815756534308016
SIM,1813,82,na,1895,166
SIM,1902,0,na,1902,3668
STAT,1806,48,25-29,1854,0.16763345356933865
STAT,1877,51,40-44,1928,0.010369812893215175
STAT,1913,39,30-34,1952,1.6816611859661386
STAT,1926,31,na,1957,4323.24371294241
SIM,1930,16,25-29,1946,52
STAT,1827,45,40-44,1872,0.15403722896298147
SIM,1897,28,35-39,1925,12
SIM,1910,47,na,1957,3164
SIM,1849,37,45-49,1886,1
STAT,1847,48,25-29,1895,0.041848904674226944
STAT,1830,50,35-39,1880,0.0063450524836679775
SIM,1866,20,20-24,1886,54
SIM,1942,27,45-49,1969,1
STAT,1880,19,25-29,1899,5.602512022483947
STAT,1856,26,30-34,1882,19.44657823749785
SIM,1867,87,na,1954,125
STAT,1861,19,15-19,1880,5.288129019053201
SIM,1826,108,na,1934,1
STAT,1825,43,40-44,1868,2.457360709166785
STAT,1872,30,45-49,1902,1.6667872608166245
SIM,1863,73,na,1936,945
STAT,1852,42,35-39,1894,1.3741123933777566
STAT,1879,9,na,1888,2594.5348893248356
STAT,1932,39,40-44,1971,1.896109481530506
SIM,1834,27,45-49,1861,1
STAT,1888,30,35-39,1918,11.39275485738168
STAT,1847,40,15-19,1887,0.010482985386536555
SIM,1846,88,na,1934,82
SIM,1856,25,30-34,1881,27
STAT,1883,68,na,1951,1414.9078483229375
SIM,1879,38,30-34,1917,12
SIM,1912,26,20-24,1938,21
STAT,1864,17,na,1881,2205.916827721108
STAT,1892,34,40-44,1926,5.086440914256692
STAT,1851,38,35-39,1889,5.188080719407647
SIM,1865,16,20-24,1881,14
STAT,1869,49,15-19,1918,3.5813731898227735E-4
SIM,1928,42,na,1970,4474
SIM,1899,71,na,1970,2105
SIM,1842,74,na,1916,721
STAT,1803,51,40-44,1854,0.030786077352428866
STAT,1863,91,na,1954,48.120654183298164
STAT,1830,36,25-29,1866,2.3161910098593417
STAT,1853,49,25-29,1902,0.04182472054683842
STAT,1934,27,45-49,1961,2.1954765388462163
SIM,1844,22,na,1866,1947
SIM,1848,36,na,1884,1807
SIM,1907,32,25-29,1939,12
STAT,1870,42,40-44,1912,2.0795226348077023
SIM,1880,30,45-49,1910,2
STAT,1826,33,30-34,1859,21.799950319764164
STAT,1893,18,45-49,1911,0.0780914634892039
STAT,1848,25,30-34,1873,21.972067705230305
STAT,1856,17,50-100,1873,0.04286183504271169
STAT,1904,26,20-24,1930,15.948585509812439
SIM,1913,30,20-24,1943,2
SIM,1868,8,na,1876,2471
STAT,1896,49,20-24,1945,0.008274857046506223
SIM,1896,30,35-39,1926,13
SIM,1919,37,25-29,1956,3
STAT,1841,32,20-24,1873,2.2438863979986383
STAT,1866,45,30-34,1911,0.08515229049909886
STAT,1868,53,40-44,1921,0.009343234445656087
SIM,1941,29,na,1970,3525
STAT,1923,34,30-34,1957,17.042292571222774
SIM,1944,21,35-39,1965,15
STAT,1880,46,50-100,1926,0.24481913140270897
STAT,1883,89,na,1972,304.9307533706643
STAT,1921,26,20-24,1947,19.286510247186797
SIM,1893,18,na,1911,3145
STAT,1906,37,35-39,1943,2.100043253987773
STAT,1884,36,35-39,1920,6.634633017328987
STAT,1886,44,45-49,1930,1.4736687716270342
STAT,1860,19,45-49,1879,0.057161949551995536
SIM,1871,40,45-49,1911,2
STAT,1864,32,15-19,1896,0.12023633188928283
SIM,1923,15,40-44,1938,2
STAT,1766,116,na,1882,1.0957031654466652E-4
STAT,1869,17,50-100,1886,0.04542034503299151
SIM,1874,41,25-29,1915,4
SIM,1881,22,15-19,1903,6
STAT,1901,28,45-49,1929,1.4629714828003
SIM,1793,83,na,1876,101
SIM,1802,61,na,1863,938
STAT,1913,18,25-29,1931,8.346367464472456
STAT,1835,21,40-44,1856,1.74075976474974
SIM,1876,48,na,1924,2218
STAT,1886,22,25-29,1908,57.13822755629758
STAT,1885,15,45-49,1900,0.06176583932987512
SIM,1840,34,20-24,1874,2
STAT,1908,50,na,1958,3109.701548701293
STAT,1936,21,35-39,1957,8.505494342834098
STAT,1856,51,na,1907,1600.738287250513
STAT,1891,26,25-29,1917,49.63308104118244
STAT,1941,29,40-44,1970,4.550161436254521
STAT,1824,35,25-29,1859,4.748710278683435
SIM,1843,21,40-44,1864,2
STAT,1812,45,na,1857,1350.3052422807955
STAT,1863,40,45-49,1903,1.255370940230192
STAT,1855,104,na,1959,0.10102446820597183
SIM,1861,72,na,1933,1022
STAT,1819,53,45-49,1872,0.024296554541766595
STAT,1796,81,na,1877,222.60236216602192
STAT,1817,45,35-39,1862,0.3233079629317867
STAT,1882,20,15-19,1902,3.0507224568084603
STAT,1869,40,50-100,1909,0.9758063553815761
SIM,1919,26,30-34,1945,44
SIM,1809,93,na,1902,13
SIM,1876,40,35-39,1916,5
SIM,1952,17,15-19,1969,38
SIM,1834,23,40-44,1857,4
SIM,1921,18,25-29,1939,56
STAT,1814,53,50-100,1867,0.038413043280450906
STAT,1854,1,na,1855,2734.5378832795545
STAT,1935,37,50-100,1972,0.5545923941999685
STAT,1801,83,na,1884,142.2755955465176
STAT,1826,53,na,1879,1265.1729485692479
STAT,1889,68,na,1957,1835.6084437415568
SIM,1832,35,25-29,1867,2
SIM,1931,21,25-29,1952,120
SIM,1768,94,na,1862,3
STAT,1826,52,35-39,1878,0.007767996456167131
STAT,1836,50,40-44,1886,0.006998411554403601
STAT,1864,70,na,1934,1184.6306536624613
STAT,1851,20,na,1871,1899.5875109635595
STAT,1910,26,45-49,1936,1.5809433379710827
SIM,1888,33,na,1921,2587
STAT,1944,17,15-19,1961,46.13718206044282
STAT,1818,105,na,1923,0.014136185120848924
STAT,1850,62,na,1912,1286.7269572491368
STAT,1875,30,25-29,1905,10.020742810416309
SIM,1883,30,25-29,1913,12
SIM,1892,36,35-39,1928,18
STAT,1912,24,50-100,1936,0.6167699012647616
SIM,1842,42,30-34,1884,1
SIM,1909,33,35-39,1942,6
STAT,1877,46,45-49,1923,0.2320116660733455
STAT,1866,41,25-29,1907,0.5618424879947345
STAT,1938,28,40-44,1966,4.359724322683671
SIM,1886,28,20-24,1914,14
STAT,1927,23,35-39,1950,10.926657763976557
STAT,1859,51,35-39,1910,0.006521635997034384
STAT,1839,37,50-100,1876,0.9782666591152751
SIM,1918,27,na,1945,3721
STAT,1815,42,20-24,1857,0.4481684003967293
SIM,1890,20,15-19,1910,3
SIM,1922,32,na,1954,4038
SIM,1851,78,na,1929,499
SIM,1853,29,20-24,1882,11
STAT,1924,41,50-100,1965,0.13221289249386878
STAT,1845,21,25-29,1866,50.4200973048444
STAT,1827,30,50-100,1857,1.166186050116635
STAT,1932,27,35-39,1959,18.577451532767434
STAT,1869,26,40-44,1895,2.748654245922652
SIM,1793,61,na,1854,836
SIM,1953,14,na,1967,4359
STAT,1838,42,15-19,1880,0.011015102647659133
STAT,1929,12,na,1941,4777.29329135923
STAT,1834,42,30-34,1876,0.8579068291725299
STAT,1867,32,40-44,1899,3.846669624056318
STAT,1901,18,50-100,1919,0.06461159499203889
SIM,1922,23,25-29,1945,126
STAT,1832,34,20-24,1866,2.0930831587857486
SIM,1851,35,35-39,1886,11
STAT,1914,36,30-34,1950,1.7270558093804307
STAT,1895,20,25-29,1915,70.99345282428129
SIM,1834,21,15-19,1855,3
SIM,1935,23,35-39,1958,13
STAT,1770,108,na,1878,0.00360647320411352
SIM,1940,27,35-39,1967,20
STAT,1934,29,na,1963,4755.956010192881
STAT,1851,41,50-100,1892,0.778218928903491
STAT,1922,42,15-19,1964,0.0016652889374409495
STAT,1878,28,20-24,1906,11.496714008060668
SIM,1801,53,50-100,1854,1
STAT,1909,29,15-19,1938,0.632640039223972
SIM,1837,24,20-24,1861,47
STAT,1845,29,20-24,1874,9.91413591653557
SIM,1848,90,na,1938,41
STAT,1860,112,na,1972,4.3004740914726416E-4
SIM,1901,64,na,1965,2483
SIM,1905,31,25-29,1936,10
STAT,1892,31,25-29,1923,12.16658845076209
SIM,1826,89,na,1915,90
STAT,1826,43,na,1869,1460.360067212155
SIM,1853,21,25-29,1874,67
SIM,1901,54,na,1955,2775
SIM,1922,36,30-34,1958,2
SIM,1869,24,40-44,1893,2
STAT,1882,33,20-24,1915,2.4743011398876606
STAT,1896,15,20-24,1911,22.237483263603714
STAT,1891,6,na,1897,3054.6469583450917
STAT,1870,30,35-39,1900,9.449668131223966
STAT,1851,42,na,1893,1692.7834433413555
SIM,1903,23,15-19,1926,3
STAT,1845,43,45-49,1888,1.0598510484814683
STAT,1855,20,40-44,1875,1.7491635661006768
STAT,1880,29,15-19,1909,0.4477563734455103
SIM,1853,43,45-49,1896,1
STAT,1801,53,50-100,1854,0.05341430361617995
STAT,1865,24,30-34,1889,15.255287749129543
SIM,1873,24,30-34,1897,19
STAT,1933,39,45-49,1972,0.8753341371767276
STAT,1864,92,na,1956,39.97398154483902
SIM,1890,33,20-24,1923,3
SIM,1924,44,40-44,1968,1
STAT,1902,39,30-34,1941,1.5181422637167659
STAT,1871,30,40-44,1901,4.094170543986096
STAT,1821,34,45-49,1855,4.741992186854634
STAT,1916,44,40-44,1960,0.24133182468945083
SIM,1910,39,30-34,1949,3
STAT,1831,33,50-100,1864,0.7424661531599744
STAT,1865,36,25-29,1901,2.483528043301493
SIM,1929,26,15-19,1955,5
SIM,1868,32,25-29,1900,11
SIM,1858,35,45-49,1893,2
STAT,1841,19,35-39,1860,0.47850898216339866
STAT,1937,16,30-34,1953,11.227847741041117
STAT,1899,35,40-44,1934,5.720995949849895
STAT,1901,12,na,1913,3414.8181235359843
SIM,1897,29,35-39,1926,14
STAT,1855,40,na,1895,1653.4219963681503
STAT,1946,24,na,1970,3836.4792263745126
SIM,1884,35,na,1919,2337
STAT,1918,49,20-24,1967,0.011044328445613628
STAT,1894,30,35-39,1924,12.40553814463531
STAT,1867,35,na,1902,2109.59952014668
SIM,1905,20,na,1925,3246
STAT,1826,59,na,1885,1123.4688922277824
STAT,1909,15,40-44,1924,0.2602589121240355
SIM,1851,56,na,1907,1504
SIM,1873,33,20-24,1906,5
STAT,1912,0,na,1912,4288.544129926739
STAT,1871,33,45-49,1904,1.6262732985650767
STAT,1801,61,na,1862,968.6808980514182
STAT,1889,46,na,1935,2631.376125039564
STAT,1871,40,na,1911,2186.417822557624
STAT,1888,46,20-24,1934,0.013430145094812503
STAT,1867,53,35-39,1920,0.007513631629377852
STAT,1914,23,25-29,1937,88.85901268101289
STAT,1843,35,35-39,1878,6.082070532890918
SIM,1955,16,15-19,1971,48
SIM,1813,45,na,1858,1349
STAT,1849,53,30-34,1902,0.0042216538119796325
SIM,1950,21,35-39,1971,16
STAT,1839,34,30-34,1873,14.031942117603464
SIM,1804,78,na,1882,280
SIM,1863,20,40-44,1883,4
SIM,1842,29,45-49,1871,4
SIM,1870,35,45-49,1905,2
STAT,1940,29,35-39,1969,14.447233173001145
SIM,1898,33,na,1931,2983
STAT,1819,39,20-24,1858,1.701624051062551
STAT,1874,70,na,1944,1354.7123858418872
SIM,1890,40,50-100,1930,3
STAT,1937,27,25-29,1964,60.60414230029967
SIM,1783,83,na,1866,104
STAT,1851,37,35-39,1888,5.24223298615462
SIM,1845,27,20-24,1872,12
STAT,1843,55,na,1898,1491.763091050787
STAT,1835,50,35-39,1885,0.005695321411254101
SIM,1821,74,na,1895,621
STAT,1835,95,na,1930,8.295482201974087
SIM,1818,76,na,1894,362
SIM,1884,22,40-44,1906,4
STAT,1889,29,35-39,1918,11.17284585656518
STAT,1834,29,45-49,1863,0.888305229913109
SIM,1902,18,15-19,1920,11
STAT,1924,46,40-44,1970,0.17777670285160038
STAT,1860,35,35-39,1895,5.481876132355712
SIM,1856,24,30-34,1880,13
SIM,1905,20,45-49,1925,6
STAT,1894,43,40-44,1937,0.18843936448906598
STAT,1928,29,25-29,1957,76.53685126105894
STAT,1938,26,15-19,1964,0.6609302638720446
STAT,1874,40,20-24,1914,0.15488623562102405
STAT,1782,79,na,1861,240.53028994402024
SIM,1813,55,na,1868,1134
STAT,1866,18,na,1884,2244.591644363649
SIM,1936,29,25-29,1965,55
STAT,1819,105,na,1924,0.014642361630940303
STAT,1954,16,30-34,1970,14.238345099482821
STAT,1827,52,40-44,1879,0.008904084179257159
STAT,1923,21,25-29,1944,101.84713598489361
SIM,1878,25,20-24,1903,13
STAT,1850,25,25-29,1875,35.55418398141229
SIM,1862,36,50-100,1898,1
STAT,1794,96,na,1890,1.5428236954937231
STAT,1880,23,45-49,1903,0.6909947517321381
STAT,1946,14,na,1960,4114.488548853262
STAT,1876,51,35-39,1927,0.008436203267036516
SIM,1866,43,30-34,1909,1
STAT,1944,23,35-39,1967,9.600788574803769
SIM,1901,26,45-49,1927,1
STAT,1919,39,25-29,1958,0.9971437994329456
SIM,1883,43,30-34,1926,3
STAT,1928,26,30-34,1954,45.763793524089074
SIM,1838,74,na,1912,703
SIM,1897,25,30-34,1922,33
STAT,1830,32,45-49,1862,1.458936935233625
SIM,1934,25,50-100,1959,2
STAT,1887,31,50-100,1918,0.9719661433885995
SIM,1847,34,30-34,1881,13
STAT,1904,21,15-19,1925,4.483088095573927
SIM,1933,16,na,1949,4687
STAT,1901,18,na,1919,3330.826347355632
STAT,1843,50,50-100,1893,0.011052539513574664
STAT,1900,54,na,1954,2744.393324083784
STAT,1891,40,20-24,1931,0.18757493780162116
STAT,1899,47,35-39,1946,0.10176113608343379
SIM,1926,27,15-19,1953,3
STAT,1829,30,40-44,1859,4.465134497487598
SIM,1916,23,25-29,1939,90
STAT,1931,39,50-100,1970,0.5241837075016258
STAT,1947,16,15-19,1963,48.311521040450714
SIM,1894,22,25-29,1916,77
STAT,1841,26,na,1867,1851.6396935469834
STAT,1794,64,na,1858,784.7746120245013
STAT,1853,42,40-44,1895,1.6660269004481305
STAT,1837,27,20-24,1864,9.505296437064219
STAT,1908,23,25-29,1931,79.9550434295612
STAT,1838,26,50-100,1864,0.5590014372283599
STAT,1923,30,50-100,1953,0.9026929958586684
STAT,1896,21,40-44,1917,2.609557219996267
SIM,1812,49,50-100,1861,2
STAT,1844,72,na,1916,886.5638173707863
STAT,1819,89,na,1908,52.46236198428234
SIM,1882,39,50-100,1921,1
STAT,1828,49,15-19,1877,3.2813417359103255E-4
STAT,1808,52,30-34,1860,0.021649900289741526
STAT,1917,27,na,1944,3711.2142402530144
SIM,1900,29,20-24,1929,14
STAT,1840,35,50-100,1875,1.0325014517072681
SIM,1931,34,30-34,1965,23
STAT,1907,46,40-44,1953,0.1343695793960543
STAT,1828,60,na,1888,1117.8922465553928
STAT,1844,52,40-44,1896,0.007351163136121706
SIM,1856,28,35-39,1884,7
SIM,1861,40,na,1901,2021
STAT,1858,34,40-44,1892,3.1887012467769353
SIM,1827,31,25-29,1858,6
STAT,1814,58,na,1872,1042.7473273157798
SIM,1945,16,30-34,1961,19
STAT,1918,27,15-19,1945,0.7097221239367921
STAT,1921,32,na,1953,3976.405403226273
STAT,1850,94,na,1944,14.07024503037504
SIM,1893,41,35-39,1934,3
STAT,1885,41,35-39,1926,1.7120121107917499
STAT,1859,24,30-34,1883,13.733802671517116
SIM,1912,21,15-19,1933,3
STAT,1825,47,35-39,1872,0.1467971819305281
STAT,1894,15,na,1909,3083.4275461502048
SIM,1837,30,40-44,1867,7
STAT,1847,45,20-24,1892,0.008917490719433372
STAT,1875,43,30-34,1918,1.1077364668943375
SIM,1927,39,25-29,1966,1
STAT,1892,38,35-39,1930,8.32581222354659
SIM,1896,68,na,1964,2154
STAT,1889,25,30-34,1914,29.568193264486474
STAT,1818,50,35-39,1868,0.01835982047109762
STAT,1777,84,na,1861,95.22885461394745
SIM,1927,21,35-39,1948,11
STAT,1863,17,20-24,1880,16.799201925928426
SIM,1922,39,35-39,1961,11
STAT,1875,86,na,1961,345.8606324586246
SIM,1813,77,na,1890,322
STAT,1899,46,na,1945,2921.486879196673
STAT,1897,33,na,1930,3002.179164745954
STAT,1836,31,25-29,1867,8.261069706554078
SIM,1864,39,25-29,1903,2
SIM,1894,41,40-44,1935,1
SIM,1913,33,25-29,1946,13
STAT,1824,32,20-24,1856,6.260957882177307
STAT,1817,76,na,1893,420.1386694195564
STAT,1899,33,15-19,1932,0.18358488157015107
SIM,1934,29,15-19,1963,5
STAT,1852,21,40-44,1873,1.8943934203810409
STAT,1929,30,45-49,1959,1.8904898653652307
STAT,1913,15,20-24,1928,26.302094159449233
SIM,1921,37,40-44,1958,1
STAT,1918,39,50-100,1957,0.41716155501596497
STAT,1818,40,na,1858,1458.3396058083274
STAT,1836,21,na,1857,1794.7820872249106
STAT,1866,48,35-39,1914,0.12040630399136443
STAT,1896,32,na,1928,2979.3862095574705
SIM,1891,41,25-29,1932,3
STAT,1883,41,25-29,1924,0.5972422852222301
STAT,1807,50,50-100,1857,0.055664315987137586
STAT,1835,89,na,1924,65.54601985312087
STAT,1901,25,40-44,1926,3.9878677562284954
SIM,1831,58,na,1889,1199
SIM,1832,32,20-24,1864,1
STAT,1926,29,15-19,1955,0.7938467623930489
STAT,1956,16,40-44,1972,1.7487474848527376
STAT,1848,28,35-39,1876,8.238972923173531
STAT,1825,52,30-34,1877,0.006016589832616813
STAT,1862,110,na,1972,0.004091461742791805
SIM,1909,30,30-34,1939,20
SIM,1892,33,30-34,1925,23
STAT,1885,38,na,1923,2206.398794214384
STAT,1816,75,na,1891,479.72582360120566
STAT,1904,37,15-19,1941,0.01642109128482604
STAT,1843,19,45-49,1862,0.059518046366971944
SIM,1861,56,na,1917,1756
SIM,1854,24,20-24,1878,70
STAT,1914,39,35-39,1953,2.2580523632919336
SIM,1872,31,50-100,1903,6
STAT,1906,33,na,1939,3296.5834770691868
STAT,1854,39,15-19,1893,0.04002959957939834
STAT,1873,26,30-34,1899,24.22999995958914
STAT,1905,33,25-29,1938,7.9950117667641605
SIM,1844,31,25-29,1875,15
SIM,1901,48,na,1949,2964
SIM,1949,2,na,1951,4349
SIM,1868,35,na,1903,2154
SIM,1920,23,15-19,1943,5
SIM,1914,21,25-29,1935,107
SIM,1830,57,na,1887,1293
SIM,1870,32,50-100,1902,3
STAT,1837,50,45-49,1887,0.009566091966309446
SIM,1891,69,na,1960,1817
SIM,1911,20,45-49,1931,1
STAT,1874,54,50-100,1928,0.014181180499042404
SIM,1945,11,na,1956,3925
SIM,1818,86,na,1904,79
STAT,1851,26,na,1877,1870.8418766766886
STAT,1884,33,30-34,1917,16.230556471363236
SIM,1836,21,25-29,1857,50
STAT,1816,107,na,1923,0.002197618400787992
SIM,1828,34,20-24,1862,2
SIM,1860,21,40-44,1881,2
STAT,1849,40,25-29,1889,0.4709504355245847
SIM,1843,43,na,1886,1638
SIM,1888,71,na,1959,1569
SIM,1871,17,20-24,1888,21
SIM,1940,24,30-34,1964,37
SIM,1834,23,na,1857,1735
SIM,1878,31,40-44,1909,2
STAT,1870,39,na,1909,2158.906841065368
STAT,1854,15,40-44,1869,0.15942602424745342
STAT,1924,16,35-39,1940,4.732594611632314
STAT,1900,28,40-44,1928,3.912135314315601
SIM,1927,3,na,1930,4665
STAT,1912,23,15-19,1935,4.80336391370282
SIM,1868,29,na,1897,2153
SIM,1905,27,40-44,1932,4
SIM,1848,74,na,1922,777
STAT,1897,47,25-29,1944,0.040858500422472833
SIM,1932,16,35-39,1948,6
STAT,1891,23,20-24,1914,80.3308508556775
STAT,1864,103,na,1967,0.8036868878648028
STAT,1897,20,35-39,1917,7.416624529759158
STAT,1856,30,15-19,1886,0.10889476570098021
STAT,1906,32,50-100,1938,0.7237192441716745
STAT,1908,20,20-24,1928,97.12459630729624
STAT,1852,91,na,1943,44.027148769664194
STAT,1863,109,na,1972,0.011500579416784989
STAT,1862,21,25-29,1883,47.56497918858004
STAT,1878,51,45-49,1929,0.014340557618022106
SIM,1873,41,na,1914,2228
SIM,1931,37,25-29,1968,4
STAT,1790,66,na,1856,718.38001944
STAT,1904,33,50-100,1937,0.7097756392373245
STAT,1868,31,30-34,1899,15.812621473225754
STAT,1869,30,25-29,1899,9.441501221451535
SIM,1849,34,40-44,1883,3
STAT,1906,21,25-29,1927,78.98532782154452
STAT,1854,92,na,1946,29.991502439388558
STAT,1832,42,20-24,1874,0.11781475965683134
STAT,1893,40,30-34,1933,1.3919153823649744
STAT,1834,78,na,1912,483.6108663605461
SIM,1916,20,20-24,1936,106
STAT,1846,24,20-24,1870,59.09344239307198
STAT,1825,101,na,1926,0.3226272260273861
STAT,1817,92,na,1909,18.469982908223088
SIM,1895,25,20-24,1920,16
SIM,1829,60,na,1889,1041
STAT,1821,38,na,1859,1521.6651006349289
SIM,1908,27,na,1935,3269
SIM,1883,24,na,1907,2247
STAT,1933,36,40-44,1969,1.928003798683488
SIM,1833,75,na,1908,605
SIM,1836,43,45-49,1879,7
STAT,1887,25,20-24,1912,12.478324080417984
SIM,1864,8,na,1872,2478
STAT,1816,50,25-29,1866,0.009292573384600402
STAT,1903,20,45-49,1923,0.942815251272066
STAT,1923,17,40-44,1940,1.5517253494110483
SIM,1898,30,45-49,1928,1
STAT,1876,25,50-100,1901,0.6280959497212001
STAT,1913,37,40-44,1950,1.3952924837053589
SIM,1926,19,15-19,1945,53
SIM,1947,24,na,1971,3716
SIM,1876,86,na,1962,356
SIM,1906,26,35-39,1932,16
STAT,1836,53,45-49,1889,0.0090908468152122
SIM,1836,89,na,1925,55
SIM,1903,13,na,1916,3445
STAT,1895,16,40-44,1911,0.22603664111698002
SIM,1931,17,40-44,1948,1
STAT,1907,6,na,1913,3624.559655780135
SIM,1851,32,30-34,1883,21
STAT,1895,34,45-49,1929,2.131378038217438
STAT,1893,67,na,1960,2022.2156591400558
STAT,1836,37,na,1873,1660.11632658347
STAT,1903,38,20-24,1941,0.22251234746471357
SIM,1848,52,na,1900,1573
STAT,1885,16,na,1901,2382.886432734667
SIM,1886,20,25-29,1906,63
STAT,1765,99,na,1864,0.3127315893724187
STAT,1850,42,25-29,1892,0.4515234551353517
STAT,1923,37,25-29,1960,1.0778499597306834
SIM,1812,42,45-49,1854,3
STAT,1869,8,na,1877,2501.7907925372347
STAT,1927,20,30-34,1947,33.65564641097659
SIM,1843,21,na,1864,1910
STAT,1862,35,45-49,1897,1.621683437228937
SIM,1834,31,40-44,1865,2
SIM,1870,21,25-29,1891,49
SIM,1937,24,na,1961,3216
STAT,1938,32,25-29,1970,8.77847627930445
STAT,1931,23,25-29,1954,112.82815280656402
STAT,1865,19,50-100,1884,0.04282976448845831
STAT,1893,22,40-44,1915,2.4976866462086584
STAT,1901,41,50-100,1942,0.09744479053551924
STAT,1851,42,30-34,1893,0.8420326540334135
SIM,1928,27,25-29,1955,80
SIM,1825,29,45-49,1854,4
SIM,1921,15,20-24,1936,133
STAT,1849,32,50-100,1881,0.6959193438575265
STAT,1826,31,40-44,1857,6.1041554493262185
STAT,1835,73,na,1908,741.0742446512282
SIM,1935,20,30-34,1955,49
STAT,1906,11,na,1917,3557.824106484188
STAT,1874,18,35-39,1892,0.5284079138226182
SIM,1938,26,40-44,1964,7
SIM,1857,32,50-100,1889,3
SIM,1881,70,na,1951,1164
STAT,1834,49,15-19,1883,2.559393451325427E-4
SIM,1863,43,50-100,1906,1
STAT,1843,32,30-34,1875,15.14330018420417
STAT,1848,22,na,1870,1875.5430336992913
STAT,1884,69,na,1953,1370.0100410583543
SIM,1892,38,na,1930,2824
STAT,1914,20,20-24,1934,103.57988805307174
STAT,1867,50,30-34,1917,0.005355788856127767
SIM,1873,36,25-29,1909,2
STAT,1823,88,na,1911,72.24385531363731
SIM,1894,67,na,1961,2206
STAT,1845,40,40-44,1885,1.6552451770462695
STAT,1940,26,30-34,1966,37.75892502179338
STAT,1922,29,30-34,1951,41.58893950809623
SIM,1891,53,na,1944,2554
STAT,1910,37,15-19,1947,0.017345117907180987
STAT,1870,88,na,1958,173.25578695134283
SIM,1936,26,20-24,1962,14
STAT,1897,31,15-19,1928,0.18065531057349873
STAT,1901,33,40-44,1934,5.710184550623743
STAT,1927,34,15-19,1961,0.14915723493930302
STAT,1769,97,na,1866,0.7718817129431447
SIM,1930,29,30-34,1959,55
STAT,1877,30,35-39,1907,10.00753528953586
STAT,1847,36,30-34,1883,4.111139772851647
SIM,1885,30,35-39,1915,16
STAT,1860,39,15-19,1899,0.042679292754364426
SIM,1908,21,25-29,1929,84
STAT,1851,54,50-100,1905,0.010770536656774795
SIM,1928,33,50-100,1961,3
STAT,1925,37,45-49,1962,0.7730563679267606
SIM,1817,75,na,1892,505
STAT,1872,20,40-44,1892,1.9876615242310574
STAT,1876,20,15-19,1896,3.2365877796492573
STAT,1851,10,na,1861,2155.077146220659
SIM,1897,32,na,1929,3010
STAT,1858,32,15-19,1890,0.10561374832922925
STAT,1919,32,15-19,1951,0.1309737540605384
SIM,1948,6,na,1954,4027
STAT,1905,42,15-19,1947,0.001307548911782983
SIM,1825,40,na,1865,1473
SIM,1888,65,na,1953,1818
SIM,1904,15,30-34,1919,3
STAT,1862,37,50-100,1899,0.9893615669415634
STAT,1917,17,40-44,1934,0.2843330033313114
SIM,1840,88,na,1928,70
SIM,1858,22,15-19,1880,2
SIM,1879,48,50-100,1927,3
SIM,1853,40,40-44,1893,7
STAT,1879,43,15-19,1922,0.01353776342529232
SIM,1862,33,45-49,1895,1
SIM,1922,20,20-24,1942,122
STAT,1839,43,20-24,1882,0.11018488914787836
STAT,1825,44,30-34,1869,1.2287208086082668
STAT,1869,91,na,1960,94.056646159217
SIM,1886,2,na,1888,2865
STAT,1839,37,35-39,1876,5.635710884324127
STAT,1882,73,na,1955,1091.8417147879918
STAT,1851,34,30-34,1885,13.052250218065458
SIM,1836,25,40-44,1861,4
SIM,1870,39,25-29,1909,5
STAT,1842,43,na,1885,1681.1468068033034
SIM,1818,92,na,1910,14
STAT,1918,19,15-19,1937,46.41373129418246
STAT,1765,116,na,1881,1.083111988579429E-4
SIM,1855,36,30-34,1891,6
STAT,1899,38,45-49,1937,0.5542789445772895
STAT,1921,39,40-44,1960,1.5758357219641137
STAT,1915,39,40-44,1954,1.4141139959559574
STAT,1821,44,na,1865,1445.7361993684308
SIM,1863,41,na,1904,2009
SIM,1923,39,40-44,1962,1
STAT,1938,21,45-49,1959,1.0522200544354967
SIM,1851,21,15-19,1872,1
STAT,1762,103,na,1865,0.009709118591739157
STAT,1842,40,25-29,1882,0.48539361865730335
SIM,1933,37,45-49,1970,3
SIM,1871,39,na,1910,2254
SIM,1883,18,na,1901,2398
STAT,1919,48,15-19,1967,3.7640138684076293E-4
SIM,1946,21,45-49,1967,2
STAT,1821,38,50-100,1859,2.4086951446747875
STAT,1812,94,na,1906,8.595978668937112
STAT,1845,34,50-100,1879,0.7515951794790181
STAT,1854,33,45-49,1887,1.272645646372773
STAT,1833,23,na,1856,1728.5796429540442
STAT,1899,44,30-34,1943,0.10196077126308546
SIM,1849,42,40-44,1891,6
SIM,1878,71,na,1949,1303
SIM,1888,28,30-34,1916,29
STAT,1905,16,25-29,1921,7.754964722268119
SIM,1901,23,40-44,1924,3
SIM,1847,37,50-100,1884,3
SIM,1861,42,40-44,1903,4
STAT,1891,43,25-29,1934,0.7454543591155872
STAT,1825,95,na,1920,7.517219258708581
STAT,1889,38,50-100,1927,1.4247798796457782
STAT,1913,48,50-100,1961,0.20792454646401773
STAT,1862,39,25-29,1901,2.296814572663171
STAT,1847,74,na,1921,816.5698928307232
SIM,1842,95,na,1937,5
STAT,1875,4,na,1879,2822.393728748492
SIM,1833,44,30-34,1877,6
STAT,1858,46,35-39,1904,0.10412293362535416
SIM,1913,33,na,1946,3401
STAT,1947,24,15-19,1971,5.679914405305045
STAT,1843,21,15-19,1864,3.0091163811107773
STAT,1878,52,50-100,1930,0.014773767852936992
STAT,1884,47,na,1931,2090.5239459803956
STAT,1850,22,20-24,1872,58.22971529126824
SIM,1899,23,15-19,1922,2
SIM,1914,15,15-19,1929,9
STAT,1819,50,40-44,1869,0.018711765574673984
STAT,1830,58,na,1888,1185.287773183873
SIM,1825,62,na,1887,965
STAT,1907,49,45-49,1956,0.18182029548924333
STAT,1858,37,45-49,1895,1.4784287779625391
SIM,1871,92,na,1963,86
SIM,1926,31,45-49,1957,2
STAT,1943,18,20-24,1961,135.76743640627888
SIM,1879,30,35-39,1909,11
STAT,1794,80,na,1874,243.19020242503325
STAT,1843,52,35-39,1895,0.006177987510295756
SIM,1907,31,35-39,1938,10
STAT,1892,35,30-34,1927,6.364805341783845
STAT,1928,26,20-24,1954,21.31990517869915
SIM,1859,68,na,1927,1262
SIM,1898,17,na,1915,3181
SIM,1808,46,50-100,1854,3
STAT,1827,35,50-100,1862,1.2895833573995132
STAT,1882,29,25-29,1911,38.607661563190035
STAT,1844,56,na,1900,1431.8418039010792
STAT,1952,19,15-19,1971,51.34557723589994
SIM,1870,4,na,1874,2591
STAT,1828,36,20-24,1864,0.7485823052604772
SIM,1820,41,40-44,1861,6
SIM,1839,91,na,1930,38
STAT,1886,41,40-44,1927,2.2552148893288244
SIM,1823,38,25-29,1861,6
STAT,1873,35,20-24,1908,0.7461934366797595
STAT,1806,55,na,1861,1067.2364625003731
SIM,1908,49,na,1957,3030
STAT,1824,52,25-29,1876,0.004007725306207138
SIM,1849,20,20-24,1869,57
STAT,1871,19,20-24,1890,16.514498622767185
STAT,1928,29,35-39,1957,17.458009350711468
SIM,1904,39,30-34,1943,1
STAT,1836,45,45-49,1881,0.16001221607275842
SIM,1913,16,25-29,1929,10
SIM,1845,60,na,1905,1340
SIM,1877,26,40-44,1903,5
STAT,1915,15,40-44,1930,0.2778118879643588
STAT,1864,21,45-49,1885,0.6025501048565803
SIM,1921,48,50-100,1969,4
STAT,1906,15,15-19,1921,8.20155118868972
STAT,1918,31,45-49,1949,1.586078430901845
STAT,1890,22,15-19,1912,3.8104618724790678
STAT,1919,21,35-39,1940,9.769736860892092
SIM,1890,29,25-29,1919,53
STAT,1945,22,15-19,1967,5.511456712947634
STAT,1825,36,50-100,1861,1.6371263143239538
SIM,1914,37,35-39,1951,8
STAT,1913,2,na,1915,3936.4903382127086
STAT,1860,38,50-100,1898,0.9379360309385747
SIM,1836,73,na,1909,737
SIM,1936,29,35-39,1965,16
STAT,1823,31,15-19,1854,0.4454744826408485
STAT,1930,27,15-19,1957,0.8480491029909563
STAT,1853,86,na,1939,164.545115774365
SIM,1877,49,na,1926,2172
STAT,1882,50,20-24,1932,6.88080370042506E-4
STAT,1852,24,45-49,1876,0.6203788077374601
SIM,1918,38,30-34,1956,5
SIM,1843,27,na,1870,1870
STAT,1897,17,na,1914,3190.889594472569
SIM,1843,35,50-100,1878,2
STAT,1907,29,40-44,1936,4.091807630725173
SIM,1836,36,20-24,1872,4
STAT,1846,17,20-24,1863,15.702397885266771
STAT,1897,35,30-34,1932,6.797419052732523
STAT,1899,31,25-29,1930,13.314403162975088
SIM,1899,29,45-49,1928,3
STAT,1851,52,35-39,1903,0.006279556392037695
STAT,1916,26,na,1942,3671.603851863723
SIM,1858,67,na,1925,1276
STAT,1876,34,na,1910,2307.337640229455
SIM,1937,31,20-24,1968,2
SIM,1908,25,40-44,1933,4
SIM,1873,20,15-19,1893,3
STAT,1773,106,na,1879,0.008868747748542967
SIM,1846,31,45-49,1877,2
SIM,1904,15,20-24,1919,27
STAT,1834,33,40-44,1867,3.402986797243844
STAT,1871,15,40-44,1886,0.17445195046337528
SIM,1904,37,40-44,1941,3
STAT,1861,19,na,1880,2045.4109339944423
SIM,1877,41,40-44,1918,6
STAT,1839,30,15-19,1869,0.11930326921323162
STAT,1931,39,35-39,1970,3.019777683544853
SIM,1923,11,na,1934,4306
STAT,1811,44,na,1855,1328.0111599317347
SIM,1866,34,50-100,1900,5
SIM,1900,31,25-29,1931,18
STAT,1827,54,na,1881,1247.0787317793952
SIM,1938,15,25-29,1953,45
STAT,1864,49,na,1913,1859.90331918959
STAT,1840,44,20-24,1884,0.11245330124288463
SIM,1877,40,50-100,1917,1
STAT,1924,42,25-29,1966,0.08024897469637787
SIM,1828,40,40-44,1868,4
SIM,1889,47,50-100,1936,1
STAT,1865,71,na,1936,1145.8526921274242
STAT,1902,48,20-24,1950,0.008910691448274496
SIM,1915,29,40-44,1944,6
SIM,1840,25,30-34,1865,28
STAT,1929,31,20-24,1960,2.928793213854818
STAT,1883,48,35-39,1931,0.12799269846540853
STAT,1920,38,20-24,1958,0.27239778261683834
SIM,1871,24,20-24,1895,62
SIM,1920,24,50-100,1944,3
SIM,1883,56,na,1939,1900
STAT,1853,20,30-34,1873,15.834416521364867
STAT,1842,19,50-100,1861,0.04427423951793374
SIM,1854,30,40-44,1884,4
STAT,1837,39,15-19,1876,0.04227261226269101
STAT,1859,111,na,1970,9.838998203373817E-4
STAT,1913,27,15-19,1940,0.6643619152131996
STAT,1917,28,20-24,1945,18.020038176813724
STAT,1941,15,na,1956,3583.177142312875
STAT,1797,82,na,1879,168.54622508760053
STAT,1944,21,45-49,1965,1.148021703400236
SIM,1923,3,na,1926,4377
STAT,1838,31,45-49,1869,1.493321287051594
STAT,1862,32,40-44,1894,3.4946902221765614
STAT,1876,0,na,1876,3570.998580144742
STAT,1919,36,30-34,1955,1.8513994035813122
SIM,1854,41,50-100,1895,1
SIM,1861,20,30-34,1881,25
STAT,1865,53,25-29,1918,0.0029918022082091127
STAT,1878,20,25-29,1898,56.63424925333434
STAT,1832,25,30-34,1857,21.296601676534987
SIM,1849,36,30-34,1885,4
SIM,1808,92,na,1900,11
STAT,1932,18,45-49,1950,0.6232594748538461
SIM,1849,15,na,1864,2087
SIM,1925,28,20-24,1953,20
SIM,1911,16,na,1927,3695
SIM,1918,20,30-34,1938,34
STAT,1907,16,35-39,1923,0.7631856569311554
SIM,1945,19,25-29,1964,48
STAT,1892,46,35-39,1938,0.09368925692347876
STAT,1826,75,na,1901,561.8980454879799
STAT,1924,30,na,1954,4187.632130292215
STAT,1815,69,na,1884,734.6290727926042
STAT,1817,49,15-19,1866,8.671009062821723E-4
STAT,1949,21,20-24,1970,122.62487106583801
STAT,1841,23,30-34,1864,15.327671740907517
STAT,1867,46,50-100,1913,0.21846582695767977
STAT,1869,37,20-24,1906,0.7048925849306255
STAT,1857,18,35-39,1875,0.47747742261804405
STAT,1880,20,40-44,1900,2.0836612705369784
STAT,1867,26,30-34,1893,22.413009694832226
STAT,1841,28,25-29,1869,35.68959762210272
STAT,1867,19,na,1886,2263.271876298278
STAT,1945,13,na,1958,4052.995496557075
SIM,1929,39,45-49,1968,3
STAT,1916,11,na,1927,3964.1283642643284
STAT,1940,15,15-19,1955,43.54962818105363
STAT,1856,46,25-29,1902,0.042738893534737574
SIM,1866,71,na,1937,1092
STAT,1826,34,45-49,1860,2.0602305611447678
STAT,1823,47,25-29,1870,0.06871066956959518
SIM,1845,17,na,1862,2047
SIM,1835,30,30-34,1865,22
SIM,1929,11,na,1940,4874
SIM,1858,57,na,1915,1653
STAT,1947,22,25-29,1969,98.62655933152129
SIM,1927,36,30-34,1963,2
SIM,1858,52,na,1910,1725
SIM,1811,81,na,1892,215
SIM,1833,91,na,1924,25
SIM,1906,63,na,1969,2767
SIM,1911,48,na,1959,3316
STAT,1837,19,20-24,1856,15.013182465037428
STAT,1863,16,45-49,1879,0.062265040826029905
SIM,1931,30,na,1961,4657
STAT,1890,38,25-29,1928,3.309055787702907
STAT,1939,27,35-39,1966,14.256806377497272
STAT,1937,31,50-100,1968,0.773091662962889
STAT,1808,62,na,1870,962.7044841960753
SIM,1872,93,na,1965,78
STAT,1845,57,na,1902,1415.546589652187
STAT,1937,19,25-29,1956,39.70264766064048
SIM,1933,21,35-39,1954,11
STAT,1936,28,30-34,1964,35.40123613218677
STAT,1833,50,25-29,1883,0.0023109299343922083
STAT,1851,45,35-39,1896,0.10368782031964834
STAT,1929,36,15-19,1965,0.023312957193061024
STAT,1821,38,25-29,1859,5.648665557283928
SIM,1803,62,na,1865,851
STAT,1864,31,50-100,1895,0.7767573852231837
STAT,1930,29,40-44,1959,5.593689028539395
STAT,1954,16,20-24,1970,158.37241193914892
SIM,1922,27,40-44,1949,5
SIM,1845,19,20-24,1864,22
SIM,1934,15,40-44,1949,4
SIM,1896,37,30-34,1933,8
SIM,1834,34,45-49,1868,2
SIM,1866,86,na,1952,143
STAT,1914,27,40-44,1941,4.438145984366581
STAT,1910,20,50-100,1930,0.5870544618669988
SIM,1886,24,40-44,1910,3
STAT,1891,23,na,1914,2756.921946746908
STAT,1827,30,30-34,1857,22.222513170366305
SIM,1853,25,40-44,1878,2
SIM,1883,34,na,1917,2242
SIM,1929,21,45-49,1950,1
STAT,1865,20,15-19,1885,2.9080657648585646
STAT,1843,26,45-49,1869,0.9929449294912952
SIM,1845,34,20-24,1879,5
STAT,1905,49,35-39,1954,0.10555762757421937
SIM,1851,26,45-49,1877,1
STAT,1820,81,na,1901,288.0838658037032
STAT,1839,27,30-34,1866,21.152370798991843
STAT,1863,29,15-19,1892,0.374067972301696
STAT,1837,34,20-24,1871,2.0954602257418933
SIM,1847,27,30-34,1874,26
STAT,1894,21,30-34,1915,21.71119809245669
SIM,1782,77,na,1859,294
STAT,1860,23,40-44,1883,1.6373901435252982
STAT,1925,21,35-39,1946,10.6809050314053
SIM,1798,60,na,1858,960
STAT,1878,24,40-44,1902,2.036497919374903
STAT,1888,37,30-34,1925,5.9478629294177185
STAT,1845,25,40-44,1870,2.6055514051586735
STAT,1930,15,30-34,1945,14.956636138256338
STAT,1925,34,40-44,1959,4.384930913596323
SIM,1860,15,30-34,1875,3
SIM,1828,38,na,1866,1505
SIM,1828,54,na,1882,1188
STAT,1883,41,15-19,1924,0.01284392097012106
STAT,1901,36,45-49,1937,0.5716875072593751
STAT,1860,56,na,1916,1565.9487461874185
STAT,1913,18,35-39,1931,0.8081785076785336
SIM,1849,37,na,1886,1762
STAT,1927,30,35-39,1957,10.632756898867758
SIM,1866,39,35-39,1905,12
STAT,1949,15,35-39,1964,4.613167441796173
SIM,1881,28,20-24,1909,11
SIM,1919,29,25-29,1948,75
STAT,1878,35,20-24,1913,0.7652929882631536
SIM,1844,42,40-44,1886,6
SIM,1920,39,25-29,1959,3
SIM,1874,39,50-100,1913,4
STAT,1922,23,50-100,1945,0.7106860336970079
SIM,1803,77,na,1880,303
SIM,1887,32,45-49,1919,2
SIM,1868,19,na,1887,2316
SIM,1914,28,45-49,1942,2
SIM,1845,26,45-49,1871,6
STAT,1907,43,50-100,1950,0.10105232478897815
SIM,1881,26,30-34,1907,23
SIM,1934,16,45-49,1950,1
SIM,1890,36,25-29,1926,2
SIM,1908,48,50-100,1956,2
STAT,1894,47,50-100,1941,0.16757034083205088
STAT,1828,43,45-49,1871,1.2983518411067727
STAT,1865,17,30-34,1882,1.4099556512317775
STAT,1830,109,na,1939,4.2499153964429144E-4
STAT,1862,32,50-100,1894,0.7383453300903283
STAT,1867,99,na,1966,7.708104364116171
SIM,1954,17,25-29,1971,66
STAT,1931,15,na,1946,4572.54480346935
STAT,1882,40,50-100,1922,0.9809426601836074
STAT,1906,37,25-29,1943,0.8548714467840627
STAT,1872,41,na,1913,2201.438991940403
SIM,1933,34,40-44,1967,6
STAT,1893,25,45-49,1918,1.339855872159546
STAT,1856,34,30-34,1890,12.807738290013921
SIM,1926,1,na,1927,4631
STAT,1896,54,na,1950,2614.444408953512
SIM,1839,75,na,1914,694
SIM,1858,34,30-34,1892,17
STAT,1879,32,45-49,1911,1.7219059767515805
STAT,1954,1,na,1955,4598.3577025009035
STAT,1832,45,25-29,1877,0.04236163967693635
STAT,1882,36,25-29,1918,2.6594409302385227
SIM,1905,23,25-29,1928,83
STAT,1931,32,15-19,1963,0.15907407077241917
SIM,1859,15,na,1874,2243
SIM,1873,17,30-34,1890,2
SIM,1828,27,20-24,1855,9
SIM,1784,84,na,1868,67
SIM,1859,40,35-39,1899,2
STAT,1812,44,45-49,1856,5.156574081057526
STAT,1815,107,na,1922,0.0020184341147773165
STAT,1849,44,40-44,1893,1.5993734661126418
SIM,1895,18,20-24,1913,28
SIM,1858,28,45-49,1886,4
STAT,1950,1,na,1951,4561.870221424591
SIM,1937,17,25-29,1954,39
STAT,1840,48,50-100,1888,0.17028446019219726
STAT,1929,17,25-29,1946,52.249039982443904
STAT,1932,24,30-34,1956,35.50360490122673
SIM,1866,37,45-49,1903,2
SIM,1864,34,30-34,1898,21
SIM,1798,82,na,1880,158
SIM,1935,30,35-39,1965,17
STAT,1887,18,20-24,1905,18.68105884633885
STAT,1926,18,45-49,1944,0.5771396117375953
STAT,1846,30,40-44,1876,3.6892646219131615
SIM,1820,44,45-49,1864,2
STAT,1902,17,20-24,1919,23.634758881333184
SIM,1892,20,25-29,1912,68
STAT,1866,31,20-24,1897,2.363955826364515
STAT,1785,97,na,1882,0.9542082700547763
STAT,1940,17,40-44,1957,1.3414897608064085
SIM,1929,32,25-29,1961,13
STAT,1879,16,50-100,1895,0.048494965421270055
STAT,1893,16,30-34,1909,1.9151295099294612
STAT,1817,42,30-34,1859,2.906787881865495
STAT,1892,31,15-19,1923,0.1691577166038626
STAT,1921,17,30-34,1938,13.12633921196143
STAT,1874,51,25-29,1925,0.0034362881696512427
SIM,1910,17,20-24,1927,21
SIM,1825,36,45-49,1861,2
STAT,1764,98,na,1862,0.3945146108602272
STAT,1916,48,na,1964,3549.7193209377783
STAT,1926,25,50-100,1951,1.1349800475681135
STAT,1928,11,na,1939,4723.958426304235
STAT,1945,26,30-34,1971,40.62783758943024
STAT,1842,47,35-39,1889,0.09971242049362312
SIM,1848,89,na,1937,59
STAT,1906,28,45-49,1934,1.5219667864370339
STAT,1884,27,45-49,1911,1.0365120653592033
STAT,1876,18,45-49,1894,0.06353921551899383
STAT,1836,49,25-29,1885,0.037102859193123915
STAT,1927,17,15-19,1944,53.313735426304085
SIM,1892,27,45-49,1919,1
STAT,1873,22,15-19,1895,3.1634616129438715
SIM,1862,19,na,1881,2256
SIM,1895,31,40-44,1926,7
STAT,1863,27,25-29,1890,35.12767448741088
STAT,1827,38,na,1865,1543.5419067453213
SIM,1918,17,15-19,1935,38
SIM,1815,62,na,1877,918
STAT,1856,39,25-29,1895,2.1088601570059833
STAT,1880,60,na,1940,1895.7335875722667
STAT,1912,39,25-29,1951,0.8984971803805846
STAT,1852,15,30-34,1867,1.482038913213204
STAT,1910,16,na,1926,3623.170634421942
STAT,1835,57,na,1892,1253.8686102386664
SIM,1848,6,na,1854,2298
STAT,1884,20,25-29,1904,53.75991198004933
SIM,1938,28,30-34,1966,38
SIM,1854,17,20-24,1871,18
STAT,1842,40,15-19,1882,0.010438573141410643
STAT,1887,31,40-44,1918,4.600449734233777
SIM,1876,31,30-34,1907,22
SIM,1935,17,15-19,1952,54
SIM,1931,30,50-100,1961,1
STAT,1946,17,25-29,1963,45.407698145057346
SIM,1835,39,na,1874,1617
STAT,1865,93,na,1958,36.85531381377184
STAT,1915,9,na,1924,3922.768590947739
SIM,1839,28,35-39,1867,7
SIM,1949,22,25-29,1971,102
SIM,1809,72,na,1881,565
STAT,1869,44,45-49,1913,1.3501095468353201
SIM,1908,26,45-49,1934,2
STAT,1857,51,25-29,1908,0.0026505382771094504
STAT,1929,38,40-44,1967,1.813863119728501
SIM,1849,23,25-29,1872,45
STAT,1836,42,40-44,1878,1.6897318178865297
SIM,1871,27,25-29,1898,47
SIM,1919,15,15-19,1934,7
STAT,1837,26,45-49,1863,0.9061184376161607
STAT,1848,37,na,1885,1749.1024713623256
STAT,1892,16,50-100,1908,0.05810007018492415
STAT,1818,37,50-100,1855,4.160967162563976
STAT,1898,19,35-39,1917,0.6979409362224838
SIM,1923,33,na,1956,4005
STAT,1841,35,25-29,1876,2.3696602555370636
SIM,1942,9,na,1951,3746
STAT,1864,48,25-29,1912,0.04802123304034694
STAT,1839,23,na,1862,1818.6312042102759
SIM,1923,17,30-34,1940,14
STAT,1906,34,30-34,1940,13.672917286987865
STAT,1924,29,40-44,1953,5.090710959862197
SIM,1903,26,50-100,1929,3
SIM,1842,42,na,1884,1611
STAT,1871,29,25-29,1900,39.33396776625382
STAT,1865,50,20-24,1915,6.425662159349278E-4
STAT,1881,23,na,1904,2150.598894439373
SIM,1868,36,40-44,1904,6
STAT,1776,83,na,1859,106.12464308562933
STAT,1874,85,na,1959,362.39171587281186
SIM,1867,104,na,1971,1
SIM,1908,28,45-49,1936,2
STAT,1884,37,na,1921,2199.3982657137244
SIM,1933,26,na,1959,4732
SIM,1870,86,na,1956,164
STAT,1832,27,20-24,1859,9.63174911579439
STAT,1835,24,45-49,1859,0.5700666270238455
SIM,1835,24,na,1859,1733
STAT,1837,40,40-44,1877,1.7189875512278243
STAT,1883,45,30-34,1928,0.09051744867338264
SIM,1886,27,45-49,1913,1
SIM,1818,54,na,1872,1129
STAT,1900,16,25-29,1916,7.444995192108622
SIM,1885,39,45-49,1924,1
STAT,1816,54,30-34,1870,0.014415624006687024
STAT,1882,53,25-29,1935,0.003203717094779514
SIM,1937,34,25-29,1971,7
STAT,1850,18,25-29,1868,4.846257344381572
STAT,1877,39,45-49,1916,1.9345802175271594
STAT,1932,15,40-44,1947,1.7578406106997597
SIM,1837,68,na,1905,938
STAT,1817,38,35-39,1855,22.554797311694408
SIM,1856,93,na,1949,13
SIM,1789,83,na,1872,93
SIM,1940,15,40-44,1955,1
SIM,1867,24,30-34,1891,18
STAT,1927,38,30-34,1965,2.138754677353697
SIM,1897,18,30-34,1915,4
SIM,1936,26,30-34,1962,34
STAT,1914,52,na,1966,3383.492370188879
STAT,1940,22,15-19,1962,5.1222682065459155
STAT,1855,31,45-49,1886,1.2706503533342468
STAT,1905,25,15-19,1930,0.6235765215982567
STAT,1897,38,35-39,1935,8.891714922729667
STAT,1951,15,50-100,1966,0.42171494722038655
SIM,1914,34,30-34,1948,18
SIM,1837,17,20-24,1854,14
SIM,1824,61,na,1885,1009
STAT,1876,22,40-44,1898,2.032245818191194
SIM,1851,23,40-44,1874,1
SIM,1861,103,na,1964,1
STAT,1825,40,15-19,1865,0.016127272957147287
STAT,1916,47,45-49,1963,0.21058417948283223
SIM,1939,1,na,1940,3810
STAT,1832,49,40-44,1881,0.10884609699580365
STAT,1837,37,25-29,1874,2.2129145300885695
STAT,1861,49,50-100,1910,0.18864471764101964
STAT,1834,36,45-49,1870,1.5508931234654697
SIM,1871,48,50-100,1919,1
STAT,1933,32,25-29,1965,11.766865396948145
SIM,1863,31,45-49,1894,1
STAT,1823,44,20-24,1867,0.1944911182577893
SIM,1872,39,35-39,1911,13
STAT,1911,29,30-34,1940,35.832080505357496
STAT,1860,26,45-49,1886,0.8678105307442673
STAT,1854,32,50-100,1886,0.6756577615243401
STAT,1886,70,na,1956,1428.507636893325
STAT,1937,16,20-24,1953,124.88679795370284
STAT,1765,101,na,1866,0.11997473343947249
STAT,1884,29,35-39,1913,8.94327853532605
SIM,1931,37,35-39,1968,6
SIM,1871,6,na,1877,2646
STAT,1845,36,20-24,1881,0.5764499947875901
STAT,1879,47,30-34,1926,0.09513781072075084
STAT,1820,50,50-100,1870,0.024910027398894422
STAT,1931,36,30-34,1967,2.2823900720260712
STAT,1768,114,na,1882,1.781717327342967E-4
STAT,1890,35,20-24,1925,0.8988070625950716
STAT,1923,37,35-39,1960,2.647803415658089
SIM,1945,16,20-24,1961,139
STAT,1858,43,30-34,1901,0.8464688144626196
STAT,1863,48,50-100,1911,0.2013869422734285
STAT,1847,32,15-19,1879,0.12302736864118478
SIM,1867,34,na,1901,2043
STAT,1896,22,na,1918,2952.839361785541
SIM,1862,19,20-24,1881,13
SIM,1849,75,na,1924,698
STAT,1854,19,20-24,1873,15.092068909946407
SIM,1902,49,na,1951,2945
SIM,1840,27,20-24,1867,11
SIM,1888,35,30-34,1923,8
SIM,1880,20,40-44,1900,2
SIM,1842,36,45-49,1878,2
SIM,1919,33,na,1952,3850
STAT,1906,25,40-44,1931,4.1486811910136465
STAT,1885,48,na,1933,2090.8971925215
STAT,1832,44,50-100,1876,0.7636767631464612
STAT,1834,28,50-100,1862,0.5154912809366309
SIM,1918,34,50-100,1952,4
STAT,1843,23,40-44,1866,1.8734944738066641
STAT,1863,30,40-44,1893,3.630215794963017
SIM,1892,29,35-39,1921,13
STAT,1908,21,35-39,1929,8.200370960530373
SIM,1849,20,30-34,1869,26
SIM,1845,37,25-29,1882,1
SIM,1851,94,na,1945,11
SIM,1864,42,na,1906,2057
STAT,1901,40,40-44,1941,0.2086177230482128
STAT,1902,67,na,1969,2424.826798368292
SIM,1932,15,na,1947,4441
SIM,1929,36,40-44,1965,2
STAT,1877,43,40-44,1920,2.1890748425286723
SIM,1834,25,30-34,1859,32
SIM,1909,31,45-49,1940,1
SIM,1885,43,40-44,1928,2
SIM,1894,20,35-39,1914,10
STAT,1854,50,45-49,1904,0.010600480849001689
SIM,1844,42,50-100,1886,4
STAT,1878,27,45-49,1905,1.0919304087667827
STAT,1932,27,25-29,1959,81.44454595076766
STAT,1881,52,20-24,1933,6.695055271104563E-4
STAT,1908,48,15-19,1956,3.137704971961388E-4
STAT,1928,38,15-19,1966,0.022905899128718325
SIM,1838,90,na,1928,43
STAT,1937,10,na,1947,3651.96825935565
SIM,1843,53,na,1896,1510
SIM,1875,26,30-34,1901,24
STAT,1926,16,45-49,1942,0.5800768779955527
SIM,1844,38,45-49,1882,2
SIM,1876,33,50-100,1909,5
STAT,1862,21,35-39,1883,4.848659663932098
STAT,1858,15,na,1873,2012.2262155100564
SIM,1907,48,na,1955,3092
SIM,1870,21,35-39,1891,7
STAT,1841,42,na,1883,1643.2005843502416
STAT,1854,30,40-44,1884,3.2650896573813837
STAT,1844,30,30-34,1874,14.964758226163148
STAT,1886,20,35-39,1906,5.859286079329393
SIM,1825,38,35-39,1863,10
SIM,1881,60,na,1941,1604
STAT,1867,22,15-19,1889,2.938290761260751
STAT,1838,46,30-34,1884,0.06879828308843108
SIM,1862,32,50-100,1894,4
SIM,1914,34,na,1948,3825
STAT,1815,45,25-29,1860,0.14488213686718016
SIM,1836,29,20-24,1865,12
STAT,1950,19,40-44,1969,1.5614560751443105
STAT,1915,17,30-34,1932,2.409736084750608
STAT,1873,28,20-24,1901,11.209788496388548
STAT,1876,25,45-49,1901,1.090175381811156
SIM,1889,18,na,1907,2975
STAT,1908,38,20-24,1946,0.23194866481775975
SIM,1875,22,15-19,1897,3
SIM,1880,5,na,1885,2741
STAT,1871,26,20-24,1897,11.024718429889248
SIM,1837,41,45-49,1878,2
STAT,1905,46,30-34,1951,0.07475357681767
SIM,1903,21,50-100,1924,1
STAT,1834,45,35-39,1879,0.1036143866421369
SIM,1897,69,na,1966,2124
STAT,1889,18,30-34,1907,1.8540150332538514
STAT,1936,24,15-19,1960,4.803632089972401
SIM,1903,27,30-34,1930,39
STAT,1856,43,20-24,1899,0.116655979207038
SIM,1918,23,35-39,1941,12
STAT,1836,38,45-49,1874,1.5292206416748881
SIM,1904,18,25-29,1922,7
SIM,1862,30,40-44,1892,3
STAT,1948,17,35-39,1965,4.536855224289367
SIM,1906,39,40-44,1945,2
SIM,1852,30,30-34,1882,18
SIM,1819,52,50-100,1871,1
STAT,1828,29,20-24,1857,14.823886331042383
SIM,1823,39,na,1862,1453
SIM,1819,36,45-49,1855,1
STAT,1888,33,15-19,1921,0.15825773233535448
SIM,1859,20,15-19,1879,3
STAT,1856,37,35-39,1893,5.233212082491813
STAT,1931,19,30-34,1950,14.991090824749175
STAT,1914,32,15-19,1946,0.1221773013370651
SIM,1868,20,40-44,1888,5
STAT,1836,42,50-100,1878,0.7936422632010078
SIM,1841,94,na,1935,7
STAT,1879,84,na,1963,538.855138200356
STAT,1896,32,45-49,1928,2.177218174727495
STAT,1866,56,na,1922,1776.4988625974236
STAT,1829,41,45-49,1870,1.2786695361970468
STAT,1858,36,30-34,1894,3.97159666696511
STAT,1885,5,na,1890,2466.4908816924744
SIM,1832,23,30-34,1855,19
SIM,1944,24,15-19,1968,5
SIM,1908,12,na,1920,3556
STAT,1811,76,na,1887,402.41266892926933
STAT,1921,48,30-34,1969,0.09468148678427327
STAT,1840,47,25-29,1887,0.04045136624191873
SIM,1812,92,na,1904,15
STAT,1931,15,15-19,1946,56.378921334425385
STAT,1880,16,45-49,1896,0.06508993724752869
STAT,1795,75,na,1870,398.1034216526583
STAT,1849,47,45-49,1896,0.16931358974106578
STAT,1802,62,na,1864,884.8251112814285
SIM,1921,15,30-34,1936,17
STAT,1892,8,na,1900,3075.280841591096
SIM,1845,23,40-44,1868,4
SIM,1942,17,40-44,1959,1
STAT,1878,38,25-29,1916,2.8175092269402104
SIM,1869,41,40-44,1910,6
STAT,1866,41,15-19,1907,0.012082634957394948
STAT,1889,0,na,1889,3364.889419976209
SIM,1831,38,35-39,1869,13
SIM,1886,48,na,1934,2160
STAT,1922,27,40-44,1949,4.982910348561172
STAT,1819,35,40-44,1854,13.299421317075367
STAT,1823,61,na,1884,1043.3532731564974
STAT,1819,44,50-100,1863,1.9397288138401851
STAT,1905,29,30-34,1934,34.13150660820323
SIM,1919,26,20-24,1945,18
STAT,1911,17,50-100,1928,0.0708098516694171
STAT,1839,36,20-24,1875,0.6206242107221737
STAT,1843,39,15-19,1882,0.04215418290154139
STAT,1854,7,na,1861,2132.085398773987
STAT,1764,101,na,1865,0.0926531674282347
SIM,1884,19,na,1903,2492
STAT,1871,89,na,1960,164.50740230890688
STAT,1893,23,50-100,1916,0.4872737721382683
STAT,1909,27,50-100,1936,0.8984042068329964
SIM,1851,72,na,1923,893
SIM,1940,27,25-29,1967,75
STAT,1823,38,35-39,1861,10.63366044745468
SIM,1858,32,40-44,1890,4
STAT,1792,100,na,1892,0.17878202736758916
SIM,1875,85,na,1960,411
STAT,1864,45,20-24,1909,0.010232738546124236
SIM,1866,34,40-44,1900,5
STAT,1798,101,na,1899,0.15826921652059597
SIM,1862,1,na,1863,2979
STAT,1865,42,50-100,1907,0.9057891160939696
STAT,1926,15,40-44,1941,1.627764179266975
STAT,1860,32,30-34,1892,13.404866930729193
STAT,1830,25,20-24,1855,13.87171410637492
STAT,1856,56,na,1912,1509.1129488511633
STAT,1930,18,35-39,1948,5.111765388138601
SIM,1873,42,50-100,1915,1
STAT,1867,1,na,1868,3163.2800311784604
SIM,1913,29,30-34,1942,30
SIM,1873,56,na,1929,1955
STAT,1906,30,15-19,1936,0.1133883926567794
SIM,1858,37,35-39,1895,9
SIM,1869,28,20-24,1897,10
SIM,1867,20,15-19,1887,2
STAT,1884,50,30-34,1934,0.005636796969195196
SIM,1849,27,40-44,1876,2
SIM,1886,38,25-29,1924,2
STAT,1847,38,20-24,1885,0.5823974953813169
SIM,1936,22,15-19,1958,3
STAT,1861,40,35-39,1901,1.4348749190687977
STAT,1810,51,35-39,1861,0.029812178383416314
SIM,1930,27,40-44,1957,4
STAT,1935,19,15-19,1954,58.29313635341451
SIM,1908,59,na,1967,2858
STAT,1838,41,50-100,1879,0.8535206083139643
STAT,1913,15,30-34,1928,2.3646687506737125
SIM,1832,28,25-29,1860,36
STAT,1861,16,35-39,1877,0.49768329306355985
STAT,1820,43,na,1863,1432.0472252527545
STAT,1821,47,15-19,1868,6.108038677511123E-4
STAT,1851,20,20-24,1871,61.22427017050839
STAT,1813,95,na,1908,5.623047854119722
SIM,1846,41,50-100,1887,1
SIM,1870,28,45-49,1898,1
STAT,1848,6,na,1854,2228.0
SIM,1836,40,40-44,1876,5
STAT,1900,2,na,1902,3493.585997702208
STAT,1911,25,15-19,1936,0.65464570256589
STAT,1825,30,20-24,1855,5.973807506278478
SIM,1916,21,35-39,1937,9
SIM,1817,91,na,1908,22
STAT,1862,28,45-49,1890,0.8915748315164703
STAT,1886,26,40-44,1912,3.0002053801567117
SIM,1822,101,na,1923,1
SIM,1894,37,20-24,1931,1
STAT,1837,23,40-44,1860,1.7096697259513913
STAT,1834,94,na,1928,12.370510412416008
STAT,1856,41,na,1897,1717.8100798207358
STAT,1866,34,na,1900,2060.6558935314597
SIM,1914,25,40-44,1939,4
STAT,1954,18,20-24,1972,158.27740268215365
STAT,1851,26,50-100,1877,0.5532194562778195
STAT,1895,31,40-44,1926,5.368151554016082
STAT,1841,52,25-29,1893,0.0024105143036620893
STAT,1919,17,15-19,1936,47.37850939715836
STAT,1876,18,na,1894,2456.6576614505075
STAT,1934,17,40-44,1951,1.7872281476152474
SIM,1927,17,15-19,1944,48
STAT,1870,52,45-49,1922,0.013362184454103008
STAT,1828,40,40-44,1868,2.0518499793901492
STAT,1853,45,45-49,1898,0.1767643173165768
STAT,1890,29,35-39,1919,11.065119227538855
STAT,1891,19,25-29,1910,6.590609032880948
SIM,1866,30,25-29,1896,9
SIM,1850,44,30-34,1894,1
STAT,1875,46,35-39,1921,0.13626109863249658
STAT,1897,44,20-24,1941,0.013745253392390603
STAT,1849,71,na,1920,962.112041074169
STAT,1865,26,20-24,1891,10.10536410698023
SIM,1943,19,15-19,1962,40
SIM,1871,49,na,1920,2114
STAT,1892,21,20-24,1913,81.77007592081728
SIM,1887,70,na,1957,1434
SIM,1891,37,50-100,1928,1
SIM,1942,28,20-24,1970,17
STAT,1825,49,50-100,1874,0.2505306696593018
SIM,1858,89,na,1947,57
STAT,1888,39,20-24,1927,0.8516168993635119
SIM,1927,39,35-39,1966,6
STAT,1906,48,na,1954,3056.5820043722238
STAT,1908,27,40-44,1935,4.196877562475622
STAT,1923,15,15-19,1938,50.58186754596416
SIM,1840,21,15-19,1861,2
STAT,1854,49,na,1903,1586.2709556801146
STAT,1899,20,45-49,1919,0.9081482933675165
STAT,1859,15,40-44,1874,0.1619697080189661
STAT,1894,46,45-49,1940,0.1622338696926659
SIM,1873,29,25-29,1902,51
SIM,1901,27,50-100,1928,4
SIM,1931,15,15-19,1946,54
SIM,1940,20,15-19,1960,5
STAT,1819,46,20-24,1865,0.02165895543760984
STAT,1904,39,40-44,1943,1.2672149306465577
STAT,1928,22,15-19,1950,6.279303998920714
SIM,1834,76,na,1910,546
SIM,1912,39,40-44,1951,1
SIM,1894,26,40-44,1920,2
STAT,1816,91,na,1907,27.00348536935377
STAT,1892,66,na,1958,2012.6031146262253
STAT,1927,21,45-49,1948,1.3137027132420525
STAT,1863,24,20-24,1887,57.53118941112012
STAT,1886,37,20-24,1923,0.7694028919346831
STAT,1883,37,50-100,1920,1.136726646221764
STAT,1864,39,35-39,1903,5.911640783296198
SIM,1899,33,40-44,1932,6
STAT,1910,23,40-44,1933,2.972840889531588
STAT,1919,39,35-39,1958,2.4495438666626126
SIM,1923,48,na,1971,3956
STAT,1853,25,50-100,1878,0.5575499144890167
STAT,1855,93,na,1948,20.698499064769084
SIM,1916,27,40-44,1943,6
STAT,1841,26,35-39,1867,8.258948299749564
SIM,1852,57,na,1909,1538
SIM,1932,29,40-44,1961,7
SIM,1938,24,15-19,1962,3
SIM,1798,97,na,1895,1
SIM,1888,20,35-39,1908,7
STAT,1858,30,25-29,1888,7.755622265323564
STAT,1884,24,40-44,1908,1.9331402876626385
SIM,1825,33,40-44,1858,5
SIM,1832,80,na,1912,352
SIM,1938,25,na,1963,3456
STAT,1869,41,40-44,1910,2.0661272131636106
SIM,1830,26,25-29,1856,35
SIM,1935,21,45-49,1956,3
STAT,1934,28,20-24,1962,23.18624763447284
SIM,1827,35,40-44,1862,3
STAT,1848,49,50-100,1897,0.1732417304104791
SIM,1905,20,20-24,1925,88
SIM,1917,26,na,1943,3660
STAT,1834,72,na,1906,781.676864679731
STAT,1836,31,35-39,1867,8.167883436229808
STAT,1859,20,15-19,1879,2.876956084074066
SIM,1917,27,50-100,1944,4
STAT,1870,20,30-34,1890,16.586665583374174
STAT,1929,34,25-29,1963,11.07723162696617
SIM,1820,35,50-100,1855,4
STAT,1880,40,45-49,1920,1.5026689830398048
SIM,1870,32,40-44,1902,4
STAT,1838,60,na,1898,1300.7429158596692
SIM,1848,15,30-34,1863,4
SIM,1873,26,20-24,1899,12
SIM,1888,55,na,1943,2255
STAT,1869,48,na,1917,2031.4866709671273
STAT,1843,28,35-39,1871,8.505575844992842
STAT,1912,36,20-24,1948,0.2441703663535835
SIM,1892,24,40-44,1916,1
SIM,1844,31,35-39,1875,12
SIM,1849,53,na,1902,1592
STAT,1840,103,na,1943,0.099946258170895
STAT,1907,42,25-29,1949,0.061794730898127107
SIM,1851,28,35-39,1879,9
STAT,1842,44,30-34,1886,0.8255989111830051
STAT,1951,20,25-29,1971,104.33188402555389
SIM,1861,71,na,1932,1084
STAT,1870,23,35-39,1893,5.385034536610441
SIM,1928,38,40-44,1966,2
STAT,1831,28,30-34,1859,21.566001638847563
STAT,1911,32,35-39,1943,8.404588320684377
STAT,1914,33,15-19,1947,0.12166171312542268
SIM,1916,22,35-39,1938,8
STAT,1873,24,15-19,1897,3.1436577934372125
SIM,1898,64,na,1962,2404
STAT,1860,18,na,1878,2020.5804192525181
STAT,1801,82,na,1883,175.80081001670285
SIM,1840,43,50-100,1883,3
STAT,1828,32,40-44,1860,4.669988248319702
STAT,1871,37,15-19,1908,0.052591187136850556
STAT,1849,22,30-34,1871,15.522652420792719
STAT,1833,49,45-49,1882,0.14919935094272574
STAT,1881,21,45-49,1902,0.6379779867380626
STAT,1759,98,na,1857,0.22942324125223196
STAT,1857,41,20-24,1898,0.11881130021897514
STAT,1863,38,na,1901,1946.7315235999504
STAT,1946,26,15-19,1972,0.7432467725163284
SIM,1939,17,35-39,1956,5
STAT,1889,26,20-24,1915,13.729016456823182
STAT,1958,5,na,1963,4877.507301898197
SIM,1897,26,20-24,1923,18
STAT,1923,48,40-44,1971,0.1737682087765126
STAT,1929,9,na,1938,4799.720999917156
STAT,1793,109,na,1902,1.2940498897494497E-4
SIM,1876,49,na,1925,2200
STAT,1927,42,40-44,1969,0.2963766444124894
STAT,1889,4,na,1893,3068.0974695540885
SIM,1848,26,25-29,1874,42
SIM,1869,51,na,1920,1993
STAT,1838,36,15-19,1874,0.04669670144476539
SIM,1817,38,na,1855,1523
SIM,1895,30,50-100,1925,1
SIM,1922,47,na,1969,4001
STAT,1860,93,na,1953,22.438078715673026
STAT,1782,112,na,1894,1.0552746963312016E-4
STAT,1932,33,35-39,1965,11.469411591063684
SIM,1940,17,30-34,1957,13
STAT,1861,22,50-100,1883,0.32864783568310113
STAT,1813,44,15-19,1857,0.044157059669772784
STAT,1898,24,20-24,1922,87.57546198230477
SIM,1849,46,50-100,1895,2
SIM,1875,91,na,1966,170
STAT,1936,35,45-49,1971,0.6332262550033917
SIM,1862,22,40-44,1884,5
SIM,1839,53,na,1892,1482
STAT,1887,40,na,1927,2466.455584652907
SIM,1876,20,15-19,1896,3
STAT,1863,20,40-44,1883,1.7905283110751569
STAT,1920,30,35-39,1950,9.532552182622146
SIM,1859,30,40-44,1889,10
STAT,1932,17,30-34,1949,15.247482682910599
SIM,1886,79,na,1965,929
STAT,1859,21,na,1880,1851.1939700866255
SIM,1826,74,na,1900,575
STAT,1883,52,30-34,1935,0.005481930487646417
STAT,1856,88,na,1944,101.57530330465245
STAT,1846,23,45-49,1869,0.6022875785599022
STAT,1854,40,40-44,1894,1.6360338087387898
STAT,1906,27,30-34,1933,34.6404494261814
SIM,1914,28,na,1942,3829
STAT,1905,35,15-19,1940,0.016703466156120565
STAT,1875,53,35-39,1928,0.008221264062553465
SIM,1839,33,20-24,1872,2
SIM,1845,25,45-49,1870,4
STAT,1868,20,15-19,1888,3.018838803324643
SIM,1903,40,na,1943,3164
STAT,1850,16,50-100,1866,0.04239642913949266
SIM,1833,30,20-24,1863,2
SIM,1871,20,40-44,1891,5
STAT,1839,17,na,1856,2002.1645820636802
SIM,1889,27,25-29,1916,54
STAT,1857,23,20-24,1880,58.82362133387613
STAT,1844,49,20-24,1893,0.008248221485520627
STAT,1846,41,45-49,1887,1.0817857200624015
STAT,1854,22,40-44,1876,1.7630802503604461
STAT,1950,15,25-29,1965,48.43534959506621
STAT,1837,25,45-49,1862,0.9126714184002748
STAT,1847,36,na,1883,1817.3581167564291
SIM,1912,19,20-24,1931,18
SIM,1793,98,na,1891,1
SIM,1922,15,15-19,1937,49
SIM,1899,18,na,1917,3262
SIM,1830,95,na,1925,5
STAT,1843,22,na,1865,1936.2332747578193
STAT,1851,41,na,1892,1702.5389917641646
STAT,1916,21,30-34,1937,28.536221011199302
STAT,1940,23,15-19,1963,5.1205778580377554
STAT,1906,64,na,1970,2699.9059432159415
SIM,1845,30,40-44,1875,5
SIM,1864,20,na,1884,2148
SIM,1953,15,na,1968,4120
STAT,1839,72,na,1911,842.063093801443
SIM,1793,82,na,1875,130
SIM,1906,32,20-24,1938,2
SIM,1865,23,20-24,1888,49
STAT,1880,35,15-19,1915,0.056347651846194814
STAT,1904,19,20-24,1923,23.890214984794696
STAT,1914,15,15-19,1929,8.908301233694205
STAT,1937,28,15-19,1965,0.6496957908546457
SIM,1907,24,35-39,1931,9
STAT,1850,46,40-44,1896,0.12086739001724851
STAT,1899,16,35-39,1915,0.7121109202113507
STAT,1900,48,45-49,1948,0.17227823909383497
STAT,1927,10,na,1937,4668.7413468677005
SIM,1854,41,45-49,1895,1
STAT,1945,23,50-100,1968,0.6810430860963063
SIM,1930,19,40-44,1949,1
STAT,1833,54,40-44,1887,0.006345460959291074
STAT,1874,17,50-100,1891,0.047303203672301015
SIM,1880,54,50-100,1934,1
STAT,1887,24,45-49,1911,0.7321058355710547
SIM,1857,22,30-34,1879,21
STAT,1822,44,na,1866,1388.031069975112
SIM,1843,58,na,1901,1409
STAT,1922,37,40-44,1959,1.609286911465864
SIM,1893,17,na,1910,3151
STAT,1766,115,na,1881,1.7484531977702221E-4
STAT,1901,17,na,1918,3339.576036571452
SIM,1874,31,20-24,1905,2
SIM,1940,24,20-24,1964,90
STAT,1914,42,30-34,1956,0.11965305964142928
SIM,1873,18,30-34,1891,1
SIM,1948,22,50-100,1970,4
SIM,1924,21,30-34,1945,38
STAT,1866,0,na,1866,3305.801903546457
SIM,1858,20,na,1878,2012
STAT,1922,19,40-44,1941,1.5211321769686807
STAT,1913,46,na,1959,3395.1119997017886
STAT,1865,18,30-34,1883,1.4016510124460222
STAT,1915,49,45-49,1964,0.2056596350697893
SIM,1880,54,na,1934,2187
STAT,1837,30,40-44,1867,3.5044780771768997
SIM,1855,87,na,1942,137
SIM,1899,21,25-29,1920,86
SIM,1856,0,na,1856,3050
SIM,1789,77,na,1866,314
SIM,1884,68,na,1952,1427
STAT,1872,29,30-34,1901,23.706878177508536
SIM,1819,92,na,1911,12
STAT,1894,48,20-24,1942,0.008122467699073996
STAT,1942,27,na,1969,3714.1520380988013
STAT,1798,61,na,1859,922.9557706655464
STAT,1868,85,na,1953,247.26296012546783
STAT,1932,24,20-24,1956,137.35701023515065
SIM,1925,1,na,1926,4567
STAT,1923,3,na,1926,4499.772831041054
SIM,1905,30,50-100,1935,4
SIM,1898,23,30-34,1921,21
SIM,1816,38,50-100,1854,4
SIM,1877,33,40-44,1910,4
STAT,1860,52,35-39,1912,0.006574501707965494
STAT,1945,15,15-19,1960,46.85851675593826
SIM,1880,29,30-34,1909,36
SIM,1886,41,40-44,1927,5
STAT,1924,25,25-29,1949,72.89645057414998
SIM,1787,98,na,1885,1
SIM,1821,75,na,1896,571
STAT,1880,15,45-49,1895,0.06523214331996618
STAT,1866,48,45-49,1914,0.20297062644534034
STAT,1839,28,30-34,1867,21.00049677665509
STAT,1889,19,30-34,1908,1.8489164919124033
STAT,1891,7,na,1898,3046.460504496727
STAT,1866,50,na,1916,1902.335526988403
STAT,1898,5,na,1903,3351.343118996586
STAT,1904,24,45-49,1928,0.9388331002947711
SIM,1900,9,na,1909,3377
STAT,1863,15,45-49,1878,0.06263395481991922
SIM,1846,94,na,1940,19
SIM,1842,80,na,1922,398
SIM,1880,31,50-100,1911,4
STAT,1842,51,30-34,1893,0.004259166864932138
SIM,1829,39,na,1868,1524
STAT,1895,41,40-44,1936,0.19342760708242446
STAT,1841,27,na,1868,1838.344920547317
STAT,1865,25,20-24,1890,10.139127401226315
SIM,1832,74,na,1906,671
SIM,1847,28,30-34,1875,28
SIM,1873,72,na,1945,1170
SIM,1912,24,45-49,1936,6
SIM,1904,17,20-24,1921,24
STAT,1854,105,na,1959,0.046826942369649134
STAT,1869,33,40-44,1902,3.9489180744450247
SIM,1953,15,15-19,1968,41
SIM,1828,33,45-49,1861,1
STAT,1922,41,25-29,1963,0.07754759896174646
STAT,1936,21,50-100,1957,0.5943742374804614
SIM,1852,33,35-39,1885,13
STAT,1878,41,40-44,1919,2.2220650332620355
STAT,1914,38,45-49,1952,0.6397085884827708
SIM,1830,48,50-100,1878,2
SIM,1799,83,na,1882,105
STAT,1816,44,na,1860,1420.5517975083214
STAT,1869,18,15-19,1887,5.469512605971777
SIM,1929,38,30-34,1967,5
SIM,1877,86,na,1963,308
STAT,1887,42,45-49,1929,1.5792484345734614
STAT,1872,19,na,1891,2381.9428115759924
STAT,1874,18,25-29,1892,5.457069914624767
STAT,1821,39,25-29,1860,5.296305705735906
SIM,1936,15,15-19,1951,35
STAT,1788,95,na,1883,2.5465766276362953
SIM,1846,23,na,1869,1855
STAT,1778,102,na,1880,0.07328760357784969
STAT,1848,25,20-24,1873,10.236091984133477
SIM,1952,9,na,1961,4396
SIM,1869,67,na,1936,1400
STAT,1877,20,40-44,1897,2.0549816503062126
SIM,1873,25,na,1898,2316
SIM,1896,69,na,1965,2088
STAT,1919,43,45-49,1962,0.17011273629708218
STAT,1928,15,15-19,1943,54.277953794569775
STAT,1844,33,35-39,1877,8.413706387871065
STAT,1881,55,na,1936,1886.0524766256367
SIM,1820,89,na,1909,34
STAT,1830,36,15-19,1866,0.04517394368120158
STAT,1840,20,45-49,1860,0.6265370553391034
STAT,1940,28,45-49,1968,1.6632927874381873
SIM,1823,38,na,1861,1460
STAT,1874,23,20-24,1897,66.33158586691677
STAT,1905,9,na,1914,3542.0774347258166
SIM,1869,34,45-49,1903,2
SIM,1911,30,35-39,1941,8
STAT,1891,47,40-44,1938,0.11239474240041206
SIM,1921,22,45-49,1943,3
STAT,1858,15,35-39,1873,0.4810083538698354
SIM,1877,18,15-19,1895,5
SIM,1878,42,45-49,1920,1
STAT,1881,30,50-100,1911,0.8424657232715113
STAT,1765,98,na,1863,0.5108490793106909
STAT,1874,47,40-44,1921,0.16452836560854947
SIM,1941,14,na,1955,3692
STAT,1919,25,15-19,1944,0.7254782552397236
SIM,1831,42,50-100,1873,1
STAT,1846,54,50-100,1900,0.010355705065888255
SIM,1907,7,na,1914,3672
STAT,1875,15,35-39,1890,0.5350173596147013
SIM,1922,38,45-49,1960,4
SIM,1939,32,30-34,1971,19
STAT,1923,35,35-39,1958,2.652390071267911
SIM,1856,25,20-24,1881,13
SIM,1931,35,35-39,1966,7
STAT,1913,43,25-29,1956,0.06566689570578998
STAT,1828,50,40-44,1878,0.008909042714845574
STAT,1903,49,25-29,1952,0.04275746176319737
SIM,1867,72,na,1939,1061
STAT,1913,22,45-49,1935,1.029763621997768
STAT,1954,12,na,1966,4587.379051325389
SIM,1919,9,na,1928,4143
STAT,1850,44,50-100,1894,0.7337054213497033
SIM,1884,4,na,1888,2595
STAT,1890,32,na,1922,2756.253727967758
SIM,1883,15,35-39,1898,3
STAT,1923,40,30-34,1963,0.1415655223935665
STAT,1839,35,20-24,1874,0.6271021762023442
STAT,1786,76,na,1862,348.97806463696077
SIM,1885,35,50-100,1920,2
SIM,1897,19,30-34,1916,2
STAT,1859,32,40-44,1891,3.2695570144565447
STAT,1870,24,na,1894,2175.548234816815
STAT,1895,46,15-19,1941,2.789502137135894E-4
SIM,1905,51,na,1956,2930
SIM,1932,25,25-29,1957,83
SIM,1837,58,na,1895,1249
STAT,1920,49,25-29,1969,0.05507205365564875
SIM,1909,13,na,1922,3633
SIM,1838,75,na,1913,663
STAT,1875,55,na,1930,2006.7946356020389
SIM,1931,28,45-49,1959,2
STAT,1831,30,45-49,1861,1.4666436623336927
STAT,1923,28,45-49,1951,1.8673564875946878
SIM,1836,32,40-44,1868,4
STAT,1834,52,35-39,1886,0.005464042017853476
SIM,1867,32,40-44,1899,5
STAT,1859,92,na,1951,31.40051537995436
STAT,1794,95,na,1889,2.520212511832669
STAT,1908,22,35-39,1930,8.175687843939178
STAT,1930,22,45-49,1952,1.36177293216658
SIM,1852,35,na,1887,1848
STAT,1895,23,40-44,1918,2.56098113196954
STAT,1866,19,na,1885,2231.3709995783465
STAT,1850,63,na,1913,1256.1543247448972
STAT,1864,26,15-19,1890,0.38438051930519124
SIM,1901,27,20-24,1928,14
STAT,1900,38,45-49,1938,0.5611189716992125
SIM,1917,32,na,1949,3693
SIM,1857,66,na,1923,1313
SIM,1836,46,50-100,1882,1
SIM,1889,71,na,1960,1681
SIM,1884,48,50-100,1932,2
STAT,1807,71,na,1878,630.4807443148591
STAT,1870,23,50-100,1893,0.376312730041423
SIM,1845,40,40-44,1885,5
STAT,1864,108,na,1972,0.029968223483208125
SIM,1853,52,na,1905,1727
STAT,1882,48,30-34,1930,0.08786532731165565
STAT,1856,29,na,1885,1803.565521507432
STAT,1914,29,30-34,1943,37.04216451038887
STAT,1910,27,20-24,1937,16.647102470480426
STAT,1889,29,25-29,1918,48.982356711351976
STAT,1875,50,30-34,1925,0.0058601960571699535
STAT,1853,23,35-39,1876,5.076572781993648
SIM,1840,23,15-19,1863,1
SIM,1923,33,35-39,1956,9
SIM,1817,97,na,1914,3
STAT,1917,46,15-19,1963,3.643734932827178E-4
STAT,1837,52,50-100,1889,0.009568605643758318
STAT,1929,26,15-19,1955,0.8350801422740469
SIM,1914,32,50-100,1946,5
STAT,1904,32,45-49,1936,1.3565881236076307
STAT,1845,47,15-19,1892,2.804387578189814E-4
STAT,1949,23,35-39,1972,10.376968659651322
SIM,1888,29,30-34,1917,36
STAT,1931,27,40-44,1958,5.6849257734104155
SIM,1818,55,na,1873,1111
SIM,1912,32,45-49,1944,1
STAT,1849,25,35-39,1874,8.364008962702322
STAT,1883,31,20-24,1914,2.5129006973847448
SIM,1902,32,35-39,1934,16
STAT,1797,102,na,1899,0.07138374226323307
SIM,1902,1,na,1903,3588
STAT,1921,44,15-19,1965,0.0016287153574244446
SIM,1858,48,50-100,1906,2
STAT,1885,23,50-100,1908,0.3826179619497802
STAT,1816,40,20-24,1856,0.5140594853189671
SIM,1861,23,35-39,1884,3
STAT,1828,35,45-49,1863,1.9792563438738706
STAT,1905,19,40-44,1924,0.24835205936471902
SIM,1853,80,na,1933,465
STAT,1907,31,30-34,1938,13.966715440666214
STAT,1906,40,30-34,1946,0.11093033595587452
STAT,1892,67,na,1959,1974.1623951368647
STAT,1840,49,50-100,1889,0.16811673901395058
SIM,1903,34,45-49,1937,1
STAT,1824,52,50-100,1876,0.017088495523408017
SIM,1775,97,na,1872,2
SIM,1924,24,35-39,1948,11
STAT,1868,14,na,1882,2387.2079344824783
STAT,1845,72,na,1917,889.5596139507019
STAT,1855,36,15-19,1891,0.039962145355320035
STAT,1854,43,45-49,1897,1.0699367287323511
STAT,1881,19,30-34,1900,1.4460417775639747
STAT,1836,47,20-24,1883,0.007930385156648274
STAT,1915,33,35-39,1948,8.754412169093857
STAT,1833,56,na,1889,1244.4302452291233
STAT,1873,84,na,1957,372.9060472043713
STAT,1870,4,na,1874,2737.136765036439
STAT,1887,16,45-49,1903,0.06918249647413018
SIM,1881,7,na,1888,2196
STAT,1833,46,40-44,1879,0.12359869180225999
STAT,1878,23,40-44,1901,2.0429946423375376
STAT,1930,40,20-24,1970,0.022013518070482338
SIM,1920,31,40-44,1951,4
SIM,1915,31,30-34,1946,23
SIM,1886,23,40-44,1909,1
STAT,1830,36,50-100,1866,0.9876665529247883
STAT,1913,25,25-29,1938,62.36270144473561
SIM,1919,28,20-24,1947,18
SIM,1893,5,na,1898,3258
SIM,1918,47,50-100,1965,3
STAT,1824,79,na,1903,369.08400718234446
STAT,1860,28,50-100,1888,0.4928282251960637
SIM,1950,8,na,1958,4277
STAT,1892,38,45-49,1930,2.346611093499663
SIM,1817,42,na,1859,1464
STAT,1842,44,40-44,1886,1.6152483222991627
SIM,1841,95,na,1936,5
SIM,1894,34,na,1928,3027
SIM,1921,25,25-29,1946,71
STAT,1955,16,15-19,1971,56.92648524202722
STAT,1910,53,na,1963,3168.269562521764
SIM,1850,44,40-44,1894,4
STAT,1868,69,na,1937,1323.6904297148724
STAT,1864,55,na,1919,1745.792820176602
SIM,1892,9,na,1901,3133
STAT,1825,47,45-49,1872,0.24745810633791074
STAT,1877,48,20-24,1925,0.011615991574749978
SIM,1856,28,25-29,1884,40
SIM,1931,32,30-34,1963,35
STAT,1854,18,na,1872,1965.6579926847344
SIM,1834,38,na,1872,1596
STAT,1902,42,35-39,1944,0.16743248827286702
STAT,1874,15,20-24,1889,17.261165106984457
SIM,1941,30,na,1971,3633
STAT,1916,24,35-39,1940,9.262259788775639
STAT,1933,21,30-34,1954,36.12439363970356
STAT,1852,51,50-100,1903,0.011529553285366817
SIM,1856,18,30-34,1874,2
STAT,1773,97,na,1870,0.6382509409662169
SIM,1849,30,25-29,1879,15
SIM,1904,22,45-49,1926,1
STAT,1827,33,35-39,1860,11.284082099489394
STAT,1830,29,25-29,1859,37.11397164215906
SIM,1900,48,na,1948,2885
SIM,1930,14,na,1944,4778
SIM,1879,38,50-100,1917,2
SIM,1871,77,na,1948,724
SIM,1891,31,20-24,1922,3
SIM,1941,21,30-34,1962,35
SIM,1888,36,20-24,1924,3
SIM,1907,21,30-34,1928,39
SIM,1913,27,40-44,1940,10
STAT,1848,18,30-34,1866,1.415055564682092
STAT,1815,90,na,1905,33.743861402215295
SIM,1830,24,na,1854,1773
SIM,1882,49,na,1931,1991
STAT,1894,24,35-39,1918,7.047000266047231
STAT,1939,33,20-24,1972,2.3493574340159507
STAT,1827,91,na,1918,32.158101769127356
STAT,1918,45,na,1963,3710.561687388008
SIM,1884,25,50-100,1909,1
SIM,1882,15,20-24,1897,13
SIM,1936,33,45-49,1969,1
SIM,1805,57,na,1862,1058
STAT,1905,45,40-44,1950,0.1331488358167291
STAT,1816,54,40-44,1870,0.025495401088552146
SIM,1885,20,40-44,1905,1
STAT,1880,38,na,1918,2330.2220762598417
STAT,1822,38,30-34,1860,9.168724336964692
STAT,1829,46,15-19,1875,3.2700421907692163E-4
SIM,1905,47,50-100,1952,1
SIM,1835,23,na,1858,1754
SIM,1835,33,35-39,1868,10
STAT,1925,15,50-100,1940,0.42959176378699054
STAT,1835,105,na,1940,0.01829403957156424
STAT,1841,47,30-34,1888,0.06652999047275907
STAT,1941,23,35-39,1964,9.18867108227997
SIM,1862,25,45-49,1887,1
SIM,1875,20,na,1895,2291
STAT,1870,39,20-24,1909,0.7063697213420641
SIM,1921,18,35-39,1939,5
SIM,1857,25,35-39,1882,14
SIM,1787,82,na,1869,128
STAT,1897,66,na,1963,2256.154867816217
STAT,1885,85,na,1970,554.5243467743281
STAT,1928,33,45-49,1961,1.8577973562329568
STAT,1845,41,na,1886,1679.1927608957137
STAT,1883,45,40-44,1928,0.16008871058025692
STAT,1854,25,45-49,1879,0.9344258119558803
SIM,1878,27,50-100,1905,3
STAT,1819,104,na,1923,0.03330913267121706
STAT,1911,48,20-24,1959,0.009853809275423281
STAT,1832,23,15-19,1855,3.113050775171509
SIM,1868,32,35-39,1900,8
STAT,1888,27,15-19,1915,0.50633664193174
STAT,1893,52,na,1945,2567.152595364109
STAT,1886,48,15-19,1934,3.942327431216304E-4
SIM,1905,35,40-44,1940,1
SIM,1837,39,30-34,1876,5
SIM,1864,52,na,1916,1922
STAT,1821,36,20-24,1857,1.7158008070282273
STAT,1900,22,35-39,1922,7.6479190618671335
STAT,1835,48,50-100,1883,0.1594673595935787
STAT,1875,23,na,1898,2288.2769054305886
STAT,1896,37,15-19,1933,0.07011077908253661
SIM,1921,29,40-44,1950,5
STAT,1825,54,35-39,1879,0.008362727852471991
STAT,1921,24,45-49,1945,1.193164188957677
STAT,1875,28,50-100,1903,0.6186604087303302
SIM,1840,15,15-19,1855,5
STAT,1844,21,40-44,1865,1.8396761003750792
SIM,1860,4,na,1864,2471
STAT,1904,53,na,1957,2905.8698563430885
STAT,1922,17,15-19,1939,49.6214139838806
STAT,1914,25,15-19,1939,0.6767537209244409
SIM,1851,41,na,1892,1726
STAT,1886,22,35-39,1908,5.8245335948198935
SIM,1913,37,40-44,1950,2
SIM,1944,17,15-19,1961,44
STAT,1911,38,20-24,1949,0.23928405318793478
STAT,1892,45,35-39,1937,0.09435540609047754
SIM,1842,64,na,1906,1193
SIM,1830,38,30-34,1868,5
STAT,1906,34,20-24,1940,2.116798215209621
SIM,1928,32,na,1960,4453
SIM,1898,35,50-100,1933,1
STAT,1937,18,20-24,1955,124.25442353643365
SIM,1945,18,20-24,1963,139
STAT,1931,35,40-44,1966,1.8762027402395425
SIM,1852,21,40-44,1873,5
STAT,1905,27,40-44,1932,4.089410297583832
SIM,1848,18,25-29,1866,6
STAT,1870,24,50-100,1894,0.37511605555989136
STAT,1804,59,na,1863,1022.5197067066065
SIM,1827,31,35-39,1858,6
STAT,1874,38,na,1912,2263.487383462338
SIM,1832,24,20-24,1856,51
STAT,1878,31,40-44,1909,4.282384093816594
SIM,1894,22,35-39,1916,9
STAT,1829,39,30-34,1868,4.5880023787161965
STAT,1955,8,na,1963,4928.349952629982
SIM,1852,67,na,1919,1186
SIM,1908,23,40-44,1931,2
STAT,1848,28,25-29,1876,36.120100092575875
STAT,1857,42,na,1899,1719.17840687205
SIM,1833,60,na,1893,1172
SIM,1849,23,35-39,1872,11
STAT,1797,76,na,1873,375.97194433487556
STAT,1876,49,na,1925,2148.356778150256
STAT,1913,29,40-44,1942,4.355088419681009
STAT,1850,108,na,1958,0.00248176391986647
SIM,1877,36,45-49,1913,1
STAT,1924,22,20-24,1946,123.96334415875005
STAT,1903,46,20-24,1949,0.009123589449534777
STAT,1913,47,40-44,1960,0.14534168171815892
SIM,1916,47,na,1963,3476
SIM,1863,35,na,1898,2040
STAT,1927,26,na,1953,4317.60534312593
STAT,1879,85,na,1964,484.9157388665004
SIM,1898,26,35-39,1924,18
STAT,1898,42,20-24,1940,0.014085927119728834
SIM,1912,33,na,1945,3355
STAT,1869,36,45-49,1905,1.8316913932459487
SIM,1861,87,na,1948,113
STAT,1904,21,40-44,1925,2.8317158391846724
SIM,1841,17,25-29,1858,3
STAT,1909,43,35-39,1952,0.1768150471435745
SIM,1912,21,40-44,1933,2
STAT,1785,82,na,1867,160.92106341053608
STAT,1925,38,20-24,1963,0.2986264069824505
STAT,1888,35,15-19,1923,0.06326423687146386
SIM,1914,27,30-34,1941,47
STAT,1912,31,40-44,1943,3.6517369944721843
STAT,1945,22,50-100,1967,0.6812679045047929
SIM,1778,77,na,1855,295
STAT,1868,34,35-39,1902,9.056176034012921
STAT,1923,32,30-34,1955,17.064298427684914
SIM,1932,22,20-24,1954,135
STAT,1905,37,40-44,1942,1.2898609891806694
SIM,1934,32,na,1966,4824
STAT,1949,21,50-100,1970,0.7256339668743196
STAT,1840,25,15-19,1865,0.39968234638721317
SIM,1853,21,35-39,1874,7
STAT,1886,23,na,1909,2353.3178427536536
SIM,1889,19,25-29,1908,8
STAT,1919,40,40-44,1959,0.2567749821286231
STAT,1868,15,45-49,1883,0.060699114136982806
STAT,1851,44,35-39,1895,1.309975358609891
STAT,1931,17,40-44,1948,1.7295644793577702
SIM,1836,35,45-49,1871,1
STAT,1837,49,30-34,1886,0.061828268836269545
SIM,1904,66,na,1970,2501
STAT,1810,59,na,1869,1070.3654249128124
SIM,1830,79,na,1909,438
STAT,1923,25,40-44,1948,5.0901680680808346
STAT,1834,73,na,1907,735.167091231287
STAT,1866,26,50-100,1892,0.5590770997571444
SIM,1876,34,35-39,1910,9
SIM,1901,17,na,1918,3399
STAT,1876,40,na,1916,2276.793222233153
STAT,1936,17,15-19,1953,41.03942917790258
STAT,1847,34,15-19,1881,0.10965386243581296
STAT,1885,22,40-44,1907,1.9612378683299252
STAT,1851,37,45-49,1888,1.4775113526137365
STAT,1923,43,35-39,1966,0.222007781266744
STAT,1860,42,35-39,1902,1.388558146985385
STAT,1867,20,25-29,1887,51.72618587811117
SIM,1850,30,20-24,1880,2
STAT,1922,35,15-19,1957,0.020679676622446692
SIM,1931,25,40-44,1956,10
STAT,1903,28,20-24,1931,15.711956866893987
STAT,1934,5,na,1939,5137.599836712654
STAT,1895,26,45-49,1921,1.373478749965375
STAT,1928,36,25-29,1964,1.1767059687352284
SIM,1911,28,20-24,1939,21
STAT,1939,11,na,1950,3743.8097482629055
SIM,1927,40,40-44,1967,2
SIM,1882,33,na,1915,2157
STAT,1897,70,na,1967,2064.4301487498446
STAT,1905,35,50-100,1940,0.36519846389184335
SIM,1874,16,25-29,1890,7
STAT,1899,34,50-100,1933,1.1760282033042384
SIM,1869,16,15-19,1885,5
SIM,1889,12,na,1901,3052
SIM,1914,34,20-24,1948,2
SIM,1886,31,40-44,1917,4
SIM,1819,40,40-44,1859,5
SIM,1871,61,na,1932,1744
SIM,1826,31,40-44,1857,5
SIM,1847,24,15-19,1871,3
SIM,1871,30,40-44,1901,3
STAT,1852,50,35-39,1902,0.006634920951084507
STAT,1920,22,35-39,1942,9.889432509616945
SIM,1888,34,na,1922,2586
SIM,1875,20,25-29,1895,63
STAT,1842,30,20-24,1872,2.3741009053878543
STAT,1828,53,45-49,1881,0.0105303824853048
STAT,1895,44,45-49,1939,0.12639514995963266
STAT,1908,6,na,1914,3659.9932759128615
SIM,1865,37,na,1902,2008
SIM,1930,17,15-19,1947,49
STAT,1840,73,na,1913,827.1707956541105
STAT,1840,18,30-34,1858,1.4286794939642415
STAT,1911,11,na,1922,3738.1699055767917
SIM,1897,29,25-29,1926,59
STAT,1866,16,25-29,1882,5.0960682460035445
STAT,1915,25,na,1940,3633.815755639011
SIM,1843,48,50-100,1891,2
SIM,1931,6,na,1937,4941
STAT,1901,19,20-24,1920,23.316490043970404
STAT,1811,45,na,1856,1337.6659084886865
STAT,1833,40,20-24,1873,0.1201540853903742
SIM,1875,36,na,1911,2252
STAT,1894,20,40-44,1914,2.54739578845709
STAT,1909,25,35-39,1934,13.7590057647136
STAT,1924,31,30-34,1955,17.376308415182088
STAT,1813,42,45-49,1855,5.324985360562754
SIM,1869,26,45-49,1895,4
STAT,1828,47,15-19,1875,3.3692307648858504E-4
STAT,1865,48,30-34,1913,0.08205333757602572
STAT,1942,22,35-39,1964,9.326029854632244
STAT,1858,50,30-34,1908,0.004478026459613094
STAT,1828,46,50-100,1874,0.20962333978538963
STAT,1859,22,40-44,1881,1.6300016892901912
SIM,1858,15,25-29,1873,6
STAT,1814,89,na,1903,43.34465771323745
SIM,1930,33,25-29,1963,11
STAT,1822,45,50-100,1867,0.3525565656457153
SIM,1904,25,25-29,1929,66
STAT,1886,54,na,1940,2090.0863338403315
STAT,1882,40,na,1922,2146.045367979695
SIM,1858,24,40-44,1882,2
STAT,1865,33,20-24,1898,2.310634614446096
SIM,1884,13,na,1897,2527
STAT,1795,81,na,1876,200.57928988511597
STAT,1928,30,40-44,1958,4.628256397806037
SIM,1853,21,na,1874,1986
STAT,1931,29,30-34,1960,47.74244349273008
STAT,1878,52,45-49,1930,0.014196291608384802
STAT,1869,26,15-19,1895,0.4163060625292413
STAT,1910,41,35-39,1951,0.18076519686498949
STAT,1935,33,35-39,1968,11.935624484120394
STAT,1825,44,40-44,1869,2.4039387622673853
STAT,1821,37,50-100,1858,2.568308622107583
SIM,1836,40,na,1876,1595
STAT,1848,36,25-29,1884,2.1598578944447153
SIM,1857,35,na,1892,1905
STAT,1922,33,25-29,1955,9.824544434596884
STAT,1910,22,na,1932,3384.5264186130066
STAT,1892,35,40-44,1927,5.227797476034011
SIM,1839,85,na,1924,184
STAT,1856,35,20-24,1891,0.5757631079044113
SIM,1852,63,na,1915,1349
SIM,1784,78,na,1862,238
SIM,1821,42,45-49,1863,2
SIM,1917,25,35-39,1942,18
STAT,1841,17,30-34,1858,1.4064741595990382
STAT,1916,41,50-100,1957,0.11389242638248187
SIM,1920,34,45-49,1954,1
STAT,1842,37,na,1879,1789.182532618819
SIM,1900,43,40-44,1943,3
STAT,1829,55,na,1884,1312.6462283018875
STAT,1905,48,45-49,1953,0.17945097775258176
SIM,1788,67,na,1855,704
SIM,1923,35,25-29,1958,3
SIM,1773,90,na,1863,19
STAT,1851,41,30-34,1892,0.846885306841616
STAT,1895,38,15-19,1933,0.06888396423243826
STAT,1826,101,na,1927,0.31145613642963943
SIM,1844,23,35-39,1867,5
SIM,1853,35,45-49,1888,1
STAT,1852,48,20-24,1900,0.009002709717911927
SIM,1892,40,30-34,1932,1
SIM,1943,15,35-39,1958,7
STAT,1836,23,35-39,1859,4.828409608576199
SIM,1869,20,na,1889,2168
SIM,1936,30,40-44,1966,5
STAT,1861,48,50-100,1909,0.1902465939621812
SIM,1845,15,15-19,1860,5
STAT,1855,62,na,1917,1294.4664384780738
STAT,1915,35,25-29,1950,0.9484787495040439
STAT,1861,49,20-24,1910,0.00921716897931389
SIM,1948,22,30-34,1970,38
STAT,1918,20,50-100,1938,0.6744007190539962
STAT,1845,35,45-49,1880,1.6552893979156111
STAT,1845,21,35-39,1866,5.13970354290044
STAT,1893,36,50-100,1929,1.4786749923370655
SIM,1900,20,30-34,1920,35
SIM,1840,78,na,1918,473
STAT,1853,76,na,1929,702.6019709973071
STAT,1915,19,50-100,1934,0.07367252080411833
SIM,1833,39,45-49,1872,1
STAT,1807,50,20-24,1857,0.00271975496047395
STAT,1831,23,50-100,1854,0.8226636566649509
STAT,1857,15,20-24,1872,15.702907685071157
STAT,1909,24,45-49,1933,0.9814706494370227
SIM,1886,1,na,1887,3052
SIM,1870,92,na,1962,65
SIM,1922,19,30-34,1941,20
STAT,1768,108,na,1876,0.0029417473836898396
SIM,1856,36,25-29,1892,2
SIM,1935,27,15-19,1962,3
SIM,1866,87,na,1953,113
SIM,1809,78,na,1887,330
STAT,1900,27,40-44,1927,3.9259546747707925
STAT,1859,40,40-44,1899,1.7128953401800617
STAT,1940,27,30-34,1967,37.74193350553358
SIM,1868,43,40-44,1911,2
SIM,1796,63,na,1859,828
STAT,1891,17,na,1908,2953.2082332359164
STAT,1916,48,20-24,1964,0.0106779032254262
STAT,1924,46,na,1970,4142.479651363557
STAT,1871,25,45-49,1896,1.0469017832755063
STAT,1884,75,na,1959,1083.0829307482034
STAT,1924,36,40-44,1960,1.6692671176968266
STAT,1854,22,na,1876,1809.038713183765
SIM,1899,25,40-44,1924,3
STAT,1844,23,50-100,1867,0.35486366403526703
SIM,1801,82,na,1883,152
STAT,1814,40,50-100,1854,3.5614442588888586
STAT,1943,16,45-49,1959,0.5005486598385812
STAT,1870,53,35-39,1923,0.00784119029795699
STAT,1869,54,45-49,1923,0.012905750268292718
STAT,1885,20,15-19,1905,3.1234993625287917
STAT,1914,19,30-34,1933,2.368707128970758
SIM,1885,53,na,1938,2024
STAT,1912,34,45-49,1946,1.4498905168840266
SIM,1879,39,30-34,1918,9
STAT,1820,96,na,1916,4.574408031108467
STAT,1844,47,50-100,1891,0.17160965406461334
SIM,1928,24,20-24,1952,124
STAT,1943,12,na,1955,3934.9691305778574
SIM,1892,39,na,1931,2790
STAT,1878,68,na,1946,1502.909735552859
STAT,1887,12,na,1899,2728.411911268962
STAT,1820,48,20-24,1868,0.019498038625328815
STAT,1902,35,15-19,1937,0.016311838708852295
STAT,1825,39,45-49,1864,2.3567621944435873
STAT,1861,53,40-44,1914,0.008126093103642805
SIM,1833,44,40-44,1877,2
STAT,1909,18,45-49,1927,0.0922773270278968
SIM,1913,18,na,1931,3606
SIM,1932,31,30-34,1963,19
STAT,1907,39,45-49,1946,0.5909861055170476
SIM,1874,14,na,1888,2491
SIM,1882,23,20-24,1905,60
SIM,1917,24,45-49,1941,2
SIM,1932,36,40-44,1968,1
STAT,1888,41,50-100,1929,1.1843457806027369
STAT,1891,38,30-34,1929,6.2010008649246835
SIM,1867,22,40-44,1889,1
STAT,1874,41,20-24,1915,0.15403281246275224
SIM,1858,88,na,1946,77
SIM,1930,15,25-29,1945,64
SIM,1885,24,35-39,1909,6
STAT,1799,95,na,1894,4.445100405702686
STAT,1924,45,na,1969,4151.654808490319
SIM,1893,20,15-19,1913,4
STAT,1880,33,45-49,1913,1.72604174479876
STAT,1858,102,na,1960,0.5120673793616846
STAT,1877,24,35-39,1901,5.684808109540451
STAT,1839,52,50-100,1891,0.010016483802032308
STAT,1857,27,50-100,1884,0.49071116562169576
STAT,1825,51,30-34,1876,0.0061373087584051895
STAT,1874,69,na,1943,1416.959412848314
STAT,1895,16,na,1911,3121.2136732022423
STAT,1837,51,45-49,1888,0.009378500902850117
STAT,1870,55,na,1925,1914.0193657503644
SIM,1909,19,15-19,1928,8
STAT,1845,88,na,1933,96.70000020832674
STAT,1791,82,na,1873,156.42884514893268
SIM,1903,28,na,1931,3208
SIM,1824,55,na,1879,1176
STAT,1922,15,25-29,1937,47.60217642393688
STAT,1846,15,45-49,1861,0.058544643016179454
SIM,1808,93,na,1901,9
STAT,1902,29,15-19,1931,0.6005297070598301
SIM,1894,33,40-44,1927,13
STAT,1841,24,20-24,1865,58.874209041395275
SIM,1862,43,45-49,1905,3
STAT,1861,21,40-44,1882,1.6915355433599537
SIM,1851,42,35-39,1893,2
STAT,1808,89,na,1897,40.832758868679775
STAT,1941,25,25-29,1966,64.37409681903382
STAT,1856,28,30-34,1884,19.168327891787314
STAT,1888,34,na,1922,2640.346562419041
STAT,1885,17,na,1902,2377.0483609744665
STAT,1897,40,50-100,1937,0.09362215803734032
STAT,1889,37,25-29,1926,3.357927064754736
STAT,1941,20,30-34,1961,28.076228047791187
SIM,1844,39,20-24,1883,3
SIM,1859,34,35-39,1893,12
STAT,1832,49,30-34,1881,0.061543821312598807
SIM,1928,18,20-24,1946,165
STAT,1830,39,50-100,1869,0.9484255501447615
STAT,1911,40,35-39,1951,0.18358033209806718
STAT,1836,39,20-24,1875,0.5852163664137059
STAT,1916,16,50-100,1932,0.07527446611638436
SIM,1803,93,na,1896,13
STAT,1790,102,na,1892,0.05901690732363123
STAT,1811,47,20-24,1858,0.039954512329948594
STAT,1896,53,na,1949,2645.208180087935
STAT,1902,0,na,1902,3914.5715782252523
STAT,1814,96,na,1910,3.5428201277321243
STAT,1843,42,35-39,1885,1.345108480508417
SIM,1885,21,30-34,1906,29
STAT,1877,35,50-100,1912,1.2150075930334938
STAT,1886,33,40-44,1919,4.310314864200435
SIM,1864,28,30-34,1892,28
SIM,1923,29,50-100,1952,1
STAT,1916,10,na,1926,3970.202774509328
STAT,1800,60,na,1860,976.7245603609742
SIM,1865,15,20-24,1880,16
STAT,1869,48,15-19,1917,3.611784414593653E-4
SIM,1876,30,40-44,1906,4
SIM,1891,54,na,1945,2515
STAT,1851,29,45-49,1880,0.9396786836182536
STAT,1887,3,na,1890,2792.9981461093016
STAT,1946,18,15-19,1964,47.53855084788326
STAT,1801,53,35-39,1854,0.030447893033272003
SIM,1830,40,45-49,1870,2
SIM,1880,31,45-49,1911,2
SIM,1848,15,20-24,1863,18
STAT,1908,28,na,1936,3332.928666259025
STAT,1934,16,50-100,1950,0.47989745761205843
STAT,1872,31,50-100,1903,0.8723365555876496
STAT,1850,37,30-34,1887,3.811450667839845
STAT,1826,81,na,1907,295.1585351152091
SIM,1913,39,30-34,1952,1
STAT,1905,39,30-34,1944,1.5545910166710728
STAT,1917,26,45-49,1943,1.7173735591436292
STAT,1932,38,40-44,1970,1.898235505296439
SIM,1809,71,na,1880,625
STAT,1886,34,50-100,1920,0.9066970020354477
STAT,1831,24,15-19,1855,3.423742584123038
SIM,1827,42,40-44,1869,7
STAT,1906,23,15-19,1929,4.524144404864297
SIM,1923,32,na,1955,4002
STAT,1872,31,45-49,1903,1.6602534547542227
STAT,1877,22,30-34,1899,17.46168356936329
SIM,1819,77,na,1896,397
STAT,1878,34,45-49,1912,1.7002834806226543
STAT,1819,42,40-44,1861,4.415742497775918
STAT,1900,48,50-100,1948,0.17928616716930587
SIM,1897,37,25-29,1934,4
STAT,1935,15,35-39,1950,5.444026011496096
STAT,1907,42,50-100,1949,0.10166229858046093
STAT,1836,36,na,1872,1677.4443264759673
SIM,1923,38,40-44,1961,2
STAT,1950,21,30-34,1971,32.22353651606413
STAT,1820,52,40-44,1872,0.01668569728205763
STAT,1851,34,40-44,1885,3.2419716529475764
STAT,1904,17,30-34,1921,2.1594111608021014
STAT,1916,32,35-39,1948,8.912614405858285
STAT,1897,36,20-24,1933,0.9785897744727203
STAT,1833,25,25-29,1858,34.65442527952112
STAT,1912,16,15-19,1928,8.688748705178114
STAT,1873,91,na,1964,138.49860661235832
STAT,1853,22,45-49,1875,0.6110216668387937
SIM,1914,23,15-19,1937,3
STAT,1884,43,35-39,1927,1.678255035328015
STAT,1870,47,50-100,1917,0.22628453541022608
STAT,1893,8,na,1901,3115.857752524282
SIM,1886,34,45-49,1920,2
SIM,1839,18,30-34,1857,2
STAT,1835,21,50-100,1856,0.3406575129934674
STAT,1876,48,50-100,1924,0.23651311406251396
STAT,1915,30,30-34,1945,15.27897164721254
STAT,1936,30,na,1966,3473.694079866807
SIM,1912,17,30-34,1929,3
STAT,1932,35,25-29,1967,1.2519459541866083
STAT,1815,42,50-100,1857,2.9812940849381526
STAT,1922,43,15-19,1965,0.0016626577809197931
SIM,1819,43,45-49,1862,2
SIM,1849,17,25-29,1866,4
STAT,1806,82,na,1888,169.00587296202548
SIM,1919,27,na,1946,3807
STAT,1852,9,na,1861,2238.774612275247
SIM,1925,26,45-49,1951,5
STAT,1847,38,30-34,1885,4.026642320347437
STAT,1880,27,15-19,1907,0.4509796091353839
SIM,1905,15,15-19,1920,7
SIM,1920,16,15-19,1936,41
STAT,1871,34,50-100,1905,0.8507570312988666
STAT,1822,40,45-49,1862,2.3814990700884207
STAT,1857,73,na,1930,884.5797142224608
STAT,1869,54,na,1923,1914.7913255520732
SIM,1915,13,na,1928,3850
STAT,1823,42,50-100,1865,1.368693759764951
SIM,1931,31,na,1962,4675
STAT,1915,38,40-44,1953,1.421405807749714
SIM,1869,36,na,1905,2157
SIM,1889,16,20-24,1905,14
STAT,1867,24,40-44,1891,1.8367685170454917
SIM,1918,42,na,1960,3694
STAT,1868,1,na,1869,3203.493361995555
SIM,1838,38,30-34,1876,11
STAT,1898,16,20-24,1914,22.727405601438033
SIM,1853,32,40-44,1885,8
SIM,1964,2,na,1966,4487
STAT,1865,61,na,1926,1604.120553957323
STAT,1817,52,35-39,1869,0.018449390659693494
STAT,1897,29,30-34,1926,31.587809905482246
SIM,1924,32,35-39,1956,12
STAT,1825,102,na,1927,0.16575941618835047
STAT,1931,38,45-49,1969,0.8520717395074455
STAT,1906,48,40-44,1954,0.13117483161419155
STAT,1874,39,50-100,1913,1.1734935818646757
STAT,1936,31,na,1967,3471.7835481228813
SIM,1836,101,na,1937,2
SIM,1903,16,15-19,1919,7
STAT,1796,59,na,1855,1050.9780800000003
SIM,1947,4,na,1951,4055
SIM,1895,31,50-100,1926,1
STAT,1936,32,40-44,1968,3.5902052045293953
SIM,1886,16,15-19,1902,6
SIM,1900,28,45-49,1928,1
SIM,1952,0,na,1952,4537
SIM,1848,58,na,1906,1439
SIM,1923,30,30-34,1953,25
SIM,1863,1,na,1864,2950
STAT,1812,49,25-29,1861,0.18345999570943541
STAT,1901,37,20-24,1938,0.2200033729756666
SIM,1841,25,25-29,1866,46
SIM,1839,25,20-24,1864,9
STAT,1845,50,40-44,1895,0.0075220434947894
SIM,1861,102,na,1963,1
STAT,1887,36,15-19,1923,0.059612643839772606
STAT,1900,21,20-24,1921,90.58866465198304
SIM,1932,39,45-49,1971,1
STAT,1835,58,na,1893,1233.8819445914623
STAT,1837,22,na,1859,1766.8592719379158
STAT,1868,30,40-44,1898,3.943060829827842
STAT,1914,45,35-39,1959,0.12134251863795473
STAT,1930,23,50-100,1953,0.7938977225340937
SIM,1913,43,na,1956,3295
STAT,1827,32,45-49,1859,2.0291342847632357
SIM,1844,20,30-34,1864,17
SIM,1894,18,15-19,1912,8
STAT,1856,24,15-19,1880,2.794346459583035
STAT,1877,50,na,1927,2141.1197392317267
STAT,1945,19,30-34,1964,12.569910913976765
SIM,1890,25,20-24,1915,16
SIM,1854,20,40-44,1874,2
SIM,1862,25,na,1887,2097
STAT,1908,16,50-100,1924,0.06880771440408903
STAT,1848,53,25-29,1901,0.002510778365494925
STAT,1863,23,45-49,1886,0.5863649054595771
STAT,1919,22,50-100,1941,0.6806660442334995
STAT,1830,42,45-49,1872,1.138314789900725
STAT,1858,53,35-39,1911,0.0062822195101369365
SIM,1919,34,20-24,1953,3
STAT,1870,3,na,1873,2901.353365525163
SIM,1903,20,35-39,1923,11
SIM,1889,33,50-100,1922,4
STAT,1850,49,45-49,1899,0.16267557547831044
STAT,1937,26,25-29,1963,60.631426442198666
SIM,1919,29,35-39,1948,23
SIM,1875,24,40-44,1899,2
STAT,1862,51,35-39,1913,0.006970698920575033
STAT,1833,43,25-29,1876,0.46747471186089773
SIM,1899,49,na,1948,2850
SIM,1940,30,30-34,1970,24
STAT,1859,25,45-49,1884,0.8638946781806603
STAT,1796,66,na,1862,823.8200979298396
SIM,1832,59,na,1891,1216
SIM,1855,38,30-34,1893,8
SIM,1864,9,na,1873,2457
STAT,1845,32,40-44,1877,3.6320542540918366
STAT,1960,12,na,1972,4831.996526178753
STAT,1815,52,20-24,1867,0.0017162983331260005
SIM,1915,36,40-44,1951,2
STAT,1901,21,35-39,1922,7.739474984237698
SIM,1843,31,40-44,1874,5
STAT,1924,39,45-49,1963,0.7578649446564231
SIM,1884,72,na,1956,1179
STAT,1882,49,45-49,1931,0.2124134119524426
STAT,1862,29,20-24,1891,9.38608029025545
STAT,1874,26,25-29,1900,40.98351930614647
SIM,1890,68,na,1958,1871
STAT,1836,20,30-34,1856,18.04558437802927
STAT,1846,20,40-44,1866,1.8391499061069763
SIM,1887,17,na,1904,2643
STAT,1861,105,na,1966,0.15545452183253358
STAT,1882,25,20-24,1907,10.857300556944354
SIM,1821,46,50-100,1867,1
STAT,1886,18,15-19,1904,5.907899102635548
SIM,1881,39,na,1920,1953
SIM,1835,32,45-49,1867,1
STAT,1885,45,50-100,1930,0.23345815312042958
SIM,1859,32,30-34,1891,21
SIM,1823,34,20-24,1857,3
STAT,1846,35,15-19,1881,0.042213884520041184
SIM,1892,32,na,1924,2839
STAT,1894,23,45-49,1917,0.8447808409640271
STAT,1909,49,20-24,1958,0.009534454469303765
STAT,1878,16,15-19,1894,5.85068311643416
SIM,1870,29,20-24,1899,10
STAT,1880,30,40-44,1910,4.345339295357476
STAT,1932,30,30-34,1962,19.80865302934143
STAT,1825,37,na,1862,1615.4362004750128
STAT,1839,88,na,1927,91.53686843357121
SIM,1845,88,na,1933,93
SIM,1864,24,15-19,1888,2
STAT,1813,46,50-100,1859,0.7556247999989877
STAT,1808,56,na,1864,1122.7529882129681
STAT,1903,47,na,1950,3010.322572443021
SIM,1844,44,na,1888,1631
STAT,1887,21,40-44,1908,2.2081834246099503
STAT,1871,22,40-44,1893,1.951577522860532
SIM,1849,43,na,1892,1692
STAT,1835,31,40-44,1866,3.480818722676769
STAT,1915,32,20-24,1947,2.3465803727538965
STAT,1864,76,na,1940,799.9031032634964
STAT,1860,62,na,1922,1403.2582628566533
SIM,1796,59,na,1855,947
SIM,1849,47,na,1896,1671
SIM,1918,42,40-44,1960,1
STAT,1859,30,15-19,1889,0.1089286333768238
STAT,1837,33,45-49,1870,1.3659529249511988
STAT,1830,24,45-49,1854,1.5540372918658296
SIM,1931,27,30-34,1958,54
STAT,1870,50,30-34,1920,0.005589275824006901
SIM,1788,92,na,1880,8
STAT,1869,9,na,1878,2482.1016989999666
SIM,1879,13,na,1892,2551
STAT,1858,17,25-29,1875,4.909211112208505
SIM,1814,93,na,1907,8
SIM,1905,47,na,1952,3040
STAT,1846,51,na,1897,1525.402953172402
SIM,1820,36,50-100,1856,1
STAT,1923,27,30-34,1950,42.501629171952814
SIM,1882,26,25-29,1908,43
STAT,1907,36,40-44,1943,1.317251660446281
SIM,1931,23,15-19,1954,6
STAT,1902,15,45-49,1917,0.08748918439145659
STAT,1923,23,15-19,1946,5.833629651554439
STAT,1918,15,35-39,1933,0.8696477530956309
SIM,1937,28,40-44,1965,8
SIM,1893,24,na,1917,2935
SIM,1927,28,30-34,1955,45
STAT,1793,105,na,1898,0.005333036811474274
SIM,1917,21,40-44,1938,5
SIM,1897,38,na,1935,3015
STAT,1848,51,20-24,1899,5.341580647253593E-4
SIM,1870,21,na,1891,2191
SIM,1919,0,na,1919,4368
STAT,1909,21,40-44,1930,2.960319552892912
SIM,1926,33,35-39,1959,17
STAT,1818,55,na,1873,1179.7568036708774
SIM,1899,43,40-44,1942,3
SIM,1874,10,na,1884,2544
STAT,1887,49,na,1936,2327.752786412333
SIM,1856,33,20-24,1889,2
STAT,1890,48,40-44,1938,0.11014064859932254
STAT,1807,53,25-29,1860,0.012293274412768642
STAT,1926,16,na,1942,4274.169897435949
STAT,1857,69,na,1926,1092.9540758644123
STAT,1929,28,40-44,1957,5.508477076436529
STAT,1841,42,50-100,1883,0.7510957487097425
STAT,1839,46,25-29,1885,0.039635379806407085
SIM,1926,15,35-39,1941,4
SIM,1822,60,na,1882,1082
SIM,1923,32,20-24,1955,2
STAT,1847,43,na,1890,1688.299461008522
STAT,1919,28,30-34,1947,39.85417466266336
SIM,1845,33,45-49,1878,1
SIM,1945,24,20-24,1969,108
STAT,1857,18,25-29,1875,4.931091321157215
STAT,1848,33,20-24,1881,2.0452196300793264
STAT,1778,96,na,1874,1.3287282347112863
STAT,1815,108,na,1923,7.839799945206573E-4
STAT,1859,18,50-100,1877,0.042622630900384845
STAT,1918,33,35-39,1951,9.134784654836471
STAT,1841,42,20-24,1883,0.11290982058585217
SIM,1867,25,45-49,1892,1
STAT,1853,47,20-24,1900,0.008857805362644714
STAT,1779,101,na,1880,0.13174845397260349
STAT,1947,3,na,1950,4253.465436057171
SIM,1898,17,25-29,1915,13
STAT,1869,51,40-44,1920,0.009672930966164096
SIM,1876,76,na,1952,877
STAT,1830,44,15-19,1874,0.010217258530939771
SIM,1872,87,na,1959,192
SIM,1778,78,na,1856,269
SIM,1865,18,25-29,1883,9
STAT,1774,82,na,1856,144.74759429
STAT,1904,46,50-100,1950,0.18822854291932578
STAT,1883,48,45-49,1931,0.21575911996947203
STAT,1849,16,25-29,1865,5.0575155976315385
STAT,1871,45,15-19,1916,3.7835183696360256E-4
STAT,1905,17,15-19,1922,8.101584160848203
STAT,1882,18,30-34,1900,1.4613258679801806
STAT,1892,42,30-34,1934,1.3583908591815865
SIM,1827,96,na,1923,2
STAT,1870,17,na,1887,2360.1471681564235
STAT,1931,25,15-19,1956,0.8617778736308205
STAT,1890,31,50-100,1921,1.0626132008328473
STAT,1879,37,15-19,1916,0.05544881580461711
STAT,1849,108,na,1957,0.0020261620414094377
SIM,1854,39,30-34,1893,5
STAT,1941,22,20-24,1963,108.54689967798384
SIM,1843,22,na,1865,1919
SIM,1900,25,40-44,1925,4
STAT,1917,23,40-44,1940,3.365344610451362
STAT,1866,87,na,1953,153.45153075795443
STAT,1925,4,na,1929,4606.617551395547
STAT,1886,36,45-49,1922,1.9993239895323949
STAT,1879,29,50-100,1908,0.6271382459608729
STAT,1921,21,40-44,1942,3.598831284877532
STAT,1937,24,20-24,1961,102.20946899583421
STAT,1900,45,40-44,1945,0.12782681520703063
STAT,1889,34,20-24,1923,3.125511279340853
SIM,1876,33,45-49,1909,1
SIM,1864,21,na,1885,2154
SIM,1897,34,20-24,1931,3
SIM,1890,18,30-34,1908,3
STAT,1900,24,25-29,1924,74.5558263872416
SIM,1911,47,na,1958,3329
STAT,1846,39,30-34,1885,3.843480684745524
SIM,1859,31,30-34,1890,20
SIM,1894,36,45-49,1930,5
SIM,1930,37,40-44,1967,2
SIM,1904,29,40-44,1933,5
SIM,1858,20,25-29,1878,51
SIM,1862,40,40-44,1902,5
STAT,1824,47,30-34,1871,0.11375505151704625
STAT,1848,21,na,1869,1889.1068206717146
STAT,1931,31,na,1962,4684.469367374583
SIM,1858,51,na,1909,1743
STAT,1833,42,25-29,1875,0.4735184091637464
SIM,1895,21,40-44,1916,2
STAT,1868,33,45-49,1901,1.566249982328203
STAT,1884,68,na,1952,1426.633109160953
STAT,1888,28,50-100,1916,0.7113902626796024
STAT,1872,25,15-19,1897,0.4331204245268036
STAT,1927,27,15-19,1954,0.8108596182659996
SIM,1913,17,15-19,1930,9
STAT,1945,26,20-24,1971,18.92722561485866
STAT,1845,53,45-49,1898,0.010058144175784696
STAT,1863,69,na,1932,1218.6679620162276
STAT,1860,25,na,1885,1878.7911483829512
SIM,1818,82,na,1900,162
SIM,1919,36,25-29,1955,4
SIM,1945,19,35-39,1964,4
SIM,1867,65,na,1932,1470
SIM,1922,35,40-44,1957,2
SIM,1857,16,25-29,1873,6
STAT,1817,70,na,1887,699.9632320402891
STAT,1836,21,30-34,1857,14.952233502146813
SIM,1931,34,20-24,1965,3
STAT,1884,40,30-34,1924,1.0840905504029141
SIM,1953,18,30-34,1971,12
STAT,1945,18,30-34,1963,12.57431192314987
STAT,1784,96,na,1880,1.271223892252435
STAT,1898,19,25-29,1917,7.207902049936575
STAT,1923,34,20-24,1957,2.6384343399909413
STAT,1856,53,20-24,1909,5.372157898314621E-4
STAT,1866,45,40-44,1911,0.15059991845489099
STAT,1780,82,na,1862,133.88843006089388
STAT,1800,97,na,1897,2.141416088495881
SIM,1828,30,40-44,1858,4
SIM,1816,39,45-49,1855,2
STAT,1937,19,35-39,1956,3.844406165178487
STAT,1889,15,50-100,1904,0.057403327418553446
SIM,1844,21,30-34,1865,19
STAT,1842,54,35-39,1896,0.005962031406089206
SIM,1918,31,35-39,1949,16
STAT,1914,35,40-44,1949,1.4251475046425235
STAT,1938,16,15-19,1954,42.39092260886414
STAT,1856,40,50-100,1896,0.7895496574224841
STAT,1913,35,50-100,1948,0.3950492929107873
STAT,1854,37,15-19,1891,0.04043657572791088
SIM,1884,32,40-44,1916,4
STAT,1920,28,20-24,1948,18.851016486695716
SIM,1911,22,35-39,1933,8
STAT,1914,17,40-44,1931,0.2732844300766815
STAT,1868,40,35-39,1908,1.6497931537409665
STAT,1901,47,15-19,1948,2.9696080217046257E-4
STAT,1940,25,40-44,1965,4.493576725161274
STAT,1783,96,na,1879,1.273257617173828
STAT,1848,54,25-29,1902,0.002481578013104218
SIM,1836,21,35-39,1857,10
SIM,1843,59,na,1902,1389
STAT,1842,92,na,1934,29.659071760705938
SIM,1908,28,na,1936,3246
STAT,1843,77,na,1920,623.6203705609266
STAT,1874,43,25-29,1917,0.6155439573319077
SIM,1922,17,40-44,1939,1
SIM,1869,31,40-44,1900,5
STAT,1882,43,20-24,1925,0.14493429956419193
STAT,1812,46,20-24,1858,0.04013479045820224
STAT,1925,31,na,1956,4245.770789715995
STAT,1890,16,15-19,1906,6.871401393590885
STAT,1940,32,30-34,1972,15.40255104327623
STAT,1833,22,20-24,1855,59.920374143103984
SIM,1841,22,20-24,1863,52
STAT,1866,52,30-34,1918,0.005157005021919055
SIM,1839,28,25-29,1867,32
SIM,1817,41,40-44,1858,5
SIM,1926,13,na,1939,4478
SIM,1948,5,na,1953,4034
STAT,1903,22,35-39,1925,7.843078104040628
SIM,1857,73,na,1930,921
STAT,1919,29,30-34,1948,39.70910546689127
SIM,1896,53,na,1949,2676
STAT,1865,65,na,1930,1450.7395910335872
STAT,1826,74,na,1900,605.741624251288
SIM,1925,23,40-44,1948,6
STAT,1876,32,40-44,1908,4.2294061765580375
STAT,1897,25,15-19,1922,0.5771036377583593
STAT,1831,37,na,1868,1642.3553639290124
SIM,1864,2,na,1866,2863
STAT,1819,45,45-49,1864,0.43236955757009266
SIM,1879,50,na,1929,2139
STAT,1807,52,25-29,1859,0.012542056617468945
STAT,1825,96,na,1921,4.854845713851765
STAT,1953,17,15-19,1970,51.86432435127756
STAT,1920,46,20-24,1966,0.011569684344810077
SIM,1905,37,30-34,1942,2
STAT,1919,36,20-24,1955,0.26777903022267524
SIM,1927,29,30-34,1956,47
SIM,1946,16,15-19,1962,44
STAT,1842,47,45-49,1889,0.16808665145492216
STAT,1895,31,na,1926,2953.865990748269
STAT,1927,45,45-49,1972,0.2589685069409926
STAT,1900,31,50-100,1931,1.2057291433234956
SIM,1945,26,25-29,1971,65
SIM,1878,72,na,1950,1212
STAT,1845,17,15-19,1862,5.283391283983609
SIM,1839,27,50-100,1866,2
STAT,1938,34,15-19,1972,0.1218938278288653
SIM,1853,17,15-19,1870,6
STAT,1878,35,na,1913,2338.996445999409
SIM,1903,31,40-44,1934,4
STAT,1906,17,na,1923,3474.246674114142
STAT,1832,43,50-100,1875,0.7736352973683456
STAT,1906,43,35-39,1949,0.17172863910619174
SIM,1828,85,na,1913,158
SIM,1920,4,na,1924,4180
SIM,1887,18,25-29,1905,5
SIM,1918,17,na,1935,3754
STAT,1930,15,20-24,1945,166.3619278196827
SIM,1853,89,na,1942,65
SIM,1832,81,na,1913,311
SIM,1851,88,na,1939,70
SIM,1936,34,20-24,1970,1
STAT,1812,45,45-49,1857,0.8022835937937964
STAT,1934,31,40-44,1965,5.050333150463619
SIM,1834,34,35-39,1868,8
SIM,1877,93,na,1970,96
SIM,1916,36,45-49,1952,1
STAT,1877,21,30-34,1898,17.514401919139903
STAT,1858,52,na,1910,1588.3520583813008
SIM,1839,54,na,1893,1453
STAT,1855,48,20-24,1903,0.008392053583007148
STAT,1882,46,40-44,1928,0.1578224305146131
STAT,1911,48,na,1959,3275.7608335048167
STAT,1950,18,40-44,1968,1.5620027761159507
STAT,1952,17,50-100,1969,0.42416058625484093
STAT,1881,88,na,1969,329.5681370469151
SIM,1912,18,30-34,1930,2
STAT,1910,45,15-19,1955,3.261136513880136E-4
SIM,1823,37,25-29,1860,2
SIM,1885,22,30-34,1907,20
STAT,1880,17,20-24,1897,17.62213226016224
STAT,1867,23,50-100,1890,0.36059260437965146
STAT,1824,42,na,1866,1450.8156964859297
STAT,1826,41,40-44,1867,2.257659515274576
SIM,1912,26,na,1938,3338
SIM,1938,31,na,1969,3521
SIM,1879,19,na,1898,2487
STAT,1882,28,25-29,1910,38.74870685614643
STAT,1896,28,50-100,1924,0.7958652098892481
STAT,1900,41,25-29,1941,0.0587071674756915
STAT,1918,30,30-34,1948,15.942831231703945
SIM,1860,31,40-44,1891,5
SIM,1875,28,45-49,1903,1
SIM,1892,25,40-44,1917,4
STAT,1829,42,20-24,1871,0.13361347712085442
SIM,1928,26,25-29,1954,73
STAT,1873,39,25-29,1912,2.7330990583275847
SIM,1904,7,na,1911,3480
SIM,1909,22,40-44,1931,2
STAT,1893,25,35-39,1918,11.643823363002843
STAT,1844,32,45-49,1876,1.4639138049702158
SIM,1890,28,25-29,1918,51
SIM,1903,18,20-24,1921,24
SIM,1852,32,45-49,1884,1
STAT,1858,38,45-49,1896,1.471095771223845
STAT,1883,53,na,1936,1961.5923710257177
STAT,1832,52,20-24,1884,4.6536329355511863E-4
STAT,1871,20,50-100,1891,0.3841921504150305
SIM,1822,97,na,1919,4
STAT,1846,67,na,1913,1117.6934309534806
SIM,1854,21,na,1875,1952
STAT,1787,108,na,1895,6.828415413451597E-4
STAT,1920,44,45-49,1964,0.17307621928178596
STAT,1923,45,25-29,1968,0.058902985159670254
STAT,1854,51,45-49,1905,0.010500306304978623
STAT,1885,54,na,1939,1970.8431200637515
SIM,1823,45,na,1868,1363
SIM,1949,19,na,1968,4032
STAT,1826,34,35-39,1860,11.964574703180038
STAT,1854,86,na,1940,159.77175895421206
SIM,1928,11,na,1939,4722
STAT,1861,45,40-44,1906,0.1356413414048048
STAT,1896,16,na,1912,3161.045162758972
STAT,1935,37,15-19,1972,0.025365975497926928
SIM,1831,64,na,1895,1044
STAT,1842,19,40-44,1861,0.16529053439481
STAT,1835,32,35-39,1867,8.044414134682599
SIM,1851,31,30-34,1882,19
STAT,1914,47,25-29,1961,0.04968990969362072
SIM,1926,30,30-34,1956,25
STAT,1855,32,20-24,1887,1.949259910499422
SIM,1804,62,na,1866,874
SIM,1863,32,20-24,1895,3
STAT,1867,27,45-49,1894,0.9848394042273614
STAT,1871,49,30-34,1920,0.08876454877747626
SIM,1827,69,na,1896,790
SIM,1866,35,40-44,1901,3
SIM,1843,32,35-39,1875,10
STAT,1873,69,na,1942,1407.2395734869222
STAT,1920,20,45-49,1940,1.188807209721539
SIM,1910,20,40-44,1930,3
STAT,1808,93,na,1901,11.359480697809198
STAT,1857,43,25-29,1900,0.47479220007245054
STAT,1867,35,35-39,1902,6.333266694629331
SIM,1890,75,na,1965,1487
STAT,1922,37,50-100,1959,0.4513510201570091
STAT,1851,26,40-44,1877,2.590626779078259
STAT,1855,34,na,1889,1685.4742840851914
STAT,1873,46,15-19,1919,3.8465201471546195E-4
STAT,1884,25,40-44,1909,2.815450108014012
STAT,1911,19,15-19,1930,8.531436075175852
SIM,1842,36,na,1878,1710
STAT,1902,29,50-100,1931,0.8467095707329548
STAT,1852,31,40-44,1883,3.447101966803153
STAT,1899,39,45-49,1938,0.5514354935916077
SIM,1797,75,na,1872,419
SIM,1835,30,na,1865,1752
STAT,1853,50,30-34,1903,0.004477894936537191
STAT,1912,24,15-19,1936,4.989667926805737
SIM,1825,41,30-34,1866,1
STAT,1870,43,40-44,1913,2.0670454989988567
SIM,1942,26,45-49,1968,1
STAT,1837,19,30-34,1856,1.3497481686446797
STAT,1919,20,35-39,1939,9.798446308576223
SIM,1943,27,50-100,1970,1
STAT,1909,47,15-19,1956,3.1968869587093145E-4
STAT,1821,52,45-49,1873,0.021303575855959548
STAT,1861,22,35-39,1883,4.702949978176295
SIM,1804,72,na,1876,497
STAT,1904,25,20-24,1929,16.00187174271569
SIM,1920,24,15-19,1944,5
STAT,1873,59,na,1932,1863.6039560705578
STAT,1803,52,40-44,1855,0.030175290360686814
STAT,1863,16,20-24,1879,16.89873547789322
SIM,1825,34,40-44,1859,6
SIM,1875,35,35-39,1910,10
STAT,1870,38,45-49,1908,1.8361570890786225
SIM,1924,26,40-44,1950,8
STAT,1849,45,40-44,1894,0.12462962875775331
STAT,1841,43,15-19,1884,0.009693259529610407
STAT,1930,15,na,1945,4516.585545260167
SIM,1898,32,50-100,1930,3
SIM,1856,22,na,1878,1936
STAT,1928,34,20-24,1962,2.8777996103016306
STAT,1796,91,na,1887,20.29526699892593
SIM,1826,42,45-49,1868,1
SIM,1872,56,na,1928,1951
STAT,1830,48,30-34,1878,0.07003666482101865
SIM,1896,28,50-100,1924,1
STAT,1896,33,20-24,1929,3.360614013997793
SIM,1848,21,15-19,1869,6
STAT,1847,15,50-100,1862,0.04552575763577051
STAT,1881,38,20-24,1919,0.6996376693779331
SIM,1907,29,45-49,1936,1
STAT,1846,19,25-29,1865,4.960146494589884
SIM,1929,18,40-44,1947,3
STAT,1889,78,na,1967,1282.2564510166405
SIM,1875,49,50-100,1924,4
STAT,1847,15,na,1862,2133.042304550954
STAT,1895,17,50-100,1912,0.0603971776378
SIM,1871,16,20-24,1887,15
STAT,1885,33,45-49,1918,1.6343233820015572
SIM,1892,32,30-34,1924,29
STAT,1895,5,na,1900,3230.722605580601
STAT,1818,42,45-49,1860,3.590184257580962
STAT,1884,32,30-34,1916,16.299339684833242
SIM,1880,75,na,1955,1013
SIM,1925,34,45-49,1959,3
STAT,1893,73,na,1966,1723.9769470125416
STAT,1904,18,30-34,1922,2.1537535035607998
SIM,1905,39,35-39,1944,4
SIM,1854,19,25-29,1873,5
STAT,1864,46,20-24,1910,0.010160495411988602
SIM,1951,13,na,1964,4350
STAT,1882,50,50-100,1932,0.014082711015965243
STAT,1917,34,45-49,1951,1.543254153678309
SIM,1858,42,40-44,1900,4
SIM,1893,33,45-49,1926,6
STAT,1820,44,40-44,1864,3.8178145766538063
STAT,1817,41,30-34,1858,3.026060025199053
STAT,1900,49,20-24,1949,0.008686152345946914
SIM,1822,43,50-100,1865,1
SIM,1868,24,35-39,1892,7
STAT,1916,26,40-44,1942,4.568290966566353
SIM,1909,34,na,1943,3371
STAT,1933,26,40-44,1959,5.849310315085225
STAT,1839,16,15-19,1855,5.206990691482984
STAT,1859,19,35-39,1878,0.4745618242940822
SIM,1894,34,50-100,1928,1
STAT,1903,26,15-19,1929,0.6118838534208725
STAT,1813,50,45-49,1863,0.04361357627736992
STAT,1790,72,na,1862,511.9800849154566
SIM,1888,37,50-100,1925,1
SIM,1884,33,35-39,1917,13
STAT,1894,47,45-49,1941,0.1610203603473646
STAT,1910,22,40-44,1932,2.982055440843795
STAT,1913,23,20-24,1936,105.72258501044924
STAT,1882,44,15-19,1926,0.012523332397347868
STAT,1860,24,40-44,1884,1.625633682294787
SIM,1889,22,15-19,1911,2
STAT,1830,50,45-49,1880,0.01069594560041489
SIM,1811,44,na,1855,1367
STAT,1905,15,25-29,1920,7.771907480575773
SIM,1817,42,35-39,1859,5
SIM,1904,23,20-24,1927,94
STAT,1876,30,15-19,1906,0.14000022083185606
SIM,1893,30,40-44,1923,6
STAT,1804,50,35-39,1854,0.026648702028408102
STAT,1840,21,20-24,1861,61.47267967128414
STAT,1825,36,40-44,1861,5.837155190524221
SIM,1915,28,40-44,1943,9
STAT,1770,102,na,1872,0.05954554602872898
STAT,1938,15,20-24,1953,126.91284370505902
SIM,1841,88,na,1929,66
STAT,1805,75,na,1880,424.67590610719066
SIM,1916,41,40-44,1957,3
STAT,1838,17,25-29,1855,5.105138083526041
SIM,1880,85,na,1965,497
STAT,1814,47,20-24,1861,0.03255385719321758
SIM,1929,15,20-24,1944,155
SIM,1837,19,25-29,1856,9
SIM,1935,29,20-24,1964,29
STAT,1871,44,50-100,1915,0.9760578784909701
STAT,1934,26,45-49,1960,2.196464948072849
SIM,1949,18,40-44,1967,1
STAT,1920,26,15-19,1946,0.7341308728439746
STAT,1913,49,30-34,1962,0.0816974895057314
STAT,1932,32,50-100,1964,1.0383379403149087
STAT,1926,35,50-100,1961,0.48563505743560326
SIM,1867,19,35-39,1886,1
STAT,1875,27,40-44,1902,2.9073086645277617
STAT,1902,20,40-44,1922,2.794601186307316
SIM,1941,26,40-44,1967,1
STAT,1876,40,40-44,1916,2.2157528067328096
STAT,1915,29,50-100,1944,0.9521423077697821
SIM,1867,93,na,1960,39
STAT,1880,41,45-49,1921,1.494389276943255
STAT,1918,45,15-19,1963,3.720574330504984E-4
STAT,1924,28,40-44,1952,5.109308844054557
SIM,1822,81,na,1903,261
SIM,1846,17,25-29,1863,9
SIM,1912,25,20-24,1937,22
SIM,1913,15,25-29,1928,9
SIM,1847,16,15-19,1863,6
SIM,1814,62,na,1876,937
SIM,1833,36,40-44,1869,6
STAT,1927,29,20-24,1956,20.88205541090777
SIM,1898,20,15-19,1918,4
STAT,1810,66,na,1876,839.0170698635196
STAT,1929,42,25-29,1971,0.08736800350138672
STAT,1828,37,20-24,1865,0.732052148526213
STAT,1804,52,45-49,1856,0.04315611074296943
SIM,1852,36,na,1888,1839
STAT,1838,32,na,1870,1836.7139600910627
SIM,1817,69,na,1886,776
SIM,1927,20,35-39,1947,13
STAT,1875,54,na,1929,2032.264886581621
STAT,1911,4,na,1915,3802.2344490968667
STAT,1925,24,na,1949,4104.078473293545
STAT,1824,53,25-29,1877,0.003928801338848653
STAT,1810,48,15-19,1858,0.0013983887082231242
STAT,1895,28,20-24,1923,14.411622548655131
SIM,1921,23,20-24,1944,98
STAT,1821,50,35-39,1871,0.013151405784293604
SIM,1867,33,35-39,1900,8
STAT,1871,43,45-49,1914,1.3915432182976266
SIM,1932,28,40-44,1960,6
SIM,1918,11,na,1929,4052
SIM,1833,69,na,1902,919
STAT,1865,51,20-24,1916,6.364939651943431E-4
STAT,1891,44,25-29,1935,0.7407430875659767
STAT,1778,78,na,1856,253.15918097940002
SIM,1901,22,40-44,1923,3
SIM,1883,27,40-44,1910,3
SIM,1861,19,na,1880,2258
SIM,1909,44,na,1953,3228
STAT,1874,17,na,1891,2438.55235465776
SIM,1828,29,25-29,1857,35
STAT,1869,22,35-39,1891,5.336177683637308
STAT,1870,22,45-49,1892,0.6454893058067843
STAT,1885,49,45-49,1934,0.21748066768424365
SIM,1884,40,40-44,1924,4
SIM,1810,96,na,1906,5
STAT,1951,18,50-100,1969,0.4213565905487043
SIM,1844,37,na,1881,1788
SIM,1906,38,40-44,1944,4
STAT,1834,34,40-44,1868,3.3678339436283156
STAT,1908,41,40-44,1949,0.21982324757501287
STAT,1788,108,na,1896,5.372337236628039E-4
STAT,1807,51,50-100,1858,0.05456017802658811
STAT,1907,28,40-44,1935,4.141616199261792
SIM,1888,27,na,1915,2590
STAT,1843,31,30-34,1874,15.301363266749695
STAT,1786,97,na,1883,0.9276667785018122
STAT,1848,86,na,1934,159.84482429200662
STAT,1865,18,50-100,1883,0.043083526459303585
STAT,1881,22,20-24,1903,62.85811629449245
SIM,1893,23,35-39,1916,9
STAT,1823,45,20-24,1868,0.014733721412241834
STAT,1871,41,35-39,1912,1.7035793608917513
STAT,1881,54,25-29,1935,0.00314198014736195
STAT,1943,24,45-49,1967,1.1300821748910832
SIM,1931,29,35-39,1960,17
SIM,1869,29,na,1898,2154
STAT,1858,21,50-100,1879,0.34950457769894505
SIM,1902,30,45-49,1932,2
STAT,1908,36,45-49,1944,0.6057322547815597
STAT,1846,57,na,1903,1416.9354654860945
SIM,1859,74,na,1933,902
STAT,1890,36,20-24,1926,0.8946365978246307
SIM,1826,32,35-39,1858,10
SIM,1862,27,20-24,1889,13
SIM,1831,29,30-34,1860,25
SIM,1930,39,30-34,1969,3
STAT,1899,43,30-34,1942,0.10260926179764662
STAT,1866,71,na,1937,1162.5966985095793
STAT,1922,39,30-34,1961,1.9551240086246944
STAT,1923,29,35-39,1952,16.168921159317094
STAT,1850,43,25-29,1893,0.44881431440453956
STAT,1909,7,na,1916,3690.104158518173
SIM,1877,22,35-39,1899,12
SIM,1950,16,40-44,1966,2
STAT,1953,19,20-24,1972,154.83267234174227
STAT,1841,58,na,1899,1353.0555418600466
STAT,1866,37,40-44,1903,3.8127569489537017
STAT,1942,16,40-44,1958,1.3811866022440642
STAT,1854,27,20-24,1881,8.855996383781203
SIM,1851,24,40-44,1875,2
SIM,1924,11,na,1935,4451
SIM,1853,73,na,1926,906
SIM,1863,17,25-29,1880,8
STAT,1855,17,25-29,1872,4.773521815461116
STAT,1862,53,45-49,1915,0.011506882082820583
STAT,1865,44,15-19,1909,0.011694956955336488
SIM,1874,41,na,1915,2222
SIM,1946,15,20-24,1961,118
STAT,1840,45,20-24,1885,0.008646096861195716
STAT,1843,24,40-44,1867,1.8600427834847328
STAT,1940,21,25-29,1961,88.91240889510003
SIM,1864,38,25-29,1902,2
STAT,1823,94,na,1917,10.517435509443079
SIM,1914,46,50-100,1960,1
STAT,1876,33,35-39,1909,9.834797066724427
SIM,1867,40,40-44,1907,7
STAT,1860,31,30-34,1891,13.459647696855392
STAT,1853,39,na,1892,1729.6262192928718
STAT,1927,35,15-19,1962,0.022596632593030415
SIM,1892,28,45-49,1920,1
STAT,1872,48,20-24,1920,0.011235457754808761
SIM,1933,36,45-49,1969,1
STAT,1815,75,na,1890,440.6110577473869
SIM,1882,70,na,1952,1238
STAT,1935,24,na,1959,4694.372691608617
STAT,1944,26,50-100,1970,1.0167147756363706
STAT,1850,40,20-24,1890,0.11293289264387438
SIM,1838,37,na,1875,1610
STAT,1911,30,45-49,1941,1.458854468993472
STAT,1914,31,25-29,1945,8.823455854294412
SIM,1835,31,30-34,1866,19
STAT,1856,38,25-29,1894,2.119734394449509
SIM,1851,34,35-39,1885,12
STAT,1891,19,50-100,1910,0.05697931731449491
STAT,1851,49,15-19,1900,2.872018978685956E-4
SIM,1865,37,50-100,1902,3
STAT,1894,22,30-34,1916,21.6458473861984
STAT,1934,34,45-49,1968,2.026976954090009
SIM,1868,21,30-34,1889,21
SIM,1887,15,20-24,1902,23
STAT,1924,34,35-39,1958,10.059851326945962
STAT,1932,10,na,1942,4971.57454227943
SIM,1862,56,na,1918,1762
SIM,1930,30,20-24,1960,3
SIM,1907,49,na,1956,3083
STAT,1846,42,20-24,1888,0.11333026951938853
STAT,1898,40,45-49,1938,0.134249273438138
STAT,1932,7,na,1939,5000.421740764126
SIM,1916,33,40-44,1949,6
STAT,1936,19,20-24,1955,121.94132869326901
STAT,1840,46,35-39,1886,0.09958703692125874
SIM,1869,23,40-44,1892,5
SIM,1834,31,30-34,1865,19
SIM,1848,21,na,1869,1942
STAT,1812,61,na,1873,1003.3557889577352
STAT,1869,38,20-24,1907,0.7013963177093698
STAT,1831,108,na,1939,0.0011171042015349737
SIM,1865,21,15-19,1886,5
STAT,1884,28,45-49,1912,1.0328635428891382
STAT,1912,51,na,1963,3292.155448975649
STAT,1916,43,40-44,1959,0.24175489575702563
STAT,1834,41,30-34,1875,0.8689688020222737
SIM,1934,24,45-49,1958,2
STAT,1881,24,na,1905,2143.759989955057
SIM,1792,66,na,1858,721
STAT,1908,12,na,1920,3618.175061327553
STAT,1893,22,30-34,1915,21.350087830073036
STAT,1877,54,35-39,1931,0.00820752326368617
STAT,1831,53,30-34,1884,0.0037745031962721975
STAT,1881,46,20-24,1927,0.010976805101985693
STAT,1925,36,45-49,1961,0.7737604899726357
SIM,1811,44,40-44,1855,9
SIM,1944,19,20-24,1963,134
STAT,1921,18,30-34,1939,13.091948203226089
SIM,1893,40,35-39,1933,5
STAT,1898,44,25-29,1942,0.05625659950492809
STAT,1903,44,45-49,1947,0.13779955294039173
STAT,1812,42,40-44,1854,8.449078747985498
SIM,1909,25,45-49,1934,1
STAT,1811,54,40-44,1865,0.032112644759294894
STAT,1800,76,na,1876,380.93887486314173
STAT,1840,102,na,1942,0.20417196063673598
STAT,1899,36,40-44,1935,5.694450528642592
STAT,1920,41,40-44,1961,0.2613580987099272
STAT,1855,53,50-100,1908,0.010524581919722617
STAT,1922,30,20-24,1952,2.6246480480165038
SIM,1908,34,45-49,1942,3
SIM,1870,36,45-49,1906,1
STAT,1865,34,na,1899,2030.9778155901176
SIM,1842,34,40-44,1876,5
STAT,1922,47,30-34,1969,0.09675448052478444
SIM,1825,37,45-49,1862,1
SIM,1820,42,40-44,1862,5
STAT,1866,9,na,1875,2393.483913881074
STAT,1827,60,na,1887,1107.3943677457858
STAT,1873,36,20-24,1909,0.7427310991335653
STAT,1857,21,15-19,1878,2.8569210199237696
SIM,1842,41,30-34,1883,3
SIM,1847,89,na,1936,57
SIM,1889,19,na,1908,2970
STAT,1884,35,35-39,1919,6.665561221396261
SIM,1866,38,45-49,1904,3
SIM,1825,44,35-39,1869,2
SIM,1922,16,na,1938,4067
STAT,1912,42,45-49,1954,0.15160341541221248
STAT,1926,24,45-49,1950,1.2834138727161006
STAT,1864,49,25-29,1913,0.04761689425814721
SIM,1802,67,na,1869,780
STAT,1881,47,35-39,1928,0.12710481235146537
STAT,1824,50,20-24,1874,8.688253895648683E-4
SIM,1875,32,30-34,1907,18
STAT,1826,31,30-34,1857,24.575466050770554
STAT,1885,30,40-44,1915,4.114436765236456
SIM,1932,34,35-39,1966,17
STAT,1844,53,40-44,1897,0.007271844085882955
SIM,1837,89,na,1926,44
SIM,1850,32,25-29,1882,13
STAT,1817,44,35-39,1861,4.222793872003621
STAT,1846,16,20-24,1862,15.795432985551667
SIM,1827,90,na,1917,31
STAT,1879,78,na,1957,846.5659773202368
SIM,1845,54,na,1899,1480
STAT,1938,18,40-44,1956,1.3028717357976036
STAT,1928,18,30-34,1946,14.47224462693733
SIM,1789,84,na,1873,79
STAT,1830,42,na,1872,1532.1453619351246
SIM,1861,21,30-34,1882,15
STAT,1858,35,40-44,1893,3.277317993216683
STAT,1865,54,25-29,1919,0.00295700754852764
STAT,1867,40,30-34,1907,1.0300459854438087
SIM,1816,44,40-44,1860,6
SIM,1883,31,25-29,1914,13
STAT,1870,35,40-44,1905,4.090604285677115
SIM,1892,35,35-39,1927,13
SIM,1922,31,25-29,1953,14
STAT,1885,40,35-39,1925,1.7214975623603554
STAT,1875,35,40-44,1910,4.288881755200694
STAT,1891,41,20-24,1932,0.18654139989433424
STAT,1906,45,25-29,1951,0.04514077621550487
SIM,1901,25,45-49,1926,1
STAT,1876,17,45-49,1893,0.063706125567982
SIM,1920,42,45-49,1962,1
STAT,1892,27,40-44,1919,3.5437724250709364
STAT,1891,54,na,1945,2448.5451049900444
STAT,1858,112,na,1970,3.0759932669012144E-4
STAT,1918,37,15-19,1955,0.019120862502649667
STAT,1853,21,30-34,1874,15.72072541074146
STAT,1928,37,25-29,1965,1.1756351663036795
SIM,1772,83,na,1855,86
SIM,1870,85,na,1955,195
STAT,1842,32,25-29,1874,8.811196712331794
STAT,1875,31,25-29,1906,9.981461498599472
SIM,1827,47,50-100,1874,3
SIM,1861,43,40-44,1904,8
STAT,1831,47,20-24,1878,0.008822854928822252
STAT,1857,112,na,1969,2.636307611139629E-4
STAT,1863,41,45-49,1904,1.2484538463495236
SIM,1918,29,20-24,1947,18
STAT,1840,53,25-29,1893,0.002427111166799497
SIM,1871,41,45-49,1912,1
SIM,1885,84,na,1969,562
STAT,1921,25,20-24,1946,19.350948907047265
STAT,1941,28,40-44,1969,4.552483202687889
SIM,1882,18,na,1900,2309
SIM,1875,25,40-44,1900,2
SIM,1925,36,50-100,1961,1
STAT,1882,36,na,1918,2176.15596560863
STAT,1920,25,na,1945,3908.692802989961
STAT,1933,18,40-44,1951,1.7642083185967419
SIM,1888,17,15-19,1905,7
STAT,1862,20,na,1882,1979.3138548424683
SIM,1897,48,na,1945,2831
STAT,1819,47,50-100,1866,0.4367172529407579
STAT,1935,30,30-34,1965,20.61384249900536
STAT,1934,35,na,1969,4912.974561687164
SIM,1941,18,40-44,1959,2
STAT,1871,51,45-49,1922,0.013656536537494608
STAT,1875,42,30-34,1917,1.114423004923881
SIM,1871,19,25-29,1890,5
STAT,1853,22,50-100,1875,0.35732262580144364
STAT,1872,54,30-34,1926,0.0054890087942898605
STAT,1841,45,50-100,1886,0.1731803386354345
STAT,1913,26,25-29,1939,62.15503364892464
SIM,1905,9,na,1914,3542
SIM,1875,42,40-44,1917,8
STAT,1859,16,30-34,1875,1.403136814458981
SIM,1866,22,na,1888,2107
STAT,1873,53,20-24,1926,6.962358146078409E-4
STAT,1861,72,na,1933,990.7115770347589
STAT,1883,33,25-29,1916,9.443270997823358
STAT,1873,53,na,1926,2031.5396104447389
STAT,1886,30,25-29,1916,10.305567825918608
SIM,1891,33,25-29,1924,16
STAT,1948,24,50-100,1972,0.7132878092741338
SIM,1867,16,30-34,1883,1
SIM,1829,54,na,1883,1207
SIM,1870,43,35-39,1913,4
SIM,1936,18,30-34,1954,11
STAT,1862,43,35-39,1905,1.448681155091216
STAT,1877,47,45-49,1924,0.23027621881111696
SIM,1779,84,na,1863,94
SIM,1782,83,na,1865,105
STAT,1906,27,na,1933,3282.9229897353443
STAT,1843,27,45-49,1870,0.9858155848975476
STAT,1864,86,na,1950,187.33245018931257
SIM,1854,16,20-24,1870,14
STAT,1903,13,na,1916,3465.597612708297
SIM,1851,27,45-49,1878,4
SIM,1939,15,30-34,1954,13
STAT,1908,44,45-49,1952,0.14364336487923085
SIM,1944,7,na,1951,3977
STAT,1802,61,na,1863,918.4400158619766
STAT,1863,19,25-29,1882,4.829015125275558
STAT,1870,46,45-49,1916,0.2190782428974231
STAT,1939,25,50-100,1964,0.9460024640516841
SIM,1842,30,25-29,1872,17
SIM,1883,42,30-34,1925,4
STAT,1817,60,na,1877,1016.2693038574733
STAT,1896,26,na,1922,2989.876511061652
SIM,1942,23,40-44,1965,4
STAT,1808,51,30-34,1859,0.022088308191588264
STAT,1927,15,45-49,1942,0.5895589210556756
SIM,1815,39,40-44,1854,5
SIM,1868,7,na,1875,2490
STAT,1871,5,na,1876,2604.609712372565
SIM,1922,37,30-34,1959,2
STAT,1825,58,na,1883,1197.8361258090852
STAT,1873,28,50-100,1901,0.6112471679745471
STAT,1934,23,40-44,1957,4.2671995811673
STAT,1936,29,30-34,1965,35.38318150175937
STAT,1946,16,25-29,1962,45.420415861498576
SIM,1812,91,na,1903,17
SIM,1876,32,30-34,1908,30
SIM,1848,37,na,1885,1808
STAT,1899,46,35-39,1945,0.10252804586651536
STAT,1921,26,50-100,1947,1.0516545225186902
STAT,1867,42,40-44,1909,1.9926524480561743
STAT,1868,32,30-34,1900,15.748264103829719
SIM,1899,28,45-49,1927,3
STAT,1914,37,30-34,1951,1.718783212053499
STAT,1841,27,25-29,1868,35.94770212334836
STAT,1834,30,25-29,1864,8.29160130386833
STAT,1925,19,45-49,1944,0.5670825202065227
SIM,1954,16,25-29,1970,59
STAT,1831,58,na,1889,1208.9585328777962
STAT,1833,29,40-44,1862,2.372717909752014
SIM,1906,34,25-29,1940,6
STAT,1841,17,50-100,1858,0.04323177890312801
STAT,1888,52,na,1940,2390.230340615778
SIM,1895,17,20-24,1912,23
STAT,1918,12,na,1930,4074.0834873816043
STAT,1885,46,40-44,1931,0.16158738399980535
STAT,1817,37,45-49,1854,6.912887618791545
STAT,1821,75,na,1896,555.9081647152883
STAT,1858,86,na,1944,164.54994873272102
STAT,1886,20,50-100,1906,0.4094540017553942
STAT,1801,105,na,1906,0.011157090183239095
STAT,1900,70,na,1970,2192.8899373845798
SIM,1924,43,40-44,1967,1
STAT,1849,52,30-34,1901,0.004267702320012567
STAT,1821,35,45-49,1856,4.7401968833260595
STAT,1890,46,15-19,1936,2.613522777523472E-4
STAT,1936,36,20-24,1972,0.2446575103002041
SIM,1851,19,na,1870,2061
SIM,1918,39,30-34,1957,3
STAT,1926,10,na,1936,4603.688699202704
STAT,1894,21,na,1915,2882.732011921997
STAT,1859,43,45-49,1902,1.120202789908085
SIM,1892,60,na,1952,2282
SIM,1935,31,35-39,1966,13
SIM,1929,16,15-19,1945,54
STAT,1816,42,25-29,1858,1.9202244116115055
STAT,1856,57,na,1913,1486.9138973735626
STAT,1887,17,20-24,1904,18.73013179163293
STAT,1944,27,15-19,1971,0.7207815904409127
SIM,1941,29,45-49,1970,1
STAT,1827,31,30-34,1858,21.240325560132888
SIM,1867,43,45-49,1910,3
SIM,1935,15,45-49,1950,2
STAT,1908,33,40-44,1941,3.47404433557047
SIM,1820,96,na,1916,2
SIM,1928,19,35-39,1947,5
SIM,1921,26,25-29,1947,76
STAT,1893,30,30-34,1923,21.095715091182196
SIM,1933,19,45-49,1952,1
SIM,1841,29,40-44,1870,6
STAT,1893,32,40-44,1925,5.1980578500999055
STAT,1914,44,20-24,1958,0.016473656453565185
STAT,1890,39,25-29,1929,3.2920803315119915
STAT,1926,41,45-49,1967,0.19412812429919987
STAT,1871,40,40-44,1911,2.127800355216708
STAT,1764,102,na,1866,0.058062960432251856
STAT,1901,15,40-44,1916,0.24297399971491243
SIM,1936,30,na,1966,2867
SIM,1801,98,na,1899,1
SIM,1904,35,na,1939,3189
STAT,1933,29,45-49,1962,2.1649212342970596
SIM,1849,74,na,1923,769
STAT,1885,20,30-34,1905,16.86458010696212
SIM,1828,26,20-24,1854,11
SIM,1834,41,40-44,1875,10
SIM,1867,35,na,1902,2051
SIM,1923,4,na,1927,4358
SIM,1919,34,na,1953,3841
STAT,1927,31,35-39,1958,10.626908882573382
STAT,1859,50,35-39,1909,0.006583853411775664
SIM,1893,20,30-34,1913,27
STAT,1876,71,na,1947,1301.7715045477544
SIM,1854,37,na,1891,1833
SIM,1859,32,50-100,1891,4
STAT,1821,42,35-39,1863,3.0223124057823973
SIM,1929,18,25-29,1947,59
SIM,1866,18,na,1884,2275
STAT,1926,41,na,1967,4332.023356908507
STAT,1823,48,25-29,1871,0.06772709426562534
SIM,1850,62,na,1912,1337
STAT,1843,34,35-39,1877,8.602957422693748
STAT,1897,39,25-29,1936,0.777246568740346
SIM,1852,31,30-34,1883,11
SIM,1873,35,na,1908,2270
SIM,1899,40,na,1939,3024
SIM,1840,19,30-34,1859,3
STAT,1869,52,35-39,1921,0.007830531439145886
STAT,1921,32,45-49,1953,1.6544377022580359
STAT,1840,35,na,1875,1801.2057747202643
STAT,1763,102,na,1865,0.028453866721675904
STAT,1903,41,40-44,1944,0.21088022594854725
STAT,1906,42,20-24,1948,0.015151955631132207
STAT,1941,14,na,1955,3820.566717967578
STAT,1838,93,na,1931,19.932429196248094
STAT,1783,86,na,1869,56.39015641107348
SIM,1920,20,35-39,1940,15
SIM,1837,20,40-44,1857,2
SIM,1883,55,na,1938,1936
STAT,1876,50,35-39,1926,0.008516685949256995
SIM,1919,31,50-100,1950,1
STAT,1949,20,30-34,1969,31.707102792590266
STAT,1931,31,25-29,1962,11.447966832806852
SIM,1908,31,40-44,1939,6
STAT,1839,38,25-29,1877,2.2704486435537525
STAT,1883,37,40-44,1920,4.052985884562342
STAT,1808,47,45-49,1855,0.8984153700921469
STAT,1802,95,na,1897,4.535607598913877
STAT,1874,21,15-19,1895,3.1949284570500764
SIM,1891,37,40-44,1928,8
SIM,1847,38,25-29,1885,1
STAT,1860,20,25-29,1880,50.51071935816271
STAT,1860,34,35-39,1894,7.708585139087193
SIM,1870,33,40-44,1903,8
STAT,1879,26,50-100,1905,0.6338204526205862
SIM,1891,16,25-29,1907,8
STAT,1913,45,30-34,1958,0.0825659571408556
STAT,1839,24,15-19,1863,2.7859093352515623
STAT,1897,17,15-19,1914,7.497802641522797
SIM,1906,64,na,1970,2730
STAT,1816,46,40-44,1862,0.45803398404127155
STAT,1814,53,30-34,1867,0.015139994296226216
STAT,1892,23,25-29,1915,67.51268626094783
STAT,1844,31,30-34,1875,14.81017227368688
STAT,1869,85,na,1954,250.67860939172874
STAT,1913,45,15-19,1958,3.411813535900886E-4
SIM,1889,1,na,1890,3152
STAT,1840,48,25-29,1888,0.0399364203496591
STAT,1945,14,na,1959,4052.184897457764
STAT,1872,32,20-24,1904,2.563046532973343
STAT,1922,45,40-44,1967,0.1719248795640516
STAT,1824,39,50-100,1863,1.6704746839239308
STAT,1891,42,50-100,1933,1.2337954201310026
SIM,1887,55,na,1942,2130
SIM,1941,24,35-39,1965,10
STAT,1841,102,na,1943,0.20058785848587612
STAT,1936,25,15-19,1961,0.6386862650111901
STAT,1924,24,25-29,1948,102.33170540323539
STAT,1933,3,na,1936,5129.380831361524
SIM,1932,24,25-29,1956,134
STAT,1825,32,25-29,1857,17.992310198135037
STAT,1834,44,35-39,1878,1.3170833668307722
SIM,1875,43,35-39,1918,4
STAT,1830,26,20-24,1856,12.378188779778682
SIM,1871,39,30-34,1910,6
STAT,1846,26,na,1872,1858.5347530768458
SIM,1902,64,na,1966,2570
STAT,1861,50,50-100,1911,0.012018011698835197
STAT,1856,20,na,1876,1864.0019378211246
SIM,1782,76,na,1858,320
STAT,1853,43,40-44,1896,1.6560307390454412
SIM,1833,32,25-29,1865,11
SIM,1906,30,na,1936,3410
STAT,1932,32,20-24,1964,3.063249190637796
SIM,1798,61,na,1859,925
SIM,1927,25,na,1952,4198
STAT,1827,53,na,1880,1272.0186999738594
SIM,1906,5,na,1911,3683
STAT,1867,43,35-39,1910,1.5945899178329683
SIM,1851,44,45-49,1895,3
STAT,1798,102,na,1900,0.0813155580639518
STAT,1864,48,na,1912,1875.6966852796447
SIM,1851,23,na,1874,1883
STAT,1858,52,40-44,1910,0.007766052691795765
STAT,1851,75,na,1926,754.9214619136125
STAT,1912,28,30-34,1940,36.34044241630911
SIM,1884,43,45-49,1927,2
STAT,1814,80,na,1894,255.23032462773287
STAT,1926,40,30-34,1966,0.14932123934346458
STAT,1848,90,na,1938,56.798599883320655
SIM,1930,38,35-39,1968,3
STAT,1840,50,20-24,1890,5.212843395276861E-4
SIM,1862,94,na,1956,16
SIM,1883,38,45-49,1921,3
SIM,1913,49,na,1962,3238
STAT,1848,31,15-19,1879,0.12089147108769194
STAT,1926,21,40-44,1947,3.8710430964337013
STAT,1922,38,35-39,1960,2.597568579667502
SIM,1813,83,na,1896,137
STAT,1773,105,na,1878,0.014152181767984691
SIM,1937,18,15-19,1955,37
STAT,1919,47,25-29,1966,0.05435294604445775
SIM,1794,61,na,1855,908
STAT,1851,22,25-29,1873,50.131290452781144
STAT,1876,43,45-49,1919,1.4490625420160483
STAT,1912,20,35-39,1932,8.573619358307212
SIM,1880,32,20-24,1912,2
STAT,1827,53,40-44,1880,0.00872920245562672
STAT,1904,33,20-24,1937,2.0939422205537035
SIM,1882,18,25-29,1900,5
SIM,1920,27,50-100,1947,2
STAT,1904,47,30-34,1951,0.0736328725146844
STAT,1843,44,45-49,1887,1.083609492178755
STAT,1875,38,45-49,1913,1.9251582624615007
STAT,1894,44,40-44,1938,0.18724842770549505
SIM,1837,80,na,1917,339
STAT,1837,52,20-24,1889,4.6752146690249777E-4
STAT,1870,21,30-34,1891,16.538066653214887
STAT,1880,36,50-100,1916,1.2262480993185967
STAT,1840,43,30-34,1883,0.8245607602654782
STAT,1882,27,50-100,1909,0.5880372733005416
SIM,1807,76,na,1883,332
SIM,1895,74,na,1969,1754
STAT,1834,25,50-100,1859,0.5267563408343213
STAT,1846,51,50-100,1897,0.010699481874101212
SIM,1915,34,35-39,1949,9
STAT,1840,32,na,1872,1838.3302031516387
STAT,1852,20,na,1872,1957.8320765319577
STAT,1882,67,na,1949,1457.2116037554008
STAT,1916,47,na,1963,3559.615050778944
SIM,1919,18,30-34,1937,20
SIM,1934,21,40-44,1955,4
STAT,1891,15,20-24,1906,20.826406025664742
STAT,1842,36,40-44,1878,3.6949676036548413
STAT,1837,53,na,1890,1337.380224305779
STAT,1853,39,20-24,1892,0.5659139928172755
SIM,1920,28,30-34,1948,49
STAT,1895,37,na,1932,2904.4481523090913
SIM,1921,37,na,1958,3867
STAT,1795,71,na,1866,581.6361610502215
STAT,1907,34,35-39,1941,7.99899206224639
STAT,1833,60,na,1893,1157.829788110369
STAT,1874,48,na,1922,2144.997281452188
SIM,1779,94,na,1873,5
SIM,1782,73,na,1855,427
SIM,1850,36,40-44,1886,3
STAT,1935,27,50-100,1962,1.2816877785513208
STAT,1886,38,20-24,1924,0.7655866535906872
STAT,1905,41,25-29,1946,0.06115141796207507
STAT,1865,28,25-29,1893,36.18561293266902
STAT,1863,35,15-19,1898,0.0470743759778845
SIM,1868,88,na,1956,105
STAT,1819,47,20-24,1866,0.021337977372876377
STAT,1839,15,50-100,1854,0.04324029046619452
STAT,1862,40,30-34,1902,0.9357943326380135
STAT,1918,39,20-24,1957,0.26191848167841797
SIM,1849,16,na,1865,2069
SIM,1868,82,na,1950,364
STAT,1930,23,20-24,1953,134.1607619121654
STAT,1873,16,15-19,1889,5.724406913405234
SIM,1878,17,20-24,1895,20
STAT,1887,43,20-24,1930,0.1665733716078832
STAT,1808,54,35-39,1862,0.030081225413907616
SIM,1834,42,35-39,1876,2
STAT,1937,18,50-100,1955,0.34337066659951937
SIM,1850,15,25-29,1865,7
SIM,1858,40,30-34,1898,4
STAT,1954,0,na,1954,4960.686224325649
SIM,1887,48,na,1935,2322
STAT,1884,45,45-49,1929,0.22251182357629296
STAT,1879,15,20-24,1894,17.587054794958732
STAT,1893,33,35-39,1926,12.087239192153028
SIM,1889,40,na,1929,2739
STAT,1929,18,15-19,1947,54.57508475692316
SIM,1946,18,40-44,1964,1
STAT,1850,35,na,1885,1720.234939371961
STAT,1845,37,20-24,1882,0.5704952663414344
STAT,1895,40,50-100,1935,1.315535284155427
STAT,1898,22,15-19,1920,4.218880782920934
STAT,1910,25,45-49,1935,1.599690057031315
SIM,1843,42,45-49,1885,3
SIM,1890,37,na,1927,2822
SIM,1848,68,na,1916,1087
SIM,1837,90,na,1927,35
SIM,1821,40,35-39,1861,2
SIM,1881,16,15-19,1897,6
SIM,1843,80,na,1923,407
STAT,1840,42,na,1882,1679.0328455609365
STAT,1846,20,na,1866,1887.0912874304006
STAT,1833,54,50-100,1887,0.009103067818129308
STAT,1815,68,na,1883,762.5379622094708
STAT,1912,35,20-24,1947,0.245308598249461
SIM,1879,29,na,1908,2349
STAT,1878,46,15-19,1924,3.944975596312736E-4
SIM,1899,43,na,1942,2965
STAT,1880,31,35-39,1911,10.107424863649396
STAT,1862,47,15-19,1909,3.2083211985017526E-4
STAT,1920,22,na,1942,3835.442496743008
STAT,1927,22,50-100,1949,0.7659348058364682
SIM,1866,0,na,1866,3189
STAT,1890,30,15-19,1920,0.16580686178107754
STAT,1842,53,50-100,1895,0.010582177213054586
SIM,1788,98,na,1886,2
STAT,1820,80,na,1900,329.54753689595174
SIM,1914,29,35-39,1943,15
SIM,1907,32,35-39,1939,7
STAT,1820,105,na,1925,0.015620130713226408
STAT,1863,39,30-34,1902,4.38121054196888
SIM,1905,17,25-29,1922,12
STAT,1858,45,35-39,1903,0.10486326829954898
STAT,1906,29,35-39,1935,13.178287670554806
SIM,1919,37,na,1956,3828
STAT,1822,48,50-100,1870,0.3377449675965803
SIM,1885,44,40-44,1929,4
SIM,1874,30,20-24,1904,2
STAT,1812,50,45-49,1862,0.04753733053774125
STAT,1871,27,20-24,1898,10.987013892859025
SIM,1868,41,na,1909,2098
STAT,1842,15,25-29,1857,5.243504535003107
STAT,1877,44,40-44,1921,2.1752398895238905
SIM,1903,28,30-34,1931,37
STAT,1832,51,25-29,1883,0.0022784256225446627
SIM,1877,55,na,1932,2033
STAT,1915,19,35-39,1934,0.825132385883513
STAT,1909,40,30-34,1949,0.11421596702668636
STAT,1877,51,30-34,1928,0.005863305431794425
STAT,1844,93,na,1937,20.516494669793293
STAT,1900,45,50-100,1945,0.18337772074719122
SIM,1831,95,na,1926,8
SIM,1862,41,35-39,1903,5
SIM,1856,56,na,1912,1596
STAT,1852,33,30-34,1885,13.59286861583034
STAT,1878,53,20-24,1931,7.140566519425657E-4
STAT,1906,46,50-100,1952,0.1911163801951255
STAT,1925,16,40-44,1941,1.600313336459402
STAT,1865,92,na,1957,45.989809845231775
STAT,1827,49,20-24,1876,0.010237576565157188
STAT,1889,32,15-19,1921,0.16608608332203886
STAT,1921,47,30-34,1968,0.09494543509383412
STAT,1864,40,15-19,1904,0.011777439247699502
STAT,1857,47,40-44,1904,0.12690691501579687
SIM,1933,16,40-44,1949,6
STAT,1837,22,40-44,1859,1.7220339295656726
STAT,1847,26,15-19,1873,0.40414744079049614
SIM,1845,22,40-44,1867,1
STAT,1806,61,na,1867,931.2400823481103
SIM,1900,23,35-39,1923,13
STAT,1853,51,45-49,1904,0.01081401449122277
SIM,1939,10,na,1949,3683
STAT,1852,42,45-49,1894,1.1357058576310348
SIM,1860,33,30-34,1893,17
STAT,1763,112,na,1875,2.6578492159737684E-4
STAT,1932,19,35-39,1951,5.2209832622270875
STAT,1902,40,45-49,1942,0.13995183090612814
STAT,1838,16,50-100,1854,0.04439813660818122
STAT,1826,42,35-39,1868,1.783960677269115
SIM,1940,19,35-39,1959,2
SIM,1844,75,na,1919,657
STAT,1837,45,15-19,1882,2.689227806261137E-4
STAT,1841,53,25-29,1894,0.002384504854325577
SIM,1923,19,35-39,1942,6
SIM,1843,90,na,1933,54
STAT,1870,51,45-49,1921,0.013497974073280208
STAT,1862,37,20-24,1899,0.6211791962334536
SIM,1899,33,na,1932,3025
STAT,1868,54,40-44,1922,0.009234572629053106
STAT,1817,54,45-49,1871,0.029881165765902124
STAT,1876,33,na,1909,2317.441685980328
STAT,1909,62,na,1971,2902.196318715688
STAT,1930,37,30-34,1967,2.2459395347474214
SIM,1874,37,40-44,1911,5
STAT,1950,2,na,1952,4467.667601352174
STAT,1861,32,45-49,1893,1.3679878089725548
SIM,1869,27,20-24,1896,10
SIM,1876,70,na,1946,1383
SIM,1825,95,na,1920,4
STAT,1916,46,45-49,1962,0.21110772664491168
STAT,1905,43,15-19,1948,0.001299703618312285
STAT,1831,31,20-24,1862,2.245548690389614
STAT,1856,16,15-19,1872,5.222760058885206
STAT,1907,33,na,1940,3325.000584293859
STAT,1820,40,50-100,1860,2.025844884330549
STAT,1931,33,15-19,1964,0.15897544484854031
STAT,1826,43,30-34,1869,1.1116990959171495
STAT,1854,49,30-34,1903,0.0682497314474808
SIM,1949,1,na,1950,4403
STAT,1826,46,50-100,1872,0.23273860229057544
STAT,1912,18,20-24,1930,25.82483028645381
SIM,1834,46,50-100,1880,2
SIM,1838,68,na,1906,957
STAT,1821,46,15-19,1867,6.198165795886276E-4
SIM,1873,28,25-29,1901,47
SIM,1927,2,na,1929,4679
STAT,1923,42,20-24,1965,0.01950146646424091
SIM,1966,0,na,1966,4554
STAT,1925,22,35-39,1947,10.648755507260768
SIM,1825,61,na,1886,1004
SIM,1851,20,25-29,1871,51
SIM,1920,18,20-24,1938,133
STAT,1922,48,45-49,1970,0.23523325106240928
STAT,1920,15,na,1935,4126.331517276678
SIM,1878,21,40-44,1899,3
STAT,1853,46,45-49,1899,0.17551636123632175
STAT,1893,34,30-34,1927,20.748324022904452
STAT,1868,43,50-100,1911,0.9460118361677143
SIM,1903,12,na,1915,3445
SIM,1933,22,35-39,1955,20
STAT,1917,31,40-44,1948,3.886885402196693
STAT,1923,29,na,1952,4034.433908777227
STAT,1800,66,na,1866,780.9297364741186
STAT,1877,40,25-29,1917,0.635869500872014
STAT,1790,65,na,1855,745.6716
STAT,1867,40,15-19,1907,0.012372925627057914
STAT,1943,18,50-100,1961,0.37518628161887857
STAT,1903,30,35-39,1933,13.720519515490317
SIM,1822,91,na,1913,22
STAT,1919,44,20-24,1963,0.01801958920626723
STAT,1892,20,20-24,1912,82.01036629405891
SIM,1922,2,na,1924,4436
SIM,1876,43,50-100,1919,3
SIM,1925,31,40-44,1956,10
STAT,1904,1,na,1905,3687.647616756547
STAT,1823,39,na,1862,1482.7334644131827
SIM,1865,26,25-29,1891,32
STAT,1833,87,na,1920,106.95759941908929
SIM,1813,76,na,1889,352
STAT,1860,89,na,1949,80.65585760889874
SIM,1938,23,15-19,1961,3
STAT,1821,105,na,1926,0.015833123710150995
SIM,1903,24,15-19,1927,3
STAT,1816,49,45-49,1865,0.6018457002170767
STAT,1843,41,40-44,1884,1.6923504376396377
STAT,1901,18,45-49,1919,0.0861487933227185
STAT,1836,32,50-100,1868,0.7313549008272184
SIM,1829,61,na,1890,1009
STAT,1904,36,25-29,1940,0.846006402274302
STAT,1913,48,35-39,1961,0.11852376463090852
SIM,1852,94,na,1946,12
STAT,1852,23,50-100,1875,0.36541834192641687
STAT,1815,65,na,1880,852.7889091462707
STAT,1853,53,35-39,1906,0.00628203499652566
STAT,1905,48,na,1953,3033.3541809923263
STAT,1943,21,40-44,1964,3.380442169985446
STAT,1806,54,na,1860,1088.423533949823
STAT,1895,47,na,1942,2761.1858300831545
STAT,1926,0,na,1926,5218.640101674139
STAT,1772,84,na,1856,85.80061019000001
STAT,1830,40,35-39,1870,1.4159493736902633
STAT,1835,42,45-49,1877,1.118888852403028
STAT,1854,45,15-19,1899,2.909090579636819E-4
SIM,1839,16,na,1855,2080
SIM,1937,25,na,1962,3296
STAT,1884,21,25-29,1905,53.602395437947784
STAT,1861,48,45-49,1909,0.18281024531275494
SIM,1860,32,35-39,1892,6
SIM,1817,76,na,1893,472
SIM,1839,36,25-29,1875,2
SIM,1873,25,20-24,1898,9
STAT,1882,51,20-24,1933,6.815780105456044E-4
STAT,1820,47,45-49,1867,0.3891294331033305
SIM,1918,48,na,1966,3647
STAT,1896,7,na,1903,3252.8711098060617
STAT,1842,39,45-49,1881,1.4842605904468626
STAT,1816,54,na,1870,1235.2890370740104
STAT,1872,74,na,1946,1052.3040843091194
SIM,1850,39,45-49,1889,1
STAT,1828,38,na,1866,1559.487192083904
SIM,1903,49,na,1952,2970
SIM,1867,42,30-34,1909,3
SIM,1893,55,na,1948,2564
STAT,1777,83,na,1860,117.66817572463543
STAT,1898,35,50-100,1933,1.5849816637479686
SIM,1832,27,25-29,1859,40
SIM,1848,23,20-24,1871,65
STAT,1813,48,30-34,1861,0.2878817836807169
STAT,1873,52,25-29,1925,0.00337838452323147
STAT,1893,30,15-19,1923,0.1720641661101908
SIM,1858,43,35-39,1901,1
SIM,1825,30,25-29,1855,11
SIM,1907,26,40-44,1933,4
STAT,1852,32,35-39,1884,7.9664923670943155
STAT,1926,43,35-39,1969,0.23417055567019587
STAT,1849,48,45-49,1897,0.1679692398385217
STAT,1822,34,15-19,1856,0.3146682934588837
SIM,1834,43,30-34,1877,1
STAT,1875,45,35-39,1920,0.13722994202318023
SIM,1900,38,na,1938,3060
SIM,1902,19,15-19,1921,6
STAT,1787,83,na,1870,129.32499900011177
SIM,1820,62,na,1882,951
STAT,1801,55,na,1856,1110.1450576754994
STAT,1880,39,30-34,1919,5.244274005877862
SIM,1832,43,na,1875,1525
SIM,1938,16,25-29,1954,55
STAT,1951,14,na,1965,4417.570271174694
STAT,1938,28,na,1966,3503.9757172605687
STAT,1865,102,na,1967,1.556103364373229
STAT,1898,27,25-29,1925,54.09619634248737
STAT,1918,41,35-39,1959,0.2025425593265379
SIM,1823,76,na,1899,495
SIM,1791,87,na,1878,61
STAT,1858,42,30-34,1900,0.8515782841676253
SIM,1853,42,na,1895,1855
STAT,1860,27,45-49,1887,0.8615796511335234
STAT,1883,16,25-29,1899,5.259523331504839
SIM,1943,25,na,1968,3681
STAT,1886,33,na,1919,2371.78335199071
STAT,1938,18,25-29,1956,40.36575657402187
SIM,1922,26,na,1948,4009
SIM,1884,30,30-34,1914,17
SIM,1870,82,na,1952,367
SIM,1802,77,na,1879,338
SIM,1874,33,25-29,1907,16
STAT,1887,18,na,1905,2661.303165125313
STAT,1931,37,30-34,1968,2.280313097060526
STAT,1855,54,30-34,1909,0.0040998824368827
STAT,1859,42,30-34,1901,0.8656959723485215
STAT,1849,46,50-100,1895,0.17752883762113436
SIM,1892,42,40-44,1934,7
STAT,1774,105,na,1879,0.019031524178702505
SIM,1892,21,25-29,1913,78
STAT,1817,39,na,1856,1353.7443547414566
STAT,1889,47,na,1936,2612.179015413675
STAT,1948,15,30-34,1963,13.18547183768824
SIM,1912,23,na,1935,3524
STAT,1884,42,40-44,1926,2.097203153744807
SIM,1892,34,50-100,1926,2
STAT,1831,47,50-100,1878,0.18057442372714813
SIM,1770,88,na,1858,32
SIM,1820,58,na,1878,1086
STAT,1891,18,25-29,1909,6.60878318664422
STAT,1930,26,25-29,1956,79.10432341711038
SIM,1866,42,30-34,1908,1
SIM,1955,10,na,1965,4547
SIM,1946,18,25-29,1964,53
STAT,1893,33,50-100,1926,1.0935920775951093
STAT,1809,52,45-49,1861,0.05031680573926968
STAT,1876,30,30-34,1906,17.16455458529378
STAT,1879,18,25-29,1897,5.580849229976734
STAT,1812,52,35-39,1864,0.027092894484233767
SIM,1888,39,25-29,1927,2
SIM,1855,16,na,1871,2212
STAT,1870,31,25-29,1901,9.520012794472924
STAT,1922,35,30-34,1957,1.9626890783604944
SIM,1792,76,na,1868,305
STAT,1845,31,50-100,1876,0.7753767405721927
SIM,1851,57,na,1908,1491
STAT,1834,79,na,1913,432.7156587847621
STAT,1859,17,45-49,1876,0.05716688750122871
SIM,1876,15,na,1891,2541
SIM,1871,71,na,1942,1196
STAT,1838,38,na,1876,1744.426409861028
STAT,1933,29,na,1962,4694.411831232898
STAT,1898,48,40-44,1946,0.12194591662239024
SIM,1833,28,na,1861,1722
STAT,1907,17,35-39,1924,0.7613158520716742
STAT,1852,28,50-100,1880,0.5620236796770912
SIM,1915,17,35-39,1932,4
SIM,1924,29,45-49,1953,5
STAT,1884,34,50-100,1918,0.8480284375764869
STAT,1916,29,45-49,1945,1.6753817024068987
STAT,1841,50,20-24,1891,5.121335417556313E-4
STAT,1866,23,30-34,1889,15.528676955738515
SIM,1892,70,na,1962,1830
SIM,1930,35,30-34,1965,2
STAT,1935,14,na,1949,5100.263404269647
SIM,1875,44,30-34,1919,3
STAT,1924,44,50-100,1968,0.13158323602616398
SIM,1842,44,35-39,1886,2
STAT,1875,92,na,1967,130.99787290031222
STAT,1867,44,30-34,1911,1.005991481311728
STAT,1850,17,25-29,1867,4.874970923118741
STAT,1885,32,30-34,1917,16.432725644833525
STAT,1856,19,na,1875,1984.6408782074454
SIM,1819,61,na,1880,998
STAT,1830,80,na,1910,369.5194068062312
SIM,1923,16,30-34,1939,16
STAT,1881,44,30-34,1925,1.0345079738847263
SIM,1884,41,na,1925,2272
STAT,1845,54,20-24,1899,5.054831357435822E-4
STAT,1871,34,na,1905,2215.7498054687744
SIM,1886,26,45-49,1912,4
STAT,1915,16,30-34,1931,2.415654438124014
STAT,1899,32,25-29,1931,13.260213542101777
STAT,1905,47,30-34,1952,0.07419442006307382
SIM,1776,80,na,1856,191
SIM,1886,70,na,1956,1392
SIM,1937,16,25-29,1953,47
STAT,1796,97,na,1893,1.2515845660026395
STAT,1881,49,25-29,1930,0.05144250812975317
STAT,1910,2,na,1912,3814.719267326818
SIM,1945,6,na,1951,3957
STAT,1825,68,na,1893,864.0339134389794
STAT,1902,23,45-49,1925,0.926760400180166
STAT,1902,34,na,1936,3180.8984264300225
STAT,1857,26,25-29,1883,32.684300489900316
SIM,1910,23,45-49,1933,5
SIM,1819,35,45-49,1854,2
STAT,1914,15,na,1929,3791.164834561291
SIM,1851,41,40-44,1892,7
STAT,1907,24,25-29,1931,78.92917639756249
STAT,1854,93,na,1947,21.045037261718957
SIM,1881,23,na,1904,1973
STAT,1904,63,na,1967,2667.4214061723924
STAT,1835,45,50-100,1880,0.18210519670782088
STAT,1864,45,50-100,1909,0.2094300406187927
STAT,1775,98,na,1873,0.5103600025489383
STAT,1928,19,50-100,1947,0.443620174793518
STAT,1942,19,45-49,1961,0.4928123404218078
SIM,1826,41,30-34,1867,2
STAT,1862,50,40-44,1912,0.008605490834459682
SIM,1889,24,20-24,1913,86
STAT,1933,24,35-39,1957,11.79106404052724
STAT,1894,20,50-100,1914,0.498511932248493
STAT,1817,51,40-44,1868,0.023016643849715024
SIM,1841,57,na,1898,1397
STAT,1881,51,20-24,1932,6.763091976387016E-4
STAT,1913,40,20-24,1953,0.016450282141325163
STAT,1929,16,25-29,1945,52.37736452553145
STAT,1798,105,na,1903,0.008132435630062225
SIM,1843,45,50-100,1888,1
STAT,1917,33,na,1950,3725.420973043153
STAT,1781,98,na,1879,0.5228887155928325
SIM,1893,32,30-34,1925,35
STAT,1845,51,35-39,1896,0.006093074930680475
SIM,1934,11,na,1945,5026
SIM,1949,10,na,1959,4295
SIM,1915,24,25-29,1939,86
STAT,1818,41,30-34,1859,2.86859855372749
SIM,1897,15,15-19,1912,6
STAT,1927,39,30-34,1966,2.13635927211506
STAT,1833,94,na,1927,12.133348768413533
SIM,1913,12,na,1925,3693
STAT,1863,60,na,1923,1583.747906636275
STAT,1925,33,40-44,1958,4.387870787023625
STAT,1793,79,na,1872,276.6118466765267
SIM,1933,33,40-44,1966,10
STAT,1834,37,45-49,1871,1.534872397500071
SIM,1863,42,na,1905,1990
STAT,1843,20,25-29,1863,52.59266628150345
SIM,1956,15,30-34,1971,18
STAT,1866,29,50-100,1895,0.5531828931189017
SIM,1872,45,50-100,1917,1
STAT,1928,42,50-100,1970,0.14149631044786054
SIM,1911,41,40-44,1952,3
STAT,1878,26,45-49,1904,1.095677626248553
STAT,1910,43,50-100,1953,0.10422729606039068
STAT,1877,18,na,1895,2469.407725369904
STAT,1889,15,15-19,1904,6.9534578017070485
STAT,1946,20,15-19,1966,5.600060516226953
STAT,1824,49,35-39,1873,0.15993470210484662
STAT,1917,26,na,1943,3723.9501497652086
SIM,1855,53,na,1908,1671
STAT,1903,2,na,1905,3582.7350710052724
SIM,1902,24,45-49,1926,4
SIM,1864,27,50-100,1891,1
SIM,1860,44,40-44,1904,7
STAT,1777,102,na,1879,0.07767745405038289
STAT,1882,45,35-39,1927,0.12997804407410576
SIM,1903,17,15-19,1920,7
STAT,1845,51,40-44,1896,0.007450960183763638
SIM,1844,28,20-24,1872,8
STAT,1863,31,35-39,1894,8.444020338210073
SIM,1859,43,na,1902,1913
STAT,1780,97,na,1877,0.7939137644325974
STAT,1889,48,25-29,1937,0.03741743894337603
STAT,1913,12,na,1925,3813.6980898969
STAT,1784,87,na,1871,45.56366008958284
SIM,1857,15,25-29,1872,6
SIM,1896,75,na,1971,1704
STAT,1829,47,15-19,1876,3.2275773424298235E-4
STAT,1771,101,na,1872,0.09059318092719992
STAT,1849,28,30-34,1877,21.361682028537814
STAT,1841,46,30-34,1887,0.06738783764599253
SIM,1837,40,na,1877,1621
STAT,1937,35,20-24,1972,0.24941566451206912
STAT,1840,28,40-44,1868,2.582461739571666
SIM,1855,102,na,1957,1
STAT,1851,39,50-100,1890,0.8912625885282903
STAT,1850,20,15-19,1870,2.8280764398297347
STAT,1955,15,15-19,1970,56.94072042213273
STAT,1839,94,na,1933,13.326159108022136
STAT,1840,17,30-34,1857,1.4371442737365492
STAT,1878,45,15-19,1923,3.973025153899264E-4
STAT,1815,54,35-39,1869,0.019236859757409963
STAT,1836,28,20-24,1864,9.517203430438318
STAT,1798,95,na,1893,3.6876751449003597
STAT,1828,54,45-49,1882,0.01032363886770313
STAT,1804,53,20-24,1857,0.002150811891776002
SIM,1851,43,30-34,1894,1
STAT,1809,72,na,1881,599.161890968382
SIM,1842,27,na,1869,1846
STAT,1882,8,na,1890,2389.6330617088315
STAT,1850,31,25-29,1881,7.62197246475082
SIM,1855,18,25-29,1873,8
STAT,1911,21,40-44,1932,3.020902191579072
SIM,1847,58,na,1905,1406
SIM,1900,27,45-49,1927,1
STAT,1824,41,25-29,1865,0.833263575876556
STAT,1857,34,15-19,1891,0.10515019746572718
STAT,1939,32,20-24,1971,2.3508149392783024
SIM,1880,21,35-39,1901,6
STAT,1893,48,45-49,1941,0.1575592145800766
STAT,1792,82,na,1874,150.70354941648168
STAT,1866,15,50-100,1881,0.04431925845077403
STAT,1905,17,na,1922,3447.844899841743
STAT,1871,55,na,1926,1936.5036012022786
STAT,1929,11,na,1940,4784.422080258816
SIM,1806,76,na,1882,353
SIM,1857,26,35-39,1883,12
STAT,1915,0,na,1915,4439.38243757297
STAT,1884,42,35-39,1926,1.68838534741249
SIM,1848,22,20-24,1870,60
STAT,1843,54,40-44,1897,0.007386365642601962
STAT,1849,15,25-29,1864,5.087480859896327
SIM,1878,39,30-34,1917,4
STAT,1842,25,40-44,1867,2.6762880307049293
SIM,1874,23,30-34,1897,22
SIM,1850,25,40-44,1875,2
SIM,1892,42,35-39,1934,3
STAT,1876,48,15-19,1924,3.8520018791835203E-4
STAT,1875,18,30-34,1893,1.5428579924280057
STAT,1953,18,15-19,1971,51.847727767485146
SIM,1825,55,na,1880,1162
STAT,1843,43,30-34,1886,0.8431250479581266
STAT,1892,19,45-49,1911,0.07686254615341355
SIM,1873,31,45-49,1904,3
SIM,1850,22,na,1872,1890
STAT,1817,51,35-39,1868,0.01882202188312597
STAT,1824,30,15-19,1854,0.4680611750245498
STAT,1910,33,50-100,1943,0.7497152251746081
STAT,1921,43,15-19,1964,0.0016315706059849187
STAT,1860,50,25-29,1910,0.0027584937903886446
STAT,1909,48,20-24,1957,0.009564007251711555
STAT,1834,63,na,1897,1104.4065060922371
SIM,1821,65,na,1886,923
STAT,1847,18,25-29,1865,5.173313738394023
STAT,1853,17,40-44,1870,0.1631689074309533
SIM,1884,31,20-24,1915,2
STAT,1885,63,na,1948,1679.350329370096
STAT,1897,42,45-49,1939,0.13114480157694838
SIM,1814,71,na,1885,579
STAT,1882,47,30-34,1929,0.08856856169148604
SIM,1772,90,na,1862,19
SIM,1872,15,20-24,1887,18
STAT,1829,38,30-34,1867,4.671007505501861
STAT,1801,92,na,1893,15.848418537574204
STAT,1850,33,20-24,1883,1.9701226980455862
SIM,1872,49,na,1921,2073
STAT,1833,36,25-29,1869,2.214417849318949
STAT,1855,37,15-19,1892,0.03977072667906805
STAT,1948,17,50-100,1965,0.40507628426054454
STAT,1939,30,25-29,1969,8.917933831624682
STAT,1831,39,25-29,1870,2.221022152891821
STAT,1851,18,45-49,1869,0.05789710996987733
SIM,1867,34,25-29,1901,11
STAT,1880,49,50-100,1929,0.23902884741907898
SIM,1897,17,na,1914,3238
SIM,1857,28,30-34,1885,27
STAT,1896,29,30-34,1925,31.215702406890784
STAT,1761,110,na,1871,0.0012039348796077049
STAT,1843,41,35-39,1884,1.3624525008441637
STAT,1895,45,45-49,1940,0.16575096643891626
SIM,1893,37,50-100,1930,1
STAT,1927,28,15-19,1955,0.8080053924097034
STAT,1877,21,50-100,1898,0.4009707833934385
STAT,1932,35,50-100,1967,0.5338528384559755
STAT,1895,30,50-100,1925,1.1386267846020357
STAT,1949,17,40-44,1966,1.5369076843097025
STAT,1864,15,20-24,1879,17.21813056838258
SIM,1908,42,40-44,1950,5
STAT,1817,53,30-34,1870,0.012503889118066623
STAT,1829,49,40-44,1878,0.13457619495708958
SIM,1868,20,na,1888,2150
STAT,1862,18,20-24,1880,16.265760379112628
SIM,1797,82,na,1879,154
STAT,1884,44,30-34,1928,1.0587739519279629
STAT,1832,51,30-34,1883,0.0038290208747911113
SIM,1818,61,na,1879,920
STAT,1830,43,20-24,1873,0.11913165396251377
STAT,1853,15,45-49,1868,0.058967183350286244
STAT,1855,41,na,1896,1644.3116411681615
STAT,1900,46,35-39,1946,0.10379328356198576
STAT,1839,54,20-24,1893,4.784937248424638E-4
SIM,1862,41,40-44,1903,5
SIM,1939,24,40-44,1963,5
SIM,1764,95,na,1859,2
STAT,1805,82,na,1887,173.16389328950305
SIM,1956,8,na,1964,4768
STAT,1901,27,na,1928,3155.6685448148623
STAT,1826,68,na,1894,834.116412732764
SIM,1843,68,na,1911,1059
SIM,1851,63,na,1914,1323
SIM,1836,18,15-19,1854,7
STAT,1889,53,na,1942,2470.927241008262
STAT,1898,37,40-44,1935,5.598068499106961
SIM,1869,42,35-39,1911,2
SIM,1870,18,20-24,1888,16
SIM,1837,38,30-34,1875,7
SIM,1851,41,35-39,1892,1
STAT,1837,44,15-19,1881,0.009124383400996226
STAT,1861,23,25-29,1884,45.804324901350675
SIM,1869,30,40-44,1899,5
STAT,1933,25,35-39,1958,18.84896905083966
STAT,1950,22,30-34,1972,32.21290274901382
SIM,1833,23,15-19,1856,2
STAT,1856,66,na,1922,1212.6937548178018
STAT,1893,26,50-100,1919,0.7693768105689787
STAT,1917,42,40-44,1959,0.24657953547879752
SIM,1936,1,na,1937,3073
SIM,1941,22,30-34,1963,33
STAT,1841,30,45-49,1871,1.4779739209341212
SIM,1922,28,35-39,1950,18
SIM,1904,28,na,1932,3139
SIM,1826,32,40-44,1858,5
STAT,1824,43,20-24,1867,0.195864640223652
SIM,1898,29,30-34,1927,34
SIM,1919,32,45-49,1951,3
STAT,1851,35,na,1886,1782.8210325787327
SIM,1922,17,25-29,1939,56
STAT,1868,91,na,1959,83.64999585187844
STAT,1918,22,35-39,1940,9.593433273726566
SIM,1863,88,na,1951,97
SIM,1866,31,50-100,1897,1
STAT,1805,49,25-29,1854,0.17048089416848286
STAT,1846,88,na,1934,96.7948782536062
STAT,1842,74,na,1916,790.2944104526389
STAT,1885,23,40-44,1908,1.9551776433167853
STAT,1914,17,25-29,1931,8.466936903188222
SIM,1867,19,na,1886,2218
STAT,1864,61,na,1925,1577.709126922523
SIM,1771,89,na,1860,26
STAT,1839,52,25-29,1891,0.0023491427643603834
STAT,1891,21,45-49,1912,0.8178445165796842
STAT,1834,54,45-49,1888,0.008853107599829308
STAT,1855,25,na,1880,1780.383097561206
STAT,1857,36,40-44,1893,3.275839890516016
SIM,1872,29,40-44,1901,4
STAT,1854,44,15-19,1898,0.009810148126874545
STAT,1859,36,45-49,1895,1.5101722833019686
SIM,1926,31,na,1957,4165
STAT,1874,34,20-24,1908,2.5875436254457003
SIM,1808,83,na,1891,113
SIM,1874,29,45-49,1903,1
SIM,1800,63,na,1863,880
STAT,1843,56,na,1899,1471.5049482743168
SIM,1888,40,na,1928,2545
STAT,1935,22,35-39,1957,12.112361701115406
STAT,1933,22,30-34,1955,36.01565921484807
SIM,1848,83,na,1931,255
SIM,1887,26,20-24,1913,12
STAT,1824,30,45-49,1854,5.731541301118468
SIM,1843,33,25-29,1876,11
STAT,1840,26,15-19,1866,0.39681262714015286
STAT,1902,52,na,1954,2855.288678557656
STAT,1808,48,50-100,1856,0.9195473428206413
STAT,1833,38,na,1871,1608.5809052544155
STAT,1929,25,15-19,1954,0.837870250207237
STAT,1928,32,45-49,1960,1.8589499051741645
SIM,1880,20,na,1900,2444
SIM,1943,22,35-39,1965,8
STAT,1903,27,20-24,1930,15.767458320181024
STAT,1859,45,35-39,1904,0.10660171906914527
SIM,1884,34,na,1918,2325
STAT,1873,38,na,1911,2247.9606622561414
STAT,1860,71,na,1931,1024.8060838557772
STAT,1869,52,40-44,1921,0.009575621280644486
SIM,1916,13,na,1929,3863
STAT,1868,28,40-44,1896,2.692419047462643
SIM,1882,34,20-24,1916,2
SIM,1917,54,na,1971,3468
SIM,1863,29,na,1892,2044
STAT,1811,46,45-49,1857,0.799424775361018
STAT,1879,26,20-24,1905,11.623764641896695
STAT,1827,109,na,1936,3.9482411526989915E-4
STAT,1839,41,15-19,1880,0.010802167575000415
SIM,1888,42,45-49,1930,1
SIM,1926,22,35-39,1948,9
SIM,1834,91,na,1925,28
SIM,1911,27,20-24,1938,25
STAT,1819,74,na,1893,554.2139747758386
SIM,1934,32,40-44,1966,3
STAT,1891,21,15-19,1912,3.8692173272138795
STAT,1930,36,50-100,1966,0.5178548237338598
STAT,1864,16,50-100,1880,0.04730115789737939
SIM,1793,92,na,1885,6
STAT,1810,50,40-44,1860,0.03719493991310749
STAT,1905,38,35-39,1943,2.0737473778741413
SIM,1936,32,45-49,1968,1
SIM,1900,14,na,1914,3348
STAT,1849,26,35-39,1875,8.30395537835012
STAT,1890,17,15-19,1907,6.854566460176587
SIM,1893,23,40-44,1916,3
STAT,1820,49,20-24,1869,0.019214126633992613
STAT,1850,39,35-39,1889,4.954241186489211
STAT,1891,32,25-29,1923,11.976746123807986
SIM,1852,22,40-44,1874,5
STAT,1913,49,25-29,1962,0.04861338171669985
SIM,1821,40,40-44,1861,5
STAT,1892,17,na,1909,2987.8091932227194
STAT,1905,27,25-29,1932,57.74801400948689
STAT,1867,10,na,1877,2408.5964255488716
STAT,1907,21,20-24,1928,95.90248057607964
SIM,1872,65,na,1937,1584
STAT,1868,20,30-34,1888,16.299490705660364
SIM,1854,12,na,1866,2226
STAT,1791,107,na,1898,8.656163507335594E-4
STAT,1863,34,15-19,1897,0.11724479525803838
STAT,1818,44,35-39,1862,4.021602741748806
STAT,1868,26,45-49,1894,1.0049046903931032
STAT,1871,44,20-24,1915,0.14672765773357047
SIM,1810,81,na,1891,188
SIM,1835,22,40-44,1857,2
SIM,1842,17,30-34,1859,2
SIM,1822,39,25-29,1861,1
SIM,1884,34,25-29,1918,9
STAT,1871,47,50-100,1918,0.22894272939944726
STAT,1924,38,45-49,1962,0.7587147051261646
STAT,1815,40,45-49,1855,4.63678455318394
SIM,1898,16,25-29,1914,6
STAT,1818,92,na,1910,20.080161999264327
STAT,1926,32,40-44,1958,4.470708459646594
SIM,1823,101,na,1924,3
STAT,1838,53,na,1891,1444.934178841218
STAT,1880,31,40-44,1911,4.328305565319675
STAT,1876,34,25-29,1910,9.903632003716263
STAT,1835,33,25-29,1868,8.05214489966547
STAT,1924,32,30-34,1956,17.366230156301278
STAT,1907,38,45-49,1945,0.5940334973584966
SIM,1874,52,50-100,1926,1
STAT,1833,33,20-24,1866,2.097658624939193
STAT,1851,51,40-44,1902,0.007757036153977888
SIM,1939,26,50-100,1965,4
STAT,1792,109,na,1901,1.1981049626580341E-4
SIM,1898,27,35-39,1925,13
STAT,1790,99,na,1889,0.3490999023000451
SIM,1884,35,50-100,1919,1
STAT,1862,1,na,1863,2929.840495713799
SIM,1841,33,20-24,1874,2
STAT,1924,21,20-24,1945,124.33760033576071
STAT,1896,38,15-19,1934,0.06976302961828723
SIM,1932,32,30-34,1964,26
STAT,1913,48,40-44,1961,0.1449376318429825
STAT,1926,38,50-100,1964,0.48430562794324067
STAT,1844,22,40-44,1866,1.8264672259743862
STAT,1848,47,25-29,1895,0.04130293683683956
STAT,1885,24,25-29,1909,53.54110003347197
SIM,1932,21,20-24,1953,137
STAT,1860,41,40-44,1901,1.7347171130571175
STAT,1809,56,na,1865,1138.1775531572403
STAT,1882,31,45-49,1913,1.609559580632604
STAT,1881,29,40-44,1910,2.712856700201718
STAT,1879,38,15-19,1917,0.055173789678226205
SIM,1822,38,40-44,1860,7
SIM,1876,20,30-34,1896,24
SIM,1826,44,35-39,1870,1
SIM,1826,33,25-29,1859,17
STAT,1813,61,na,1874,992.8050851498758
STAT,1922,29,na,1951,3976.2163186238245
SIM,1930,38,40-44,1968,3
SIM,1893,35,35-39,1928,16
SIM,1837,22,45-49,1859,3
SIM,1915,21,20-24,1936,90
STAT,1922,38,40-44,1960,1.6076615316852836
SIM,1846,25,20-24,1871,10
STAT,1885,35,35-39,1920,6.720108969933828
SIM,1832,30,45-49,1862,1
STAT,1830,40,40-44,1870,1.7588007954446645
STAT,1887,70,na,1957,1538.4390739639928
STAT,1918,9,na,1927,4093.209873710223
SIM,1932,38,45-49,1970,1
STAT,1812,46,50-100,1858,0.8214253455221597
STAT,1820,36,15-19,1856,0.13703312747263321
STAT,1869,50,45-49,1919,0.013461390691666523
STAT,1874,20,na,1894,2297.153837031312
STAT,1907,32,30-34,1939,13.909870908822702
STAT,1937,22,45-49,1959,1.0349554037734583
SIM,1915,32,30-34,1947,17
SIM,1945,22,45-49,1967,2
STAT,1889,13,na,1902,3007.239636926211
SIM,1917,32,35-39,1949,8
STAT,1883,4,na,1887,2597.6625073975965
STAT,1854,44,45-49,1898,1.063174728606763
STAT,1859,38,40-44,1897,3.2839372950531187
STAT,1880,91,na,1971,209.63775903868256
SIM,1930,7,na,1937,4839
STAT,1838,25,20-24,1863,10.32578232926589
STAT,1909,32,35-39,1941,8.23603862749759
SIM,1893,24,25-29,1917,73
STAT,1891,34,20-24,1925,3.1336440753168935
STAT,1935,25,45-49,1960,2.226540193446698
STAT,1834,51,35-39,1885,0.00557333511954781
STAT,1855,25,20-24,1880,9.655046818324166
STAT,1828,51,40-44,1879,0.008734110556162985
SIM,1890,31,45-49,1921,2
SIM,1815,96,na,1911,3
STAT,1846,31,35-39,1877,8.52614710377109
STAT,1865,45,35-39,1910,0.12138044270927537
SIM,1859,83,na,1942,300
STAT,1936,18,15-19,1954,40.93190587345648
STAT,1807,49,35-39,1856,0.5017787450701053
STAT,1948,24,40-44,1972,3.644900440210486
SIM,1860,24,na,1884,2029
STAT,1918,38,20-24,1956,0.2622121592968305
STAT,1795,107,na,1902,9.110270028610847E-4
SIM,1841,31,25-29,1872,12
SIM,1899,5,na,1904,3387
SIM,1937,15,na,1952,3250
SIM,1841,20,15-19,1861,3
STAT,1844,34,35-39,1878,8.326792800884357
STAT,1940,18,35-39,1958,4.0231812193114465
SIM,1852,34,35-39,1886,2
SIM,1934,26,na,1960,4685
STAT,1862,35,na,1897,1916.5661562561663
SIM,1847,41,45-49,1888,7
SIM,1874,15,25-29,1889,7
SIM,1930,36,na,1966,4576
STAT,1889,45,20-24,1934,0.014134791373619017
STAT,1866,25,na,1891,2092.737719084684
SIM,1819,86,na,1905,82
STAT,1822,38,na,1860,1464.0727187690904
SIM,1867,33,40-44,1900,4
STAT,1844,23,25-29,1867,49.815755953582425
SIM,1823,40,45-49,1863,4
SIM,1943,25,45-49,1968,1
SIM,1877,40,na,1917,2291
STAT,1798,79,na,1877,281.167951679024
SIM,1863,25,20-24,1888,8
STAT,1861,20,20-24,1881,56.34439265580653
STAT,1867,42,35-39,1909,1.6042152090874922
STAT,1900,49,15-19,1949,2.895381568439359E-4
STAT,1839,41,45-49,1880,1.1706848287493454
SIM,1873,50,na,1923,2108
STAT,1793,64,na,1857,811.9060441104322
STAT,1799,104,na,1903,0.02229984011168383
STAT,1902,46,15-19,1948,3.016564131589993E-4
SIM,1854,31,35-39,1885,8
STAT,1867,66,na,1933,1453.802788138487
STAT,1822,49,30-34,1871,0.13122799971748209
STAT,1942,15,35-39,1957,4.144595715753961
STAT,1821,53,20-24,1874,0.0010618665990422573
STAT,1873,18,50-100,1891,0.046855636213103756
SIM,1878,2,na,1880,3122
STAT,1847,51,45-49,1898,0.010729160780303955
SIM,1845,42,50-100,1887,1
SIM,1891,44,na,1935,2797
STAT,1915,42,50-100,1957,0.11172372265451276
STAT,1872,35,25-29,1907,2.755989125655078
SIM,1852,23,25-29,1875,59
SIM,1862,44,45-49,1906,3
STAT,1881,18,30-34,1899,1.450029358299298
STAT,1887,41,50-100,1928,1.1211880049492453
STAT,1804,50,40-44,1854,0.03258755554815983
STAT,1895,45,15-19,1940,2.8093360496463966E-4
SIM,1876,23,35-39,1899,6
SIM,1871,31,40-44,1902,5
STAT,1889,37,na,1926,2747.7102164436137
STAT,1882,42,30-34,1924,1.0555314701417429
SIM,1827,81,na,1908,302
SIM,1890,22,na,1912,2801
SIM,1890,42,30-34,1932,1
SIM,1957,4,na,1961,4700
SIM,1942,21,na,1963,3471
STAT,1830,33,na,1863,1658.3791497610516
STAT,1805,66,na,1871,791.8636646443621
STAT,1861,22,40-44,1883,1.6793903181586294
SIM,1898,24,30-34,1922,29
STAT,1933,28,45-49,1961,2.1660259075098893
STAT,1844,41,na,1885,1683.1490037996255
SIM,1865,55,na,1920,1759
STAT,1815,51,30-34,1866,0.014125037501335064
SIM,1941,28,45-49,1969,1
STAT,1846,47,15-19,1893,2.8071391274250894E-4
STAT,1868,23,35-39,1891,5.247204882043301
STAT,1923,14,na,1937,4381.487946920955
STAT,1871,41,40-44,1912,2.1160761752594635
SIM,1786,82,na,1868,121
SIM,1939,27,45-49,1966,2
STAT,1885,23,na,1908,2219.0567942676325
STAT,1863,47,20-24,1910,0.009918506208687757
SIM,1883,49,na,1932,2077
SIM,1817,43,25-29,1860,4
SIM,1950,15,35-39,1965,5
STAT,1938,17,35-39,1955,3.9098661382528945
SIM,1864,41,45-49,1905,1
STAT,1881,33,na,1914,2167.4737521526044
STAT,1893,32,35-39,1925,12.138463508157455
STAT,1866,26,35-39,1892,8.432951564705574
STAT,1875,52,40-44,1927,0.010163091213214454
STAT,1849,22,50-100,1871,0.3553721177716907
STAT,1838,37,15-19,1875,0.04621432451884098
SIM,1814,55,na,1869,1139
STAT,1874,32,25-29,1906,9.889557442195123
SIM,1875,33,50-100,1908,1
SIM,1935,5,na,1940,5163
STAT,1801,76,na,1877,392.15456960411217
STAT,1888,12,na,1900,2882.106409088745
SIM,1878,23,45-49,1901,4
STAT,1881,27,15-19,1908,0.4138420393258022
SIM,1858,35,50-100,1893,4
STAT,1847,15,15-19,1862,5.514687890875753
SIM,1839,23,na,1862,1892
STAT,1891,35,35-39,1926,8.348959770475735
STAT,1908,16,40-44,1924,0.25688219624259123
STAT,1865,44,20-24,1909,0.13449199772234
STAT,1867,33,50-100,1900,0.8092806096632597
STAT,1917,36,50-100,1953,0.41393612827017445
SIM,1882,32,25-29,1914,11
STAT,1866,15,25-29,1881,5.126261928763964
STAT,1926,19,na,1945,4240.83284189965
STAT,1872,21,35-39,1893,5.549920917222088
SIM,1946,11,na,1957,4073
STAT,1777,93,na,1870,6.138513485289405
STAT,1914,28,35-39,1942,14.245269416752802
SIM,1915,47,na,1962,3468
STAT,1823,79,na,1902,367.89581702523094
SIM,1944,18,15-19,1962,38
STAT,1873,3,na,1876,2977.1742556311883
STAT,1824,44,35-39,1868,2.1776850253231985
STAT,1842,98,na,1940,2.3133270628966818
SIM,1894,7,na,1901,3327
STAT,1895,42,40-44,1937,0.1923192668938422
SIM,1882,21,15-19,1903,7
SIM,1921,16,na,1937,3906
STAT,1826,41,35-39,1867,1.8175631856310919
STAT,1893,48,15-19,1941,2.6704929146636677E-4
STAT,1944,28,15-19,1972,0.7204356152775014
STAT,1909,47,na,1956,3188.2836396087077
STAT,1931,25,30-34,1956,47.8313478725288
SIM,1825,71,na,1896,679
SIM,1874,24,15-19,1898,2
SIM,1876,55,na,1931,2034
STAT,1832,54,35-39,1886,0.005218382025476317
SIM,1832,44,35-39,1876,2
STAT,1850,20,45-49,1870,0.5977764010605267
STAT,1881,15,20-24,1896,16.246105852503437
STAT,1866,24,15-19,1890,2.855425684628629
STAT,1848,31,na,1879,1839.8050186128812
STAT,1885,38,15-19,1923,0.05258937099107776
SIM,1865,36,40-44,1901,3
STAT,1821,48,50-100,1869,0.36958216697267676
SIM,1855,15,15-19,1870,8
SIM,1894,12,na,1906,3304
STAT,1861,5,na,1866,2267.2823438032947
SIM,1871,24,na,1895,2267
SIM,1895,32,35-39,1927,18
STAT,1850,10,na,1860,2079.4229685570376
SIM,1805,94,na,1899,4
STAT,1768,97,na,1865,0.5390843546092373
STAT,1906,42,na,1948,3186.41460671945
STAT,1927,16,20-24,1943,159.65750956095124
SIM,1839,32,20-24,1871,1
STAT,1948,20,25-29,1968,100.26862970612164
STAT,1921,47,na,1968,3912.8034049740863
SIM,1905,0,na,1905,3728
SIM,1924,25,35-39,1949,24
SIM,1945,26,na,1971,3756
STAT,1803,59,na,1862,978.0827509570286
SIM,1901,39,na,1940,3167
SIM,1866,77,na,1943,664
STAT,1813,43,15-19,1856,0.04658642347839996
STAT,1898,23,20-24,1921,87.85484037469631
STAT,1806,54,50-100,1860,0.040963880056578326
STAT,1928,26,na,1954,4375.363853103062
SIM,1904,44,na,1948,3054
SIM,1824,35,40-44,1859,4
STAT,1855,28,30-34,1883,18.456275875415024
SIM,1888,80,na,1968,1053
SIM,1863,28,30-34,1891,32
STAT,1865,31,45-49,1896,1.5030927404381713
SIM,1827,38,na,1865,1511
SIM,1844,93,na,1937,14
SIM,1785,97,na,1882,2
STAT,1916,25,35-39,1941,14.763960301575658
STAT,1900,30,25-29,1930,13.531752772325575
SIM,1927,32,na,1959,4307
STAT,1834,105,na,1939,0.01814821653264518
STAT,1844,27,40-44,1871,2.5743209525981468
STAT,1852,107,na,1959,0.008675180811880004
SIM,1889,65,na,1954,1939
STAT,1887,46,25-29,1933,0.0610269755846522
SIM,1963,0,na,1963,4688
SIM,1891,26,40-44,1917,8
SIM,1900,21,30-34,1921,26
STAT,1864,27,15-19,1891,0.38306593792916777
STAT,1868,51,na,1919,1951.4000550597796
STAT,1905,35,30-34,1940,1.5853106019944725
SIM,1828,41,35-39,1869,1
SIM,1885,29,20-24,1914,12
STAT,1902,39,50-100,1941,0.3497252979833297
STAT,1876,31,20-24,1907,2.6469457007025996
SIM,1946,17,35-39,1963,4
SIM,1843,38,50-100,1881,5
STAT,1924,5,na,1929,4523.69199127921
STAT,1887,35,15-19,1922,0.059890535926471436
STAT,1920,39,15-19,1959,0.019821324799155427
SIM,1831,31,50-100,1862,3
STAT,1859,55,na,1914,1558.9000098665108
SIM,1893,27,na,1920,2991
STAT,1918,38,15-19,1956,0.019101550431521987
SIM,1875,14,na,1889,2503
STAT,1863,20,na,1883,2032.1856827697507
SIM,1929,19,30-34,1948,16
SIM,1762,101,na,1863,1
STAT,1860,44,45-49,1904,1.1335498223320473
STAT,1848,44,20-24,1892,0.11286828965059766
SIM,1832,68,na,1900,951
SIM,1900,54,na,1954,2689
SIM,1862,63,na,1925,1519
STAT,1852,47,15-19,1899,3.0249184521193874E-4
STAT,1865,31,15-19,1896,0.12274871928831266
SIM,1880,24,15-19,1904,3
STAT,1901,31,50-100,1932,1.2164906582463508
STAT,1889,45,15-19,1934,4.7115929800619526E-4
SIM,1841,36,25-29,1877,3
SIM,1876,46,50-100,1922,2
STAT,1917,45,45-49,1962,0.2154567012921374
SIM,1848,39,45-49,1887,3
STAT,1880,34,15-19,1914,0.14034108295098924
STAT,1900,49,45-49,1949,0.17082765632066496
STAT,1854,41,35-39,1895,1.309856643014175
STAT,1870,24,35-39,1894,5.36791012678402
SIM,1863,37,20-24,1900,2
STAT,1897,48,na,1945,2807.289357164108
STAT,1852,76,na,1928,719.8110984781066
SIM,1880,35,25-29,1915,3
STAT,1968,0,na,1968,4672.700622421969
SIM,1932,35,40-44,1967,5
STAT,1909,35,45-49,1944,0.6152113302195131
STAT,1835,30,20-24,1865,2.192226647045745
STAT,1931,22,50-100,1953,0.8062251336001697
STAT,1880,34,45-49,1914,1.7185162027914376
STAT,1939,15,50-100,1954,0.35511368967735807
STAT,1929,39,35-39,1968,2.927455017712275
STAT,1834,23,na,1857,1757.1956638789864
SIM,1843,12,na,1855,2183
STAT,1873,51,50-100,1924,0.014551443857832639
SIM,1882,37,25-29,1919,2
STAT,1937,30,15-19,1967,0.12022407112372774
SIM,1913,24,20-24,1937,99
STAT,1866,29,45-49,1895,0.9601500725884137
STAT,1818,37,40-44,1855,14.835880932370761
STAT,1813,43,45-49,1856,5.048803290005717
STAT,1877,29,20-24,1906,11.418344360182088
SIM,1876,23,40-44,1899,7
STAT,1842,42,50-100,1884,0.7783490913996854
SIM,1822,66,na,1888,861
SIM,1913,35,30-34,1948,1
STAT,1848,44,15-19,1892,0.00981463441275757
STAT,1944,28,20-24,1972,18.6284064742411
STAT,1856,52,30-34,1908,0.004380809478532236
STAT,1895,42,35-39,1937,0.15482955557684938
STAT,1849,23,30-34,1872,15.41119977641143
STAT,1852,47,45-49,1899,0.17847033889050293
STAT,1901,70,na,1971,2228.4376830955803
STAT,1831,34,25-29,1865,8.196966787567026
STAT,1802,53,40-44,1855,0.029410850252846676
STAT,1854,41,40-44,1895,1.627019262452639
STAT,1894,16,45-49,1910,0.07957619329007358
SIM,1775,79,na,1854,257
STAT,1868,23,40-44,1891,1.8737399115853157
STAT,1905,24,20-24,1929,93.48733085452427
SIM,1829,28,25-29,1857,34
STAT,1874,37,25-29,1911,2.779955659910499
STAT,1887,32,35-39,1919,10.699210030295175
STAT,1794,89,na,1883,36.218623246725585
STAT,1828,51,35-39,1879,0.007142380144174522
STAT,1876,27,na,1903,2327.4696724350356
SIM,1846,17,na,1863,2042
STAT,1822,46,20-24,1868,0.016981116209681995
STAT,1884,78,na,1962,938.5944375266466
STAT,1855,39,40-44,1894,3.069105321699837
STAT,1875,52,35-39,1927,0.00831093909539275
STAT,1806,101,na,1907,0.18987415317147247
STAT,1831,23,15-19,1854,6.655348216234945
STAT,1790,75,na,1865,385.2666807511599
STAT,1885,28,40-44,1913,2.809438756943266
STAT,1834,51,40-44,1885,0.0068153926447585295
STAT,1924,35,40-44,1959,1.6706370400696835
SIM,1843,30,20-24,1873,1
STAT,1883,26,40-44,1909,2.783011997073757
SIM,1845,91,na,1936,37
SIM,1856,6,na,1862,2326
SIM,1875,42,35-39,1917,2
STAT,1822,34,50-100,1856,2.024563822490026
STAT,1840,43,50-100,1883,0.7577044807434085
STAT,1939,29,na,1968,3553.806319720173
SIM,1937,20,15-19,1957,4
SIM,1935,16,20-24,1951,164
STAT,1889,28,50-100,1917,0.7434292098781909
SIM,1895,34,na,1929,2954
SIM,1939,22,15-19,1961,4
SIM,1826,40,na,1866,1562
SIM,1874,27,25-29,1901,41
STAT,1850,34,35-39,1884,7.304858991332202
STAT,1859,34,25-29,1893,7.656036836996015
SIM,1857,23,30-34,1880,14
SIM,1821,43,45-49,1864,1
STAT,1858,54,30-34,1912,0.004293188757856256
SIM,1908,18,na,1926,3467
STAT,1857,22,20-24,1879,59.24902936471478
STAT,1881,73,na,1954,1083.4014341008774
STAT,1867,100,na,1967,5.125503996919048
SIM,1937,28,25-29,1965,61
SIM,1904,21,45-49,1925,1
STAT,1929,28,25-29,1957,77.78715957382434
SIM,1896,19,25-29,1915,4
SIM,1835,25,45-49,1860,4
STAT,1888,19,25-29,1907,6.290211500438661
SIM,1829,45,na,1874,1417
STAT,1929,20,15-19,1949,6.397620527286195
STAT,1843,40,20-24,1883,0.12103132173370688
SIM,1865,22,20-24,1887,59
SIM,1826,37,40-44,1863,4
SIM,1850,23,20-24,1873,56
STAT,1874,37,30-34,1911,5.145875398720198
STAT,1877,16,45-49,1893,0.06419403602428317
STAT,1894,25,35-39,1919,11.805123497075034
STAT,1919,19,20-24,1938,140.77677256063845
SIM,1937,31,na,1968,3378
STAT,1851,108,na,1959,0.0032022835176251496
STAT,1940,15,30-34,1955,11.696322824786446
SIM,1893,28,40-44,1921,3
STAT,1856,27,50-100,1883,0.49045188187317257
STAT,1857,51,na,1908,1611.2457988224899
SIM,1835,34,35-39,1869,9
SIM,1915,23,40-44,1938,3
STAT,1871,31,50-100,1902,0.8616105280997763
SIM,1941,25,40-44,1966,4
STAT,1918,27,na,1945,3766.151451538416
SIM,1882,6,na,1888,2410
SIM,1934,32,35-39,1966,11
STAT,1821,53,na,1874,1273.2180851473152
SIM,1899,64,na,1963,2432
STAT,1871,44,45-49,1915,1.382748665157986
STAT,1907,23,40-44,1930,2.882282228072365
STAT,1915,16,50-100,1931,0.07425165820686626
SIM,1852,88,na,1940,84
SIM,1763,94,na,1857,1
SIM,1895,35,45-49,1930,3
STAT,1892,18,30-34,1910,1.880618207511437
STAT,1884,40,15-19,1924,0.013022109636544245
STAT,1910,47,na,1957,3237.1245450319443
STAT,1804,53,45-49,1857,0.042299298932991
STAT,1874,48,40-44,1922,0.16322201038561757
STAT,1930,21,45-49,1951,1.3658842437402385
STAT,1867,44,25-29,1911,0.5619051540226999
SIM,1869,33,45-49,1902,1
STAT,1795,104,na,1899,0.01288510055459337
STAT,1907,35,40-44,1942,1.3233922002554663
SIM,1886,40,45-49,1926,4
SIM,1927,19,20-24,1946,154
SIM,1937,25,20-24,1962,16
STAT,1842,23,20-24,1865,61.45166964946335
STAT,1925,1,na,1926,4766.281340633157
STAT,1766,93,na,1859,6.0105814018959025
SIM,1835,23,25-29,1858,47
SIM,1893,38,45-49,1931,1
SIM,1865,39,45-49,1904,1
STAT,1874,34,15-19,1908,0.13632188703270326
STAT,1808,71,na,1879,649.8038173048583
SIM,1835,22,35-39,1857,5
STAT,1887,35,45-49,1922,2.1261137725428134
STAT,1844,37,15-19,1881,0.04165717826825075
SIM,1826,56,na,1882,1226
SIM,1895,50,na,1945,2720
SIM,1917,20,40-44,1937,4
STAT,1882,44,20-24,1926,0.14401831479094618
STAT,1874,22,20-24,1896,66.53718577094902
STAT,1926,32,35-39,1958,10.439962974245852
STAT,1845,66,na,1911,1154.48817309263
SIM,1837,96,na,1933,4
STAT,1856,52,25-29,1908,0.0026067626397881394
SIM,1880,28,30-34,1908,26
SIM,1925,46,na,1971,4128
SIM,1863,28,25-29,1891,47
STAT,1846,45,25-29,1891,0.041017059083994965
STAT,1855,28,25-29,1883,31.003486688902672
STAT,1827,34,35-39,1861,10.822476205431926
STAT,1941,21,20-24,1962,108.58273197953706
SIM,1854,52,na,1906,1702
STAT,1924,47,35-39,1971,0.14501760739046687
STAT,1943,29,50-100,1972,1.0003966714629735
STAT,1922,32,na,1954,4037.207419752991
SIM,1929,15,15-19,1944,50
STAT,1870,33,na,1903,2199.613631004578
SIM,1864,73,na,1937,1045
STAT,1909,20,40-44,1929,2.969018777912195
SIM,1915,35,40-44,1950,2
STAT,1881,18,25-29,1899,5.155329780575524
SIM,1927,42,45-49,1969,1
SIM,1933,15,35-39,1948,5
SIM,1882,35,35-39,1917,13
SIM,1824,30,na,1854,1618
STAT,1846,34,15-19,1880,0.11621810508424678
SIM,1883,65,na,1948,1545
SIM,1884,10,na,1894,2542
SIM,1895,53,na,1948,2649
STAT,1860,54,40-44,1914,0.0078604356923699
SIM,1828,32,45-49,1860,1
SIM,1861,24,35-39,1885,7
STAT,1941,24,na,1965,3562.4172172129643
STAT,1953,12,na,1965,4489.11107470296
STAT,1860,43,30-34,1903,0.8762927041072627
STAT,1884,51,25-29,1935,0.003322430588840165
SIM,1894,19,15-19,1913,5
SIM,1850,78,na,1928,549
STAT,1829,33,na,1862,1726.2607901577048
STAT,1919,42,45-49,1961,0.17038193976190605
STAT,1856,54,20-24,1910,5.309679701957224E-4
SIM,1899,67,na,1966,2305
STAT,1880,46,15-19,1926,3.98727892092297E-4
STAT,1839,54,na,1893,1396.192116193045
STAT,1914,25,30-34,1939,37.56193288322032
STAT,1944,15,45-49,1959,0.5081082571231014
STAT,1876,33,40-44,1909,4.211558082492964
SIM,1878,38,50-100,1916,1
STAT,1853,24,35-39,1877,5.040122989418938
STAT,1888,68,na,1956,1731.9323132984396
SIM,1815,44,35-39,1859,1
STAT,1882,31,15-19,1913,0.1314432382151557
SIM,1915,27,50-100,1942,5
STAT,1898,35,20-24,1933,0.9951444131545475
SIM,1852,27,40-44,1879,2
STAT,1885,37,50-100,1922,1.1555261483129498
STAT,1925,15,35-39,1940,4.811428645857479
SIM,1900,36,35-39,1936,3
STAT,1874,35,35-39,1909,6.893985760336368
SIM,1884,33,40-44,1917,4
STAT,1920,46,na,1966,3846.179459477577
STAT,1781,82,na,1863,144.0455512856455
STAT,1831,23,45-49,1854,1.4067547992956824
STAT,1899,15,na,1914,3284.8751463585536
SIM,1833,27,30-34,1860,28
SIM,1862,87,na,1949,128
SIM,1882,37,30-34,1919,7
SIM,1874,91,na,1965,129
SIM,1831,27,na,1858,1690
STAT,1818,47,15-19,1865,8.549232786268553E-4
STAT,1819,58,na,1877,1107.014547781589
STAT,1815,44,na,1859,1330.7583029828902
STAT,1877,12,na,1889,2539.2817796177706
STAT,1809,54,40-44,1863,0.035059512303035834
STAT,1833,33,15-19,1866,0.11051283514220202
SIM,1817,42,40-44,1859,2
SIM,1887,79,na,1966,935
STAT,1880,33,50-100,1913,0.9069032840417386
STAT,1938,19,30-34,1957,11.349622343563604
SIM,1946,19,30-34,1965,17
STAT,1859,48,45-49,1907,0.17569054388968952
STAT,1870,28,20-24,1898,10.821221304093447
STAT,1917,15,50-100,1932,0.07651446066108254
STAT,1844,25,na,1869,1886.0529837810009
STAT,1766,90,na,1856,26.1986596
SIM,1908,22,50-100,1930,1
STAT,1896,63,na,1959,2318.286887639712
STAT,1876,45,40-44,1921,0.16862828071258054
SIM,1927,16,na,1943,4219
STAT,1841,43,20-24,1884,0.11147247856979424
STAT,1883,29,45-49,1912,1.0206458852118148
SIM,1876,24,25-29,1900,70
STAT,1846,34,45-49,1880,1.4231235248109377
STAT,1869,76,na,1945,866.3407602614424
STAT,1946,24,30-34,1970,30.194771377150378
STAT,1822,49,25-29,1871,0.0780860817239359
SIM,1856,38,50-100,1894,3
STAT,1862,54,20-24,1916,5.782910580919375E-4
SIM,1948,15,na,1963,3747
SIM,1848,38,30-34,1886,5
STAT,1868,35,na,1903,2145.2190344027404
STAT,1911,21,35-39,1932,8.459708110939316
SIM,1915,21,15-19,1936,3
STAT,1852,32,40-44,1884,3.4114934034860753
STAT,1854,40,na,1894,1681.1039010137824
STAT,1928,42,na,1970,4473.16711479392
SIM,1874,72,na,1946,1141
STAT,1858,16,35-39,1874,0.47817521466554225
SIM,1905,29,na,1934,3215
STAT,1815,40,15-19,1855,0.04278463555914968
STAT,1867,50,na,1917,1937.3062823758542
SIM,1871,31,35-39,1902,13
STAT,1835,32,40-44,1867,3.444861865271516
STAT,1820,90,na,1910,42.00108386796133
SIM,1904,47,50-100,1951,2
STAT,1906,40,50-100,1946,0.10193598416819634
SIM,1876,35,35-39,1911,9
STAT,1840,22,50-100,1862,0.3611533954646769
SIM,1885,35,na,1920,2262
SIM,1923,42,na,1965,4017
STAT,1807,49,na,1856,1239.1986111825881
STAT,1907,43,na,1950,3194.598747407594
STAT,1815,51,25-29,1866,0.008404980911523969
STAT,1869,17,na,1886,2341.488117736648
STAT,1846,47,20-24,1893,0.008421424790040936
STAT,1882,42,25-29,1924,0.5895761388878157
SIM,1883,49,50-100,1932,4
STAT,1794,105,na,1899,0.005268246213977394
SIM,1885,75,na,1960,1099
SIM,1848,36,40-44,1884,7
STAT,1858,31,50-100,1889,0.6866074920308454
SIM,1843,32,40-44,1875,2
STAT,1777,77,na,1854,295.0
SIM,1859,26,45-49,1885,1
STAT,1907,21,15-19,1928,4.591106342208112
STAT,1835,44,40-44,1879,1.6390195968609256
SIM,1932,30,50-100,1962,4
SIM,1840,63,na,1903,1204
SIM,1935,19,25-29,1954,63
STAT,1861,34,40-44,1895,3.3729258559695965
STAT,1831,27,30-34,1858,22.089724924369303
STAT,1852,33,25-29,1885,7.974148248454562
STAT,1799,80,na,1879,262.56581715653294
STAT,1847,51,50-100,1898,0.011165601200487145
STAT,1809,96,na,1905,3.6071043764079187
SIM,1813,86,na,1899,73
STAT,1847,15,20-24,1862,16.47425747549274
STAT,1898,38,25-29,1936,0.7907844089322537
SIM,1818,45,na,1863,1313
STAT,1887,23,45-49,1910,0.7344413590929701
SIM,1860,33,25-29,1893,13
STAT,1863,22,45-49,1885,0.5906054526093121
STAT,1937,35,15-19,1972,0.01816935532991679
SIM,1897,60,na,1957,2456
SIM,1909,23,40-44,1932,3
STAT,1927,19,25-29,1946,50.63471434589674
SIM,1836,58,na,1894,1249
STAT,1844,22,na,1866,1874.078006076876
STAT,1955,15,20-24,1970,170.1013924335247
STAT,1826,42,40-44,1868,2.2159206512063303
STAT,1962,3,na,1965,4760.142480845441
STAT,1862,101,na,1963,1.607992033962827
STAT,1929,25,20-24,1954,21.6649305816488
SIM,1939,24,35-39,1963,13
STAT,1933,13,na,1946,5003.000602904864
STAT,1862,18,15-19,1880,5.444894371234541
STAT,1878,40,45-49,1918,1.4867263075882102
SIM,1824,33,20-24,1857,2
STAT,1883,24,20-24,1907,63.40438872888568
SIM,1880,39,40-44,1919,7
STAT,1815,53,20-24,1868,0.0016822482206758152
STAT,1831,38,40-44,1869,3.4166021008061302
STAT,1900,46,40-44,1946,0.12692435789166898
STAT,1911,47,25-29,1958,0.047430138099615195
STAT,1841,30,15-19,1871,0.1206974134432338
SIM,1950,13,na,1963,4274
STAT,1946,25,20-24,1971,19.226312872379328
STAT,1870,17,40-44,1887,0.17092060790714822
SIM,1817,60,na,1877,1092
SIM,1843,44,40-44,1887,3
STAT,1851,51,na,1902,1586.5079508313186
SIM,1842,67,na,1909,1095
STAT,1832,53,20-24,1885,4.56237112696454E-4
STAT,1850,31,50-100,1881,0.6818186227359149
STAT,1872,28,30-34,1900,23.793486468252972
STAT,1855,65,na,1920,1196.8936298712729
SIM,1820,46,50-100,1866,1
SIM,1845,32,45-49,1877,2
SIM,1910,34,45-49,1944,1
STAT,1891,32,na,1923,2790.329560767686
STAT,1818,89,na,1907,50.64877371418787
STAT,1833,78,na,1911,474.33930485663166
STAT,1928,21,50-100,1949,0.7785244118559331
SIM,1867,30,30-34,1897,16
SIM,1923,31,20-24,1954,2
STAT,1902,34,45-49,1936,1.3234561746318059
STAT,1857,37,25-29,1894,2.144284332826393
STAT,1873,30,50-100,1903,0.8856577660579155
STAT,1796,69,na,1865,736.6349303622078
SIM,1851,47,na,1898,1670
STAT,1896,43,50-100,1939,0.09093339046994948
SIM,1870,18,15-19,1888,5
STAT,1890,53,na,1943,2447.1029919619227
SIM,1889,39,30-34,1928,7
STAT,1868,35,35-39,1903,6.440200679569321
SIM,1848,43,na,1891,1699
SIM,1857,17,na,1874,2194
STAT,1872,39,40-44,1911,4.108982723470763
SIM,1894,49,na,1943,2839
STAT,1846,22,45-49,1868,0.6066432772908503
STAT,1859,48,15-19,1907,2.9778033222701157E-4
STAT,1843,43,25-29,1886,0.47093471339893367
STAT,1899,48,50-100,1947,0.17710067299093216
SIM,1899,44,40-44,1943,2
SIM,1855,15,20-24,1870,14
STAT,1899,17,35-39,1916,0.7103662484568329
STAT,1902,46,45-49,1948,0.17797743356439857
SIM,1812,45,na,1857,1344
SIM,1885,25,35-39,1910,11
SIM,1918,19,25-29,1937,51
STAT,1907,64,na,1971,2737.817386629319
STAT,1826,43,25-29,1869,0.6209490471069459
STAT,1903,50,na,1953,2935.595970473199
STAT,1866,26,40-44,1892,2.618057065355484
SIM,1896,16,na,1912,3221
STAT,1776,92,na,1868,9.043599048233542
STAT,1911,36,15-19,1947,0.017602496974296042
STAT,1929,36,30-34,1965,2.2126113141170105
STAT,1837,32,45-49,1869,1.3802104994101054
SIM,1887,39,na,1926,2434
SIM,1861,22,na,1883,2105
STAT,1842,15,na,1857,2124.005451574384
STAT,1859,30,30-34,1889,13.355060887679018
STAT,1915,31,20-24,1946,2.356169984591183
STAT,1893,34,25-29,1927,12.171839244655606
STAT,1872,24,15-19,1896,3.1085594760888244
STAT,1841,41,25-29,1882,0.46243519923056975
SIM,1860,32,40-44,1892,4
SIM,1907,22,30-34,1929,35
SIM,1794,77,na,1871,321
SIM,1872,25,na,1897,2232
STAT,1816,38,45-49,1854,7.364983032014557
STAT,1881,40,50-100,1921,0.9733596641524269
SIM,1824,38,45-49,1862,1
STAT,1853,36,50-100,1889,0.920007325642194
STAT,1926,22,50-100,1948,0.7552625318001551
STAT,1827,69,na,1896,814.4122105242506
SIM,1931,21,na,1952,4454
STAT,1841,49,35-39,1890,0.09378686534260729
SIM,1891,24,20-24,1915,97
STAT,1915,42,30-34,1957,0.12158169844965099
STAT,1897,17,50-100,1914,0.061897092385513094
SIM,1854,34,45-49,1888,1
SIM,1891,29,45-49,1920,1
STAT,1851,17,30-34,1868,1.4210598127765652
SIM,1861,28,20-24,1889,9
STAT,1833,21,20-24,1854,72.62882536032892
STAT,1930,34,20-24,1964,2.9700560406334566
STAT,1859,45,40-44,1904,0.13035867330393272
STAT,1913,21,45-49,1934,1.0328725684287383
SIM,1878,20,35-39,1898,5
SIM,1928,23,20-24,1951,142
SIM,1920,17,15-19,1937,42
STAT,1908,19,15-19,1927,8.269900063339806
SIM,1938,16,na,1954,3355
STAT,1891,37,30-34,1928,6.231911144199916
STAT,1861,10,na,1871,2179.458059674482
STAT,1831,74,na,1905,676.8212616301315
STAT,1822,110,na,1932,1.4273772543626988E-4
SIM,1863,24,15-19,1887,1
SIM,1913,9,na,1922,3711
STAT,1857,91,na,1948,43.15668152618365
STAT,1897,42,15-19,1939,0.001210102060293884
SIM,1840,60,na,1900,1308
STAT,1878,50,na,1928,2147.96811717818
SIM,1879,35,50-100,1914,4
SIM,1916,32,na,1948,3596
STAT,1876,48,45-49,1924,0.2272683021597053
STAT,1865,24,na,1889,2025.540283784544
SIM,1878,65,na,1943,1683
STAT,1915,45,35-39,1960,0.12329838914585349
STAT,1879,75,na,1954,1016.523881106497
STAT,1875,61,na,1936,1813.581872864051
SIM,1874,51,na,1925,2056
STAT,1838,28,25-29,1866,36.436590433669124
STAT,1840,19,20-24,1859,15.79753294693744
STAT,1917,42,na,1959,3661.2892696863246
STAT,1909,23,45-49,1932,0.9846016827882892
STAT,1855,24,15-19,1879,2.6905439765380033
SIM,1876,28,40-44,1904,4
SIM,1863,35,25-29,1898,1
STAT,1868,24,25-29,1892,51.31098771808317
STAT,1888,16,20-24,1904,19.833813930720307
STAT,1876,86,na,1962,368.4529768178486
STAT,1892,16,40-44,1908,0.2169069814367365
STAT,1904,36,50-100,1940,0.3607527287385959
STAT,1912,17,15-19,1929,8.667461270850428
SIM,1900,24,40-44,1924,3
STAT,1905,57,na,1962,2876.7425910884695
STAT,1824,43,15-19,1867,0.0170317087654323
STAT,1887,27,na,1914,2521.3535052854286
SIM,1835,49,50-100,1884,2
STAT,1831,36,20-24,1867,0.6159167175790732
SIM,1921,21,45-49,1942,2
STAT,1891,48,40-44,1939,0.11150232814575278
SIM,1854,38,30-34,1892,4
STAT,1833,40,50-100,1873,0.7992858571429314
SIM,1889,37,40-44,1926,8
STAT,1885,23,35-39,1908,5.475262394658463
SIM,1913,27,25-29,1940,59
STAT,1845,54,45-49,1899,0.009941167959020315
SIM,1841,21,20-24,1862,55
SIM,1896,16,20-24,1912,21
STAT,1787,92,na,1879,11.020658386822776
STAT,1850,33,15-19,1883,0.10379374525029474
STAT,1824,46,30-34,1870,0.11537544098332807
SIM,1885,48,50-100,1933,2
STAT,1853,28,20-24,1881,9.105782079704372
SIM,1886,42,35-39,1928,4
SIM,1829,25,20-24,1854,6
SIM,1873,87,na,1960,227
STAT,1856,8,na,1864,2148.3879671138984
SIM,1913,38,35-39,1951,8
SIM,1928,34,30-34,1962,33
SIM,1841,40,50-100,1881,1
SIM,1906,31,20-24,1937,2
SIM,1861,25,na,1886,2102
SIM,1863,39,40-44,1902,4
STAT,1889,33,20-24,1922,3.1391981834205653
SIM,1826,44,40-44,1870,7
STAT,1851,15,40-44,1866,0.16501054367478635
STAT,1940,24,50-100,1964,0.6327300673767686
STAT,1896,36,25-29,1932,3.612072239503024
STAT,1846,38,30-34,1884,3.883598254716747
STAT,1911,49,15-19,1960,3.2744507879355945E-4
STAT,1864,21,na,1885,2043.6199615484725
STAT,1845,18,15-19,1863,5.252272109320947
STAT,1878,53,na,1931,2083.5388557825813
STAT,1765,110,na,1875,0.0017882981827415925
STAT,1862,45,50-100,1907,0.1998868866132808
SIM,1893,35,40-44,1928,6
STAT,1885,35,40-44,1920,4.15914357921543
SIM,1815,93,na,1908,10
STAT,1834,53,30-34,1887,0.0037039082875779806
STAT,1820,36,45-49,1856,4.864675446749604
SIM,1946,15,15-19,1961,35
STAT,1803,56,na,1859,1037.9560904727327
STAT,1877,48,50-100,1925,0.23774061815044298
SIM,1906,33,40-44,1939,3
SIM,1895,20,40-44,1915,4
STAT,1865,47,30-34,1912,0.08271005541602898
STAT,1922,24,15-19,1946,5.731166101778927
STAT,1899,12,na,1911,3343.3511018843783
STAT,1839,29,50-100,1868,0.5296424408753581
STAT,1848,45,35-39,1893,0.10186481870774243
STAT,1872,24,45-49,1896,0.6570626839955039
SIM,1850,28,45-49,1878,1
SIM,1895,39,30-34,1934,12
SIM,1853,18,15-19,1871,8
STAT,1823,52,50-100,1875,0.017331427459440437
STAT,1842,28,45-49,1870,0.9707499490030271
STAT,1860,51,50-100,1911,0.011650761045932186
STAT,1870,34,50-100,1904,0.8408791145254512
STAT,1877,28,na,1905,2331.3140367705896
SIM,1886,17,na,1903,2466
STAT,1891,34,15-19,1925,0.165092587980026
STAT,1895,40,45-49,1935,1.863674991227455
SIM,1852,22,35-39,1874,5
STAT,1810,53,45-49,1863,0.04827795249154222
STAT,1856,41,15-19,1897,0.010264043087416548
SIM,1930,26,50-100,1956,1
STAT,1890,21,50-100,1911,0.47243095551371805
SIM,1925,42,40-44,1967,2
SIM,1838,19,30-34,1857,1
SIM,1884,50,na,1934,2150
SIM,1839,47,na,1886,1579
SIM,1916,19,15-19,1935,43
SIM,1835,33,na,1868,1702
STAT,1887,39,30-34,1926,5.574010104531064
STAT,1887,48,20-24,1935,0.012518659768637601
STAT,1920,27,20-24,1947,18.917606461439988
STAT,1941,24,25-29,1965,90.10860906928625
STAT,1829,45,25-29,1874,0.047708217124441094
SIM,1906,14,na,1920,3619
SIM,1830,30,35-39,1860,11
SIM,1883,18,30-34,1901,1
STAT,1830,89,na,1919,62.75387624795705
STAT,1866,28,30-34,1894,21.855953830356086
SIM,1897,33,20-24,1930,2
SIM,1872,18,25-29,1890,7
SIM,1878,35,45-49,1913,2
STAT,1842,26,25-29,1868,37.52146061084412
STAT,1938,15,15-19,1953,42.48353671891136
SIM,1862,66,na,1928,1396
SIM,1850,26,25-29,1876,33
STAT,1863,76,na,1939,786.736863846864
STAT,1831,36,50-100,1867,0.9809799370365957
STAT,1871,44,15-19,1915,0.01275892744856163
SIM,1864,14,na,1878,2393
STAT,1896,25,15-19,1921,0.5703053003073978
SIM,1911,54,na,1965,3259
STAT,1892,57,na,1949,2377.4071115556953
STAT,1867,41,20-24,1908,0.14150462663601968
SIM,1870,45,50-100,1915,2
STAT,1865,42,25-29,1907,0.5505777014787768
SIM,1905,18,30-34,1923,3
STAT,1864,18,25-29,1882,4.920286080130707
STAT,1829,34,15-19,1863,0.13196098140975784
STAT,1844,22,35-39,1866,5.114822866166241
STAT,1897,46,30-34,1943,0.0691824653794774
SIM,1887,29,25-29,1916,39
STAT,1857,39,45-49,1896,1.4697084219560197
STAT,1852,35,45-49,1887,1.5547699895632183
SIM,1915,1,na,1916,3972
STAT,1948,22,15-19,1970,5.774423653848675
STAT,1840,24,25-29,1864,49.973288547462644
STAT,1842,16,50-100,1858,0.04506587240263357
STAT,1830,43,15-19,1873,0.010359274817123293
SIM,1827,41,na,1868,1476
STAT,1875,16,35-39,1891,0.5338510217707408
SIM,1856,32,20-24,1888,2
SIM,1829,85,na,1914,138
STAT,1932,31,na,1963,4752.490357015258
SIM,1874,26,40-44,1900,10
SIM,1879,16,15-19,1895,5
SIM,1913,23,30-34,1936,31
SIM,1826,96,na,1922,8
SIM,1796,81,na,1877,177
SIM,1804,93,na,1897,13
SIM,1888,24,na,1912,2554
SIM,1902,21,35-39,1923,16
SIM,1880,37,20-24,1917,4
STAT,1850,47,40-44,1897,0.11996330193991948
SIM,1883,16,35-39,1899,1
STAT,1826,40,20-24,1866,0.16241609365633772
STAT,1887,20,40-44,1907,2.2146724147852708
SIM,1918,16,20-24,1934,24
SIM,1849,84,na,1933,187
STAT,1849,24,15-19,1873,2.833823885829902
SIM,1866,40,na,1906,2063
SIM,1860,30,20-24,1890,1
SIM,1891,27,25-29,1918,60
STAT,1835,47,15-19,1882,2.6306745725612063E-4
STAT,1832,37,na,1869,1624.7837419419109
STAT,1863,42,50-100,1905,0.8762119074725899
SIM,1907,25,35-39,1932,14
STAT,1886,19,15-19,1905,5.891652380103297
STAT,1868,39,20-24,1907,0.6882902282529548
STAT,1790,96,na,1886,1.521641401257332
STAT,1931,17,25-29,1948,53.58561156451103
SIM,1860,35,45-49,1895,1
SIM,1835,27,40-44,1862,2
SIM,1840,19,25-29,1859,5
SIM,1838,22,na,1860,1759
STAT,1861,37,45-49,1898,1.5638437926537496
STAT,1935,4,na,1939,5212.286749051931
STAT,1894,18,40-44,1912,0.2216851617193844
SIM,1935,28,15-19,1963,3
SIM,1900,33,30-34,1933,24
STAT,1931,28,35-39,1959,18.302768412664808
STAT,1848,32,20-24,1880,2.270953070142941
SIM,1859,23,40-44,1882,1
STAT,1879,29,25-29,1908,41.47124361084282
SIM,1797,66,na,1863,790
SIM,1922,25,30-34,1947,46
STAT,1766,109,na,1875,0.002886825839941219
STAT,1910,40,35-39,1950,0.18176673155586223
STAT,1879,52,50-100,1931,0.014833550142949766
STAT,1819,55,na,1874,1174.7804477561017
STAT,1815,41,na,1856,1380.3289265887622
STAT,1833,34,35-39,1867,7.7766299876954665
SIM,1876,39,na,1915,2313
STAT,1849,19,40-44,1868,0.16037221374409147
SIM,1841,34,35-39,1875,11
STAT,1875,22,50-100,1897,0.3957760971150579
STAT,1846,44,50-100,1890,0.734820711753559
SIM,1857,24,15-19,1881,2
STAT,1846,49,40-44,1895,0.1181881050558196
STAT,1878,42,35-39,1920,1.7786568667843412
SIM,1930,4,na,1934,4877
STAT,1914,19,50-100,1933,0.0728086059648052
STAT,1862,50,35-39,1912,0.007037200464968989
STAT,1827,27,40-44,1854,8.055218891948929
SIM,1865,37,25-29,1902,2
STAT,1875,54,30-34,1929,0.005618307095409474
STAT,1905,23,30-34,1928,24.241396782211307
STAT,1841,34,30-34,1875,14.195915420833035
STAT,1930,24,na,1954,4392.026855287331
SIM,1875,54,na,1929,2024
SIM,1923,34,25-29,1957,16
SIM,1871,40,na,1911,2260
SIM,1910,31,40-44,1941,4
SIM,1858,43,40-44,1901,5
SIM,1928,38,25-29,1966,3
STAT,1830,43,45-49,1873,1.1226863294842875
STAT,1894,29,20-24,1923,14.154404896971396
STAT,1873,52,30-34,1925,0.005677562934039086
STAT,1866,65,na,1931,1471.9388194667047
STAT,1857,34,20-24,1891,1.995869695535592
STAT,1921,29,50-100,1950,1.0405671983008666
STAT,1852,30,20-24,1882,2.170991766241256
STAT,1911,44,20-24,1955,0.015724476164594922
STAT,1908,19,45-49,1927,0.09102805052148658
STAT,1827,38,20-24,1865,0.7515237073549067
STAT,1851,54,45-49,1905,0.010349538498263087
SIM,1939,21,30-34,1960,30
SIM,1873,10,na,1883,2543
SIM,1815,56,na,1871,1088
SIM,1848,22,15-19,1870,5
STAT,1837,41,35-39,1878,1.3662801046512927
STAT,1877,68,na,1945,1498.118000607561
STAT,1883,27,25-29,1910,39.16549435213067
STAT,1899,21,50-100,1920,0.5295248265319371
SIM,1889,23,15-19,1912,3
STAT,1826,45,45-49,1871,0.22666147425792119
STAT,1845,47,50-100,1892,0.1721895419470808
STAT,1933,25,40-44,1958,5.851768057669445
STAT,1822,78,na,1900,403.58408206507863
STAT,1856,10,na,1866,2114.705405002206
SIM,1929,17,35-39,1946,5
STAT,1904,44,20-24,1948,0.014739718598731005
STAT,1893,31,20-24,1924,3.253169902334285
STAT,1913,45,50-100,1958,0.20948552708068668
STAT,1856,41,45-49,1897,1.1123655915019153
STAT,1858,52,35-39,1910,0.0063507440383103065
SIM,1822,34,25-29,1856,10
STAT,1893,36,45-49,1929,2.400925525235378
SIM,1906,54,na,1960,3023
STAT,1902,31,40-44,1933,5.805112394504368
SIM,1865,34,20-24,1899,2
SIM,1902,40,na,1942,3148
STAT,1850,36,30-34,1886,3.8512339141732554
STAT,1915,34,25-29,1949,8.81568536120669
SIM,1846,28,25-29,1874,50
SIM,1926,25,45-49,1951,3
SIM,1833,25,40-44,1858,4
SIM,1824,36,25-29,1860,1
STAT,1908,46,na,1954,3161.63353658769
SIM,1948,23,30-34,1971,39
STAT,1904,32,na,1936,3260.530352580565
SIM,1899,27,na,1926,3060
SIM,1921,45,50-100,1966,2
STAT,1859,33,35-39,1892,7.602823751828468
STAT,1880,32,na,1912,2371.989422054932
STAT,1788,77,na,1865,326.5557058239552
SIM,1845,41,35-39,1886,3
STAT,1911,32,na,1943,3478.365714356681
STAT,1924,23,40-44,1947,3.7368799386229354
SIM,1932,23,40-44,1955,9
STAT,1872,37,20-24,1909,0.7309206921980013
STAT,1856,110,na,1966,0.0015221041387328913
STAT,1835,47,45-49,1882,0.15520993041867875
STAT,1841,45,40-44,1886,0.12071854232914907
SIM,1930,34,25-29,1964,15
SIM,1838,81,na,1919,327
STAT,1889,46,35-39,1935,0.16374165772364366
STAT,1817,48,na,1865,1268.8944315138215
STAT,1922,34,25-29,1956,9.81796198982571
STAT,1918,25,45-49,1943,1.7486187899724368
STAT,1861,37,15-19,1898,0.04405194306008512
STAT,1913,46,20-24,1959,0.01021282926750433
STAT,1940,7,na,1947,3818.077240357925
SIM,1836,55,na,1891,1285
SIM,1873,4,na,1877,2667
STAT,1859,22,25-29,1881,44.77879254165484
STAT,1881,25,25-29,1906,38.846759503776525
STAT,1852,36,na,1888,1818.5041168836865
STAT,1941,21,50-100,1962,0.6425394608411781
SIM,1867,22,25-29,1889,62
SIM,1915,28,na,1943,3523
STAT,1849,27,25-29,1876,36.14359886422322
STAT,1842,24,35-39,1866,5.166338138758253
SIM,1899,33,25-29,1932,23
STAT,1864,42,50-100,1906,0.8908755342627199
SIM,1893,8,na,1901,3234
SIM,1799,86,na,1885,49
SIM,1945,23,20-24,1968,110
STAT,1924,26,45-49,1950,1.9069722548932553
SIM,1957,14,na,1971,4694
STAT,1817,52,40-44,1869,0.022560969097539872
STAT,1898,49,40-44,1947,0.1209191320044297
STAT,1854,62,na,1916,1316.1386410952107
STAT,1880,38,30-34,1918,5.271315856220274
STAT,1896,26,15-19,1922,0.5684061836573745
STAT,1943,20,40-44,1963,3.381659567429721
SIM,1860,37,40-44,1897,5
SIM,1874,24,20-24,1898,53
SIM,1914,15,30-34,1929,4
STAT,1930,37,25-29,1967,1.2133236500422575
STAT,1828,108,na,1936,0.0010398264445596298
SIM,1919,6,na,1925,4176
STAT,1833,106,na,1939,0.007371099015338503
STAT,1833,24,25-29,1857,46.74135524358086
SIM,1872,5,na,1877,2599
SIM,1897,36,25-29,1933,3
STAT,1878,90,na,1968,229.28266501151342
STAT,1850,72,na,1922,889.0809395851843
SIM,1781,88,na,1869,34
SIM,1928,37,35-39,1965,9
SIM,1874,35,na,1909,2280
SIM,1879,1,na,1880,3246
STAT,1889,49,30-34,1938,0.06235261833711511
STAT,1897,30,45-49,1927,2.2208811617172706
SIM,1932,26,45-49,1958,3
STAT,1911,33,40-44,1944,3.5839111650977626
STAT,1925,19,15-19,1944,51.51945738602677
STAT,1815,44,30-34,1859,2.941899997493016
SIM,1885,13,na,1898,2459
STAT,1866,24,20-24,1890,59.646278226879446
STAT,1906,15,30-34,1921,2.2027281144195774
STAT,1848,68,na,1916,1100.9494762175207
SIM,1844,90,na,1934,37
STAT,1845,50,35-39,1895,0.006151203806653347
SIM,1851,42,40-44,1893,7
SIM,1838,29,40-44,1867,3
STAT,1887,67,na,1954,1674.7771280749241
STAT,1820,37,20-24,1857,1.7595474583432882
SIM,1939,29,35-39,1968,16
STAT,1882,35,30-34,1917,4.945743188839462
SIM,1910,31,35-39,1941,12
STAT,1829,73,na,1902,728.0313819257192
SIM,1824,76,na,1900,528
STAT,1836,27,15-19,1863,0.37073048881706483
STAT,1865,49,45-49,1914,0.19836299402593977
STAT,1908,27,50-100,1935,0.8962287975743986
STAT,1829,35,15-19,1864,0.051909794033768816
STAT,1891,72,na,1963,1699.7624054968085
STAT,1844,21,35-39,1865,5.151812882663767
STAT,1939,31,30-34,1970,15.19330064559925
SIM,1879,24,50-100,1903,1
STAT,1919,33,50-100,1952,0.8391240379774413
SIM,1902,18,na,1920,3370
STAT,1809,45,50-100,1854,0.929670224487905
SIM,1862,40,35-39,1902,3
STAT,1866,101,na,1967,2.877192323655509
STAT,1849,16,na,1865,2048.666236308595
STAT,1944,15,50-100,1959,0.38108119284232594
SIM,1852,21,35-39,1873,6
STAT,1909,36,20-24,1945,0.23678839579905206
SIM,1829,29,30-34,1858,23
STAT,1900,30,30-34,1930,23.066455732343233
STAT,1855,24,45-49,1879,0.5687058781504494
SIM,1830,45,50-100,1875,1
SIM,1795,96,na,1891,1
STAT,1813,47,30-34,1860,0.29280554118037677
SIM,1905,15,20-24,1920,24
SIM,1836,95,na,1931,10
SIM,1877,18,na,1895,2467
STAT,1932,34,25-29,1966,11.592492369461251
SIM,1907,25,40-44,1932,5
STAT,1838,35,25-29,1873,2.4192578776644873
SIM,1882,30,na,1912,2172
STAT,1835,21,25-29,1856,47.82149667865228
STAT,1931,16,35-39,1947,5.201436657464939
STAT,1871,58,na,1929,1852.1059721142653
SIM,1928,20,40-44,1948,4
STAT,1822,75,na,1897,531.751076822545
STAT,1900,23,25-29,1923,74.79367025866414
SIM,1922,29,25-29,1951,69
STAT,1813,80,na,1893,261.62133891999406
STAT,1902,31,35-39,1933,13.556052470652952
SIM,1833,53,na,1886,1316
SIM,1907,18,35-39,1925,1
STAT,1875,17,25-29,1892,5.499775421636396
STAT,1840,29,30-34,1869,21.553326877665683
SIM,1831,40,na,1871,1563
STAT,1950,16,45-49,1966,0.5581928643745235
SIM,1839,44,na,1883,1642
STAT,1879,36,25-29,1915,2.8566952314906104
STAT,1898,30,20-24,1928,3.4845301274738447
STAT,1886,15,35-39,1901,0.5502244486129197
STAT,1901,26,35-39,1927,12.802436531195818
STAT,1942,16,50-100,1958,0.3699606070644711
STAT,1862,91,na,1953,46.69654304509796
STAT,1856,17,15-19,1873,5.191998002138374
STAT,1873,35,na,1908,2280.621700694175
STAT,1831,29,20-24,1860,9.848000793661079
STAT,1833,37,30-34,1870,4.0563219969926525
SIM,1864,17,15-19,1881,8
SIM,1952,19,25-29,1971,60
STAT,1913,47,35-39,1960,0.11885417924922137
STAT,1889,36,25-29,1925,3.3740889508292087
STAT,1880,30,35-39,1910,10.147201895078098
SIM,1808,86,na,1894,74
STAT,1854,48,30-34,1902,0.06882927393400512
STAT,1857,22,15-19,1879,2.8364083270007177
SIM,1841,24,25-29,1865,46
SIM,1844,13,na,1857,2189
STAT,1852,37,40-44,1889,3.343952120391273
SIM,1874,38,40-44,1912,7
SIM,1827,59,na,1886,1075
SIM,1848,80,na,1928,415
STAT,1792,106,na,1898,0.0020446720430720927
STAT,1847,19,30-34,1866,1.446517203983365
SIM,1890,35,30-34,1925,6
SIM,1865,22,15-19,1887,5
STAT,1811,49,50-100,1860,0.7900839632703048
STAT,1844,78,na,1922,548.502731980263
STAT,1857,11,na,1868,2099.171841509082
SIM,1800,82,na,1882,127
STAT,1898,21,50-100,1919,0.5230677923506108
STAT,1820,74,na,1894,591.2225737412984
STAT,1876,49,20-24,1925,0.011458714149548912
STAT,1947,19,35-39,1966,4.462645739650291
SIM,1852,47,50-100,1899,1
STAT,1869,30,na,1899,2199.6709025893674
SIM,1823,44,30-34,1867,2
STAT,1855,25,15-19,1880,0.37339960370259334
STAT,1907,27,50-100,1934,0.8875521065612592
SIM,1825,58,na,1883,1098
SIM,1884,41,25-29,1925,1
STAT,1863,0,na,1863,3188.5764061447408
STAT,1915,44,35-39,1959,0.19086313649607367
SIM,1806,73,na,1879,477
STAT,1874,25,50-100,1899,0.6218334656835921
SIM,1855,19,30-34,1874,2
SIM,1924,15,30-34,1939,23
STAT,1913,15,na,1928,3746.9956607777926
SIM,1855,56,na,1911,1596
STAT,1851,53,30-34,1904,0.004295015983234637
STAT,1929,26,20-24,1955,21.5927863628119
SIM,1933,19,15-19,1952,44
STAT,1940,29,na,1969,3604.842081104485
SIM,1824,34,35-39,1858,6
SIM,1841,37,30-34,1878,12
STAT,1842,77,na,1919,615.54452615074
STAT,1884,43,40-44,1927,2.0846199348223373
STAT,1875,38,50-100,1913,1.1856608416513956
SIM,1894,71,na,1965,1964
STAT,1885,22,35-39,1907,5.492233395851645
STAT,1890,41,15-19,1931,0.01602289950693007
SIM,1848,32,25-29,1880,5
STAT,1819,71,na,1890,666.5820602347028
SIM,1907,55,na,1962,3018
STAT,1877,28,15-19,1905,0.44320670423846614
SIM,1962,1,na,1963,4683
STAT,1867,46,45-49,1913,0.20992644644416852
STAT,1920,26,45-49,1946,1.796568739731504
STAT,1967,1,na,1968,4645.454339782657
SIM,1900,17,na,1917,3283
SIM,1886,20,na,1906,2313
SIM,1919,33,20-24,1952,2
STAT,1919,12,na,1931,4136.466715373295
STAT,1920,15,20-24,1935,28.96484808791736
SIM,1867,41,na,1908,2013
STAT,1922,31,20-24,1953,2.6143594276682802
SIM,1911,15,20-24,1926,21
STAT,1881,46,50-100,1927,0.2246586021924852
STAT,1891,33,15-19,1924,0.16581554375077937
STAT,1924,20,30-34,1944,32.23283126749383
STAT,1825,89,na,1914,59.396643953298
SIM,1821,43,50-100,1864,1
STAT,1859,32,35-39,1891,7.6350436359722735
STAT,1876,41,25-29,1917,0.6291008239171711
STAT,1794,86,na,1880,68.32872494154809
STAT,1862,97,na,1959,7.7368093468998484
STAT,1807,92,na,1899,14.940261938561902
SIM,1890,81,na,1971,997
SIM,1920,37,na,1957,3837
SIM,1929,26,30-34,1955,63
STAT,1794,108,na,1902,3.291183519705657E-4
STAT,1920,37,25-29,1957,1.0184614266040597
STAT,1875,49,50-100,1924,0.23338727660660424
SIM,1913,26,35-39,1939,24
SIM,1925,30,40-44,1955,4
STAT,1944,19,25-29,1963,44.02552979127836
SIM,1856,35,25-29,1891,2
SIM,1867,32,35-39,1899,14
STAT,1908,18,45-49,1926,0.09127906795837214
SIM,1895,30,45-49,1925,3
STAT,1896,25,45-49,1921,1.39565398014969
STAT,1887,30,45-49,1917,1.8571510907895266
STAT,1897,18,15-19,1915,7.4781583986020035
STAT,1866,28,na,1894,2071.318775617277
STAT,1916,15,30-34,1931,2.4542801262207172
STAT,1761,113,na,1874,2.962918533575877E-4
SIM,1849,68,na,1917,1101
SIM,1852,26,na,1878,1961
STAT,1798,76,na,1874,373.6435019386198
STAT,1829,34,45-49,1863,1.615899492297099
STAT,1874,44,25-29,1918,0.6116537195215698
STAT,1946,4,na,1950,4174.793058130168
STAT,1832,53,na,1885,1320.2060347258002
STAT,1907,20,30-34,1927,24.861413331087242
STAT,1905,26,35-39,1931,13.217490788126483
SIM,1884,22,25-29,1906,66
STAT,1864,25,25-29,1889,36.097289842351216
STAT,1895,49,30-34,1944,0.06590940559782439
STAT,1902,9,na,1911,3459.0303155936044
STAT,1903,37,na,1940,3191.4972920096784
STAT,1850,38,45-49,1888,1.4109162891860563
SIM,1932,20,30-34,1952,45
STAT,1914,29,25-29,1943,62.22470134702402
STAT,1938,26,30-34,1964,36.68368188377145
SIM,1856,32,na,1888,1897
SIM,1861,62,na,1923,1558
SIM,1930,31,20-24,1961,2
STAT,1918,26,45-49,1944,1.7427958894018283
SIM,1819,46,na,1865,1376
SIM,1888,18,15-19,1906,8
STAT,1915,22,na,1937,3565.7167439331165
STAT,1807,100,na,1907,0.380827807856065
STAT,1903,15,20-24,1918,23.93843934308414
STAT,1927,16,45-49,1943,0.5882736826077741
STAT,1948,24,35-39,1972,10.20714735603443
SIM,1822,39,30-34,1861,9
STAT,1921,10,na,1931,4279.957237311938
STAT,1848,48,30-34,1896,0.06886075029868335
STAT,1824,42,15-19,1866,0.017469101480388452
STAT,1925,18,45-49,1943,0.568646297524716
SIM,1837,34,45-49,1871,1
SIM,1887,25,45-49,1912,1
STAT,1887,15,50-100,1902,0.05200023286323949
SIM,1941,15,30-34,1956,16
SIM,1836,18,na,1854,1922
SIM,1879,40,45-49,1919,2
STAT,1917,30,40-44,1947,3.9021819554621047
STAT,1933,34,30-34,1967,20.032132233779507
SIM,1936,12,na,1948,2989
SIM,1869,82,na,1951,369
STAT,1926,44,40-44,1970,0.2903625040150102
SIM,1878,30,45-49,1908,1
STAT,1856,45,30-34,1901,0.07233577624059909
STAT,1933,15,30-34,1948,15.48581655966275
STAT,1770,98,na,1868,0.4045881874623646
STAT,1879,25,45-49,1904,1.1037869138666685
SIM,1889,33,25-29,1922,16
SIM,1899,32,50-100,1931,1
STAT,1837,74,na,1911,700.5625897149931
SIM,1851,8,na,1859,2219
STAT,1906,41,20-24,1947,0.01523927668654611
SIM,1933,18,45-49,1951,1
STAT,1820,68,na,1888,805.3378576087068
STAT,1894,37,na,1931,2863.031194262759
SIM,1898,28,25-29,1926,63
SIM,1874,29,na,1903,2266
SIM,1906,36,45-49,1942,3
SIM,1843,21,25-29,1864,58
STAT,1874,2,na,1876,3166.631470221624
SIM,1895,37,na,1932,2937
STAT,1899,52,na,1951,2772.756487357426
STAT,1843,42,40-44,1885,1.6708068165684848
SIM,1920,15,na,1935,3843
STAT,1814,40,na,1854,1359.8484297901982
SIM,1887,33,20-24,1920,2
SIM,1840,23,na,1863,1818
SIM,1865,35,35-39,1900,13
STAT,1841,48,45-49,1889,0.16013639480587105
SIM,1802,83,na,1885,106
SIM,1863,24,45-49,1887,1
STAT,1833,28,50-100,1861,0.5107742723720978
SIM,1956,5,na,1961,4773
STAT,1862,75,na,1937,829.5794881745983
SIM,1857,97,na,1954,5
SIM,1946,19,25-29,1965,45
STAT,1938,19,25-29,1957,40.35162855922096
STAT,1940,23,na,1963,3512.806196777252
SIM,1902,25,20-24,1927,21
SIM,1804,56,na,1860,1042
STAT,1892,29,50-100,1921,0.7513517287713262
STAT,1869,51,35-39,1920,0.007910107116740292
STAT,1782,83,na,1865,115.96702706579124
SIM,1823,42,50-100,1865,4
SIM,1862,10,na,1872,2402
SIM,1870,45,na,1915,2110
STAT,1855,35,25-29,1890,2.058519458789608
STAT,1907,44,30-34,1951,0.10927370440342368
STAT,1944,16,45-49,1960,0.5079812300588208
SIM,1846,73,na,1919,788
SIM,1915,26,45-49,1941,1
SIM,1876,21,20-24,1897,67
STAT,1923,41,20-24,1964,0.019529589072505318
STAT,1886,44,50-100,1930,1.040236776991092
SIM,1915,20,30-34,1935,40
STAT,1829,95,na,1924,8.149482207529303
STAT,1854,45,20-24,1899,0.008727279415716039
SIM,1872,25,25-29,1897,47
STAT,1856,104,na,1960,0.12519204300762943
STAT,1937,23,20-24,1960,102.24525483502644
STAT,1879,38,na,1917,2314.828656895895
STAT,1883,43,na,1926,2124.4427153256097
STAT,1838,24,45-49,1862,0.6082138406631586
STAT,1918,29,25-29,1947,65.69872763521805
SIM,1857,27,25-29,1884,39
STAT,1860,53,40-44,1913,0.007952928247892895
STAT,1899,18,25-29,1917,7.317002080736366
STAT,1848,35,25-29,1883,2.182402108222655
STAT,1891,39,45-49,1930,2.307536959555832
SIM,1844,47,na,1891,1572
SIM,1940,31,20-24,1971,3
SIM,1865,15,na,1880,2267
STAT,1878,13,na,1891,2535.8384673443556
STAT,1850,32,15-19,1882,0.10487712596147676
STAT,1903,37,25-29,1940,0.83524855703712
STAT,1868,21,20-24,1889,62.60700511430125
SIM,1833,21,25-29,1854,48
SIM,1869,40,45-49,1909,3
SIM,1824,70,na,1894,771
STAT,1824,48,45-49,1872,0.2734426338778188
SIM,1926,29,25-29,1955,80
SIM,1787,67,na,1854,679
SIM,1766,99,na,1865,1
SIM,1951,20,40-44,1971,6
STAT,1904,47,25-29,1951,0.043814601404640816
STAT,1881,17,na,1898,2303.7164214752693
STAT,1913,24,50-100,1937,0.6236250568635349
STAT,1917,42,35-39,1959,0.1985126113942699
STAT,1876,9,na,1885,2585.4929930614594
STAT,1851,18,50-100,1869,0.043422832477408
SIM,1837,37,na,1874,1657
STAT,1821,53,45-49,1874,0.02088337565530104
STAT,1877,25,35-39,1902,9.52318139019195
STAT,1895,46,20-24,1941,0.008368513772631056
STAT,1924,45,45-49,1969,0.2456088113096877
STAT,1933,35,na,1968,4849.398493068721
STAT,1871,40,35-39,1911,1.713018090570797
STAT,1941,31,30-34,1972,15.634616794163305
STAT,1858,92,na,1950,30.888438739871297
STAT,1834,52,40-44,1886,0.006681742794994816
SIM,1926,22,40-44,1948,4
STAT,1923,15,30-34,1938,13.585003514578144
STAT,1851,27,40-44,1878,2.572026078804478
STAT,1854,46,na,1900,1624.697109709416
SIM,1919,30,40-44,1949,4
STAT,1910,16,35-39,1926,0.7871642496114372
STAT,1926,42,45-49,1968,0.19384857980020911
STAT,1905,39,25-29,1944,0.8398365216374245
SIM,1909,29,25-29,1938,68
SIM,1913,39,25-29,1952,3
STAT,1850,56,na,1906,1435.9070733622111
STAT,1936,24,na,1960,3295.3758424365487
STAT,1932,31,20-24,1963,3.065026906243418
SIM,1833,23,20-24,1856,53
STAT,1869,14,na,1883,2410.0617882965716
STAT,1832,99,na,1931,1.1451428386426987
STAT,1924,2,na,1926,4601.407038619642
SIM,1906,30,30-34,1936,16
STAT,1900,33,35-39,1933,13.216417009185994
SIM,1870,61,na,1931,1725
STAT,1909,39,25-29,1948,0.8713330333632755
STAT,1874,60,na,1934,1841.4421104287642
STAT,1912,29,15-19,1941,0.652362839090956
STAT,1837,42,50-100,1879,0.7869581134539665
SIM,1902,24,na,1926,3160
STAT,1835,40,25-29,1875,0.4925370558739456
STAT,1874,25,25-29,1899,41.12045040599845
SIM,1911,26,45-49,1937,1
SIM,1834,42,40-44,1876,5
STAT,1918,22,40-44,1940,3.4257474633070184
STAT,1947,16,30-34,1963,12.975246169642565
STAT,1922,36,20-24,1958,0.28364274726145516
SIM,1908,6,na,1914,3576
SIM,1846,21,35-39,1867,8
STAT,1893,33,40-44,1926,5.176122045972484
SIM,1955,16,30-34,1971,16
STAT,1857,32,25-29,1889,7.675282238054345
STAT,1862,41,na,1903,1870.9117393547306
STAT,1832,44,30-34,1876,0.83106000877718
STAT,1911,36,45-49,1947,0.6248885682729763
STAT,1828,50,35-39,1878,0.0072854321434271
STAT,1801,79,na,1880,295.0975903637435
STAT,1895,41,35-39,1936,0.15572184172996195
STAT,1879,33,20-24,1912,2.6578233745371858
STAT,1893,49,20-24,1942,0.007944029080799104
SIM,1840,44,30-34,1884,2
STAT,1857,29,na,1886,1804.5189998126605
SIM,1917,22,30-34,1939,35
SIM,1865,32,25-29,1897,12
STAT,1909,22,30-34,1931,25.22848143372722
STAT,1925,25,50-100,1950,1.1182774300847589
STAT,1903,26,45-49,1929,1.497405223054863
STAT,1813,64,na,1877,887.7361775955465
STAT,1893,21,na,1914,2843.3436005993713
STAT,1920,23,40-44,1943,3.5205345356403983
STAT,1913,44,30-34,1957,0.11735918708195188
SIM,1844,24,35-39,1868,6
SIM,1831,24,na,1855,1703
STAT,1838,21,35-39,1859,5.2010165539690005
STAT,1884,46,45-49,1930,0.2209408901018443
SIM,1891,47,na,1938,2728
SIM,1871,30,35-39,1901,9
SIM,1929,19,25-29,1948,67
STAT,1915,41,30-34,1956,0.1217570285707929
STAT,1828,91,na,1919,32.89561386708395
SIM,1806,57,na,1863,1063
STAT,1877,65,na,1942,1656.6989453700185
SIM,1839,31,45-49,1870,1
SIM,1933,25,50-100,1958,1
STAT,1875,64,na,1939,1687.1429366722073
STAT,1918,48,25-29,1966,0.05317709127809608
STAT,1900,20,20-24,1920,90.85486941938177
STAT,1838,32,20-24,1870,2.290851539691313
STAT,1896,20,45-49,1916,0.8758231090319583
STAT,1836,43,na,1879,1559.3016185306826
SIM,1886,14,na,1900,2518
STAT,1865,43,15-19,1908,0.011769339178947435
STAT,1873,54,20-24,1927,6.881385920839523E-4
SIM,1875,43,40-44,1918,2
SIM,1778,84,na,1862,87
STAT,1873,19,40-44,1892,0.1744466997515406
SIM,1849,22,na,1871,1914
STAT,1880,69,na,1949,1458.735811433015
STAT,1867,43,40-44,1910,1.980696533367838
SIM,1859,16,35-39,1875,1
SIM,1846,32,20-24,1878,1
SIM,1868,57,na,1925,1786
SIM,1910,3,na,1913,3711
STAT,1930,21,na,1951,4433.038359050118
STAT,1924,30,50-100,1954,0.9154570342186743
STAT,1806,54,30-34,1860,0.016145372963029942
STAT,1857,35,35-39,1892,5.31759044570281
SIM,1820,80,na,1900,268
STAT,1893,47,50-100,1940,0.1652807317102632
STAT,1873,45,30-34,1918,0.09374772493556838
STAT,1880,22,50-100,1902,0.4053430234283682
STAT,1933,37,35-39,1970,3.1123247021988076
SIM,1928,23,45-49,1951,2
STAT,1809,50,25-29,1859,0.012785650684225549
STAT,1937,20,40-44,1957,3.0948964734817173
STAT,1836,24,35-39,1860,4.793741627586624
STAT,1859,49,20-24,1908,0.008858198446856121
STAT,1895,68,na,1963,2076.8886361331756
STAT,1913,34,15-19,1947,0.1197200215757962
STAT,1945,20,na,1965,3783.566156224348
STAT,1866,19,40-44,1885,0.16159470598277315
STAT,1835,67,na,1902,989.0645996793855
STAT,1854,40,35-39,1894,1.3171139408281376
STAT,1898,33,25-29,1931,13.04324253948241
SIM,1893,22,35-39,1915,6
SIM,1948,19,35-39,1967,4
STAT,1901,23,30-34,1924,23.480170987566495
STAT,1888,15,50-100,1903,0.054929464202326486
STAT,1838,105,na,1943,0.019997410658282117
STAT,1924,39,na,1963,4182.429502684702
STAT,1895,46,50-100,1941,0.1712755750986007
STAT,1906,18,35-39,1924,0.7528316682097534
SIM,1914,18,35-39,1932,1
SIM,1945,20,40-44,1965,4
SIM,1931,15,30-34,1946,23
SIM,1940,8,na,1948,3645
STAT,1931,29,25-29,1960,80.19939782620204
SIM,1850,25,na,1875,1873
STAT,1865,46,40-44,1911,0.14738301858424382
SIM,1917,44,40-44,1961,3
SIM,1937,26,20-24,1963,16
STAT,1945,8,na,1953,4069.2122772163684
STAT,1863,46,15-19,1909,3.3310823237951275E-4
SIM,1924,27,na,1951,4075
STAT,1813,44,20-24,1857,0.5078061587753351
STAT,1903,53,na,1956,2865.5902922887026
SIM,1769,88,na,1857,25
STAT,1824,58,na,1882,1125.9697088315277
STAT,1908,15,40-44,1923,0.2574434229045231
STAT,1864,22,20-24,1886,59.11920015919843
SIM,1908,33,45-49,1941,1
STAT,1889,50,na,1939,2547.335711461589
SIM,1944,18,20-24,1962,125
SIM,1891,25,35-39,1916,14
STAT,1878,21,45-49,1899,0.6878530990991563
STAT,1879,22,40-44,1901,2.0576196979911896
STAT,1878,30,35-39,1908,10.039544421355723
STAT,1911,37,15-19,1948,0.01751818101378917
SIM,1826,31,35-39,1857,7
STAT,1870,92,na,1962,85.56758298778215
SIM,1861,49,50-100,1910,2
STAT,1927,41,na,1968,4407.0382926070815
SIM,1929,29,35-39,1958,22
STAT,1867,48,40-44,1915,0.14994642549932347
STAT,1900,48,na,1948,2912.109610067372
STAT,1924,18,50-100,1942,0.42041338063205097
STAT,1865,86,na,1951,190.46846382769232
STAT,1930,15,50-100,1945,0.4597325747157469
SIM,1887,22,40-44,1909,3
STAT,1906,44,25-29,1950,0.06051412110908705
SIM,1829,39,40-44,1868,4
SIM,1933,27,35-39,1960,22
STAT,1772,100,na,1872,0.17821283917269168
STAT,1857,44,25-29,1901,0.47179151336799263
STAT,1853,49,50-100,1902,0.17833596247863706
STAT,1889,40,20-24,1929,0.18708812160211227
SIM,1905,25,30-34,1930,38
STAT,1907,27,na,1934,3311.2223412483836
STAT,1942,15,40-44,1957,1.3815319852403736
SIM,1845,78,na,1923,548
SIM,1831,24,25-29,1855,44
STAT,1875,53,40-44,1928,0.010053431459023869
STAT,1850,35,40-44,1885,3.196267512333624
SIM,1939,23,20-24,1962,85
STAT,1862,54,45-49,1916,0.01137305704419738
STAT,1936,18,20-24,1954,122.27759207146556
SIM,1848,34,20-24,1882,4
SIM,1886,30,35-39,1916,1
STAT,1883,25,35-39,1908,8.994234155467717
STAT,1886,85,na,1971,599.8603416415125
SIM,1859,46,na,1905,1902
SIM,1915,23,35-39,1938,15
STAT,1866,38,40-44,1904,3.7938456744868905
SIM,1870,17,15-19,1887,3
SIM,1950,15,40-44,1965,1
STAT,1877,71,na,1948,1308.5277043031704
STAT,1822,45,15-19,1867,5.741958786381851E-4
SIM,1922,26,20-24,1948,20
SIM,1864,11,na,1875,2428
SIM,1882,86,na,1968,438
STAT,1914,26,20-24,1940,17.440646105462186
STAT,1885,39,20-24,1924,0.7182051564749998
STAT,1890,15,25-29,1905,6.575634504347698
SIM,1893,39,20-24,1932,1
STAT,1807,47,30-34,1854,0.3584533534446021
STAT,1907,23,35-39,1930,8.071517975924449
SIM,1874,28,30-34,1902,28
STAT,1862,17,15-19,1879,5.4771548130836045
SIM,1858,32,25-29,1890,17
STAT,1841,73,na,1914,812.6503658233613
STAT,1843,50,25-29,1893,0.002592126512584501
STAT,1898,22,45-49,1920,0.8917536087071708
STAT,1818,48,20-24,1866,0.02525289275833492
SIM,1857,63,na,1920,1436
SIM,1907,33,na,1940,3362
STAT,1874,38,30-34,1912,5.120351856742543
STAT,1857,21,45-49,1878,0.6038733399677907
STAT,1810,52,30-34,1862,0.020203500006133805
STAT,1882,18,na,1900,2315.5808545040586
STAT,1804,81,na,1885,216.57473776636564
SIM,1891,15,25-29,1906,9
STAT,1891,36,40-44,1927,5.1432797880362395
STAT,1898,36,35-39,1934,9.088576758037801
STAT,1844,38,20-24,1882,0.5659322744447653
STAT,1876,22,25-29,1898,55.82909176373738
STAT,1893,38,40-44,1931,5.220920130864901
STAT,1900,26,na,1926,3138.4859852793365
STAT,1904,31,45-49,1935,2.3722255671616823
SIM,1882,64,na,1946,1563
SIM,1907,37,35-39,1944,4
STAT,1868,46,50-100,1914,0.2221545112617224
SIM,1882,38,30-34,1920,5
SIM,1918,28,20-24,1946,24
STAT,1935,26,20-24,1961,23.515719878632396
SIM,1846,21,40-44,1867,5
STAT,1769,107,na,1876,0.006721411664986762
STAT,1842,21,na,1863,1934.3200856267877
SIM,1857,101,na,1958,1
STAT,1915,56,na,1971,3366.564391956249
STAT,1810,50,na,1860,1279.0026103280247
STAT,1881,15,15-19,1896,5.438315101725499
STAT,1939,9,na,1948,3755.7811512022736
STAT,1955,16,20-24,1971,170.05886708541635
SIM,1819,40,na,1859,1460
STAT,1933,18,35-39,1951,5.292624649353554
SIM,1889,30,20-24,1919,2
STAT,1807,86,na,1893,79.59027507824202
SIM,1941,18,35-39,1959,6
SIM,1837,43,na,1880,1571
STAT,1824,45,40-44,1869,0.20695982997632198
STAT,1855,40,50-100,1895,0.7557678862354825
STAT,1861,30,25-29,1891,8.099671179636065
STAT,1845,26,na,1871,1868.1097846598373
SIM,1850,24,35-39,1874,5
STAT,1826,84,na,1910,181.5732718542364
SIM,1904,22,20-24,1926,75
SIM,1943,26,20-24,1969,21
STAT,1826,47,40-44,1873,0.1600731874006353
STAT,1774,88,na,1862,40.66947787191823
STAT,1918,33,50-100,1951,0.8264689703130732
STAT,1918,37,45-49,1955,0.6787905381192678
SIM,1859,35,35-39,1894,7
STAT,1900,34,50-100,1934,1.1905408686065113
SIM,1855,29,40-44,1884,3
STAT,1879,22,35-39,1901,5.762140229778751
SIM,1924,25,40-44,1949,6
SIM,1865,92,na,1957,43
SIM,1872,22,20-24,1894,69
STAT,1838,21,40-44,1859,1.8572463848967766
SIM,1887,22,35-39,1909,6
STAT,1898,23,15-19,1921,4.20584444130171
STAT,1926,23,45-49,1949,1.2875081486287405
STAT,1907,47,35-39,1954,0.10905975078832701
SIM,1833,37,40-44,1870,7
STAT,1948,21,30-34,1969,31.187897306797524
STAT,1870,70,na,1940,1298.7829862549763
SIM,1824,92,na,1916,17
STAT,1843,45,45-49,1888,0.1738682028935983
SIM,1835,20,20-24,1855,56
STAT,1833,47,40-44,1880,0.12202483158721396
STAT,1848,39,40-44,1887,3.1831083433076746
STAT,1892,28,40-44,1920,3.5312983461346863
STAT,1890,47,na,1937,2586.992841420365
STAT,1916,25,40-44,1941,4.583554202059211
SIM,1921,34,20-24,1955,2
SIM,1848,29,40-44,1877,5
STAT,1911,31,45-49,1942,1.4531357594750183
STAT,1880,35,20-24,1915,0.7734994871156919
SIM,1912,31,45-49,1943,2
STAT,1920,34,20-24,1954,2.5024753301648435
STAT,1847,29,40-44,1876,2.6113119891868504
STAT,1882,12,na,1894,2373.9716946670155
SIM,1885,69,na,1954,1338
STAT,1912,41,45-49,1953,0.1524771092482047
STAT,1825,37,40-44,1862,5.605702560735486
SIM,1897,63,na,1960,2359
SIM,1934,23,45-49,1957,1
SIM,1791,66,na,1857,713
STAT,1863,100,na,1963,2.947650003118751
STAT,1907,45,45-49,1952,0.18654610878967995
STAT,1854,49,50-100,1903,0.17316254132438524
STAT,1865,32,15-19,1897,0.1222491320008093
SIM,1878,19,na,1897,2550
STAT,1877,32,50-100,1909,0.8982110716074255
STAT,1855,9,na,1864,2052.3013777635956
STAT,1892,17,25-29,1909,6.703778212845427
SIM,1897,32,45-49,1929,6
SIM,1878,81,na,1959,685
SIM,1869,0,na,1869,3250
SIM,1943,22,40-44,1965,4
STAT,1899,15,20-24,1914,23.058232040659156
STAT,1837,48,30-34,1885,0.06262549134104096
SIM,1946,22,15-19,1968,5
STAT,1829,31,35-39,1860,10.148476694785474
STAT,1859,52,na,1911,1614.6841754615664
STAT,1876,44,35-39,1920,1.7421681500956565
STAT,1913,34,20-24,1947,2.2724214387698245
SIM,1930,39,25-29,1969,3
SIM,1810,59,na,1869,1051
SIM,1891,22,25-29,1913,75
STAT,1926,22,30-34,1948,32.98986381118849
SIM,1833,26,25-29,1859,42
SIM,1871,46,na,1917,2172
STAT,1837,19,50-100,1856,0.04148815248648713
SIM,1884,44,35-39,1928,5
STAT,1922,39,25-29,1961,1.0562164126544673
STAT,1928,19,30-34,1947,14.432445954213252
SIM,1924,28,45-49,1952,6
STAT,1785,75,na,1860,394.65096976856165
SIM,1956,13,na,1969,4764
STAT,1864,29,40-44,1893,2.511110272951445
SIM,1934,22,30-34,1956,49
STAT,1923,18,35-39,1941,4.6429792181638
SIM,1930,34,30-34,1964,23
STAT,1901,18,15-19,1919,7.826619457131296
SIM,1852,20,20-24,1872,65
STAT,1879,91,na,1970,200.1326778317373
STAT,1922,34,30-34,1956,16.73586485287394
STAT,1896,22,35-39,1918,7.285784823901968
SIM,1894,4,na,1898,3355
STAT,1880,88,na,1968,346.80551629047943
STAT,1821,50,40-44,1871,0.016082290464848558
SIM,1833,21,30-34,1854,15
SIM,1921,22,20-24,1943,120
STAT,1853,61,na,1914,1385.7947765343931
STAT,1859,21,35-39,1880,5.052366666278317
STAT,1881,26,15-19,1907,0.4152622361735157
SIM,1829,32,20-24,1861,1
STAT,1916,28,45-49,1944,1.6815023710374744
SIM,1867,21,35-39,1888,9
STAT,1883,22,25-29,1905,53.00182908558098
SIM,1909,5,na,1914,3697
SIM,1927,33,50-100,1960,1
SIM,1909,26,20-24,1935,22
STAT,1922,47,50-100,1969,0.24548450780476794
SIM,1822,69,na,1891,765
SIM,1910,22,45-49,1932,4
STAT,1789,65,na,1854,700.9999999999999
STAT,1809,53,35-39,1862,0.029253617505849087
SIM,1893,73,na,1966,1755
STAT,1860,49,na,1909,1691.2715394750064
SIM,1830,61,na,1891,1164
SIM,1931,18,35-39,1949,6
SIM,1932,35,35-39,1967,7
STAT,1848,15,na,1863,2074.358435053366
STAT,1857,25,25-29,1882,32.92067090701268
SIM,1809,87,na,1896,80
SIM,1875,32,25-29,1907,14
STAT,1888,28,15-19,1916,0.5045543369521402
STAT,1913,44,25-29,1957,0.06555197863830485
SIM,1822,44,na,1866,1444
STAT,1822,94,na,1916,10.32346755779744
SIM,1948,18,na,1966,3763
STAT,1883,34,25-29,1917,9.402098336272843
SIM,1902,28,25-29,1930,61
STAT,1805,49,30-34,1854,0.28650261657219356
STAT,1870,27,15-19,1897,0.41997859945465027
SIM,1882,36,40-44,1918,6
STAT,1861,2,na,1863,2700.3371438118825
STAT,1833,51,50-100,1884,0.00966031837735868
STAT,1842,12,na,1854,2183.0
SIM,1824,31,25-29,1855,14
STAT,1848,49,45-49,1897,0.16647006695447877
SIM,1874,25,35-39,1899,14
SIM,1889,59,na,1948,2242
STAT,1844,20,20-24,1864,61.278897133395226
SIM,1882,22,15-19,1904,3
SIM,1916,27,50-100,1943,5
SIM,1911,38,na,1949,3478
STAT,1892,73,na,1965,1683.0106341488397
SIM,1891,34,25-29,1925,15
STAT,1863,103,na,1966,0.6953649774365466
STAT,1912,11,na,1923,3777.404608485465
SIM,1817,41,35-39,1858,2
STAT,1866,25,35-39,1891,8.461127118008543
STAT,1816,43,25-29,1859,1.8410429301939129
SIM,1884,32,35-39,1916,11
STAT,1902,22,45-49,1924,0.929632966045246
STAT,1904,44,15-19,1948,0.00128171472998574
SIM,1936,19,30-34,1955,8
SIM,1919,33,45-49,1952,3
STAT,1874,36,40-44,1910,4.2469599321266385
STAT,1942,29,50-100,1971,0.9858711438739282
SIM,1948,16,30-34,1964,16
STAT,1873,15,25-29,1888,5.498454133435836
STAT,1884,3,na,1887,2761.8815647546435
STAT,1912,17,20-24,1929,25.892669079441944
STAT,1924,35,35-39,1959,2.699320844459471
STAT,1903,27,15-19,1930,0.609791210642173
STAT,1855,21,35-39,1876,4.863172274039193
STAT,1937,23,45-49,1960,1.034613868490213
SIM,1863,29,30-34,1892,21
SIM,1867,38,40-44,1905,5
STAT,1918,45,20-24,1963,0.011161732809746798
SIM,1929,16,20-24,1945,162
STAT,1889,20,45-49,1909,0.81811904057384
SIM,1889,38,25-29,1927,3
SIM,1796,87,na,1883,60
SIM,1841,21,15-19,1862,2
SIM,1855,37,na,1892,1881
STAT,1876,32,35-39,1908,9.876475794577544
STAT,1922,27,25-29,1949,70.36544530313884
STAT,1848,42,25-29,1890,0.4620554719840002
SIM,1817,45,50-100,1862,1
SIM,1932,23,35-39,1955,9
STAT,1955,13,na,1968,4925.048836770387
SIM,1857,5,na,1862,2389
SIM,1942,15,na,1957,3468
SIM,1905,16,35-39,1921,3
STAT,1857,50,50-100,1907,0.011409419806238979
STAT,1909,32,40-44,1941,3.526921279008602
SIM,1945,23,45-49,1968,1
SIM,1917,32,40-44,1949,4
SIM,1897,54,na,1951,2665
SIM,1963,3,na,1966,4682
STAT,1919,46,50-100,1965,0.23233110549390512
SIM,1897,20,45-49,1917,2
SIM,1930,27,25-29,1957,82
STAT,1836,27,na,1863,1767.6233727335934
STAT,1930,34,15-19,1964,0.1564741324824201
STAT,1833,21,15-19,1854,3.476934681313142
STAT,1912,33,na,1945,3500.0408243463335
STAT,1855,29,30-34,1884,18.323759814629543
STAT,1892,70,na,1962,1841.5750649793913
SIM,1837,27,50-100,1864,1
SIM,1929,36,na,1965,4670
SIM,1920,17,20-24,1937,131
STAT,1822,39,20-24,1861,1.2583660886856598
STAT,1885,31,50-100,1916,0.8658755164305035
STAT,1942,18,45-49,1960,0.49298488513160377
STAT,1888,23,20-24,1911,76.6694002589811
SIM,1863,21,35-39,1884,4
STAT,1823,54,30-34,1877,0.006564328044687632
STAT,1883,15,25-29,1898,5.27101414233513
SIM,1891,60,na,1951,2250
STAT,1823,57,na,1880,1149.2860161407098
STAT,1909,44,40-44,1953,0.2182401731647966
SIM,1950,10,na,1960,4277
SIM,1939,20,25-29,1959,88
STAT,1877,23,45-49,1900,0.6814838646501787
STAT,1830,36,na,1866,1626.4810857923076
STAT,1835,43,35-39,1878,1.336531744143881
STAT,1889,32,45-49,1921,2.033771004508844
STAT,1862,51,40-44,1913,0.00852416894607404
STAT,1882,43,15-19,1925,0.012602983251497332
SIM,1896,23,20-24,1919,82
STAT,1859,77,na,1936,651.6864558806066
STAT,1903,39,15-19,1942,0.016126356004740553
STAT,1955,17,35-39,1972,5.261954615022859
SIM,1858,42,na,1900,1868
STAT,1884,44,na,1928,2128.510108817741
SIM,1843,43,35-39,1886,3
STAT,1942,24,30-34,1966,28.447521252861595
SIM,1883,38,50-100,1921,1
SIM,1843,31,35-39,1874,10
STAT,1868,38,15-19,1906,0.05039890042113361
SIM,1869,41,50-100,1910,3
STAT,1898,26,25-29,1924,54.2818402360948
STAT,1929,24,30-34,1953,34.12257008920145
STAT,1930,30,na,1960,4616.394441034165
STAT,1898,45,25-29,1943,0.041964859149477146
SIM,1841,38,45-49,1879,2
STAT,1847,27,15-19,1874,0.40124566216562035
STAT,1893,22,25-29,1915,68.61550690376464
SIM,1866,93,na,1959,29
STAT,1861,27,40-44,1888,2.3670228535494564
STAT,1919,43,20-24,1962,0.018051178769113174
STAT,1904,38,na,1942,3201.1621008451048
SIM,1924,22,30-34,1946,46
STAT,1929,29,25-29,1958,77.7474881224417
SIM,1929,33,na,1962,4610
STAT,1773,87,na,1860,37.368776893992305
SIM,1845,94,na,1939,13
STAT,1901,17,45-49,1918,0.08637509607443351
STAT,1847,25,25-29,1872,37.95360736706821
STAT,1847,25,50-100,1872,0.5739436939828749
STAT,1948,23,20-24,1971,120.58069735818015
STAT,1936,3,na,1939,3667.83814795492
STAT,1791,97,na,1888,0.9275709130471511
STAT,1833,38,45-49,1871,1.5014213881488705
SIM,1848,32,30-34,1880,5
SIM,1777,83,na,1860,91
SIM,1855,31,na,1886,1986
STAT,1846,46,15-19,1892,2.82829477232206E-4
STAT,1841,42,15-19,1883,0.009818245798626926
STAT,1900,23,na,1923,3090.030144943175
SIM,1846,54,na,1900,1463
SIM,1889,26,25-29,1915,50
SIM,1937,29,25-29,1966,58
STAT,1920,18,25-29,1938,45.8125327038351
STAT,1838,25,15-19,1863,0.39933965129506743
STAT,1916,34,30-34,1950,15.234367303545481
SIM,1848,37,25-29,1885,1
SIM,1903,29,20-24,1932,17
STAT,1857,38,30-34,1895,3.9495199233951293
STAT,1883,19,40-44,1902,0.16843576952777958
STAT,1889,43,25-29,1932,0.743519669640196
STAT,1811,54,na,1865,1161.7908239667001
STAT,1835,31,35-39,1866,8.128380303214808
STAT,1851,16,25-29,1867,5.082268107335408
STAT,1945,5,na,1950,4102.229179054157
STAT,1910,19,45-49,1929,0.09297910647903
STAT,1859,31,20-24,1890,2.0462304922580925
STAT,1878,49,30-34,1927,0.09321053860810456
SIM,1881,15,25-29,1896,7
SIM,1933,24,30-34,1957,41
STAT,1916,22,30-34,1938,28.450326985955577
STAT,1872,37,na,1909,2233.9429833776094
SIM,1903,17,20-24,1920,23
STAT,1852,31,35-39,1883,8.049645202031305
STAT,1861,96,na,1957,9.003327368719924
SIM,1839,23,25-29,1862,43
STAT,1836,104,na,1940,0.042120344163606126
STAT,1842,21,25-29,1863,51.78892370220399
SIM,1867,31,20-24,1898,2
STAT,1838,102,na,1940,0.19995247198775376
STAT,1891,16,50-100,1907,0.05742722996197452
STAT,1924,36,na,1960,4195.169946566593
STAT,1832,40,15-19,1872,0.010513701095215846
SIM,1908,34,na,1942,3253
SIM,1877,34,na,1911,2325
SIM,1907,21,25-29,1928,97
SIM,1878,20,40-44,1898,3
SIM,1905,28,35-39,1933,13
STAT,1888,16,15-19,1904,6.639285180308535
SIM,1860,31,35-39,1891,12
STAT,1893,36,na,1929,2837.5036087317944
STAT,1800,91,na,1891,23.09843461787186
SIM,1839,35,25-29,1874,2
STAT,1842,33,25-29,1875,8.720177050293408
SIM,1830,37,30-34,1867,6
STAT,1893,58,na,1951,2370.3800129510405
STAT,1884,22,na,1906,2207.8668126582957
SIM,1865,25,25-29,1890,41
STAT,1936,31,50-100,1967,0.7589655852105559
SIM,1900,34,45-49,1934,1
SIM,1896,16,15-19,1912,9
STAT,1797,60,na,1857,963.9893858836855
STAT,1872,59,na,1931,1842.7971865810691
STAT,1916,16,45-49,1932,0.10036595482184583
STAT,1898,39,30-34,1937,1.4562831694314171
STAT,1952,15,35-39,1967,4.753118266190003
SIM,1848,25,25-29,1873,45
SIM,1834,54,na,1888,1282
SIM,1879,44,na,1923,2233
SIM,1892,23,na,1915,2813
STAT,1888,15,45-49,1903,0.07323928560310197
SIM,1850,21,25-29,1871,54
STAT,1904,16,na,1920,3430.1534326101014
STAT,1836,22,45-49,1858,0.581152484935725
SIM,1900,60,na,1960,2548
STAT,1807,48,45-49,1855,0.859788587005818
STAT,1817,54,na,1871,1144.3779053063715
SIM,1907,34,30-34,1941,17
STAT,1930,41,20-24,1971,0.0219842400914486
SIM,1850,9,na,1859,2163
STAT,1827,43,50-100,1870,0.954971168203453
SIM,1809,62,na,1871,966
STAT,1949,10,na,1959,4317.4126417174475
SIM,1869,30,35-39,1899,12
SIM,1924,34,30-34,1958,22
STAT,1861,33,35-39,1894,7.910921352796652
STAT,1901,24,45-49,1925,0.9162869672753184
SIM,1840,16,15-19,1856,7
SIM,1889,33,30-34,1922,22
STAT,1874,39,45-49,1913,1.9054022750095614
SIM,1855,25,25-29,1880,50
STAT,1891,29,50-100,1920,0.7426505402341864
STAT,1897,11,na,1908,3267.6505110964054
STAT,1943,28,na,1971,3767.066172021965
SIM,1937,24,30-34,1961,25
STAT,1861,21,35-39,1882,4.736961360746456
STAT,1822,37,30-34,1859,9.665083847067473
STAT,1802,77,na,1879,338.1921085384654
STAT,1847,67,na,1914,1166.385369055931
STAT,1898,73,na,1971,1925.4689222261636
STAT,1937,2,na,1939,3758.1777244368072
SIM,1879,19,25-29,1898,6
STAT,1859,71,na,1930,1006.3389459977428
STAT,1860,31,na,1891,1839.6005682075872
SIM,1850,33,25-29,1883,8
STAT,1826,31,25-29,1857,14.417001672147435
STAT,1935,34,40-44,1969,5.1077715329682984
SIM,1859,20,30-34,1879,23
SIM,1882,21,45-49,1903,1
SIM,1895,6,na,1901,3269
STAT,1877,74,na,1951,1087.944580822982
STAT,1831,39,30-34,1870,4.111253794942382
SIM,1834,69,na,1903,896
SIM,1810,44,45-49,1854,1
STAT,1873,81,na,1954,518.5435871569711
STAT,1841,76,na,1917,648.2056017201128
SIM,1868,22,30-34,1890,16
STAT,1935,22,40-44,1957,4.325239065965264
SIM,1860,83,na,1943,286
SIM,1910,53,na,1963,3099
SIM,1935,14,na,1949,5101
SIM,1904,37,25-29,1941,4
SIM,1834,31,25-29,1865,4
STAT,1852,44,40-44,1896,1.685870135682145
SIM,1821,81,na,1902,256
SIM,1908,32,30-34,1940,20
STAT,1833,31,25-29,1864,8.117612614875435
STAT,1907,26,45-49,1933,1.5457956102221408
STAT,1937,25,na,1962,3452.2792677871457
STAT,1851,57,na,1908,1473.6954436422266
STAT,1902,41,45-49,1943,0.13918069631783536
STAT,1914,1,na,1915,4066.874206836388
SIM,1879,66,na,1945,1583
STAT,1890,19,40-44,1909,0.2101250400710468
STAT,1926,20,40-44,1946,3.8824185828815434
SIM,1929,22,15-19,1951,6
SIM,1896,26,25-29,1922,51
STAT,1860,34,na,1894,1816.42757039612
STAT,1863,23,na,1886,1988.7259431045952
STAT,1879,26,15-19,1905,0.44953786268327967
STAT,1862,24,50-100,1886,0.3315840793537414
SIM,1839,39,40-44,1878,11
STAT,1848,32,15-19,1880,0.11964266219135608
STAT,1926,25,35-39,1951,17.119699183183755
SIM,1955,9,na,1964,4547
STAT,1761,99,na,1860,0.2105400945067192
STAT,1779,97,na,1876,0.9163665163748174
STAT,1842,27,30-34,1869,22.176029393922516
STAT,1893,45,40-44,1938,0.11690560985663728
STAT,1922,37,35-39,1959,2.6001947763916564
SIM,1879,41,na,1920,2277
STAT,1892,15,35-39,1907,0.6521425774530908
SIM,1919,19,30-34,1938,13
SIM,1939,26,30-34,1965,34
SIM,1913,49,50-100,1962,2
STAT,1808,108,na,1916,7.119640239435244E-4
STAT,1873,41,15-19,1914,0.013302279150021598
SIM,1843,37,40-44,1880,6
SIM,1856,19,na,1875,2120
SIM,1857,24,20-24,1881,57
SIM,1926,26,20-24,1952,19
STAT,1809,47,40-44,1856,0.6245033987719079
SIM,1891,24,15-19,1915,3
STAT,1853,106,na,1959,0.020807610132727777
STAT,1863,38,30-34,1901,4.403802046467256
STAT,1826,54,40-44,1880,0.009129546293656813
STAT,1866,22,30-34,1888,15.64097918629612
STAT,1888,26,25-29,1914,47.3708234868511
STAT,1911,24,45-49,1935,1.0015563464955732
SIM,1904,34,20-24,1938,1
SIM,1905,23,na,1928,3208
SIM,1950,19,15-19,1969,51
STAT,1826,36,50-100,1862,1.369419855824988
STAT,1928,29,na,1957,4356.084380043758
STAT,1938,16,20-24,1954,126.63617370578203
SIM,1883,17,25-29,1900,8
STAT,1871,45,20-24,1916,0.01135056509324309
SIM,1834,36,50-100,1870,1
SIM,1934,20,40-44,1954,6
STAT,1827,37,15-19,1864,0.056121221785359394
STAT,1935,29,25-29,1964,84.67124720427009
SIM,1910,41,45-49,1951,1
SIM,1899,30,20-24,1929,2
STAT,1943,23,45-49,1966,1.130477842135831
SIM,1921,37,25-29,1958,1
SIM,1882,39,45-49,1921,3
STAT,1889,47,40-44,1936,0.11210304254977413
STAT,1802,55,na,1857,1052.567100715617
STAT,1864,19,30-34,1883,1.375767800550677
STAT,1900,45,35-39,1945,0.10453127435896001
STAT,1913,37,25-29,1950,0.9177200685006753
STAT,1928,33,20-24,1961,2.8797290287508948
SIM,1872,19,30-34,1891,1
STAT,1847,52,na,1899,1575.8425417838632
SIM,1831,28,40-44,1859,3
SIM,1880,38,na,1918,2411
STAT,1804,54,20-24,1858,0.0021081093032387405
SIM,1930,24,20-24,1954,122
STAT,1905,49,50-100,1954,0.1851782375250647
STAT,1942,19,15-19,1961,44.77201018719992
STAT,1835,37,40-44,1872,3.376659892583967
SIM,1918,7,na,1925,4078
STAT,1934,11,na,1945,5070.404422481866
STAT,1861,38,20-24,1899,0.6017135841857187
SIM,1930,37,35-39,1967,7
STAT,1866,27,25-29,1893,36.844073728230676
SIM,1876,52,na,1928,2121
SIM,1833,24,35-39,1857,5
STAT,1867,51,25-29,1918,0.003156799299356132
STAT,1887,47,15-19,1934,4.2062807883957315E-4
SIM,1850,27,30-34,1877,27
STAT,1918,34,40-44,1952,3.894736147278221
STAT,1871,74,na,1945,1039.3652220528018
SIM,1924,18,35-39,1942,5
STAT,1811,51,na,1862,1232.9096941866335
STAT,1848,46,40-44,1894,0.12368668406196706
SIM,1922,16,35-39,1938,4
STAT,1792,79,na,1871,252.96956417801368
SIM,1936,33,20-24,1969,2
SIM,1839,20,20-24,1859,65
STAT,1896,47,na,1943,2796.422810332031
SIM,1926,34,40-44,1960,6
SIM,1880,23,na,1903,2422
STAT,1894,28,15-19,1922,0.549407772874653
STAT,1874,22,15-19,1896,3.185311722394356
STAT,1879,29,na,1908,2339.6870513017466
STAT,1913,41,20-24,1954,0.01635964108672645
SIM,1859,33,45-49,1892,2
STAT,1776,98,na,1874,0.4760100495739915
SIM,1946,16,20-24,1962,135
STAT,1802,104,na,1906,0.022753889683877426
STAT,1916,29,15-19,1945,0.6846102819971229
STAT,1933,16,45-49,1949,0.6332809154918476
STAT,1865,89,na,1954,90.18265312133842
SIM,1874,34,25-29,1908,8
STAT,1942,27,35-39,1969,14.885317949337237
SIM,1864,67,na,1931,1455
STAT,1852,21,25-29,1873,52.04206260697707
SIM,1826,43,35-39,1869,5
SIM,1860,21,25-29,1881,60
STAT,1868,33,50-100,1901,0.8229449008890409
SIM,1846,29,30-34,1875,17
STAT,1922,26,na,1948,4018.583211945821
SIM,1800,66,na,1866,790
SIM,1893,34,35-39,1927,18
STAT,1842,18,40-44,1860,0.16626986389314047
SIM,1907,15,30-34,1922,3
SIM,1874,22,30-34,1896,18
SIM,1934,25,35-39,1959,23
STAT,1866,34,25-29,1900,8.844816337237587
STAT,1883,28,30-34,1911,23.233023650350482
SIM,1888,30,45-49,1918,2
SIM,1823,91,na,1914,19
STAT,1883,24,15-19,1907,3.03533641120042
SIM,1932,22,na,1954,4370
SIM,1871,38,30-34,1909,6
SIM,1856,16,na,1872,2168
STAT,1902,18,50-100,1920,0.06514231136728477
STAT,1935,24,50-100,1959,0.8458510210233128
STAT,1838,56,na,1894,1391.0799985977305
STAT,1871,71,na,1942,1250.098775175201
SIM,1868,41,50-100,1909,1
SIM,1877,19,15-19,1896,6
STAT,1838,29,30-34,1867,21.53484665353982
STAT,1885,34,35-39,1919,9.449781587169399
STAT,1882,53,50-100,1935,0.013660293819941743
STAT,1914,16,35-39,1930,0.8218668164618483
SIM,1941,25,35-39,1966,18
STAT,1921,19,20-24,1940,145.22063765782215
STAT,1934,14,na,1948,5046.459149582234
SIM,1790,65,na,1855,701
STAT,1844,34,50-100,1878,0.753365966707663
SIM,1889,23,20-24,1912,73
STAT,1805,69,na,1874,708.060457528848
SIM,1793,76,na,1869,330
STAT,1807,95,na,1902,4.769306629663644
SIM,1829,35,25-29,1864,5
SIM,1900,24,35-39,1924,6
SIM,1827,44,50-100,1871,1
STAT,1857,48,40-44,1905,0.1258992741105714
SIM,1839,60,na,1899,1374
SIM,1842,16,25-29,1858,8
SIM,1852,26,50-100,1878,1
SIM,1908,30,40-44,1938,4
STAT,1869,19,15-19,1888,5.437297176722606
STAT,1842,23,15-19,1865,2.9418545648891095
SIM,1893,70,na,1963,1908
STAT,1836,19,50-100,1855,0.0582317429638756
SIM,1902,27,na,1929,3189
SIM,1848,35,35-39,1883,11
STAT,1849,93,na,1942,21.06539573779225
STAT,1835,48,20-24,1883,0.007791565109477626
SIM,1878,32,35-39,1910,15
SIM,1768,91,na,1859,8
SIM,1872,71,na,1943,1209
SIM,1915,22,20-24,1937,98
STAT,1925,15,40-44,1940,1.6038096414778247
STAT,1816,47,40-44,1863,0.45076941953667615
STAT,1903,18,25-29,1921,7.5963157181378085
SIM,1849,49,50-100,1898,1
STAT,1848,31,45-49,1879,1.480350211605851
STAT,1847,22,20-24,1869,62.15942833665835
STAT,1929,16,50-100,1945,0.4528301494608074
STAT,1796,106,na,1902,0.0028286795057423293
SIM,1891,28,30-34,1919,36
SIM,1846,79,na,1925,453
SIM,1911,18,25-29,1929,8
STAT,1919,46,25-29,1965,0.05448807647411356
SIM,1911,34,20-24,1945,2
STAT,1822,91,na,1913,29.93195637317286
STAT,1931,26,20-24,1957,22.273754503297983
SIM,1908,35,35-39,1943,3
STAT,1924,23,35-39,1947,10.464725939984934
STAT,1826,50,25-29,1876,0.0033253626760992453
SIM,1956,10,na,1966,4767
STAT,1929,27,35-39,1956,17.75172474638138
SIM,1852,42,na,1894,1783
SIM,1853,27,na,1880,2080
SIM,1898,25,20-24,1923,14
SIM,1893,21,20-24,1914,75
STAT,1835,42,na,1877,1571.7225320537423
STAT,1899,4,na,1903,3405.723791621326
SIM,1923,26,na,1949,4000
SIM,1948,22,25-29,1970,102
STAT,1830,44,20-24,1874,0.11749846675961305
STAT,1907,22,20-24,1929,95.6138141095456
SIM,1938,19,40-44,1957,1
SIM,1824,37,30-34,1861,6
STAT,1893,41,25-29,1934,0.7731824137373895
STAT,1828,94,na,1922,11.345626671267073
STAT,1818,43,35-39,1861,4.178234517439471
STAT,1903,34,20-24,1937,2.068208806650189
SIM,1920,12,na,1932,4127
STAT,1890,45,30-34,1935,0.11292127903085662
STAT,1923,47,50-100,1970,0.24997924161613
STAT,1953,18,20-24,1971,154.88688275070493
STAT,1857,29,40-44,1886,2.2650321957577204
SIM,1850,23,15-19,1873,2
STAT,1916,18,35-39,1934,0.8388052023223247
STAT,1916,37,35-39,1953,2.339868633230837
STAT,1883,38,40-44,1921,4.0328830745749125
STAT,1889,33,15-19,1922,0.1653852000504199
SIM,1933,15,40-44,1948,2
SIM,1881,85,na,1966,381
SIM,1914,12,na,1926,4171
SIM,1917,48,na,1965,3551
STAT,1911,40,50-100,1951,0.1071031104709272
SIM,1872,15,15-19,1887,6
STAT,1917,33,45-49,1950,1.550012206900394
STAT,1814,65,na,1879,831.7830016140779
STAT,1829,79,na,1908,428.5156161143483
STAT,1779,94,na,1873,3.9942183336488903
STAT,1887,33,na,1920,2510.4901633918776
STAT,1838,39,40-44,1877,3.528570608501716
STAT,1872,36,15-19,1908,0.05350216028653341
STAT,1858,53,40-44,1911,0.007682256983251286
SIM,1826,30,20-24,1856,2
SIM,1831,43,na,1874,1506
STAT,1855,19,na,1874,1910.9167877661516
STAT,1857,45,na,1902,1692.2753837520802
SIM,1944,25,na,1969,3805
STAT,1909,44,na,1953,3240.497645805088
STAT,1909,47,45-49,1956,0.18861648931915148
SIM,1790,87,na,1877,38
SIM,1855,22,20-24,1877,66
STAT,1922,24,20-24,1946,119.71690585798785
STAT,1938,29,35-39,1967,14.035826112982715
STAT,1920,16,50-100,1936,0.3980894480001117
SIM,1952,16,20-24,1968,147
STAT,1926,36,15-19,1962,0.022193787435343285
STAT,1874,21,45-49,1895,0.6753186751968561
SIM,1840,57,na,1897,1388
SIM,1846,39,40-44,1885,5
SIM,1860,86,na,1946,195
STAT,1938,15,50-100,1953,0.3507170731049975
STAT,1944,16,20-24,1960,137.86613355772806
SIM,1935,11,na,1946,5118
STAT,1864,15,15-19,1879,5.763696257037952
STAT,1907,35,35-39,1942,2.138262271136801
STAT,1898,35,15-19,1933,0.07249397299306978
SIM,1865,29,40-44,1894,2
SIM,1924,37,35-39,1961,4
SIM,1865,38,30-34,1903,4
STAT,1790,108,na,1898,3.6873084685259364E-4
STAT,1799,101,na,1900,0.19077671728726953
STAT,1872,34,na,1906,2243.3332582523904
STAT,1785,72,na,1857,524.4508469305703
STAT,1895,62,na,1957,2298.287255222496
STAT,1918,26,20-24,1944,18.414363322931194
STAT,1875,48,na,1923,2156.119559281348
SIM,1828,51,50-100,1879,1
STAT,1789,107,na,1896,0.0010405381301541888
STAT,1920,27,15-19,1947,0.7316201452588483
STAT,1873,17,15-19,1890,5.69069015668528
STAT,1860,25,50-100,1885,0.5035980280645403
STAT,1903,23,40-44,1926,2.792053770946819
STAT,1880,47,20-24,1927,0.011872372667117728
SIM,1867,56,na,1923,1767
SIM,1781,73,na,1854,399
SIM,1881,17,15-19,1898,4
SIM,1892,48,na,1940,2683
STAT,1837,90,na,1927,49.76871552649957
STAT,1926,35,45-49,1961,0.7885259515368227
SIM,1891,38,40-44,1929,8
STAT,1842,37,40-44,1879,3.656798588309088
STAT,1853,2,na,1855,2671.7088
STAT,1921,31,45-49,1952,1.661198781297918
STAT,1835,64,na,1899,1084.6135673857664
STAT,1897,38,50-100,1935,1.5434553740964951
SIM,1759,95,na,1854,1
SIM,1884,38,40-44,1922,4
STAT,1772,106,na,1878,0.010793751539287445
STAT,1933,35,45-49,1968,0.8787211160899097
STAT,1802,52,50-100,1854,0.04304745825344377
STAT,1876,38,40-44,1914,4.248008099481198
STAT,1894,30,50-100,1924,1.1223901519285284
STAT,1946,7,na,1953,4134.592912241494
STAT,1913,22,20-24,1935,101.76593138524865
SIM,1868,25,35-39,1893,10
STAT,1885,21,20-24,1906,65.05483194349603
SIM,1846,57,na,1903,1408
SIM,1818,45,50-100,1863,1
SIM,1856,31,45-49,1887,1
STAT,1822,33,15-19,1855,0.36871880325551015
SIM,1850,37,40-44,1887,6
STAT,1862,4,na,1866,2459.9800959352183
SIM,1905,18,25-29,1923,7
SIM,1937,27,35-39,1964,12
SIM,1838,18,25-29,1856,8
SIM,1911,23,40-44,1934,2
STAT,1880,85,na,1965,507.9462780387545
SIM,1858,42,35-39,1900,3
STAT,1905,63,na,1968,2703.2032828918937
STAT,1853,27,15-19,1880,0.38978472448589296
STAT,1905,36,20-24,1941,0.22822908701668804
STAT,1909,48,15-19,1957,3.1879996129641013E-4
SIM,1915,35,35-39,1950,6
SIM,1833,50,na,1883,1380
SIM,1934,35,45-49,1969,1
SIM,1812,51,na,1863,1229
STAT,1833,35,40-44,1868,3.402201584756064
STAT,1852,40,25-29,1892,0.4928161748384793
SIM,1837,31,35-39,1868,10
STAT,1935,37,45-49,1972,0.900492023085882
SIM,1879,16,20-24,1895,19
STAT,1814,43,na,1857,1310.8847913360255
SIM,1832,28,na,1860,1742
SIM,1902,21,40-44,1923,2
STAT,1923,44,25-29,1967,0.07859138972323401
SIM,1906,33,35-39,1939,7
SIM,1895,20,35-39,1915,5
STAT,1811,43,40-44,1854,8.327731716244926
SIM,1859,23,35-39,1882,4
STAT,1859,44,35-39,1903,1.3467890899387753
STAT,1887,20,35-39,1907,6.201949286096946
STAT,1927,28,20-24,1955,20.89271069336139
STAT,1849,24,20-24,1873,59.19504361472128
SIM,1935,28,20-24,1963,22
SIM,1889,36,35-39,1925,10
STAT,1820,65,na,1885,900.654429183243
STAT,1831,35,15-19,1866,0.04539464388095087
SIM,1841,35,40-44,1876,9
STAT,1884,24,50-100,1908,0.37830536757454586
STAT,1867,32,25-29,1899,9.085194972932761
STAT,1901,21,40-44,1922,2.7637120140495095
STAT,1840,94,na,1934,13.91863844632622
STAT,1899,37,50-100,1936,0.3430693195367757
STAT,1890,42,20-24,1932,0.18320750547149012
STAT,1858,28,40-44,1886,2.2579117721035136
STAT,1878,45,50-100,1923,0.24394394937226488
STAT,1898,24,50-100,1922,0.5182287192371589
SIM,1885,21,25-29,1906,57
SIM,1867,31,50-100,1898,4
STAT,1887,18,50-100,1905,0.05162413897458839
SIM,1910,21,30-34,1931,38
STAT,1819,80,na,1899,308.91893918213367
STAT,1873,45,25-29,1918,0.05578376967195848
STAT,1879,18,30-34,1897,1.5697143678759746
STAT,1837,93,na,1930,18.448754987285728
SIM,1858,36,na,1894,1920
STAT,1808,51,25-29,1859,0.0131434559873282
SIM,1832,38,40-44,1870,2
STAT,1854,43,50-100,1897,0.7552494534115127
STAT,1844,15,35-39,1859,0.495473291138895
SIM,1888,31,20-24,1919,2
STAT,1941,28,35-39,1969,14.663878360569623
STAT,1898,48,35-39,1946,0.0997221283090281
SIM,1840,26,na,1866,1815
SIM,1928,27,30-34,1955,48
SIM,1897,37,30-34,1934,13
STAT,1869,39,na,1908,2132.709208975524
STAT,1902,21,30-34,1923,23.818104834852456
STAT,1782,86,na,1868,61.46999034347208
SIM,1909,32,45-49,1941,2
SIM,1941,7,na,1948,3736
STAT,1843,37,50-100,1880,1.0340482655144831
STAT,1805,60,na,1865,990.3998446872147
SIM,1922,45,50-100,1967,2
STAT,1824,38,40-44,1862,6.257334619471042
STAT,1900,42,30-34,1942,0.10450251683165743
STAT,1809,48,50-100,1857,0.8796147772538653
STAT,1868,31,25-29,1899,9.276348605131837
STAT,1902,38,25-29,1940,0.8243748591539805
STAT,1904,17,25-29,1921,7.677414668932792
SIM,1883,24,25-29,1907,54
STAT,1869,18,45-49,1887,0.0602037589343296
SIM,1846,18,15-19,1864,5
STAT,1875,42,25-29,1917,0.6224705098016154
SIM,1907,37,40-44,1944,1
STAT,1930,38,30-34,1968,2.243671135817327
STAT,1823,51,20-24,1874,8.638389324481231E-4
STAT,1833,25,30-34,1858,20.629667871895613
SIM,1827,44,na,1871,1422
STAT,1873,44,na,1917,2186.351609059262
SIM,1836,30,45-49,1866,2
SIM,1899,34,30-34,1933,30
SIM,1910,38,25-29,1948,1
SIM,1912,17,25-29,1929,9
SIM,1931,23,50-100,1954,1
STAT,1918,48,30-34,1966,0.08936705703699603
STAT,1900,24,30-34,1924,23.198450517079117
STAT,1794,71,na,1865,570.7171516401278
STAT,1838,18,15-19,1856,5.314927983397324
STAT,1903,28,na,1931,3196.2754877011184
STAT,1934,30,35-39,1964,11.799987953340725
STAT,1943,25,35-39,1968,15.11778334119591
STAT,1806,54,25-29,1860,0.009607163984582376
STAT,1836,39,15-19,1875,0.04263166119519684
STAT,1919,15,na,1934,4064.1189910957314
SIM,1845,69,na,1914,1069
STAT,1867,39,50-100,1906,1.0780480373406236
STAT,1891,29,40-44,1920,3.4776983260354566
STAT,1913,40,45-49,1953,0.15502602592957035
STAT,1832,62,na,1894,1105.153210859768
STAT,1861,30,30-34,1891,13.806837137440757
SIM,1804,87,na,1891,46
STAT,1883,19,35-39,1902,0.5053072793266483
STAT,1927,38,50-100,1965,0.49269204522344345
STAT,1947,17,50-100,1964,0.39871753473729166
SIM,1870,36,na,1906,2197
SIM,1887,19,15-19,1906,6
SIM,1905,21,20-24,1926,77
STAT,1924,40,20-24,1964,0.019901610222161206
SIM,1897,24,25-29,1921,69
SIM,1863,82,na,1945,349
STAT,1899,40,15-19,1939,0.0012540394855736375
STAT,1831,80,na,1911,377.2602562814492
SIM,1924,32,40-44,1956,8
SIM,1871,18,na,1889,2431
STAT,1809,50,na,1859,1281.5767009562792
STAT,1946,17,30-34,1963,12.771732984223426
STAT,1811,54,35-39,1865,0.026260340401104226
STAT,1872,47,50-100,1919,0.23179279439819192
STAT,1827,75,na,1902,571.2992839862877
STAT,1857,7,na,1864,2166.574683032818
SIM,1841,25,30-34,1866,29
STAT,1934,32,30-34,1966,20.32096096263057
STAT,1823,85,na,1908,144.2599808877455
STAT,1876,80,na,1956,639.5887321047735
STAT,1917,35,35-39,1952,2.3957671311061355
STAT,1872,90,na,1962,152.7470229442762
STAT,1907,43,25-29,1950,0.06142396251273836
SIM,1891,19,35-39,1910,4
STAT,1852,15,50-100,1867,0.04555446552969799
SIM,1923,38,35-39,1961,7
STAT,1909,40,25-29,1949,0.06379630616782002
STAT,1930,25,25-29,1955,79.13756119281135
STAT,1872,48,15-19,1920,3.745149290575332E-4
STAT,1856,72,na,1928,934.4083495341248
STAT,1916,32,40-44,1948,3.8166515264597534
STAT,1833,109,na,1942,4.319201380213435E-4
SIM,1893,31,50-100,1924,2
STAT,1830,49,20-24,1879,0.00857082344232014
SIM,1800,97,na,1897,1
STAT,1786,109,na,1895,3.50113838201104E-4
STAT,1902,26,50-100,1928,0.8557313268909225
SIM,1877,31,45-49,1908,3
SIM,1925,17,35-39,1942,8
STAT,1932,35,30-34,1967,2.3174318853645177
STAT,1940,1,na,1941,3988.819854567259
STAT,1910,16,40-44,1926,0.2623880983957704
STAT,1872,18,50-100,1890,0.046332502304317215
SIM,1877,15,na,1892,2500
STAT,1833,43,30-34,1876,0.8369305291008586
STAT,1835,22,30-34,1857,14.773080738570004
STAT,1904,49,50-100,1953,0.1837766983633747
STAT,1900,40,35-39,1940,0.1664651219948481
STAT,1849,35,50-100,1884,0.924535759186988
STAT,1822,104,na,1926,0.03445276851426841
STAT,1869,31,45-49,1900,1.601131780579937
STAT,1885,16,35-39,1901,0.5177020902390149
STAT,1913,22,15-19,1935,4.871805298434234
SIM,1913,3,na,1916,3777
SIM,1893,16,35-39,1909,1
STAT,1877,34,na,1911,2319.312732590995
SIM,1843,22,30-34,1865,19
STAT,1816,46,35-39,1862,0.37456050183210926
STAT,1864,52,20-24,1916,6.197165544349728E-4
SIM,1954,17,30-34,1971,20
STAT,1915,38,35-39,1953,2.2966271148486666
STAT,1917,17,35-39,1934,0.8529989606063092
STAT,1881,79,na,1960,795.2111801898913
STAT,1907,25,25-29,1932,59.09001193339537
STAT,1835,40,30-34,1875,0.8818002093277314
STAT,1912,27,30-34,1939,36.468812636790595
STAT,1944,22,45-49,1966,1.147642856238114
STAT,1825,80,na,1905,349.7507078794696
STAT,1892,11,na,1903,3059.684751927786
SIM,1906,17,na,1923,3549
STAT,1917,49,25-29,1966,0.052032917129329226
STAT,1851,23,25-29,1874,49.771347787330185
STAT,1927,22,45-49,1949,1.309748468075194
SIM,1864,36,na,1900,2125
SIM,1872,31,na,1903,2225
STAT,1820,53,50-100,1873,0.023464772807618037
SIM,1821,59,na,1880,1089
SIM,1872,2,na,1874,2948
STAT,1871,20,45-49,1891,0.6569685521773194
SIM,1795,65,na,1860,751
SIM,1867,26,35-39,1893,13
SIM,1842,23,25-29,1865,48
STAT,1922,30,15-19,1952,0.13827669268404363
STAT,1807,109,na,1916,2.5521116033235447E-4
STAT,1839,17,20-24,1856,15.463441471768272
STAT,1860,47,40-44,1907,0.13082767384204683
STAT,1871,49,na,1920,2063.079555530745
STAT,1839,33,25-29,1872,8.317648535008503
STAT,1852,39,50-100,1891,0.9234167338489087
STAT,1834,23,25-29,1857,47.050283581053236
STAT,1944,10,na,1954,4000.118163703449
STAT,1814,49,35-39,1863,0.3676540784481208
STAT,1927,35,20-24,1962,0.3101900992957007
STAT,1860,31,25-29,1891,7.89599525604909
STAT,1866,37,35-39,1903,6.160437043068999
STAT,1877,2,na,1879,3185.5760305516214
SIM,1929,25,25-29,1954,81
SIM,1895,28,na,1923,2969
STAT,1818,39,na,1857,1430.2658069870895
SIM,1843,40,30-34,1883,1
STAT,1920,6,na,1926,4248.3270998199205
SIM,1873,23,25-29,1896,54
SIM,1856,49,50-100,1905,1
SIM,1915,25,25-29,1940,57
STAT,1899,29,40-44,1928,3.8503798912937013
SIM,1920,27,30-34,1947,45
SIM,1882,61,na,1943,1688
STAT,1889,24,25-29,1913,66.34600029004157
SIM,1906,38,35-39,1944,7
STAT,1869,30,30-34,1899,16.094143429583827
STAT,1910,32,45-49,1942,1.4329243134528404
SIM,1826,40,30-34,1866,1
SIM,1916,0,na,1916,4101
STAT,1904,48,30-34,1952,0.07304822750691779
STAT,1822,60,na,1882,1063.7128056204372
SIM,1802,92,na,1894,5
SIM,1874,37,35-39,1911,16
SIM,1884,23,30-34,1907,22
STAT,1830,47,25-29,1877,0.04221642991824124
STAT,1854,20,45-49,1874,0.5985580435612109
STAT,1784,81,na,1865,162.1665811836824
STAT,1891,40,15-19,1931,0.016310865037626656
SIM,1856,36,30-34,1892,4
SIM,1925,32,30-34,1957,29
SIM,1911,19,30-34,1930,2
SIM,1893,31,30-34,1924,28
SIM,1907,58,na,1965,2967
STAT,1855,111,na,1966,4.842335757697344E-4
SIM,1802,52,na,1854,1172
SIM,1935,22,45-49,1957,1
STAT,1922,43,20-24,1965,0.01912056344785937
SIM,1878,56,na,1934,2070
STAT,1885,69,na,1954,1381.2215445959268
STAT,1885,31,30-34,1916,16.49988015707282
SIM,1847,33,25-29,1880,14
SIM,1886,23,na,1909,2277
SIM,1946,25,25-29,1971,76
STAT,1848,77,na,1925,622.7284443650523
STAT,1818,40,30-34,1858,2.9840294966738443
STAT,1892,26,50-100,1918,0.7593574397259986
STAT,1848,36,30-34,1884,3.9980348478336856
STAT,1903,19,30-34,1922,2.130724968435847
SIM,1856,41,na,1897,1847
SIM,1858,36,35-39,1894,8
STAT,1865,23,25-29,1888,49.38243453325223
STAT,1917,32,30-34,1949,15.584997205964742
STAT,1834,41,25-29,1875,0.4853699634758073
STAT,1848,23,25-29,1871,49.85469854736288
STAT,1883,74,na,1957,1089.8565984762786
STAT,1908,24,30-34,1932,24.799332780125507
SIM,1831,39,35-39,1870,11
SIM,1859,42,50-100,1901,1
SIM,1870,76,na,1946,807
STAT,1809,50,30-34,1859,0.02148699649585651
STAT,1851,41,25-29,1892,0.47303503818929593
STAT,1825,33,25-29,1858,16.389196757052996
STAT,1865,39,40-44,1904,3.720023641299435
STAT,1925,15,na,1940,4220.470894155852
STAT,1854,77,na,1931,622.4437941466713
STAT,1855,47,30-34,1902,0.06823770376543965
SIM,1879,50,50-100,1929,1
STAT,1932,25,na,1957,4639.440585875311
SIM,1944,25,20-24,1969,16
STAT,1810,75,na,1885,449.9642429530016
SIM,1961,2,na,1963,4712
SIM,1816,72,na,1888,518
STAT,1828,57,na,1885,1186.324024903894
STAT,1928,33,15-19,1961,0.15171535331102148
STAT,1936,25,20-24,1961,16.514601862875008
STAT,1828,30,45-49,1858,2.020057210298087
STAT,1855,18,15-19,1873,4.969684318279708
STAT,1933,15,25-29,1948,55.057155104910954
STAT,1878,16,50-100,1894,0.04829952063165222
SIM,1815,59,na,1874,1027
STAT,1938,25,25-29,1963,61.64840223617546
SIM,1833,33,25-29,1866,10
SIM,1941,15,25-29,1956,44
SIM,1847,17,20-24,1864,17
SIM,1938,10,na,1948,3638
STAT,1895,21,45-49,1916,0.8622532687330817
SIM,1926,37,na,1963,4213
STAT,1894,46,na,1940,2742.3243556204666
SIM,1873,39,40-44,1912,7
STAT,1904,35,25-29,1939,0.8499501710680575
STAT,1908,40,35-39,1948,0.17795257289253671
SIM,1874,38,na,1912,2235
STAT,1771,107,na,1878,0.005486923897409907
STAT,1865,49,na,1914,1891.0387800729118
SIM,1866,28,40-44,1894,6
STAT,1857,14,na,1871,2070.7107264652154
STAT,1859,41,30-34,1900,0.8706849973835293
SIM,1833,44,na,1877,1501
STAT,1923,46,45-49,1969,0.24080526349604497
STAT,1876,41,30-34,1917,1.1262934059531637
SIM,1955,15,25-29,1970,63
STAT,1790,81,na,1871,194.11166304640906
SIM,1916,24,30-34,1940,41
STAT,1840,39,35-39,1879,5.706157392352963
STAT,1942,22,40-44,1964,3.3302595854530295
STAT,1838,29,50-100,1867,0.5470467929552633
SIM,1847,15,25-29,1862,8
SIM,1853,30,45-49,1883,1
STAT,1941,19,50-100,1960,0.36428566612944013
SIM,1844,16,na,1860,2133
STAT,1900,27,35-39,1927,12.645784561260564
STAT,1870,95,na,1965,41.28185946029039
STAT,1889,37,30-34,1926,6.21573736675154
STAT,1871,48,25-29,1919,0.05326708280733942
SIM,1925,30,35-39,1955,10
STAT,1892,24,25-29,1916,67.29799591863798
STAT,1840,51,20-24,1891,5.1635820251915E-4
STAT,1803,65,na,1868,795.8068675165426
STAT,1879,69,na,1948,1449.0994199854497
SIM,1912,17,na,1929,3550
SIM,1841,79,na,1920,445
SIM,1856,23,25-29,1879,50
STAT,1818,102,na,1920,0.1413465576964384
STAT,1845,30,45-49,1875,1.491120304231605
STAT,1908,42,30-34,1950,0.11171404268405603
STAT,1839,15,25-29,1854,5.001461273359303
SIM,1778,93,na,1871,3
STAT,1933,33,25-29,1966,11.759569940402033
SIM,1901,32,45-49,1933,3
STAT,1858,37,50-100,1895,0.9105303929451688
STAT,1902,35,20-24,1937,0.22391703046740516
SIM,1888,18,20-24,1906,18
STAT,1919,43,na,1962,3796.1132608007947
STAT,1947,15,25-29,1962,46.14278994126997
SIM,1884,41,30-34,1925,2
STAT,1930,40,45-49,1970,0.20745347671713252
STAT,1943,22,30-34,1965,28.886297782751353
SIM,1898,48,na,1946,2818
STAT,1882,80,na,1962,775.3096406777486
SIM,1932,25,na,1957,4492
SIM,1814,77,na,1891,339
SIM,1846,17,30-34,1863,2
STAT,1842,52,na,1894,1525.1352804694159
SIM,1882,29,40-44,1911,3
STAT,1884,18,40-44,1902,0.17029991192451288
SIM,1863,18,15-19,1881,6
SIM,1810,87,na,1897,59
STAT,1874,29,40-44,1903,2.871639509297564
STAT,1775,104,na,1879,0.029497860908734165
STAT,1859,49,na,1908,1660.7946081151294
STAT,1853,39,15-19,1892,0.041225527842384195
SIM,1857,94,na,1951,13
SIM,1850,16,na,1866,2070
SIM,1876,21,na,1897,2359
SIM,1931,12,na,1943,4891
SIM,1944,10,na,1954,3960
STAT,1920,15,15-19,1935,9.69586017755959
STAT,1819,40,na,1859,1456.350668579222
SIM,1899,37,35-39,1936,2
STAT,1840,36,30-34,1876,4.435744252615424
SIM,1771,83,na,1854,88
STAT,1791,101,na,1892,0.10473832785071113
STAT,1842,33,30-34,1875,14.864561989349705
SIM,1854,8,na,1862,2289
STAT,1894,21,25-29,1915,69.77605312253502
STAT,1820,37,na,1857,1497.2203178306324
STAT,1807,55,na,1862,1111.155693039532
STAT,1879,19,15-19,1898,5.828540027558154
STAT,1857,103,na,1960,0.26077770619854895
SIM,1850,15,30-34,1865,1
STAT,1901,33,na,1934,3142.0722338520463
STAT,1924,43,25-29,1967,0.08012218131635758
STAT,1930,22,20-24,1952,134.57660361734298
SIM,1910,24,35-39,1934,14
SIM,1950,19,na,1969,3980
STAT,1833,28,35-39,1861,7.704366180054032
STAT,1843,35,40-44,1878,3.7642551212168396
STAT,1883,24,50-100,1907,0.3751961385213652
SIM,1851,35,40-44,1886,4
STAT,1902,24,35-39,1926,7.730858075780829
SIM,1835,30,25-29,1865,9
STAT,1825,36,35-39,1861,9.431345229523709
STAT,1829,70,na,1899,860.0124321503306
STAT,1854,48,25-29,1902,0.0409562617808758
STAT,1921,35,25-29,1956,1.04047850390118
STAT,1939,24,30-34,1963,27.246364760374103
SIM,1789,93,na,1882,5
STAT,1903,68,na,1971,2408.4083179901377
STAT,1962,9,na,1971,4755.1940328498495
SIM,1856,20,15-19,1876,5
STAT,1813,49,20-24,1862,0.035088419548947064
SIM,1879,23,20-24,1902,60
STAT,1901,22,25-29,1923,75.69512541922327
STAT,1929,42,50-100,1971,0.14373445646974936
SIM,1831,49,na,1880,1432
STAT,1835,25,35-39,1860,7.960120239412945
STAT,1925,24,30-34,1949,32.30089462313851
STAT,1909,34,50-100,1943,0.7387752699856268
SIM,1876,31,25-29,1907,13
STAT,1918,32,45-49,1950,1.5796230916880742
STAT,1848,20,15-19,1868,2.935876763331818
STAT,1922,49,35-39,1971,0.13911395461905504
STAT,1938,22,20-24,1960,103.9508632121041
SIM,1833,36,35-39,1869,12
SIM,1850,33,30-34,1883,26
STAT,1883,34,na,1917,2190.490860351093
STAT,1893,20,50-100,1913,0.4917004794476652
STAT,1961,4,na,1965,4798.542817360743
STAT,1914,31,na,1945,3610.5283381302274
SIM,1901,31,30-34,1932,35
STAT,1843,93,na,1936,21.08481771211802
STAT,1898,48,50-100,1946,0.17494110455949924
SIM,1907,32,40-44,1939,4
SIM,1919,43,na,1962,3801
STAT,1890,56,na,1946,2355.832386722301
SIM,1856,39,35-39,1895,17
SIM,1913,16,30-34,1929,3
STAT,1896,19,15-19,1915,7.36974228062459
STAT,1905,43,20-24,1948,0.01494659080331292
SIM,1843,25,35-39,1868,9
STAT,1843,17,40-44,1860,0.16863119566743134
SIM,1856,72,na,1928,947
SIM,1883,21,20-24,1904,59
SIM,1889,28,na,1917,2787
STAT,1908,43,45-49,1951,0.14455696489738235
SIM,1918,38,25-29,1956,1
STAT,1795,65,na,1860,770.5167101666595
STAT,1905,16,30-34,1921,2.181223510129897
SIM,1839,69,na,1908,1042
SIM,1841,28,40-44,1869,3
STAT,1830,67,na,1897,946.9322108131028
STAT,1921,17,25-29,1938,46.6684395471345
STAT,1869,15,35-39,1884,0.5147539016890433
SIM,1897,21,20-24,1918,80
STAT,1841,38,40-44,1879,3.492306299227084
SIM,1915,53,na,1968,3381
SIM,1838,22,20-24,1860,48
STAT,1829,28,15-19,1857,0.5556274225459952
STAT,1867,44,na,1911,2022.398674861087
SIM,1926,32,45-49,1958,1
STAT,1827,49,15-19,1876,3.412522519947982E-4
STAT,1881,37,30-34,1918,4.861342278034076
STAT,1897,31,20-24,1928,3.429042154949255
SIM,1918,22,45-49,1940,1
STAT,1889,21,20-24,1910,80.61335864025027
SIM,1869,20,25-29,1889,56
STAT,1859,26,35-39,1885,7.453647335180785
SIM,1897,23,na,1920,3004
SIM,1891,78,na,1969,1318
STAT,1899,47,40-44,1946,0.12443933183791336
STAT,1951,17,40-44,1968,1.5735685291745607
SIM,1891,16,30-34,1907,1
STAT,1838,17,30-34,1855,1.4359120394540834
STAT,1816,60,na,1876,1097.0137287715363
SIM,1868,44,50-100,1912,1
SIM,1862,41,na,1903,2018
STAT,1814,46,30-34,1860,0.26690627896839625
SIM,1937,3,na,1940,3581
STAT,1876,23,30-34,1899,17.317847264708917
SIM,1868,66,na,1934,1455
STAT,1906,45,30-34,1951,0.07586158298219979
SIM,1916,25,45-49,1941,4
STAT,1856,30,20-24,1886,2.066945836557988
SIM,1842,20,20-24,1862,57
SIM,1904,22,15-19,1926,3
STAT,1947,19,40-44,1966,1.4875486660107242
SIM,1825,49,na,1874,1302
SIM,1903,68,na,1971,2377
STAT,1904,13,na,1917,3493.4198417526673
SIM,1911,21,45-49,1932,4
STAT,1853,52,45-49,1905,0.01070522550544107
SIM,1859,35,40-44,1894,3
SIM,1925,35,35-39,1960,5
STAT,1833,46,35-39,1879,0.10107369680035624
STAT,1853,20,25-29,1873,50.88908883121346
STAT,1788,71,na,1859,576.6874628763078
STAT,1883,34,30-34,1917,16.026976601901328
SIM,1922,36,25-29,1958,1
STAT,1871,18,na,1889,2366.594291503315
STAT,1964,1,na,1965,4683.71973816617
SIM,1886,51,na,1937,2103
SIM,1912,49,50-100,1961,1
SIM,1892,36,40-44,1928,8
STAT,1848,39,35-39,1887,5.143086436599582
STAT,1816,43,30-34,1859,3.29606071637748
SIM,1832,90,na,1922,31
STAT,1942,25,45-49,1967,1.7143461224998227
SIM,1891,34,30-34,1925,24
STAT,1834,35,50-100,1869,0.9651293079234861
STAT,1853,24,na,1877,1846.7078703494371
STAT,1869,43,50-100,1912,0.9590798857956927
STAT,1935,30,25-29,1965,12.092946728398918
STAT,1840,54,30-34,1894,0.004031457643514106
SIM,1933,19,na,1952,4668
SIM,1864,30,20-24,1894,2
SIM,1887,18,30-34,1905,1
STAT,1908,25,45-49,1933,1.5661224639000788
SIM,1879,69,na,1948,1392
STAT,1920,33,15-19,1953,0.1324174978462518
STAT,1876,26,35-39,1902,9.442462773409183
SIM,1946,22,20-24,1968,106
SIM,1838,28,na,1866,1720
STAT,1917,46,20-24,1963,0.010931214413941731
STAT,1862,72,na,1934,1017.6884924769486
STAT,1849,52,25-29,1901,0.002539459207268073
SIM,1862,46,50-100,1908,2
STAT,1936,15,na,1951,3343.9181689669135
STAT,1923,43,40-44,1966,0.2757637169394085
STAT,1884,16,na,1900,2363.5443222855747
STAT,1919,30,50-100,1949,0.8494537309888527
STAT,1916,35,45-49,1951,0.6657498358561793
SIM,1927,30,50-100,1957,4
SIM,1910,50,na,1960,3128
SIM,1869,23,35-39,1892,8
STAT,1789,96,na,1885,1.4304831004444714
STAT,1808,49,40-44,1857,0.6304260058551044
SIM,1837,34,na,1871,1693
STAT,1853,52,na,1905,1588.3054072616137
STAT,1812,70,na,1882,717.3229709239303
STAT,1894,74,na,1968,1701.5078320873674
STAT,1921,16,50-100,1937,0.40446439709384846
SIM,1874,66,na,1940,1528
SIM,1898,32,20-24,1930,3
STAT,1817,45,40-44,1862,0.3953594509019832
SIM,1819,49,na,1868,1322
SIM,1842,39,40-44,1881,7
STAT,1861,59,na,1920,1524.602264154679
SIM,1841,28,35-39,1869,9
STAT,1892,27,35-39,1919,11.414747834346635
STAT,1936,28,25-29,1964,59.46821344694882
SIM,1886,20,30-34,1906,21
STAT,1831,47,15-19,1878,2.9409490559817556E-4
STAT,1871,50,45-49,1921,0.013786822005446082
STAT,1925,27,40-44,1952,5.20140317021205
SIM,1830,64,na,1894,1109
STAT,1869,15,40-44,1884,0.17158464383089395
SIM,1897,21,15-19,1918,4
STAT,1838,87,na,1925,120.1595788693551
STAT,1922,46,25-29,1968,0.057716049278608184
STAT,1851,53,25-29,1904,0.002555711965392332
SIM,1858,33,30-34,1891,21
STAT,1850,87,na,1937,124.03167999299646
STAT,1933,19,40-44,1952,1.759356745720601
STAT,1889,21,15-19,1910,3.859175486356118
SIM,1942,15,45-49,1957,1
SIM,1905,24,25-29,1929,84
STAT,1863,45,50-100,1908,0.20598286552399422
STAT,1827,30,25-29,1857,13.036660581516996
SIM,1885,38,na,1923,2213
STAT,1909,36,15-19,1945,0.017249487956943328
STAT,1785,110,na,1895,1.99407712630085E-4
SIM,1912,32,20-24,1944,2
STAT,1832,44,25-29,1876,0.46419568247749915
SIM,1861,20,25-29,1881,54
SIM,1868,97,na,1965,5
SIM,1763,91,na,1854,5
STAT,1846,18,50-100,1864,0.0431371802408309
SIM,1906,35,30-34,1941,1
STAT,1896,48,30-34,1944,0.06731732289688118
SIM,1856,20,20-24,1876,59
STAT,1890,16,na,1906,2924.3078611896244
SIM,1941,19,40-44,1960,1
STAT,1834,39,40-44,1873,3.301156983093225
STAT,1855,6,na,1861,2101.5290156214096
SIM,1865,44,30-34,1909,3
STAT,1834,20,20-24,1854,102.85052497715482
STAT,1918,21,na,1939,3731.8773489633477
STAT,1907,58,na,1965,2932.7027840939877
SIM,1882,25,50-100,1907,1
STAT,1813,55,na,1868,1137.7922912811844
STAT,1812,51,45-49,1863,0.04659475985818716
STAT,1851,26,35-39,1877,8.34459662445509
STAT,1874,15,15-19,1889,5.778101886503817
STAT,1920,33,45-49,1953,1.6214896650138753
STAT,1904,32,20-24,1936,2.102816104514756
SIM,1891,38,na,1929,2879
STAT,1884,36,40-44,1920,4.106241645475321
STAT,1912,42,20-24,1954,0.01608709855113249
SIM,1866,31,na,1897,2113
STAT,1848,20,20-24,1868,61.32680083680588
STAT,1913,32,50-100,1945,0.7769257902284967
STAT,1912,24,20-24,1936,104.22793456825652
STAT,1914,36,25-29,1950,0.9330071562678144
SIM,1795,93,na,1888,5
STAT,1857,44,30-34,1901,0.8446589962835527
SIM,1856,39,40-44,1895,5
STAT,1923,44,50-100,1967,0.12929551131258243
SIM,1816,44,na,1860,1354
SIM,1933,27,40-44,1960,4
STAT,1903,36,50-100,1939,0.3578796285954675
SIM,1808,77,na,1885,313
STAT,1844,87,na,1931,123.68052760281569
STAT,1934,33,45-49,1967,2.0283359391692533
STAT,1836,52,na,1888,1375.7382860563262
STAT,1897,26,na,1923,3025.5174027874446
STAT,1903,21,45-49,1924,0.9400528025858391
STAT,1962,0,na,1962,4793.090397168726
SIM,1920,24,20-24,1944,107
SIM,1882,15,15-19,1897,7
STAT,1912,36,na,1948,3484.7679119331833
SIM,1879,26,25-29,1905,36
SIM,1817,82,na,1899,251
STAT,1840,54,25-29,1894,0.002398883863929619
SIM,1932,25,30-34,1957,52
SIM,1814,49,na,1863,1277
SIM,1835,70,na,1905,845
STAT,1855,87,na,1942,124.77771306061125
SIM,1854,77,na,1931,595
STAT,1903,15,15-19,1918,8.01329114639331
SIM,1886,45,50-100,1931,3
STAT,1815,59,na,1874,1048.116265754756
STAT,1951,17,35-39,1968,4.720705314200458
STAT,1821,39,30-34,1860,9.803799977200091
SIM,1842,27,40-44,1869,3
STAT,1933,37,40-44,1970,1.9262493152266864
STAT,1834,27,40-44,1861,2.431410073576923
SIM,1898,20,20-24,1918,81
SIM,1917,17,na,1934,3891
STAT,1860,35,40-44,1895,3.3927887211278476
STAT,1859,31,50-100,1890,0.6936029759624133
STAT,1920,31,na,1951,3929.725434207174
STAT,1897,34,25-29,1931,12.829870903220025
STAT,1900,25,45-49,1925,1.4650238699804305
SIM,1852,30,25-29,1882,16
SIM,1838,27,20-24,1865,8
STAT,1923,23,50-100,1946,0.7210915108949487
STAT,1868,16,35-39,1884,0.5068695032904663
STAT,1830,27,na,1857,1698.0790043197403
SIM,1908,30,35-39,1938,12
STAT,1909,42,45-49,1951,0.14702000930420528
STAT,1941,9,na,1950,3850.969987542982
STAT,1847,52,20-24,1899,5.400623301321665E-4
STAT,1914,45,50-100,1959,0.21286944633564958
STAT,1906,41,15-19,1947,0.0013251545660550158
SIM,1921,32,50-100,1953,4
STAT,1818,40,25-29,1858,1.6667552211778836
SIM,1911,15,15-19,1926,8
SIM,1951,18,20-24,1969,153
STAT,1924,21,na,1945,4083.430886206817
SIM,1827,75,na,1902,539
STAT,1912,27,25-29,1939,61.261565159574616
STAT,1883,16,30-34,1899,1.4793356712265953
STAT,1920,37,30-34,1957,1.8852371191690291
SIM,1930,28,30-34,1958,52
SIM,1929,29,40-44,1958,7
SIM,1908,40,na,1948,3218
STAT,1922,28,30-34,1950,41.7408762978203
SIM,1866,62,na,1928,1572
SIM,1881,79,na,1960,708
STAT,1826,50,30-34,1876,0.0055884567734164154
STAT,1774,114,na,1888,2.8367673032377787E-4
STAT,1836,52,45-49,1888,0.009272684151421576
SIM,1904,38,30-34,1942,1
SIM,1906,17,30-34,1923,2
SIM,1786,88,na,1874,35
STAT,1868,54,50-100,1922,0.013247728014247017
STAT,1935,32,45-49,1967,2.056520543606936
STAT,1895,49,25-29,1944,0.0392188194818771
SIM,1906,23,30-34,1929,27
STAT,1893,41,30-34,1934,1.3842459286081434
SIM,1890,28,na,1918,2832
STAT,1828,85,na,1913,155.61967413890537
SIM,1853,36,na,1889,1906
SIM,1841,48,na,1889,1559
STAT,1828,88,na,1916,77.93266818186228
SIM,1877,3,na,1880,2838
SIM,1916,40,40-44,1956,4
STAT,1844,47,na,1891,1572.0455929730197
SIM,1833,33,30-34,1866,17
SIM,1904,50,na,1954,2907
STAT,1764,111,na,1875,8.654646161641807E-4
STAT,1898,64,na,1962,2380.451662449583
STAT,1904,32,15-19,1936,0.11078455127527877
STAT,1899,43,25-29,1942,0.05731328159894825
STAT,1911,25,20-24,1936,16.92726731633778
STAT,1930,40,15-19,1970,0.0019142190660392678
SIM,1898,39,40-44,1937,2
STAT,1872,43,15-19,1915,0.012999920434933043
STAT,1849,31,20-24,1880,2.279663363120898
STAT,1858,36,na,1894,1755.6721099232443
SIM,1917,8,na,1925,3997
STAT,1876,24,na,1900,2292.087163927436
SIM,1879,28,20-24,1907,12
STAT,1892,24,30-34,1916,20.940137127690384
STAT,1909,53,na,1962,3120.467523426318
SIM,1893,31,25-29,1924,12
SIM,1790,93,na,1883,5
STAT,1841,22,25-29,1863,49.616746582556935
STAT,1857,32,30-34,1889,13.083416535616648
STAT,1848,25,15-19,1873,0.395870963886444
SIM,1865,26,30-34,1891,24
SIM,1908,43,na,1951,3154
STAT,1893,39,50-100,1932,1.456781218807674
STAT,1861,42,30-34,1903,0.9007775237502954
STAT,1885,31,25-29,1916,9.679523445183763
SIM,1857,35,50-100,1892,1
SIM,1876,16,35-39,1892,1
STAT,1832,93,na,1925,17.67138337576523
STAT,1841,67,na,1908,1084.5926903459776
STAT,1845,17,45-49,1862,0.0581550931740057
STAT,1867,72,na,1939,1120.188389208525
STAT,1825,40,na,1865,1585.3000497758676
STAT,1831,42,15-19,1873,0.010518191254818314
STAT,1873,13,na,1886,2504.119892423136
SIM,1907,33,25-29,1940,11
STAT,1874,54,na,1928,2021.781509352511
STAT,1908,40,40-44,1948,0.2210411845016168
STAT,1924,25,30-34,1949,43.39502249005552
STAT,1860,17,40-44,1877,0.16195571743402323
SIM,1901,34,35-39,1935,11
STAT,1847,109,na,1956,5.977861483720178E-4
STAT,1840,26,na,1866,1892.0172577951766
STAT,1922,46,30-34,1968,0.0969950281947073
SIM,1823,85,na,1908,140
SIM,1929,22,20-24,1951,133
STAT,1825,33,30-34,1858,27.937303307696762
STAT,1899,25,25-29,1924,55.135526186894346
SIM,1857,31,20-24,1888,2
STAT,1925,27,35-39,1952,16.75409660978816
STAT,1903,33,15-19,1936,0.10943845555598754
STAT,1858,46,40-44,1904,0.12732747282537277
SIM,1939,32,25-29,1971,13
STAT,1928,20,na,1948,4333.414913870884
STAT,1935,26,15-19,1961,0.9094477374048218
SIM,1854,74,na,1928,769
STAT,1857,26,30-34,1883,19.45685892330562
STAT,1907,28,35-39,1935,13.340445962827927
STAT,1842,101,na,1943,0.4063482413409452
SIM,1915,28,35-39,1943,16
SIM,1900,51,na,1951,2797
STAT,1932,31,15-19,1963,0.16147756797458462
STAT,1795,96,na,1891,1.6587687809663558
SIM,1837,74,na,1911,668
SIM,1828,69,na,1897,742
SIM,1902,29,30-34,1931,47
SIM,1939,26,25-29,1965,54
SIM,1832,26,50-100,1858,1
STAT,1860,29,40-44,1889,2.2912553656439822
SIM,1925,43,na,1968,4149
STAT,1916,33,25-29,1949,8.97625687621535
STAT,1877,50,40-44,1927,0.010468742509934055
SIM,1863,40,50-100,1903,3
STAT,1859,41,25-29,1900,0.48632855908691736
SIM,1842,89,na,1931,47
STAT,1826,32,30-34,1858,23.10316995629359
STAT,1845,20,50-100,1865,0.3617661845220178
SIM,1847,95,na,1942,4
STAT,1827,47,na,1874,1401.9915805047085
STAT,1912,29,20-24,1941,16.86823898981634
STAT,1804,75,na,1879,429.850679986455
STAT,1813,43,50-100,1856,3.563861135673684
STAT,1912,45,25-29,1957,0.04837498788351273
SIM,1922,33,20-24,1955,2
STAT,1852,11,na,1863,2203.6749626373175
STAT,1875,21,20-24,1896,67.08411876051166
STAT,1843,62,na,1905,1318.6264764589257
STAT,1920,19,30-34,1939,12.850164595748884
SIM,1887,64,na,1951,1749
STAT,1930,22,15-19,1952,6.442539282289623
STAT,1771,86,na,1857,45.585536710702
STAT,1797,91,na,1888,18.987793078150887
STAT,1833,28,40-44,1861,2.3918636502308095
STAT,1893,23,30-34,1916,21.2841160586781
STAT,1796,103,na,1899,0.03343504915859028
SIM,1920,29,20-24,1949,16
SIM,1933,10,na,1943,5049
STAT,1906,18,40-44,1924,0.2509439039326038
SIM,1869,20,30-34,1889,21
SIM,1851,31,25-29,1882,12
SIM,1916,22,40-44,1938,2
STAT,1813,47,25-29,1860,0.1742313947256352
SIM,1839,24,30-34,1863,16
SIM,1850,56,na,1906,1500
SIM,1876,61,na,1937,1805
SIM,1865,32,30-34,1897,16
SIM,1903,39,25-29,1942,3
SIM,1902,55,na,1957,2820
SIM,1924,21,25-29,1945,105
STAT,1898,27,30-34,1925,32.203291633806295
STAT,1848,46,na,1894,1625.4401011110974
SIM,1830,37,25-29,1867,2
STAT,1898,15,30-34,1913,2.0477533355853295
STAT,1905,43,50-100,1948,0.09942731953538463
STAT,1901,26,40-44,1927,3.9745881566002548
SIM,1860,25,35-39,1885,10
STAT,1925,40,40-44,1965,0.2869053186053698
STAT,1926,20,35-39,1946,10.872291088145557
STAT,1914,33,20-24,1947,2.309276940855213
SIM,1895,68,na,1963,2089
STAT,1852,43,35-39,1895,1.3658677190174902
SIM,1810,56,na,1866,1113
SIM,1834,32,30-34,1866,19
SIM,1913,31,20-24,1944,2
SIM,1878,87,na,1965,363
SIM,1924,33,25-29,1957,10
STAT,1880,38,25-29,1918,2.8477223434753243
SIM,1934,6,na,1940,5069
STAT,1897,16,25-29,1913,7.177015485506036
STAT,1921,47,25-29,1968,0.05649645670141313
SIM,1868,21,25-29,1889,48
SIM,1864,17,20-24,1881,17
STAT,1856,17,20-24,1873,15.510272492662923
STAT,1925,22,40-44,1947,3.8025956011267072
STAT,1817,45,na,1862,1318.5940456526182
STAT,1831,49,35-39,1880,0.10031992332375117
STAT,1849,38,40-44,1887,3.1953172289140355
SIM,1856,9,na,1865,2283
STAT,1843,31,25-29,1874,8.976423045126708
STAT,1786,100,na,1886,0.2128283191259021
STAT,1820,41,30-34,1861,2.139234944960712
STAT,1879,60,na,1939,1883.2103940049562
STAT,1905,31,20-24,1936,2.1275118175610706
STAT,1905,19,35-39,1924,0.745056134956293
SIM,1838,25,25-29,1863,47
SIM,1848,26,30-34,1874,24
STAT,1861,28,na,1889,1872.2336553933158
STAT,1834,26,na,1860,1768.4275609348297
SIM,1857,38,40-44,1895,7
SIM,1907,15,25-29,1922,10
SIM,1841,70,na,1911,969
STAT,1889,26,15-19,1915,0.5309564418139148
SIM,1933,22,40-44,1955,4
SIM,1859,38,45-49,1897,2
SIM,1911,32,na,1943,3491
STAT,1880,57,na,1937,1997.5700443707308
STAT,1832,22,na,1854,1636.7356377173674
STAT,1856,15,25-29,1871,5.016608195072952
STAT,1906,17,50-100,1923,0.06739367220044797
SIM,1893,64,na,1957,2157
SIM,1839,42,30-34,1881,6
SIM,1871,38,25-29,1909,2
STAT,1846,11,na,1857,2124.051328083098
STAT,1852,25,35-39,1877,8.662653924077656
SIM,1920,27,25-29,1947,76
SIM,1903,27,25-29,1930,57
SIM,1822,41,na,1863,1515
SIM,1934,20,35-39,1954,13
SIM,1924,15,25-29,1939,60
STAT,1861,87,na,1948,138.20971276863006
STAT,1878,23,35-39,1901,5.721184351670212
STAT,1942,23,25-29,1965,91.45744621943138
SIM,1838,100,na,1938,1
SIM,1886,23,35-39,1909,7
STAT,1898,33,30-34,1931,22.233732887766976
STAT,1931,21,20-24,1952,136.65530335052011
SIM,1868,28,45-49,1896,4
STAT,1884,32,25-29,1916,9.5618779723517
STAT,1916,21,25-29,1937,91.71050186703619
SIM,1913,58,na,1971,3086
SIM,1947,24,30-34,1971,38
SIM,1889,68,na,1957,1778
STAT,1867,51,30-34,1918,0.005305176651437361
STAT,1817,41,25-29,1858,1.6902317327024334
STAT,1934,30,40-44,1964,5.053112362262863
SIM,1938,16,30-34,1954,13
STAT,1842,15,30-34,1857,1.4748300961808138
SIM,1864,15,25-29,1879,4
STAT,1865,40,na,1905,2004.0918348567423
STAT,1839,32,na,1871,1778.3174606023442
STAT,1867,33,30-34,1900,15.421423541265291
SIM,1826,34,na,1860,1634
STAT,1898,45,30-34,1943,0.07052427786146305
STAT,1847,27,20-24,1874,10.375066324237878
STAT,1856,50,50-100,1906,0.011335014888794834
SIM,1828,29,na,1857,1631
SIM,1938,19,na,1957,3354
STAT,1864,39,na,1903,1969.1567023850268
STAT,1919,43,15-19,1962,0.0015696678038324364
SIM,1944,19,na,1963,3685
STAT,1837,20,45-49,1857,0.5887281084620578
SIM,1840,29,35-39,1869,8
STAT,1858,34,50-100,1892,0.6736971018691936
SIM,1848,44,30-34,1892,5
SIM,1769,85,na,1854,46
STAT,1886,15,40-44,1901,0.18340816015675362
STAT,1933,32,50-100,1965,1.052597342219389
SIM,1923,36,45-49,1959,2
SIM,1847,33,na,1880,1765
STAT,1950,15,30-34,1965,13.623314488427448
SIM,1839,36,30-34,1875,5
SIM,1889,27,30-34,1916,37
SIM,1849,99,na,1948,2
STAT,1886,79,na,1965,988.2245193065577
STAT,1851,23,30-34,1874,15.486625321750834
STAT,1863,14,na,1877,2241.6051771806706
STAT,1910,45,20-24,1955,0.009783418147460789
SIM,1933,23,25-29,1956,4
STAT,1832,29,35-39,1861,7.739849766993386
STAT,1783,71,na,1854,470.99999999999994
STAT,1925,23,25-29,1948,104.14068214272542
STAT,1897,18,20-24,1915,22.339814934027718
STAT,1916,15,25-29,1931,8.72577051779162
STAT,1856,33,25-29,1889,7.591982972268775
STAT,1848,25,50-100,1873,0.5581534601160665
STAT,1915,36,45-49,1951,0.6536567118445368
SIM,1875,33,30-34,1908,28
SIM,1942,24,na,1966,3472
SIM,1864,76,na,1940,809
STAT,1868,30,50-100,1898,0.8330754272555358
STAT,1926,39,25-29,1965,1.1344800373019226
STAT,1863,38,25-29,1901,2.3790654603193118
SIM,1864,33,25-29,1897,10
STAT,1876,53,30-34,1929,0.005712046414432965
STAT,1832,41,20-24,1873,0.11935118744152234
STAT,1931,33,20-24,1964,3.0175337788681853
SIM,1915,25,30-34,1940,40
STAT,1915,18,45-49,1933,0.09850090522820198
STAT,1923,41,15-19,1964,0.001698225228462208
STAT,1883,7,na,1890,2412.2136023008256
STAT,1916,37,40-44,1953,1.4481684219185278
SIM,1849,43,30-34,1892,6
STAT,1941,26,45-49,1967,1.6889442439824585
STAT,1805,54,50-100,1859,0.042319448114500176
STAT,1823,54,25-29,1877,0.003906046402168218
STAT,1830,47,30-34,1877,0.07094705651859955
STAT,1838,47,na,1885,1578.6312737459266
SIM,1855,27,20-24,1882,7
SIM,1875,76,na,1951,818
STAT,1924,28,35-39,1952,16.457454110223356
SIM,1835,48,na,1883,1474
STAT,1834,88,na,1922,84.97255472477327
STAT,1842,21,30-34,1863,16.11440503118022
STAT,1915,53,na,1968,3422.489608710857
SIM,1784,93,na,1877,1
SIM,1919,18,25-29,1937,50
STAT,1853,40,45-49,1893,1.1211195731005665
SIM,1831,89,na,1920,55
STAT,1873,42,20-24,1915,0.15209964832562348
SIM,1857,34,25-29,1891,19
SIM,1892,32,25-29,1924,16
STAT,1893,44,35-39,1937,0.1486874542948216
STAT,1799,55,na,1854,1085.96574016
STAT,1867,36,35-39,1903,6.303880337166251
STAT,1917,30,35-39,1947,9.112344386020425
SIM,1875,36,35-39,1911,16
SIM,1832,34,na,1866,1670
STAT,1934,17,35-39,1951,5.361684132410607
STAT,1860,3,na,1863,2501.749787565571
SIM,1911,37,30-34,1948,5
SIM,1932,28,35-39,1960,22
STAT,1926,36,20-24,1962,0.30466013464502517
SIM,1940,20,na,1960,3346
STAT,1892,42,na,1934,2730.8460604160637
SIM,1843,74,na,1917,763
SIM,1942,17,35-39,1959,5
SIM,1886,21,45-49,1907,1
SIM,1924,37,40-44,1961,2
SIM,1793,67,na,1860,659
STAT,1863,53,20-24,1916,6.02939469054614E-4
SIM,1871,21,na,1892,2275
STAT,1852,14,na,1866,2173.7969672342256
STAT,1899,40,20-24,1939,0.014421453305181606
STAT,1806,51,20-24,1857,0.0021258012758500135
STAT,1843,47,40-44,1890,0.12293733744383331
STAT,1951,15,45-49,1966,0.5622865962938486
SIM,1929,42,na,1971,4647
STAT,1863,54,na,1917,1738.8503363634982
STAT,1876,38,50-100,1914,1.191423838518398
STAT,1926,40,25-29,1966,0.08340465655111284
STAT,1843,29,40-44,1872,2.6216441456808686
STAT,1857,47,35-39,1904,0.10377901952794523
STAT,1846,73,na,1919,837.4516845148332
STAT,1921,29,25-29,1950,68.81037163993948
STAT,1887,44,50-100,1931,1.1010719819930816
STAT,1939,18,30-34,1957,11.520933095023809
SIM,1947,18,30-34,1965,14
SIM,1850,21,30-34,1871,18
SIM,1902,31,45-49,1933,7
STAT,1867,13,na,1880,2367.9920877926784
STAT,1843,100,na,1943,0.7659295324616541
STAT,1849,34,25-29,1883,7.619706373433411
SIM,1923,17,na,1940,4015
STAT,1862,42,45-49,1904,1.2045644323890194
STAT,1896,17,50-100,1913,0.06116793856679076
SIM,1816,41,na,1857,1391
STAT,1827,49,50-100,1876,0.20952905873774674
STAT,1865,25,15-19,1890,0.3921209523627294
SIM,1938,19,35-39,1957,4
STAT,1879,20,45-49,1899,0.6926660192004117
SIM,1914,43,na,1957,3757
SIM,1851,29,40-44,1880,2
STAT,1821,59,na,1880,1130.641699446271
STAT,1841,53,30-34,1894,0.004007292918807749
STAT,1857,29,35-39,1886,7.295832872432068
STAT,1911,28,25-29,1939,60.41185980587773
STAT,1913,40,15-19,1953,0.0014304593938973208
STAT,1851,29,na,1880,1830.8325893342922
STAT,1944,6,na,1950,4034.140052784213
SIM,1812,42,na,1854,1389
STAT,1857,24,50-100,1881,0.3144870053840247
STAT,1917,23,50-100,1940,0.6585802065152543
SIM,1847,17,15-19,1864,4
SIM,1896,13,na,1909,3289
STAT,1852,22,30-34,1874,16.076903612215734
STAT,1932,22,50-100,1954,0.815616393976736
STAT,1849,87,na,1936,126.98949313442827
STAT,1861,45,35-39,1906,0.11092165794664312
SIM,1901,33,na,1934,3192
STAT,1901,29,45-49,1930,1.457646266602907
STAT,1848,24,30-34,1872,15.401180180252299
STAT,1799,58,na,1857,1023.3230175440473
STAT,1827,50,45-49,1877,0.012771058289207882
STAT,1851,50,20-24,1901,5.48904657572532E-4
STAT,1961,1,na,1962,4804.546118216159
STAT,1871,48,30-34,1919,0.08951829280287649
STAT,1919,49,50-100,1968,0.23039651376748346
STAT,1835,52,30-34,1887,0.003784977526575849
SIM,1860,22,30-34,1882,21
SIM,1898,35,25-29,1933,3
STAT,1929,17,30-34,1946,14.695983601855945
SIM,1934,3,na,1937,5106
SIM,1908,28,20-24,1936,18
SIM,1937,17,30-34,1954,15
STAT,1868,54,na,1922,1888.7011234321774
SIM,1896,5,na,1901,3351
STAT,1847,28,50-100,1875,0.5616694988960569
SIM,1952,16,15-19,1968,45
SIM,1888,16,25-29,1904,9
STAT,1903,37,30-34,1940,1.546098401300486
STAT,1878,20,30-34,1898,17.62205440593481
STAT,1908,22,40-44,1930,2.9194805543568494
STAT,1826,53,35-39,1879,0.007615374125478977
SIM,1940,22,50-100,1962,3
SIM,1951,20,35-39,1971,12
STAT,1872,47,30-34,1919,0.09135807229522298
STAT,1944,16,15-19,1960,46.15010408958791
STAT,1858,42,25-29,1900,0.4756563408505847
SIM,1896,22,45-49,1918,4
STAT,1913,38,30-34,1951,1.6903325921639392
STAT,1939,3,na,1942,3826.7218843197693
SIM,1865,29,35-39,1894,10
STAT,1907,25,30-34,1932,35.17609398799238
SIM,1811,97,na,1908,1
STAT,1893,26,35-39,1919,11.605049431204037
SIM,1872,62,na,1934,1732
SIM,1887,61,na,1948,1916
STAT,1817,85,na,1902,121.56853542248484
STAT,1922,26,50-100,1948,1.0677350548524158
STAT,1858,39,na,1897,1729.677021235246
STAT,1873,17,20-24,1890,17.000036395459112
SIM,1824,31,30-34,1855,21
SIM,1834,35,35-39,1869,15
SIM,1829,31,45-49,1860,1
SIM,1881,17,20-24,1898,15
STAT,1934,35,35-39,1969,3.1585895736831957
STAT,1943,20,35-39,1963,9.46996991520172
SIM,1891,22,30-34,1913,23
STAT,1899,22,20-24,1921,89.215042934969
STAT,1888,40,45-49,1928,1.6871192209024004
STAT,1837,22,35-39,1859,4.822368775085882
SIM,1845,22,35-39,1867,4
STAT,1902,43,na,1945,3069.5312292469084
SIM,1865,24,50-100,1889,1
STAT,1761,104,na,1865,0.019877857322634446
STAT,1883,37,35-39,1920,6.548585370789345
STAT,1814,42,15-19,1856,0.043012298961266265
STAT,1888,22,45-49,1910,0.7782179566517393
SIM,1921,38,30-34,1959,3
STAT,1826,35,35-39,1861,8.114690037442504
SIM,1888,34,25-29,1922,11
SIM,1820,49,na,1869,1300
SIM,1907,30,20-24,1937,2
STAT,1853,55,na,1908,1533.4325762766457
STAT,1912,38,50-100,1950,0.3851113857659201
STAT,1918,44,45-49,1962,0.16660447359311015
SIM,1891,37,35-39,1928,14
STAT,1905,54,na,1959,2930.3322652899637
SIM,1921,22,15-19,1943,7
STAT,1839,17,15-19,1856,5.176321516310149
SIM,1864,100,na,1964,8
SIM,1866,42,25-29,1908,3
STAT,1881,33,15-19,1914,0.12934813968602593
STAT,1883,22,30-34,1905,16.491807132151166
STAT,1866,34,30-34,1900,15.077024235976651
SIM,1829,70,na,1899,736
SIM,1837,31,40-44,1868,3
STAT,1871,80,na,1951,579.3423053780274
SIM,1848,36,50-100,1884,5
STAT,1875,24,25-29,1899,55.211233445864934
SIM,1806,82,na,1888,132
SIM,1933,25,45-49,1958,2
SIM,1807,67,na,1874,727
STAT,1884,48,40-44,1932,0.15781383088491135
SIM,1823,82,na,1905,251
STAT,1923,45,30-34,1968,0.09898973990293912
STAT,1945,23,na,1968,3779.7082296023423
STAT,1901,36,na,1937,3154.9720217787117
STAT,1822,52,20-24,1874,9.906371996379858E-4
SIM,1847,36,na,1883,1734
STAT,1852,40,30-34,1892,0.8822999223105779
SIM,1805,97,na,1902,2
STAT,1832,107,na,1939,0.002851541636110767
STAT,1870,20,25-29,1890,53.30668781808722
STAT,1914,42,50-100,1956,0.10995145996976564
STAT,1931,36,25-29,1967,1.2330153194984905
STAT,1908,24,50-100,1932,0.5677503541593857
STAT,1920,21,45-49,1941,1.1853240045970552
STAT,1934,20,na,1954,4651.2192023945545
STAT,1877,53,45-49,1930,0.01399833988955563
SIM,1938,29,45-49,1967,1
SIM,1865,21,na,1886,2047
STAT,1850,28,40-44,1878,2.463916014867046
STAT,1820,44,35-39,1864,3.0735897849715257
STAT,1875,79,na,1954,678.5082280724426
STAT,1875,46,40-44,1921,0.1666278573720471
STAT,1917,7,na,1924,4050.1714661350675
STAT,1908,45,35-39,1953,0.11174478471525276
STAT,1880,54,na,1934,2081.3899564400003
STAT,1844,49,15-19,1893,2.7494047433701183E-4
STAT,1918,26,15-19,1944,0.7121577032820167
STAT,1875,39,na,1914,2263.552158844553
SIM,1847,30,20-24,1877,1
SIM,1883,28,40-44,1911,2
SIM,1907,25,50-100,1932,4
SIM,1839,39,35-39,1878,11
SIM,1863,51,na,1914,1870
SIM,1871,35,20-24,1906,3
STAT,1831,46,30-34,1877,0.07209209469598465
SIM,1870,42,45-49,1912,1
STAT,1939,20,15-19,1959,5.053235528742995
SIM,1881,17,na,1898,2100
STAT,1908,27,35-39,1935,13.518446819092125
SIM,1874,34,30-34,1908,20
STAT,1861,38,50-100,1899,0.9583583901548991
STAT,1942,27,40-44,1969,4.621230363806291
STAT,1829,31,40-44,1860,4.345885203216556
STAT,1896,22,40-44,1918,2.601702452764079
SIM,1878,8,na,1886,2663
STAT,1927,38,25-29,1965,1.1554191871704027
SIM,1832,22,25-29,1854,49
STAT,1839,30,20-24,1869,2.264511007491209
STAT,1868,51,45-49,1919,0.013152494189868467
SIM,1862,43,50-100,1905,4
SIM,1916,27,35-39,1943,20
STAT,1820,34,na,1854,1453.5099610168884
STAT,1905,46,25-29,1951,0.04448146676858527
SIM,1881,76,na,1957,843
STAT,1887,64,na,1951,1836.5696194629386
STAT,1900,42,25-29,1942,0.058370775406055786
STAT,1834,45,40-44,1879,0.1267055925159012
STAT,1941,16,35-39,1957,4.08387867791868
STAT,1856,19,40-44,1875,0.15813810093567507
SIM,1920,43,na,1963,3806
SIM,1933,20,20-24,1953,122
STAT,1839,49,40-44,1888,0.1133632075746165
SIM,1911,2,na,1913,3861
STAT,1909,13,na,1922,3652.075155599695
SIM,1868,25,40-44,1893,6
SIM,1863,21,40-44,1884,4
SIM,1852,11,na,1863,2280
STAT,1809,59,na,1868,1072.5230503368955
STAT,1925,43,45-49,1968,0.19007400332209043
SIM,1874,22,25-29,1896,57
STAT,1776,106,na,1882,0.010804578357338706
STAT,1822,34,20-24,1856,5.9727601678084365
STAT,1822,63,na,1885,951.1397093401957
STAT,1921,19,15-19,1940,48.611993177124575
SIM,1911,33,45-49,1944,1
SIM,1906,28,50-100,1934,4
SIM,1903,24,20-24,1927,76
SIM,1947,20,15-19,1967,8
STAT,1842,36,35-39,1878,5.97011968065305
STAT,1865,20,20-24,1885,60.74586379416707
SIM,1825,89,na,1914,31
SIM,1850,36,35-39,1886,14
SIM,1902,58,na,1960,2775
STAT,1881,17,50-100,1898,0.04468764711166637
STAT,1938,29,40-44,1967,4.357500863279104
STAT,1821,41,45-49,1862,2.5753537028617832
SIM,1825,39,40-44,1864,5
SIM,1878,28,na,1906,2402
STAT,1847,21,45-49,1868,0.6335364815697876
STAT,1940,20,na,1960,3516.391698017361
STAT,1918,44,15-19,1962,0.001537296288720282
SIM,1860,77,na,1937,665
STAT,1803,93,na,1896,9.655411449196844
SIM,1812,82,na,1894,208
SIM,1830,34,20-24,1864,2
SIM,1799,55,na,1854,1057
STAT,1875,28,40-44,1903,2.8970749380286245
STAT,1811,60,na,1871,1031.7832153119969
STAT,1866,22,25-29,1888,50.26741453621782
STAT,1869,79,na,1948,639.2875643362357
STAT,1921,32,20-24,1953,2.5645058980560713
STAT,1827,44,na,1871,1450.180553774286
SIM,1821,56,na,1877,1164
STAT,1815,50,50-100,1865,0.036563299320482266
STAT,1855,21,40-44,1876,1.7366045716960739
STAT,1925,20,20-24,1945,126.50386115029048
SIM,1839,20,15-19,1859,2
STAT,1925,25,45-49,1950,1.9409749813775978
STAT,1817,39,40-44,1856,12.76688684355887
SIM,1859,21,na,1880,2062
SIM,1934,18,20-24,1952,178
STAT,1950,18,35-39,1968,4.686008057033561
SIM,1823,50,50-100,1873,1
STAT,1903,39,50-100,1942,0.35258073899507736
STAT,1886,18,45-49,1904,0.06502914592336308
SIM,1884,28,na,1912,2323
STAT,1898,67,na,1965,2258.564659150832
STAT,1903,33,45-49,1936,1.3401048012941064
SIM,1873,20,20-24,1893,62
SIM,1957,7,na,1964,4697
STAT,1862,69,na,1931,1182.601980621539
STAT,1916,2,na,1918,4085.667390573313
SIM,1924,19,40-44,1943,2
STAT,1844,30,25-29,1874,8.778956375604999
STAT,1889,25,50-100,1914,0.7511168089121232
STAT,1916,19,40-44,1935,0.2788328454827353
STAT,1919,47,30-34,1966,0.09134314631617689
STAT,1926,18,20-24,1944,156.6357221192153
SIM,1882,25,25-29,1907,40
SIM,1800,57,na,1857,1038
STAT,1842,18,35-39,1860,0.4988095627989413
STAT,1890,45,25-29,1935,0.06719282654431992
SIM,1827,27,45-49,1854,3
STAT,1922,35,na,1957,4051.4348073677993
STAT,1867,54,35-39,1921,0.007426248093528188
STAT,1886,33,35-39,1919,10.065413120933242
STAT,1889,43,30-34,1932,1.331140048264321
STAT,1857,40,15-19,1897,0.010388659482100868
STAT,1872,44,50-100,1916,0.9882086395286033
SIM,1855,7,na,1862,2378
STAT,1849,38,50-100,1887,0.8961793454729214
SIM,1834,94,na,1928,10
STAT,1883,50,50-100,1933,0.014184082645299013
STAT,1884,21,50-100,1905,0.38183787603065605
STAT,1913,29,35-39,1942,14.028055457298958
SIM,1939,18,40-44,1957,1
SIM,1838,84,na,1922,187
SIM,1893,34,50-100,1927,1
STAT,1941,23,40-44,1964,3.2812097351520455
SIM,1836,42,45-49,1878,4
SIM,1876,24,na,1900,2325
SIM,1857,16,30-34,1873,2
STAT,1878,46,20-24,1924,0.011834937199343058
STAT,1850,53,40-44,1903,0.007292490225427092
SIM,1940,16,25-29,1956,46
STAT,1852,50,40-44,1902,0.008113560458615396
STAT,1915,26,35-39,1941,14.514855871372218
SIM,1834,29,40-44,1863,2
STAT,1870,24,40-44,1894,1.916842904453451
STAT,1855,43,15-19,1898,0.009709976330790331
SIM,1797,97,na,1894,1
SIM,1919,15,20-24,1934,23
SIM,1827,42,35-39,1869,3
SIM,1949,21,25-29,1970,108
STAT,1798,70,na,1868,659.843081319067
SIM,1848,16,20-24,1864,14
STAT,1850,21,20-24,1871,58.650828238017226
STAT,1904,29,25-29,1933,56.90133061898136
SIM,1881,33,25-29,1914,12
SIM,1878,25,na,1903,2419
STAT,1819,42,35-39,1861,3.5549607666185525
SIM,1860,43,35-39,1903,3
STAT,1932,23,30-34,1955,35.51603551365651
SIM,1899,22,30-34,1921,30
STAT,1860,40,20-24,1900,0.12316056165452362
SIM,1865,86,na,1951,132
SIM,1894,33,35-39,1927,16
SIM,1878,32,40-44,1910,6
SIM,1879,22,45-49,1901,4
STAT,1853,27,45-49,1880,0.9538831251209922
SIM,1921,29,35-39,1950,22
STAT,1923,45,na,1968,4079.4735520135937
STAT,1929,39,40-44,1968,1.8118315930344047
STAT,1832,33,50-100,1865,0.7173502241466332
STAT,1828,42,45-49,1870,1.3202332369213898
STAT,1874,17,35-39,1891,0.5297959792883539
SIM,1903,65,na,1968,2538
SIM,1872,34,na,1906,2214
SIM,1864,39,na,1903,2088
STAT,1921,37,15-19,1958,0.020257931170308843
SIM,1783,77,na,1860,303
SIM,1778,90,na,1868,19
SIM,1909,44,45-49,1953,1
STAT,1895,33,45-49,1928,2.140711540534167
SIM,1829,48,na,1877,1365
SIM,1895,39,25-29,1934,3
SIM,1913,0,na,1913,3909
STAT,1929,36,na,1965,4567.330909426381
STAT,1810,44,40-44,1854,8.318649528176914
STAT,1901,20,35-39,1921,7.762218283809261
SIM,1872,27,20-24,1899,17
SIM,1873,81,na,1954,491
STAT,1918,0,na,1918,4632.270195234549
SIM,1832,24,15-19,1856,2
STAT,1841,36,na,1877,1744.5568444346393
STAT,1821,81,na,1902,292.0121201230602
STAT,1864,27,20-24,1891,9.904990601321531
STAT,1931,40,na,1971,4700.233899539049
SIM,1890,17,30-34,1907,4
STAT,1872,21,40-44,1893,1.9818376759650598
STAT,1899,17,40-44,1916,0.23678876319539788
SIM,1935,34,45-49,1969,4
STAT,1920,3,na,1923,4299.202947248453
SIM,1853,32,35-39,1885,12
STAT,1930,19,25-29,1949,52.6459737155198
SIM,1879,72,na,1951,1188
STAT,1949,16,35-39,1965,4.612014149935725
SIM,1935,16,15-19,1951,52
STAT,1892,20,15-19,1912,3.926053951448853
SIM,1855,37,30-34,1892,7
SIM,1924,33,na,1957,4107
STAT,1886,40,40-44,1926,2.267709971270525
STAT,1866,49,35-39,1915,0.11939248291175712
SIM,1915,31,25-29,1946,14
STAT,1929,31,45-49,1960,1.8894500959392793
STAT,1950,18,50-100,1968,0.4183934990024843
SIM,1861,27,45-49,1888,5
STAT,1839,42,20-24,1881,0.11160562880253463
STAT,1851,48,45-49,1899,0.17088814050812168
STAT,1932,16,25-29,1948,54.34294023563549
STAT,1838,53,25-29,1891,0.002377002326622952
STAT,1937,31,na,1968,3536.4013454192504
SIM,1899,15,25-29,1914,9
SIM,1915,50,na,1965,3425
STAT,1883,46,30-34,1929,0.0898783954857485
STAT,1915,16,na,1931,3827.786321027191
SIM,1844,45,50-100,1889,2
SIM,1911,60,na,1971,3086
STAT,1869,43,45-49,1912,1.358696508770751
SIM,1857,57,na,1914,1589
STAT,1875,54,25-29,1929,0.0033431248509983046
SIM,1894,40,40-44,1934,7
STAT,1833,31,30-34,1864,13.83742041284393
STAT,1849,16,30-34,1865,1.4225173575226955
STAT,1813,100,na,1913,0.4489988071715126
STAT,1848,27,35-39,1875,8.29855655926908
STAT,1843,53,35-39,1896,0.006111327025059665
SIM,1830,39,na,1869,1650
SIM,1889,17,20-24,1906,25
STAT,1927,16,15-19,1943,53.44467487975948
SIM,1785,78,na,1863,238
STAT,1864,40,20-24,1904,0.13544054403328284
SIM,1937,31,45-49,1968,1
STAT,1909,16,na,1925,3585.935472572749
STAT,1913,21,na,1934,3503.109503365245
SIM,1841,31,30-34,1872,26
STAT,1843,37,na,1880,1803.9042018821476
STAT,1927,35,50-100,1962,0.4940444956138181
STAT,1949,23,40-44,1972,3.7055424318188845
SIM,1923,26,35-39,1949,15
SIM,1940,23,30-34,1963,29
STAT,1766,100,na,1866,0.1936736076654481
STAT,1868,35,40-44,1903,3.985905500212943
STAT,1923,11,na,1934,4402.2779546245065
STAT,1940,18,40-44,1958,1.3410604840829508
SIM,1910,13,na,1923,3630
STAT,1852,73,na,1925,902.4216250980893
SIM,1849,21,20-24,1870,54
SIM,1876,35,40-44,1911,8
STAT,1822,69,na,1891,758.034504965516
SIM,1877,71,na,1948,1252
STAT,1831,27,25-29,1858,37.10707930880478
STAT,1852,19,40-44,1871,0.16609845743809729
STAT,1935,30,na,1965,4948.392962507209
SIM,1840,16,20-24,1856,13
STAT,1845,32,35-39,1877,8.48154431795992
SIM,1865,52,na,1917,1828
STAT,1847,37,30-34,1884,4.068671698998091
STAT,1812,79,na,1891,300.68400159912494
STAT,1898,27,50-100,1925,0.8180558559018586
STAT,1809,81,na,1890,227.16569358183
SIM,1932,21,15-19,1953,7
STAT,1881,51,45-49,1932,0.013300747048794024
STAT,1878,19,50-100,1897,0.04792280097840684
STAT,1878,1,na,1879,3377.3531202749596
STAT,1879,38,20-24,1917,0.7573855630191451
STAT,1889,18,25-29,1907,6.591631307230014
STAT,1890,49,40-44,1939,0.10921326433811623
SIM,1931,18,40-44,1949,1
STAT,1847,21,na,1868,1942.549897942231
SIM,1853,47,50-100,1900,1
STAT,1923,18,40-44,1941,1.5476598289955914
STAT,1830,64,na,1894,1038.410962818222
STAT,1870,46,20-24,1916,0.011139572095500216
SIM,1922,20,45-49,1942,1
STAT,1792,85,na,1877,79.88258353904789
STAT,1864,51,45-49,1915,0.012311613270863808
STAT,1905,26,na,1931,3269.155650089916
STAT,1861,56,na,1917,1600.0452802303537
SIM,1880,28,25-29,1908,49
STAT,1827,78,na,1905,433.6000567968518
STAT,1882,5,na,1887,2446.952124225395
STAT,1892,48,na,1940,2628.6227401602205
SIM,1905,33,20-24,1938,1
STAT,1854,38,15-19,1892,0.040236010312300445
STAT,1942,18,na,1960,3632.451552286447
STAT,1956,16,50-100,1972,0.46841439096457643
STAT,1776,103,na,1879,0.043902687827719424
SIM,1930,24,15-19,1954,6
STAT,1823,32,15-19,1855,0.38022754024254696
SIM,1882,22,20-24,1904,59
SIM,1905,60,na,1965,2752
STAT,1889,22,na,1911,2758.2899797001196
SIM,1888,49,na,1937,2389
SIM,1880,69,na,1949,1548
STAT,1839,35,15-19,1874,0.0456829457358847
STAT,1894,41,45-49,1935,1.8269768720227915
STAT,1879,51,20-24,1930,7.3213156587759E-4
STAT,1910,44,45-49,1954,0.14672215478194392
STAT,1885,32,na,1917,2245.946707839741
STAT,1909,20,35-39,1929,8.314414252487227
STAT,1818,44,40-44,1862,4.995374998977537
STAT,1878,84,na,1962,513.4364803944885
STAT,1950,21,25-29,1971,103.56089913444386
STAT,1919,46,na,1965,3773.7080094275602
STAT,1963,2,na,1965,4721.63530174955
SIM,1874,69,na,1943,1345
SIM,1835,34,40-44,1869,5
SIM,1901,70,na,1971,2173
SIM,1823,51,na,1874,1244
STAT,1867,36,50-100,1903,1.0942498796479116
STAT,1848,42,30-34,1890,0.8272283416190127
STAT,1927,34,45-49,1961,1.8264724741811929
STAT,1872,28,25-29,1900,39.96911652061436
SIM,1859,52,na,1911,1787
STAT,1890,23,15-19,1913,3.798687545293108
STAT,1915,31,15-19,1946,0.12413222150562184
STAT,1840,32,15-19,1872,0.12079456266050073
STAT,1858,21,20-24,1879,59.06277232564601
STAT,1818,47,50-100,1865,0.5249233340338627
SIM,1779,78,na,1857,248
SIM,1858,24,35-39,1882,10
STAT,1851,51,35-39,1902,0.006343370701292699
SIM,1813,92,na,1905,20
SIM,1877,40,40-44,1917,4
SIM,1873,1,na,1874,3177
SIM,1897,18,25-29,1915,8
STAT,1929,30,na,1959,4543.7516958921215
SIM,1896,28,20-24,1924,16
STAT,1907,31,25-29,1938,8.193462514464864
SIM,1868,43,35-39,1911,4
STAT,1837,45,20-24,1882,0.00806769051539263
STAT,1881,70,na,1951,1279.8056862215276
SIM,1866,21,20-24,1887,63
STAT,1815,81,na,1896,231.4478852606427
SIM,1886,54,na,1940,2020
SIM,1840,94,na,1934,8
STAT,1820,48,15-19,1868,6.499340491401596E-4
SIM,1932,31,25-29,1963,13
SIM,1800,94,na,1894,3
STAT,1901,29,50-100,1930,0.8398114023254535
STAT,1839,45,25-29,1884,0.04014644403902388
STAT,1914,28,40-44,1942,4.42252371050161
STAT,1811,52,45-49,1863,0.04608170470881649
STAT,1921,37,50-100,1958,0.4429119846070158
SIM,1799,92,na,1891,7
SIM,1856,17,25-29,1873,7
SIM,1875,2,na,1877,3039
STAT,1823,103,na,1926,0.0755230713676589
SIM,1877,19,20-24,1896,15
STAT,1888,28,20-24,1916,13.046333465156776
STAT,1809,87,na,1896,74.01046027703008
STAT,1824,31,20-24,1855,7.319077080088283
SIM,1917,20,35-39,1937,18
STAT,1835,36,na,1871,1669.2820213471784
STAT,1890,41,45-49,1931,1.7364816121488174
STAT,1812,49,50-100,1861,0.7822530427795513
STAT,1840,88,na,1928,95.60658595685238
STAT,1870,39,15-19,1909,0.05145740339311058
STAT,1890,30,20-24,1920,3.1472018000591473
STAT,1911,26,na,1937,3462.3195222347276
STAT,1827,34,40-44,1861,4.634512214775704
STAT,1891,15,15-19,1906,6.971551178622085
STAT,1879,44,15-19,1923,0.01345220476044447
SIM,1811,66,na,1877,795
STAT,1869,19,20-24,1888,16.243064962625308
STAT,1853,21,na,1874,1887.064081098965
SIM,1898,17,30-34,1915,2
STAT,1903,39,20-24,1942,0.22137085912221963
SIM,1791,72,na,1863,490
SIM,1905,28,40-44,1933,7
STAT,1824,64,na,1888,932.2899887583742
STAT,1803,96,na,1899,2.836838138758789
STAT,1863,35,20-24,1898,0.6462027162121011
STAT,1928,15,20-24,1943,162.1467984677988
STAT,1863,28,15-19,1891,0.3754345540785417
STAT,1863,19,50-100,1882,0.0417494018787659
STAT,1894,25,40-44,1919,3.664966736944657
SIM,1912,48,na,1960,3180
SIM,1916,9,na,1925,3888
SIM,1877,33,35-39,1910,14
STAT,1925,46,na,1971,4216.520199098322
SIM,1922,28,40-44,1950,6
STAT,1891,22,20-24,1913,80.57984256921641
STAT,1924,31,25-29,1955,10.193673111219601
STAT,1889,49,50-100,1938,0.15820044446318265
SIM,1859,45,50-100,1904,2
STAT,1848,17,25-29,1865,5.060794557577185
STAT,1845,42,45-49,1887,1.0735169188585376
STAT,1840,50,45-49,1890,0.010251924954981048
STAT,1854,32,45-49,1886,1.2859292960004578
SIM,1776,95,na,1871,2
SIM,1920,20,40-44,1940,4
SIM,1785,72,na,1857,404
SIM,1912,29,25-29,1941,63
STAT,1838,37,20-24,1875,0.634396556759723
STAT,1933,21,25-29,1954,116.09758240375879
STAT,1916,29,50-100,1945,0.9652579567248608
SIM,1854,43,na,1897,1804
STAT,1858,16,40-44,1874,0.15939174745043944
STAT,1830,29,30-34,1859,22.093827908239753
STAT,1834,53,25-29,1887,0.002203978463928742
STAT,1839,52,30-34,1891,0.003947864961487931
STAT,1902,47,20-24,1949,0.008982008596530946
STAT,1896,44,15-19,1940,0.0011811594515687314
STAT,1923,23,20-24,1946,121.85724151124047
STAT,1900,15,35-39,1915,0.7224736505244937
SIM,1931,23,20-24,1954,122
STAT,1884,51,30-34,1935,0.005583529237836306
STAT,1844,34,40-44,1878,3.565784965758193
STAT,1810,44,na,1854,1349.6994261249984
STAT,1936,18,na,1954,3319.733139049734
SIM,1871,86,na,1957,250
STAT,1892,49,45-49,1941,0.15419799464292339
SIM,1899,25,35-39,1924,19
SIM,1941,21,25-29,1962,88
SIM,1892,54,na,1946,2533
SIM,1832,31,20-24,1863,2
SIM,1856,22,50-100,1878,1
SIM,1909,32,50-100,1941,4
STAT,1912,20,40-44,1932,3.0615790958299645
STAT,1869,33,35-39,1902,9.22148220078641
STAT,1914,20,45-49,1934,1.048118945463862
SIM,1884,36,45-49,1920,3
SIM,1819,42,45-49,1861,1
STAT,1883,30,15-19,1913,0.13291041537762047
STAT,1859,18,na,1877,1997.0205783098745
SIM,1909,41,40-44,1950,1
STAT,1915,23,30-34,1938,27.977035088591563
STAT,1878,49,25-29,1927,0.05546412161241608
SIM,1853,42,45-49,1895,3
STAT,1938,13,na,1951,3686.226391513417
STAT,1836,110,na,1946,1.745044703161113E-4
STAT,1878,33,45-49,1911,1.7077291798467864
STAT,1941,30,na,1971,3755.185505122405
SIM,1921,26,30-34,1947,52
SIM,1883,71,na,1954,1180
SIM,1886,33,45-49,1919,1
STAT,1843,16,50-100,1859,0.04543668133714958
STAT,1892,30,25-29,1922,12.21446916990813
STAT,1884,44,25-29,1928,0.5913872548478896
STAT,1898,33,na,1931,3038.8007602359207
STAT,1857,17,35-39,1874,0.4803064274758768
STAT,1836,42,35-39,1878,1.3603443411202487
STAT,1897,57,na,1954,2538.9986854902468
STAT,1920,42,50-100,1962,0.12257929868756076
SIM,1797,100,na,1897,1
STAT,1939,19,45-49,1958,0.47200403389084533
SIM,1841,42,na,1883,1661
STAT,1831,24,20-24,1855,71.51770884780623
STAT,1866,16,30-34,1882,1.4333609842854738
STAT,1836,89,na,1925,66.340146536542
STAT,1913,26,30-34,1939,37.00069155385888
SIM,1845,32,na,1877,1807
SIM,1900,23,na,1923,3034
STAT,1823,50,45-49,1873,0.01733041892072799
STAT,1849,26,40-44,1875,2.5780094765011534
STAT,1858,19,45-49,1877,0.05592564768840947
STAT,1897,36,15-19,1933,0.0712880057850481
STAT,1900,22,40-44,1922,2.731018038924808
SIM,1810,50,na,1860,1276
SIM,1870,30,45-49,1900,3
SIM,1863,57,na,1920,1745
STAT,1864,43,25-29,1907,0.5382635075554573
SIM,1928,41,45-49,1969,1
STAT,1876,36,45-49,1912,1.9535160128491456
STAT,1894,43,na,1937,2798.006013964821
SIM,1912,19,15-19,1931,8
STAT,1929,29,30-34,1958,46.28282953484559
SIM,1881,30,20-24,1911,5
STAT,1836,27,45-49,1863,0.9072535043975374
STAT,1852,53,45-49,1905,0.010849094521751932
SIM,1867,16,na,1883,2256
SIM,1860,36,50-100,1896,1
STAT,1921,16,na,1937,3973.610202879261
STAT,1940,23,20-24,1963,106.96247962154233
STAT,1938,18,50-100,1956,0.34898341579601305
STAT,1852,36,50-100,1888,0.9476557326035376
STAT,1932,26,35-39,1958,18.58581514958475
SIM,1828,60,na,1888,1042
SIM,1807,92,na,1899,18
SIM,1860,40,30-34,1900,1
STAT,1766,99,na,1865,0.3163670940988731
SIM,1844,42,35-39,1886,4
STAT,1818,95,na,1913,6.410091746827146
STAT,1811,91,na,1902,25.10004743074551
SIM,1940,26,35-39,1966,13
STAT,1791,66,na,1857,715.3357216832001
STAT,1904,19,15-19,1923,7.997148246775545
SIM,1937,29,30-34,1966,45
STAT,1817,103,na,1920,0.06364363228301251
STAT,1873,30,20-24,1903,2.612820286848219
STAT,1817,53,25-29,1870,0.0074403306431737835
STAT,1860,50,30-34,1910,0.0046358021090823305
STAT,1886,43,45-49,1929,1.483041594504301
SIM,1882,24,na,1906,2146
STAT,1872,99,na,1971,13.303190934851301
STAT,1853,92,na,1945,30.887531522705565
STAT,1883,49,35-39,1932,0.12691499994432984
STAT,1887,32,40-44,1919,4.581725903815445
STAT,1822,37,25-29,1859,5.221367107110115
STAT,1862,17,45-49,1879,0.060287877872858844
STAT,1920,39,20-24,1959,0.2720926971003074
SIM,1895,36,20-24,1931,1
STAT,1844,19,na,1863,2024.3341527227967
STAT,1866,40,25-29,1906,0.5649553922057885
STAT,1859,46,na,1905,1701.0260384353717
SIM,1836,32,35-39,1868,4
STAT,1809,45,45-49,1854,0.8933313246721386
STAT,1810,47,45-49,1857,0.8390959640288342
STAT,1802,52,35-39,1854,0.024538453476309424
SIM,1865,17,35-39,1882,2
SIM,1878,39,25-29,1917,2
SIM,1838,59,na,1897,1229
STAT,1858,54,25-29,1912,0.0025546246907974944
STAT,1923,33,30-34,1956,17.05371856265976
STAT,1895,23,35-39,1918,7.171749192833207
STAT,1862,32,35-39,1894,8.160772918945016
SIM,1904,13,na,1917,3449
STAT,1831,77,na,1908,527.162557736238
SIM,1822,32,50-100,1854,4
STAT,1829,53,50-100,1882,0.01050290161644527
SIM,1907,27,na,1934,3348
STAT,1843,50,30-34,1893,0.004356212653411281
STAT,1861,50,na,1911,1713.3830172691105
SIM,1868,40,30-34,1908,1
STAT,1912,35,50-100,1947,0.3907067406956643
STAT,1857,21,50-100,1878,0.3531423175304642
STAT,1887,36,20-24,1923,0.8183189170249046
STAT,1906,36,35-39,1942,2.110150876687104
STAT,1908,15,35-39,1923,0.7723302239965677
SIM,1898,23,25-29,1921,74
SIM,1923,23,30-34,1946,33
SIM,1895,32,40-44,1927,5
SIM,1899,2,na,1901,3413
SIM,1817,51,na,1868,1322
STAT,1870,27,45-49,1897,1.0277737267927192
SIM,1863,26,na,1889,2046
SIM,1860,15,na,1875,2266
STAT,1873,27,30-34,1900,24.147133359727338
SIM,1881,27,30-34,1908,20
SIM,1915,22,na,1937,3509
STAT,1850,24,25-29,1874,47.67930694999873
STAT,1923,48,35-39,1971,0.14210017105615586
SIM,1935,31,40-44,1966,6
STAT,1903,49,30-34,1952,0.07185629060013611
STAT,1933,31,35-39,1964,11.640884868622237
SIM,1908,20,25-29,1928,88
STAT,1837,38,15-19,1875,0.0427138462949175
STAT,1885,60,na,1945,1794.998143904265
STAT,1838,50,20-24,1888,5.208373806204864E-4
SIM,1807,98,na,1905,2
STAT,1819,52,45-49,1871,0.02478586718446411
STAT,1903,45,15-19,1948,3.0628172981656123E-4
SIM,1844,84,na,1928,197
STAT,1924,21,15-19,1945,5.9523710132147665
SIM,1828,41,40-44,1869,4
SIM,1834,33,50-100,1867,4
STAT,1847,92,na,1939,30.645168090240166
STAT,1914,18,30-34,1932,2.3752390363206395
SIM,1887,40,35-39,1927,4
SIM,1875,21,30-34,1896,28
SIM,1852,37,45-49,1889,2
STAT,1856,35,15-19,1891,0.04194301313767829
STAT,1901,41,30-34,1942,0.10604286052135375
SIM,1854,31,40-44,1885,3
STAT,1867,75,na,1942,913.1333580445146
STAT,1845,63,na,1908,1256.8306286083791
SIM,1885,41,45-49,1926,3
SIM,1877,9,na,1886,2573
STAT,1835,35,45-49,1870,1.5699774628761793
STAT,1858,24,25-29,1882,43.69291333749809
STAT,1830,31,45-49,1861,1.4827939087228603
SIM,1847,67,na,1914,1101
SIM,1818,37,45-49,1855,2
STAT,1888,38,30-34,1926,5.918361529287809
STAT,1950,13,na,1963,4387.382219230095
SIM,1877,43,50-100,1920,3
SIM,1924,30,20-24,1954,2
STAT,1877,28,45-49,1905,1.0846176608669647
SIM,1885,28,45-49,1913,1
SIM,1910,43,40-44,1953,2
SIM,1837,38,25-29,1875,4
STAT,1898,18,35-39,1916,0.6998655665304424
STAT,1927,31,40-44,1958,4.550764361752567
SIM,1862,22,35-39,1884,7
STAT,1850,19,na,1869,1951.5284808559263
SIM,1813,61,na,1874,957
SIM,1896,38,30-34,1934,7
SIM,1832,34,25-29,1866,10
STAT,1912,47,15-19,1959,3.3436343206281463E-4
SIM,1876,30,50-100,1906,5
STAT,1849,22,na,1871,1863.2880520034646
STAT,1882,23,25-29,1905,52.460427350910486
SIM,1890,53,na,1943,2498
SIM,1931,33,30-34,1964,22
STAT,1867,21,30-34,1888,15.97932255049512
SIM,1914,2,na,1916,4266
STAT,1905,34,25-29,1939,7.960153515461069
SIM,1886,42,50-100,1928,1
STAT,1879,40,35-39,1919,1.806097746507823
SIM,1922,18,30-34,1940,16
SIM,1948,16,25-29,1964,56
SIM,1854,15,na,1869,2179
STAT,1842,48,35-39,1890,0.09844308138073928
STAT,1899,15,15-19,1914,7.718645481217538
STAT,1910,48,25-29,1958,0.046610479636728167
STAT,1844,37,45-49,1881,1.4788296526538893
STAT,1824,34,25-29,1858,18.399610600122067
STAT,1854,22,35-39,1876,4.937314533316556
SIM,1923,33,40-44,1956,3
STAT,1854,46,50-100,1900,0.17735726635620258
SIM,1913,34,25-29,1947,13
STAT,1849,22,25-29,1871,49.887132681645674
STAT,1878,42,50-100,1920,1.0376911334451289
STAT,1874,32,30-34,1906,16.85790767766555
STAT,1925,45,35-39,1970,0.1483043118108314
STAT,1818,47,45-49,1865,0.5044051589391167
STAT,1907,47,40-44,1954,0.13336449494217184
SIM,1822,75,na,1897,539
STAT,1837,37,na,1874,1646.1092226057513
STAT,1891,25,25-29,1916,49.798911416198386
STAT,1839,63,na,1902,1189.7242983077188
STAT,1874,23,na,1897,2276.4728979103675
SIM,1849,30,50-100,1879,4
STAT,1816,69,na,1885,784.2812646590362
STAT,1916,30,20-24,1946,2.398026213377293
SIM,1850,84,na,1934,221
SIM,1801,76,na,1877,366
SIM,1879,44,25-29,1923,3
SIM,1839,27,35-39,1866,10
STAT,1841,46,25-29,1887,0.040098547634291874
STAT,1879,54,25-29,1933,0.0034013182923963363
STAT,1870,49,25-29,1919,0.05220531135977607
STAT,1918,6,na,1924,4121.1710093024685
STAT,1932,28,na,1960,4633.1801549481515
STAT,1840,17,25-29,1857,5.109519080404954
STAT,1882,58,na,1940,1817.9066240019154
STAT,1888,74,na,1962,1453.3086953546313
SIM,1869,42,na,1911,2108
SIM,1919,12,na,1931,4126
STAT,1851,45,40-44,1896,0.1267953914127653
STAT,1823,31,50-100,1854,2.8661658646423778
STAT,1865,29,50-100,1894,0.5452158157095508
SIM,1882,32,30-34,1914,20
STAT,1910,34,35-39,1944,8.25031304917987
STAT,1909,18,20-24,1927,25.04407159080476
STAT,1931,24,25-29,1955,112.46935928063914
STAT,1878,39,15-19,1917,0.05466952701394397
STAT,1885,38,45-49,1923,1.8669224481605233
STAT,1915,33,40-44,1948,3.748904535404084
STAT,1865,35,25-29,1900,2.4951053320421672
SIM,1857,22,25-29,1879,61
STAT,1939,32,15-19,1971,0.12385009683919362
STAT,1832,26,30-34,1858,20.960778245815728
STAT,1873,75,na,1948,987.1597580944032
STAT,1823,42,25-29,1865,0.8319511141062927
STAT,1944,13,na,1957,3992.720005405399
STAT,1928,37,30-34,1965,2.176175745316457
STAT,1910,30,50-100,1940,0.7589442875915318
SIM,1895,65,na,1960,2227
STAT,1839,19,40-44,1858,0.15766062584858928
SIM,1914,26,25-29,1940,72
SIM,1836,18,20-24,1854,14
STAT,1889,28,na,1917,2773.5379035071846
SIM,1873,35,25-29,1908,4
STAT,1876,89,na,1965,242.83649886022283
STAT,1771,83,na,1854,86.0
SIM,1916,38,na,1954,3546
SIM,1844,27,45-49,1871,2
STAT,1866,46,30-34,1912,0.08455111532817522
STAT,1826,29,40-44,1855,5.645547452651488
SIM,1947,19,45-49,1966,2
SIM,1853,67,na,1920,1239
STAT,1912,23,45-49,1935,1.0152970241109003
SIM,1832,99,na,1931,1
SIM,1866,24,25-29,1890,52
SIM,1795,62,na,1857,852
STAT,1907,41,35-39,1948,0.1752587285154217
SIM,1897,28,50-100,1925,3
SIM,1840,26,30-34,1866,26
SIM,1816,75,na,1891,395
STAT,1828,54,na,1882,1258.9028778725478
STAT,1847,47,40-44,1894,0.12537976071680923
STAT,1890,33,25-29,1923,11.78056004601877
SIM,1814,46,na,1860,1332
STAT,1892,46,40-44,1938,0.11456857677364572
SIM,1808,46,na,1854,1297
SIM,1870,39,na,1909,2157
STAT,1834,54,na,1888,1313.4170356570069
SIM,1830,33,na,1863,1735
SIM,1900,20,25-29,1920,67
STAT,1898,41,15-19,1939,0.0012319222082114855
STAT,1871,32,45-49,1903,1.633165255945166
SIM,1843,35,45-49,1878,1
STAT,1837,48,25-29,1885,0.03726475481898776
STAT,1846,31,40-44,1877,3.651154518368799
STAT,1882,47,25-29,1929,0.0527019535564215
SIM,1874,97,na,1971,20
SIM,1920,23,45-49,1943,1
SIM,1851,32,na,1883,1817
STAT,1829,38,25-29,1867,2.523417833947903
STAT,1942,20,20-24,1962,110.2092110366342
SIM,1890,23,25-29,1913,70
STAT,1902,43,40-44,1945,0.2067259724359913
STAT,1844,19,15-19,1863,5.233637896111385
STAT,1894,33,50-100,1927,1.1087414441937866
STAT,1943,7,na,1950,3969.7811910935707
SIM,1849,31,30-34,1880,18
SIM,1834,60,na,1894,1185
STAT,1835,32,50-100,1867,0.7278177776356218
SIM,1894,30,30-34,1924,32
SIM,1777,77,na,1854,264
STAT,1886,30,30-34,1916,17.567046047380508
SIM,1823,32,25-29,1855,7
STAT,1865,54,30-34,1919,0.004969415511392349
STAT,1896,29,25-29,1925,52.43721000865364
STAT,1921,44,20-24,1965,0.01873022559874536
STAT,1862,104,na,1966,0.3365199800941803
STAT,1928,18,25-29,1946,51.453574570746134
STAT,1845,44,50-100,1889,0.7386064529194043
SIM,1880,25,20-24,1905,10
SIM,1950,20,20-24,1970,109
STAT,1906,26,25-29,1932,58.38991128113608
STAT,1865,32,20-24,1897,2.3204268156079615
STAT,1874,28,50-100,1902,0.6154690676387932
SIM,1856,78,na,1934,539
STAT,1860,41,35-39,1901,1.3965604382968262
STAT,1816,110,na,1926,1.287726078582604E-4
STAT,1872,25,20-24,1897,11.19925660154011
SIM,1857,38,50-100,1895,1
SIM,1851,37,50-100,1888,4
STAT,1836,80,na,1916,390.63677116550275
STAT,1823,36,30-34,1859,9.03179432705647
STAT,1914,37,na,1951,3547.957854562409
SIM,1880,44,50-100,1924,1
SIM,1831,29,25-29,1860,41
STAT,1888,34,15-19,1922,0.15756772862237228
STAT,1920,49,30-34,1969,0.0925516466188536
STAT,1836,40,45-49,1876,1.1535079252285252
STAT,1836,24,40-44,1860,1.711811376791383
STAT,1832,36,40-44,1868,3.392249212926326
SIM,1936,18,25-29,1954,50
SIM,1913,27,na,1940,3400
SIM,1838,53,na,1891,1337
SIM,1873,42,30-34,1915,1
STAT,1919,18,15-19,1937,47.254377702537816
SIM,1914,8,na,1922,4189
STAT,1884,41,20-24,1925,0.14892910679934873
SIM,1818,39,na,1857,1396
STAT,1819,49,na,1868,1312.135212580378
STAT,1919,8,na,1927,4163.755466806706
STAT,1882,89,na,1971,294.3664721158971
STAT,1905,38,40-44,1943,1.2834632786743334
SIM,1862,72,na,1934,1050
SIM,1877,30,30-34,1907,17
SIM,1829,76,na,1905,475
STAT,1863,82,na,1945,387.4563879929013
STAT,1934,15,45-49,1949,0.6412612262893889
STAT,1874,54,40-44,1928,0.009885252863229329
SIM,1904,26,30-34,1930,34
STAT,1878,42,40-44,1920,2.2093326006214444
STAT,1865,42,30-34,1907,0.9857116873241306
SIM,1939,32,na,1971,3566
STAT,1896,72,na,1968,1910.914234169922
STAT,1832,90,na,1922,47.67162081095896
STAT,1862,38,na,1900,1889.1187979856252
STAT,1880,53,20-24,1933,7.217137260105158E-4
SIM,1927,18,15-19,1945,45
SIM,1794,83,na,1877,114
STAT,1875,19,45-49,1894,0.06305798443166426
SIM,1868,29,20-24,1897,7
STAT,1810,52,25-29,1862,0.012021917243156263
STAT,1874,47,35-39,1921,0.13454422452287326
SIM,1844,40,45-49,1884,8
SIM,1831,36,30-34,1867,6
STAT,1852,42,na,1894,1753.8541149190935
STAT,1929,19,50-100,1948,0.4492982299996411
SIM,1940,29,na,1969,3451
STAT,1825,43,na,1868,1525.7930646626103
STAT,1888,43,na,1931,2560.7342728501885
STAT,1911,37,20-24,1948,0.24047681820623773
STAT,1924,41,35-39,1965,0.22661981155308242
STAT,1846,28,15-19,1874,0.38421304940759926
STAT,1940,26,25-29,1966,63.42874029423448
STAT,1947,24,20-24,1971,118.64632189429474
STAT,1919,25,20-24,1944,18.758794735075963
SIM,1921,22,na,1943,3794
STAT,1869,70,na,1939,1283.0226772915455
STAT,1900,37,45-49,1937,0.5639159950345839
STAT,1881,27,20-24,1908,10.700772645339633
SIM,1849,90,na,1939,40
SIM,1831,80,na,1911,324
STAT,1832,48,40-44,1880,0.12115515902740687
SIM,1876,92,na,1968,120
SIM,1949,18,35-39,1967,5
STAT,1915,41,25-29,1956,0.06800843065113146
STAT,1866,19,35-39,1885,0.48478408987989724
STAT,1806,50,45-49,1856,0.042655628912059027
STAT,1813,58,na,1871,1072.1600118625024
SIM,1913,30,45-49,1943,1
STAT,1873,41,45-49,1914,1.4416344016694658
STAT,1890,27,30-34,1917,29.08577446314694
STAT,1959,12,na,1971,4853.027459382665
STAT,1865,47,25-29,1912,0.04921590026908647
SIM,1842,58,na,1900,1352
SIM,1840,36,40-44,1876,5
SIM,1853,9,na,1862,2334
SIM,1884,26,35-39,1910,15
STAT,1883,40,25-29,1923,0.6005513230120262
STAT,1759,110,na,1869,8.031279335252122E-4
STAT,1859,23,30-34,1882,13.83312450546636
SIM,1881,41,45-49,1922,3
STAT,1861,25,45-49,1886,0.8900704631031068
STAT,1888,48,40-44,1936,0.1064200930944175
SIM,1829,79,na,1908,333
STAT,1931,28,40-44,1959,5.682197009039178
STAT,1858,51,20-24,1909,5.498813149255207E-4
SIM,1887,30,na,1917,2517
STAT,1847,40,20-24,1887,0.12055432543392655
STAT,1907,52,na,1959,3039.5052473626724
STAT,1847,45,15-19,1892,2.9724942917705324E-4
STAT,1860,53,35-39,1913,0.006503562834536546
STAT,1891,44,30-34,1935,1.32616907070017
STAT,1819,41,50-100,1860,2.146577983646387
SIM,1886,42,40-44,1928,6
SIM,1794,86,na,1880,59
SIM,1845,41,40-44,1886,3
SIM,1927,25,20-24,1952,26
STAT,1910,31,30-34,1941,14.405536817341206
SIM,1849,18,30-34,1867,4
STAT,1824,53,30-34,1877,0.006602568980310821
SIM,1807,61,na,1868,911
STAT,1865,52,50-100,1917,0.01289585859759773
SIM,1848,29,35-39,1877,11
SIM,1918,31,40-44,1949,4
SIM,1850,53,na,1903,1561
STAT,1817,50,20-24,1867,0.0016459011915035723
STAT,1852,45,na,1897,1726.4084597072135
STAT,1836,45,50-100,1881,0.16652118730053964
STAT,1888,41,20-24,1929,0.1780389115890777
SIM,1832,41,30-34,1873,3
SIM,1845,38,na,1883,1703
SIM,1958,6,na,1964,4848
STAT,1878,30,40-44,1908,4.2992371032613805
STAT,1897,46,25-29,1943,0.04116642528359412
SIM,1874,3,na,1877,2793
SIM,1900,30,35-39,1930,16
STAT,1891,32,30-34,1923,20.41576497372351
STAT,1847,33,15-19,1880,0.12175649592312136
STAT,1941,6,na,1947,3877.2763576792768
STAT,1890,42,50-100,1932,1.2187281653390167
SIM,1817,48,50-100,1865,1
STAT,1849,56,na,1905,1470.1494928126738
SIM,1887,33,na,1920,2477
SIM,1914,43,40-44,1957,1
STAT,1877,41,45-49,1918,1.4738204265520327
STAT,1824,95,na,1919,7.019215721682123
SIM,1925,12,na,1937,4425
SIM,1913,24,15-19,1937,4
STAT,1923,36,35-39,1959,2.6502151114094716
STAT,1942,30,30-34,1972,15.871827089403
SIM,1875,24,35-39,1899,5
SIM,1849,93,na,1942,12
STAT,1841,53,50-100,1894,0.010167263825586479
SIM,1834,23,35-39,1857,6
STAT,1870,30,na,1900,2226.691074295033
SIM,1931,36,35-39,1967,5
STAT,1885,34,50-100,1919,0.8549682946161521
SIM,1867,36,45-49,1903,2
STAT,1840,57,na,1897,1399.5406040118853
STAT,1865,18,na,1883,2221.0215532571783
STAT,1905,24,15-19,1929,4.475486713420526
SIM,1898,27,40-44,1925,4
STAT,1840,26,20-24,1866,10.26044070521272
STAT,1882,20,20-24,1902,63.725784015791184
STAT,1915,48,45-49,1963,0.2062970930874294
SIM,1885,25,40-44,1910,3
STAT,1850,52,50-100,1902,0.01057576907906923
SIM,1872,37,30-34,1909,8
SIM,1914,36,35-39,1950,8
STAT,1827,46,50-100,1873,0.21805863370960413
SIM,1805,66,na,1871,783
STAT,1926,25,na,1951,4271.669965618128
STAT,1937,23,15-19,1960,4.89475178445863
STAT,1863,34,45-49,1897,1.4356956359975372
STAT,1882,25,15-19,1907,0.41989560501651135
STAT,1801,54,40-44,1855,0.03649233484475005
STAT,1856,49,40-44,1905,0.12402508102333144
STAT,1839,23,50-100,1862,0.3468550242626061
SIM,1830,30,40-44,1860,3
SIM,1826,65,na,1891,904
SIM,1880,21,40-44,1901,3
STAT,1850,43,30-34,1893,0.8035223983076162
STAT,1837,106,na,1943,0.00766453530020507
STAT,1906,48,35-39,1954,0.1072691382496344
STAT,1856,53,50-100,1909,0.010995016063229134
SIM,1881,37,40-44,1918,5
STAT,1841,41,30-34,1882,0.827908175880251
STAT,1863,85,na,1948,227.64495454055023
STAT,1903,15,50-100,1918,0.06615263779463573
SIM,1929,34,20-24,1963,4
STAT,1921,19,na,1940,3942.6174096137306
STAT,1870,64,na,1934,1609.145348652368
STAT,1883,52,25-29,1935,0.003261975134764381
STAT,1815,41,20-24,1856,0.4699497431634172
SIM,1869,11,na,1880,2430
SIM,1859,41,35-39,1900,5
SIM,1944,24,45-49,1968,1
STAT,1873,49,40-44,1922,0.16073746332953653
STAT,1947,24,na,1971,3896.5208758227645
STAT,1864,37,30-34,1901,4.4998198886792835
STAT,1896,26,20-24,1922,14.69735977386844
SIM,1838,50,na,1888,1400
STAT,1906,46,45-49,1952,0.18364603338812935
STAT,1929,35,25-29,1964,1.1962997151071437
STAT,1836,83,na,1919,250.69293226547404
STAT,1877,25,40-44,1902,2.956525023528268
STAT,1931,20,45-49,1951,1.386870706694915
STAT,1811,46,15-19,1857,0.0013549561059300608
STAT,1876,55,na,1931,2016.5488172292105
STAT,1828,32,35-39,1860,10.905319557892831
STAT,1819,43,na,1862,1402.4863757683206
STAT,1828,40,50-100,1868,0.9637238549658972
SIM,1840,22,15-19,1862,2
STAT,1905,30,45-49,1935,2.399723826184962
STAT,1855,56,na,1911,1444.5438519562838
STAT,1830,95,na,1925,7.942109447474337
STAT,1914,21,50-100,1935,0.6111391793993989
SIM,1903,20,40-44,1923,2
STAT,1841,31,20-24,1872,2.267307686399142
STAT,1894,77,na,1971,1492.761922740829
STAT,1925,42,30-34,1967,0.14623946218825276
STAT,1900,20,15-19,1920,4.349463795995433
STAT,1832,34,15-19,1866,0.11027178174547551
STAT,1901,64,na,1965,2517.7974055697277
STAT,1829,47,20-24,1876,0.009682740544550476
SIM,1945,23,15-19,1968,5
SIM,1857,26,na,1883,1959
STAT,1849,53,na,1902,1527.0647651851739
STAT,1896,38,20-24,1934,0.9576560133628008
SIM,1875,36,50-100,1911,1
SIM,1832,65,na,1897,1042
STAT,1879,50,45-49,1929,0.014535951659006438
STAT,1882,39,40-44,1921,3.9835197995087297
STAT,1923,20,50-100,1943,0.7276423684303652
SIM,1930,19,35-39,1949,6
SIM,1885,31,35-39,1916,14
STAT,1832,22,15-19,1854,4.958975670429868
STAT,1859,8,na,1867,2149.056143465518
STAT,1850,31,30-34,1881,12.992543790104932
SIM,1940,26,na,1966,3447
STAT,1837,44,45-49,1881,0.9888549816575329
STAT,1799,86,na,1885,73.77265745346809
STAT,1829,35,20-24,1864,0.7125798102643182
SIM,1890,32,20-24,1922,1
SIM,1857,26,40-44,1883,2
STAT,1867,18,40-44,1885,0.1648760706351292
SIM,1869,42,40-44,1911,6
STAT,1855,37,20-24,1892,0.5459435429970789
STAT,1932,36,45-49,1968,0.8661064031391889
STAT,1922,19,35-39,1941,4.563396266690825
STAT,1916,40,30-34,1956,0.12410682046530935
SIM,1930,30,45-49,1960,4
SIM,1818,36,na,1854,1451
STAT,1832,40,45-49,1872,1.139422276197571
STAT,1914,21,20-24,1935,103.27639898107628
STAT,1826,28,na,1854,1431.2382068672382
STAT,1826,90,na,1916,43.03253274227321
SIM,1826,47,50-100,1873,2
STAT,1874,40,15-19,1914,0.01346836904230993
SIM,1913,38,40-44,1951,4
SIM,1839,17,25-29,1856,7
STAT,1832,54,50-100,1886,0.009154533011181392
STAT,1821,50,na,1871,1351.1581037700807
SIM,1922,21,20-24,1943,112
STAT,1882,32,20-24,1914,2.4847869407777425
STAT,1845,23,50-100,1868,0.3540295567461763
STAT,1862,30,45-49,1892,1.4165333968760527
STAT,1876,35,50-100,1911,1.2087342569964454
SIM,1881,48,na,1929,1851
SIM,1904,19,25-29,1923,10
STAT,1936,24,45-49,1960,1.0153537090869573
STAT,1768,94,na,1862,2.3497373311736904
SIM,1906,48,na,1954,3098
STAT,1877,31,35-39,1908,9.968305751200878
SIM,1909,22,35-39,1931,10
STAT,1873,37,40-44,1910,4.1976238995059205
STAT,1901,42,45-49,1943,0.1372557788981376
SIM,1844,24,40-44,1868,1
STAT,1911,49,20-24,1960,0.009823361004762223
STAT,1945,15,20-24,1960,139.9824043051017
SIM,1928,23,15-19,1951,6
SIM,1898,6,na,1904,3300
SIM,1849,34,35-39,1883,15
SIM,1890,20,20-24,1910,79
SIM,1828,91,na,1919,29
STAT,1841,24,15-19,1865,2.818464683069468
STAT,1877,21,25-29,1898,56.28827269297196
STAT,1815,48,40-44,1863,0.40979260657029226
SIM,1880,18,15-19,1898,4
STAT,1941,31,25-29,1972,9.17192357610526
SIM,1863,20,na,1883,2093
SIM,1890,39,40-44,1929,9
STAT,1831,43,na,1874,1542.9718300792483
STAT,1846,42,na,1888,1649.3194669212312
STAT,1872,18,15-19,1890,5.61241158150067
STAT,1769,113,na,1882,4.0709327028247286E-4
STAT,1922,30,45-49,1952,1.6932371608456798
SIM,1850,87,na,1937,103
SIM,1894,18,na,1912,3211
STAT,1846,35,20-24,1881,0.5794814327762963
SIM,1840,40,45-49,1880,1
STAT,1884,84,na,1968,597.4329808864813
STAT,1842,51,25-29,1893,0.002534380258839413
STAT,1888,46,15-19,1934,4.4767110937365577E-4
STAT,1886,48,na,1934,2217.4041165757208
SIM,1801,73,na,1874,480
SIM,1953,15,20-24,1968,123
SIM,1848,19,25-29,1867,7
STAT,1789,93,na,1882,6.235127237487562
STAT,1863,16,15-19,1879,5.656780103727426
SIM,1935,2,na,1937,5228
SIM,1924,29,50-100,1953,1
SIM,1818,40,35-39,1858,4
STAT,1848,22,50-100,1870,0.3577094261625306
SIM,1889,15,30-34,1904,3
STAT,1818,64,na,1882,920.4780199414267
STAT,1937,27,30-34,1964,36.07745092385379
SIM,1918,33,na,1951,3726
SIM,1827,28,20-24,1855,10
SIM,1840,38,30-34,1878,7
STAT,1852,52,30-34,1904,0.004498506472523828
SIM,1835,79,na,1914,418
SIM,1871,16,15-19,1887,5
SIM,1839,38,na,1877,1730
STAT,1854,22,50-100,1876,0.34502551440924145
STAT,1830,98,na,1928,1.940520870713059
STAT,1861,15,35-39,1876,0.500632015635654
SIM,1936,15,20-24,1951,115
STAT,1825,51,25-29,1876,0.0036519522838540297
STAT,1880,23,na,1903,2343.590444318561
SIM,1953,18,25-29,1971,55
SIM,1814,40,na,1854,1415
STAT,1900,34,40-44,1934,5.634994037426587
SIM,1836,24,na,1860,1750
STAT,1834,57,na,1891,1243.8739379064575
STAT,1945,18,25-29,1963,44.70580154576432
STAT,1849,19,35-39,1868,0.48111661337619477
STAT,1913,52,na,1965,3329.7060463289044
STAT,1872,96,na,1968,37.483750513611746
SIM,1857,19,35-39,1876,1
STAT,1886,31,45-49,1917,1.7476640394337173
STAT,1810,50,35-39,1860,0.03041642289628305
STAT,1815,50,na,1865,1252.477903044032
SIM,1855,93,na,1948,20
STAT,1906,23,20-24,1929,94.50372929114133
STAT,1856,45,25-29,1901,0.04304277552997923
STAT,1941,0,na,1941,4358.128228560265
STAT,1925,28,50-100,1953,1.1068319819345047
STAT,1819,40,45-49,1859,3.1419462528093054
STAT,1895,30,40-44,1925,5.389277521901937
STAT,1870,15,45-49,1885,0.06176855004724542
STAT,1846,15,50-100,1861,0.043908482262134584
SIM,1831,26,20-24,1857,14
STAT,1847,43,25-29,1890,0.469078713542767
SIM,1921,19,25-29,1940,44
STAT,1892,42,25-29,1934,0.758740843367973
STAT,1899,19,30-34,1918,2.0523790224116616
STAT,1875,16,40-44,1891,0.17795035089336006
STAT,1834,50,20-24,1884,4.872698174010382E-4
SIM,1844,30,35-39,1874,14
STAT,1823,39,35-39,1862,10.015418575590266
SIM,1849,28,40-44,1877,4
STAT,1845,97,na,1942,3.784107254300798
STAT,1848,54,30-34,1902,0.004170429756660811
SIM,1914,23,20-24,1937,126
SIM,1882,44,30-34,1926,4
STAT,1923,26,25-29,1949,71.6407089908717
SIM,1845,44,45-49,1889,4
SIM,1861,24,40-44,1885,4
STAT,1832,38,30-34,1870,4.041797785648126
SIM,1824,39,na,1863,1488
STAT,1844,25,45-49,1869,0.968020667404675
STAT,1867,41,na,1908,2059.346866110474
STAT,1883,42,15-19,1925,0.012770325302962267
SIM,1835,19,15-19,1854,4
SIM,1888,18,na,1906,2741
SIM,1918,16,15-19,1934,8
STAT,1750,117,na,1867,0.00229882419808161
STAT,1869,40,40-44,1909,2.0775746494822585
STAT,1874,51,50-100,1925,0.01465195104896001
STAT,1838,43,15-19,1881,0.009896142040809762
STAT,1874,44,30-34,1918,1.0950574611146473
SIM,1893,33,na,1926,2966
STAT,1941,25,30-34,1966,38.3216927194203
STAT,1853,24,40-44,1877,1.7997924260383444
STAT,1803,103,na,1906,0.04741412856700897
STAT,1888,44,25-29,1932,0.7069802904453546
STAT,1858,18,30-34,1876,1.3726711138923484
STAT,1913,19,25-29,1932,8.323414953945159
SIM,1890,59,na,1949,2279
STAT,1836,30,35-39,1866,8.253138355441516
STAT,1875,51,20-24,1926,7.196054651978064E-4
STAT,1850,36,25-29,1886,2.080551643362352
SIM,1923,35,30-34,1958,1
SIM,1873,32,20-24,1905,3
STAT,1908,37,na,1945,3326.8425059806327
STAT,1895,22,na,1917,2915.6314181638145
STAT,1868,38,45-49,1906,1.7891607521752748
STAT,1905,23,na,1928,3218.682369355884
SIM,1894,31,45-49,1925,5
STAT,1842,45,30-34,1887,0.07073342691668713
SIM,1903,34,na,1937,3210
STAT,1915,35,30-34,1950,1.7556947161664056
STAT,1818,61,na,1879,1029.4221211551105
STAT,1842,41,15-19,1883,0.010305690105320483
STAT,1932,38,35-39,1970,3.067061572468195
STAT,1840,29,25-29,1869,36.206019430138674
STAT,1938,10,na,1948,3703.123904507573
STAT,1837,26,15-19,1863,0.3702666671171099
SIM,1876,38,45-49,1914,1
SIM,1854,46,na,1900,1771
SIM,1900,20,na,1920,3093
STAT,1890,17,20-24,1907,20.476932690000936
STAT,1780,111,na,1891,6.608306709101467E-4
STAT,1883,27,50-100,1910,0.5922701441189436
SIM,1866,18,30-34,1884,1
STAT,1864,33,15-19,1897,0.11972893456871012
STAT,1891,47,35-39,1938,0.0919115886235106
STAT,1837,68,na,1905,964.6864782490678
STAT,1911,47,30-34,1958,0.07970898285229923
SIM,1887,38,20-24,1925,4
SIM,1855,90,na,1945,49
SIM,1937,32,20-24,1969,1
STAT,1946,25,15-19,1971,0.7435590673246049
STAT,1811,51,30-34,1862,0.01928475149787962
STAT,1861,49,15-19,1910,3.0723869571950467E-4
STAT,1872,20,50-100,1892,0.38897488627024945
STAT,1799,89,na,1888,39.10425796036178
SIM,1827,40,45-49,1867,5
STAT,1834,38,50-100,1872,0.9355278504664858
STAT,1897,43,20-24,1940,0.013832675904104546
SIM,1847,64,na,1911,1204
SIM,1881,39,30-34,1920,3
STAT,1842,83,na,1925,282.6994354050133
STAT,1857,82,na,1939,347.48762720891614
SIM,1933,28,50-100,1961,1
STAT,1942,8,na,1950,3908.8118925348685
STAT,1901,44,35-39,1945,0.16402874523534336
STAT,1929,32,20-24,1961,2.927094513790782
STAT,1806,48,30-34,1854,0.28171733440806707
SIM,1874,60,na,1934,1782
SIM,1913,28,30-34,1941,43
STAT,1875,70,na,1945,1361.736864457422
STAT,1905,28,30-34,1933,34.25619917319366
STAT,1911,43,15-19,1954,0.0013760424153596415
STAT,1866,52,25-29,1918,0.003068631057847885
SIM,1859,31,25-29,1890,13
SIM,1881,23,15-19,1904,2
STAT,1868,29,na,1897,2137.2041942898754
SIM,1918,34,45-49,1952,1
STAT,1873,39,30-34,1912,5.059140837867197
SIM,1841,43,30-34,1884,1
SIM,1904,29,35-39,1933,14
STAT,1907,40,20-24,1947,0.015455803305685021
SIM,1869,45,na,1914,2086
STAT,1867,24,35-39,1891,5.143670511704156
STAT,1878,45,45-49,1923,0.23440868137787038
STAT,1806,76,na,1882,376.9972696126569
SIM,1835,37,45-49,1872,3
STAT,1835,19,40-44,1854,0.2878906599454333
STAT,1850,46,35-39,1896,0.0988401556158736
SIM,1906,45,na,1951,3167
SIM,1830,33,45-49,1863,2
SIM,1898,3,na,1901,3332
STAT,1890,19,50-100,1909,0.05628347918943542
STAT,1832,32,25-29,1864,8.108005430672149
STAT,1836,20,25-29,1856,57.99540167366606
SIM,1889,18,35-39,1907,2
STAT,1931,18,30-34,1949,15.032430007269166
SIM,1848,103,na,1951,1
STAT,1859,33,40-44,1892,3.2557594838555373
STAT,1894,28,45-49,1922,1.344513446612517
SIM,1925,15,na,1940,4119
STAT,1805,91,na,1896,19.402578821728323
STAT,1902,12,na,1914,3442.867266988799
SIM,1858,21,30-34,1879,13
SIM,1866,37,50-100,1903,1
STAT,1824,41,30-34,1865,1.4918105894171956
STAT,1793,61,na,1854,908.0
STAT,1824,46,25-29,1870,0.06865315430361692
STAT,1938,34,20-24,1972,2.3136827404985305
STAT,1920,45,15-19,1965,3.8650999267482715E-4
SIM,1884,59,na,1943,1885
STAT,1941,21,15-19,1962,5.198143639778572
SIM,1909,59,na,1968,2960
STAT,1861,111,na,1972,0.0013683648147294286
STAT,1906,43,40-44,1949,0.2133102162215227
STAT,1933,30,20-24,1963,3.1088285018118405
STAT,1887,29,15-19,1916,0.47590925782217514
STAT,1857,50,25-29,1907,0.0026758248216742714
SIM,1881,45,na,1926,1890
STAT,1871,22,35-39,1893,5.465180648778368
STAT,1841,34,25-29,1875,8.32792085964923
STAT,1879,0,na,1879,3583.486952306256
SIM,1877,43,45-49,1920,6
SIM,1826,35,45-49,1861,1
SIM,1849,24,25-29,1873,54
STAT,1841,44,35-39,1885,1.2548483733563707
STAT,1781,76,na,1857,321.3188901828295
STAT,1891,37,25-29,1928,3.3666646226386545
SIM,1875,45,na,1920,2179
SIM,1914,33,30-34,1947,22
STAT,1847,100,na,1947,0.781146423883259
STAT,1943,26,50-100,1969,1.0018386276279156
SIM,1941,30,20-24,1971,4
STAT,1922,16,30-34,1938,13.359781573409828
STAT,1838,47,30-34,1885,0.0679224809447154
STAT,1845,18,20-24,1863,15.690331850595774
STAT,1880,22,45-49,1902,0.6931365436520229
SIM,1908,27,45-49,1935,2
SIM,1870,20,35-39,1890,5
SIM,1896,44,na,1940,2871
STAT,1858,30,na,1888,1806.896618277798
SIM,1840,32,25-29,1872,13
STAT,1844,16,na,1860,2060.529680920796
SIM,1880,60,na,1940,1974
STAT,1856,42,20-24,1898,0.11736014004732188
SIM,1913,22,50-100,1935,3
STAT,1858,67,na,1925,1175.6444902855794
STAT,1796,75,na,1871,441.81411798304293
STAT,1917,11,na,1928,4020.6452034026697
SIM,1820,40,na,1860,1457
SIM,1946,14,na,1960,4069
SIM,1860,46,na,1906,1889
SIM,1910,16,na,1926,3546
STAT,1909,37,50-100,1946,0.3753300007221164
STAT,1915,45,40-44,1960,0.15077631552207907
STAT,1803,62,na,1865,889.9953891792148
STAT,1812,76,na,1888,406.19213031867724
STAT,1837,41,40-44,1878,1.6971048397006943
SIM,1852,25,45-49,1877,4
STAT,1881,6,na,1887,2423.4474240188833
STAT,1878,27,15-19,1905,0.4461949082964884
STAT,1887,39,25-29,1926,3.0112468215501766
STAT,1936,21,40-44,1957,3.0372521325535415
SIM,1930,16,30-34,1946,17
SIM,1853,18,20-24,1871,15
STAT,1906,33,30-34,1939,13.732792261246901
SIM,1944,21,40-44,1965,3
STAT,1895,20,30-34,1915,22.089998625010384
STAT,1865,15,na,1880,2257.9213666233904
SIM,1927,28,25-29,1955,79
STAT,1877,37,na,1914,2309.604418411859
STAT,1822,33,45-49,1855,4.515065897629912
STAT,1905,22,50-100,1927,0.5566972873665448
SIM,1868,41,45-49,1909,4
STAT,1862,20,35-39,1882,4.883724808053928
SIM,1867,23,30-34,1890,25
STAT,1807,53,30-34,1860,0.020659530809460865
STAT,1879,48,30-34,1927,0.09438241650362804
SIM,1952,14,na,1966,4393
STAT,1882,35,25-29,1917,2.6718382597638266
SIM,1823,54,na,1877,1174
SIM,1942,27,50-100,1969,4
STAT,1919,28,25-29,1947,66.94841266959014
STAT,1914,24,25-29,1938,88.5764410206873
SIM,1928,39,30-34,1967,2
STAT,1858,6,na,1864,2161.26583159244
STAT,1934,27,50-100,1961,1.2649064955643043
SIM,1934,29,na,1963,4671
SIM,1936,4,na,1940,3037
STAT,1924,47,40-44,1971,0.17733581662852843
SIM,1893,26,45-49,1919,1
STAT,1898,36,na,1934,3027.388248758245
SIM,1825,80,na,1905,278
STAT,1900,37,50-100,1937,0.3473029341694239
SIM,1931,26,25-29,1957,83
SIM,1931,15,na,1946,4532
STAT,1918,36,50-100,1954,0.42006363669876134
SIM,1844,53,na,1897,1497
SIM,1844,20,25-29,1864,49
STAT,1827,37,45-49,1864,1.9923031364466925
SIM,1871,34,45-49,1905,3
STAT,1866,96,na,1962,18.990015713635252
SIM,1949,15,30-34,1964,19
STAT,1846,38,25-29,1884,2.098035827238147
SIM,1919,37,30-34,1956,1
STAT,1864,30,na,1894,2030.9832595301968
STAT,1873,33,25-29,1906,9.780270930860857
SIM,1773,84,na,1857,91
SIM,1883,74,na,1957,1090
STAT,1850,29,50-100,1879,0.5223829729205526
STAT,1885,26,45-49,1911,1.0485805271973094
SIM,1788,83,na,1871,110
STAT,1843,31,na,1874,1899.338821929603
STAT,1859,15,na,1874,2032.7277339476802
STAT,1833,53,40-44,1886,0.006472385808219197
STAT,1863,31,40-44,1894,3.615985349046763
SIM,1878,59,na,1937,1964
STAT,1837,103,na,1940,0.09059496278029407
STAT,1901,67,na,1968,2388.8778456730724
SIM,1894,19,20-24,1913,20
STAT,1860,43,25-29,1903,0.4894607916841605
STAT,1838,16,na,1854,2080.1643146995143
STAT,1849,29,45-49,1878,0.9351021037835124
STAT,1825,39,50-100,1864,1.4514758092996272
STAT,1917,15,45-49,1932,0.10201928088144342
SIM,1899,58,na,1957,2581
SIM,1857,29,45-49,1886,3
STAT,1883,37,na,1920,2181.3217762599406
SIM,1922,24,25-29,1946,121
SIM,1904,16,20-24,1920,16
STAT,1863,21,50-100,1884,0.3478811051142941
STAT,1910,41,40-44,1951,0.22453484421287048
SIM,1890,35,25-29,1925,2
STAT,1896,40,35-39,1936,0.15858288375282018
SIM,1808,49,50-100,1857,4
STAT,1851,97,na,1948,3.93955356869378
STAT,1815,44,25-29,1859,1.6432234287463667
STAT,1886,19,20-24,1905,17.60037923932406
SIM,1882,28,50-100,1910,1
SIM,1900,32,25-29,1932,13
STAT,1932,33,40-44,1965,4.911549548004132
SIM,1870,46,na,1916,2093
STAT,1953,16,20-24,1969,154.97985677857696
STAT,1928,42,15-19,1970,0.0018496251083332735
SIM,1952,18,20-24,1970,134
SIM,1882,79,na,1961,760
STAT,1950,15,40-44,1965,1.5633312331249622
STAT,1837,23,35-39,1860,4.787744167280765
SIM,1838,33,45-49,1871,1
STAT,1900,33,30-34,1933,22.785958516445383
SIM,1905,23,30-34,1928,29
SIM,1823,68,na,1891,763
SIM,1873,40,50-100,1913,3
SIM,1903,15,20-24,1918,20
STAT,1932,39,35-39,1971,3.0636264635070307
SIM,1937,29,35-39,1966,14
STAT,1920,32,45-49,1952,1.6283613499104972
SIM,1914,29,40-44,1943,7
STAT,1803,71,na,1874,600.7268177994574
STAT,1839,31,45-49,1870,1.4458111109881204
STAT,1906,29,40-44,1935,4.091273248809138
STAT,1897,24,45-49,1921,0.8754915346773501
STAT,1883,76,na,1959,1002.5792806350123
SIM,1901,43,40-44,1944,1
STAT,1824,65,na,1889,898.1681751698178
SIM,1855,30,40-44,1885,9
STAT,1932,19,na,1951,4579.722473090378
STAT,1894,28,na,1922,2889.942865404838
STAT,1921,25,15-19,1946,0.7483792454995821
STAT,1807,85,na,1892,98.33608248173522
STAT,1890,14,na,1904,2973.21112443188
STAT,1898,17,15-19,1915,7.589263370657764
STAT,1902,41,40-44,1943,0.2091723730253944
SIM,1834,35,50-100,1869,1
SIM,1885,12,na,1897,2468
SIM,1885,47,50-100,1932,3
SIM,1919,38,30-34,1957,3
STAT,1915,27,40-44,1942,4.490807069194732
STAT,1918,28,20-24,1946,18.286789320941494
STAT,1932,31,25-29,1963,11.61419740713071
SIM,1917,25,50-100,1942,5
SIM,1845,23,35-39,1868,6
STAT,1942,19,50-100,1961,0.36960925531635586
STAT,1888,31,40-44,1919,4.859598218642555
SIM,1922,35,25-29,1957,4
STAT,1906,21,30-34,1927,24.576713958292764
STAT,1930,23,15-19,1953,6.422631835907348
STAT,1940,30,20-24,1970,2.387271549485053
SIM,1876,22,25-29,1898,57
STAT,1831,48,40-44,1879,0.12426455201781506
SIM,1862,20,30-34,1882,20
STAT,1854,63,na,1917,1284.8671869827886
STAT,1933,18,45-49,1951,0.6300742462805008
STAT,1858,77,na,1935,641.0588146881945
STAT,1877,20,25-29,1897,56.453681981176786
STAT,1925,41,35-39,1966,0.2306702973459131
STAT,1941,17,40-44,1958,1.3609118094247916
STAT,1923,33,25-29,1956,10.004428340291387
SIM,1907,31,40-44,1938,10
STAT,1854,20,30-34,1874,15.289481580967466
SIM,1861,85,na,1946,182
SIM,1843,15,25-29,1858,5
SIM,1829,40,40-44,1869,5
STAT,1816,46,na,1862,1405.0336764936833
SIM,1931,33,25-29,1964,11
STAT,1845,27,na,1872,1854.6967564059798
STAT,1781,104,na,1885,0.030221997269123793
SIM,1849,33,20-24,1882,1
SIM,1787,68,na,1855,664
SIM,1809,96,na,1905,4
SIM,1896,31,40-44,1927,8
STAT,1914,35,25-29,1949,0.9373564903831926
STAT,1865,21,45-49,1886,0.6102704806324064
STAT,1922,17,30-34,1939,13.327050108554973
SIM,1783,86,na,1869,56
SIM,1914,21,30-34,1935,33
STAT,1919,44,15-19,1963,0.0015669208851757297
STAT,1847,30,40-44,1877,3.8251508223112065
STAT,1947,25,35-39,1972,16.060812262101337
STAT,1824,110,na,1934,1.4588928958433062E-4
STAT,1860,16,na,1876,2044.5948148840755
STAT,1896,19,na,1915,3136.3900974077205
STAT,1912,27,15-19,1939,0.6570589624973625
STAT,1931,32,20-24,1963,3.0194058104706767
SIM,1936,21,na,1957,2725
STAT,1909,17,15-19,1926,8.405419054837589
SIM,1856,37,50-100,1893,1
SIM,1865,16,15-19,1881,5
STAT,1796,84,na,1880,117.99358316753691
STAT,1846,21,35-39,1867,5.113359896421737
SIM,1928,34,na,1962,4450
STAT,1929,34,30-34,1963,18.882437276188508
SIM,1924,20,na,1944,4067
STAT,1924,25,40-44,1949,5.1621428156172975
STAT,1841,45,na,1886,1586.4339895406185
SIM,1899,32,20-24,1931,4
SIM,1836,86,na,1922,123
SIM,1887,20,35-39,1907,10
SIM,1854,21,35-39,1875,10
SIM,1842,49,50-100,1891,3
STAT,1786,74,na,1860,421.81874410313975
SIM,1907,26,45-49,1933,2
STAT,1858,20,15-19,1878,2.8479399166765114
SIM,1930,17,30-34,1947,19
STAT,1944,18,20-24,1962,137.78342623039896
SIM,1832,72,na,1904,766
SIM,1840,91,na,1931,24
STAT,1903,40,45-49,1943,0.14109451117530775
STAT,1870,26,na,1896,2216.712912460697
SIM,1884,36,50-100,1920,1
STAT,1873,66,na,1939,1571.6604765476052
SIM,1907,40,na,1947,3286
SIM,1953,17,25-29,1970,52
SIM,1802,74,na,1876,446
STAT,1915,47,35-39,1962,0.12272079547457068
SIM,1870,48,50-100,1918,2
STAT,1835,20,20-24,1855,76.6149545213478
STAT,1914,40,20-24,1954,0.016644196262521917
SIM,1820,47,50-100,1867,2
STAT,1857,16,15-19,1873,5.22552113872964
STAT,1875,57,na,1932,1950.4232962694955
STAT,1930,36,20-24,1966,0.32513961924661655
STAT,1794,93,na,1887,6.724792514798078
SIM,1937,34,30-34,1971,14
STAT,1850,52,35-39,1902,0.00602853288096681
SIM,1808,79,na,1887,262
STAT,1860,39,20-24,1899,0.5858702177345603
STAT,1913,39,25-29,1952,0.9084836242131025
SIM,1848,24,15-19,1872,2
SIM,1804,65,na,1869,776
SIM,1899,27,25-29,1926,58
STAT,1929,29,35-39,1958,17.734154884504676
STAT,1945,17,25-29,1962,44.720111981598436
STAT,1946,26,30-34,1972,41.25250371256612
SIM,1917,17,15-19,1934,7
STAT,1900,20,25-29,1920,75.4731439052299
STAT,1902,36,45-49,1938,0.5763833195460621
SIM,1884,16,25-29,1900,8
STAT,1887,58,na,1945,2089.3248633266826
STAT,1883,44,na,1927,2111.016237364752
STAT,1872,49,40-44,1921,0.15894286135043667
SIM,1856,31,na,1887,1918
SIM,1835,46,50-100,1881,1
STAT,1873,20,40-44,1893,2.010103937025558
SIM,1888,32,45-49,1920,5
STAT,1855,49,40-44,1904,0.11871852826988298
STAT,1891,63,na,1954,2086.3989562038582
SIM,1823,36,na,1859,1517
SIM,1870,78,na,1948,660
STAT,1879,39,na,1918,2302.9535858860195
STAT,1895,77,na,1972,1528.9622508118998
STAT,1933,23,40-44,1956,4.211980127051559
STAT,1931,23,50-100,1954,0.803733897937345
STAT,1800,104,na,1904,0.026587136871706787
STAT,1916,23,40-44,1939,3.3180391083809466
STAT,1938,32,30-34,1970,14.963939845850545
SIM,1875,23,20-24,1898,60
STAT,1920,29,15-19,1949,0.7263911191213922
STAT,1903,29,15-19,1932,0.6054329187067984
SIM,1935,26,20-24,1961,22
STAT,1919,27,25-29,1946,67.18490353001575
STAT,1859,24,25-29,1883,44.138077534981306
SIM,1871,95,na,1966,42
STAT,1910,30,35-39,1940,8.388448787787791
SIM,1811,67,na,1878,769
STAT,1914,18,35-39,1932,0.8177052272654817
STAT,1832,52,na,1884,1346.6131179360038
SIM,1930,21,15-19,1951,9
STAT,1865,47,na,1912,1922.3600718502505
SIM,1862,59,na,1921,1673
SIM,1919,41,na,1960,3819
STAT,1922,34,20-24,1956,2.5909941607170666
STAT,1887,22,35-39,1909,6.165164404188867
STAT,1903,38,na,1941,3175.667465441314
SIM,1915,25,40-44,1940,6
SIM,1843,20,20-24,1863,58
SIM,1924,23,40-44,1947,3
STAT,1910,38,45-49,1948,0.6126974844791137
SIM,1929,32,30-34,1961,25
SIM,1936,17,25-29,1953,42
SIM,1959,5,na,1964,4855
SIM,1890,66,na,1956,1918
STAT,1904,46,20-24,1950,0.0091968347087192
STAT,1918,48,15-19,1966,3.692850484883146E-4
SIM,1922,18,35-39,1940,6
STAT,1765,103,na,1868,0.04711591210338294
SIM,1836,30,30-34,1866,17
SIM,1886,21,30-34,1907,19
SIM,1930,34,20-24,1964,5
SIM,1932,25,40-44,1957,7
SIM,1895,22,35-39,1917,6
STAT,1858,33,20-24,1891,1.9962087145886658
STAT,1875,25,na,1900,2331.9254854769683
SIM,1848,12,na,1860,2192
STAT,1927,26,20-24,1953,21.038464366616275
STAT,1925,24,45-49,1949,1.264526870222322
STAT,1870,45,15-19,1915,3.7395889301003997E-4
SIM,1867,24,25-29,1891,47
SIM,1828,31,35-39,1859,16
SIM,1941,23,40-44,1964,4
STAT,1782,92,na,1874,9.882335196665348
STAT,1890,20,50-100,1910,0.4738192459042174
STAT,1932,19,40-44,1951,1.740327854838603
STAT,1907,45,35-39,1952,0.11066294604645734
SIM,1940,19,40-44,1959,2
SIM,1879,34,45-49,1913,4
SIM,1904,0,na,1904,3633
SIM,1943,23,na,1966,3597
STAT,1906,7,na,1913,3583.951567130258
SIM,1926,28,20-24,1954,23
STAT,1896,20,35-39,1916,7.329255965429485
STAT,1860,54,45-49,1914,0.010835647342822179
STAT,1837,83,na,1920,250.60109999369817
SIM,1900,31,30-34,1931,33
STAT,1880,52,20-24,1932,7.295859585027605E-4
SIM,1921,19,30-34,1940,20
SIM,1906,35,40-44,1941,1
STAT,1779,110,na,1889,0.001963792825904337
STAT,1825,82,na,1907,263.80296458826
STAT,1868,22,25-29,1890,51.63422695283657
STAT,1907,25,40-44,1932,4.18444352467396
STAT,1829,96,na,1925,5.263180094088648
STAT,1915,39,na,1954,3553.9240388554
STAT,1778,87,na,1865,47.62475123917382
STAT,1864,30,40-44,1894,3.6909683699177696
STAT,1911,25,na,1936,3473.8875678356217
STAT,1828,107,na,1935,0.002677136130788675
SIM,1824,85,na,1909,130
SIM,1902,19,20-24,1921,25
STAT,1852,29,na,1881,1894.3534115967161
STAT,1908,24,45-49,1932,0.9708530686202683
STAT,1895,21,30-34,1916,22.025274929039107
SIM,1795,87,na,1882,48
SIM,1791,73,na,1864,440
SIM,1939,18,na,1957,3415
SIM,1877,28,50-100,1905,3
SIM,1927,27,25-29,1954,84
SIM,1921,23,15-19,1944,4
SIM,1901,30,35-39,1931,11
SIM,1928,31,50-100,1959,1
SIM,1878,22,35-39,1900,7
STAT,1834,49,20-24,1883,0.007678187107965334
STAT,1867,23,20-24,1890,60.93653775582975
STAT,1828,30,30-34,1858,20.225472629178086
STAT,1933,35,35-39,1968,3.1177160244814637
SIM,1925,3,na,1928,4514
STAT,1927,38,15-19,1965,0.022534774147398653
SIM,1847,31,45-49,1878,1
STAT,1817,49,20-24,1866,0.02601305007041021
STAT,1913,19,30-34,1932,2.3411103766829284
STAT,1878,0,na,1878,3579.9799875715066
STAT,1889,22,45-49,1911,0.8132666287100859
SIM,1799,69,na,1868,666
STAT,1898,10,na,1908,3312.5786610882005
STAT,1820,51,na,1871,1296.8901021886345
SIM,1882,47,na,1929,2035
SIM,1884,21,20-24,1905,70
STAT,1911,57,na,1968,3140.6655558647344
STAT,1938,27,35-39,1965,14.049731908197462
SIM,1840,32,50-100,1872,4
STAT,1924,45,35-39,1969,0.1457001425054765
SIM,1815,49,na,1864,1242
STAT,1914,23,30-34,1937,27.64896465596336
STAT,1824,33,na,1857,1516.163470697931
SIM,1845,20,30-34,1865,21
SIM,1916,24,45-49,1940,1
SIM,1869,81,na,1950,429
SIM,1908,5,na,1913,3583
STAT,1937,28,30-34,1965,36.06013374741033
SIM,1874,28,na,1902,2279
SIM,1909,28,20-24,1937,17
STAT,1923,46,30-34,1969,0.09877097257775362
STAT,1849,22,15-19,1871,2.874960101798576
STAT,1923,5,na,1928,4460.619038702227
SIM,1857,22,15-19,1879,3
STAT,1828,47,na,1875,1415.3226070015846
STAT,1904,33,15-19,1937,0.11031704046889704
STAT,1806,68,na,1874,717.3120960574322
STAT,1802,54,na,1856,1073.4592279940628
SIM,1931,30,20-24,1961,2
SIM,1812,52,na,1864,1204
SIM,1868,20,25-29,1888,59
SIM,1889,17,15-19,1906,8
STAT,1836,34,na,1870,1694.3324438027116
STAT,1852,15,25-29,1867,5.269134243061837
STAT,1925,17,na,1942,4200.952655450956
STAT,1938,24,30-34,1962,26.850622097276094
STAT,1928,38,30-34,1966,2.173977807813688
SIM,1920,15,20-24,1935,139
STAT,1887,26,na,1913,2530.0061262371596
STAT,1877,16,40-44,1893,0.17974334457707886
STAT,1787,91,na,1878,18.00231694407327
STAT,1891,31,50-100,1922,1.075750391141256
STAT,1891,31,na,1922,2801.732612500563
STAT,1950,18,45-49,1968,0.5578579986699791
STAT,1832,39,45-49,1871,1.4955592138974616
STAT,1895,45,na,1940,2801.775690206691
SIM,1923,39,35-39,1962,6
STAT,1808,109,na,1917,2.7653394653990443E-4
STAT,1915,39,35-39,1954,2.284845417749494
SIM,1844,30,na,1874,1907
STAT,1935,21,50-100,1956,0.846705906225535
SIM,1848,44,na,1892,1697
STAT,1915,31,25-29,1946,8.928151093896089
SIM,1878,42,na,1920,2346
STAT,1956,15,35-39,1971,5.247554039316858
STAT,1814,48,40-44,1862,0.4569488552585656
STAT,1899,34,20-24,1933,3.4694556579974036
STAT,1901,24,35-39,1925,7.667874541893216
STAT,1912,15,20-24,1927,26.01297019617643
STAT,1795,67,na,1862,715.1470403467307
STAT,1816,50,50-100,1866,0.03962250068330339
STAT,1854,23,35-39,1877,4.9018646149673435
SIM,1852,39,50-100,1891,4
STAT,1803,102,na,1905,0.09685840939493576
STAT,1923,30,20-24,1953,2.6630767128858346
STAT,1831,67,na,1898,966.7689489441083
STAT,1914,0,na,1914,4387.324379516255
SIM,1932,39,na,1971,4628
STAT,1901,15,45-49,1916,0.08677640736775447
SIM,1948,22,na,1970,3719
STAT,1847,33,45-49,1880,1.4909426850586995
STAT,1922,29,25-29,1951,69.8625302931459
STAT,1930,19,30-34,1949,14.807628363831796
STAT,1913,23,15-19,1936,5.061220811395528
STAT,1944,20,na,1964,3727.297574488935
STAT,1868,12,na,1880,2409.032293699243
STAT,1930,28,20-24,1958,21.917601129306515
STAT,1906,46,30-34,1952,0.07532600020634544
STAT,1852,49,15-19,1901,2.9756330165608475E-4
SIM,1862,23,35-39,1885,4
STAT,1903,37,15-19,1940,0.016290310736371914
STAT,1910,43,40-44,1953,0.22190876999819756
SIM,1841,97,na,1938,1
SIM,1817,83,na,1900,218
SIM,1855,33,45-49,1888,2
SIM,1930,29,25-29,1959,82
STAT,1861,65,na,1926,1325.7361490409517
SIM,1899,15,30-34,1914,3
STAT,1865,79,na,1944,600.1432915522734
SIM,1852,17,na,1869,2171
STAT,1902,44,45-49,1946,0.13668355750630198
SIM,1935,34,50-100,1969,1
SIM,1946,24,30-34,1970,37
SIM,1894,31,50-100,1925,2
SIM,1902,34,45-49,1936,1
STAT,1848,26,15-19,1874,0.39302861036573955
SIM,1816,66,na,1882,769
STAT,1893,6,na,1899,3131.2132964265916
STAT,1928,17,25-29,1945,51.5887370618482
SIM,1817,37,50-100,1854,3
SIM,1865,24,na,1889,1996
STAT,1908,49,45-49,1957,0.1845527136871745
STAT,1874,51,na,1925,2088.8982908528496
STAT,1907,20,na,1927,3301.0058572516114
SIM,1912,16,25-29,1928,7
STAT,1844,85,na,1929,192.4448866936288
STAT,1888,34,45-49,1922,1.9294613450371854
STAT,1848,99,na,1947,1.364386374846403
SIM,1866,32,50-100,1898,1
STAT,1840,71,na,1911,929.5774489833359
SIM,1906,27,40-44,1933,4
STAT,1905,25,30-34,1930,34.6104332013578
STAT,1907,33,40-44,1940,3.440410949377933
SIM,1866,33,20-24,1899,4
SIM,1866,8,na,1874,2446
STAT,1816,78,na,1894,364.0983809904301
STAT,1913,44,20-24,1957,0.016211779870370775
STAT,1923,16,35-39,1939,4.666608970682176
SIM,1846,40,40-44,1886,7
SIM,1873,11,na,1884,2532
SIM,1899,24,20-24,1923,89
SIM,1931,16,35-39,1947,6
SIM,1842,82,na,1924,286
STAT,1881,39,40-44,1920,3.952725935549189
STAT,1931,40,20-24,1971,0.02235042964954295
STAT,1889,81,na,1970,1058.2218868050045
STAT,1900,41,na,1941,3053.300959585565
STAT,1922,21,15-19,1943,5.784682108828225
STAT,1847,61,na,1908,1374.9209396760946
STAT,1871,49,25-29,1920,0.05281857397010164
STAT,1925,46,40-44,1971,0.1809541920757852
SIM,1898,23,15-19,1921,3
SIM,1849,36,25-29,1885,2
SIM,1849,61,na,1910,1382
SIM,1829,43,45-49,1872,2
SIM,1838,30,40-44,1868,5
SIM,1860,15,25-29,1875,5
STAT,1924,28,45-49,1952,1.8937608243390902
SIM,1878,30,35-39,1908,11
SIM,1913,25,30-34,1938,44
SIM,1792,90,na,1882,10
SIM,1840,39,45-49,1879,1
SIM,1896,34,45-49,1930,2
SIM,1889,45,50-100,1934,2
STAT,1874,16,15-19,1890,5.744068866392311
STAT,1936,33,na,1969,3467.6186563184992
STAT,1935,16,50-100,1951,0.48501402038763125
SIM,1920,38,na,1958,3825
STAT,1897,21,40-44,1918,2.6406645068644865
STAT,1908,41,35-39,1949,0.17697205421589893
SIM,1882,16,15-19,1898,3
STAT,1941,21,25-29,1962,90.19968009074462
SIM,1915,33,40-44,1948,8
SIM,1907,23,40-44,1930,4
SIM,1852,49,na,1901,1710
SIM,1871,63,na,1934,1661
SIM,1846,96,na,1942,10
SIM,1839,39,50-100,1878,1
STAT,1846,44,na,1890,1607.595070296058
STAT,1904,16,25-29,1920,7.696270531735545
STAT,1842,30,na,1872,1903.5014806530849
SIM,1875,77,na,1952,728
STAT,1936,36,15-19,1972,0.01782273478080636
SIM,1878,10,na,1888,2632
STAT,1869,17,45-49,1886,0.060560460043988684
STAT,1916,18,45-49,1934,0.09985774367996304
STAT,1838,40,40-44,1878,1.840649369248342
SIM,1905,15,30-34,1920,2
STAT,1904,55,na,1959,2875.8428344768417
STAT,1941,29,35-39,1970,14.65639978260573
SIM,1834,20,na,1854,1746
STAT,1919,49,20-24,1968,0.011257159098834738
STAT,1852,26,50-100,1878,0.5701821003828774
SIM,1841,43,50-100,1884,1
SIM,1900,22,40-44,1922,1
SIM,1932,28,45-49,1960,3
STAT,1841,30,50-100,1871,0.7765625638327044
SIM,1801,89,na,1890,32
STAT,1924,42,30-34,1966,0.1436715508847161
STAT,1931,15,30-34,1946,15.141944764698671
SIM,1849,20,15-19,1869,6
STAT,1940,25,25-29,1965,63.45539155868914
STAT,1916,26,45-49,1942,1.6932330244104417
STAT,1839,23,45-49,1862,0.5931220688894078
SIM,1863,33,na,1896,2036
SIM,1939,27,50-100,1966,1
SIM,1904,39,25-29,1943,1
STAT,1852,52,45-49,1904,0.010967433125172546
STAT,1873,23,45-49,1896,0.666601280429241
STAT,1920,24,45-49,1944,1.1743581802713046
SIM,1896,39,na,1935,2976
SIM,1892,25,na,1917,2864
STAT,1920,18,na,1938,3891.176742201327
STAT,1882,27,na,1909,2193.8116561781185
SIM,1887,41,40-44,1928,7
STAT,1899,3,na,1902,3422.4940122815055
STAT,1900,28,35-39,1928,12.601271399604931
STAT,1892,80,na,1972,1195.0948130536815
STAT,1879,41,40-44,1920,2.231056655275328
SIM,1918,29,25-29,1947,66
STAT,1912,48,20-24,1960,0.010003025850645025
STAT,1876,21,20-24,1897,67.41018634464814
STAT,1901,32,35-39,1933,13.390887265983762
SIM,1841,15,15-19,1856,4
STAT,1956,6,na,1962,4913.5844098520465
STAT,1853,37,50-100,1890,0.9105036499683099
SIM,1938,25,35-39,1963,19
STAT,1807,53,na,1860,1155.8466671208478
STAT,1913,27,30-34,1940,36.874149188744674
STAT,1775,90,na,1865,25.87280615215309
STAT,1887,5,na,1892,2768.695481614527
SIM,1825,32,20-24,1857,1
SIM,1859,26,40-44,1885,5
SIM,1913,17,30-34,1930,3
SIM,1925,19,15-19,1944,49
STAT,1857,105,na,1962,0.08087831676455397
SIM,1883,64,na,1947,1594
STAT,1906,37,40-44,1943,1.2997380630248814
STAT,1880,7,na,1887,2636.5400617688433
STAT,1884,23,20-24,1907,64.13376265614227
STAT,1849,30,15-19,1879,0.12135515311862165
SIM,1921,27,30-34,1948,51
STAT,1862,21,50-100,1883,0.3388302048522241
SIM,1897,30,45-49,1927,3
SIM,1789,91,na,1880,12
STAT,1889,30,45-49,1919,2.050118744865819
STAT,1901,1,na,1902,3599.088538822294
SIM,1887,78,na,1965,1003
STAT,1858,16,30-34,1874,1.3889851724108486
STAT,1917,19,15-19,1936,45.736689758422926
SIM,1866,16,30-34,1882,5
STAT,1905,17,30-34,1922,2.1758795125300785
SIM,1848,16,15-19,1864,9
STAT,1866,51,50-100,1917,0.013217267676790049
SIM,1847,23,45-49,1870,1
SIM,1924,26,45-49,1950,2
STAT,1836,98,na,1934,2.05141812135491
SIM,1857,48,na,1905,1769
STAT,1928,34,15-19,1962,0.1516137040243031
SIM,1892,23,20-24,1915,81
STAT,1911,43,50-100,1954,0.10526723708276402
STAT,1832,84,na,1916,201.14763444395572
SIM,1895,4,na,1899,3289
STAT,1936,32,50-100,1968,0.7585253851711337
STAT,1923,49,35-39,1972,0.1416610815275923
SIM,1906,55,na,1961,2999
SIM,1902,41,na,1943,3129
STAT,1943,17,15-19,1960,45.462121989052974
SIM,1928,36,30-34,1964,4
STAT,1830,48,25-29,1878,0.04167470924390994
STAT,1821,38,30-34,1859,10.456040557050216
STAT,1912,42,na,1954,3383.072591483924
STAT,1916,43,35-39,1959,0.1946284616883921
SIM,1870,39,30-34,1909,8
STAT,1935,3,na,1938,5237.952717367029
SIM,1835,21,25-29,1856,59
SIM,1879,31,40-44,1910,5
SIM,1933,21,40-44,1954,5
STAT,1878,20,40-44,1898,2.0615545153153256
STAT,1899,17,30-34,1916,2.0634448541583175
SIM,1937,1,na,1938,3626
SIM,1865,99,na,1964,2
STAT,1908,16,45-49,1924,0.09174361920545204
STAT,1811,48,15-19,1859,0.001309093349484387
SIM,1923,31,25-29,1954,9
STAT,1889,27,15-19,1916,0.529140570782911
SIM,1832,29,na,1861,1729
STAT,1877,80,na,1957,678.0369297983002
STAT,1942,16,45-49,1958,0.49328080941929486
STAT,1916,56,na,1972,3426.9718584942666
SIM,1882,5,na,1887,2433
STAT,1873,17,50-100,1890,0.046978720460710825
STAT,1890,20,40-44,1910,2.421216170417888
SIM,1951,17,15-19,1968,42
STAT,1862,50,na,1912,1760.0381587334891
SIM,1898,30,na,1928,3053
STAT,1904,38,20-24,1942,0.22429870300514382
STAT,1853,46,na,1899,1673.2367207149905
STAT,1866,64,na,1930,1514.0911161400434
STAT,1862,39,30-34,1901,4.251550402523317
STAT,1856,11,na,1867,2098.0626734648386
STAT,1868,30,25-29,1898,9.312854996718977
STAT,1925,21,40-44,1946,3.814075969795793
STAT,1919,21,na,1940,3789.020644189986
STAT,1843,22,20-24,1865,62.405374031317805
STAT,1861,33,na,1894,1864.1054607534338
SIM,1851,22,20-24,1873,55
SIM,1853,98,na,1951,2
STAT,1895,24,35-39,1919,7.1489430304
SIM,1879,19,20-24,1898,15
STAT,1934,31,35-39,1965,11.793497959966388
STAT,1867,26,25-29,1893,37.65014417982367
SIM,1840,16,na,1856,2016
SIM,1935,34,20-24,1969,3
STAT,1806,49,45-49,1855,0.6751065576089758
STAT,1924,17,40-44,1941,1.5736666760580287
SIM,1927,24,20-24,1951,117
STAT,1837,41,50-100,1878,0.797105263457784
STAT,1923,41,25-29,1964,0.07896746784944231
STAT,1924,43,na,1967,4167.074372965087
SIM,1905,26,35-39,1931,15
STAT,1890,78,na,1968,1286.6923840713368
STAT,1932,27,40-44,1959,5.767473922798341
SIM,1861,2,na,1863,2800
STAT,1927,34,20-24,1961,2.8311730482700224
STAT,1824,97,na,1921,2.8362091490169257
STAT,1879,20,35-39,1899,5.796520439939276
STAT,1922,37,25-29,1959,1.0584697558935328
SIM,1944,19,25-29,1963,62
STAT,1910,35,40-44,1945,1.3649719682162398
STAT,1932,34,50-100,1966,1.0369989156974837
STAT,1820,83,na,1903,211.48863712655628
STAT,1936,19,25-29,1955,38.97719333912023
SIM,1903,26,na,1929,3199
SIM,1829,84,na,1913,168
SIM,1930,37,25-29,1967,1
SIM,1836,33,35-39,1869,5
STAT,1914,27,25-29,1941,62.67263439737925
SIM,1858,31,20-24,1889,5
STAT,1905,42,20-24,1947,0.01503681167335304
SIM,1922,27,25-29,1949,78
STAT,1828,33,35-39,1861,10.523123146691958
SIM,1790,88,na,1878,31
SIM,1828,67,na,1895,813
SIM,1940,27,40-44,1967,5
STAT,1919,24,20-24,1943,114.30566148384922
SIM,1914,42,na,1956,3757
SIM,1824,53,na,1877,1221
SIM,1868,0,na,1868,3228
STAT,1840,38,40-44,1878,3.5684608677766954
STAT,1866,2,na,1868,2942.1754628111235
STAT,1896,40,50-100,1936,0.0925192798338735
STAT,1919,16,20-24,1935,28.46595493650477
SIM,1849,24,30-34,1873,14
STAT,1860,48,na,1908,1705.6329690746136
SIM,1777,90,na,1867,12
SIM,1849,29,na,1878,1849
SIM,1938,2,na,1940,3712
STAT,1914,26,35-39,1940,14.344648591359226
SIM,1914,30,20-24,1944,3
STAT,1882,52,50-100,1934,0.013809296125131916
STAT,1940,17,25-29,1957,41.562225692235245
STAT,1851,52,50-100,1903,0.011016136037153594
STAT,1926,42,40-44,1968,0.29133183348800573
STAT,1894,60,na,1954,2317.643383453452
SIM,1906,39,35-39,1945,10
STAT,1871,46,50-100,1917,0.23066812698932734
STAT,1874,53,35-39,1927,0.0081788549194162
STAT,1834,22,50-100,1856,0.33758763829599275
SIM,1826,33,na,1859,1658
SIM,1955,0,na,1955,4553
STAT,1898,74,na,1972,1855.3818534571312
SIM,1834,52,na,1886,1332
STAT,1870,49,30-34,1919,0.0877339268807462
SIM,1809,64,na,1873,916
SIM,1805,50,na,1855,1223
SIM,1888,21,40-44,1909,2
STAT,1829,32,na,1861,1743.5526402018834
SIM,1867,15,35-39,1882,1
SIM,1946,6,na,1952,4101
SIM,1921,28,20-24,1949,24
SIM,1925,44,40-44,1969,2
STAT,1827,30,na,1857,1641.6790930855725
STAT,1830,28,30-34,1858,23.096261505781843
SIM,1845,15,na,1860,2074
SIM,1918,37,25-29,1955,1
SIM,1877,25,na,1902,2341
STAT,1906,43,50-100,1949,0.10018868140726107
SIM,1942,17,na,1959,3475
STAT,1887,30,35-39,1917,10.785211801002026
STAT,1905,61,na,1966,2771.7360726560983
SIM,1922,26,35-39,1948,20
STAT,1854,54,20-24,1908,5.167591240271003E-4
STAT,1888,16,50-100,1904,0.05480971797036542
STAT,1914,30,50-100,1944,0.7924027619682376
STAT,1759,112,na,1871,3.154006184380137E-4
STAT,1826,35,50-100,1861,1.4085766419930368
STAT,1851,109,na,1960,0.0014203408314074591
STAT,1920,37,15-19,1957,0.01986361182261992
STAT,1855,40,40-44,1895,1.6090940509622298
STAT,1876,24,25-29,1900,55.479591946200244
SIM,1930,25,30-34,1955,56
SIM,1831,38,40-44,1869,2
STAT,1926,34,na,1960,4315.164276683988
SIM,1872,80,na,1952,485
STAT,1901,41,25-29,1942,0.05923114756057755
STAT,1901,21,30-34,1922,23.624058016465725
STAT,1913,47,25-29,1960,0.048900004683371016
SIM,1823,39,45-49,1862,1
STAT,1902,28,45-49,1930,1.4749882566090184
SIM,1889,3,na,1892,3115
SIM,1904,35,30-34,1939,1
STAT,1842,41,50-100,1883,0.788385235446925
SIM,1834,63,na,1897,1105
SIM,1879,27,na,1906,2348
SIM,1910,28,45-49,1938,1
SIM,1927,16,20-24,1943,171
STAT,1825,109,na,1934,4.022551700818279E-4
STAT,1936,28,15-19,1964,0.6378244259225715
STAT,1823,38,40-44,1861,6.581280269629863
STAT,1856,43,na,1899,1697.7192258949838
STAT,1859,15,35-39,1874,0.48590909592333964
STAT,1924,21,25-29,1945,103.28724990682713
SIM,1875,26,25-29,1901,40
SIM,1884,24,25-29,1908,57
SIM,1918,18,20-24,1936,128
STAT,1881,10,na,1891,2362.750264447107
SIM,1798,84,na,1882,108
STAT,1759,101,na,1860,0.05388086879043982
STAT,1815,39,45-49,1854,6.6612873522307945
SIM,1794,70,na,1864,634
STAT,1851,53,40-44,1904,0.007596143956273671
STAT,1929,43,20-24,1972,0.021573001644285363
STAT,1921,16,25-29,1937,46.78305803933084
SIM,1876,94,na,1970,91
SIM,1932,21,25-29,1953,132
STAT,1851,98,na,1949,2.3822086474534414
SIM,1870,14,na,1884,2431
STAT,1907,41,40-44,1948,0.21769506512665215
SIM,1932,29,35-39,1961,17
STAT,1919,48,30-34,1967,0.09108921236941793
STAT,1785,89,na,1874,36.5914548101194
STAT,1922,25,30-34,1947,42.172507334156904
STAT,1848,24,na,1872,1848.706924480061
STAT,1907,17,50-100,1924,0.06797461705517598
SIM,1917,39,na,1956,3615
SIM,1780,89,na,1869,31
STAT,1900,24,40-44,1924,2.713921391350204
STAT,1940,16,35-39,1956,4.025596216347833
SIM,1913,25,na,1938,3415
STAT,1781,75,na,1856,353.2646087523
STAT,1859,62,na,1921,1377.9713679027327
SIM,1839,62,na,1901,1317
SIM,1872,39,40-44,1911,3
STAT,1834,49,50-100,1883,0.15714688992116724
SIM,1925,31,35-39,1956,14
STAT,1830,29,na,1859,1681.4731082655276
STAT,1929,30,15-19,1959,0.15438515772052067
SIM,1876,83,na,1959,451
STAT,1909,54,na,1963,3105.083618535826
STAT,1939,28,40-44,1967,4.423980894005609
SIM,1847,81,na,1928,355
STAT,1907,36,45-49,1943,0.5998679580465559
STAT,1905,40,na,1945,3198.045207493084
SIM,1902,31,40-44,1933,8
STAT,1841,29,45-49,1870,0.9300338908696705
STAT,1929,38,25-29,1967,1.1930248359594848
STAT,1822,51,20-24,1873,0.0010105480907158608
STAT,1921,46,20-24,1967,0.011799358103266084
SIM,1901,22,35-39,1923,8
SIM,1913,21,15-19,1934,5
STAT,1819,49,30-34,1868,0.16706570433217638
STAT,1854,49,25-29,1903,0.040611410056680834
SIM,1860,29,20-24,1889,9
SIM,1898,19,na,1917,3175
STAT,1865,26,15-19,1891,0.3908151895913613
STAT,1876,36,50-100,1912,1.2031257300439822
STAT,1910,46,45-49,1956,0.19198199631687538
STAT,1912,22,45-49,1934,1.0184440161207127
SIM,1895,30,35-39,1925,18
SIM,1892,14,na,1906,3108
STAT,1810,52,40-44,1862,0.03573180986199474
STAT,1905,29,25-29,1934,57.33527814293287
STAT,1926,37,50-100,1963,0.48479527116711935
STAT,1899,37,25-29,1936,0.8045367855340879
STAT,1876,31,na,1907,2336.773402468901
SIM,1929,19,35-39,1948,6
STAT,1852,29,20-24,1881,9.312088150157686
SIM,1809,53,na,1862,1187
SIM,1915,36,45-49,1951,1
STAT,1811,51,45-49,1862,0.04701654286381499
STAT,1938,16,30-34,1954,11.385123969658137
STAT,1940,22,20-24,1962,106.99778889187667
SIM,1843,23,25-29,1866,54
SIM,1923,35,na,1958,4029
SIM,1946,16,30-34,1962,19
STAT,1917,27,15-19,1944,0.6993693394621485
STAT,1906,30,20-24,1936,2.152239959443916
STAT,1884,61,na,1945,1744.4455278658882
STAT,1864,39,40-44,1903,3.658774421141056
SIM,1872,30,40-44,1902,2
SIM,1913,29,25-29,1942,56
STAT,1918,36,20-24,1954,0.26374057870276085
STAT,1905,21,15-19,1926,4.5172775417181255
STAT,1888,75,na,1963,1396.077398931566
STAT,1903,24,50-100,1927,0.5446526893232391
SIM,1877,57,na,1934,1962
SIM,1873,43,na,1916,2202
SIM,1952,16,na,1968,4114
SIM,1933,30,30-34,1963,23
STAT,1902,33,40-44,1935,5.757087717881344
SIM,1853,39,30-34,1892,5
STAT,1838,52,50-100,1890,0.010245826347136605
STAT,1856,19,50-100,1875,0.04235840959297606
SIM,1829,49,50-100,1878,2
SIM,1939,29,45-49,1968,1
STAT,1835,23,25-29,1858,47.13724529927221
STAT,1926,38,20-24,1964,0.30407546719963663
SIM,1903,23,20-24,1926,91
STAT,1846,33,na,1879,1787.1438922488655
STAT,1866,32,na,1898,2078.4507592143113
STAT,1884,23,50-100,1907,0.37951221642277033
STAT,1836,40,30-34,1876,0.886085672072129
STAT,1873,54,30-34,1927,0.005550984437372131
STAT,1845,59,na,1904,1368.9398942818848
STAT,1876,42,na,1918,2251.273950013904
STAT,1830,101,na,1931,0.34086284457861316
STAT,1858,13,na,1871,2058.7268330201437
SIM,1847,20,40-44,1867,1
STAT,1901,16,35-39,1917,0.7273329070748917
SIM,1897,56,na,1953,2596
SIM,1893,42,na,1935,2880
STAT,1856,20,40-44,1876,1.816647139309832
SIM,1885,76,na,1961,1057
SIM,1881,62,na,1943,1532
STAT,1898,25,15-19,1923,0.5841433428585595
SIM,1868,24,40-44,1892,1
STAT,1921,17,15-19,1938,48.87409492903957
SIM,1927,17,na,1944,4251
STAT,1889,27,50-100,1916,0.7460553246208563
STAT,1929,37,35-39,1966,2.933700481135108
STAT,1946,18,30-34,1964,12.767646029668471
STAT,1915,35,40-44,1950,1.4420576770205795
SIM,1913,36,na,1949,3404
STAT,1893,16,25-29,1909,6.808913309023129
STAT,1935,36,20-24,1971,0.34852277556936884
SIM,1876,30,25-29,1906,11
STAT,1925,30,30-34,1955,17.69661674146286
STAT,1841,51,30-34,1892,0.004092170478825426
SIM,1908,57,na,1965,2915
STAT,1875,39,50-100,1914,1.1795784015337245
SIM,1910,33,40-44,1943,12
STAT,1920,40,45-49,1960,0.17413603027019556
STAT,1941,28,45-49,1969,1.687373890647512
STAT,1895,13,na,1908,3178.7819380480278
STAT,1922,39,50-100,1961,0.45039015305234864
SIM,1864,20,40-44,1884,3
SIM,1904,43,na,1947,3080
STAT,1936,27,25-29,1963,59.49677189745961
STAT,1911,31,40-44,1942,3.613807561189639
STAT,1941,23,na,1964,3563.664499787891
SIM,1825,70,na,1895,710
SIM,1944,27,25-29,1971,68
STAT,1843,25,25-29,1868,38.10377809061749
STAT,1847,50,na,1897,1607.0431774012154
STAT,1881,8,na,1889,2385.4524623855827
STAT,1949,17,45-49,1966,0.5488954680614968
STAT,1839,20,40-44,1859,1.8111620364414291
SIM,1851,25,25-29,1876,41
STAT,1802,86,na,1888,71.50379546636769
STAT,1880,79,na,1959,836.8030549823991
SIM,1845,47,na,1892,1588
STAT,1926,23,na,1949,4178.66523947271
SIM,1841,33,na,1874,1803
SIM,1897,45,na,1942,2908
SIM,1899,35,25-29,1934,3
STAT,1836,49,30-34,1885,0.06235341674495315
SIM,1893,31,na,1924,2996
STAT,1888,42,45-49,1930,1.6682092670936355
STAT,1937,32,15-19,1969,0.12008825627483663
SIM,1864,37,40-44,1901,6
STAT,1950,19,35-39,1969,4.684367954213599
STAT,1827,62,na,1889,1027.8165212260524
SIM,1940,23,25-29,1963,86
SIM,1910,16,15-19,1926,11
STAT,1905,46,50-100,1951,0.189664033254056
STAT,1902,20,35-39,1922,7.825976752424038
STAT,1882,52,30-34,1934,0.005442751907027293
SIM,1825,35,25-29,1860,1
STAT,1949,19,na,1968,4041.7071763368117
STAT,1949,22,40-44,1971,3.7067656644881657
STAT,1863,52,20-24,1915,6.095161482947135E-4
SIM,1870,7,na,1877,2532
STAT,1822,85,na,1907,141.59946417032796
STAT,1808,70,na,1878,714.40770617419
STAT,1826,99,na,1925,1.0337050819791564
SIM,1810,100,na,1910,1
SIM,1913,57,na,1970,3113
SIM,1928,28,30-34,1956,54
STAT,1862,30,30-34,1892,14.182795071732421
STAT,1921,20,45-49,1941,1.2078446031573988
SIM,1880,13,na,1893,2646
STAT,1894,20,25-29,1914,69.98109773890998
SIM,1765,89,na,1854,30
STAT,1826,39,20-24,1865,0.7896672944537784
STAT,1919,6,na,1925,4184.27525138841
STAT,1931,19,25-29,1950,53.298242914740946
STAT,1939,32,25-29,1971,8.907859411215838
STAT,1822,42,50-100,1864,1.5933185537618084
STAT,1919,34,50-100,1953,0.8354654571718595
STAT,1847,41,45-49,1888,1.1216309917382266
STAT,1884,26,25-29,1910,39.62557604558589
STAT,1910,32,50-100,1942,0.7528924312344176
SIM,1862,70,na,1932,1181
SIM,1862,3,na,1865,2658
STAT,1867,17,35-39,1884,0.49755880462625274
STAT,1813,49,na,1862,1269.6205299479748
STAT,1944,26,20-24,1970,18.645742987739208
SIM,1892,26,25-29,1918,61
SIM,1920,19,15-19,1939,45
SIM,1919,17,25-29,1936,65
STAT,1914,54,na,1968,3351.593763681175
STAT,1927,37,25-29,1964,1.1565873403841909
SIM,1923,35,40-44,1958,2
STAT,1912,19,15-19,1931,8.62097945288442
SIM,1890,27,40-44,1917,3
SIM,1910,20,35-39,1930,8
STAT,1901,40,35-39,1941,0.1679508759922547
STAT,1932,23,25-29,1955,114.14242411448257
STAT,1802,53,45-49,1855,0.040542994544404964
STAT,1902,16,15-19,1918,7.931066511425346
STAT,1910,40,na,1950,3352.4347856654263
STAT,1863,32,50-100,1895,0.7608627530054306
STAT,1845,39,30-34,1884,3.863282008817692
STAT,1929,18,30-34,1947,14.657480124819088
SIM,1866,84,na,1950,241
SIM,1834,25,25-29,1859,39
SIM,1938,17,35-39,1955,5
STAT,1898,42,na,1940,2962.2317419718925
SIM,1827,82,na,1909,251
SIM,1938,22,30-34,1960,34
SIM,1858,65,na,1923,1367
SIM,1922,23,30-34,1945,42
STAT,1879,82,na,1961,646.5142077854789
SIM,1854,51,na,1905,1725
SIM,1779,92,na,1871,13
STAT,1862,48,20-24,1910,0.009548549783779284
STAT,1846,29,50-100,1875,0.5378270004599257
STAT,1899,59,na,1958,2579.1236169787226
SIM,1937,18,30-34,1955,11
STAT,1920,21,40-44,1941,3.542108452403556
STAT,1879,37,50-100,1916,1.21231259232072
STAT,1901,48,45-49,1949,0.1738158770046026
STAT,1859,43,50-100,1902,0.7907313788456468
SIM,1912,37,30-34,1949,1
STAT,1923,17,25-29,1940,48.07577446272561
SIM,1914,33,25-29,1947,12
STAT,1880,25,50-100,1905,0.6401670625955066
SIM,1789,70,na,1859,639
SIM,1858,34,25-29,1892,8
STAT,1821,47,20-24,1868,0.01832413215105018
SIM,1911,32,45-49,1943,4
STAT,1905,26,20-24,1931,16.070214461494697
SIM,1885,41,30-34,1926,2
SIM,1867,58,na,1925,1717
SIM,1863,44,na,1907,1968
STAT,1768,101,na,1869,0.07750559302576628
STAT,1882,27,40-44,1909,2.7536723266354532
STAT,1872,28,na,1900,2254.9414059722603
SIM,1823,36,40-44,1859,3
STAT,1837,20,30-34,1857,15.038387116099178
SIM,1930,28,35-39,1958,22
STAT,1934,27,15-19,1961,0.8971363422545794
STAT,1919,19,25-29,1938,44.99773407878438
STAT,1873,98,na,1971,21.106769321253807
SIM,1801,68,na,1869,713
STAT,1905,45,25-29,1950,0.04479773880454535
SIM,1892,46,na,1938,2722
SIM,1820,71,na,1891,625
STAT,1900,36,35-39,1936,2.010412492746027
STAT,1856,16,20-24,1872,15.602169269661227
SIM,1924,27,35-39,1951,21
STAT,1906,33,25-29,1939,8.056233342009902
STAT,1948,18,40-44,1966,1.5118012310706856
STAT,1911,27,20-24,1938,16.813201039829053
SIM,1935,18,20-24,1953,141
STAT,1951,20,30-34,1971,32.463432654468306
SIM,1952,7,na,1959,4396
STAT,1849,84,na,1933,239.78057807821224
STAT,1845,16,45-49,1861,0.05849965614872166
SIM,1912,20,45-49,1932,1
STAT,1861,42,45-49,1903,1.1726338042278055
STAT,1950,16,na,1966,4112.922318361097
SIM,1924,28,50-100,1952,2
STAT,1879,16,15-19,1895,5.874358000073951
STAT,1845,70,na,1915,988.2992979899394
STAT,1922,28,35-39,1950,15.993818284666055
SIM,1886,20,40-44,1906,2
SIM,1907,15,40-44,1922,1
STAT,1825,38,50-100,1863,1.5096747415306733
STAT,1843,39,20-24,1882,0.5786618924800015
STAT,1881,30,40-44,1911,3.987506395246883
STAT,1910,22,35-39,1932,8.350922009490906
STAT,1904,21,50-100,1925,0.5541518679457422
SIM,1886,61,na,1947,1780
SIM,1865,24,15-19,1889,3
STAT,1853,15,40-44,1868,0.165108153530975
SIM,1931,17,25-29,1948,55
SIM,1933,24,45-49,1957,2
STAT,1947,22,30-34,1969,30.68818987316056
SIM,1898,27,30-34,1925,34
STAT,1924,15,50-100,1939,0.42347619012976856
STAT,1857,24,15-19,1881,2.544199580660544
SIM,1893,10,na,1903,3226
STAT,1957,7,na,1964,4894.975821201408
STAT,1897,27,50-100,1924,0.8081971935522044
STAT,1902,21,na,1923,3162.4792412814304
SIM,1897,24,na,1921,3013
SIM,1892,57,na,1949,2421
SIM,1918,34,20-24,1952,2
STAT,1872,43,50-100,1915,0.9944938406012027
STAT,1903,32,45-49,1935,2.3437546683926436
STAT,1915,40,15-19,1955,0.0014644947714493317
STAT,1906,35,na,1941,3297.498773249725
STAT,1871,54,20-24,1925,6.720889518255031E-4
STAT,1873,49,35-39,1922,0.13144418760531645
SIM,1904,19,30-34,1923,1
STAT,1876,20,30-34,1896,17.475173690741048
STAT,1897,17,20-24,1914,22.39849900141142
STAT,1919,53,na,1972,3684.279943551088
SIM,1923,19,40-44,1942,1
STAT,1931,35,25-29,1966,1.2340272218203834
STAT,1865,52,30-34,1917,0.005082732554854157
STAT,1921,49,25-29,1970,0.056165307816438186
SIM,1835,26,na,1861,1769
STAT,1885,20,50-100,1905,0.38609390879058214
STAT,1900,27,45-49,1927,1.455151643428908
STAT,1806,100,na,1906,0.35326081075270704
STAT,1912,35,15-19,1947,0.017870165034732946
STAT,1928,39,20-24,1967,0.3140833170993477
STAT,1832,100,na,1932,0.6419327210579376
SIM,1838,66,na,1904,1032
STAT,1889,60,na,1949,2224.2902611572244
SIM,1857,80,na,1937,434
STAT,1843,28,50-100,1871,0.5638918519448467
STAT,1820,41,45-49,1861,2.784859907696512
SIM,1933,24,na,1957,4578
STAT,1827,108,na,1935,0.0010165137747995654
STAT,1848,21,45-49,1869,0.6161067418374427
SIM,1914,24,35-39,1938,10
STAT,1832,48,35-39,1880,0.0990754807415458
STAT,1902,49,15-19,1951,2.9452185513787523E-4
SIM,1904,38,35-39,1942,4
STAT,1908,37,15-19,1945,0.016981151238661434
STAT,1836,66,na,1902,1035.0169258906099
STAT,1901,58,na,1959,2697.021173566934
STAT,1916,27,35-39,1943,14.664471710378312
STAT,1838,25,na,1863,1904.02383871987
STAT,1838,49,40-44,1887,0.11708838710191256
STAT,1851,15,50-100,1866,0.0441992420218792
STAT,1847,26,50-100,1873,0.5698227782600778
SIM,1854,29,na,1883,1909
SIM,1850,15,na,1865,2075
SIM,1946,19,35-39,1965,5
STAT,1915,19,40-44,1934,0.2750441445525655
STAT,1916,28,50-100,1944,0.9687843316922201
STAT,1925,38,na,1963,4261.957485870277
SIM,1913,26,20-24,1939,23
STAT,1926,45,45-49,1971,0.25456044315613213
SIM,1859,22,25-29,1881,47
STAT,1921,41,15-19,1962,0.0016365091402027346
STAT,1936,31,45-49,1967,1.4444828968981311
STAT,1817,52,na,1869,1190.6159630000345
SIM,1840,30,45-49,1870,1
STAT,1842,51,na,1893,1540.6340591040034
STAT,1930,27,30-34,1957,47.069358473136525
STAT,1927,18,20-24,1945,158.8490708290311
SIM,1788,85,na,1873,73
STAT,1921,24,na,1945,3872.4677018093057
SIM,1838,77,na,1915,537
SIM,1867,47,na,1914,1947
STAT,1855,80,na,1935,438.112652236861
STAT,1906,24,35-39,1930,7.977086711894977
STAT,1941,25,40-44,1966,4.558634594536329
STAT,1859,94,na,1953,15.067994559376064
STAT,1811,90,na,1901,34.14972439557209
STAT,1817,63,na,1880,908.7171698742117
SIM,1871,84,na,1955,291
SIM,1784,71,na,1855,471
SIM,1842,15,30-34,1857,2
STAT,1822,54,25-29,1876,0.004569526086620053
STAT,1866,30,15-19,1896,0.12503253755448668
STAT,1931,39,40-44,1970,1.8689710270125708
STAT,1832,30,45-49,1862,1.411072900716974
SIM,1837,21,35-39,1858,7
STAT,1854,48,50-100,1902,0.1746329507698676
STAT,1891,16,15-19,1907,6.956353197052689
STAT,1877,41,30-34,1918,1.1321388736156859
SIM,1849,27,35-39,1876,10
STAT,1841,26,40-44,1867,2.5640367767628613
STAT,1880,30,50-100,1910,0.9180673457194042
STAT,1772,115,na,1887,1.6088759449013596E-4
STAT,1955,15,na,1970,4618.108844750883
STAT,1850,15,15-19,1865,5.166049855972063
SIM,1883,16,30-34,1899,2
STAT,1936,24,20-24,1960,100.3418781586411
SIM,1912,17,15-19,1929,6
STAT,1859,40,25-29,1899,0.48902307623698305
STAT,1830,24,50-100,1854,0.908793772560877
SIM,1819,63,na,1882,936
STAT,1920,17,50-100,1937,0.3971141288525115
SIM,1788,74,na,1862,397
STAT,1850,81,na,1931,380.69946472787007
SIM,1858,38,40-44,1896,9
SIM,1830,37,50-100,1867,1
SIM,1897,15,20-24,1912,19
STAT,1789,109,na,1898,1.569780047918818E-4
STAT,1841,54,35-39,1895,0.005728267918945933
STAT,1942,17,35-39,1959,4.14239937014631
SIM,1886,24,35-39,1910,10
STAT,1859,21,20-24,1880,59.66453196205173
STAT,1896,41,40-44,1937,0.19589604100530383
STAT,1925,33,35-39,1958,10.246521097446568
SIM,1931,37,40-44,1968,1
STAT,1867,25,50-100,1892,0.5712569353534135
SIM,1933,33,35-39,1966,13
STAT,1875,16,30-34,1891,1.5507101388234592
SIM,1855,14,na,1869,2278
STAT,1904,17,15-19,1921,8.040266548017925
SIM,1859,28,na,1887,2005
SIM,1881,31,45-49,1912,1
STAT,1905,49,40-44,1954,0.12908189856451058
STAT,1923,37,40-44,1960,1.6387523810298363
STAT,1941,30,15-19,1971,0.1275916787007237
STAT,1932,20,20-24,1952,138.65337805015255
SIM,1903,26,25-29,1929,66
SIM,1939,30,25-29,1969,12
STAT,1854,95,na,1949,9.57404040210005
SIM,1944,24,20-24,1968,120
SIM,1848,15,25-29,1863,9
STAT,1820,38,15-19,1858,0.1197702964460137
SIM,1821,34,na,1855,1548
SIM,1774,93,na,1867,2
SIM,1953,8,na,1961,4367
STAT,1822,37,50-100,1859,2.2264872069197335
STAT,1878,24,35-39,1902,5.702990985431899
STAT,1889,15,20-24,1904,20.77235492507706
SIM,1825,48,na,1873,1321
STAT,1907,42,30-34,1949,0.11063250163915594
SIM,1863,45,50-100,1908,1
SIM,1905,27,25-29,1932,58
STAT,1829,50,40-44,1879,0.008538213210437698
STAT,1833,52,35-39,1885,0.005398708688569564
SIM,1929,16,30-34,1945,20
STAT,1924,29,35-39,1953,16.39754897726214
SIM,1914,10,na,1924,4176
SIM,1918,24,na,1942,3660
STAT,1901,45,40-44,1946,0.1289677100647263
SIM,1868,43,na,1911,2081
SIM,1867,21,20-24,1888,54
SIM,1805,71,na,1876,590
SIM,1839,51,na,1890,1494
STAT,1855,45,50-100,1900,0.17567709243645913
STAT,1915,44,30-34,1959,0.12117716756720986
SIM,1809,85,na,1894,120
STAT,1938,19,35-39,1957,3.907246965845272
SIM,1904,15,15-19,1919,6
SIM,1925,39,45-49,1964,3
STAT,1917,39,45-49,1956,0.6648258266057597
STAT,1890,46,na,1936,2606.4893819977106
STAT,1795,99,na,1894,0.36585685263196627
STAT,1915,38,45-49,1953,0.6472990887416754
SIM,1813,90,na,1903,35
SIM,1869,40,35-39,1909,1
SIM,1940,20,20-24,1960,99
SIM,1868,27,45-49,1895,4
SIM,1838,26,20-24,1864,10
STAT,1935,16,na,1951,4764.959966314656
STAT,1917,31,35-39,1948,9.076623996027223
STAT,1897,38,40-44,1935,5.503172522133858
SIM,1914,21,na,1935,3801
STAT,1854,107,na,1961,0.01201245717035051
STAT,1868,26,40-44,1894,2.7112021518605705
SIM,1903,58,na,1961,2768
SIM,1918,35,na,1953,3737
STAT,1813,48,25-29,1861,0.1713015555805212
STAT,1911,34,45-49,1945,1.4348309642080272
STAT,1924,41,40-44,1965,0.28149248287338124
SIM,1889,16,25-29,1905,7
SIM,1960,0,na,1960,4676
STAT,1933,32,30-34,1965,20.057998720035688
STAT,1931,16,20-24,1947,168.05594418114313
STAT,1874,83,na,1957,443.1727415267676
SIM,1887,46,na,1933,2361
SIM,1916,21,40-44,1937,5
STAT,1823,48,na,1871,1353.3252865069944
STAT,1903,25,20-24,1928,15.874429934707548
SIM,1906,31,25-29,1937,11
STAT,1829,41,50-100,1870,0.9025902582584858
STAT,1880,39,25-29,1919,2.833113527853297
SIM,1814,86,na,1900,94
SIM,1900,34,35-39,1934,15
SIM,1870,30,30-34,1900,23
STAT,1914,32,20-24,1946,2.3190633883540666
STAT,1830,53,20-24,1883,4.6635745251305316E-4
SIM,1840,48,na,1888,1548
SIM,1797,99,na,1896,1
SIM,1899,39,40-44,1938,1
STAT,1858,36,25-29,1894,2.145575199111359
STAT,1918,43,45-49,1961,0.16689654254255964
STAT,1943,29,45-49,1972,1.7363713677167598
SIM,1793,85,na,1878,64
STAT,1849,26,30-34,1875,21.671771434507647
STAT,1873,31,45-49,1904,1.6789991480832236
STAT,1907,17,40-44,1924,0.25377196538365204
SIM,1853,66,na,1919,1283
SIM,1927,19,25-29,1946,52
SIM,1857,102,na,1959,1
STAT,1937,19,50-100,1956,0.3432504868662094
SIM,1911,25,20-24,1936,20
STAT,1839,95,na,1934,8.865094085020644
STAT,1835,81,na,1916,337.39907416264884
STAT,1890,29,40-44,1919,3.4352282650244703
SIM,1948,16,40-44,1964,2
SIM,1922,32,20-24,1954,2
STAT,1892,37,50-100,1929,1.452428021920146
SIM,1856,95,na,1951,3
SIM,1852,81,na,1933,394
SIM,1908,19,15-19,1927,9
STAT,1913,28,20-24,1941,17.118032489914274
STAT,1804,101,na,1905,0.19337242115548625
STAT,1837,51,na,1888,1391.4165075936312
STAT,1908,21,40-44,1929,2.9282947214684687
SIM,1858,30,30-34,1888,18
SIM,1879,27,20-24,1906,10
STAT,1851,66,na,1917,1201.913079274549
STAT,1871,29,30-34,1900,23.4153844583071
STAT,1904,37,30-34,1941,1.5585106628072392
STAT,1943,21,35-39,1964,9.466560726032247
SIM,1834,22,20-24,1856,57
SIM,1864,23,45-49,1887,1
STAT,1965,0,na,1965,4670.2678039950215
SIM,1868,40,50-100,1908,1
STAT,1868,48,15-19,1916,3.562571644443322E-4
SIM,1814,40,45-49,1854,3
STAT,1839,36,15-19,1875,0.04521104090643303
SIM,1813,44,50-100,1857,1
SIM,1941,26,45-49,1967,3
STAT,1923,42,15-19,1965,0.001695779784133222
STAT,1772,93,na,1865,5.530762759171468
STAT,1861,17,40-44,1878,0.1649173223709881
STAT,1861,39,15-19,1900,0.04360857984748962
STAT,1869,30,40-44,1899,3.9975296140864702
STAT,1889,38,na,1927,2734.0815737700527
SIM,1857,26,30-34,1883,26
SIM,1883,32,na,1915,2268
STAT,1893,75,na,1968,1595.805177691041
STAT,1916,24,na,1940,3592.204585571312
SIM,1859,39,na,1898,1946
STAT,1878,21,30-34,1899,17.570421786525433
STAT,1869,61,na,1930,1708.7491208784897
STAT,1857,28,na,1885,1817.5691462829718
STAT,1856,23,45-49,1879,0.594918338630005
STAT,1912,10,na,1922,3783.1928936126924
STAT,1933,26,45-49,1959,2.168041718010628
SIM,1929,35,35-39,1964,6
STAT,1868,22,50-100,1890,0.3678175833201313
STAT,1878,15,45-49,1893,0.06454005816901143
STAT,1885,24,na,1909,2212.000193661862
SIM,1950,17,35-39,1967,6
STAT,1852,31,25-29,1883,8.14148250843601
STAT,1853,14,na,1867,2110.3751768797206
SIM,1881,16,20-24,1897,18
STAT,1900,21,15-19,1921,4.336719867073168
STAT,1835,27,40-44,1862,2.43590398055474
SIM,1855,39,40-44,1894,4
SIM,1894,22,40-44,1916,2
SIM,1909,42,na,1951,3276
SIM,1933,22,30-34,1955,37
STAT,1864,94,na,1958,25.139275980527135
STAT,1850,23,15-19,1873,2.767596008897533
STAT,1875,36,25-29,1911,2.807819791953704
SIM,1802,85,na,1887,67
SIM,1897,23,20-24,1920,89
STAT,1822,38,25-29,1860,4.953218867492062
SIM,1764,94,na,1858,2
STAT,1805,83,na,1888,140.14153883919477
SIM,1847,59,na,1906,1366
SIM,1866,30,na,1896,2121
SIM,1830,38,25-29,1868,1
STAT,1858,27,35-39,1885,7.325494522423418
STAT,1822,53,na,1875,1221.8128141837124
STAT,1905,18,na,1923,3438.8115462041574
STAT,1913,37,na,1950,3506.622177034994
STAT,1854,29,30-34,1883,18.73765393774573
STAT,1856,37,40-44,1893,3.2388880193683462
STAT,1898,21,20-24,1919,88.39321686107817
SIM,1920,49,50-100,1969,4
STAT,1814,42,45-49,1856,4.661457572656081
SIM,1855,78,na,1933,581
SIM,1858,11,na,1869,2246
SIM,1866,27,35-39,1893,8
SIM,1890,39,35-39,1929,11
STAT,1849,21,25-29,1870,50.24791269479428
SIM,1935,30,40-44,1965,11
SIM,1909,35,45-49,1944,3
STAT,1889,23,20-24,1912,80.1223669293321
SIM,1885,44,35-39,1929,3
STAT,1856,75,na,1931,761.6928029380742
SIM,1857,21,25-29,1878,58
STAT,1881,64,na,1945,1585.6331573148009
STAT,1864,48,30-34,1912,0.08070235074838066
SIM,1848,23,25-29,1871,51
STAT,1861,37,50-100,1898,0.9631355424454282
STAT,1877,44,35-39,1921,1.7512100103518145
SIM,1848,36,30-34,1884,8
SIM,1929,33,20-24,1962,3
STAT,1942,29,15-19,1971,0.6992302079647522
STAT,1873,16,20-24,1889,17.100759871099896
SIM,1787,89,na,1876,27
SIM,1922,30,50-100,1952,5
STAT,1817,43,25-29,1860,1.5591659176476784
STAT,1945,21,45-49,1966,1.1653526386853432
SIM,1846,15,15-19,1861,5
STAT,1867,25,35-39,1892,8.616668557753636
STAT,1883,65,na,1948,1564.6807121746976
SIM,1918,33,45-49,1951,1
SIM,1876,54,50-100,1930,1
SIM,1883,36,25-29,1919,3
STAT,1882,26,15-19,1908,0.41849735265180626
SIM,1826,48,50-100,1874,2
SIM,1839,30,20-24,1869,2
SIM,1872,48,na,1920,2093
SIM,1822,42,45-49,1864,1
STAT,1892,33,20-24,1925,3.184242390077329
SIM,1830,92,na,1922,16
SIM,1920,39,30-34,1959,1
STAT,1871,38,20-24,1909,0.7183526879968473
STAT,1869,52,50-100,1921,0.013736989397247427
SIM,1901,31,25-29,1932,15
SIM,1863,97,na,1960,10
STAT,1894,38,15-19,1932,0.06790169011113516
STAT,1871,32,na,1903,2234.883990025687
STAT,1818,49,15-19,1867,8.288111736910244E-4
STAT,1845,48,na,1893,1564.8334876130264
STAT,1864,19,50-100,1883,0.04228793609148526
STAT,1884,34,25-29,1918,9.480012990254115
SIM,1926,22,na,1948,4085
STAT,1848,42,15-19,1890,0.009936677480507358
STAT,1856,65,na,1921,1250.3931069936611
STAT,1827,47,15-19,1874,3.504514491675026E-4
SIM,1832,83,na,1915,238
STAT,1825,42,20-24,1867,0.1773927900491287
SIM,1938,31,20-24,1969,2
SIM,1910,39,na,1949,3277
STAT,1865,17,25-29,1882,5.012854613241287
STAT,1875,24,30-34,1899,17.179275304766534
STAT,1890,25,na,1915,2775.1998041398656
SIM,1879,80,na,1959,723
SIM,1889,24,25-29,1913,80
SIM,1909,52,na,1961,3105
STAT,1880,19,30-34,1899,1.5758074184576383
SIM,1838,98,na,1936,4
STAT,1944,27,50-100,1971,1.0162572539873351
SIM,1887,16,15-19,1903,7
SIM,1832,26,40-44,1858,3
SIM,1925,23,35-39,1948,11
SIM,1927,31,45-49,1958,1
STAT,1916,24,30-34,1940,28.272222994356664
STAT,1918,32,40-44,1950,3.928369276821349
STAT,1870,15,na,1885,2388.1972805423356
STAT,1930,39,50-100,1969,0.5162821340920146
STAT,1790,90,na,1880,28.909294542161796
STAT,1837,22,45-49,1859,0.5762579494311411
STAT,1912,39,30-34,1951,1.6631756408980893
SIM,1879,36,50-100,1915,2
STAT,1855,106,na,1961,0.028568211050674898
SIM,1811,49,50-100,1860,2
STAT,1861,19,20-24,1880,15.797448694720721
STAT,1950,16,30-34,1966,13.619908659805347
SIM,1902,23,40-44,1925,2
SIM,1905,24,20-24,1929,81
STAT,1815,48,35-39,1863,0.33511077717374377
STAT,1778,111,na,1889,0.0010923974118423438
STAT,1830,37,20-24,1867,0.611772117281701
SIM,1942,20,30-34,1962,30
STAT,1889,43,15-19,1932,0.015989671382755172
STAT,1788,86,na,1874,69.04351641592383
STAT,1858,46,50-100,1904,0.18266137443384065
STAT,1900,62,na,1962,2546.6848335593522
SIM,1942,15,35-39,1957,5
STAT,1835,28,na,1863,1746.390823195823
SIM,1855,26,20-24,1881,11
STAT,1899,28,35-39,1927,12.447662196403341
STAT,1837,29,na,1866,1727.6297839301042
STAT,1856,97,na,1953,3.9748897752312655
STAT,1925,42,25-29,1967,0.08168330353845613
SIM,1865,20,20-24,1885,65
STAT,1939,24,25-29,1963,87.56512592349105
STAT,1863,39,25-29,1902,2.3668608545078738
STAT,1849,34,30-34,1883,12.988680972335647
STAT,1853,37,15-19,1890,0.041644662850427706
STAT,1866,43,20-24,1909,0.13732518466179472
STAT,1876,23,35-39,1899,5.673497990592711
SIM,1926,32,40-44,1958,7
STAT,1919,31,45-49,1950,1.6103647992774832
STAT,1934,15,35-39,1949,5.38659529883874
SIM,1907,32,30-34,1939,19
STAT,1891,17,40-44,1908,0.21386977613576666
STAT,1841,25,15-19,1866,0.39115272037369336
SIM,1888,25,20-24,1913,12
STAT,1886,22,40-44,1908,2.0798999292617046
STAT,1847,39,40-44,1886,3.273158891688698
SIM,1906,20,20-24,1926,82
STAT,1850,49,40-44,1899,0.11800872244274094
STAT,1870,15,40-44,1885,0.17295198218988378
STAT,1915,15,25-29,1930,8.607207244444213
SIM,1849,50,na,1899,1627
STAT,1836,26,45-49,1862,0.913814693899737
STAT,1935,27,45-49,1962,2.224603524294496
STAT,1777,111,na,1888,0.0011578308693502859
SIM,1785,88,na,1873,37
STAT,1853,23,40-44,1876,1.8128083902805578
SIM,1876,26,40-44,1902,2
SIM,1929,20,15-19,1949,6
SIM,1843,27,40-44,1870,3
STAT,1843,47,na,1890,1615.5924925994454
STAT,1917,23,35-39,1940,9.424281652184074
STAT,1882,39,35-39,1921,6.43634599929762
STAT,1859,30,na,1889,1825.3061410486332
STAT,1847,26,20-24,1873,10.450098028079493
STAT,1765,91,na,1856,15.853992767999998
STAT,1873,45,na,1918,2178.8993168539378
SIM,1909,40,40-44,1949,5
SIM,1860,47,na,1907,1878
SIM,1947,24,25-29,1971,99
STAT,1843,33,25-29,1876,8.791928009243474
SIM,1877,25,45-49,1902,1
STAT,1848,78,na,1926,562.8904681460144
SIM,1861,23,40-44,1884,7
STAT,1934,20,30-34,1954,36.6071317357384
SIM,1827,31,40-44,1858,6
SIM,1851,33,25-29,1884,12
SIM,1889,37,30-34,1926,4
SIM,1923,15,25-29,1938,56
SIM,1830,70,na,1900,892
SIM,1804,86,na,1890,54
STAT,1798,86,na,1884,71.8553629092863
SIM,1924,24,30-34,1948,48
STAT,1805,51,na,1856,1183.467271381419
STAT,1900,23,50-100,1923,0.5327944014212321
STAT,1944,25,45-49,1969,1.7654359047116133
STAT,1871,64,na,1935,1628.0481892102378
STAT,1927,25,45-49,1952,1.997802121011633
SIM,1838,21,15-19,1859,2
SIM,1868,11,na,1879,2409
STAT,1938,20,15-19,1958,4.979839282932086
SIM,1849,32,30-34,1881,21
STAT,1813,70,na,1883,709.7800212702948
STAT,1880,21,35-39,1901,5.817970076284703
SIM,1925,36,40-44,1961,1
SIM,1933,7,na,1940,5070
STAT,1868,21,35-39,1889,5.301534015488394
SIM,1881,4,na,1885,2234
STAT,1886,17,45-49,1903,0.06519996984435529
SIM,1911,21,40-44,1932,2
SIM,1933,26,50-100,1959,1
SIM,1866,32,30-34,1898,20
SIM,1890,77,na,1967,1334
SIM,1843,77,na,1920,577
SIM,1916,30,30-34,1946,22
STAT,1767,102,na,1869,0.05847650357210771
STAT,1924,30,15-19,1954,0.14228511815361167
SIM,1867,23,35-39,1890,7
SIM,1882,24,15-19,1906,2
STAT,1896,44,45-49,1940,0.12800814657657794
SIM,1819,39,30-34,1858,7
STAT,1850,19,45-49,1869,0.05553558404925236
SIM,1943,27,45-49,1970,5
STAT,1839,27,25-29,1866,35.53247962547213
STAT,1865,22,20-24,1887,59.87668478515152
SIM,1847,27,25-29,1874,42
STAT,1930,39,na,1969,4626.258197607787
STAT,1820,72,na,1892,672.7875865840105
STAT,1829,53,45-49,1882,0.010092364762019192
STAT,1835,29,20-24,1864,9.403171416703316
STAT,1909,37,45-49,1946,0.6094235608164841
STAT,1947,23,20-24,1970,118.68786264622094
STAT,1808,48,na,1856,1293.6435034463836
STAT,1868,76,na,1944,854.5363379004788
STAT,1873,77,na,1950,828.8728272807839
STAT,1844,39,15-19,1883,0.040800986156898804
STAT,1915,18,na,1933,3808.404014939977
SIM,1946,20,15-19,1966,3
SIM,1893,26,40-44,1919,8
SIM,1935,25,45-49,1960,3
SIM,1856,22,20-24,1878,70
STAT,1796,73,na,1869,534.0320646471525
STAT,1851,35,25-29,1886,2.178753407504015
STAT,1847,29,na,1876,1885.7798668231417
STAT,1917,36,40-44,1953,1.4758845414292387
SIM,1826,29,20-24,1855,12
STAT,1903,21,40-44,1924,2.8091635407965017
SIM,1817,37,40-44,1854,3
STAT,1860,27,na,1887,1851.9085636849695
SIM,1932,26,30-34,1958,60
STAT,1859,39,45-49,1898,1.4878121499850998
SIM,1870,67,na,1937,1457
SIM,1855,46,na,1901,1794
SIM,1882,15,25-29,1897,5
SIM,1772,91,na,1863,16
SIM,1826,35,40-44,1861,3
STAT,1876,28,40-44,1904,2.9111563964059433
SIM,1878,25,50-100,1903,3
STAT,1828,39,30-34,1867,4.8426930609909355
SIM,1889,80,na,1969,1075
STAT,1839,44,15-19,1883,0.009459325337778166
STAT,1858,32,30-34,1890,12.948643490582569
SIM,1843,29,20-24,1872,11
SIM,1898,22,25-29,1920,72
SIM,1903,22,45-49,1925,4
SIM,1857,34,30-34,1891,18
STAT,1834,48,45-49,1882,0.15295141220334266
STAT,1924,26,30-34,1950,43.25051706516365
SIM,1927,34,50-100,1961,1
SIM,1836,24,45-49,1860,1
STAT,1848,22,20-24,1870,60.44930952055681
SIM,1919,52,na,1971,3700
STAT,1857,20,20-24,1877,60.109097232752944
STAT,1899,45,25-29,1944,0.042482896264178886
STAT,1891,24,15-19,1915,3.8334219182591784
SIM,1884,28,40-44,1912,3
SIM,1833,25,30-34,1858,23
STAT,1929,22,15-19,1951,6.359675083888833
SIM,1858,4,na,1862,2370
STAT,1865,58,na,1923,1697.6583422017827
STAT,1874,15,25-29,1889,5.517339993282742
STAT,1876,95,na,1971,67.3279154452981
SIM,1836,39,30-34,1875,5
STAT,1812,53,na,1865,1196.1623471211503
STAT,1885,26,40-44,1911,2.829038225131912
STAT,1824,33,15-19,1857,0.28826782028905623
SIM,1862,48,na,1910,1941
SIM,1937,22,15-19,1959,7
STAT,1923,37,na,1960,4118.480898519339
SIM,1850,47,na,1897,1648
SIM,1883,10,na,1893,2460
SIM,1877,42,35-39,1919,2
SIM,1946,20,na,1966,3797
STAT,1894,16,40-44,1910,0.22281339539485115
STAT,1845,81,na,1926,380.90443040266734
SIM,1858,33,35-39,1891,13
STAT,1828,30,50-100,1858,1.0613859852996321
SIM,1869,60,na,1929,1717
STAT,1899,25,30-34,1924,32.82200134624625
STAT,1860,70,na,1930,1077.223793655031
STAT,1814,42,50-100,1856,3.2904406300927596
STAT,1904,20,45-49,1924,0.9503842840331768
STAT,1954,16,15-19,1970,53.01449389563388
STAT,1868,98,na,1966,12.748006708190896
STAT,1877,27,45-49,1904,1.0884490013517225
SIM,1886,44,50-100,1930,1
STAT,1880,25,na,1905,2388.2941228209315
STAT,1938,33,20-24,1971,2.3152339472431844
SIM,1916,22,na,1938,3527
STAT,1855,15,15-19,1870,5.058543338237209
STAT,1915,1,na,1916,4115.129944332641
STAT,1886,4,na,1890,2625.752973396166
SIM,1873,17,25-29,1890,4
SIM,1917,37,45-49,1954,3
SIM,1852,25,40-44,1877,4
STAT,1805,73,na,1878,513.316668058642
STAT,1903,59,na,1962,2753.205794515752
STAT,1800,54,50-100,1854,0.04234400248542572
STAT,1835,49,15-19,1884,2.5641239063872387E-4
STAT,1855,26,na,1881,1774.5172110386284
STAT,1875,49,45-49,1924,0.22426464727042908
SIM,1862,29,30-34,1891,20
STAT,1840,32,45-49,1872,1.4791635405412327
SIM,1836,43,50-100,1879,1
STAT,1850,41,50-100,1891,0.7471098448027607
STAT,1953,15,45-49,1968,0.5711812095171106
STAT,1881,33,45-49,1914,1.583904507342259
STAT,1929,20,na,1949,4388.879860034458
SIM,1835,25,40-44,1860,2
STAT,1844,25,40-44,1869,2.611690184754137
STAT,1932,20,50-100,1952,0.8204828258782668
SIM,1818,36,45-49,1854,1
STAT,1917,40,25-29,1957,0.07059263391478561
STAT,1908,30,30-34,1938,14.158756085427823
SIM,1868,32,40-44,1900,3
SIM,1842,28,na,1870,1800
STAT,1895,15,45-49,1910,0.08090372231125358
SIM,1910,1,na,1911,3759
SIM,1911,28,25-29,1939,75
STAT,1890,38,30-34,1928,6.125273512988798
STAT,1856,49,35-39,1905,0.10142237957540098
SIM,1863,37,25-29,1900,4
SIM,1863,15,15-19,1878,6
SIM,1879,22,15-19,1901,2
STAT,1949,21,15-19,1970,5.8703781161969495
STAT,1930,17,na,1947,4495.69787726901
SIM,1856,10,na,1866,2270
SIM,1876,21,35-39,1897,6
SIM,1916,25,35-39,1941,19
SIM,1845,29,30-34,1874,20
STAT,1834,35,25-29,1869,2.263338593115624
STAT,1927,30,40-44,1957,4.553268659515299
STAT,1884,31,20-24,1915,2.5337249624927445
STAT,1948,22,25-29,1970,100.1994562635376
STAT,1869,42,35-39,1911,1.6538360940537276
SIM,1873,27,40-44,1900,2
STAT,1869,6,na,1875,2541.6387654798336
STAT,1823,47,30-34,1870,0.11547209858402871
STAT,1880,48,15-19,1928,3.9260318892421866E-4
STAT,1903,28,25-29,1931,56.65438004799362
SIM,1842,18,na,1860,2007
STAT,1845,24,45-49,1869,0.6010438150426533
STAT,1855,16,na,1871,1945.0843891883717
STAT,1867,22,30-34,1889,15.864591014582565
SIM,1898,35,30-34,1933,8
STAT,1943,26,40-44,1969,4.69142931904499
STAT,1910,31,25-29,1941,8.450893584468888
STAT,1837,29,30-34,1866,20.111453019513455
SIM,1842,35,25-29,1877,1
STAT,1908,25,35-39,1933,13.610160401126988
STAT,1839,32,20-24,1871,2.217967853555088
SIM,1892,31,20-24,1923,6
SIM,1918,22,50-100,1940,3
SIM,1870,33,35-39,1903,9
SIM,1875,22,30-34,1897,14
SIM,1847,32,20-24,1879,2
SIM,1918,30,40-44,1948,3
STAT,1849,46,25-29,1895,0.04163542742198426
STAT,1927,33,45-49,1960,1.8276970311920913
STAT,1902,25,40-44,1927,4.020623900397453
SIM,1882,26,na,1908,2172
STAT,1860,38,45-49,1898,1.5229273297976065
STAT,1892,36,25-29,1928,3.4225035940276327
STAT,1817,40,20-24,1857,0.4347661638969848
STAT,1880,47,na,1927,2225.9122584999845
SIM,1827,34,45-49,1861,2
SIM,1906,36,30-34,1942,2
STAT,1886,25,45-49,1911,1.1157388930095231
STAT,1839,37,40-44,1876,3.487998608909762
STAT,1852,27,40-44,1879,2.6508887480555354
STAT,1849,17,40-44,1866,0.16227822142013523
SIM,1916,22,30-34,1938,34
SIM,1922,18,na,1940,4070
SIM,1870,99,na,1969,9
SIM,1846,32,na,1878,1805
SIM,1908,25,na,1933,3281
STAT,1870,18,45-49,1888,0.06068351578848845
STAT,1966,1,na,1967,4644.903476294137
SIM,1933,25,35-39,1958,23
STAT,1874,50,30-34,1924,0.005829966412250389
STAT,1920,16,45-49,1936,0.5307859306668157
STAT,1942,22,30-34,1964,28.466875440236834
SIM,1894,25,45-49,1919,1
STAT,1815,51,na,1866,1227.9168441388379
STAT,1825,45,25-29,1870,0.062083110192659385
STAT,1835,31,25-29,1866,8.221115887671619
STAT,1917,41,na,1958,3666.56912923242
STAT,1898,33,15-19,1931,0.18134624459587173
STAT,1877,38,15-19,1915,0.054776225914888704
STAT,1897,45,15-19,1942,2.8791036238435977E-4
STAT,1845,48,20-24,1893,0.008346369564201548
STAT,1893,43,na,1936,2759.775262266279
STAT,1868,34,40-44,1902,3.878128965321834
SIM,1929,36,25-29,1965,1
SIM,1881,29,40-44,1910,4
STAT,1925,25,35-39,1950,16.867761902436403
STAT,1929,2,na,1931,4931.1110740683735
STAT,1873,29,40-44,1902,2.851941080054559
STAT,1878,76,na,1954,931.7265161611135
SIM,1917,42,40-44,1959,1
STAT,1825,71,na,1896,754.6884242321851
SIM,1851,30,20-24,1881,1
STAT,1895,32,35-39,1927,12.484644821456689
SIM,1871,19,30-34,1890,1
STAT,1768,88,na,1856,25.543693110000003
STAT,1844,39,50-100,1883,0.8920578118639112
STAT,1932,15,25-29,1947,54.46166666897384
SIM,1885,27,45-49,1912,4
SIM,1892,0,na,1892,3305
SIM,1948,20,25-29,1968,99
STAT,1925,29,15-19,1954,0.7821643378067661
STAT,1812,49,20-24,1861,0.038220834222361375
STAT,1832,31,na,1863,1710.4200418799348
SIM,1814,64,na,1878,865
STAT,1863,77,na,1940,717.8029798366019
SIM,1909,32,40-44,1941,3
SIM,1840,15,20-24,1855,12
SIM,1843,31,25-29,1874,11
STAT,1908,22,30-34,1930,24.955558916217157
SIM,1847,26,50-100,1873,1
STAT,1886,31,50-100,1917,0.9182641506442132
SIM,1876,34,40-44,1910,6
SIM,1961,1,na,1962,4712
STAT,1885,2,na,1887,2937.594852670607
SIM,1865,23,25-29,1888,46
STAT,1838,46,na,1884,1598.9863702390699
SIM,1822,73,na,1895,614
STAT,1856,36,15-19,1892,0.04174839755671945
SIM,1842,71,na,1913,901
SIM,1792,68,na,1860,662
SIM,1827,29,na,1856,1613
STAT,1889,39,30-34,1928,6.153178734915165
SIM,1842,23,30-34,1865,18
STAT,1900,30,na,1930,3152.61335418664
STAT,1940,21,50-100,1961,0.633369555369521
STAT,1909,42,40-44,1951,0.22095394722087922
STAT,1884,17,35-39,1901,0.5122417796557514
STAT,1834,23,30-34,1857,14.63995140769288
STAT,1868,44,na,1912,2056.5458472237565
SIM,1872,43,50-100,1915,3
STAT,1855,43,45-49,1898,1.0523186109683214
SIM,1822,36,25-29,1858,2
SIM,1836,41,35-39,1877,2
STAT,1865,27,40-44,1892,2.571526356349283
SIM,1848,76,na,1924,664
SIM,1860,27,40-44,1887,3
STAT,1856,6,na,1862,2182.607017659264
SIM,1872,33,45-49,1905,2
STAT,1843,30,20-24,1873,2.3936353730509916
STAT,1935,24,40-44,1959,4.32229840296552
SIM,1940,15,25-29,1955,51
STAT,1935,32,40-44,1967,5.11436694181521
SIM,1775,88,na,1863,40
STAT,1863,19,30-34,1882,1.3582474839348142
SIM,1929,19,na,1948,4500
SIM,1850,21,15-19,1871,2
STAT,1844,19,20-24,1863,15.634665087155637
SIM,1883,24,30-34,1907,20
STAT,1828,41,35-39,1869,1.6243729095035202
STAT,1826,37,40-44,1863,4.744173009775683
SIM,1840,70,na,1910,914
SIM,1942,23,35-39,1965,9
STAT,1863,13,na,1876,2251.8284784729376
STAT,1857,15,25-29,1872,5.019260290060788
STAT,1793,87,na,1880,57.21022905115017
SIM,1916,28,50-100,1944,6
STAT,1892,16,30-34,1908,1.8901893343110563
STAT,1857,16,50-100,1873,0.0431385807483336
SIM,1834,49,50-100,1883,3
SIM,1839,33,25-29,1872,15
STAT,1840,26,25-29,1866,36.99723160504949
STAT,1934,21,na,1955,4637.591130131543
SIM,1883,20,15-19,1903,2
STAT,1780,90,na,1870,24.638789790350206
SIM,1926,39,25-29,1965,3
STAT,1881,27,25-29,1908,38.58498628733132
STAT,1918,39,25-29,1957,0.9782915504485048
SIM,1865,46,na,1911,1935
SIM,1876,62,na,1938,1754
STAT,1842,21,15-19,1863,2.9845589705280196
STAT,1898,38,50-100,1936,0.33720505258511263
SIM,1873,22,20-24,1895,67
STAT,1876,15,35-39,1891,0.5376178531613695
SIM,1873,97,na,1970,19
SIM,1923,20,20-24,1943,125
STAT,1839,26,50-100,1865,0.5412167468655176
SIM,1879,7,na,1886,2643
STAT,1910,62,na,1972,2946.654689408033
STAT,1934,23,35-39,1957,11.94982843483861
SIM,1862,31,35-39,1893,11
STAT,1882,17,25-29,1899,5.2091405243790785
STAT,1893,28,40-44,1921,3.5778921975097284
SIM,1869,27,na,1896,2165
STAT,1868,41,50-100,1909,0.9572069650927929
SIM,1833,99,na,1932,2
SIM,1876,41,50-100,1917,4
STAT,1909,39,50-100,1948,0.37155247121163276
SIM,1888,28,25-29,1916,51
SIM,1832,29,45-49,1861,3
STAT,1946,22,15-19,1968,5.596197139757947
STAT,1764,104,na,1868,0.022802212280541058
STAT,1848,38,30-34,1886,3.915862073778215
SIM,1863,65,na,1928,1441
SIM,1864,29,na,1893,2110
STAT,1838,78,na,1916,532.8879053224439
STAT,1860,25,25-29,1885,33.30180648097105
STAT,1858,24,30-34,1882,13.595287412446003
STAT,1837,49,25-29,1886,0.03679037449014204
STAT,1836,37,15-19,1873,0.043526269278167995
STAT,1951,19,15-19,1970,51.02247454491251
STAT,1826,49,50-100,1875,0.22356000670148693
STAT,1908,28,50-100,1936,0.8855570693941501
STAT,1750,118,na,1868,0.0014406041602118024
STAT,1884,82,na,1966,716.7954482770959
STAT,1930,26,50-100,1956,1.196234844106716
STAT,1951,15,35-39,1966,4.72320828396638
SIM,1908,31,35-39,1939,9
SIM,1848,98,na,1946,2
SIM,1856,38,30-34,1894,4
STAT,1866,46,25-29,1912,0.05031140698311099
SIM,1884,32,25-29,1916,13
STAT,1876,32,25-29,1908,9.989155162547252
SIM,1866,36,25-29,1902,2
SIM,1844,26,45-49,1870,1
SIM,1852,19,20-24,1871,23
STAT,1898,24,25-29,1922,72.74894000725378
STAT,1929,35,20-24,1964,0.32028591565524345
SIM,1866,24,30-34,1890,19
SIM,1903,39,30-34,1942,1
SIM,1848,20,20-24,1868,65
SIM,1902,26,45-49,1928,1
STAT,1780,105,na,1885,0.017603752977388573
STAT,1928,26,15-19,1954,0.8245267262292674
SIM,1865,15,25-29,1880,9
STAT,1833,47,na,1880,1455.678574815705
SIM,1931,22,20-24,1953,128
STAT,1899,42,20-24,1941,0.014259811488481544
SIM,1861,37,50-100,1898,3
SIM,1919,33,50-100,1952,5
STAT,1854,31,35-39,1885,7.545849262338569
SIM,1888,38,40-44,1926,4
STAT,1833,27,30-34,1860,20.27344682787124
STAT,1883,22,15-19,1905,3.0544578481948945
STAT,1807,64,na,1871,866.9535865300312
STAT,1833,43,50-100,1876,0.7690712953239496
STAT,1858,44,25-29,1902,0.4698142916197506
STAT,1886,49,20-24,1935,0.011727409418556219
SIM,1939,26,40-44,1965,5
STAT,1841,38,35-39,1879,5.642671006712253
STAT,1859,36,40-44,1895,3.316191373544044
SIM,1847,24,20-24,1871,67
STAT,1915,20,20-24,1935,104.80892136798919
SIM,1934,21,35-39,1955,16
STAT,1843,16,35-39,1859,0.508890925261449
STAT,1810,52,na,1862,1229.3320756147602
STAT,1830,40,na,1870,1571.897597785463
SIM,1871,39,25-29,1910,2
SIM,1867,9,na,1876,2385
STAT,1896,38,25-29,1934,3.5769403522249643
STAT,1927,22,40-44,1949,3.913926573071344
SIM,1804,54,na,1858,1076
SIM,1899,26,35-39,1925,18
SIM,1935,22,40-44,1957,4
STAT,1910,18,15-19,1928,8.470447262923944
SIM,1857,59,na,1916,1538
STAT,1831,49,30-34,1880,0.06936406123813098
SIM,1909,43,45-49,1952,1
STAT,1845,21,40-44,1866,1.835351940421817
STAT,1897,37,15-19,1934,0.07094653623733771
STAT,1818,38,45-49,1856,6.099839524617734
STAT,1829,47,25-29,1876,0.04647715244581221
STAT,1932,32,15-19,1964,0.16138391098515947
STAT,1872,3,na,1875,2953.6183975096046
STAT,1888,27,20-24,1915,13.09241877925977
STAT,1923,22,20-24,1945,122.2349474990124
SIM,1859,92,na,1951,51
SIM,1922,39,40-44,1961,1
STAT,1850,16,40-44,1866,0.1582800406105199
SIM,1853,21,40-44,1874,2
SIM,1943,24,40-44,1967,3
SIM,1826,38,45-49,1864,2
SIM,1852,28,45-49,1880,3
STAT,1869,93,na,1962,61.58373028939586
STAT,1876,10,na,1886,2565.1451632060657
STAT,1846,65,na,1911,1191.5460217489317
SIM,1868,35,45-49,1903,1
SIM,1852,71,na,1923,992
STAT,1879,24,15-19,1903,3.2371692574099873
SIM,1858,33,na,1891,1897
STAT,1906,42,15-19,1948,0.0013175614303915211
SIM,1867,20,30-34,1887,15
STAT,1827,33,40-44,1860,4.832185844526723
SIM,1822,83,na,1905,169
STAT,1862,33,35-39,1895,8.126334457227067
STAT,1869,25,45-49,1894,1.022190169344832
STAT,1939,20,na,1959,3466.6081780749832
STAT,1851,15,30-34,1866,1.4379489661282279
SIM,1897,39,30-34,1936,3
STAT,1866,48,40-44,1914,0.14723970854131688
STAT,1847,34,20-24,1881,2.081354351287849
SIM,1900,39,na,1939,3048
SIM,1924,32,30-34,1956,23
SIM,1850,69,na,1919,1067
SIM,1909,20,na,1929,3342
SIM,1930,27,na,1957,4441
SIM,1899,57,na,1956,2605
SIM,1797,89,na,1886,43
SIM,1859,50,na,1909,1825
SIM,1928,24,15-19,1952,6
SIM,1916,33,35-39,1949,12
STAT,1839,24,20-24,1863,58.19416846314707
STAT,1866,26,30-34,1892,22.008427370052186
STAT,1894,24,40-44,1918,2.516434168719404
STAT,1908,33,35-39,1941,8.112560808116585
STAT,1898,16,25-29,1914,7.264563144560452
STAT,1800,74,na,1874,460.4505957759702
SIM,1890,9,na,1899,3108
SIM,1908,23,35-39,1931,10
SIM,1915,38,na,1953,3531
STAT,1844,28,45-49,1872,0.9473188552855388
SIM,1858,25,35-39,1883,9
SIM,1899,21,50-100,1920,1
SIM,1905,32,20-24,1937,1
STAT,1838,23,15-19,1861,2.8982654476631295
STAT,1950,20,15-19,1970,5.970290528859508
SIM,1892,34,25-29,1926,13
SIM,1891,51,na,1942,2617
SIM,1835,33,40-44,1868,2
SIM,1797,67,na,1864,761
SIM,1844,43,35-39,1887,7
STAT,1865,54,50-100,1919,0.012608351719474524
STAT,1861,21,25-29,1882,46.46922740671209
STAT,1916,32,30-34,1948,15.36592421257661
SIM,1852,28,na,1880,1934
STAT,1857,23,25-29,1880,48.86478475320224
STAT,1919,23,45-49,1942,1.1603423201157936
STAT,1879,1,na,1880,3380.661590805722
SIM,1889,21,20-24,1910,77
STAT,1922,4,na,1926,4413.109600918819
SIM,1846,10,na,1856,2153
SIM,1917,34,40-44,1951,4
STAT,1893,65,na,1958,2097.928183774803
SIM,1839,25,25-29,1864,43
SIM,1893,29,45-49,1922,2
SIM,1924,2,na,1926,4570
STAT,1850,17,na,1867,1974.7222011251056
STAT,1907,21,25-29,1928,79.66619470857884
STAT,1881,42,na,1923,2105.5879097539737
SIM,1847,37,40-44,1884,3
SIM,1932,22,15-19,1954,4
STAT,1908,20,15-19,1928,4.649612266672181
SIM,1921,15,15-19,1936,44
SIM,1837,82,na,1919,253
STAT,1873,24,20-24,1897,65.66708719013319
STAT,1917,44,40-44,1961,0.24575910741806878
STAT,1878,23,45-49,1901,0.683663592847541
STAT,1836,43,35-39,1879,1.3430271576577884
SIM,1915,21,25-29,1936,96
SIM,1859,37,45-49,1896,1
SIM,1891,22,15-19,1913,7
STAT,1885,29,45-49,1914,1.0375256113246631
SIM,1910,25,40-44,1935,5
STAT,1863,99,na,1962,4.432889695644411
SIM,1834,21,30-34,1855,19
STAT,1887,42,50-100,1929,1.114763597680886
SIM,1949,15,45-49,1964,1
STAT,1913,15,15-19,1928,8.80451458170804
STAT,1862,16,45-49,1878,0.060645077378618885
SIM,1941,21,na,1962,3443
STAT,1851,32,20-24,1883,2.063112230480815
SIM,1808,90,na,1898,28
SIM,1945,5,na,1950,3964
STAT,1855,48,na,1903,1573.3986346420252
SIM,1896,27,20-24,1923,14
SIM,1811,89,na,1900,32
SIM,1916,20,15-19,1936,5
SIM,1850,54,50-100,1904,1
STAT,1926,21,35-39,1947,10.84043527525729
STAT,1815,53,50-100,1868,0.034430012219990765
SIM,1841,27,30-34,1868,29
STAT,1909,34,40-44,1943,3.4967251869647034
SIM,1935,33,45-49,1968,1
STAT,1835,71,na,1906,832.8218421993294
SIM,1927,23,45-49,1950,2
STAT,1919,20,50-100,1939,0.6847272854939843
STAT,1775,113,na,1888,4.3968400300273676E-4
STAT,1858,35,35-39,1893,5.295305060782612
SIM,1886,23,45-49,1909,1
STAT,1920,40,na,1960,3885.8941904118687
SIM,1840,28,40-44,1868,1
SIM,1846,23,15-19,1869,5
SIM,1880,77,na,1957,964
STAT,1832,28,40-44,1860,2.4296150799255836
STAT,1858,41,20-24,1899,0.11831337628419965
SIM,1892,36,50-100,1928,1
SIM,1853,34,na,1887,1926
STAT,1843,79,na,1922,504.37324958718904
STAT,1886,41,na,1927,2317.3424215467235
STAT,1866,17,40-44,1883,0.16351524285646565
SIM,1824,32,na,1856,1589
STAT,1945,26,15-19,1971,0.7319921567200123
STAT,1883,26,30-34,1909,23.39510403271714
STAT,1912,49,50-100,1961,0.20409597630166115
SIM,1824,35,30-34,1859,3
SIM,1919,21,45-49,1940,1
SIM,1868,41,30-34,1909,1
STAT,1888,49,30-34,1937,0.05966545966746328
STAT,1942,25,35-39,1967,14.898276634234737
SIM,1887,56,na,1943,2101
SIM,1925,32,25-29,1957,14
STAT,1878,22,na,1900,2325.913022935348
STAT,1900,42,50-100,1942,0.09602933958052594
SIM,1826,31,25-29,1857,17
SIM,1924,15,40-44,1939,2
SIM,1880,26,20-24,1906,10
STAT,1842,110,na,1952,1.9678382947698963E-4
STAT,1926,30,25-29,1956,10.571012963242717
SIM,1872,16,na,1888,2374
STAT,1825,47,40-44,1872,0.1795119820610704
SIM,1881,23,45-49,1904,1
STAT,1874,24,15-19,1898,3.16537111740499
SIM,1882,28,30-34,1910,27
SIM,1947,15,35-39,1962,4
SIM,1929,8,na,1937,4892
SIM,1832,51,na,1883,1384
SIM,1842,26,35-39,1868,8
STAT,1843,38,45-49,1881,1.512093238187926
STAT,1812,47,50-100,1859,0.808152155304891
SIM,1847,35,25-29,1882,1
SIM,1886,32,35-39,1918,10
STAT,1922,26,20-24,1948,19.581414462396033
STAT,1882,21,45-49,1903,0.6429481788670204
SIM,1944,18,na,1962,3716
STAT,1899,49,40-44,1948,0.12241182373568729
SIM,1851,38,45-49,1889,2
STAT,1911,39,15-19,1950,0.0173418683139723
SIM,1913,28,35-39,1941,13
SIM,1958,4,na,1962,4848
STAT,1816,49,40-44,1865,0.43659315162369666
STAT,1909,45,45-49,1954,0.19042985594662046
STAT,1783,87,na,1870,45.636553583481756
STAT,1878,32,35-39,1910,9.959488636336607
SIM,1874,1,na,1875,3125
STAT,1916,15,40-44,1931,0.28163871423639253
STAT,1849,48,50-100,1897,0.17480188659571747
STAT,1903,60,na,1963,2726.472166251004
SIM,1834,30,20-24,1864,2
SIM,1941,27,35-39,1968,19
STAT,1839,49,35-39,1888,0.09270355780984996
SIM,1911,3,na,1914,3843
SIM,1854,39,25-29,1893,1
SIM,1890,21,45-49,1911,4
SIM,1893,22,25-29,1915,68
STAT,1854,31,na,1885,1778.0809830671526
STAT,1889,28,40-44,1917,3.4813446953178864
STAT,1839,35,25-29,1874,2.3422889301865326
STAT,1811,69,na,1880,737.6464156606597
STAT,1905,28,35-39,1933,13.12592051949799
SIM,1904,53,na,1957,2862
STAT,1857,39,35-39,1896,5.214548068261979
STAT,1933,27,35-39,1960,18.83257401022059
STAT,1823,39,30-34,1862,7.546804041667995
SIM,1796,72,na,1868,508
STAT,1854,38,20-24,1892,0.5523306175224019
STAT,1893,21,20-24,1914,82.84899432162331
SIM,1858,22,30-34,1880,19
SIM,1835,36,45-49,1871,1
STAT,1863,48,15-19,1911,3.279914871338717E-4
STAT,1935,35,45-49,1970,0.9020518997613416
STAT,1943,25,na,1968,3772.1562951726464
STAT,1890,16,20-24,1906,20.527224389755833
SIM,1897,28,40-44,1925,2
SIM,1920,18,25-29,1938,55
STAT,1867,81,na,1948,479.6583766209523
STAT,1846,25,15-19,1871,0.3926092787428204
STAT,1855,37,25-29,1892,2.039153372123306
STAT,1885,22,25-29,1907,53.87838810708621
SIM,1888,16,30-34,1904,4
STAT,1837,27,15-19,1864,0.36760815244720907
STAT,1846,39,25-29,1885,2.0763631171427765
STAT,1912,18,25-29,1930,8.254620593457904
STAT,1897,28,25-29,1925,53.2561413312127
STAT,1940,29,40-44,1969,4.485224490286082
SIM,1885,66,na,1951,1538
SIM,1846,43,45-49,1889,4
STAT,1914,39,40-44,1953,1.397531502887274
STAT,1933,20,15-19,1953,6.710282524220315
SIM,1868,64,na,1932,1542
STAT,1911,26,45-49,1937,1.5967173999812063
SIM,1850,25,30-34,1875,26
STAT,1875,27,35-39,1902,9.36465193064173
STAT,1809,45,40-44,1854,0.6480437400185888
SIM,1894,31,30-34,1925,24
STAT,1860,51,40-44,1911,0.008121377412541845
STAT,1900,19,45-49,1919,0.08515187664166655
STAT,1853,29,15-19,1882,0.34962883125970895
SIM,1915,37,35-39,1952,10
STAT,1886,63,na,1949,1780.9571636697078
STAT,1919,36,15-19,1955,0.019507084126149113
SIM,1919,20,40-44,1939,2
STAT,1904,49,25-29,1953,0.04310072374207489
STAT,1861,28,45-49,1889,0.8710356716772637
SIM,1900,23,30-34,1923,27
STAT,1858,18,45-49,1876,0.056257001426813405
STAT,1952,20,25-29,1972,104.9925715516905
SIM,1921,23,na,1944,3821
SIM,1847,15,30-34,1862,4
SIM,1877,52,50-100,1929,1
SIM,1909,39,25-29,1948,1
STAT,1886,28,15-19,1914,0.4512574256435473
SIM,1849,82,na,1931,281
STAT,1869,34,35-39,1903,9.18127653839098
SIM,1877,22,40-44,1899,2
SIM,1879,38,25-29,1917,1
STAT,1800,84,na,1884,111.85050964429018
SIM,1877,34,35-39,1911,8
STAT,1843,37,40-44,1880,3.6868872899358034
STAT,1857,48,50-100,1905,0.18061250992391636
SIM,1861,31,na,1892,2080
SIM,1871,17,15-19,1888,6
SIM,1884,37,45-49,1921,1
SIM,1838,37,25-29,1875,2
STAT,1838,43,45-49,1881,1.072494318375183
SIM,1942,19,15-19,1961,40
STAT,1827,36,45-49,1863,2.042671051425337
STAT,1874,28,30-34,1902,24.228333229041414
STAT,1878,44,na,1922,2242.3134190725914
SIM,1864,38,30-34,1902,4
STAT,1859,20,30-34,1879,15.533429244819287
STAT,1894,27,45-49,1921,1.349262851851033
STAT,1892,38,40-44,1930,5.152929603708212
SIM,1831,25,20-24,1856,10
SIM,1831,39,30-34,1870,3
STAT,1863,17,15-19,1880,5.623461668916472
SIM,1929,24,30-34,1953,45
SIM,1865,37,35-39,1902,14
SIM,1883,27,35-39,1910,11
SIM,1911,23,na,1934,3476
STAT,1917,32,25-29,1949,9.142814639389599
STAT,1919,40,35-39,1959,0.20672061103567504
STAT,1839,48,30-34,1887,0.06492437581792511
STAT,1865,25,25-29,1890,36.5597985031674
SIM,1941,20,15-19,1961,5
STAT,1882,48,25-29,1930,0.05228350004518353
STAT,1857,35,50-100,1892,0.9230461864767667
STAT,1846,12,na,1858,2114.4081350536007
SIM,1910,26,50-100,1936,5
STAT,1842,39,40-44,1881,3.259291817599246
STAT,1890,17,25-29,1907,6.5452244370564525
STAT,1842,25,30-34,1867,22.497939989368337
STAT,1899,49,50-100,1948,0.17560948532434856
STAT,1932,40,na,1972,4768.483798581187
STAT,1862,48,50-100,1910,0.19542697783721724
SIM,1882,29,35-39,1911,15
SIM,1932,34,30-34,1966,31
STAT,1907,41,na,1948,3232.4037129205026
SIM,1831,26,25-29,1857,38
SIM,1902,27,20-24,1929,17
SIM,1930,26,20-24,1956,21
SIM,1874,81,na,1955,467
SIM,1845,31,35-39,1876,13
SIM,1851,37,40-44,1888,6
STAT,1875,15,40-44,1890,0.17833913019719
SIM,1807,47,50-100,1854,2
STAT,1876,36,40-44,1912,4.28973106017145
SIM,1879,42,45-49,1921,1
STAT,1908,46,40-44,1954,0.13568317362152707
STAT,1923,25,25-29,1948,71.88006962271531
SIM,1850,39,40-44,1889,4
STAT,1939,15,35-39,1954,3.97727406128061
STAT,1785,101,na,1886,0.13718906365645564
STAT,1871,23,35-39,1894,5.448293240573642
STAT,1874,29,35-39,1903,9.249758996339178
SIM,1919,19,na,1938,3802
SIM,1860,20,20-24,1880,56
STAT,1871,11,na,1882,2484.014620932379
STAT,1907,37,35-39,1944,2.1181459820819137
STAT,1924,34,30-34,1958,17.343834933331653
SIM,1884,36,40-44,1920,6
STAT,1848,37,50-100,1885,0.9114892666495622
SIM,1836,32,na,1868,1700
SIM,1867,39,45-49,1906,3
STAT,1848,34,15-19,1882,0.10663708544111364
STAT,1849,43,20-24,1892,0.11364406408105573
STAT,1841,16,25-29,1857,5.030104082076004
SIM,1873,25,25-29,1898,39
SIM,1902,63,na,1965,2606
STAT,1833,69,na,1902,890.9309760257175
SIM,1892,39,45-49,1931,2
STAT,1841,98,na,1939,2.2226245213814972
STAT,1852,23,25-29,1875,51.297421481169216
STAT,1827,39,15-19,1866,0.053425954508959414
STAT,1891,26,30-34,1917,29.54641345454802
STAT,1832,22,45-49,1854,1.0481890048893987
STAT,1907,30,15-19,1937,0.1143658197823396
STAT,1944,8,na,1952,4014.3565347596536
STAT,1905,34,20-24,1939,2.100712072255354
SIM,1822,51,na,1873,1317
SIM,1914,25,25-29,1939,71
SIM,1912,29,30-34,1941,42
STAT,1819,40,30-34,1859,2.413536566281926
SIM,1875,25,35-39,1900,15
STAT,1846,107,na,1953,0.0033250891043960116
SIM,1838,45,na,1883,1507
STAT,1931,18,35-39,1949,5.175098761633496
STAT,1861,24,50-100,1885,0.3239453953473762
STAT,1925,26,50-100,1951,1.1145535662425772
SIM,1901,18,15-19,1919,7
STAT,1833,79,na,1912,424.4198364135201
SIM,1843,35,40-44,1878,8
STAT,1941,26,30-34,1967,38.30559760847814
SIM,1787,90,na,1877,19
STAT,1921,29,30-34,1950,40.96259284705332
STAT,1906,25,25-29,1931,58.58499932890131
SIM,1854,61,na,1915,1447
STAT,1838,39,25-29,1877,2.320832440768366
SIM,1834,37,40-44,1871,4
STAT,1809,108,na,1917,7.694749900566449E-4
STAT,1885,14,na,1899,2422.735493787019
STAT,1839,15,30-34,1854,1.406751069173767
STAT,1835,35,40-44,1870,3.4475177280203795
STAT,1936,20,40-44,1956,3.038345937090893
SIM,1838,41,45-49,1879,3
SIM,1875,39,45-49,1914,1
STAT,1845,27,15-19,1872,0.3889854013886856
STAT,1873,36,15-19,1909,0.05410624581714829
SIM,1932,18,na,1950,4476
SIM,1848,27,40-44,1875,6
STAT,1873,38,30-34,1911,5.0852280578037306
SIM,1860,23,25-29,1883,50
STAT,1886,31,30-34,1917,17.49818322687478
STAT,1862,27,15-19,1889,0.366958483454261
STAT,1910,30,na,1940,3471.686125097671
STAT,1856,15,30-34,1871,1.41101141373124
STAT,1926,37,45-49,1963,0.7871623900387288
STAT,1937,18,na,1955,3373.402440296158
SIM,1887,44,45-49,1931,3
SIM,1913,34,20-24,1947,2
STAT,1869,22,40-44,1891,1.9055114724715247
SIM,1807,84,na,1891,81
STAT,1915,23,25-29,1938,89.91337457470092
SIM,1907,35,35-39,1942,5
STAT,1930,39,25-29,1969,1.2107406431793806
SIM,1859,21,35-39,1880,6
STAT,1842,26,35-39,1868,8.558622407422588
STAT,1875,20,15-19,1895,3.220932187885127
STAT,1900,19,na,1919,3292.2819148767335
STAT,1911,19,20-24,1930,25.486315330863558
STAT,1887,37,20-24,1924,0.8143991694123552
STAT,1841,20,45-49,1861,0.6131661201102627
STAT,1856,29,40-44,1885,2.2638353898169026
STAT,1934,36,40-44,1970,1.9532801091324874
STAT,1955,16,30-34,1971,15.289006507772267
SIM,1855,17,30-34,1872,2
STAT,1899,19,45-49,1918,0.08411387725991716
STAT,1847,17,30-34,1864,1.463708915876307
SIM,1928,39,35-39,1967,11
SIM,1865,36,30-34,1901,5
SIM,1872,26,na,1898,2230
STAT,1817,37,50-100,1854,4.257489013842471
STAT,1858,49,45-49,1907,0.17137020922773769
STAT,1817,47,40-44,1864,0.383042520127738
STAT,1870,35,50-100,1905,1.147277346410061
STAT,1904,29,30-34,1933,33.87317904337584
SIM,1907,49,50-100,1956,1
STAT,1893,48,50-100,1941,0.16396840270048374
SIM,1853,12,na,1865,2291
STAT,1826,30,20-24,1856,4.07941799281208
STAT,1879,44,45-49,1923,1.4578825885582933
SIM,1895,37,20-24,1932,1
STAT,1950,9,na,1959,4389.7961141630685
SIM,1850,26,35-39,1876,6
SIM,1794,91,na,1885,13
SIM,1864,29,40-44,1893,4
STAT,1884,38,40-44,1922,4.066303347163447
STAT,1917,51,na,1968,3578.7383507248783
SIM,1935,36,na,1971,4974
STAT,1814,87,na,1901,72.69147797527688
STAT,1878,31,50-100,1909,0.9047664016850415
STAT,1878,28,15-19,1906,0.4446243022192847
SIM,1803,91,na,1894,13
SIM,1934,37,45-49,1971,1
STAT,1920,17,20-24,1937,143.70239498731524
STAT,1845,30,30-34,1875,14.929583551545901
STAT,1840,17,na,1857,2069.7314762019237
STAT,1851,37,40-44,1888,3.2444711481116073
STAT,1830,72,na,1902,754.3921348731334
SIM,1923,23,25-29,1946,105
STAT,1931,24,20-24,1955,135.39105995047754
STAT,1864,43,50-100,1907,0.885530281057144
SIM,1875,38,40-44,1913,5
STAT,1866,22,15-19,1888,2.896875475574612
SIM,1892,38,40-44,1930,4
STAT,1817,48,45-49,1865,0.5197411800289211
SIM,1881,38,30-34,1919,7
STAT,1916,35,35-39,1951,2.3620906491705815
SIM,1854,83,na,1937,262
STAT,1832,37,30-34,1869,4.085698318902428
STAT,1883,27,35-39,1910,8.933625506653417
SIM,1944,20,40-44,1964,2
STAT,1841,47,25-29,1888,0.03958809312290733
STAT,1889,35,15-19,1924,0.0661134739935029
SIM,1900,26,35-39,1926,16
STAT,1914,24,20-24,1938,106.62867036085474
SIM,1891,27,35-39,1918,13
STAT,1822,47,15-19,1869,5.579963606582321E-4
SIM,1922,24,20-24,1946,122
SIM,1875,31,20-24,1906,2
SIM,1927,20,40-44,1947,4
STAT,1860,5,na,1865,2226.566217162602
SIM,1874,22,15-19,1896,1
SIM,1912,41,na,1953,3247
SIM,1829,27,30-34,1856,20
STAT,1900,40,40-44,1940,0.2067722154608452
SIM,1840,37,30-34,1877,4
SIM,1917,30,25-29,1947,12
STAT,1872,15,15-19,1887,5.712762702576086
SIM,1908,20,30-34,1928,27
STAT,1947,17,35-39,1964,4.465637216433931
STAT,1867,38,40-44,1905,3.863588181619825
STAT,1828,43,50-100,1871,0.9164836499196556
SIM,1824,36,35-39,1860,9
STAT,1847,37,25-29,1884,2.1980180322206078
STAT,1840,49,na,1889,1540.0484320792837
STAT,1951,0,na,1951,4938.28130137531
SIM,1874,26,30-34,1900,28
STAT,1915,36,30-34,1951,1.7475482926833936
SIM,1910,21,25-29,1931,85
SIM,1924,35,35-39,1959,6
SIM,1893,63,na,1956,2190
STAT,1884,39,45-49,1923,1.8422688930596622
SIM,1831,32,45-49,1863,1
SIM,1903,18,25-29,1921,6
STAT,1873,5,na,1878,2649.695686252108
SIM,1891,26,30-34,1917,29
SIM,1853,30,30-34,1883,21
STAT,1897,32,45-49,1929,2.203171754061556
STAT,1858,104,na,1962,0.17329722728895883
SIM,1819,41,35-39,1860,3
STAT,1836,30,50-100,1866,0.746702086169232
STAT,1831,25,20-24,1856,11.000388857613633
STAT,1890,23,45-49,1913,0.8029364898338719
SIM,1823,37,30-34,1860,4
STAT,1855,32,50-100,1887,0.6607332262723881
STAT,1867,39,45-49,1906,1.750427283679249
SIM,1896,18,30-34,1914,2
SIM,1905,38,na,1943,3217
SIM,1880,15,15-19,1895,6
STAT,1846,38,20-24,1884,0.5617081718892596
SIM,1859,34,40-44,1893,3
STAT,1834,97,na,1931,3.3251836614039476
STAT,1856,27,25-29,1883,32.43248136046169
STAT,1783,103,na,1886,0.04400981520447387
STAT,1877,20,50-100,1897,0.4021490801984198
SIM,1934,30,25-29,1964,19
SIM,1885,20,25-29,1905,47
STAT,1868,37,45-49,1905,1.7980792251319293
SIM,1904,23,15-19,1927,4
STAT,1774,113,na,1887,4.526732256590834E-4
STAT,1871,17,15-19,1888,5.59386005310316
STAT,1888,18,30-34,1906,1.774114097204349
STAT,1909,38,20-24,1947,0.23448533465343407
STAT,1882,28,30-34,1910,23.066980521536166
STAT,1919,20,40-44,1939,3.498956174311923
SIM,1876,37,45-49,1913,2
SIM,1885,44,na,1929,2155
SIM,1890,28,30-34,1918,41
STAT,1823,32,45-49,1855,4.6559936329018035
SIM,1923,36,30-34,1959,2
STAT,1902,21,25-29,1923,76.54728869210551
STAT,1857,32,15-19,1889,0.106713005287701
SIM,1889,37,na,1926,2772
SIM,1839,22,20-24,1861,66
STAT,1878,44,50-100,1922,1.0249461279288654
STAT,1918,36,na,1954,3764.071453319425
SIM,1857,27,na,1884,1967
SIM,1864,27,25-29,1891,44
STAT,1928,0,na,1928,5363.180881824495
STAT,1816,38,35-39,1854,26.13107298606948
STAT,1849,30,na,1879,1846.8616332761792
SIM,1884,39,45-49,1923,1
SIM,1939,22,25-29,1961,82
SIM,1872,27,25-29,1899,46
STAT,1856,31,45-49,1887,1.3196726562247794
STAT,1857,36,30-34,1893,3.9883112017190347
SIM,1799,90,na,1889,20
SIM,1883,33,20-24,1916,2
STAT,1872,29,25-29,1901,39.823628936479324
STAT,1909,30,25-29,1939,8.39696021477587
SIM,1869,32,35-39,1901,13
STAT,1889,26,25-29,1915,49.50426752182017
STAT,1933,15,40-44,1948,1.777060987524707
STAT,1907,34,30-34,1941,13.790780146921826
STAT,1833,23,15-19,1856,2.7475474217199536
SIM,1797,57,na,1854,1097
STAT,1808,47,40-44,1855,0.6517318272012648
STAT,1923,29,40-44,1952,5.019732172718086
SIM,1867,36,40-44,1903,3
STAT,1829,25,15-19,1854,1.3017437712038125
STAT,1917,47,45-49,1964,0.21444739023816575
STAT,1917,20,30-34,1937,29.028116173735583
STAT,1819,64,na,1883,916.59533308198
STAT,1859,32,25-29,1891,7.722150809544734
STAT,1864,27,25-29,1891,35.71554496063276
STAT,1927,18,na,1945,4312.617836227831
STAT,1854,27,15-19,1881,0.3424971004614422
SIM,1869,59,na,1928,1749
SIM,1838,39,40-44,1877,4
STAT,1878,26,15-19,1904,0.4477261316667887
SIM,1910,29,20-24,1939,15
SIM,1930,37,na,1967,4569
STAT,1846,36,20-24,1882,0.5734953895757173
STAT,1936,16,20-24,1952,122.89990569886409
STAT,1871,96,na,1967,34.141882623960555
STAT,1875,33,20-24,1908,2.6123504503659265
SIM,1841,23,15-19,1864,2
SIM,1929,40,na,1969,4668
SIM,1808,47,na,1855,1275
SIM,1860,79,na,1939,547
STAT,1902,29,20-24,1931,15.527982300900575
STAT,1924,37,35-39,1961,2.694653033631771
STAT,1831,27,20-24,1858,10.290904764335203
STAT,1832,32,50-100,1864,0.7252963877057163
STAT,1840,39,30-34,1879,4.299695648862589
STAT,1871,20,30-34,1891,16.781511310127062
STAT,1928,20,40-44,1948,3.9899500086757684
SIM,1915,34,30-34,1949,17
STAT,1903,38,50-100,1941,0.3543988048640298
STAT,1932,36,30-34,1968,2.3155315912185173
SIM,1834,33,25-29,1867,14
SIM,1842,37,40-44,1879,5
STAT,1893,15,35-39,1908,0.6607472976864988
STAT,1840,50,na,1890,1521.0504283688879
SIM,1864,31,45-49,1895,1
SIM,1944,16,20-24,1960,127
SIM,1859,82,na,1941,347
SIM,1933,20,15-19,1953,6
SIM,1941,24,30-34,1965,33
STAT,1876,39,45-49,1915,1.9245915788842745
SIM,1934,17,15-19,1951,47
STAT,1865,39,35-39,1904,6.01060380920487
STAT,1888,47,15-19,1935,4.4432252947554065E-4
SIM,1932,5,na,1937,4881
STAT,1953,19,25-29,1972,49.49054655831268
STAT,1941,22,15-19,1963,5.196428252377445
SIM,1863,12,na,1875,2333
SIM,1834,24,35-39,1858,4
SIM,1880,29,25-29,1909,45
SIM,1814,54,na,1868,1152
STAT,1937,5,na,1942,3694.704322210696
SIM,1824,38,35-39,1862,15
STAT,1863,67,na,1930,1316.3864204346503
SIM,1881,20,40-44,1901,1
SIM,1925,20,30-34,1945,33
STAT,1841,18,40-44,1859,0.16044804225840179
STAT,1861,25,40-44,1886,2.401382915158537
STAT,1880,15,na,1895,2522.1124206660656
SIM,1891,29,35-39,1920,18
SIM,1846,64,na,1910,1196
STAT,1833,49,40-44,1882,0.10823274939872422
SIM,1937,26,30-34,1963,36
STAT,1850,27,na,1877,1792.2047133247704
SIM,1883,6,na,1889,2486
SIM,1782,91,na,1873,9
STAT,1910,19,na,1929,3594.911149292524
SIM,1873,39,35-39,1912,11
STAT,1883,29,35-39,1912,8.869775212782672
STAT,1934,32,25-29,1966,11.921130104822652
SIM,1832,37,30-34,1869,6
SIM,1874,27,35-39,1901,8
STAT,1851,39,40-44,1890,3.1777865881389196
STAT,1904,25,15-19,1929,0.6188569231885781
SIM,1890,45,na,1935,2702
STAT,1928,32,50-100,1960,0.9767363848248567
SIM,1929,27,35-39,1956,23
STAT,1895,19,50-100,1914,0.060073279955549896
STAT,1849,37,35-39,1886,5.216701388820659
SIM,1876,30,na,1906,2391
STAT,1897,25,20-24,1922,14.922251085247876
SIM,1936,20,40-44,1956,1
SIM,1861,53,na,1914,1823
SIM,1827,43,35-39,1870,3
STAT,1925,20,15-19,1945,6.056075669285418
STAT,1933,24,30-34,1957,35.9911727263906
STAT,1875,18,45-49,1893,0.06323187207988394
SIM,1883,38,40-44,1921,9
STAT,1842,28,35-39,1870,8.436161807177799
STAT,1926,17,15-19,1943,52.570880042225234
SIM,1873,38,30-34,1911,8
STAT,1898,20,45-49,1918,0.8970743185920693
SIM,1831,87,na,1918,92
SIM,1943,28,20-24,1971,22
STAT,1880,28,20-24,1908,11.61999721039241
SIM,1895,39,20-24,1934,3
STAT,1848,24,50-100,1872,0.35259115958225795
STAT,1904,23,na,1927,3194.3214646945967
SIM,1924,41,na,1965,4143
SIM,1947,21,20-24,1968,96
STAT,1900,16,40-44,1916,0.2402995665685084
SIM,1856,25,25-29,1881,36
STAT,1809,48,45-49,1857,0.845232442071836
SIM,1850,28,35-39,1878,16
STAT,1918,35,45-49,1953,0.6852370941111772
STAT,1836,23,40-44,1859,1.724191068664393
SIM,1932,37,35-39,1969,8
STAT,1943,16,50-100,1959,0.37541149487893594
SIM,1872,26,20-24,1898,10
SIM,1936,30,35-39,1966,6
STAT,1867,38,50-100,1905,1.0836069409476845
STAT,1929,26,30-34,1955,46.34954088373597
STAT,1913,36,20-24,1949,0.2468842242291559
SIM,1841,87,na,1928,88
STAT,1894,7,na,1901,3166.0816234336344
STAT,1864,26,20-24,1890,9.938981919486174
STAT,1876,63,na,1939,1740.1523493152665
STAT,1844,31,na,1875,1838.3679067345086
SIM,1911,17,20-24,1928,27
STAT,1896,16,15-19,1912,7.42767559628608
STAT,1801,69,na,1870,718.8427079671948
STAT,1826,33,25-29,1859,12.788767446504506
STAT,1935,28,20-24,1963,23.49385533854077
SIM,1786,72,na,1858,492
STAT,1903,17,20-24,1920,23.8277322241302
STAT,1908,42,25-29,1950,0.06239883490766016
STAT,1875,25,50-100,1900,0.625057807564399
SIM,1827,72,na,1899,678
SIM,1906,23,25-29,1929,79
STAT,1804,99,na,1903,0.6417919927809699
STAT,1887,39,20-24,1926,0.8062026040169704
SIM,1889,28,40-44,1917,4
SIM,1857,37,35-39,1894,11
STAT,1814,49,30-34,1863,0.25420653412607197
STAT,1869,31,30-34,1900,16.031054387339857
STAT,1893,24,25-29,1917,68.18596190517202
STAT,1875,38,40-44,1913,4.227460199920322
STAT,1865,38,30-34,1903,4.552455780506698
SIM,1833,46,na,1879,1465
SIM,1867,32,25-29,1899,11
STAT,1858,15,40-44,1873,0.1603361272398823
STAT,1909,22,na,1931,3349.7437926492603
STAT,1865,48,25-29,1913,0.048825126020949926
STAT,1939,21,20-24,1960,105.51778234190594
SIM,1800,101,na,1901,1
SIM,1868,44,35-39,1912,2
SIM,1832,38,35-39,1870,13
STAT,1898,38,35-39,1936,1.9426095813402093
STAT,1928,21,45-49,1949,1.3312766935481923
STAT,1952,17,na,1969,4167.112965471738
SIM,1899,25,na,1924,3096
STAT,1846,97,na,1943,3.787820064007545
STAT,1810,84,na,1894,150.6454716358229
STAT,1831,35,na,1866,1676.7693790429787
STAT,1832,35,15-19,1867,0.043987020317307515
STAT,1921,28,50-100,1949,1.0443687003702145
SIM,1781,95,na,1876,2
SIM,1878,74,na,1952,1056
SIM,1875,38,50-100,1913,1
STAT,1844,26,50-100,1870,0.5537130627940301
SIM,1926,35,45-49,1961,3
STAT,1911,23,40-44,1934,3.0025027853196313
SIM,1899,23,30-34,1922,24
SIM,1844,20,na,1864,1971
SIM,1936,21,45-49,1957,4
SIM,1931,25,25-29,1956,86
STAT,1859,23,35-39,1882,4.531868360181046
STAT,1786,101,na,1887,0.1333731227466291
SIM,1941,15,40-44,1956,1
SIM,1918,26,20-24,1944,20
SIM,1848,37,50-100,1885,3
SIM,1931,29,40-44,1960,7
STAT,1837,31,35-39,1868,8.099092548274898
STAT,1870,29,15-19,1899,0.4169769337843544
SIM,1884,81,na,1965,668
SIM,1838,34,20-24,1872,2
SIM,1877,31,30-34,1908,31
SIM,1866,20,15-19,1886,2
SIM,1935,29,25-29,1964,89
STAT,1874,26,30-34,1900,24.39735718274495
STAT,1824,38,35-39,1862,10.11024738706352
STAT,1830,49,15-19,1879,2.8569386343794826E-4
STAT,1899,16,40-44,1915,0.2373703204805753
STAT,1905,32,50-100,1937,0.7182194987841123
SIM,1902,31,na,1933,3202
STAT,1893,11,na,1904,3100.0558796581463
SIM,1929,29,na,1958,4481
STAT,1917,39,50-100,1956,0.40945098618391296
SIM,1921,39,25-29,1960,3
STAT,1850,27,30-34,1877,20.86244887028527
STAT,1764,95,na,1859,1.7195930486680333
STAT,1874,17,40-44,1891,0.17659866998763699
SIM,1914,22,20-24,1936,121
SIM,1911,24,45-49,1935,1
STAT,1829,64,na,1893,1065.5244329680736
SIM,1861,26,45-49,1887,2
STAT,1863,45,na,1908,1886.9244725184774
STAT,1900,25,30-34,1925,33.227038163178456
STAT,1944,22,40-44,1966,3.429505726414007
SIM,1887,1,na,1888,3095
STAT,1837,25,15-19,1862,0.372944407966308
SIM,1844,23,40-44,1867,2
STAT,1869,49,20-24,1918,0.010744129020361972
SIM,1850,79,na,1929,490
SIM,1894,26,na,1920,3039
SIM,1880,45,na,1925,2347
STAT,1834,32,20-24,1866,2.1432079435397733
STAT,1825,49,40-44,1874,0.17463701415715055
STAT,1905,37,25-29,1942,0.8483750390482279
STAT,1852,20,20-24,1872,63.10150983319426
SIM,1928,21,45-49,1949,4
STAT,1843,90,na,1933,56.879951810606656
SIM,1847,49,na,1896,1570
SIM,1852,8,na,1860,2328
STAT,1934,19,15-19,1953,57.67818404482168
SIM,1860,90,na,1950,71
SIM,1865,39,35-39,1904,9
STAT,1926,34,40-44,1960,4.464943102865945
SIM,1864,24,20-24,1888,58
STAT,1877,26,na,1903,2347.5779667774314
STAT,1882,19,40-44,1901,0.16723198294375424
STAT,1848,25,25-29,1873,36.909434667380175
SIM,1890,17,25-29,1907,7
STAT,1891,29,35-39,1920,11.201918372292068
SIM,1841,65,na,1906,1170
SIM,1853,33,35-39,1886,9
STAT,1819,43,35-39,1862,3.4367668763795525
STAT,1881,41,50-100,1922,0.9679964524029472
STAT,1927,29,25-29,1956,75.2967891558821
SIM,1857,48,50-100,1905,1
STAT,1831,28,25-29,1859,36.22731092969364
SIM,1865,78,na,1943,622
SIM,1871,15,15-19,1886,9
STAT,1898,37,30-34,1935,6.815607614895303
STAT,1906,22,20-24,1928,94.79665094255382
SIM,1871,31,na,1902,2302
SIM,1879,59,na,1938,1893
STAT,1819,37,15-19,1856,0.14598883852383393
SIM,1905,39,40-44,1944,3
STAT,1907,28,45-49,1935,1.535086397593074
STAT,1865,34,15-19,1899,0.1212024837344718
SIM,1901,35,40-44,1936,3
SIM,1868,28,20-24,1896,9
SIM,1949,17,na,1966,4021
STAT,1822,101,na,1923,0.2947458836337829
SIM,1887,38,25-29,1925,4
SIM,1836,21,40-44,1857,1
SIM,1867,37,45-49,1904,2
STAT,1880,17,15-19,1897,5.898934111664475
SIM,1876,3,na,1879,2917
SIM,1882,26,30-34,1908,26
STAT,1864,0,na,1864,3229.7065159739786
STAT,1863,9,na,1872,2308.6096986334173
STAT,1867,36,40-44,1903,3.901535458096236
STAT,1914,15,30-34,1929,2.392543206489665
STAT,1780,80,na,1860,204.42027509055288
SIM,1913,37,25-29,1950,1
STAT,1830,50,na,1880,1388.7344901399679
STAT,1860,16,35-39,1876,0.48874583715176495
SIM,1871,21,35-39,1892,6
SIM,1875,36,40-44,1911,5
SIM,1922,15,30-34,1937,18
SIM,1917,21,35-39,1938,8
SIM,1915,28,45-49,1943,2
STAT,1815,83,na,1898,169.91093091256258
STAT,1860,22,20-24,1882,54.54083039501618
STAT,1853,26,45-49,1879,0.9607815365534462
STAT,1936,23,45-49,1959,1.0157092073095157
STAT,1909,21,35-39,1930,8.290053018727441
SIM,1844,83,na,1927,237
SIM,1812,73,na,1885,476
SIM,1849,35,35-39,1884,14
STAT,1879,38,25-29,1917,2.8289103234915656
STAT,1838,36,20-24,1874,0.641018275546114
STAT,1847,48,30-34,1895,0.07032940992201168
SIM,1875,34,25-29,1909,15
SIM,1833,21,15-19,1854,2
STAT,1848,27,40-44,1875,2.576333382866412
STAT,1925,16,45-49,1941,0.5715403383225796
STAT,1841,13,na,1854,2097.0
STAT,1862,29,15-19,1891,0.36299758319664277
STAT,1811,47,na,1858,1303.854092648151
SIM,1898,62,na,1960,2430
STAT,1913,59,na,1972,3184.6595485445273
STAT,1824,37,30-34,1861,8.009504865848102
STAT,1906,49,35-39,1955,0.10636593210557249
STAT,1931,27,25-29,1958,80.27885423963576
SIM,1944,23,45-49,1967,2
STAT,1877,24,40-44,1901,2.030004942441261
STAT,1898,25,50-100,1923,0.8236058154388815
SIM,1826,98,na,1924,4
STAT,1863,21,35-39,1884,4.978178031523061
STAT,1886,34,35-39,1920,10.021527919725974
SIM,1945,24,15-19,1969,4
SIM,1885,24,40-44,1909,5
STAT,1906,16,35-39,1922,0.7566630930712296
SIM,1894,34,35-39,1928,16
STAT,1850,49,na,1899,1550.8226386214708
STAT,1928,36,na,1964,4496.211194942786
SIM,1923,27,40-44,1950,5
STAT,1867,31,20-24,1898,2.407412577173039
SIM,1859,30,25-29,1889,13
STAT,1856,18,35-39,1874,0.4772251313627294
STAT,1857,8,na,1865,2149.5237402773496
STAT,1809,98,na,1907,1.3646552328208044
STAT,1841,110,na,1951,1.8906819179266495E-4
STAT,1845,33,35-39,1878,8.393929965155396
STAT,1838,37,25-29,1875,2.3695341662588802
STAT,1824,87,na,1911,93.01247492527418
STAT,1891,28,30-34,1919,29.341717036717203
SIM,1859,60,na,1919,1592
SIM,1880,67,na,1947,1667
STAT,1846,53,50-100,1899,0.010477559077964986
SIM,1934,34,40-44,1968,10
SIM,1917,20,30-34,1937,39
STAT,1899,21,15-19,1920,4.28385535347254
SIM,1910,60,na,1970,2961
STAT,1921,38,20-24,1959,0.27780524410534096
SIM,1911,45,na,1956,3345
SIM,1868,96,na,1964,15
SIM,1842,32,20-24,1874,2
STAT,1857,37,35-39,1894,5.267563754438038
STAT,1865,26,na,1891,2055.729140747107
SIM,1898,38,35-39,1936,7
SIM,1865,35,50-100,1900,3
STAT,1930,15,15-19,1945,55.688950486219696
STAT,1873,54,50-100,1927,0.014083902627032994
STAT,1823,53,50-100,1876,0.016989820988266655
STAT,1864,33,45-49,1897,1.4661146235499665
STAT,1946,22,50-100,1968,0.6917426185426041
SIM,1827,50,na,1877,1305
STAT,1834,26,35-39,1860,7.888386692434644
STAT,1915,32,15-19,1947,0.12362700336409398
STAT,1856,24,20-24,1880,58.370409458673215
SIM,1829,94,na,1923,9
STAT,1879,37,20-24,1916,0.7611609211882383
SIM,1895,44,na,1939,2851
SIM,1869,20,40-44,1889,6
SIM,1879,37,na,1916,2320
STAT,1908,29,15-19,1937,0.6257961190840997
SIM,1856,27,40-44,1883,4
STAT,1862,82,na,1944,375.9897741849156
SIM,1847,27,na,1874,1834
STAT,1937,24,15-19,1961,4.893038621334069
SIM,1811,99,na,1910,1
STAT,1782,103,na,1885,0.04797438219387092
STAT,1821,39,20-24,1860,1.4179825516382312
STAT,1761,106,na,1867,0.007806338481171369
SIM,1846,37,25-29,1883,1
STAT,1872,28,20-24,1900,11.084633425478502
STAT,1828,48,20-24,1876,0.009974992586245257
STAT,1829,42,na,1871,1598.4885985086194
SIM,1904,27,30-34,1931,37
STAT,1844,21,25-29,1865,50.538888998580845
STAT,1867,34,25-29,1901,9.007411160384345
STAT,1909,20,30-34,1929,25.379008921628316
STAT,1835,38,45-49,1873,1.5218247224151438
STAT,1960,5,na,1965,4836.49267671056
SIM,1907,19,na,1926,3543
STAT,1903,24,45-49,1927,0.9313560632554061
SIM,1852,21,25-29,1873,57
STAT,1882,59,na,1941,1786.529555671642
STAT,1895,39,20-24,1934,0.9407379738116688
STAT,1925,22,30-34,1947,32.50437767665523
STAT,1847,46,15-19,1893,2.9515084820706317E-4
SIM,1897,26,25-29,1923,57
STAT,1850,28,35-39,1878,7.936452068914279
SIM,1880,28,20-24,1908,9
STAT,1872,26,20-24,1898,11.161963077056974
STAT,1824,32,25-29,1856,23.72442494818456
STAT,1833,91,na,1924,35.179542529034656
STAT,1893,26,40-44,1919,3.6028526221262784
STAT,1939,23,20-24,1962,105.44815209644682
STAT,1834,54,30-34,1888,0.0036312746460585767
STAT,1884,20,30-34,1904,16.727688744190775
SIM,1783,76,na,1859,328
SIM,1855,27,25-29,1882,47
SIM,1821,67,na,1888,857
STAT,1919,25,45-49,1944,1.7753940107020225
STAT,1835,46,45-49,1881,0.15721122936854026
STAT,1838,47,25-29,1885,0.04041668248666413
STAT,1829,86,na,1915,135.99870610295395
STAT,1852,43,40-44,1895,1.6965926009199592
STAT,1855,44,20-24,1899,0.11095900073137493
STAT,1870,48,50-100,1918,0.22448783619906887
STAT,1878,49,20-24,1927,0.01155502587492986
SIM,1834,35,40-44,1869,2
SIM,1902,19,na,1921,3370
STAT,1868,50,40-44,1918,0.009632155236698125
STAT,1931,8,na,1939,4931.822787318439
STAT,1936,22,40-44,1958,3.036249839349798
STAT,1875,48,40-44,1923,0.16406835203977294
SIM,1872,34,20-24,1906,2
SIM,1883,22,30-34,1905,26
STAT,1876,29,45-49,1905,1.0750899311750948
STAT,1916,30,15-19,1946,0.1263373708356983
STAT,1881,54,50-100,1935,0.01339705433395702
STAT,1841,31,15-19,1872,0.11945060916236512
SIM,1944,22,40-44,1966,3
STAT,1827,33,50-100,1860,1.0209264986619582
STAT,1889,42,25-29,1931,0.7480077159358108
SIM,1823,34,25-29,1857,14
SIM,1853,17,20-24,1870,19
STAT,1885,77,na,1962,1020.2435466528839
STAT,1898,35,30-34,1933,6.880336266284645
STAT,1845,17,20-24,1862,15.783295460860243
STAT,1891,23,25-29,1914,66.73084123509567
STAT,1826,35,40-44,1861,5.0222639420808015
SIM,1861,95,na,1956,9
SIM,1950,20,15-19,1970,5
SIM,1813,48,na,1861,1289
SIM,1857,35,35-39,1892,11
STAT,1868,52,35-39,1920,0.007723835662312546
SIM,1840,31,20-24,1871,2
SIM,1892,28,40-44,1920,5
STAT,1858,33,35-39,1891,7.478837619917233
SIM,1890,25,25-29,1915,56
STAT,1850,37,25-29,1887,2.0590595448864186
STAT,1893,39,45-49,1932,2.3653765912351097
STAT,1806,49,30-34,1855,0.2769081137205003
SIM,1883,11,na,1894,2460
SIM,1909,41,na,1950,3289
SIM,1927,25,45-49,1952,3
STAT,1870,31,40-44,1901,4.030771397446985
STAT,1842,16,40-44,1858,0.1682459645497094
SIM,1947,23,20-24,1970,109
STAT,1849,35,35-39,1884,5.326171747189237
STAT,1866,32,30-34,1898,15.207222403471999
STAT,1884,28,40-44,1912,2.7866342816689715
STAT,1829,49,25-29,1878,0.04527797178261029
STAT,1873,34,15-19,1907,0.13538676720401582
STAT,1855,31,50-100,1886,0.6676298425458872
STAT,1912,45,30-34,1957,0.08129685542109741
STAT,1919,48,50-100,1967,0.23111064566258085
SIM,1832,32,25-29,1864,8
STAT,1843,52,30-34,1895,0.004271637076611548
STAT,1874,5,na,1879,2658.7967499607603
STAT,1846,46,20-24,1892,0.008484891780559525
STAT,1844,44,45-49,1888,1.0488244071326283
STAT,1911,35,na,1946,3464.648703507599
SIM,1928,24,na,1952,4277
STAT,1867,44,50-100,1911,0.9244246024200578
STAT,1943,6,na,1949,3980.4487938611187
STAT,1815,41,15-19,1856,0.04086519726485312
STAT,1819,50,45-49,1869,0.025794256306369945
STAT,1960,4,na,1964,4837.5085535067965
SIM,1853,76,na,1929,703
STAT,1886,41,45-49,1927,1.5005919476996565
SIM,1880,78,na,1958,916
STAT,1847,27,25-29,1874,37.410550164825565
SIM,1885,43,45-49,1928,5
STAT,1824,55,na,1879,1194.8959490656023
SIM,1800,73,na,1873,511
STAT,1824,47,25-29,1871,0.06768895562222968
SIM,1938,25,20-24,1963,15
SIM,1766,96,na,1862,3
SIM,1866,38,40-44,1904,3
SIM,1846,29,25-29,1875,34
STAT,1798,85,na,1883,88.78705413231967
STAT,1877,43,45-49,1920,1.4565831828948426
STAT,1895,8,na,1903,3204.720047830238
STAT,1817,37,40-44,1854,15.180028491578444
STAT,1885,27,45-49,1912,1.0449943817942948
STAT,1910,45,50-100,1955,0.20023395015691137
STAT,1883,66,na,1949,1517.5055887026303
SIM,1823,46,na,1869,1344
SIM,1870,68,na,1938,1387
STAT,1832,31,20-24,1863,2.1633967984781455
STAT,1829,54,20-24,1883,5.031002748006778E-4
STAT,1942,20,15-19,1962,5.276007510135746
SIM,1865,34,30-34,1899,19
STAT,1835,28,45-49,1863,0.896383090117675
STAT,1876,51,30-34,1927,0.005833031970564715
SIM,1860,42,30-34,1902,3
STAT,1861,36,45-49,1897,1.5713706581060778
STAT,1833,30,25-29,1863,8.203405572726567
STAT,1851,29,40-44,1880,2.5352243784300708
STAT,1849,40,30-34,1889,0.8431531956345801
STAT,1901,20,50-100,1921,0.5424332070108361
SIM,1881,17,25-29,1898,7
SIM,1947,18,25-29,1965,50
STAT,1878,50,50-100,1928,0.015066278643357094
SIM,1837,29,30-34,1866,28
STAT,1886,18,20-24,1904,17.648913752142462
STAT,1835,47,50-100,1882,0.16152355444162053
SIM,1920,22,50-100,1942,1
STAT,1880,53,45-49,1933,0.01419370273955178
SIM,1889,36,40-44,1925,4
STAT,1859,54,35-39,1913,0.00631209433569337
STAT,1886,19,na,1905,2507.3495759689627
SIM,1843,28,45-49,1871,4
SIM,1866,33,35-39,1899,10
SIM,1893,27,45-49,1920,1
SIM,1825,37,40-44,1862,5
STAT,1873,17,25-29,1890,5.433873096664607
SIM,1868,10,na,1878,2421
STAT,1877,50,35-39,1927,0.008560887586277247
SIM,1892,20,30-34,1912,32
STAT,1786,84,na,1870,102.4662405440911
STAT,1849,48,40-44,1897,0.12184887217851052
STAT,1832,39,30-34,1871,3.9983708627090904
STAT,1852,25,40-44,1877,2.6893694499065632
STAT,1898,28,40-44,1926,3.817323354491146
STAT,1807,63,na,1870,899.889543834369
STAT,1865,29,40-44,1894,2.5531471760907207
SIM,1909,21,na,1930,3338
STAT,1875,47,na,1922,2173.376166039702
STAT,1870,33,35-39,1903,9.334756432923895
SIM,1802,84,na,1886,84
STAT,1882,25,25-29,1907,39.1493966830127
STAT,1818,36,45-49,1854,7.431219040535827
STAT,1882,30,20-24,1912,2.5047600113251054
SIM,1840,39,30-34,1879,10
STAT,1892,15,40-44,1907,0.2173808717371235
STAT,1855,39,25-29,1894,2.018630200448304
STAT,1827,51,35-39,1878,0.007427253141627314
STAT,1816,68,na,1884,814.0764632126178
STAT,1867,49,45-49,1916,0.20496141885983912
STAT,1835,51,40-44,1886,0.006827989343643549
STAT,1856,42,50-100,1898,0.7807000471717044
STAT,1858,99,na,1957,1.9396968898640152
STAT,1884,46,40-44,1930,0.1602757641988915
STAT,1829,36,20-24,1865,0.700311863131906
STAT,1767,93,na,1860,4.621145352126636
STAT,1884,36,50-100,1920,1.1516631015213448
STAT,1863,46,50-100,1909,0.20452862649339487
STAT,1796,74,na,1870,485.7395450411106
SIM,1862,49,na,1911,1921
STAT,1894,42,35-39,1936,0.15262171130785793
STAT,1894,38,na,1932,2848.830559539215
STAT,1896,27,20-24,1923,14.647094803441812
SIM,1853,40,45-49,1893,2
SIM,1910,38,na,1948,3282
SIM,1919,30,35-39,1949,15
SIM,1839,37,40-44,1876,5
SIM,1890,30,20-24,1920,3
STAT,1925,39,50-100,1964,0.47509412469544193
SIM,1826,36,45-49,1862,4
SIM,1873,33,25-29,1906,13
STAT,1812,54,na,1866,1172.7056431678318
STAT,1815,82,na,1897,199.69786436058783
STAT,1890,24,na,1914,2714.5941436473927
STAT,1771,115,na,1886,1.3050891333054473E-4
STAT,1849,28,45-49,1877,0.9418646922740402
SIM,1910,2,na,1912,3733
STAT,1885,42,40-44,1927,2.114365656115266
STAT,1918,37,50-100,1955,0.4180515318789744
SIM,1820,93,na,1913,7
STAT,1834,24,35-39,1858,4.761756166162158
STAT,1843,27,40-44,1870,2.659700328462376
SIM,1814,85,na,1899,111
STAT,1891,30,15-19,1921,0.16785674813290416
STAT,1923,36,na,1959,4122.232129757415
STAT,1838,52,20-24,1890,5.006104276610269E-4
STAT,1866,27,50-100,1893,0.5571650560759746
STAT,1956,15,20-24,1971,169.5459748516433
STAT,1810,50,25-29,1860,0.012514185293903985
STAT,1850,52,20-24,1902,5.167314086868863E-4
STAT,1929,43,50-100,1972,0.14350735602852727
STAT,1801,90,na,1891,30.00038150204695
STAT,1834,21,30-34,1855,14.852467155721238
SIM,1888,26,25-29,1914,52
STAT,1840,32,50-100,1872,0.7771876181986842
STAT,1860,27,40-44,1887,2.324515574943444
STAT,1874,30,15-19,1904,0.1386043367338767
SIM,1847,39,40-44,1886,11
STAT,1848,41,25-29,1889,0.4680132810517897
STAT,1852,82,na,1934,354.4964283100073
SIM,1873,96,na,1969,31
STAT,1942,19,na,1961,3631.180194243146
SIM,1842,21,30-34,1863,25
SIM,1951,20,na,1971,4041
STAT,1871,30,45-49,1901,1.6462928703644062
SIM,1872,19,25-29,1891,8
STAT,1864,19,25-29,1883,4.891305595118739
SIM,1873,30,20-24,1903,2
STAT,1888,43,20-24,1931,0.1759566361339183
SIM,1833,24,40-44,1857,1
STAT,1817,38,50-100,1855,3.915141614965863
STAT,1820,73,na,1893,632.7567251822619
STAT,1844,51,35-39,1895,0.00607255509957277
SIM,1906,17,25-29,1923,8
STAT,1930,38,na,1968,4631.445416474241
STAT,1821,90,na,1911,42.57380229723434
SIM,1945,20,35-39,1965,10
STAT,1874,52,50-100,1926,0.01450455242140747
STAT,1885,47,50-100,1932,0.2300760002189751
SIM,1968,0,na,1968,4488
STAT,1834,47,40-44,1881,0.11238524787206691
STAT,1915,17,na,1932,3818.4082445406752
SIM,1829,31,na,1860,1637
SIM,1870,32,45-49,1902,1
STAT,1881,29,25-29,1910,38.309212167226335
SIM,1847,7,na,1854,2192
SIM,1857,28,45-49,1885,3
SIM,1898,36,35-39,1934,16
STAT,1820,35,45-49,1855,5.314942220427366
STAT,1856,44,na,1900,1686.9896403873272
STAT,1859,47,45-49,1906,0.1770966916211616
STAT,1903,37,50-100,1940,0.3561653851744953
SIM,1893,42,40-44,1935,4
STAT,1813,71,na,1884,645.5946139468222
STAT,1835,53,35-39,1888,0.005366793147258108
STAT,1896,45,20-24,1941,0.008535570010550525
SIM,1865,27,40-44,1892,2
STAT,1818,51,40-44,1869,0.02200738248964016
SIM,1894,18,20-24,1912,22
SIM,1851,85,na,1936,155
STAT,1870,16,45-49,1886,0.06140473328746714
STAT,1879,45,20-24,1924,0.011967316719735164
STAT,1899,31,30-34,1930,22.69595789463677
STAT,1825,39,40-44,1864,5.175220433538968
STAT,1922,19,na,1941,4002.9027841138677
STAT,1835,27,na,1862,1759.0205910394875
STAT,1840,35,15-19,1875,0.04722460459156084
STAT,1915,2,na,1917,4030.1525109821714
STAT,1900,63,na,1963,2513.5269970264103
SIM,1875,12,na,1887,2524
STAT,1860,41,25-29,1901,0.49525308355322745
STAT,1767,101,na,1868,0.09331307318382515
STAT,1857,34,30-34,1891,12.891810408089095
STAT,1894,40,40-44,1934,2.760946222800838
SIM,1907,20,15-19,1927,8
SIM,1933,6,na,1939,5078
SIM,1806,66,na,1872,768
SIM,1827,27,20-24,1854,8
STAT,1903,47,30-34,1950,0.07304644696691212
STAT,1848,37,40-44,1885,3.2499045781496054
SIM,1857,40,30-34,1897,3
SIM,1811,57,na,1868,1094
STAT,1820,34,35-39,1854,31.20900118540855
STAT,1928,30,35-39,1958,10.807867671208223
STAT,1837,17,50-100,1854,0.05383445734259956
STAT,1840,15,20-24,1855,16.175268551118617
SIM,1791,63,na,1854,800
SIM,1833,39,40-44,1872,3
STAT,1882,32,15-19,1914,0.13090826423561996
SIM,1896,25,20-24,1921,15
SIM,1947,15,na,1962,3740
SIM,1852,44,45-49,1896,1
STAT,1837,48,20-24,1885,0.00776349094943439
STAT,1839,39,40-44,1878,3.4163087581444462
STAT,1844,63,na,1907,1252.5979624220222
STAT,1848,19,40-44,1867,0.16142699351463743
STAT,1948,16,25-29,1964,46.86695575017313
STAT,1843,46,na,1889,1636.4241723129908
STAT,1855,29,25-29,1884,30.780881654476346
SIM,1863,66,na,1929,1388
STAT,1880,20,45-49,1900,0.697272191014012
STAT,1850,22,25-29,1872,48.371426978254306
STAT,1834,37,40-44,1871,3.370430420661372
STAT,1891,38,25-29,1929,3.3499659661103665
STAT,1887,36,na,1923,2501.0617736865697
STAT,1937,20,35-39,1957,8.666921051669359
SIM,1830,48,na,1878,1531
SIM,1855,47,na,1902,1776
STAT,1847,28,na,1875,1899.4176858072367
STAT,1838,79,na,1917,476.80678216630986
STAT,1888,25,20-24,1913,13.181242047185094
STAT,1838,29,25-29,1867,36.1749757143554
STAT,1853,41,35-39,1894,1.3489900492010956
STAT,1839,46,30-34,1885,0.06660945837218428
STAT,1859,52,40-44,1911,0.007894800350510845
STAT,1855,27,na,1882,1761.7761774633702
STAT,1851,13,na,1864,2118.7466595490055
SIM,1944,4,na,1948,4014
SIM,1816,39,40-44,1855,10
SIM,1831,33,20-24,1864,2
SIM,1936,23,45-49,1959,1
SIM,1819,84,na,1903,123
SIM,1888,62,na,1950,1983
STAT,1857,27,40-44,1884,2.297911745558467
STAT,1928,23,45-49,1951,1.3231682877889466
SIM,1842,49,na,1891,1498
STAT,1876,52,40-44,1928,0.010212489709616872
STAT,1864,83,na,1947,335.180393011672
SIM,1893,37,45-49,1930,3
STAT,1864,63,na,1927,1506.5072818927601
SIM,1842,29,na,1871,1808
STAT,1843,45,40-44,1888,0.12612811995015477
SIM,1879,8,na,1887,2617
SIM,1843,66,na,1909,1155
STAT,1805,52,na,1857,1160.259539640239
SIM,1850,48,na,1898,1630
STAT,1847,42,20-24,1889,0.11750454848642283
STAT,1797,68,na,1865,715.3612113072542
STAT,1876,47,45-49,1923,0.22908725496412044
STAT,1840,33,20-24,1873,2.2691326398985856
STAT,1844,26,45-49,1870,0.9610702790127097
STAT,1949,4,na,1953,4349.881689785732
SIM,1863,29,25-29,1892,37
SIM,1875,3,na,1878,2858
STAT,1948,23,15-19,1971,5.772518094042907
SIM,1817,38,45-49,1855,1
SIM,1799,79,na,1878,252
STAT,1818,53,35-39,1871,0.01729183922539719
STAT,1852,50,na,1902,1659.4260902784279
STAT,1811,44,35-39,1855,6.386575901512854
STAT,1823,33,20-24,1856,6.187276110668564
STAT,1914,43,50-100,1957,0.10977773666301338
STAT,1861,40,30-34,1901,0.9109882699091201
STAT,1896,47,15-19,1943,2.8039687254691366E-4
SIM,1924,42,na,1966,4133
STAT,1929,21,na,1950,4376.020442044557
SIM,1884,29,45-49,1913,2
SIM,1916,23,na,1939,3518
SIM,1851,27,40-44,1878,3
SIM,1792,69,na,1861,631
STAT,1845,36,50-100,1881,0.9181206865340149
STAT,1890,24,20-24,1914,79.09750856180244
STAT,1892,59,na,1951,2299.131278157168
SIM,1919,51,na,1970,3721
STAT,1948,12,na,1960,4247.097199724842
STAT,1885,44,35-39,1929,1.6812956968006136
STAT,1850,18,40-44,1868,0.15642099279912486
STAT,1856,64,na,1920,1286.2009411965737
SIM,1939,21,20-24,1960,94
SIM,1898,29,45-49,1927,2
STAT,1857,49,50-100,1906,0.17909175259035698
STAT,1840,28,25-29,1868,36.4678586552836
SIM,1858,5,na,1863,2349
STAT,1826,38,45-49,1864,2.0998293500165754
STAT,1829,39,25-29,1868,2.4785759840914543
STAT,1891,22,15-19,1913,3.857570983058965
SIM,1908,30,30-34,1938,28
STAT,1818,46,45-49,1864,0.512295955618017
STAT,1819,39,15-19,1858,0.12395938355424307
SIM,1883,25,35-39,1908,9
STAT,1885,50,40-44,1935,0.01005079438149726
SIM,1866,45,50-100,1911,1
SIM,1938,28,25-29,1966,65
STAT,1860,19,40-44,1879,0.16005349766659518
STAT,1876,26,40-44,1902,2.9314654766599695
SIM,1870,17,20-24,1887,18
SIM,1857,70,na,1927,1107
SIM,1929,41,na,1970,4663
STAT,1820,42,35-39,1862,3.2665974994033333
SIM,1841,37,25-29,1878,3
STAT,1936,25,45-49,1961,1.5629962186031676
STAT,1939,26,25-29,1965,62.53074421514629
STAT,1868,53,45-49,1921,0.012879692355057535
SIM,1861,34,45-49,1895,1
STAT,1835,43,40-44,1878,1.6601533489936149
SIM,1843,43,40-44,1886,5
SIM,1878,29,20-24,1907,10
SIM,1912,3,na,1915,3706
STAT,1872,51,45-49,1923,0.013826544193521466
STAT,1839,25,25-29,1864,36.04827447182263
SIM,1855,24,20-24,1879,72
SIM,1898,26,40-44,1924,3
STAT,1774,95,na,1869,2.29025248369828
STAT,1858,48,40-44,1906,0.12537164532580958
STAT,1917,26,50-100,1943,0.9894512338595869
STAT,1856,38,50-100,1894,0.9038938298138028
STAT,1862,17,20-24,1879,16.36213334451181
SIM,1848,38,45-49,1886,3
SIM,1860,78,na,1938,604
STAT,1882,49,na,1931,2024.9845561271602
STAT,1830,39,20-24,1869,0.5954771648826255
SIM,1918,34,na,1952,3710
STAT,1850,25,30-34,1875,21.165291332251517
STAT,1840,25,20-24,1865,10.334643445148894
STAT,1891,19,40-44,1910,0.2127228363696546
SIM,1823,31,20-24,1854,1
STAT,1846,49,25-29,1895,0.03976422195220992
STAT,1914,44,50-100,1958,0.10958562562385311
SIM,1938,20,15-19,1958,8
STAT,1878,39,20-24,1917,0.7504634127712771
SIM,1799,91,na,1890,7
STAT,1844,43,35-39,1887,1.2853554274808905
STAT,1898,36,40-44,1934,5.625012308062578
SIM,1877,78,na,1955,692
STAT,1885,37,45-49,1922,1.8762285417274909
SIM,1831,33,na,1864,1635
STAT,1882,22,20-24,1904,63.34781487554435
SIM,1925,26,50-100,1951,1
STAT,1847,83,na,1930,292.09854532535866
STAT,1865,33,25-29,1898,8.755605535880091
STAT,1847,44,15-19,1891,0.010023960585028758
SIM,1855,37,25-29,1892,2
SIM,1875,23,35-39,1898,6
SIM,1835,47,na,1882,1486
SIM,1882,23,25-29,1905,51
STAT,1849,34,50-100,1883,0.6816159110011017
STAT,1902,48,25-29,1950,0.04277131695655443
SIM,1834,38,45-49,1872,1
STAT,1873,35,25-29,1908,2.7871066196856753
STAT,1873,41,50-100,1914,1.017624280615254
SIM,1894,40,35-39,1934,2
STAT,1886,40,35-39,1926,1.825654458337825
STAT,1783,102,na,1885,0.07022805496429359
SIM,1826,28,45-49,1854,2
STAT,1823,41,20-24,1864,0.21172165721475247
STAT,1876,54,35-39,1930,0.008165146119905159
SIM,1863,39,25-29,1902,1
SIM,1904,22,na,1926,3186
SIM,1871,85,na,1956,250
SIM,1895,12,na,1907,3236
STAT,1866,54,25-29,1920,0.003000217424984535
STAT,1894,17,45-49,1911,0.07938123161651292
SIM,1911,55,na,1966,3235
STAT,1919,22,40-44,1941,3.4782032329806998
STAT,1893,29,45-49,1922,1.3213154336611819
SIM,1890,22,20-24,1912,90
STAT,1935,37,na,1972,4969.545604189476
SIM,1927,22,40-44,1949,5
STAT,1849,31,na,1880,1827.7835526044364
STAT,1890,32,20-24,1922,3.1221058693930726
STAT,1875,25,35-39,1900,9.428184804244927
SIM,1939,23,15-19,1962,4
STAT,1859,37,45-49,1896,1.5029385580649528
STAT,1894,35,45-49,1929,2.445532456086198
STAT,1859,30,50-100,1889,0.7008426808556524
SIM,1863,11,na,1874,2344
SIM,1901,57,na,1958,2718
STAT,1856,105,na,1961,0.06817207509937455
SIM,1843,25,40-44,1868,2
STAT,1880,15,15-19,1895,5.926341419848853
STAT,1880,50,40-44,1930,0.010614845789948176
SIM,1835,44,45-49,1879,4
STAT,1836,27,20-24,1863,9.586031133980295
STAT,1852,28,45-49,1880,0.9754948743911694
SIM,1852,43,35-39,1895,1
SIM,1859,61,na,1920,1569
SIM,1847,18,35-39,1865,2
SIM,1885,40,40-44,1925,5
STAT,1846,98,na,1944,2.290456914504723
STAT,1842,84,na,1926,236.89364588633902
STAT,1810,83,na,1893,179.77430174806133
STAT,1815,42,25-29,1857,1.8121591610593306
STAT,1885,19,45-49,1904,0.06115048771144087
SIM,1867,25,na,1892,2065
SIM,1867,48,na,1915,1928
STAT,1857,81,na,1938,402.73478501763543
STAT,1817,53,na,1870,1167.2680076879196
SIM,1849,33,35-39,1882,9
SIM,1860,28,45-49,1888,3
STAT,1827,44,45-49,1871,1.3294512261370113
STAT,1910,47,20-24,1957,0.009737587537307376
STAT,1913,33,50-100,1946,0.7736471633937325
SIM,1878,64,na,1942,1722
SIM,1829,29,25-29,1858,39
SIM,1898,33,30-34,1931,37
STAT,1807,47,25-29,1854,0.21329455536587916
SIM,1919,23,45-49,1942,1
STAT,1928,15,45-49,1943,0.5974457106340968
STAT,1840,18,25-29,1858,5.079424013021369
SIM,1930,38,na,1968,4565
STAT,1791,75,na,1866,383.6340260833774
STAT,1831,49,50-100,1880,0.17598980781071485
STAT,1877,40,40-44,1917,2.227252573411226
STAT,1852,109,na,1961,0.001803382075331153
STAT,1874,38,25-29,1912,2.766167079837342
STAT,1821,35,na,1856,1561.4232963246245
SIM,1844,52,na,1896,1513
SIM,1876,27,45-49,1903,3
STAT,1832,41,15-19,1873,0.010378364685894235
SIM,1832,24,25-29,1856,48
SIM,1944,25,45-49,1969,1
SIM,1947,15,20-24,1962,146
SIM,1842,24,35-39,1866,7
SIM,1837,39,25-29,1876,3
STAT,1842,24,40-44,1866,1.8448629670368668
STAT,1831,45,na,1876,1509.4978360483058
STAT,1861,11,na,1872,2162.3057247448437
SIM,1894,58,na,1952,2566
STAT,1910,18,na,1928,3604.8244164377275
STAT,1933,26,na,1959,4701.178283255299
SIM,1868,43,45-49,1911,1
SIM,1924,20,15-19,1944,9
SIM,1844,27,20-24,1871,13
STAT,1888,38,25-29,1926,3.197275751144709
SIM,1842,29,40-44,1871,1
SIM,1822,38,25-29,1860,1
SIM,1832,28,40-44,1860,4
STAT,1824,31,15-19,1855,0.3855975176934772
STAT,1814,45,15-19,1859,0.0011210118245275566
STAT,1918,21,35-39,1939,9.62239668775671
SIM,1882,38,25-29,1920,2
STAT,1849,43,35-39,1892,1.2957893622882497
STAT,1849,105,na,1954,0.021134070769816174
STAT,1839,43,25-29,1882,0.4455301982533346
STAT,1832,34,25-29,1866,7.931245545075092
SIM,1852,36,45-49,1888,1
SIM,1847,25,25-29,1872,40
SIM,1861,41,35-39,1902,3
SIM,1921,33,50-100,1954,1
SIM,1926,21,35-39,1947,13
STAT,1881,36,15-19,1917,0.05146757501911778
STAT,1947,25,20-24,1972,19.527208425189816
STAT,1861,33,40-44,1894,3.3876962114515257
STAT,1856,40,20-24,1896,0.11869047363979225
STAT,1879,53,20-24,1932,7.169460937069765E-4
SIM,1813,91,na,1904,27
SIM,1782,90,na,1872,16
SIM,1896,38,25-29,1934,6
STAT,1834,29,40-44,1863,2.396620369945035
STAT,1881,26,20-24,1907,10.737494877821785
STAT,1916,20,15-19,1936,5.300742403279563
SIM,1871,28,20-24,1899,11
STAT,1866,28,45-49,1894,0.9636577869328491
STAT,1844,36,45-49,1880,1.642049897861966
SIM,1812,74,na,1886,429
SIM,1840,34,25-29,1874,13
SIM,1890,44,na,1934,2703
STAT,1824,35,30-34,1859,8.790165883262164
STAT,1852,46,45-49,1898,0.1798153577665972
STAT,1863,28,20-24,1891,9.70766482048037
STAT,1865,57,na,1922,1725.1573503666264
STAT,1896,48,25-29,1944,0.040056588445142385
SIM,1865,77,na,1942,681
STAT,1845,17,na,1862,2043.5784115505328
STAT,1888,45,15-19,1933,4.5085413959922627E-4
SIM,1850,24,40-44,1874,4
SIM,1873,29,40-44,1902,3
STAT,1851,65,na,1916,1239.2772895546207
STAT,1855,36,20-24,1891,0.5485711990404826
STAT,1837,30,na,1867,1751.28593356278
STAT,1834,65,na,1899,1046.0130883668417
STAT,1881,31,na,1912,2185.554460861055
SIM,1830,27,20-24,1857,10
SIM,1898,72,na,1970,1975
STAT,1859,104,na,1963,0.20526861641003089
STAT,1839,50,50-100,1889,0.010320661812950339
STAT,1874,93,na,1967,97.92791105880474
STAT,1916,34,na,1950,3657.0394848389747
SIM,1894,33,45-49,1927,3
STAT,1866,36,25-29,1902,2.519819103830479
STAT,1893,76,na,1969,1528.1909123122716
STAT,1930,25,50-100,1955,1.1967374738457308
STAT,1829,28,20-24,1857,14.366937524923534
STAT,1842,49,40-44,1891,0.11936820998757966
STAT,1871,19,15-19,1890,5.528158444429952
STAT,1892,44,25-29,1936,0.052041396115209464
STAT,1845,40,45-49,1885,1.1013795607227221
STAT,1857,17,40-44,1874,0.16010215176168263
STAT,1910,46,50-100,1956,0.19979143312706457
SIM,1832,35,30-34,1867,7
STAT,1864,42,20-24,1906,0.1339224684878371
STAT,1875,22,30-34,1897,17.287498047108596
STAT,1829,29,30-34,1858,27.565360538123617
STAT,1857,38,na,1895,1745.9129308791757
SIM,1871,46,50-100,1917,2
STAT,1955,14,na,1969,4924.063827003033
STAT,1870,48,na,1918,2056.440912350547
SIM,1857,25,40-44,1882,2
STAT,1898,43,30-34,1941,0.1013580428225376
SIM,1850,23,30-34,1873,14
SIM,1872,79,na,1951,566
STAT,1844,18,45-49,1862,0.0579487682953873
STAT,1891,15,25-29,1906,6.656929713003537
SIM,1917,40,na,1957,3625
STAT,1912,20,na,1932,3474.7829267647126
STAT,1911,49,30-34,1960,0.0792417758390607
STAT,1808,49,na,1857,1277.1888830844653
SIM,1837,28,20-24,1865,10
STAT,1926,20,30-34,1946,33.18670012647534
STAT,1870,26,45-49,1896,1.03130077544474
STAT,1854,25,15-19,1879,0.38183389355958114
SIM,1874,36,25-29,1910,1
SIM,1840,16,25-29,1856,4
STAT,1863,38,20-24,1901,0.6369483748425776
STAT,1881,16,20-24,1897,16.210689341744978
STAT,1853,42,45-49,1895,1.1085535854224138
SIM,1888,36,25-29,1924,3
SIM,1836,64,na,1900,1100
STAT,1825,53,25-29,1878,0.0035096997516607287
STAT,1835,25,40-44,1860,2.4712639310174733
STAT,1883,24,30-34,1907,16.388565553227814
SIM,1939,24,25-29,1963,79
SIM,1860,38,45-49,1898,1
STAT,1863,46,na,1909,1873.6027857424979
STAT,1832,26,25-29,1858,35.210635868249064
STAT,1876,44,40-44,1920,2.164008675113036
SIM,1820,40,35-39,1860,1
STAT,1815,39,30-34,1854,17.808921913484507
STAT,1855,26,20-24,1881,8.723008384816387
STAT,1888,46,25-29,1934,0.06446469344800111
STAT,1852,38,45-49,1890,1.5070836771451466
SIM,1884,44,40-44,1928,5
SIM,1841,30,25-29,1871,16
STAT,1850,48,na,1898,1563.99144660186
STAT,1868,45,45-49,1913,0.21498876835881336
STAT,1860,37,40-44,1897,3.360870130252613
STAT,1896,19,20-24,1915,22.015938936437998
STAT,1849,25,40-44,1874,2.5966534482596564
STAT,1880,38,50-100,1918,1.214321314043084
SIM,1962,2,na,1964,4682
STAT,1893,46,35-39,1939,0.0949254434148606
STAT,1777,112,na,1889,7.255778708957437E-4
STAT,1965,1,na,1966,4642.6665212734115
SIM,1816,39,50-100,1855,1
SIM,1834,48,50-100,1882,1
STAT,1831,50,45-49,1881,0.009765699837292374
STAT,1861,43,35-39,1904,1.4102794739161926
STAT,1839,18,35-39,1857,0.475784219211839
STAT,1850,21,15-19,1871,2.807770850991757
SIM,1823,39,30-34,1862,3
SIM,1840,26,25-29,1866,42
SIM,1824,33,30-34,1857,20
SIM,1907,18,na,1925,3554
STAT,1840,36,25-29,1876,2.3963215945804923
STAT,1900,43,45-49,1943,0.13522531540681615
SIM,1897,6,na,1903,3340
STAT,1809,53,40-44,1862,0.03577299503894168
STAT,1921,25,na,1946,3971.2860663062697
SIM,1863,26,20-24,1889,12
STAT,1888,28,25-29,1916,47.04264024077381
SIM,1848,65,na,1913,1221
STAT,1862,29,na,1891,1909.4055954641087
STAT,1804,102,na,1906,0.09935088254126571
STAT,1832,33,15-19,1865,0.11149432205448825
STAT,1887,19,50-100,1906,0.05148217259240829
SIM,1818,99,na,1917,1
STAT,1843,53,40-44,1896,0.007473279887695864
STAT,1860,22,35-39,1882,4.618493841771571
STAT,1881,19,25-29,1900,5.141152623678942
SIM,1859,81,na,1940,407
SIM,1891,24,30-34,1915,25
STAT,1855,46,15-19,1901,2.840988039573829E-4
STAT,1829,46,20-24,1875,0.009810135201629237
STAT,1822,37,20-24,1859,1.397919203485852
SIM,1805,72,na,1877,546
STAT,1845,29,15-19,1874,0.38341962415575065
STAT,1857,35,40-44,1892,3.291110643903731
STAT,1865,15,25-29,1880,5.5741010065649235
STAT,1813,44,50-100,1857,3.3780148178941523
SIM,1899,26,na,1925,3071
STAT,1894,43,45-49,1937,0.12538521021652554
STAT,1904,48,50-100,1952,0.1853372379065479
SIM,1934,20,30-34,1954,44
STAT,1903,39,30-34,1942,1.5305376085959654
STAT,1873,27,25-29,1900,40.563184726270215
STAT,1897,41,20-24,1938,0.013996372154198633
STAT,1827,107,na,1934,0.002617115354392433
SIM,1881,27,25-29,1908,32
STAT,1842,23,30-34,1865,15.883832911186403
SIM,1801,67,na,1868,735
STAT,1826,48,45-49,1874,0.21772187129317624
SIM,1839,27,40-44,1866,5
SIM,1789,69,na,1858,692
STAT,1837,38,20-24,1875,0.5863445435497472
STAT,1839,96,na,1935,5.725343712928882
SIM,1829,37,25-29,1866,1
SIM,1892,37,50-100,1929,2
STAT,1835,82,na,1917,291.1146691690169
STAT,1811,68,na,1879,765.6699352923602
SIM,1834,22,35-39,1856,7
STAT,1865,36,30-34,1901,4.597168956453182
SIM,1810,44,40-44,1854,6
STAT,1847,45,25-29,1892,0.04280395345659464
SIM,1911,39,30-34,1950,2
STAT,1884,37,50-100,1921,1.1461466352650576
SIM,1873,15,25-29,1888,7
SIM,1896,28,25-29,1924,53
STAT,1896,37,20-24,1933,0.9624296644987143
SIM,1884,26,40-44,1910,3
SIM,1873,36,30-34,1909,8
STAT,1886,15,45-49,1901,0.0655028984130272
STAT,1819,42,45-49,1861,2.938180155971628
STAT,1893,12,na,1905,3095.4367963974555
STAT,1857,42,30-34,1899,0.8551621664245522
STAT,1849,32,30-34,1881,13.261243163421332
SIM,1887,25,na,1912,2510
STAT,1827,52,45-49,1879,0.012274321660170447
STAT,1921,38,35-39,1959,2.5490011175185643
STAT,1938,22,15-19,1960,4.976403785431767
SIM,1874,29,35-39,1903,11
STAT,1880,14,na,1894,2558.6996092295053
SIM,1857,32,30-34,1889,21
SIM,1948,17,30-34,1965,13
STAT,1852,45,35-39,1897,0.10742857336532652
STAT,1898,18,40-44,1916,0.23328853568394212
STAT,1839,42,15-19,1881,0.009704837811343615
STAT,1874,31,25-29,1905,9.929972429985163
SIM,1882,31,25-29,1913,11
STAT,1850,28,na,1878,1779.336683483099
SIM,1949,21,30-34,1970,37
STAT,1883,17,40-44,1900,0.16934392628896242
STAT,1886,33,45-49,1919,1.7332059213757547
STAT,1855,19,30-34,1874,1.3268692826591784
STAT,1896,61,na,1957,2377.061108908694
STAT,1876,22,50-100,1898,0.39769979766042807
STAT,1835,50,30-34,1885,0.003937907945425413
SIM,1874,2,na,1876,2942
STAT,1848,14,na,1862,2112.659649850373
STAT,1885,34,40-44,1919,4.046682788798172
STAT,1949,23,30-34,1972,31.674772533009882
STAT,1862,31,35-39,1893,8.1941229995532
STAT,1883,28,25-29,1911,39.02763181201118
SIM,1872,42,50-100,1914,1
SIM,1839,84,na,1923,221
STAT,1841,28,40-44,1869,2.5273493908980758
SIM,1844,34,45-49,1878,2
STAT,1781,85,na,1866,76.35341588540815
STAT,1888,42,na,1930,2576.1914213784603
STAT,1919,49,35-39,1968,0.13133351801868556
SIM,1891,61,na,1952,2190
STAT,1860,47,35-39,1907,0.10698524754745947
SIM,1815,43,30-34,1858,4
STAT,1858,105,na,1963,0.09436727214792963
SIM,1943,21,35-39,1964,10
STAT,1848,47,35-39,1895,0.10038908360257005
STAT,1868,27,45-49,1895,1.001467916351959
SIM,1847,28,na,1875,1827
SIM,1843,14,na,1857,2166
SIM,1851,33,na,1884,1811
STAT,1844,40,30-34,1884,0.848035738753968
STAT,1947,20,15-19,1967,5.687702557422643
SIM,1888,18,25-29,1906,5
STAT,1874,34,30-34,1908,16.71357700180612
SIM,1880,39,25-29,1919,3
SIM,1833,34,35-39,1867,11
SIM,1882,34,30-34,1916,21
SIM,1919,29,50-100,1948,1
STAT,1924,22,15-19,1946,5.934454376464988
SIM,1942,16,na,1958,3488
SIM,1877,40,35-39,1917,5
STAT,1911,43,20-24,1954,0.01582448692194159
SIM,1864,32,20-24,1896,2
SIM,1838,24,20-24,1862,56
STAT,1905,62,na,1967,2738.8632828343966
STAT,1848,33,25-29,1881,7.749877978654742
SIM,1798,74,na,1872,437
SIM,1925,30,30-34,1955,21
STAT,1888,35,20-24,1923,0.8684453241532463
STAT,1840,41,20-24,1881,0.11685959805593743
SIM,1891,0,na,1891,3250
STAT,1818,48,50-100,1866,0.5168425179907733
SIM,1849,38,40-44,1887,4
STAT,1854,48,20-24,1902,0.00853255493570243
STAT,1829,54,50-100,1883,0.010296785216577212
SIM,1858,36,40-44,1894,1
SIM,1931,5,na,1936,4957
SIM,1828,45,na,1873,1383
SIM,1824,31,na,1855,1593
SIM,1856,15,25-29,1871,6
SIM,1918,23,50-100,1941,3
STAT,1935,21,35-39,1956,12.116360099948386
SIM,1852,25,50-100,1877,1
STAT,1852,17,40-44,1869,0.1680725209461389
STAT,1902,45,20-24,1947,0.009114045516534486
SIM,1896,35,20-24,1931,1
STAT,1836,34,45-49,1870,1.36332471449748
STAT,1865,41,25-29,1906,0.5537506929493768
STAT,1892,26,25-29,1918,50.21460192135616
STAT,1856,32,20-24,1888,2.024463297091279
SIM,1891,28,25-29,1919,57
STAT,1857,38,45-49,1895,1.477286903772373
SIM,1849,30,30-34,1879,25
STAT,1870,79,na,1949,647.1404025664121
STAT,1928,35,na,1963,4499.9011138561455
STAT,1802,52,40-44,1854,0.030007023038973006
SIM,1874,28,45-49,1902,1
SIM,1818,90,na,1908,30
STAT,1895,26,15-19,1921,0.5612438484794201
SIM,1923,1,na,1924,4442
STAT,1845,32,45-49,1877,1.4604728745536124
SIM,1833,35,25-29,1868,1
STAT,1947,18,na,1965,3915.8973795929833
SIM,1824,37,25-29,1861,5
STAT,1830,29,20-24,1859,10.29281621485824
STAT,1828,35,15-19,1863,0.055753706457911376
SIM,1807,52,na,1859,1113
STAT,1928,1,na,1929,4971.454150216035
SIM,1863,31,50-100,1894,4
STAT,1883,20,15-19,1903,3.0726824832366955
SIM,1853,32,45-49,1885,1
STAT,1825,35,25-29,1860,3.986906647887113
STAT,1853,27,20-24,1880,10.078719223752474
SIM,1897,16,25-29,1913,6
SIM,1829,26,20-24,1855,8
SIM,1917,31,35-39,1948,12
SIM,1815,71,na,1886,582
SIM,1852,33,40-44,1885,7
STAT,1877,35,45-49,1912,1.9728086013399935
SIM,1954,9,na,1963,4435
STAT,1872,46,15-19,1918,3.8035745106754687E-4
STAT,1843,15,50-100,1858,0.04570588902349796
STAT,1836,41,35-39,1877,1.3778848148128158
STAT,1951,16,50-100,1967,0.4216095184835815
STAT,1839,54,30-34,1893,0.0038598492375452997
SIM,1891,20,15-19,1911,8
STAT,1850,26,40-44,1876,2.499682592254959
STAT,1848,48,25-29,1896,0.040974991518355076
STAT,1869,36,15-19,1905,0.05159694679095355
STAT,1843,69,na,1912,1058.7670815134945
SIM,1855,34,20-24,1889,4
SIM,1932,15,25-29,1947,71
SIM,1834,62,na,1896,1131
SIM,1889,32,25-29,1921,10
STAT,1841,29,30-34,1870,21.093357055942494
SIM,1835,19,20-24,1854,16
STAT,1859,44,40-44,1903,1.6728943609806426
STAT,1825,34,35-39,1859,14.861287055905354
STAT,1902,47,15-19,1949,2.9940002318856995E-4
SIM,1849,48,50-100,1897,2
SIM,1861,27,20-24,1888,10
SIM,1879,25,20-24,1904,14
SIM,1847,80,na,1927,396
SIM,1875,20,30-34,1895,27
STAT,1869,40,35-39,1909,1.672583121038124
SIM,1818,44,45-49,1862,5
SIM,1946,5,na,1951,4112
STAT,1909,31,35-39,1940,8.269696291403609
STAT,1871,22,45-49,1893,0.6530719529801388
SIM,1847,29,40-44,1876,2
SIM,1927,39,na,1966,4322
SIM,1927,38,na,1965,4325
STAT,1759,111,na,1870,5.032961821022447E-4
STAT,1860,58,na,1918,1518.3195967073138
SIM,1812,47,50-100,1859,2
SIM,1923,25,na,1948,4006
STAT,1851,88,na,1939,100.6723132597342
STAT,1924,15,25-29,1939,48.98208921097884
STAT,1849,54,25-29,1903,0.0024828432027362867
STAT,1851,25,25-29,1876,36.84772675375232
SIM,1856,33,25-29,1889,12
STAT,1844,33,40-44,1877,3.603003997047696
SIM,1833,28,35-39,1861,8
STAT,1839,47,40-44,1886,0.11630549790813566
STAT,1831,45,15-19,1876,3.017563076955007E-4
STAT,1851,43,25-29,1894,0.46750260013594847
SIM,1885,35,45-49,1920,1
SIM,1877,58,na,1935,1915
STAT,1889,16,25-29,1905,6.625178434874454
SIM,1844,41,35-39,1885,5
SIM,1865,38,25-29,1903,1
STAT,1857,50,na,1907,1626.617332615708
SIM,1870,6,na,1876,2556
STAT,1862,35,50-100,1897,0.9987576536271607
SIM,1838,44,na,1882,1514
STAT,1862,40,45-49,1902,1.218218749161784
STAT,1892,25,35-39,1917,11.49218923171442
STAT,1810,53,30-34,1863,0.01980214324397659
STAT,1872,39,25-29,1911,2.702584548035142
STAT,1912,37,30-34,1949,1.6800849486040035
SIM,1833,27,45-49,1860,3
STAT,1773,115,na,1888,1.3219421312500238E-4
SIM,1896,17,20-24,1913,27
STAT,1882,29,40-44,1911,2.733991315029531
STAT,1892,19,35-39,1911,0.6456455073114157
STAT,1888,17,20-24,1905,19.785221086590052
SIM,1798,85,na,1883,86
STAT,1841,99,na,1940,1.2957678697201989
STAT,1848,40,15-19,1888,0.01019457941115757
SIM,1794,92,na,1886,9
SIM,1853,8,na,1861,2351
STAT,1895,24,na,1919,2897.3790587493672
STAT,1860,40,15-19,1900,0.010709614635350657
STAT,1915,17,25-29,1932,8.567401845996331
SIM,1899,37,40-44,1936,3
SIM,1917,49,na,1966,3546
STAT,1841,21,20-24,1862,60.16079043628407
STAT,1852,2,na,1854,2752.0
SIM,1913,35,na,1948,3423
STAT,1827,37,20-24,1864,0.7703912203080195
SIM,1826,105,na,1931,1
STAT,1831,38,25-29,1869,2.247187848145441
STAT,1850,18,50-100,1868,0.0418984700253888
STAT,1892,18,45-49,1910,0.07707450103124949
STAT,1950,19,50-100,1969,0.41824706127783345
STAT,1852,35,40-44,1887,3.4141235965219674
SIM,1921,13,na,1934,4173
SIM,1850,27,45-49,1877,3
STAT,1857,53,20-24,1910,5.407421633637647E-4
STAT,1932,17,25-29,1949,54.209800032058176
SIM,1948,18,40-44,1966,1
STAT,1826,77,na,1903,471.80004835917265
STAT,1834,96,na,1930,5.314766501085187
STAT,1814,97,na,1911,2.216565412915604
STAT,1858,8,na,1866,2127.3813695088593
SIM,1903,37,30-34,1940,1
STAT,1889,34,25-29,1923,11.843388690172702
STAT,1853,16,45-49,1869,0.058619866640353055
SIM,1893,47,50-100,1940,4
STAT,1839,29,40-44,1868,2.4802198749478213
STAT,1872,43,45-49,1915,1.4088662782223247
STAT,1841,35,30-34,1876,4.386392411987527
STAT,1893,18,40-44,1911,0.21865615094147825
SIM,1880,43,45-49,1923,3
SIM,1890,13,na,1903,3091
STAT,1877,28,20-24,1905,11.460058974850543
SIM,1838,17,30-34,1855,1
STAT,1803,51,45-49,1854,0.04243875152920288
STAT,1856,39,40-44,1895,3.206290052110795
STAT,1891,10,na,1901,3028.8856167362446
STAT,1898,31,15-19,1929,0.1828590050713576
STAT,1844,32,na,1876,1819.377566257941
STAT,1821,49,20-24,1870,0.017795342785597346
SIM,1844,51,na,1895,1528
SIM,1894,27,na,1921,3026
STAT,1810,46,40-44,1856,0.6190614053619512
STAT,1762,94,na,1856,0.7495287047999999
SIM,1856,44,30-34,1900,1
SIM,1880,14,na,1894,2642
SIM,1928,20,35-39,1948,17
STAT,1811,50,40-44,1861,0.034798829449710134
STAT,1870,23,40-44,1893,1.9229579106091883
STAT,1899,37,na,1936,3074.147151433032
SIM,1919,16,20-24,1935,132
SIM,1923,17,25-29,1940,51
STAT,1873,40,20-24,1913,0.15382377094075425
STAT,1889,48,35-39,1937,0.09094516501621394
STAT,1861,15,40-44,1876,0.16687734820721742
STAT,1862,24,45-49,1886,0.5670087540902409
STAT,1902,11,na,1913,3448.0047941320563
STAT,1842,27,25-29,1869,37.25205652365827
STAT,1917,15,35-39,1932,0.8569621181788039
STAT,1851,18,35-39,1869,0.48633581385341784
STAT,1893,7,na,1900,3122.8216447921686
STAT,1894,28,20-24,1922,14.206115156139745
SIM,1866,94,na,1960,23
STAT,1861,98,na,1959,4.650188919079827
SIM,1826,66,na,1892,875
SIM,1841,29,45-49,1870,2
STAT,1895,23,na,1918,2906.622117081689
STAT,1898,46,35-39,1944,0.10127781723976602
STAT,1884,83,na,1967,657.4734569776834
SIM,1834,27,40-44,1861,2
SIM,1862,80,na,1942,493
SIM,1792,89,na,1881,19
STAT,1883,46,25-29,1929,0.05348135878185928
STAT,1889,49,25-29,1938,0.03710238410747278
STAT,1851,24,35-39,1875,5.037143332329632
STAT,1939,33,15-19,1972,0.12377330977915328
SIM,1897,34,25-29,1931,26
SIM,1820,41,45-49,1861,4
STAT,1833,29,45-49,1862,0.8794458040885103
STAT,1842,27,45-49,1869,0.9777703400445469
STAT,1904,35,30-34,1939,1.573312027422032
STAT,1874,15,50-100,1889,0.047700336135974415
SIM,1841,36,35-39,1877,11
SIM,1868,25,45-49,1893,1
SIM,1881,24,20-24,1905,53
STAT,1876,64,na,1940,1695.3434263203987
STAT,1872,50,na,1922,2070.977774331159
SIM,1929,38,25-29,1967,3
STAT,1805,101,na,1906,0.1910610241537722
STAT,1897,33,20-24,1930,3.4006742906553526
STAT,1906,24,na,1930,3233.015550772847
SIM,1849,39,na,1888,1724
STAT,1930,25,30-34,1955,47.11033556122135
STAT,1909,21,na,1930,3359.856962105198
SIM,1889,39,45-49,1928,1
STAT,1847,49,40-44,1896,0.12333693007030898
STAT,1902,10,na,1912,3453.2883252697193
STAT,1877,51,45-49,1928,0.014294835543403933
STAT,1833,22,25-29,1855,49.77585735864764
STAT,1879,61,na,1940,1845.1507119421165
SIM,1861,42,45-49,1903,3
STAT,1919,7,na,1926,4173.061393714689
STAT,1870,42,45-49,1912,1.383688505967744
SIM,1916,54,na,1970,3385
STAT,1832,42,25-29,1874,0.47638141339535706
STAT,1897,47,30-34,1944,0.0686649805384389
SIM,1912,40,na,1952,3266
SIM,1815,39,45-49,1854,1
SIM,1885,28,20-24,1913,13
STAT,1936,5,na,1941,3635.9232538992055
SIM,1850,27,25-29,1877,45
SIM,1925,15,35-39,1940,9
STAT,1832,23,20-24,1855,65.0277447842009
STAT,1802,54,35-39,1856,0.02357309118275061
SIM,1874,32,30-34,1906,22
STAT,1889,41,15-19,1930,0.01617889357401732
STAT,1910,39,20-24,1949,0.23570475203495156
SIM,1873,32,na,1905,2278
STAT,1851,17,45-49,1868,0.05824014442051416
STAT,1852,42,30-34,1894,0.8724107274216439
STAT,1883,26,50-100,1909,0.5943026592134532
STAT,1868,38,20-24,1906,0.6918393641912561
STAT,1922,10,na,1932,4345.400773442722
STAT,1833,36,35-39,1869,5.439850966442488
SIM,1905,21,15-19,1926,7
STAT,1926,24,na,1950,4165.377084011183
SIM,1840,23,20-24,1863,55
SIM,1848,31,25-29,1879,13
STAT,1949,16,40-44,1965,1.537338138988619
STAT,1859,61,na,1920,1408.8102236995146
SIM,1859,42,40-44,1901,4
SIM,1865,49,50-100,1914,1
SIM,1767,90,na,1857,22
STAT,1867,28,na,1895,2109.395960847698
STAT,1942,6,na,1948,3928.0752663435937
SIM,1846,63,na,1909,1237
STAT,1833,37,25-29,1870,2.191346354162339
SIM,1841,22,25-29,1863,45
SIM,1862,81,na,1943,415
SIM,1848,39,35-39,1887,9
SIM,1908,35,na,1943,3275
SIM,1858,44,na,1902,1839
SIM,1904,21,na,1925,3137
STAT,1842,45,25-29,1887,0.04208931147865898
SIM,1860,35,40-44,1895,2
STAT,1867,80,na,1947,548.695207647112
STAT,1831,42,45-49,1873,1.1399088972103244
STAT,1897,15,20-24,1912,22.502565694372986
SIM,1893,32,na,1925,2957
STAT,1790,89,na,1879,35.72135739795105
STAT,1853,34,45-49,1887,1.3043892366301126
SIM,1940,17,25-29,1957,47
STAT,1865,19,40-44,1884,0.15989782630673005
STAT,1898,39,45-49,1937,0.544711280386653
SIM,1888,15,20-24,1903,20
STAT,1892,48,40-44,1940,0.11280873368505298
STAT,1907,10,na,1917,3593.9919598245983
STAT,1895,49,20-24,1944,0.008170587773192937
STAT,1848,44,30-34,1892,0.817068256948981
STAT,1858,30,30-34,1888,13.220365511386492
STAT,1879,27,20-24,1906,11.584011366821413
STAT,1850,19,30-34,1869,1.3550685263010724
STAT,1866,21,25-29,1887,50.630944719302434
SIM,1939,20,30-34,1959,34
STAT,1860,44,30-34,1904,0.8707545342173049
STAT,1855,47,na,1902,1585.9914064089123
SIM,1831,34,na,1865,1655
SIM,1864,35,25-29,1899,2
STAT,1890,79,na,1969,1214.1872682289168
SIM,1838,27,25-29,1865,32
STAT,1920,39,na,1959,3883.271807658449
STAT,1878,75,na,1953,1012.4270785960006
STAT,1885,3,na,1888,2771.326984009451
SIM,1824,34,20-24,1858,1
STAT,1889,38,40-44,1927,5.080036401017211
SIM,1844,31,40-44,1875,8
SIM,1897,38,40-44,1935,1
STAT,1828,32,45-49,1860,1.8778329518264445
STAT,1856,35,25-29,1891,2.150532409600744
SIM,1790,78,na,1868,262
STAT,1820,40,40-44,1860,4.3131959043479
SIM,1895,18,15-19,1913,5
STAT,1823,43,15-19,1866,0.017392185645601545
SIM,1903,36,na,1939,3210
STAT,1812,85,na,1897,117.90476084963419
SIM,1869,91,na,1960,65
SIM,1819,85,na,1904,98
SIM,1891,25,20-24,1916,14
STAT,1897,18,25-29,1915,7.140674086256923
STAT,1887,18,15-19,1905,6.253405299868355
STAT,1847,53,25-29,1900,0.0025643281568134067
SIM,1833,31,30-34,1864,18
SIM,1886,39,na,1925,2269
SIM,1882,25,na,1907,2187
SIM,1882,37,35-39,1919,13
STAT,1839,51,25-29,1890,0.002373015298260888
STAT,1840,18,na,1858,2057.5407578070935
SIM,1872,37,25-29,1909,3
SIM,1919,20,na,1939,3773
SIM,1887,27,20-24,1914,15
SIM,1902,20,35-39,1922,8
STAT,1834,43,25-29,1877,0.47309109981586733
SIM,1825,32,35-39,1857,8
STAT,1883,25,20-24,1908,10.935454702575557
STAT,1892,22,30-34,1914,21.072051834496943
SIM,1907,24,30-34,1931,26
STAT,1860,33,25-29,1893,7.830673072253361
STAT,1895,23,45-49,1918,0.8570015435252367
STAT,1855,58,na,1913,1400.6072957804165
STAT,1936,23,na,1959,3296.5296278062797
STAT,1861,29,20-24,1890,9.137273807529539
STAT,1919,46,30-34,1965,0.09157024051264825
STAT,1911,46,25-29,1957,0.04754805728167373
STAT,1884,23,35-39,1907,5.43081918136873
STAT,1836,31,40-44,1867,3.4977351611151373
SIM,1892,23,35-39,1915,7
SIM,1903,9,na,1912,3460
STAT,1750,119,na,1869,9.027834090799302E-4
STAT,1899,39,40-44,1938,1.2108986816498464
SIM,1818,41,40-44,1859,7
SIM,1874,21,25-29,1895,54
STAT,1870,30,30-34,1900,16.2918396024118
STAT,1822,53,20-24,1875,9.711186281568687E-4
STAT,1866,10,na,1876,2374.64719547883
STAT,1864,37,25-29,1901,2.430937167896239
STAT,1933,30,15-19,1963,0.1637852068117471
SIM,1890,36,30-34,1926,5
SIM,1903,25,na,1928,3214
SIM,1833,38,50-100,1871,1
SIM,1880,36,20-24,1916,4
STAT,1884,50,25-29,1934,0.0033541270898391437
STAT,1819,96,na,1915,4.288065053274625
STAT,1893,36,40-44,1929,5.272198810256689
SIM,1870,35,50-100,1905,2
STAT,1874,37,35-39,1911,6.8291286975863095
SIM,1939,28,40-44,1967,4
STAT,1836,44,na,1880,1539.4517089267863
STAT,1832,30,na,1862,1728.2502861188161
STAT,1806,78,na,1884,311.89647060983737
STAT,1825,31,30-34,1856,34.034129244347675
STAT,1925,32,30-34,1957,17.67662520976575
SIM,1846,26,20-24,1872,9
SIM,1864,17,25-29,1881,6
SIM,1885,42,35-39,1927,4
SIM,1877,79,na,1956,644
STAT,1872,18,20-24,1890,16.766191538247952
STAT,1872,36,20-24,1908,0.7344386533475358
STAT,1850,59,na,1909,1368.203264127985
STAT,1855,52,20-24,1907,5.198394752548575E-4
STAT,1882,36,30-34,1918,4.922794940443247
STAT,1884,49,45-49,1933,0.21571535690941868
SIM,1860,14,na,1874,2311
STAT,1839,39,50-100,1878,0.9581600596970549
STAT,1883,43,20-24,1926,0.1459775806537857
STAT,1895,43,50-100,1938,0.08978756299632341
STAT,1846,43,na,1889,1628.323630107323
STAT,1886,36,15-19,1922,0.05631899231833557
SIM,1880,18,20-24,1898,15
STAT,1893,43,30-34,1936,0.09500063706758101
STAT,1850,29,45-49,1879,0.9066911786457087
SIM,1885,32,40-44,1917,7
STAT,1802,64,na,1866,821.2411894616959
STAT,1826,45,40-44,1871,0.16442561168459985
STAT,1880,6,na,1886,2657.4542265316477
SIM,1917,0,na,1917,4203
SIM,1896,38,na,1934,2968
STAT,1750,108,na,1858,0.1542252981358105
SIM,1888,33,20-24,1921,3
SIM,1856,37,40-44,1893,4
STAT,1899,36,50-100,1935,1.5971024414753487
STAT,1917,20,na,1937,3688.2466600027806
SIM,1854,17,15-19,1871,3
SIM,1939,19,na,1958,3396
STAT,1866,29,35-39,1895,8.344045116714307
STAT,1849,62,na,1911,1317.4118427864528
SIM,1778,85,na,1863,76
SIM,1882,27,50-100,1909,1
STAT,1867,46,40-44,1913,0.15228562541722074
STAT,1877,32,40-44,1909,4.251356812960655
STAT,1836,50,45-49,1886,0.00964734303940169
SIM,1803,90,na,1893,22
SIM,1889,43,30-34,1932,7
SIM,1886,83,na,1969,648
STAT,1856,17,25-29,1873,4.957686587208157
STAT,1864,44,15-19,1908,0.011502402535695767
STAT,1816,52,20-24,1868,0.0018600175487989738
SIM,1866,30,30-34,1896,25
SIM,1773,86,na,1859,62
SIM,1832,29,30-34,1861,18
SIM,1920,28,na,1948,3791
STAT,1846,17,15-19,1863,5.256311163305019
STAT,1858,38,40-44,1896,3.23038315570394
STAT,1826,52,30-34,1878,0.005371014690115833
STAT,1873,76,na,1949,908.4732537766984
STAT,1819,45,15-19,1864,7.328291417829908E-4
SIM,1852,59,na,1911,1486
SIM,1842,25,25-29,1867,38
SIM,1933,32,30-34,1965,26
STAT,1826,108,na,1934,9.997861353615725E-4
STAT,1851,47,40-44,1898,0.12495848233408967
STAT,1907,40,50-100,1947,0.10281468959528763
STAT,1865,16,50-100,1881,0.04359556985027101
SIM,1806,67,na,1873,734
STAT,1906,57,na,1963,2914.85773844694
STAT,1844,15,40-44,1859,0.16515777327540307
STAT,1853,24,50-100,1877,0.3522098937338692
STAT,1873,43,25-29,1916,0.6113215439509098
SIM,1802,53,na,1855,1155
SIM,1875,28,40-44,1903,3
STAT,1861,41,40-44,1902,1.7724883627510926
SIM,1849,51,na,1900,1610
SIM,1873,65,na,1938,1602
STAT,1806,52,25-29,1858,0.010000943218976013
STAT,1823,70,na,1893,738.3510996560108
STAT,1859,51,30-34,1910,0.00450924545876315
STAT,1838,44,20-24,1882,0.11235688168675509
SIM,1847,39,50-100,1886,1
STAT,1834,25,25-29,1859,34.83321368931343
STAT,1850,30,25-29,1880,8.463219066941711
STAT,1931,24,na,1955,4446.442865433452
STAT,1851,51,25-29,1902,0.002609843919338694
STAT,1854,22,45-49,1876,0.5899936071593572
STAT,1802,102,na,1904,0.10001300238574773
SIM,1890,29,40-44,1919,3
STAT,1824,40,25-29,1864,0.8547150157701979
STAT,1828,44,50-100,1872,0.9013454109938579
STAT,1851,21,30-34,1872,15.711431516323128
STAT,1846,28,20-24,1874,9.934651626454588
SIM,1836,44,50-100,1880,1
STAT,1850,109,na,1959,0.0011007615690175742
STAT,1860,26,50-100,1886,0.49998219422303686
SIM,1887,24,na,1911,2487
STAT,1848,23,50-100,1871,0.3551410724826837
SIM,1893,41,30-34,1934,1
STAT,1881,42,20-24,1923,0.1446820037567532
STAT,1808,50,50-100,1858,0.05717708716475784
SIM,1863,43,45-49,1906,6
STAT,1867,53,30-34,1920,0.005195139581386945
STAT,1899,34,35-39,1933,12.998388047320171
STAT,1863,54,20-24,1917,5.959272830295088E-4
STAT,1829,107,na,1936,0.002890637466568619
SIM,1823,38,40-44,1861,4
STAT,1891,31,25-29,1922,12.025690684895508
STAT,1846,53,45-49,1899,0.010068012811322243
STAT,1883,18,30-34,1901,1.4718449352291494
SIM,1874,25,40-44,1899,3
SIM,1909,10,na,1919,3656
STAT,1854,19,15-19,1873,5.052006124692094
STAT,1900,40,na,1940,3070.2178599941335
SIM,1862,19,15-19,1881,5
STAT,1885,41,30-34,1926,1.086940004419199
SIM,1857,58,na,1915,1568
STAT,1866,25,40-44,1891,2.626804323753584
STAT,1831,35,20-24,1866,0.6231445785098166
SIM,1867,44,40-44,1911,9
SIM,1864,42,50-100,1906,4
SIM,1838,99,na,1937,2
STAT,1877,42,35-39,1919,1.772985965822929
SIM,1834,85,na,1919,162
SIM,1891,18,30-34,1909,3
STAT,1875,24,na,1899,2281.0001848713196
STAT,1883,40,30-34,1923,1.0751805900256612
STAT,1871,65,na,1936,1582.723327622625
STAT,1904,38,35-39,1942,2.058052022953458
STAT,1943,20,30-34,1963,28.90623965405137
STAT,1879,48,25-29,1927,0.05616143737823837
STAT,1894,46,50-100,1940,0.16883321326729034
SIM,1854,28,20-24,1882,9
STAT,1930,7,na,1937,4882.354299487627
SIM,1846,19,30-34,1865,1
SIM,1859,101,na,1960,1
STAT,1838,26,20-24,1864,10.251643212141756
STAT,1847,50,20-24,1897,5.507552055472678E-4
STAT,1889,45,30-34,1934,0.11402064619402819
SIM,1839,29,na,1868,1849
STAT,1907,15,25-29,1922,7.898928811789314
STAT,1861,18,45-49,1879,0.058552114098095
SIM,1870,31,35-39,1901,13
STAT,1811,53,45-49,1864,0.04516545731100294
STAT,1893,32,25-29,1925,12.276949586053123
STAT,1902,27,50-100,1929,0.8528047257529556
STAT,1941,31,50-100,1972,0.8204684980718574
STAT,1810,49,45-49,1859,0.8112387506669474
STAT,1869,33,45-49,1902,1.5878858981977133
STAT,1898,36,20-24,1934,0.9905269430775101
SIM,1808,78,na,1886,288
SIM,1922,39,na,1961,4046
STAT,1939,28,50-100,1967,0.9447259344844873
STAT,1871,10,na,1881,2503.718888585547
STAT,1871,25,15-19,1896,0.42779488640819946
STAT,1874,27,40-44,1901,2.892311400316318
SIM,1867,80,na,1947,490
SIM,1879,28,25-29,1907,48
SIM,1948,21,15-19,1969,5
STAT,1841,24,25-29,1865,48.90680796399795
SIM,1848,42,30-34,1890,1
SIM,1882,27,40-44,1909,2
SIM,1836,33,na,1869,1688
SIM,1877,33,45-49,1910,1
STAT,1815,45,30-34,1860,0.243482482359549
SIM,1824,52,na,1876,1246
STAT,1930,28,35-39,1958,18.026871496865812
STAT,1945,15,45-49,1960,0.5157788362558366
SIM,1951,20,30-34,1971,39
STAT,1854,21,50-100,1875,0.3475207131295113
SIM,1831,36,25-29,1867,4
SIM,1883,26,25-29,1909,43
STAT,1848,15,25-29,1863,5.120941593328747
STAT,1939,22,30-34,1961,27.26490174446419
SIM,1850,17,30-34,1867,2
STAT,1838,19,30-34,1857,1.4190468104333782
SIM,1852,70,na,1922,1050
SIM,1859,6,na,1865,2381
STAT,1926,9,na,1935,4611.34352946161
SIM,1874,35,35-39,1909,8
STAT,1885,16,40-44,1901,0.17256737340445005
STAT,1773,89,na,1862,24.475296637851244
STAT,1807,53,50-100,1860,0.0524171565464486
SIM,1885,33,50-100,1918,6
SIM,1912,38,35-39,1950,5
STAT,1856,42,15-19,1898,0.010205230120525653
SIM,1864,39,40-44,1903,11
STAT,1828,29,15-19,1857,0.5732994759630046
STAT,1843,22,35-39,1865,5.284459982909054
STAT,1866,35,35-39,1901,6.218943460148429
STAT,1819,45,50-100,1864,0.44995747103735295
STAT,1897,43,15-19,1940,0.0012028414479321203
STAT,1877,33,50-100,1910,0.894420620885242
STAT,1920,39,30-34,1959,1.8812236966854279
SIM,1947,22,30-34,1969,41
SIM,1936,20,na,1956,2747
STAT,1929,32,15-19,1961,0.15421075174116178
STAT,1833,26,40-44,1859,2.4323117899315476
STAT,1850,70,na,1920,987.7674915410091
STAT,1864,34,20-24,1898,2.2626821223657396
SIM,1841,26,40-44,1867,4
SIM,1841,33,30-34,1874,20
STAT,1879,2,na,1881,3189.316144766118
STAT,1818,50,30-34,1868,0.012694504434263227
STAT,1791,74,na,1865,421.7751531859861
STAT,1890,27,25-29,1917,48.85928382799075
SIM,1909,7,na,1916,3676
STAT,1795,88,na,1883,45.609243849904345
SIM,1852,40,30-34,1892,1
SIM,1915,15,25-29,1930,9
STAT,1887,47,20-24,1934,0.012618853465150895
STAT,1907,40,15-19,1947,0.0013439829687362079
STAT,1949,19,45-49,1968,0.5485277695741884
SIM,1827,45,50-100,1872,4
STAT,1875,26,25-29,1901,41.19602777507613
STAT,1845,35,15-19,1880,0.04662787590901412
STAT,1814,51,20-24,1865,0.0019535457380355204
STAT,1844,25,50-100,1869,0.5577174742592114
STAT,1890,34,15-19,1924,0.16307645787711209
SIM,1893,34,40-44,1927,12
STAT,1842,42,20-24,1884,0.11700672838858207
SIM,1848,35,40-44,1883,3
SIM,1868,65,na,1933,1500
STAT,1842,29,na,1871,1877.7905665798703
STAT,1852,108,na,1960,0.00406588374291192
SIM,1879,18,30-34,1897,1
STAT,1787,70,na,1857,629.4954350812161
STAT,1910,49,15-19,1959,3.226834343662514E-4
STAT,1823,36,25-29,1859,4.879245184384499
SIM,1836,32,45-49,1868,1
SIM,1915,22,15-19,1937,5
STAT,1835,39,20-24,1874,0.5823860273000931
SIM,1864,51,na,1915,1949
STAT,1808,53,25-29,1861,0.012626892600055955
STAT,1889,82,na,1971,979.2467873927469
STAT,1917,30,30-34,1947,15.71027162831733
STAT,1919,18,20-24,1937,141.16497624531306
STAT,1833,33,30-34,1866,13.549289993278872
SIM,1860,31,25-29,1891,17
STAT,1866,43,na,1909,1998.522559963581
STAT,1766,102,na,1868,0.07605858678664172
STAT,1901,25,na,1926,3177.0776363941523
STAT,1844,52,45-49,1896,0.010133612743615468
STAT,1856,46,30-34,1902,0.07182508566034046
STAT,1813,47,20-24,1860,0.036298208927717866
SIM,1858,39,45-49,1897,1
SIM,1851,22,35-39,1873,6
STAT,1875,44,25-29,1919,0.6148252772025911
STAT,1818,70,na,1888,735.9584131655447
STAT,1842,24,20-24,1866,61.010446661380236
STAT,1862,21,40-44,1883,1.7314222208273293
SIM,1895,29,20-24,1924,12
SIM,1797,88,na,1885,52
SIM,1850,24,20-24,1874,62
SIM,1892,79,na,1971,1204
SIM,1826,43,40-44,1869,5
STAT,1887,29,20-24,1916,12.305653567877888
STAT,1907,22,15-19,1929,4.577287112118065
STAT,1832,85,na,1917,165.75771963988615
SIM,1915,8,na,1923,3876
SIM,1872,16,20-24,1888,19
SIM,1927,18,20-24,1945,140
STAT,1874,23,25-29,1897,55.10165121131038
SIM,1870,21,40-44,1891,1
STAT,1857,50,30-34,1907,0.004496872313098358
STAT,1880,38,20-24,1918,0.7624221144533175
STAT,1818,43,40-44,1861,5.189932867214506
STAT,1843,48,45-49,1891,0.16812410492172625
STAT,1864,16,20-24,1880,17.116715779334807
STAT,1895,30,35-39,1925,12.584998170746134
STAT,1897,36,25-29,1933,3.6551300297219744
STAT,1910,21,30-34,1931,25.567403482534186
SIM,1859,24,40-44,1883,3
STAT,1818,48,na,1866,1334.349158751601
STAT,1824,66,na,1890,865.2952199586024
STAT,1860,80,na,1940,474.9332860543162
SIM,1890,37,40-44,1927,7
STAT,1934,33,35-39,1967,11.779350003356297
STAT,1879,52,45-49,1931,0.014253737131455592
STAT,1909,49,25-29,1958,0.04576537931783024
STAT,1824,44,40-44,1868,2.7049795889130483
STAT,1916,42,30-34,1958,0.123763282262003
SIM,1893,38,20-24,1931,4
STAT,1807,47,45-49,1854,0.8739151997244758
STAT,1834,40,20-24,1874,0.12158551808149022
STAT,1858,76,na,1934,702.6226075628515
STAT,1826,67,na,1893,865.2390617851767
STAT,1862,81,na,1943,435.7684965403161
SIM,1892,16,25-29,1908,6
STAT,1891,37,35-39,1928,8.270414640480428
SIM,1851,64,na,1915,1284
STAT,1915,38,na,1953,3572.2496797123245
STAT,1921,31,15-19,1952,0.13566030717983693
SIM,1857,79,na,1936,502
STAT,1885,78,na,1963,968.0886965479881
STAT,1857,35,20-24,1892,0.5795425124249438
STAT,1841,43,30-34,1884,0.806963798643175
SIM,1832,44,40-44,1876,4
STAT,1906,48,45-49,1954,0.18082511851158256
STAT,1885,38,20-24,1923,0.7219085473227659
STAT,1923,45,40-44,1968,0.17507276280972464
STAT,1858,33,50-100,1891,0.6766472840275537
STAT,1807,84,na,1891,119.33121675816706
STAT,1913,47,50-100,1960,0.20850418810695504
STAT,1850,41,30-34,1891,0.813031303481238
STAT,1922,25,50-100,1947,1.0713024921512793
STAT,1873,46,30-34,1919,0.09308586599752328
STAT,1824,46,35-39,1870,0.16686530728291205
SIM,1839,38,30-34,1877,17
STAT,1874,38,45-49,1912,1.9152273915281002
STAT,1912,33,15-19,1945,0.1189225096044507
SIM,1857,29,35-39,1886,9
STAT,1884,16,25-29,1900,5.30310870211298
STAT,1933,31,50-100,1964,1.0532082029771161
SIM,1791,94,na,1885,3
SIM,1809,95,na,1904,6
SIM,1839,30,na,1869,1870
SIM,1783,75,na,1858,357
SIM,1841,19,30-34,1860,1
STAT,1842,17,30-34,1859,1.4575077626009842
STAT,1847,39,na,1886,1761.6179702955953
STAT,1882,37,40-44,1919,4.024019768595651
STAT,1836,45,15-19,1881,2.712069176155735E-4
STAT,1900,0,na,1900,3848.331863394
STAT,1846,20,45-49,1866,0.6154494028215745
STAT,1815,46,40-44,1861,0.4235566568647065
STAT,1891,35,40-44,1926,5.167255855204388
STAT,1892,18,50-100,1910,0.0578058757734371
SIM,1891,29,na,1920,2896
SIM,1881,39,40-44,1920,2
STAT,1869,15,45-49,1884,0.061280215037785676
STAT,1914,21,15-19,1935,4.9441153921591035
STAT,1827,84,na,1911,184.61121378574322
STAT,1841,34,na,1875,1762.1209823969343
SIM,1922,21,15-19,1943,4
STAT,1907,19,na,1926,3485.4029872879105
SIM,1888,31,na,1919,2625
STAT,1923,4,na,1927,4477.723944168953
SIM,1900,33,45-49,1933,4
STAT,1859,48,20-24,1907,0.008933417824942136
SIM,1836,97,na,1933,5
SIM,1841,44,35-39,1885,6
STAT,1848,52,30-34,1900,0.004265527614528916
SIM,1853,99,na,1952,1
SIM,1926,23,50-100,1949,3
STAT,1914,47,40-44,1961,0.14768945496134506
SIM,1891,40,30-34,1931,2
STAT,1833,37,45-49,1870,1.517235380468681
STAT,1823,40,45-49,1863,2.0535619905828058
STAT,1826,41,25-29,1867,0.6445505311137174
STAT,1847,39,50-100,1886,0.9180113218928747
STAT,1879,19,20-24,1898,17.411841072470942
STAT,1882,44,30-34,1926,1.042567348182944
STAT,1832,45,30-34,1877,0.07119108958764749
SIM,1874,43,35-39,1917,2
STAT,1860,30,20-24,1890,2.091981051189423
STAT,1911,58,na,1969,3116.13695787343
STAT,1850,34,40-44,1884,3.1281619455583805
STAT,1784,72,na,1856,427.72319139330006
STAT,1792,91,na,1883,16.97770336283582
SIM,1900,15,30-34,1915,3
STAT,1932,38,45-49,1970,0.8644442748835571
STAT,1937,16,15-19,1953,41.805326487707596
STAT,1958,8,na,1966,4875.410273223125
SIM,1945,16,15-19,1961,41
STAT,1769,95,na,1864,2.0596455025671347
STAT,1856,47,40-44,1903,0.12607930952005747
SIM,1828,30,45-49,1858,1
STAT,1866,43,35-39,1909,1.5658056133235922
STAT,1832,51,na,1883,1373.5484020673719
STAT,1833,44,35-39,1877,1.3014030608604985
STAT,1851,17,25-29,1868,5.052333548183202
SIM,1774,92,na,1866,2
STAT,1809,49,20-24,1858,0.042199975490939665
STAT,1892,26,na,1918,2832.9619194479965
STAT,1911,19,50-100,1930,0.07043011295093361
SIM,1871,32,50-100,1903,1
STAT,1841,14,na,1855,2087.47962
SIM,1867,89,na,1956,78
SIM,1907,27,35-39,1934,16
STAT,1948,20,30-34,1968,31.199128993235107
STAT,1917,29,na,1946,3684.6894973386165
STAT,1904,22,50-100,1926,0.5524838708232257
STAT,1915,46,45-49,1961,0.20738651635787345
STAT,1865,47,35-39,1912,0.11962198102780547
STAT,1898,29,30-34,1927,31.973128680043285
STAT,1933,19,35-39,1952,5.278069931567829
STAT,1880,49,25-29,1929,0.0560588823868514
STAT,1902,37,20-24,1939,0.22181046956044992
SIM,1781,74,na,1855,361
STAT,1815,53,30-34,1868,0.013570135144562812
STAT,1926,46,20-24,1972,0.012915146146578705
STAT,1886,32,50-100,1918,0.9145268155510913
STAT,1877,59,na,1936,1905.210901098977
SIM,1919,19,25-29,1938,59
STAT,1900,34,35-39,1934,13.158793431025947
SIM,1848,38,25-29,1886,2
SIM,1841,37,45-49,1878,2
STAT,1816,47,na,1863,1387.155634396442
STAT,1794,72,na,1866,519.107199617311
STAT,1872,40,40-44,1912,2.1542889418279865
STAT,1887,21,45-49,1908,0.7389420326662831
SIM,1800,72,na,1872,559
SIM,1941,19,35-39,1960,3
STAT,1822,43,50-100,1865,1.5512972794471733
STAT,1888,11,na,1899,2886.4071557508137
SIM,1920,26,25-29,1946,65
STAT,1809,65,na,1874,872.6472358220648
STAT,1928,18,15-19,1946,53.88538619272247
STAT,1860,15,25-29,1875,5.077370243436351
STAT,1875,78,na,1953,758.313098565473
STAT,1881,45,25-29,1926,0.053063288851039926
SIM,1863,40,40-44,1903,4
STAT,1848,38,50-100,1886,0.9020735825250721
STAT,1923,36,50-100,1959,0.46003372710030066
SIM,1882,46,na,1928,2052
STAT,1912,26,25-29,1938,61.47179871116681
STAT,1891,42,30-34,1933,1.3426597248536
STAT,1843,15,25-29,1858,5.286648897379651
SIM,1880,40,40-44,1920,4
STAT,1830,24,15-19,1854,7.35214077361605
SIM,1875,13,na,1888,2515
STAT,1844,37,20-24,1881,0.5718393751904827
STAT,1907,26,30-34,1933,35.05895759501237
STAT,1889,49,45-49,1938,0.1520167139846423
STAT,1874,42,30-34,1916,1.1086742874065165
STAT,1864,62,na,1926,1543.1730741341887
SIM,1840,38,40-44,1878,10
SIM,1842,81,na,1923,342
STAT,1854,47,50-100,1901,0.17603063400385818
STAT,1814,54,25-29,1868,0.008830328894165488
STAT,1840,47,30-34,1887,0.06798076892285783
SIM,1799,70,na,1869,610
SIM,1829,30,na,1859,1664
SIM,1879,17,20-24,1896,20
SIM,1882,42,30-34,1924,4
SIM,1915,44,45-49,1959,1
SIM,1888,41,na,1929,2532
STAT,1877,46,15-19,1923,3.9323978100518444E-4
STAT,1945,18,15-19,1963,46.8186982429467
STAT,1854,35,50-100,1889,0.8976180458483902
STAT,1915,40,50-100,1955,0.11203384182916565
SIM,1858,45,50-100,1903,2
STAT,1794,62,na,1856,845.5351391600001
SIM,1836,87,na,1923,89
SIM,1851,15,25-29,1866,6
STAT,1875,41,20-24,1916,0.15483150612536514
SIM,1791,74,na,1865,412
SIM,1877,30,40-44,1907,6
STAT,1867,42,25-29,1909,0.5688923351949512
STAT,1865,45,40-44,1910,0.1484309410279008
STAT,1906,8,na,1914,3575.9593551355574
SIM,1936,18,15-19,1954,37
STAT,1837,84,na,1921,209.99620376171924
SIM,1842,17,25-29,1859,8
STAT,1929,40,15-19,1969,0.0018840972622080564
SIM,1878,36,45-49,1914,2
STAT,1841,39,45-49,1880,1.573945328661126
STAT,1846,16,50-100,1862,0.04364986130161061
SIM,1787,99,na,1886,1
SIM,1953,18,15-19,1971,41
STAT,1856,54,30-34,1910,0.004283141467729142
STAT,1843,15,na,1858,2141.482095349696
STAT,1851,34,na,1885,1783.9194203538123
STAT,1828,48,na,1876,1397.3058730849282
STAT,1824,32,na,1856,1519.0757656161775
STAT,1865,53,50-100,1918,0.012756712283329648
SIM,1901,8,na,1909,3503
SIM,1849,30,na,1879,1843
SIM,1889,39,25-29,1928,2
STAT,1857,28,30-34,1885,19.178461476940903
STAT,1868,16,40-44,1884,0.16895651087920255
SIM,1865,28,30-34,1893,27
SIM,1874,27,na,1901,2293
SIM,1819,95,na,1914,3
STAT,1915,17,50-100,1932,0.07406974164425943
STAT,1816,67,na,1883,845.0035947816259
STAT,1872,81,na,1953,512.7541505907509
STAT,1850,36,35-39,1886,5.111000559970669
STAT,1920,28,25-29,1948,67.97324237686618
SIM,1837,17,15-19,1854,7
STAT,1849,29,35-39,1878,8.126369372310403
STAT,1853,108,na,1961,0.004817347651987045
SIM,1888,2,na,1890,2868
STAT,1797,69,na,1866,689.1789909734086
STAT,1898,11,na,1909,3307.5104157367355
STAT,1852,51,na,1903,1643.7445137252964
STAT,1765,102,na,1867,0.07518456620451422
STAT,1899,27,25-29,1926,54.76398930158634
SIM,1869,31,45-49,1900,2
SIM,1902,38,25-29,1940,1
STAT,1903,33,20-24,1936,2.0772656850369504
SIM,1833,27,25-29,1860,39
SIM,1915,19,40-44,1934,1
SIM,1883,18,25-29,1901,7
SIM,1906,21,30-34,1927,28
STAT,1927,44,15-19,1971,0.0018136027642435422
STAT,1849,95,na,1944,9.583302104516013
STAT,1920,35,15-19,1955,0.019898020550268944
SIM,1897,14,na,1911,3301
SIM,1851,54,na,1905,1560
STAT,1818,47,20-24,1865,0.025647720919395
SIM,1841,41,30-34,1882,1
SIM,1911,33,20-24,1944,1
STAT,1908,43,35-39,1951,0.1749022563191703
STAT,1859,26,40-44,1885,2.3140265799948825
STAT,1808,50,20-24,1858,0.0027936688645870513
STAT,1821,34,15-19,1855,0.3872505349483022
SIM,1828,78,na,1906,390
STAT,1907,44,45-49,1951,0.14225270537741852
STAT,1874,20,20-24,1894,66.9341845143105
STAT,1807,51,30-34,1858,0.0215041744569095
STAT,1882,15,50-100,1897,0.04524503079009425
STAT,1860,48,45-49,1908,0.17891460821440597
STAT,1824,51,30-34,1875,0.00687050577279408
SIM,1896,60,na,1956,2432
STAT,1924,44,30-34,1968,0.14319352187210824
STAT,1838,51,45-49,1889,0.010042266890761332
SIM,1882,35,40-44,1917,5
SIM,1860,1,na,1861,2949
STAT,1851,44,na,1895,1671.992541667562
STAT,1849,36,25-29,1885,2.14574517162982
STAT,1800,105,na,1905,0.011687439497433588
STAT,1918,47,25-29,1965,0.05332533571137368
SIM,1823,69,na,1892,763
SIM,1893,30,25-29,1923,13
STAT,1909,38,50-100,1947,0.37346836391853483
STAT,1824,39,45-49,1863,2.712350806415899
SIM,1866,9,na,1875,2434
SIM,1815,44,40-44,1859,6
STAT,1924,44,45-49,1968,0.18640958490457957
STAT,1864,52,na,1916,1808.2648165580313
STAT,1842,18,50-100,1860,0.04453655985548253
STAT,1919,28,15-19,1947,0.7180530640205343
STAT,1895,20,40-44,1915,2.5842467262706026
SIM,1867,26,40-44,1893,3
SIM,1857,36,25-29,1893,1
SIM,1915,26,30-34,1941,41
STAT,1892,18,25-29,1910,6.686214313927771
STAT,1900,35,45-49,1935,2.637455383619692
STAT,1904,34,50-100,1938,0.70668101745025
STAT,1885,30,25-29,1915,9.717616501871099
STAT,1917,48,20-24,1965,0.010873791590289051
SIM,1832,39,45-49,1871,1
SIM,1900,30,40-44,1930,5
STAT,1857,38,25-29,1895,2.1336486825355743
STAT,1848,30,20-24,1878,2.3186080973138505
SIM,1832,43,30-34,1875,1
STAT,1844,47,15-19,1891,2.7949431580703024E-4
STAT,1831,99,na,1930,1.1550033045910875
STAT,1849,85,na,1934,197.5935831711316
SIM,1901,32,35-39,1933,18
SIM,1823,90,na,1913,31
STAT,1858,45,50-100,1903,0.18396013297262742
SIM,1873,37,40-44,1910,4
SIM,1900,32,35-39,1932,13
STAT,1891,34,30-34,1925,20.24097334399185
SIM,1877,89,na,1966,197
STAT,1869,51,50-100,1920,0.013876587871232022
STAT,1904,31,15-19,1935,0.19372567134294227
SIM,1886,60,na,1946,1819
SIM,1884,27,na,1911,2348
STAT,1841,46,35-39,1887,0.09746174870572678
SIM,1904,11,na,1915,3466
STAT,1824,47,45-49,1871,0.2773366955863935
STAT,1934,30,30-34,1964,20.34394312864809
SIM,1863,25,45-49,1888,4
STAT,1819,65,na,1884,883.04794389118
SIM,1860,37,na,1897,1963
STAT,1873,97,na,1970,29.7903619162098
STAT,1851,40,20-24,1891,0.11763533215720265
SIM,1891,28,45-49,1919,2
STAT,1905,31,15-19,1936,0.11208561772725469
STAT,1857,59,na,1916,1447.3964333858246
STAT,1911,42,50-100,1953,0.10590265300076863
SIM,1874,28,25-29,1902,39
SIM,1808,48,na,1856,1258
STAT,1810,54,40-44,1864,0.03432623662892864
STAT,1844,96,na,1940,6.027912415659134
SIM,1811,88,na,1899,43
STAT,1848,48,45-49,1896,0.16788364726444543
STAT,1857,53,35-39,1910,0.006308658341956738
STAT,1897,40,45-49,1937,0.13263139093297102
SIM,1831,88,na,1919,73
STAT,1874,62,na,1936,1764.7320458608963
SIM,1861,54,na,1915,1807
SIM,1844,44,50-100,1888,3
STAT,1927,34,50-100,1961,0.9596719720355826
STAT,1881,48,30-34,1929,0.08718610062968234
SIM,1902,10,na,1912,3478
STAT,1871,48,20-24,1919,0.01109730943585435
SIM,1818,78,na,1896,288
STAT,1887,25,na,1912,2538.459195357704
STAT,1834,32,na,1866,1718.2500935176072
SIM,1824,37,45-49,1861,2
STAT,1900,42,35-39,1942,0.16459930971039716
STAT,1816,44,35-39,1860,4.978552309889556
STAT,1869,28,50-100,1897,0.5828992037016917
STAT,1909,46,20-24,1955,0.009614513305397414
STAT,1908,40,30-34,1948,0.1129803750493152
SIM,1857,28,25-29,1885,44
STAT,1761,105,na,1866,0.01245685684837533
STAT,1918,40,40-44,1958,0.25192033037346295
SIM,1893,33,50-100,1926,1
STAT,1832,53,30-34,1885,0.0036803125728786927
STAT,1836,44,50-100,1880,0.7735647432102244
SIM,1919,10,na,1929,4134
SIM,1869,21,30-34,1890,22
SIM,1844,62,na,1906,1273
STAT,1863,49,25-29,1912,0.04683313004030457
SIM,1912,48,50-100,1960,2
STAT,1907,19,40-44,1926,0.25241103835655243
STAT,1824,43,30-34,1867,1.4178896542234545
SIM,1857,34,50-100,1891,4
STAT,1853,15,na,1868,2072.115378166914
SIM,1889,29,30-34,1918,36
STAT,1883,35,35-39,1918,6.610778079570407
STAT,1924,36,45-49,1960,0.7601735396467856
STAT,1817,84,na,1901,147.52388833638912
STAT,1850,37,45-49,1887,1.4256431832692276
SIM,1881,84,na,1965,430
STAT,1920,33,20-24,1953,2.513433901977465
SIM,1833,45,na,1878,1490
SIM,1934,31,35-39,1965,16
STAT,1924,43,35-39,1967,0.22593593532758724
STAT,1950,15,na,1965,4113.950806062611
SIM,1842,40,na,1882,1644
SIM,1837,35,45-49,1872,4
SIM,1954,0,na,1954,4539
STAT,1884,22,50-100,1906,0.3806885440238038
STAT,1920,49,na,1969,3814.152809645992
STAT,1822,48,25-29,1870,0.07921054558763012
STAT,1865,44,30-34,1909,0.9736050975234809
STAT,1831,34,na,1865,1675.485299803647
STAT,1896,26,45-49,1922,1.391006452395791
STAT,1933,16,30-34,1949,15.452057479562683
SIM,1923,43,40-44,1966,4
SIM,1875,23,na,1898,2297
STAT,1927,19,na,1946,4300.758137178203
STAT,1928,44,15-19,1972,0.0018434709709359487
SIM,1926,40,40-44,1966,1
STAT,1883,28,45-49,1911,1.0243746087878023
STAT,1871,32,50-100,1903,0.8581037732504102
SIM,1938,32,30-34,1970,25
STAT,1837,30,45-49,1867,1.4091736557675465
STAT,1897,35,na,1932,3004.84667781302
SIM,1820,72,na,1892,587
STAT,1938,30,15-19,1968,0.1221892580899922
SIM,1941,16,30-34,1957,13
SIM,1873,44,30-34,1917,2
STAT,1805,52,45-49,1857,0.042338530724396806
STAT,1912,41,15-19,1953,0.0014069399765010606
SIM,1856,30,20-24,1886,2
STAT,1865,37,40-44,1902,3.7578446764788827
STAT,1887,59,na,1946,2053.263116185664
STAT,1900,31,30-34,1931,22.976035225872444
SIM,1903,59,na,1962,2738
STAT,1891,38,45-49,1929,2.3194356645147924
SIM,1867,79,na,1946,565
SIM,1898,29,25-29,1927,56
STAT,1832,38,40-44,1870,3.319771639163622
STAT,1944,7,na,1951,4023.328557442751
SIM,1819,64,na,1883,895
STAT,1829,35,45-49,1864,1.8427974690451059
STAT,1926,31,35-39,1957,10.446021666812603
SIM,1845,30,45-49,1875,1
STAT,1846,50,40-44,1896,0.007529423813111578
SIM,1810,72,na,1882,549
STAT,1898,39,25-29,1937,0.7867276849144312
STAT,1814,66,na,1880,801.3397437550036
STAT,1931,21,15-19,1952,6.542052156943216
SIM,1848,28,30-34,1876,26
STAT,1842,34,35-39,1876,8.532748653441331
STAT,1915,43,40-44,1958,0.23749346573108415
SIM,1784,92,na,1876,4
SIM,1839,15,25-29,1854,7
STAT,1878,21,na,1899,2332.9351577602074
SIM,1891,43,35-39,1934,3
STAT,1883,43,35-39,1926,1.6644617356242766
STAT,1873,47,40-44,1920,0.16339975933401057
STAT,1890,45,na,1935,2624.534066375574
STAT,1957,6,na,1963,4895.6612137713355
SIM,1883,5,na,1888,2509
STAT,1840,44,25-29,1884,0.4547024731289941
SIM,1892,56,na,1948,2460
STAT,1850,44,35-39,1894,1.2576094599053977
STAT,1804,66,na,1870,801.5127060635049
STAT,1929,18,50-100,1947,0.45053720731977065
SIM,1928,16,15-19,1944,55
STAT,1816,52,35-39,1868,0.021700203942711233
STAT,1849,51,20-24,1900,5.344303959766064E-4
SIM,1850,34,35-39,1884,9
STAT,1861,51,35-39,1912,0.006785919435748954
STAT,1948,23,35-39,1971,10.210721108422382
STAT,1950,8,na,1958,4390.322952917419
SIM,1865,13,na,1878,2325
STAT,1925,17,35-39,1942,4.7891774290675535
STAT,1857,45,35-39,1902,0.10530458721719786
STAT,1891,45,35-39,1936,0.09326270323713583
SIM,1871,30,na,1901,2323
SIM,1897,31,20-24,1928,6
STAT,1875,19,35-39,1894,0.529687167364402
SIM,1914,11,na,1925,4174
STAT,1824,36,40-44,1860,6.903952174662838
SIM,1855,16,20-24,1871,26
STAT,1861,44,45-49,1905,1.1582314220335748
STAT,1910,31,50-100,1941,0.7559692259841733
SIM,1899,25,25-29,1924,56
SIM,1895,43,na,1938,2872
SIM,1845,19,15-19,1864,3
STAT,1820,50,35-39,1870,0.014199527062029574
SIM,1833,90,na,1923,33
STAT,1888,21,na,1909,2647.3868967592057
STAT,1824,54,35-39,1878,0.009361118743054566
STAT,1764,96,na,1860,1.0527004725335964
STAT,1821,99,na,1920,1.0226856982227965
SIM,1859,29,na,1888,1979
STAT,1875,18,25-29,1893,5.485366010031712
SIM,1832,36,40-44,1868,5
SIM,1808,68,na,1876,745
STAT,1830,47,20-24,1877,0.00879508997656676
SIM,1786,73,na,1859,435
SIM,1841,64,na,1905,1197
SIM,1933,17,35-39,1950,5
SIM,1831,40,45-49,1871,3
STAT,1917,19,na,1936,3709.4193739933867
STAT,1847,16,20-24,1863,16.377224098962092
STAT,1866,40,30-34,1906,1.0114523915849147
SIM,1872,70,na,1942,1280
SIM,1826,97,na,1923,6
STAT,1889,31,20-24,1920,3.16538485713514
SIM,1945,13,na,1958,3925
STAT,1789,108,na,1897,4.041554151331886E-4
STAT,1907,29,35-39,1936,13.180008953438444
STAT,1882,71,na,1953,1227.015558647242
SIM,1833,24,20-24,1857,54
STAT,1922,49,40-44,1971,0.1701164926847077
STAT,1846,54,20-24,1900,5.059790949135692E-4
SIM,1898,61,na,1959,2458
STAT,1890,31,45-49,1921,2.0223928785853986
STAT,1901,31,30-34,1932,23.181103625620782
STAT,1839,17,25-29,1856,4.942717570753771
STAT,1837,39,na,1876,1612.2762605711412
STAT,1919,42,15-19,1961,0.0015721518036822548
SIM,1891,35,35-39,1926,17
STAT,1787,69,na,1856,653.4102502400001
STAT,1883,12,na,1895,2391.060263651199
SIM,1793,75,na,1868,355
STAT,1881,15,45-49,1896,0.0598603632498686
STAT,1849,28,25-29,1877,35.884087824378085
SIM,1843,45,na,1888,1604
SIM,1850,42,35-39,1892,5
STAT,1873,39,40-44,1912,4.155376682060505
STAT,1867,28,40-44,1895,2.6477137483270337
STAT,1826,49,20-24,1875,0.010923127795740025
STAT,1859,95,na,1954,10.023832700679332
SIM,1847,17,25-29,1864,5
STAT,1806,48,40-44,1854,0.49824387976543216
STAT,1881,44,15-19,1925,0.012426523089606616
SIM,1911,24,na,1935,3418
STAT,1920,25,20-24,1945,19.04594971531543
SIM,1813,79,na,1892,279
SIM,1922,40,na,1962,4058
SIM,1872,41,45-49,1913,1
STAT,1859,18,40-44,1877,0.15912452738987548
SIM,1824,44,35-39,1868,1
STAT,1900,32,40-44,1932,5.683655224543968
SIM,1878,18,15-19,1896,4
STAT,1911,20,35-39,1931,8.484567894871288
STAT,1843,41,25-29,1884,0.4831576090332186
STAT,1870,27,20-24,1897,10.859446555970456
STAT,1824,86,na,1910,117.13679859615158
STAT,1836,67,na,1903,1001.0476703828799
SIM,1840,46,50-100,1886,1
STAT,1842,42,35-39,1884,1.3341310449258155
STAT,1885,33,50-100,1918,0.8587122801576392
STAT,1896,30,na,1926,3003.334939315646
STAT,1832,46,40-44,1878,0.12430349057381597
STAT,1853,31,40-44,1884,3.346530762792619
STAT,1851,54,30-34,1905,0.004245064947349617
STAT,1877,17,45-49,1894,0.06403676063602368
SIM,1915,29,35-39,1944,19
SIM,1821,44,50-100,1865,4
STAT,1855,25,45-49,1880,0.9137853756802639
STAT,1881,35,50-100,1916,1.1305137864814059
STAT,1852,39,20-24,1891,0.5797751637897071
STAT,1854,108,na,1962,0.005629998426599878
STAT,1850,33,30-34,1883,12.725504255457405
STAT,1904,22,na,1926,3204.222512257473
STAT,1892,15,20-24,1907,21.070416466057328
STAT,1919,52,na,1971,3701.0085019800367
STAT,1862,35,15-19,1897,0.04568122901652838
STAT,1864,41,45-49,1905,1.2693470356698762
STAT,1924,40,15-19,1964,0.0017305748953969097
SIM,1898,41,na,1939,2951
STAT,1823,49,na,1872,1336.0992385882046
STAT,1948,2,na,1950,4348.1394497056335
STAT,1885,48,15-19,1933,3.717410505514945E-4
STAT,1840,43,15-19,1883,0.009904634458974498
STAT,1891,27,40-44,1918,3.5027330146024394
STAT,1863,20,45-49,1883,0.5991787706522219
STAT,1850,80,na,1930,435.4932219083828
STAT,1832,46,50-100,1878,0.1783232316742615
STAT,1795,98,na,1893,0.6275525354327969
SIM,1865,38,45-49,1903,1
STAT,1930,21,15-19,1951,6.461989871803753
STAT,1839,85,na,1924,182.7851909816109
STAT,1865,48,45-49,1913,0.2000473930756366
STAT,1837,19,15-19,1856,5.025599221489268
SIM,1856,63,na,1919,1377
STAT,1820,43,45-49,1863,2.61836850337143
SIM,1893,62,na,1955,2224
STAT,1837,50,na,1887,1419.247960091015
STAT,1846,13,na,1859,2104.8087221204573
STAT,1911,45,15-19,1956,3.309259134548612E-4
STAT,1843,19,40-44,1862,0.16665057035277225
SIM,1854,0,na,1854,2983
STAT,1916,34,45-49,1950,1.521561156077028
STAT,1877,47,50-100,1924,0.2396433866403675
SIM,1915,22,35-39,1937,14
SIM,1846,25,45-49,1871,4
STAT,1865,30,20-24,1895,2.3390787361117056
STAT,1816,41,30-34,1857,3.5838317552783026
STAT,1881,37,25-29,1918,2.62624236567098
SIM,1845,16,na,1861,2067
STAT,1830,28,na,1858,1690.4858015997756
STAT,1856,33,na,1889,1768.7721100020299
SIM,1879,26,na,1905,2375
STAT,1829,31,na,1860,1760.9847889874634
SIM,1883,42,na,1925,2180
STAT,1799,71,na,1870,616.1877155878948
STAT,1910,32,35-39,1942,8.321558914640706
STAT,1851,29,50-100,1880,0.541388463789592
SIM,1821,98,na,1919,2
STAT,1879,92,na,1971,163.5144017688644
SIM,1832,50,na,1882,1405
STAT,1858,52,25-29,1910,0.002612877520823896
STAT,1831,43,20-24,1874,0.11936553946762467
STAT,1933,31,40-44,1964,4.984979600819023
STAT,1814,46,25-29,1860,0.15882026364059007
SIM,1850,31,30-34,1881,16
STAT,1951,21,na,1972,4123.245284357135
STAT,1863,46,20-24,1909,0.009993255761785913
STAT,1834,32,35-39,1866,8.029573299780699
SIM,1842,32,35-39,1874,6
SIM,1853,45,na,1898,1835
SIM,1868,75,na,1943,834
STAT,1823,44,25-29,1867,0.7864205985596715
SIM,1853,35,na,1888,1933
STAT,1886,30,na,1916,2400.9802201613484
SIM,1938,3,na,1941,3700
SIM,1851,10,na,1861,2197
SIM,1891,25,40-44,1916,3
SIM,1960,1,na,1961,4675
SIM,1930,25,50-100,1955,2
STAT,1826,98,na,1924,1.7731094563871692
SIM,1917,18,na,1935,3928
STAT,1831,35,50-100,1866,0.9924918612276113
STAT,1920,41,50-100,1961,0.12275606742465228
SIM,1867,29,45-49,1896,3
STAT,1833,52,20-24,1885,4.62746475936496E-4
SIM,1895,5,na,1900,3280
STAT,1922,45,25-29,1967,0.057843884262829035
STAT,1860,45,40-44,1905,0.132750860946544
SIM,1861,31,40-44,1892,3
SIM,1864,38,50-100,1902,1
STAT,1855,51,45-49,1906,0.010327402965863725
STAT,1785,102,na,1887,0.08597227052159107
STAT,1913,33,15-19,1946,0.12024428666565841
SIM,1813,70,na,1883,660
STAT,1893,21,50-100,1914,0.4902597970428834
SIM,1779,91,na,1870,20
SIM,1898,26,20-24,1924,13
STAT,1838,25,45-49,1863,0.9772659897446866
STAT,1859,44,50-100,1903,0.7857339565313426
STAT,1881,49,40-44,1930,0.1528985670204024
STAT,1859,29,45-49,1888,0.8393495613138463
STAT,1922,31,15-19,1953,0.1377346480487221
SIM,1858,17,35-39,1875,1
SIM,1868,40,40-44,1908,6
SIM,1857,25,20-24,1882,8
STAT,1839,41,na,1880,1644.5594796666037
STAT,1872,44,20-24,1916,0.14855424276097534
STAT,1883,25,40-44,1908,2.792310390674705
STAT,1945,25,50-100,1970,1.0324971046131795
SIM,1855,39,50-100,1894,3
SIM,1826,43,na,1869,1496
STAT,1939,33,35-39,1972,8.801916669205223
STAT,1822,45,20-24,1867,0.017225891511613307
STAT,1842,31,30-34,1873,15.176488781144455
STAT,1942,24,45-49,1966,1.1136736438778168
STAT,1912,22,50-100,1934,0.5955813186703776
STAT,1866,51,20-24,1917,6.457948631968858E-4
STAT,1918,23,50-100,1941,0.6683291882801143
SIM,1892,42,25-29,1934,2
STAT,1920,43,15-19,1963,0.0015998121874350834
SIM,1835,41,40-44,1876,6
SIM,1925,37,na,1962,4167
STAT,1863,50,40-44,1913,0.008867933716691851
SIM,1892,15,na,1907,3071
SIM,1855,13,na,1868,2287
SIM,1887,26,45-49,1913,1
STAT,1890,34,50-100,1924,1.0492277225921407
SIM,1875,16,25-29,1891,6
SIM,1751,105,na,1856,1
STAT,1839,40,20-24,1879,0.125826694220435
SIM,1921,44,na,1965,3837
STAT,1843,52,50-100,1895,0.01083795519943876
STAT,1879,26,45-49,1905,1.1001113034434924
SIM,1817,73,na,1890,535
STAT,1890,35,25-29,1925,3.3571336745140146
STAT,1811,52,35-39,1863,0.02733660452639071
STAT,1924,33,40-44,1957,4.310821385830178
SIM,1885,77,na,1962,1004
STAT,1873,12,na,1885,2515.540446048195
STAT,1888,65,na,1953,1886.0153285513693
SIM,1890,8,na,1898,3112
SIM,1882,20,20-24,1902,63
SIM,1816,42,35-39,1858,2
SIM,1932,33,40-44,1965,5
STAT,1907,22,35-39,1929,8.096536273008041
STAT,1867,50,25-29,1917,0.003186915652270083
STAT,1894,32,50-100,1926,1.1134401616760592
SIM,1792,80,na,1872,187
STAT,1840,48,40-44,1888,0.11869991696333354
STAT,1855,47,25-29,1902,0.04060425308892368
SIM,1839,61,na,1900,1348
STAT,1875,33,35-39,1908,9.78722549492037
STAT,1867,16,25-29,1883,5.1689243711852555
STAT,1892,30,30-34,1922,20.82099171793665
SIM,1917,9,na,1926,3994
STAT,1805,53,20-24,1858,0.002109837235077389
STAT,1890,49,35-39,1939,0.08930991263198854
STAT,1855,18,20-24,1873,14.846145539209662
STAT,1817,51,25-29,1868,0.0077439174966277115
SIM,1898,19,30-34,1917,2
STAT,1811,45,45-49,1856,0.8133286133558986
STAT,1949,23,50-100,1972,0.7251551274777214
STAT,1924,40,30-34,1964,0.1440703498302118
SIM,1863,18,20-24,1881,12
STAT,1894,32,40-44,1926,5.270065763823518
STAT,1894,46,15-19,1940,2.7497242905621635E-4
SIM,1858,24,25-29,1882,50
STAT,1870,37,15-19,1907,0.051980564655412086
SIM,1888,10,na,1898,2813
STAT,1882,40,15-19,1922,0.012822780808686929
STAT,1884,42,25-29,1926,0.5987410402029452
STAT,1800,73,na,1873,506.2288727376347
STAT,1827,41,40-44,1868,2.105927890122758
STAT,1899,22,50-100,1921,0.5279309568040758
STAT,1920,36,25-29,1956,1.0193890706583586
STAT,1935,17,na,1952,4753.285814397185
SIM,1883,33,35-39,1916,15
SIM,1838,19,25-29,1857,5
SIM,1839,16,20-24,1855,14
STAT,1839,31,na,1870,1796.8792229756825
STAT,1939,15,20-24,1954,128.50383300859946
SIM,1890,33,25-29,1923,21
STAT,1790,68,na,1858,666.7569151558332
STAT,1868,42,40-44,1910,2.0262973705180323
SIM,1804,96,na,1900,7
SIM,1842,50,na,1892,1501
SIM,1879,24,45-49,1903,2
SIM,1807,83,na,1890,103
SIM,1894,30,40-44,1924,5
STAT,1835,54,45-49,1889,0.008869470550057493
SIM,1865,42,30-34,1907,1
SIM,1954,17,na,1971,4116
STAT,1869,16,40-44,1885,0.17057401027872995
SIM,1855,19,25-29,1874,6
SIM,1866,53,na,1919,1841
STAT,1828,40,45-49,1868,1.3652754651140604
SIM,1862,35,50-100,1897,1
STAT,1808,80,na,1888,276.8900871697874
STAT,1864,45,25-29,1909,0.04911714273021803
SIM,1858,75,na,1933,799
STAT,1921,3,na,1924,4368.049785741758
STAT,1858,19,35-39,1877,0.4697755276208611
STAT,1797,90,na,1887,31.016683129391495
STAT,1949,18,35-39,1967,4.609247354682231
STAT,1927,41,45-49,1968,0.1974897194619696
STAT,1820,36,20-24,1856,1.8810908768170593
STAT,1912,23,20-24,1935,100.3362762911243
STAT,1921,35,30-34,1956,1.9259921348150775
SIM,1834,31,na,1865,1697
STAT,1901,20,40-44,1921,2.77183348616397
SIM,1920,23,20-24,1943,110
STAT,1874,53,20-24,1927,7.010447330060553E-4
STAT,1835,33,50-100,1868,0.7202994199926458
STAT,1901,49,20-24,1950,0.008763679009883597
STAT,1893,47,45-49,1940,0.15882024734398792
SIM,1823,42,25-29,1865,3
SIM,1837,28,na,1865,1750
SIM,1876,42,40-44,1918,3
SIM,1897,55,na,1952,2634
SIM,1899,48,50-100,1947,2
SIM,1924,16,30-34,1940,16
STAT,1789,71,na,1860,529.1604237992656
SIM,1889,26,na,1915,2829
STAT,1849,25,20-24,1874,10.169208357552574
STAT,1890,42,15-19,1932,0.015931088292755358
STAT,1842,50,20-24,1892,5.330330744412223E-4
STAT,1882,33,25-29,1915,9.37578127774569
SIM,1827,83,na,1910,200
SIM,1803,70,na,1873,591
SIM,1819,40,45-49,1859,1
STAT,1886,30,40-44,1916,4.36337523110046
STAT,1866,25,20-24,1891,10.287287470214247
SIM,1862,47,50-100,1909,3
STAT,1822,52,45-49,1874,0.019482530853512835
SIM,1822,50,na,1872,1339
STAT,1878,31,45-49,1909,1.7219747751270376
STAT,1932,35,40-44,1967,1.903446203084338
STAT,1910,5,na,1915,3750.2909118341263
SIM,1825,29,40-44,1854,2
STAT,1866,33,na,1899,2069.6796970104256
STAT,1762,105,na,1867,0.0038129193127192052
STAT,1932,21,30-34,1953,35.733678597731405
SIM,1821,88,na,1909,53
SIM,1834,21,na,1855,1736
STAT,1898,32,25-29,1930,13.098518286652082
SIM,1874,25,20-24,1899,13
STAT,1934,19,50-100,1953,0.4761544224543456
SIM,1857,18,30-34,1875,1
SIM,1886,31,45-49,1917,1
STAT,1884,62,na,1946,1706.2596152609044
STAT,1882,47,35-39,1929,0.12809502729780206
SIM,1889,36,na,1925,2783
STAT,1916,16,30-34,1932,2.4489297955455562
STAT,1873,22,na,1895,2267.8648029185124
STAT,1857,31,25-29,1888,7.755395473293461
SIM,1923,21,30-34,1944,32
STAT,1901,16,50-100,1917,0.06494042609976956
SIM,1891,32,30-34,1923,32
SIM,1908,15,35-39,1923,4
STAT,1866,18,30-34,1884,1.4165257181931938
SIM,1904,42,na,1946,3102
STAT,1849,18,30-34,1867,1.4058094531654968
STAT,1883,51,20-24,1934,6.864842159891973E-4
SIM,1869,24,35-39,1893,11
STAT,1810,102,na,1912,0.1327633640594031
STAT,1834,86,na,1920,137.3316805553974
SIM,1824,34,40-44,1858,3
STAT,1938,17,50-100,1955,0.34909512623640887
SIM,1866,63,na,1929,1530
SIM,1874,82,na,1956,444
SIM,1881,35,25-29,1916,1
SIM,1929,9,na,1938,4883
STAT,1934,22,na,1956,4636.060725058595
STAT,1876,48,20-24,1924,0.011556015802606862
STAT,1830,102,na,1932,0.1751285122875998
SIM,1865,35,40-44,1900,3
SIM,1857,43,35-39,1900,3
STAT,1880,24,50-100,1904,0.40280550565308926
STAT,1917,40,na,1957,3671.4521606060266
STAT,1922,41,na,1963,4033.1729242685356
STAT,1915,21,30-34,1936,28.148479004329616
STAT,1852,50,30-34,1902,0.004587573912670882
STAT,1887,80,na,1967,998.3739422069402
SIM,1873,42,na,1915,2215
STAT,1886,40,na,1926,2330.181722839569
SIM,1865,31,25-29,1896,16
SIM,1924,34,45-49,1958,2
STAT,1793,86,na,1879,70.69100339941946
STAT,1883,32,30-34,1915,16.165378116112556
STAT,1830,73,na,1903,709.5058028481819
SIM,1874,18,30-34,1892,2
SIM,1903,19,15-19,1922,10
STAT,1840,28,na,1868,1864.94542800372
STAT,1916,41,35-39,1957,0.19521757460467226
STAT,1873,42,15-19,1915,0.013226057090491971
STAT,1893,40,25-29,1933,0.777466252790264
SIM,1939,16,25-29,1955,50
SIM,1907,16,30-34,1923,4
STAT,1821,102,na,1923,0.15831410772281324
SIM,1780,88,na,1868,42
STAT,1821,68,na,1889,822.5778433692823
STAT,1911,38,25-29,1949,0.8937497113252243
STAT,1869,41,45-49,1910,1.3747753589544456
SIM,1901,24,na,1925,3194
STAT,1906,45,40-44,1951,0.1341684192405739
SIM,1854,82,na,1936,309
STAT,1812,44,15-19,1856,0.04758084837914433
STAT,1906,31,30-34,1937,13.847348950287628
SIM,1881,30,na,1911,2010
STAT,1914,22,na,1936,3523.9036557660725
SIM,1883,15,20-24,1898,18
SIM,1912,30,na,1942,3391
STAT,1892,41,20-24,1933,0.18872699298627604
SIM,1849,26,25-29,1875,40
STAT,1868,45,na,1913,2049.5360046514734
SIM,1851,52,50-100,1903,1
SIM,1853,36,50-100,1889,1
STAT,1847,19,25-29,1866,5.142842920474882
STAT,1856,7,na,1863,2165.429900430285
SIM,1919,18,15-19,1937,47
STAT,1825,50,20-24,1875,7.760888589109594E-4
STAT,1925,43,35-39,1968,0.22997419786898896
STAT,1841,32,25-29,1873,8.50267889408927
STAT,1875,15,20-24,1890,17.286156391871213
STAT,1832,49,45-49,1881,0.15004485347218113
SIM,1824,41,30-34,1865,3
SIM,1860,43,40-44,1903,7
STAT,1931,36,50-100,1967,0.5257804667787246
SIM,1877,41,45-49,1918,1
SIM,1932,22,35-39,1954,16
STAT,1864,49,40-44,1913,0.14152799236905456
STAT,1922,42,20-24,1964,0.0191508217462184
SIM,1833,35,na,1868,1639
SIM,1850,20,25-29,1870,56
STAT,1845,108,na,1953,0.0012902319367648907
STAT,1895,44,na,1939,2820.5431016331045
STAT,1817,94,na,1911,8.863090258401956
STAT,1874,35,40-44,1909,4.266757687798021
STAT,1881,34,20-24,1915,2.444469453295581
SIM,1878,41,na,1919,2353
STAT,1930,33,15-19,1963,0.15657904043951454
STAT,1901,30,35-39,1931,13.498525120830006
STAT,1810,73,na,1883,543.883329891253
STAT,1831,46,25-29,1877,0.042897774942845836
STAT,1879,51,na,1930,2136.2794687242795
SIM,1899,36,na,1935,3072
SIM,1866,26,25-29,1892,33
STAT,1912,48,35-39,1960,0.11670196399134604
STAT,1922,5,na,1927,4396.2515222433085
SIM,1924,31,40-44,1955,7
STAT,1853,49,30-34,1902,0.07028876715198092
STAT,1847,60,na,1907,1403.2812538157102
STAT,1908,59,na,1967,2950.7885564320327
SIM,1782,80,na,1862,194
STAT,1865,1,na,1866,3085.944623380116
SIM,1844,31,na,1875,1889
STAT,1820,46,15-19,1866,6.692929571879439E-4
SIM,1849,23,20-24,1872,59
STAT,1830,46,25-29,1876,0.0427652033929756
STAT,1861,34,na,1895,1855.9779609445495
SIM,1943,22,na,1965,3591
STAT,1880,48,na,1928,2208.238515167494
STAT,1787,90,na,1877,29.406901473542543
SIM,1911,36,25-29,1947,1
STAT,1815,49,45-49,1864,0.5556607115660395
STAT,1870,21,50-100,1891,0.3786187831230336
SIM,1846,28,50-100,1874,1
STAT,1918,44,20-24,1962,0.017678906365430146
STAT,1844,41,40-44,1885,1.6380240826879282
STAT,1890,46,30-34,1936,0.06324730450976249
STAT,1847,50,50-100,1897,0.011272122760574578
STAT,1903,23,50-100,1926,0.5463902101916486
STAT,1880,46,20-24,1926,0.011961847284808097
STAT,1882,81,na,1963,722.8134249074579
STAT,1834,108,na,1942,0.0011337570177684918
SIM,1818,68,na,1886,697
SIM,1797,68,na,1865,739
STAT,1900,43,30-34,1943,0.10387550173066742
STAT,1875,52,25-29,1927,0.003419357764742456
STAT,1891,41,na,1932,2714.7765864955277
STAT,1876,40,25-29,1916,0.6325863748425536
SIM,1803,69,na,1872,661
STAT,1939,30,30-34,1969,15.201661559456955
STAT,1776,112,na,1888,6.543969268278569E-4
STAT,1833,41,30-34,1874,0.8587103638373085
STAT,1835,47,20-24,1882,0.007892030659776582
STAT,1897,44,25-29,1941,0.05557863257215993
STAT,1902,30,35-39,1932,13.609401323842409
SIM,1940,9,na,1949,3642
SIM,1950,21,40-44,1971,3
STAT,1911,42,45-49,1953,0.1500287588476822
SIM,1940,21,30-34,1961,36
STAT,1912,30,45-49,1942,1.4741661651238593
SIM,1899,29,40-44,1928,3
STAT,1858,26,25-29,1884,32.3476175837312
STAT,1923,48,45-49,1971,0.23954028801786437
STAT,1814,43,20-24,1857,0.4724118236727202
STAT,1891,20,20-24,1911,81.06062780035577
STAT,1924,22,35-39,1946,10.497162171093619
STAT,1933,34,45-49,1967,2.0007469737994192
STAT,1863,53,45-49,1916,0.011857809108066868
STAT,1903,36,25-29,1939,0.8392686538892492
SIM,1906,32,35-39,1938,9
STAT,1820,52,50-100,1872,0.023936958232947045
STAT,1914,43,25-29,1957,0.0667276442734315
SIM,1852,41,40-44,1893,2
STAT,1875,88,na,1963,265.24226542119663
STAT,1897,48,40-44,1945,0.12047630594944439
STAT,1904,43,15-19,1947,0.0012898666874504266
STAT,1904,56,na,1960,2858.3864684715663
SIM,1846,18,20-24,1864,13
SIM,1920,30,45-49,1950,1
SIM,1910,30,35-39,1940,4
STAT,1931,24,50-100,1955,0.8011780241419042
SIM,1846,97,na,1943,5
STAT,1871,47,25-29,1918,0.05369340847059594
STAT,1825,42,35-39,1867,2.0226634109841863
STAT,1838,45,na,1883,1619.6039282456359
STAT,1825,72,na,1897,714.0333588187967
SIM,1884,37,na,1921,2319
STAT,1861,47,15-19,1908,3.1232749291146305E-4
SIM,1871,64,na,1935,1608
STAT,1840,40,45-49,1880,1.2257962255638986
STAT,1882,26,na,1908,2201.340239798229
STAT,1868,11,na,1879,2420.019180779984
STAT,1920,47,30-34,1967,0.09309732821078211
STAT,1824,50,50-100,1874,0.01778195893572668
STAT,1900,9,na,1909,3400.4989598324573
STAT,1926,23,50-100,1949,0.7529287705768926
SIM,1841,34,40-44,1875,5
STAT,1916,19,35-39,1935,0.8364984880159384
STAT,1875,30,30-34,1905,17.081528485680426
STAT,1833,34,40-44,1867,3.3301885801029836
STAT,1848,45,na,1893,1636.997302063667
SIM,1804,55,na,1859,1061
STAT,1838,18,20-24,1856,15.877506360252822
STAT,1815,72,na,1887,585.5271115591198
SIM,1934,23,50-100,1957,4
STAT,1865,40,15-19,1905,0.011974597882354908
STAT,1867,54,40-44,1921,0.0090812405048578
SIM,1898,15,15-19,1913,6
SIM,1927,18,na,1945,4237
SIM,1865,23,na,1888,2046
SIM,1904,1,na,1905,3550
STAT,1838,28,50-100,1866,0.5510029944554534
SIM,1831,98,na,1929,2
SIM,1913,56,na,1969,3137
SIM,1837,40,50-100,1877,1
STAT,1823,48,40-44,1871,0.2012999761899344
STAT,1842,20,25-29,1862,52.163457325803265
STAT,1829,40,50-100,1869,0.9165910019623785
SIM,1922,19,na,1941,4001
SIM,1908,46,50-100,1954,3
STAT,1862,32,45-49,1894,1.4052378949754403
SIM,1875,67,na,1942,1471
STAT,1895,31,45-49,1926,2.1585690032853435
SIM,1858,28,40-44,1886,2
STAT,1863,12,na,1875,2262.098405232694
STAT,1878,11,na,1889,2551.358285394152
STAT,1885,45,45-49,1930,0.22433275336688777
STAT,1892,41,50-100,1933,1.255444755498328
SIM,1827,28,na,1855,1629
STAT,1865,78,na,1943,670.7310245789636
STAT,1890,39,40-44,1929,5.005246261877456
SIM,1848,34,na,1882,1828
STAT,1933,36,na,1969,4845.421986304405
STAT,1782,91,na,1873,16.142858630901614
SIM,1860,68,na,1928,1244
STAT,1901,23,45-49,1924,0.9192100552510172
SIM,1912,19,na,1931,3533
STAT,1820,39,25-29,1859,5.741097155520124
STAT,1940,23,30-34,1963,27.64732290865585
STAT,1818,54,45-49,1872,0.02857257878548429
SIM,1849,16,30-34,1865,6
STAT,1843,29,50-100,1872,0.5598431084478829
STAT,1949,15,30-34,1964,13.400153286876561
STAT,1869,92,na,1961,76.84710161146505
SIM,1813,69,na,1882,717
STAT,1897,25,na,1922,3035.626037492291
STAT,1908,15,na,1923,3554.8923735321882
STAT,1867,59,na,1926,1723.8536361700164
STAT,1841,36,40-44,1877,3.5655909275035818
SIM,1922,30,na,1952,4084
STAT,1908,17,35-39,1925,0.7687584600751903
STAT,1860,52,30-34,1912,0.004545798321733239
STAT,1885,21,50-100,1906,0.38496265363782567
SIM,1840,17,na,1857,1998
STAT,1874,45,35-39,1919,0.13652204549903285
SIM,1869,28,50-100,1897,1
STAT,1868,19,45-49,1887,0.059281628147224104
STAT,1814,50,45-49,1864,0.039196775155161644
STAT,1909,55,na,1964,3088.223014487176
SIM,1843,35,na,1878,1792
SIM,1838,16,20-24,1854,14
STAT,1842,20,na,1862,1948.3089438435838
STAT,1936,26,50-100,1962,0.9001297331024888
STAT,1911,35,20-24,1946,0.24276065568814786
STAT,1917,41,35-39,1958,0.19879888178403893
STAT,1939,18,25-29,1957,40.96069444721885
SIM,1883,30,30-34,1913,22
STAT,1889,46,40-44,1935,0.2002326552688676
SIM,1924,19,35-39,1943,5
STAT,1787,79,na,1866,268.23641420814727
SIM,1914,52,na,1966,3656
STAT,1864,15,45-49,1879,0.06344188322201687
STAT,1861,37,20-24,1898,0.6047129604696478
SIM,1812,84,na,1896,142
STAT,1834,51,25-29,1885,0.0022930292831892097
STAT,1869,19,45-49,1888,0.05984915879420641
STAT,1872,4,na,1876,2786.443596210561
STAT,1856,43,25-29,1899,0.47169590989736254
SIM,1833,42,35-39,1875,3
SIM,1961,10,na,1971,4704
SIM,1891,21,25-29,1912,60
SIM,1915,37,na,1952,3543
SIM,1862,30,45-49,1892,2
STAT,1842,61,na,1903,1330.6789081746858
STAT,1857,60,na,1917,1420.373541974511
STAT,1892,33,35-39,1925,11.929830585251523
STAT,1870,41,35-39,1911,1.6837995477080676
STAT,1866,74,na,1940,966.6136786150447
SIM,1904,48,50-100,1952,2
SIM,1835,57,na,1892,1283
STAT,1842,53,25-29,1895,0.00248181353083032
SIM,1861,3,na,1864,2634
STAT,1872,47,25-29,1919,0.05436182761868057
STAT,1784,102,na,1886,0.07011588242070509
STAT,1775,112,na,1887,7.016196770273615E-4
STAT,1942,21,40-44,1963,3.331358933901216
SIM,1809,54,na,1863,1159
SIM,1839,19,25-29,1858,4
STAT,1763,105,na,1868,0.007002578834581332
STAT,1818,79,na,1897,337.05508451854064
SIM,1828,68,na,1896,777
STAT,1844,86,na,1930,155.75911794322232
SIM,1847,18,20-24,1865,14
SIM,1861,64,na,1925,1483
STAT,1876,18,40-44,1894,0.17790984671640797
STAT,1883,21,25-29,1904,53.161846242771716
SIM,1940,31,25-29,1971,12
STAT,1854,30,45-49,1884,1.3129139996239947
STAT,1924,22,na,1946,4071.1397592393323
STAT,1881,41,na,1922,2117.7224594466034
SIM,1918,49,50-100,1967,2
STAT,1840,46,50-100,1886,0.174704115668532
SIM,1881,32,20-24,1913,2
SIM,1811,43,45-49,1854,4
SIM,1852,50,na,1902,1684
SIM,1822,84,na,1906,134
SIM,1785,87,na,1872,45
SIM,1939,27,30-34,1966,41
STAT,1839,18,20-24,1857,15.372361801499562
STAT,1866,28,25-29,1894,36.71438258870729
STAT,1870,34,45-49,1904,1.6003828407501366
STAT,1843,49,20-24,1892,0.008476703709402709
STAT,1903,43,15-19,1946,0.0012795939552737695
SIM,1889,4,na,1893,3098
STAT,1836,42,45-49,1878,1.124326542756663
STAT,1853,45,15-19,1898,2.996002856560122E-4
SIM,1906,23,na,1929,3310
STAT,1881,41,45-49,1922,1.3713283115005592
SIM,1824,30,25-29,1854,7
STAT,1956,7,na,1963,4912.896508034667
SIM,1864,82,na,1946,338
SIM,1876,63,na,1939,1720
STAT,1925,40,30-34,1965,0.1466453890607018
SIM,1891,30,na,1921,2952
SIM,1887,19,20-24,1906,18
STAT,1874,52,na,1926,2067.8839740468716
STAT,1828,79,na,1907,396.8656228166474
STAT,1912,41,na,1953,3402.5693136511445
STAT,1858,45,na,1903,1685.1832602230174
SIM,1839,20,na,1859,1903
STAT,1873,32,20-24,1905,2.591985538736287
STAT,1906,41,25-29,1947,0.06161968320612538
SIM,1879,81,na,1960,723
STAT,1905,6,na,1911,3566.2737282182943
SIM,1949,16,35-39,1965,7
STAT,1927,40,na,1967,4412.9074595282555
STAT,1896,16,50-100,1912,0.06131816807858328
SIM,1826,87,na,1913,90
STAT,1847,27,50-100,1874,0.5657314507121708
STAT,1916,31,40-44,1947,3.8322487789902455
STAT,1807,54,35-39,1861,0.029286799321383238
STAT,1896,40,na,1936,2924.8409285540984
SIM,1878,39,50-100,1917,2
STAT,1893,44,40-44,1937,0.18468994566155994
STAT,1848,45,40-44,1893,0.124566120875347
STAT,1852,53,35-39,1905,0.0064359035388250815
SIM,1944,26,50-100,1970,1
STAT,1812,48,30-34,1860,0.313376542164659
STAT,1851,32,35-39,1883,7.729493038813168
SIM,1882,15,na,1897,2328
STAT,1831,68,na,1899,931.994269850589
SIM,1848,75,na,1923,728
STAT,1826,53,40-44,1879,0.009312514623395713
STAT,1867,19,35-39,1886,0.4917148232675614
STAT,1929,16,30-34,1945,14.73207719097383
SIM,1839,24,20-24,1863,61
SIM,1896,51,na,1947,2732
STAT,1839,19,na,1858,1978.6485425808678
SIM,1938,32,na,1970,3516
STAT,1954,10,na,1964,4588.617895562068
STAT,1831,90,na,1921,48.08210619134012
STAT,1908,42,45-49,1950,0.145429542150284
STAT,1898,15,20-24,1913,22.777059591347165
STAT,1950,17,35-39,1967,4.687508059612635
STAT,1909,35,15-19,1944,0.017329898686850306
SIM,1935,19,30-34,1954,17
SIM,1781,75,na,1856,330
STAT,1843,24,na,1867,1908.5287824045704
STAT,1901,25,45-49,1926,1.4780996725571822
STAT,1905,44,15-19,1949,0.0012914894914445513
SIM,1924,30,30-34,1954,22
STAT,1903,22,45-49,1925,0.9372232436500554
SIM,1855,77,na,1932,637
SIM,1868,29,45-49,1897,1
STAT,1904,15,15-19,1919,8.077622798993897
STAT,1913,36,na,1949,3523.4997407933934
SIM,1797,98,na,1895,1
STAT,1835,80,na,1915,385.96064215910786
SIM,1931,28,30-34,1959,55
STAT,1860,49,20-24,1909,0.009020753590471015
STAT,1923,31,30-34,1954,17.1340339458445
STAT,1932,37,40-44,1969,1.9001546615045573
SIM,1889,18,25-29,1907,10
STAT,1927,19,30-34,1946,14.24192543943374
SIM,1907,33,35-39,1940,11
STAT,1864,54,30-34,1918,0.004887595379569368
SIM,1876,32,25-29,1908,12
SIM,1945,22,15-19,1967,5
SIM,1903,28,25-29,1931,53
STAT,1868,32,25-29,1900,9.23859386630895
SIM,1909,43,na,1952,3255
SIM,1838,97,na,1935,4
STAT,1853,48,20-24,1901,0.008787474388065316
SIM,1920,25,20-24,1945,22
STAT,1911,41,35-39,1952,0.18256880446820672
STAT,1855,105,na,1960,0.055011863916879906
SIM,1883,22,15-19,1905,3
STAT,1903,47,15-19,1950,3.01844567835642E-4
SIM,1851,87,na,1938,90
STAT,1943,27,45-49,1970,1.7380916529683619
STAT,1900,61,na,1961,2577.2510307844564
STAT,1835,29,na,1864,1733.8517370852785
STAT,1801,102,na,1903,0.11155883131324372
SIM,1937,16,30-34,1953,10
SIM,1804,85,na,1889,72
SIM,1859,36,40-44,1895,5
STAT,1873,46,na,1919,2163.5162876769505
STAT,1866,32,15-19,1898,0.12403552239854344
STAT,1844,65,na,1909,1186.3692000431267
SIM,1862,33,50-100,1895,4
SIM,1910,18,15-19,1928,10
SIM,1928,29,40-44,1957,7
SIM,1880,76,na,1956,964
STAT,1848,79,na,1927,503.6518752783278
STAT,1902,18,15-19,1920,7.890906913728358
STAT,1935,22,50-100,1957,0.8464264932764809
SIM,1947,17,na,1964,3759
SIM,1848,17,25-29,1865,7
STAT,1830,25,50-100,1855,0.7563966050925877
STAT,1906,47,40-44,1953,0.13222469569803394
SIM,1817,43,50-100,1860,2
SIM,1905,38,30-34,1943,1
STAT,1886,16,40-44,1902,0.18300833036761185
STAT,1787,109,na,1896,2.652224830738735E-4
STAT,1832,109,na,1941,4.3019020989775326E-4
STAT,1912,25,20-24,1937,17.104930804351362
STAT,1934,32,45-49,1966,2.0295942876275825
STAT,1896,39,na,1935,2911.9083564620632
SIM,1925,37,45-49,1962,3
STAT,1841,31,50-100,1872,0.7685406725483123
STAT,1900,1,na,1901,3567.2497040917015
SIM,1910,23,40-44,1933,3
STAT,1838,51,50-100,1889,0.010450765865764246
STAT,1766,101,na,1867,0.12136943971570638
STAT,1927,39,25-29,1966,1.1541251176807714
STAT,1929,36,25-29,1965,1.195318749340756
SIM,1867,22,30-34,1889,22
STAT,1930,41,45-49,1971,0.20717756359309872
STAT,1937,22,15-19,1959,4.89636758576193
SIM,1941,9,na,1950,3723
SIM,1884,58,na,1942,1913
STAT,1826,44,na,1870,1441.8165456689774
STAT,1913,24,25-29,1937,87.54447633772214
SIM,1813,46,na,1859,1327
STAT,1885,79,na,1964,913.536898497509
STAT,1922,45,50-100,1967,0.24663989713839876
SIM,1921,24,25-29,1945,100
STAT,1829,105,na,1934,0.017972065560796616
STAT,1936,33,50-100,1969,0.7580550994323277
STAT,1849,20,20-24,1869,60.926085519580504
STAT,1930,21,20-24,1951,134.98290215282296
SIM,1880,68,na,1948,1609
STAT,1923,40,15-19,1963,0.0017004868760072977
STAT,1942,17,na,1959,3633.6143088652816
SIM,1955,12,na,1967,4546
STAT,1951,9,na,1960,4420.8849522700575
SIM,1911,22,45-49,1933,1
SIM,1906,34,30-34,1940,21
SIM,1850,46,na,1896,1661
STAT,1928,37,20-24,1965,0.31475338576199074
STAT,1900,40,20-24,1940,0.014599419891699186
STAT,1818,49,na,1867,1317.3682570330363
STAT,1813,46,25-29,1859,0.17721493555739867
SIM,1923,21,25-29,1944,98
STAT,1933,36,45-49,1969,0.878000564774716
SIM,1845,21,40-44,1866,2
STAT,1805,50,na,1855,1207.1392085454577
SIM,1900,32,40-44,1932,8
SIM,1835,31,25-29,1866,14
STAT,1914,22,20-24,1936,107.30038944760442
SIM,1868,21,35-39,1889,5
STAT,1822,54,na,1876,1197.853072122244
SIM,1880,44,na,1924,2352
SIM,1904,26,20-24,1930,17
SIM,1909,18,20-24,1927,26
SIM,1888,19,20-24,1907,21
STAT,1917,10,na,1927,4026.806216914549
STAT,1916,38,40-44,1954,1.4409855065458117
STAT,1838,20,45-49,1858,0.6259998507919098
SIM,1909,29,30-34,1938,47
STAT,1887,15,45-49,1902,0.06933364381765264
STAT,1894,22,25-29,1916,69.56602720263616
STAT,1845,19,50-100,1864,0.043104032774042865
SIM,1905,36,35-39,1941,5
STAT,1948,16,40-44,1964,1.5127087207644427
SIM,1922,22,20-24,1944,126
STAT,1852,52,na,1904,1627.2084439172206
STAT,1827,85,na,1912,152.13071683227957
STAT,1880,37,25-29,1917,2.861917454047402
SIM,1905,25,25-29,1930,62
STAT,1917,37,45-49,1954,0.6688889556441496
STAT,1837,21,40-44,1858,1.7344875501759356
STAT,1872,80,na,1952,586.5544288255863
STAT,1934,34,40-44,1968,5.040894902823116
STAT,1770,115,na,1885,1.3688474209882446E-4
SIM,1891,38,50-100,1929,2
STAT,1915,21,25-29,1936,90.46436580609823
STAT,1916,30,30-34,1946,15.489437695075503
SIM,1924,38,40-44,1962,1
SIM,1830,26,na,1856,1795
STAT,1844,31,25-29,1875,8.688269756245003
STAT,1917,18,na,1935,3915.9089319991513
STAT,1924,44,25-29,1968,0.07998196749905397
SIM,1901,55,na,1956,2756
STAT,1812,47,20-24,1859,0.039486263223212546
STAT,1856,25,50-100,1881,0.4975713555411946
STAT,1838,69,na,1907,1000.9002769541154
STAT,1913,26,20-24,1939,17.23745290169905
STAT,1814,67,na,1881,772.0107091335695
STAT,1946,19,40-44,1965,1.4646269678116912
SIM,1921,37,30-34,1958,2
STAT,1845,18,45-49,1863,0.057812559675210796
STAT,1921,23,na,1944,3884.821433969327
STAT,1935,33,45-49,1968,2.0552455008699004
STAT,1906,66,na,1972,2611.542281066099
STAT,1913,37,30-34,1950,1.6987584339965625
STAT,1896,30,35-39,1926,12.745602113857554
STAT,1918,46,20-24,1964,0.011137065380237258
SIM,1867,8,na,1875,2405
STAT,1867,31,50-100,1898,0.8160314950902173
STAT,1907,15,40-44,1922,0.2549510269449724
STAT,1929,43,na,1972,4536.742927684844
STAT,1942,28,40-44,1970,4.6190121732316625
STAT,1851,11,na,1862,2138.1166890799022
STAT,1942,20,30-34,1962,28.486527760191873
SIM,1867,0,na,1867,3177
SIM,1889,81,na,1970,985
STAT,1864,85,na,1949,231.45465014679635
STAT,1922,47,25-29,1969,0.05757291347639724
SIM,1904,37,30-34,1941,1
SIM,1905,61,na,1966,2718
STAT,1946,23,na,1969,3837.822464236994
STAT,1889,40,45-49,1929,1.7631021608889723
STAT,1940,26,35-39,1966,14.468057189648162
STAT,1868,75,na,1943,928.5511500727802
SIM,1850,38,na,1888,1742
SIM,1915,27,35-39,1942,18
STAT,1875,77,na,1952,838.9254445303991
STAT,1859,39,na,1898,1758.3520606220598
STAT,1924,43,40-44,1967,0.2806430160268006
STAT,1917,29,15-19,1946,0.6943708158710725
STAT,1955,6,na,1961,4929.680876746512
SIM,1843,76,na,1919,649
STAT,1809,88,na,1897,57.670430857067345
STAT,1948,19,45-49,1967,0.5397399046915118
SIM,1849,26,30-34,1875,22
SIM,1906,21,25-29,1927,86
STAT,1784,71,na,1855,470.24769000000003
SIM,1884,6,na,1890,2557
SIM,1833,66,na,1899,1034
SIM,1857,20,20-24,1877,66
STAT,1859,25,35-39,1884,7.507551555348185
STAT,1904,31,20-24,1935,3.6771323877607767
STAT,1859,31,na,1890,1806.4507286116007
STAT,1863,44,na,1907,1893.3781495791
SIM,1866,26,30-34,1892,18
SIM,1855,69,na,1924,1097
STAT,1930,41,15-19,1971,0.0019116731546814354
SIM,1861,21,25-29,1882,53
SIM,1950,20,30-34,1970,30
SIM,1860,48,na,1908,1861
STAT,1928,35,25-29,1963,1.177671659496015
STAT,1902,23,40-44,1925,2.7694418016506805
SIM,1921,26,20-24,1947,24
SIM,1926,33,45-49,1959,2
SIM,1858,16,25-29,1874,7
STAT,1869,32,50-100,1901,0.8378486456961586
SIM,1912,31,20-24,1943,2
STAT,1794,73,na,1867,472.1643355559176
STAT,1918,33,45-49,1951,1.5729570822411505
STAT,1819,98,na,1917,1.6222792032024882
SIM,1902,24,15-19,1926,3
STAT,1759,96,na,1855,0.61218
STAT,1890,44,30-34,1934,1.3099737380222702
STAT,1909,43,45-49,1952,0.14613788924838006
STAT,1870,21,25-29,1891,53.150499222780205
STAT,1888,17,50-100,1905,0.05467543416133806
STAT,1899,23,50-100,1922,0.5262996501475513
SIM,1818,77,na,1895,321
STAT,1859,42,50-100,1901,0.7955044052773107
SIM,1776,96,na,1872,1
STAT,1853,21,25-29,1874,50.52370517340535
STAT,1851,21,15-19,1872,2.9099239954032896
STAT,1920,18,50-100,1938,0.3960736898349178
STAT,1898,3,na,1901,3380.7600657026037
STAT,1801,60,na,1861,1005.4815217473721
STAT,1892,49,na,1941,2606.4897366880696
STAT,1840,53,30-34,1893,0.004078895194627626
STAT,1885,35,50-100,1920,1.1665003201625672
SIM,1912,15,15-19,1927,10
SIM,1896,4,na,1900,3364
STAT,1852,60,na,1912,1449.0223768263086
SIM,1936,35,25-29,1971,1
SIM,1931,15,25-29,1946,70
STAT,1908,44,40-44,1952,0.21587924400469502
SIM,1951,19,15-19,1970,46
STAT,1903,25,50-100,1928,0.8656006617722031
SIM,1873,74,na,1947,1013
STAT,1808,47,na,1855,1310.3100293989028
STAT,1907,27,35-39,1934,13.387570209967008
STAT,1858,26,30-34,1884,19.256432672505316
STAT,1907,43,40-44,1950,0.21514898636905563
STAT,1817,83,na,1900,176.049128651848
STAT,1940,15,25-29,1955,41.58426244043032
STAT,1919,45,25-29,1964,0.054608761837775036
STAT,1895,48,25-29,1943,0.039551846025411064
STAT,1900,29,45-49,1929,1.4447514022289338
SIM,1800,95,na,1895,1
SIM,1932,27,35-39,1959,16
STAT,1923,28,30-34,1951,42.352023437267555
STAT,1920,47,15-19,1967,3.846993791931499E-4
STAT,1869,16,35-39,1885,0.5117220012080947
SIM,1931,26,35-39,1957,21
STAT,1823,53,30-34,1876,0.006696313827005952
STAT,1922,27,30-34,1949,41.88832319546837
STAT,1913,41,15-19,1954,0.0014225775626369463
STAT,1923,15,25-29,1938,48.29914152225878
STAT,1848,55,na,1903,1489.6295132496803
STAT,1922,16,20-24,1938,148.60019306864288
STAT,1944,19,30-34,1963,12.382973239183798
SIM,1930,16,20-24,1946,154
STAT,1826,34,50-100,1860,1.0824940169701325
STAT,1879,18,15-19,1897,5.844612712517576
SIM,1875,16,30-34,1891,6
SIM,1831,67,na,1898,952
SIM,1897,25,na,1922,3072
STAT,1871,31,na,1902,2244.01713978461
SIM,1893,11,na,1904,3223
SIM,1915,43,40-44,1958,1
SIM,1931,31,30-34,1962,20
SIM,1898,21,20-24,1919,72
STAT,1834,21,15-19,1855,2.750834672351164
STAT,1924,27,35-39,1951,16.51558898344508
SIM,1857,49,50-100,1906,1
STAT,1923,26,35-39,1949,16.341202268541476
SIM,1842,21,15-19,1863,6
SIM,1878,40,35-39,1918,5
STAT,1812,52,na,1864,1220.088236968896
STAT,1868,15,35-39,1883,0.5098726532179199
SIM,1930,27,30-34,1957,52
STAT,1923,38,na,1961,4114.3212328118325
STAT,1934,29,15-19,1963,0.896248396894724
SIM,1941,30,30-34,1971,12
STAT,1852,39,15-19,1891,0.042235282146226835
SIM,1856,94,na,1950,7
SIM,1852,80,na,1932,449
SIM,1899,17,25-29,1916,8
STAT,1933,17,35-39,1950,5.30652775206396
SIM,1924,33,35-39,1957,13
STAT,1922,44,15-19,1966,0.0016597481298031836
SIM,1863,13,na,1876,2322
STAT,1909,23,na,1932,3339.393084329976
STAT,1772,94,na,1866,3.385822345909588
STAT,1917,34,40-44,1951,3.837923258742755
STAT,1867,16,30-34,1883,1.4538530817732929
STAT,1842,82,na,1924,332.2592207759547
STAT,1910,17,40-44,1927,0.2617452475547007
SIM,1858,21,20-24,1879,52
SIM,1905,22,20-24,1927,86
STAT,1877,26,40-44,1903,2.946679795199919
SIM,1901,23,na,1924,3195
STAT,1872,29,na,1901,2246.73341925452
SIM,1914,31,30-34,1945,17
STAT,1894,49,20-24,1943,0.008054076521047792
STAT,1848,36,50-100,1884,0.9210032300156233
STAT,1916,33,35-39,1949,8.875003173065563
STAT,1876,62,na,1938,1782.5046600377643
STAT,1946,16,30-34,1962,12.775310071043316
SIM,1914,28,30-34,1942,42
STAT,1880,34,20-24,1914,2.6638325105554204
STAT,1907,48,40-44,1955,0.13230558085233093
STAT,1936,29,25-29,1965,59.43788465809089
SIM,1858,32,30-34,1890,22
STAT,1914,53,na,1967,3368.198984675625
STAT,1934,3,na,1937,5182.6959355682875
SIM,1801,69,na,1870,679
SIM,1925,34,40-44,1959,6
STAT,1931,22,20-24,1953,136.24397088743504
STAT,1887,40,35-39,1927,1.932422518929793
STAT,1933,30,30-34,1963,20.080683486637565
SIM,1911,19,15-19,1930,6
SIM,1820,48,50-100,1868,2
SIM,1954,16,30-34,1970,16
STAT,1797,78,na,1875,311.04820097728646
STAT,1863,36,na,1899,1965.851873875072
SIM,1862,79,na,1941,559
STAT,1906,19,40-44,1925,0.2502538081967891
SIM,1928,8,na,1936,4742
STAT,1920,38,na,1958,3887.6259487210177
STAT,1921,15,15-19,1936,49.101171101886436
STAT,1813,43,20-24,1856,0.5357438410656092
STAT,1907,40,30-34,1947,0.11188657421686635
SIM,1835,49,na,1884,1455
SIM,1888,3,na,1891,2856
SIM,1931,34,35-39,1965,13
STAT,1843,15,30-34,1858,1.4869652252130654
STAT,1919,47,20-24,1966,0.011323530954139942
SIM,1869,69,na,1938,1281
SIM,1941,17,35-39,1958,2
STAT,1942,26,45-49,1968,1.7136260971283732
STAT,1906,58,na,1964,2892.0926995096697
SIM,1856,36,50-100,1892,3
SIM,1916,45,na,1961,3500
STAT,1842,50,na,1892,1555.3319459936422
STAT,1927,28,na,1955,4287.693139104801
SIM,1907,30,30-34,1937,19
SIM,1895,10,na,1905,3251
STAT,1842,53,40-44,1895,0.007376501385171122
SIM,1851,15,30-34,1866,1
STAT,1789,94,na,1883,3.8170201922451352
STAT,1901,42,35-39,1943,0.16606841074154388
SIM,1879,29,20-24,1908,12
SIM,1894,36,na,1930,3031
STAT,1923,34,35-39,1957,9.884949331899772
STAT,1879,23,40-44,1902,2.051261653124396
STAT,1902,44,na,1946,3050.1317918780724
STAT,1868,67,na,1935,1429.8300774667962
STAT,1903,19,15-19,1922,7.933457508100424
SIM,1913,32,20-24,1945,2
STAT,1851,67,na,1918,1162.4662920127582
STAT,1846,40,50-100,1886,0.7734595878205351
STAT,1943,24,40-44,1967,3.377029072277209
STAT,1896,41,50-100,1937,0.09200949860198888
SIM,1907,38,40-44,1945,1
SIM,1844,25,40-44,1869,4
SIM,1818,69,na,1887,667
STAT,1838,22,40-44,1860,1.843911355853218
STAT,1933,38,40-44,1971,1.9243038034183069
SIM,1904,24,25-29,1928,94
STAT,1855,57,na,1912,1423.294611894007
SIM,1924,40,na,1964,4148
STAT,1837,40,50-100,1877,0.8073832522590416
SIM,1885,26,40-44,1911,3
SIM,1904,21,15-19,1925,3
STAT,1939,26,40-44,1965,4.428098068740354
STAT,1860,4,na,1864,2360.1507495893593
STAT,1870,48,20-24,1918,0.010968461486341844
STAT,1871,95,na,1966,45.610690834226915
SIM,1854,28,na,1882,1938
STAT,1905,32,20-24,1937,2.118852844463596
STAT,1860,79,na,1939,536.7448194637631
SIM,1869,25,45-49,1894,5
SIM,1916,23,35-39,1939,9
SIM,1933,20,30-34,1953,46
SIM,1906,37,35-39,1943,6
STAT,1877,0,na,1877,3579.284593593785
STAT,1916,36,45-49,1952,0.6626607566178067
STAT,1817,110,na,1927,1.2254577609101066E-4
STAT,1906,42,50-100,1948,0.10079344205961879
STAT,1897,24,na,1921,2969.333109417018
SIM,1875,1,na,1876,3225
SIM,1869,22,35-39,1891,7
STAT,1884,38,na,1922,2188.4892503157853
STAT,1902,21,45-49,1923,0.932439609269146
STAT,1913,41,45-49,1954,0.15417183252669828
STAT,1830,49,35-39,1879,0.09999293650504082
SIM,1933,25,na,1958,4712
STAT,1937,27,20-24,1964,16.807344268364933
SIM,1905,33,30-34,1938,19
STAT,1942,18,50-100,1960,0.36973866384870285
STAT,1899,27,30-34,1926,32.60082663380362
SIM,1846,22,40-44,1868,1
STAT,1880,24,na,1904,2336.137826705629
SIM,1838,28,20-24,1866,10
STAT,1849,23,25-29,1872,49.528943068991474
STAT,1908,8,na,1916,3642.044582511943
SIM,1901,33,40-44,1934,5
STAT,1880,16,na,1896,2516.6142155890134
SIM,1910,21,45-49,1931,2
SIM,1903,8,na,1911,3467
STAT,1850,26,na,1876,1805.1658037960244
STAT,1827,31,25-29,1858,12.460468032824576
STAT,1919,35,50-100,1954,0.42848390526409064
SIM,1928,26,30-34,1954,52
STAT,1885,47,na,1932,2107.631788925568
SIM,1863,3,na,1866,2608
SIM,1886,22,40-44,1908,3
SIM,1926,30,40-44,1956,6
SIM,1924,36,45-49,1960,2
STAT,1930,6,na,1936,4895.474170263935
STAT,1804,100,na,1904,0.3597693373932283
STAT,1924,12,na,1936,4457.873823206028
STAT,1798,63,na,1861,856.6317628849812
SIM,1859,59,na,1918,1625
SIM,1934,10,na,1944,5035
SIM,1907,5,na,1912,3696
SIM,1941,12,na,1953,3708
SIM,1908,58,na,1966,2894
STAT,1904,34,25-29,1938,7.899906333966689
STAT,1923,23,30-34,1946,31.497273779924623
STAT,1921,18,25-29,1939,46.54616823552099
SIM,1814,87,na,1901,67
STAT,1911,29,20-24,1940,16.693033944566164
STAT,1924,41,20-24,1965,0.019875141080565734
STAT,1857,9,na,1866,2132.606988441367
SIM,1852,9,na,1861,2312
STAT,1843,110,na,1953,1.9936560142326087E-4
STAT,1862,38,20-24,1900,0.6180981474201359
STAT,1875,50,50-100,1925,0.014868431280195875
STAT,1878,22,40-44,1900,2.049327062962091
SIM,1857,23,25-29,1880,45
STAT,1827,93,na,1920,16.21861247979124
STAT,1830,100,na,1930,0.6341752303831014
SIM,1801,80,na,1881,220
SIM,1912,34,25-29,1946,9
STAT,1791,73,na,1864,463.7082942335237
STAT,1862,22,50-100,1884,0.336397403981385
STAT,1897,19,20-24,1916,22.27838044295914
SIM,1868,95,na,1963,18
STAT,1809,107,na,1916,0.001981089544699274
STAT,1936,26,15-19,1962,0.6384180167798852
STAT,1891,27,50-100,1918,0.7479966120454407
STAT,1932,34,30-34,1966,19.76075949411168
SIM,1794,93,na,1887,5
SIM,1876,31,na,1907,2370
STAT,1905,18,40-44,1923,0.2490369108696104
STAT,1908,23,35-39,1931,8.15042496850141
STAT,1918,30,40-44,1948,3.9599460673358253
STAT,1940,24,15-19,1964,5.118785655787439
STAT,1842,39,na,1881,1754.1546946894423
STAT,1886,30,50-100,1916,0.9218779120594863
STAT,1855,48,30-34,1903,0.06769589639754212
STAT,1876,22,30-34,1898,17.371525277817373
STAT,1901,35,na,1936,3169.6793338879506
SIM,1849,29,35-39,1878,8
STAT,1822,62,na,1884,987.2739353749172
STAT,1830,49,na,1879,1405.999701882651
SIM,1802,54,na,1856,1128
STAT,1853,38,50-100,1891,0.9059875518644671
STAT,1898,37,50-100,1935,1.5700705138272917
SIM,1883,33,na,1916,2238
SIM,1918,39,25-29,1957,1
STAT,1836,25,40-44,1861,2.4832740319404736
STAT,1893,74,na,1967,1661.2241861412847
STAT,1832,46,35-39,1878,0.1016500509373036
SIM,1904,29,25-29,1933,65
SIM,1931,23,30-34,1954,44
SIM,1873,66,na,1939,1556
SIM,1825,79,na,1904,317
SIM,1811,98,na,1909,1
SIM,1820,48,na,1868,1324
SIM,1928,32,50-100,1960,1
STAT,1893,34,na,1927,2835.7821483550133
STAT,1918,49,25-29,1967,0.05301277406604674
STAT,1829,30,45-49,1859,1.7954599129314994
STAT,1877,46,50-100,1923,0.24144942836453415
STAT,1884,16,30-34,1900,1.4915948417673988
SIM,1865,79,na,1944,546
STAT,1935,25,15-19,1960,0.90982986594852
SIM,1821,57,na,1878,1142
STAT,1827,45,50-100,1872,0.22097864138831455
SIM,1828,36,na,1864,1541
SIM,1911,19,20-24,1930,24
SIM,1939,28,50-100,1967,4
SIM,1882,17,25-29,1899,10
SIM,1885,46,50-100,1931,2
STAT,1856,18,20-24,1874,15.418916987681138
SIM,1936,16,15-19,1952,28
SIM,1868,44,na,1912,2067
SIM,1887,23,40-44,1910,2
STAT,1882,82,na,1964,668.8698590066144
SIM,1847,26,na,1873,1856
SIM,1932,24,30-34,1956,42
STAT,1870,46,na,1916,2088.5218799182107
STAT,1919,42,20-24,1961,0.01807974476584321
SIM,1910,26,45-49,1936,1
STAT,1924,24,30-34,1948,31.841066207154466
STAT,1895,45,20-24,1940,0.008428015562502318
STAT,1902,26,45-49,1928,1.4852782069923787
STAT,1873,47,35-39,1920,0.13362129882894905
SIM,1898,24,25-29,1922,73
STAT,1926,40,40-44,1966,0.2921405031743068
STAT,1911,39,50-100,1950,0.37915625476073184
STAT,1928,16,15-19,1944,54.15962785529761
STAT,1854,47,25-29,1901,0.04128405719500413
STAT,1828,54,20-24,1882,5.24930809804482E-4
SIM,1930,19,25-29,1949,62
STAT,1804,57,na,1861,1063.8341837228122
STAT,1826,49,15-19,1875,3.6410393957976995E-4
STAT,1927,33,50-100,1960,0.960315383342422
STAT,1914,34,15-19,1948,0.12113126805619588
STAT,1922,19,25-29,1941,47.127932462853146
SIM,1909,51,na,1960,3128
SIM,1891,20,na,1911,2938
STAT,1870,36,50-100,1906,1.141953979522718
STAT,1909,24,50-100,1933,0.5739594659847159
SIM,1805,59,na,1864,1013
SIM,1864,18,20-24,1882,18
STAT,1903,19,20-24,1922,23.699948980897304
STAT,1862,15,40-44,1877,0.17081234265098227
SIM,1870,49,50-100,1919,1
SIM,1839,39,na,1878,1725
SIM,1894,30,50-100,1924,1
STAT,1866,49,45-49,1915,0.20126161377067053
SIM,1925,14,na,1939,4413
SIM,1892,16,30-34,1908,5
STAT,1918,49,50-100,1967,0.22604057990402085
SIM,1846,41,na,1887,1675
STAT,1856,42,na,1898,1707.9670280633634
STAT,1874,17,25-29,1891,5.471404995713535
STAT,1885,87,na,1972,434.7708700894479
STAT,1780,81,na,1861,165.43732863078446
STAT,1920,31,35-39,1951,9.495184578066263
SIM,1938,32,25-29,1970,10
STAT,1935,15,na,1950,4775.37027351091
STAT,1877,36,na,1913,2320.7206704231835
STAT,1942,23,35-39,1965,9.322952264780215
STAT,1903,61,na,1964,2697.1353257421433
SIM,1911,14,na,1925,3757
SIM,1896,29,20-24,1925,18
SIM,1871,34,20-24,1905,2
SIM,1929,37,35-39,1966,3
STAT,1924,20,na,1944,4095.43049756468
STAT,1910,33,40-44,1943,3.5485055028574117
STAT,1867,21,20-24,1888,61.82110175080542
STAT,1821,77,na,1898,466.7706198695834
SIM,1866,61,na,1927,1602
SIM,1856,54,na,1910,1662
SIM,1946,23,20-24,1969,118
STAT,1894,44,50-100,1938,0.08794784141006148
SIM,1944,26,20-24,1970,22
STAT,1814,43,50-100,1857,3.142565549743309
STAT,1825,108,na,1933,0.0010356457611334102
SIM,1938,1,na,1939,3744
STAT,1914,13,na,1927,3852.6726316031104
SIM,1911,18,30-34,1929,4
STAT,1843,18,35-39,1861,0.502913844656737
STAT,1912,40,45-49,1952,0.15332191298877287
STAT,1925,26,45-49,1951,1.9345115346896113
SIM,1821,97,na,1918,2
STAT,1860,39,50-100,1899,0.9331244190998599
STAT,1938,23,20-24,1961,103.91655942724411
STAT,1938,29,50-100,1967,0.9305293521172905
SIM,1877,24,na,1901,2312
SIM,1853,49,50-100,1902,2
STAT,1867,32,30-34,1899,15.486777743342198
STAT,1883,46,40-44,1929,0.15895848428356035
SIM,1847,18,15-19,1865,5
STAT,1829,32,40-44,1861,4.231961543485308
SIM,1841,39,50-100,1880,3
STAT,1873,14,na,1887,2492.751188111535
SIM,1844,28,45-49,1872,4
SIM,1828,47,na,1875,1341
SIM,1863,22,40-44,1885,1
STAT,1785,88,na,1873,45.21370914385196
SIM,1940,27,na,1967,3414
STAT,1897,48,35-39,1945,0.09852034387744583
STAT,1860,47,na,1907,1719.2840847071889
SIM,1822,42,na,1864,1494
SIM,1926,3,na,1929,4574
SIM,1929,26,25-29,1955,98
STAT,1763,103,na,1866,0.01783118465847264
STAT,1781,74,na,1855,388.38639
STAT,1854,24,45-49,1878,0.5815517145469822
STAT,1854,33,50-100,1887,0.6686782168477934
STAT,1871,21,40-44,1892,1.957469506073814
SIM,1837,30,45-49,1867,1
STAT,1836,20,35-39,1856,5.911911864268376
STAT,1836,106,na,1942,0.007667343953833252
SIM,1921,21,15-19,1942,7
STAT,1839,18,15-19,1857,5.145832982579084
STAT,1931,37,25-29,1968,1.231893275557747
STAT,1890,47,40-44,1937,0.11102216458613647
STAT,1882,50,na,1932,2007.7429192552784
STAT,1824,96,na,1920,4.5332200895339625
SIM,1858,66,na,1924,1327
STAT,1933,33,35-39,1966,11.626919992842087
STAT,1907,24,30-34,1931,24.559242137593674
STAT,1928,39,40-44,1967,1.7836188473095413
SIM,1849,92,na,1941,14
STAT,1886,64,na,1950,1735.0975167052127
SIM,1779,93,na,1872,5
STAT,1896,21,45-49,1917,0.8732569473224945
STAT,1785,100,na,1885,0.21891755414565178
STAT,1854,44,20-24,1898,0.11281669736572943
SIM,1889,31,20-24,1920,2
STAT,1840,45,50-100,1885,0.17695677541962387
STAT,1855,22,40-44,1877,1.7241357508712964
STAT,1837,47,25-29,1884,0.0377452518753611
SIM,1844,20,35-39,1864,4
STAT,1855,17,15-19,1872,4.99912918920412
STAT,1926,24,40-44,1950,3.8352307966842085
STAT,1937,19,na,1956,3372.221749442053
SIM,1859,33,30-34,1892,19
SIM,1842,59,na,1901,1329
STAT,1856,44,30-34,1900,0.8391506721133296
STAT,1902,39,20-24,1941,0.2195780458456208
SIM,1828,44,na,1872,1398
STAT,1816,41,15-19,1857,0.04304903314471086
STAT,1907,43,35-39,1950,0.1732089690250222
STAT,1937,25,25-29,1962,60.65690234118193
STAT,1900,18,na,1918,3301.360656682611
SIM,1915,24,30-34,1939,38
SIM,1810,49,na,1859,1297
SIM,1875,46,na,1921,2154
STAT,1842,45,40-44,1887,0.12509878786878675
STAT,1864,1,na,1865,3046.9051271698513
SIM,1913,33,50-100,1946,1
STAT,1947,16,25-29,1963,46.13125424378465
STAT,1859,102,na,1961,0.606538050923451
SIM,1847,18,na,1865,2025
STAT,1835,41,25-29,1876,0.4862670591526702
SIM,1879,28,na,1907,2331
STAT,1856,21,45-49,1877,0.6035542631784503
SIM,1843,36,na,1879,1772
SIM,1955,16,25-29,1971,54
STAT,1841,19,50-100,1860,0.042724008348846064
SIM,1818,37,na,1855,1423
SIM,1862,2,na,1864,2814
STAT,1866,23,25-29,1889,49.90649449984781
STAT,1841,89,na,1930,71.87673488365874
SIM,1837,32,40-44,1869,3
SIM,1902,7,na,1909,3497
STAT,1800,83,na,1883,138.20648664807882
STAT,1896,23,40-44,1919,2.5936631921850384
STAT,1938,34,30-34,1972,14.944642579470013
STAT,1877,29,45-49,1906,1.0806696525814083
STAT,1901,33,50-100,1934,1.206426844403141
SIM,1818,38,45-49,1856,3
STAT,1896,15,50-100,1911,0.061452133730114926
SIM,1830,33,20-24,1863,1
STAT,1841,36,35-39,1877,5.761080164381216
SIM,1933,26,45-49,1959,2
STAT,1957,15,na,1972,4586.239336275765
STAT,1802,85,na,1887,88.35264483673258
SIM,1875,21,20-24,1896,81
SIM,1885,21,35-39,1906,7
STAT,1905,47,25-29,1952,0.04414874539715624
STAT,1851,99,na,1950,1.3888038193788819
STAT,1888,29,20-24,1917,12.998844811343611
STAT,1910,31,45-49,1941,1.4387801486578777
STAT,1828,34,45-49,1862,1.7502788257720852
STAT,1883,13,na,1896,2387.3541202425395
STAT,1864,44,50-100,1908,0.8799337296808627
STAT,1774,115,na,1889,1.7777169659200187E-4
STAT,1832,31,50-100,1863,0.7333183936459172
STAT,1883,38,50-100,1921,1.1310884820565037
SIM,1899,56,na,1955,2620
STAT,1922,32,20-24,1954,2.6037189847976694
SIM,1904,28,40-44,1932,5
STAT,1834,95,na,1929,8.229358346755628
STAT,1762,104,na,1866,0.0060844133478851785
SIM,1845,48,na,1893,1575
SIM,1857,25,na,1882,1988
STAT,1822,33,20-24,1855,6.998699986575759
STAT,1920,19,15-19,1939,47.84579722990171
SIM,1853,11,na,1864,2302
SIM,1930,32,20-24,1962,2
STAT,1845,31,40-44,1876,3.66996499246399
SIM,1900,30,na,1930,3126
SIM,1934,24,40-44,1958,6
STAT,1906,44,30-34,1950,0.10833979702622282
STAT,1936,26,20-24,1962,16.507665730092594
STAT,1939,29,45-49,1968,1.6389083533220128
SIM,1885,29,45-49,1914,5
SIM,1884,22,30-34,1906,24
STAT,1921,34,25-29,1955,9.634392824009264
SIM,1911,22,na,1933,3441
STAT,1867,45,45-49,1912,0.2114190650433748
STAT,1862,18,45-49,1880,0.05993278227218767
STAT,1895,25,45-49,1920,1.3780677154578487
SIM,1823,43,30-34,1866,1
STAT,1906,26,35-39,1932,13.318703347963988
STAT,1861,31,25-29,1892,8.067920468611888
STAT,1909,31,na,1940,3422.5386123158223
STAT,1921,15,20-24,1936,146.68197930458834
STAT,1886,61,na,1947,1865.1302954536682
SIM,1859,20,25-29,1879,64
SIM,1890,34,30-34,1924,28
SIM,1898,30,50-100,1928,4
STAT,1952,17,45-49,1969,0.5655474483397881
SIM,1859,31,35-39,1890,12
STAT,1906,31,25-29,1937,8.123437112389832
STAT,1900,43,25-29,1943,0.05802055075361944
SIM,1881,21,na,1902,1960
STAT,1892,6,na,1898,3090.436414703099
SIM,1874,23,25-29,1897,51
STAT,1858,14,na,1872,2049.380213198232
STAT,1895,18,50-100,1913,0.060238937032388966
STAT,1908,29,50-100,1937,0.8823336416615554
STAT,1928,13,na,1941,4709.608502670256
SIM,1928,29,35-39,1957,24
STAT,1855,20,45-49,1875,0.5853365561008814
SIM,1836,34,45-49,1870,1
SIM,1849,31,20-24,1880,1
SIM,1881,61,na,1942,1562
STAT,1911,32,45-49,1943,1.4472214969339547
STAT,1835,21,30-34,1856,14.879918553786188
STAT,1848,47,na,1895,1613.2818091547863
STAT,1867,90,na,1957,88.50432951977238
SIM,1916,53,na,1969,3403
STAT,1953,1,na,1954,4592.024949066313
SIM,1928,25,25-29,1953,86
SIM,1843,21,30-34,1864,20
SIM,1853,43,na,1896,1837
SIM,1842,51,na,1893,1484
SIM,1945,25,25-29,1970,61
SIM,1932,16,na,1948,4477
STAT,1883,32,15-19,1915,0.1318505816646844
STAT,1835,40,na,1875,1612.5158733147673
STAT,1822,36,25-29,1858,5.484547744612836
STAT,1886,72,na,1958,1349.6566616472112
STAT,1925,44,40-44,1969,0.28515918135382384
SIM,1921,24,na,1945,3769
STAT,1905,44,20-24,1949,0.014852128349435986
SIM,1943,18,20-24,1961,126
STAT,1914,21,na,1935,3544.4037738807983
SIM,1901,15,na,1916,3424
SIM,1914,15,25-29,1929,14
STAT,1925,39,15-19,1964,0.02172987955166281
STAT,1935,18,20-24,1953,174.62173079282294
STAT,1879,30,35-39,1909,10.080169599859145
SIM,1887,30,35-39,1917,8
STAT,1922,24,50-100,1946,0.7084260521098515
SIM,1914,26,35-39,1940,17
SIM,1853,14,na,1867,2270
STAT,1857,83,na,1940,295.6563727344342
SIM,1835,92,na,1927,31
SIM,1914,31,25-29,1945,10
STAT,1906,15,25-29,1921,7.831420641094554
SIM,1815,51,50-100,1866,1
SIM,1857,28,na,1885,1935
STAT,1853,77,na,1930,641.039986298523
STAT,1920,34,45-49,1954,1.6144199700744148
SIM,1862,28,na,1890,2041
STAT,1783,78,na,1861,242.5905065602431
STAT,1937,27,na,1964,3449.2764373049554
SIM,1893,35,50-100,1928,1
STAT,1836,28,45-49,1864,0.9007394242359628
STAT,1898,43,15-19,1941,0.0012175141141946841
STAT,1926,43,45-49,1969,0.19354229904412482
SIM,1807,85,na,1892,81
SIM,1918,23,45-49,1941,1
SIM,1845,21,35-39,1866,6
STAT,1845,49,50-100,1894,0.1693840327382155
STAT,1836,22,30-34,1858,14.844876465601402
STAT,1901,34,35-39,1935,13.276239834854605
STAT,1914,41,30-34,1955,0.11982560851769479
SIM,1840,17,20-24,1857,15
STAT,1935,29,30-34,1964,50.404521039784456
STAT,1951,16,45-49,1967,0.5621460246447755
SIM,1834,44,45-49,1878,3
STAT,1932,16,35-39,1948,5.262025249840301
STAT,1801,68,na,1869,746.1518662727783
STAT,1847,23,15-19,1870,2.954371061568367
STAT,1844,54,na,1898,1469.9770378571866
STAT,1911,18,50-100,1929,0.0706243298580432
STAT,1901,23,25-29,1924,75.46122748167785
STAT,1872,22,40-44,1894,1.9758723445604056
STAT,1895,46,na,1941,2781.995153833832
SIM,1937,19,35-39,1956,5
STAT,1914,38,30-34,1952,1.710258047321713
STAT,1884,19,35-39,1903,0.5094947320010224
STAT,1894,6,na,1900,3174.5895233562296
SIM,1940,16,35-39,1956,5
STAT,1941,27,40-44,1968,4.554669444021021
SIM,1922,38,30-34,1960,2
STAT,1837,21,35-39,1858,4.857243785465523
SIM,1894,28,na,1922,3014
SIM,1908,34,40-44,1942,5
STAT,1783,89,na,1872,29.890413316269964
STAT,1948,19,50-100,1967,0.404804928518634
SIM,1890,35,na,1925,2842
STAT,1869,35,45-49,1904,1.840230060727725
SIM,1899,33,30-34,1932,37
SIM,1890,46,na,1936,2685
STAT,1875,24,50-100,1899,0.3932984699612321
SIM,1848,30,20-24,1878,2
SIM,1899,20,25-29,1919,81
STAT,1828,70,na,1898,796.4922553121688
STAT,1861,36,50-100,1897,0.9677711663321596
STAT,1921,27,50-100,1948,1.0480578640516762
SIM,1807,74,na,1881,398
STAT,1815,43,30-34,1858,3.088651983757277
STAT,1866,46,40-44,1912,0.14953668303059942
SIM,1844,22,30-34,1866,20
STAT,1878,48,25-29,1926,0.055935095113269814
SIM,1877,35,45-49,1912,2
STAT,1946,19,35-39,1965,4.3938806490346085
STAT,1898,30,45-49,1928,2.247972220269262
SIM,1952,19,30-34,1971,19
STAT,1912,37,15-19,1949,0.017702046553595415
STAT,1832,29,na,1861,1704.1507262632135
SIM,1907,33,40-44,1940,8
STAT,1901,22,35-39,1923,7.716179164535144
SIM,1899,22,20-24,1921,85
STAT,1903,69,na,1972,2353.183515258625
STAT,1852,21,30-34,1873,16.193170576958295
SIM,1860,21,30-34,1881,28
SIM,1919,35,25-29,1954,3
SIM,1935,35,na,1970,4976
STAT,1840,59,na,1899,1353.4609037276452
STAT,1842,31,15-19,1873,0.12378484802820441
SIM,1821,89,na,1910,40
STAT,1882,34,30-34,1916,15.912434070526036
STAT,1831,47,30-34,1878,0.07117102712517151
STAT,1925,42,45-49,1967,0.1903747954989789
SIM,1854,9,na,1863,2269
STAT,1925,23,40-44,1948,3.7908455807192265
STAT,1838,77,na,1915,589.5364641639586
SIM,1941,20,na,1961,3440
SIM,1792,67,na,1859,698
STAT,1932,30,15-19,1962,0.16156642951081562
STAT,1863,37,25-29,1900,2.390924445569335
SIM,1852,18,na,1870,2156
STAT,1898,18,25-29,1916,7.227778440648358
SIM,1929,34,30-34,1963,24
SIM,1920,28,25-29,1948,71
STAT,1854,21,40-44,1875,1.7758307148933805
STAT,1821,37,na,1858,1534.951348661793
STAT,1929,19,35-39,1948,5.03214110833193
STAT,1894,9,na,1903,3153.0507112293058
STAT,1837,44,20-24,1881,0.10493040344407432
STAT,1931,34,20-24,1965,3.015512031236345
SIM,1923,37,40-44,1960,3
STAT,1825,31,15-19,1856,0.2775944803199826
SIM,1889,34,25-29,1923,22
STAT,1872,72,na,1944,1197.4798606803872
SIM,1929,23,20-24,1952,127
SIM,1931,13,na,1944,4883
STAT,1804,97,na,1901,1.820540741780314
STAT,1942,24,25-29,1966,91.42543611325458
SIM,1935,27,na,1962,4780
STAT,1795,66,na,1861,742.3157985745598
STAT,1892,22,15-19,1914,3.90276781602486
STAT,1951,1,na,1952,4577.589235122858
SIM,1855,23,15-19,1878,1
STAT,1802,53,na,1855,1094.930778061443
STAT,1857,29,50-100,1886,0.48368985062166264
STAT,1774,96,na,1870,1.4020467654704127
STAT,1823,54,50-100,1877,0.01665494797118358
STAT,1840,70,na,1910,977.1243183124183
STAT,1912,28,25-29,1940,61.04592445021293
SIM,1920,50,na,1970,3721
SIM,1827,28,45-49,1855,3
STAT,1927,36,20-24,1963,0.3099357434142781
STAT,1920,22,45-49,1942,1.181756179343218
STAT,1813,93,na,1906,12.360220622050157
SIM,1875,24,25-29,1899,65
STAT,1841,33,30-34,1874,14.344089869181683
STAT,1940,28,30-34,1968,37.7238173774509
STAT,1885,32,25-29,1917,9.640127784761864
SIM,1854,92,na,1946,25
SIM,1880,36,na,1916,2426
SIM,1846,33,na,1879,1785
STAT,1826,44,45-49,1870,1.4206122946558029
STAT,1867,24,25-29,1891,50.459012964360376
SIM,1871,37,25-29,1908,1
STAT,1886,19,45-49,1905,0.06485031577207383
STAT,1900,36,50-100,1936,0.3489745221304286
STAT,1881,54,30-34,1935,0.00528027224298489
SIM,1844,85,na,1929,169
SIM,1889,15,20-24,1904,21
SIM,1848,99,na,1947,1
STAT,1845,22,50-100,1867,0.35658987202733244
SIM,1893,32,25-29,1925,23
STAT,1856,47,35-39,1903,0.10310223933127051
STAT,1883,49,45-49,1932,0.21394242817932912
STAT,1865,41,50-100,1906,0.9110091988031118
STAT,1877,21,35-39,1898,5.73789123877826
STAT,1893,35,45-49,1928,2.412117751602816
SIM,1890,43,na,1933,2728
STAT,1835,34,50-100,1869,0.7128587269841218
STAT,1925,40,25-29,1965,0.08191003746813906
STAT,1940,31,30-34,1971,15.411489707306464
STAT,1827,29,na,1856,1578.559806274072
STAT,1866,20,20-24,1886,61.39051559498816
SIM,1925,4,na,1929,4491
STAT,1937,29,40-44,1966,4.287418566063617
SIM,1882,29,50-100,1911,3
SIM,1859,39,45-49,1898,1
SIM,1901,31,45-49,1932,2
SIM,1924,34,25-29,1958,13
STAT,1818,41,25-29,1859,1.6022802798089142
STAT,1922,35,25-29,1957,1.0603032893858555
SIM,1896,24,15-19,1920,3
SIM,1920,39,na,1959,3826
STAT,1827,47,50-100,1874,0.21517737054659897
SIM,1817,52,na,1869,1301
STAT,1874,29,50-100,1903,0.613228760232588
STAT,1918,29,30-34,1947,39.11024118243308
STAT,1842,48,45-49,1890,0.16594690838190104
STAT,1793,88,na,1881,46.300238371095844
STAT,1923,44,30-34,1967,0.1407039390901005
STAT,1926,27,45-49,1953,1.9566905969647477
STAT,1828,31,40-44,1859,4.842877813869389
SIM,1833,22,25-29,1855,58
STAT,1896,31,na,1927,2991.5618663535306
STAT,1908,39,15-19,1947,0.01681024350466037
STAT,1909,26,50-100,1935,0.9091395190252646
SIM,1885,23,30-34,1908,25
STAT,1932,21,25-29,1953,114.84189151980453
SIM,1917,26,50-100,1943,6
STAT,1857,42,15-19,1899,0.010272218943395818
STAT,1874,27,50-100,1901,0.6176431716028352
STAT,1918,18,20-24,1936,139.0360271920488
SIM,1930,35,25-29,1965,1
SIM,1835,47,50-100,1882,3
SIM,1830,36,25-29,1866,1
SIM,1862,21,40-44,1883,5
STAT,1897,56,na,1953,2576.9049574138035
STAT,1918,25,15-19,1943,0.7145371118645253
SIM,1926,29,30-34,1955,51
STAT,1872,2,na,1874,3130.8229780682686
STAT,1893,42,na,1935,2766.8783134276027
SIM,1852,31,25-29,1883,11
STAT,1916,45,35-39,1961,0.12551077615211872
STAT,1863,34,20-24,1897,2.225438843241982
STAT,1912,43,na,1955,3362.774155935023
SIM,1874,20,20-24,1894,59
SIM,1868,26,40-44,1894,1
STAT,1877,23,30-34,1900,17.407726967133954
STAT,1911,45,20-24,1956,0.009927786136457105
SIM,1849,22,15-19,1871,2
SIM,1926,18,20-24,1944,145
STAT,1852,34,45-49,1886,1.3435892336792365
STAT,1928,32,15-19,1960,0.15180947518563656
STAT,1800,103,na,1903,0.05720616419594369
SIM,1854,84,na,1938,221
SIM,1904,49,50-100,1953,4
STAT,1897,45,30-34,1942,0.06967436640630592
SIM,1822,74,na,1896,581
STAT,1839,62,na,1901,1218.6801383960078
STAT,1906,40,15-19,1946,0.0013324966224446861
STAT,1921,31,20-24,1952,2.5749860914482654
STAT,1916,34,25-29,1950,8.937120396235054
STAT,1915,37,40-44,1952,1.4284911237233815
STAT,1825,59,na,1884,1174.346559381969
SIM,1847,21,45-49,1868,1
SIM,1910,51,na,1961,3116
STAT,1888,24,15-19,1912,3.658695959048114
SIM,1903,25,20-24,1928,20
SIM,1860,34,45-49,1894,1
SIM,1839,27,25-29,1866,47
STAT,1839,21,45-49,1860,0.6017319185147233
STAT,1856,34,20-24,1890,1.9828539136248966
STAT,1938,26,25-29,1964,61.62250990723628
SIM,1907,17,na,1924,3562
STAT,1907,18,45-49,1925,0.09039536474465525
STAT,1946,18,50-100,1964,0.39244805636911556
STAT,1882,37,35-39,1919,6.501783558823856
SIM,1907,36,45-49,1943,1
SIM,1952,15,15-19,1967,45
SIM,1853,34,45-49,1887,1
SIM,1822,82,na,1904,221
SIM,1849,34,25-29,1883,16
SIM,1902,32,45-49,1934,2
SIM,1811,90,na,1901,27
SIM,1859,51,na,1910,1810
SIM,1905,29,40-44,1934,5
SIM,1807,82,na,1889,124
SIM,1914,23,30-34,1937,35
STAT,1815,46,35-39,1861,0.34636642580494587
SIM,1879,90,na,1969,220
STAT,1836,31,50-100,1867,0.7389886536191037
STAT,1900,26,40-44,1926,3.939427516878518
SIM,1845,70,na,1915,1022
STAT,1906,23,30-34,1929,24.42702458870603
STAT,1893,49,50-100,1942,0.16258778874974572
SIM,1875,37,50-100,1912,1
STAT,1779,81,na,1860,190.95427653165297
STAT,1850,18,na,1868,1963.091087360479
SIM,1929,20,na,1949,4462
SIM,1940,21,25-29,1961,88
STAT,1907,7,na,1914,3614.845835902644
STAT,1911,16,45-49,1927,0.0946450158480505
STAT,1845,34,45-49,1879,1.4304553504192585
SIM,1888,64,na,1952,1885
SIM,1924,3,na,1927,4543
SIM,1930,18,40-44,1948,5
STAT,1895,22,40-44,1917,2.5689190919637097
STAT,1922,18,40-44,1940,1.5253268257394639
STAT,1935,30,40-44,1965,5.12015107920652
STAT,1923,35,na,1958,4125.615134167437
SIM,1855,28,20-24,1883,11
STAT,1904,19,30-34,1923,2.147830681426008
STAT,1897,35,20-24,1932,0.9831515978869156
STAT,1881,42,50-100,1923,0.9624498327306784
STAT,1913,28,na,1941,3513.0372281132572
STAT,1852,24,35-39,1876,5.191590665450112
SIM,1836,31,40-44,1867,5
STAT,1839,104,na,1943,0.044473726716583215
STAT,1775,114,na,1889,2.7553677416172507E-4
SIM,1784,100,na,1884,1
STAT,1843,49,15-19,1892,2.825565417670621E-4
STAT,1919,26,15-19,1945,0.7230624126497751
SIM,1887,18,15-19,1905,8
STAT,1902,65,na,1967,2515.613237429161
STAT,1847,28,20-24,1875,10.300573348029847
STAT,1830,46,30-34,1876,0.07186930083919438
STAT,1878,45,20-24,1923,0.011919085946122681
SIM,1856,62,na,1918,1412
STAT,1816,39,50-100,1855,4.247760507410221
SIM,1858,23,40-44,1881,1
STAT,1815,40,50-100,1855,3.2730243811035074
SIM,1930,23,15-19,1953,5
STAT,1913,21,15-19,1934,4.886513704685335
STAT,1834,55,na,1889,1287.6962193098925
SIM,1879,68,na,1947,1453
SIM,1953,16,15-19,1969,48
SIM,1846,17,15-19,1863,6
SIM,1848,33,25-29,1881,9
SIM,1931,19,40-44,1950,5
STAT,1869,32,40-44,1901,3.9656531306563942
STAT,1943,8,na,1951,3960.928579037432
SIM,1806,89,na,1895,22
SIM,1865,17,25-29,1882,5
SIM,1854,46,50-100,1900,4
SIM,1888,19,15-19,1907,6
STAT,1858,26,50-100,1884,0.48916855117337993
STAT,1860,45,35-39,1905,0.10855794728607235
SIM,1928,19,20-24,1947,143
STAT,1815,52,na,1867,1203.837426938909
SIM,1891,39,na,1930,2851
SIM,1933,27,50-100,1960,1
STAT,1862,51,na,1913,1743.4057981334581
SIM,1832,52,na,1884,1364
SIM,1881,18,20-24,1899,16
STAT,1811,67,na,1878,794.7580810591245
SIM,1917,40,40-44,1957,2
STAT,1871,98,na,1969,17.634169874358193
STAT,1857,17,25-29,1874,4.96030753252378
STAT,1874,39,na,1913,2251.875693185176
STAT,1873,18,20-24,1891,16.955496300103007
STAT,1896,71,na,1967,1968.4926440071306
SIM,1958,5,na,1963,4848
SIM,1860,24,35-39,1884,7
SIM,1912,19,30-34,1931,1
SIM,1888,22,45-49,1910,4
SIM,1921,29,25-29,1950,80
SIM,1911,25,na,1936,3510
SIM,1851,48,50-100,1899,2
STAT,1871,24,45-49,1895,0.6489836090505776
STAT,1922,23,15-19,1945,5.749449350714199
STAT,1838,17,15-19,1855,5.346418387700884
STAT,1938,12,na,1950,3691.9489123275252
SIM,1922,17,na,1939,4063
STAT,1903,18,30-34,1921,2.1366006201412344
STAT,1923,19,40-44,1942,1.5434037644658534
SIM,1890,37,35-39,1927,12
STAT,1845,15,40-44,1860,0.16476956981446678
STAT,1879,16,na,1895,2499.9894919660996
STAT,1857,80,na,1937,460.7000675119946
STAT,1879,21,45-49,1900,0.6906365077641543
STAT,1923,24,15-19,1947,5.8150787092624965
SIM,1919,39,40-44,1958,1
STAT,1841,23,20-24,1864,59.29998291875193
STAT,1871,47,30-34,1918,0.09023475677164333
STAT,1913,29,25-29,1942,61.49974905205448
STAT,1859,42,25-29,1901,0.48354189644334905
STAT,1872,25,45-49,1897,1.0599344667656694
SIM,1899,24,40-44,1923,2
STAT,1909,40,40-44,1949,0.22345856640639092
SIM,1878,33,40-44,1911,7
STAT,1914,44,35-39,1958,0.18783549288853124
STAT,1945,16,15-19,1961,46.84680212674925
SIM,1866,26,50-100,1892,1
STAT,1863,47,na,1910,1859.5882369051442
SIM,1843,44,na,1887,1616
STAT,1849,32,na,1881,1812.483581146661
SIM,1895,13,na,1908,3229
SIM,1877,32,40-44,1909,4
SIM,1928,22,20-24,1950,118
STAT,1910,15,45-49,1925,0.09391474650078138
SIM,1899,34,50-100,1933,1
STAT,1858,29,35-39,1887,7.220678067905238
SIM,1832,41,na,1873,1573
STAT,1925,27,50-100,1952,1.1107417930460268
SIM,1866,29,35-39,1895,7
SIM,1931,24,15-19,1955,6
SIM,1825,36,50-100,1861,3
STAT,1872,48,30-34,1920,0.09063268920119895
STAT,1871,87,na,1958,219.81977240373237
STAT,1901,27,40-44,1928,3.960995065104682
STAT,1930,38,50-100,1968,0.5168610184326587
STAT,1794,70,na,1864,627.458196334672
STAT,1944,15,15-19,1959,46.16164450071307
STAT,1843,48,50-100,1891,0.17496305127526215
STAT,1811,78,na,1889,332.9230773917264
STAT,1800,75,na,1875,418.8120483999494
STAT,1908,23,40-44,1931,2.9104593594438866
SIM,1762,93,na,1855,4
SIM,1903,29,30-34,1932,44
SIM,1879,82,na,1961,676
STAT,1790,80,na,1870,239.85130735995193
SIM,1876,33,30-34,1909,25
STAT,1820,52,na,1872,1271.458098373786
STAT,1887,35,20-24,1922,0.8221336170078213
STAT,1856,17,30-34,1873,1.3944386502265522
STAT,1930,17,15-19,1947,55.43140808015305
STAT,1937,34,15-19,1971,0.11993339230890379
STAT,1823,101,na,1924,0.3002838731692125
SIM,1840,25,na,1865,1838
STAT,1850,54,50-100,1904,0.01033998746525396
STAT,1881,50,20-24,1931,6.827612918466525E-4
SIM,1874,20,15-19,1894,5
SIM,1935,32,35-39,1967,17
STAT,1864,53,25-29,1917,0.0029425429642391163
STAT,1840,16,25-29,1856,5.1397924579824705
STAT,1866,95,na,1961,25.369067815957848
STAT,1784,74,na,1858,353.8629177092254
SIM,1836,31,35-39,1867,6
SIM,1866,39,45-49,1905,1
STAT,1911,24,na,1935,3396.896832008844
STAT,1828,56,na,1884,1210.0531675189407
SIM,1843,34,45-49,1877,1
SIM,1937,15,25-29,1952,58
STAT,1868,33,30-34,1901,15.68180642931156
SIM,1872,28,20-24,1900,14
STAT,1906,35,40-44,1941,1.3120818329031727
SIM,1853,65,na,1918,1324
SIM,1905,17,30-34,1922,2
STAT,1824,33,30-34,1857,35.342720940974985
SIM,1950,21,20-24,1971,112
STAT,1871,28,20-24,1899,10.948339603956166
STAT,1886,10,na,1896,2585.4669458219782
SIM,1832,26,25-29,1858,37
STAT,1905,45,50-100,1950,0.19101258208356597
SIM,1896,32,45-49,1928,2
STAT,1808,100,na,1908,0.4126458126730562
STAT,1921,39,25-29,1960,1.0364680406406483
STAT,1836,43,50-100,1879,0.7835391971904592
SIM,1871,44,50-100,1915,1
STAT,1890,15,na,1905,2930.6967801703963
SIM,1848,38,50-100,1886,1
SIM,1923,28,45-49,1951,2
STAT,1888,32,45-49,1920,1.9461232756307236
STAT,1916,31,20-24,1947,2.3886259506208547
SIM,1828,76,na,1904,501
STAT,1825,37,50-100,1862,1.572211612148186
STAT,1855,38,20-24,1893,0.5432356630238133
SIM,1881,28,30-34,1909,23
STAT,1863,32,40-44,1895,3.601268288676143
SIM,1878,19,25-29,1897,6
SIM,1914,35,40-44,1949,5
SIM,1933,35,35-39,1968,2
STAT,1849,49,45-49,1898,0.1665549388390814
STAT,1923,47,35-39,1970,0.1424963108001803
STAT,1942,21,20-24,1963,110.16953572066097
SIM,1931,27,25-29,1958,85
STAT,1843,20,20-24,1863,63.31125987573981
SIM,1870,69,na,1939,1335
SIM,1869,43,40-44,1912,5
STAT,1844,38,45-49,1882,1.4635533423419755
SIM,1869,26,20-24,1895,9
SIM,1939,23,35-39,1962,13
SIM,1940,25,40-44,1965,4
STAT,1891,24,30-34,1915,20.697635414891298
STAT,1915,28,45-49,1943,1.658654597898687
STAT,1813,47,15-19,1860,0.0012099392332868206
STAT,1846,35,45-49,1881,1.4985927222421378
STAT,1923,27,25-29,1950,71.3956977661229
STAT,1843,13,na,1856,2190.9696922476
SIM,1919,50,na,1969,3735
STAT,1833,39,40-44,1872,3.2626051207128235
STAT,1876,16,45-49,1892,0.06386258891081346
STAT,1931,21,45-49,1952,1.3828071755242992
SIM,1834,23,25-29,1857,46
STAT,1899,50,na,1949,2827.6552240800406
SIM,1915,29,50-100,1944,1
STAT,1828,31,35-39,1859,11.309049901587587
SIM,1867,30,25-29,1897,6
SIM,1852,38,45-49,1890,2
STAT,1925,35,35-39,1960,2.747567114967972
STAT,1767,94,na,1861,2.828972761664884
STAT,1871,3,na,1874,2926.5160606465047
STAT,1876,49,50-100,1925,0.23452167364210758
SIM,1851,20,20-24,1871,66
STAT,1895,22,35-39,1917,7.193978586666006
SIM,1837,37,25-29,1874,6
STAT,1952,0,na,1952,4946.587479174211
SIM,1910,37,na,1947,3309
STAT,1873,28,30-34,1901,24.062135450301092
SIM,1930,18,35-39,1948,6
STAT,1839,25,50-100,1864,0.5451307859083395
STAT,1887,28,15-19,1915,0.47764789616421294
STAT,1932,25,40-44,1957,5.772494902361857
SIM,1916,23,40-44,1939,3
STAT,1922,18,35-39,1940,4.57598021227458
STAT,1900,47,40-44,1947,0.1259749636946393
STAT,1958,11,na,1969,4873.7040785365125
STAT,1866,97,na,1963,13.843531555082961
STAT,1903,34,45-49,1937,1.3342619443604649
SIM,1845,56,na,1901,1442
SIM,1854,35,45-49,1889,2
STAT,1943,20,25-29,1963,92.89967808706916
STAT,1882,46,25-29,1928,0.053099135086871294
SIM,1839,23,30-34,1862,20
SIM,1934,28,20-24,1962,27
STAT,1884,21,20-24,1905,64.52677583162586
STAT,1856,37,25-29,1893,2.130300685851332
STAT,1831,23,20-24,1854,139.02191660573519
STAT,1952,2,na,1954,4490.602517427118
STAT,1896,39,20-24,1935,0.9527432380142498
STAT,1850,51,30-34,1901,0.0042106591064186485
SIM,1909,20,30-34,1929,28
STAT,1851,28,35-39,1879,8.225198400910939
SIM,1919,39,35-39,1958,6
STAT,1883,67,na,1950,1467.7010552814102
STAT,1898,47,30-34,1945,0.06950257916384207
SIM,1924,31,20-24,1955,2
STAT,1850,19,50-100,1869,0.04165168803693927
STAT,1896,28,25-29,1924,52.62877876335225
STAT,1835,34,45-49,1869,1.3567311339254873
STAT,1859,30,25-29,1889,7.834640236385766
SIM,1915,20,15-19,1935,5
STAT,1929,28,30-34,1957,46.30644582221493
SIM,1937,28,30-34,1965,39
STAT,1870,50,45-49,1920,0.013626746830831565
SIM,1858,26,45-49,1884,4
STAT,1912,44,25-29,1956,0.06454439474169354
STAT,1807,108,na,1915,6.570663997640489E-4
STAT,1881,86,na,1967,429.73786299198036
STAT,1890,43,25-29,1933,0.736350782800319
SIM,1886,30,na,1916,2391
SIM,1880,22,40-44,1902,1
SIM,1905,37,25-29,1942,1
SIM,1861,94,na,1955,11
STAT,1903,15,na,1918,3410.2694561339404
STAT,1880,38,15-19,1918,0.0555406908222418
STAT,1869,20,40-44,1889,1.92508649931514
STAT,1881,47,20-24,1928,0.010894698599822842
STAT,1919,38,15-19,1957,0.01946964845358791
SIM,1841,39,40-44,1880,6
SIM,1938,24,30-34,1962,28
STAT,1917,16,45-49,1933,0.10179687884912188
STAT,1837,42,40-44,1879,1.6755006950913045
STAT,1905,33,50-100,1938,0.7151886124992433
SIM,1951,20,25-29,1971,118
STAT,1921,34,na,1955,3942.361007544886
STAT,1927,32,35-39,1959,10.620745275421491
STAT,1829,48,20-24,1877,0.009557006444830738
STAT,1928,36,30-34,1964,2.1781578689772263
SIM,1873,27,25-29,1900,38
SIM,1787,69,na,1856,636
SIM,1911,34,45-49,1945,4
STAT,1841,45,25-29,1886,0.04061558401885185
STAT,1939,31,15-19,1970,0.12392197158271151
SIM,1863,75,na,1938,812
SIM,1892,21,20-24,1913,78
STAT,1926,28,20-24,1954,20.601598796915514
STAT,1854,106,na,1960,0.024317699441982494
STAT,1866,36,30-34,1902,4.664346026311766
STAT,1887,43,50-100,1930,1.1080750160948014
STAT,1874,92,na,1966,122.19909538396857
STAT,1900,45,45-49,1945,0.17620986224516555
SIM,1922,34,20-24,1956,1
STAT,1912,46,20-24,1958,0.01005585029413792
SIM,1892,29,45-49,1921,2
SIM,1855,31,45-49,1886,1
SIM,1933,5,na,1938,5091
SIM,1848,13,na,1861,2187
STAT,1885,39,45-49,1924,1.8573451360014588
STAT,1814,56,na,1870,1084.879092802094
STAT,1803,80,na,1883,255.9777220694349
STAT,1833,26,35-39,1859,7.834652569717748
STAT,1929,15,25-29,1944,52.49179664221148
STAT,1884,29,45-49,1913,1.029103919593022
SIM,1841,26,35-39,1867,6
STAT,1823,92,na,1915,21.9175082769356
STAT,1849,27,40-44,1876,2.5594993684598744
STAT,1905,31,45-49,1936,1.3725200498234902
STAT,1870,47,45-49,1917,0.2174395376405504
STAT,1928,16,20-24,1944,161.79331844713894
SIM,1889,17,35-39,1906,1
STAT,1852,54,45-49,1906,0.010722919552463957
SIM,1936,16,20-24,1952,98
STAT,1850,23,30-34,1873,14.942965942523344
STAT,1818,48,45-49,1866,0.49664020539961723
STAT,1914,34,20-24,1948,2.2992084933930848
SIM,1857,27,40-44,1884,2
STAT,1845,38,20-24,1883,0.5646020502401272
STAT,1858,34,25-29,1892,7.531182911116076
SIM,1896,62,na,1958,2378
STAT,1781,105,na,1886,0.018939219028641808
SIM,1831,33,50-100,1864,4
SIM,1874,36,30-34,1910,6
STAT,1845,28,na,1873,1841.380033694985
SIM,1925,2,na,1927,4534
STAT,1839,47,35-39,1886,0.09510963635916433
STAT,1907,16,50-100,1923,0.06814156388669838
SIM,1840,92,na,1932,19
STAT,1865,24,15-19,1889,2.8254413247993253
STAT,1834,38,45-49,1872,1.519017165633896
STAT,1918,22,50-100,1940,0.670400726525077
SIM,1959,6,na,1965,4855
STAT,1840,49,25-29,1889,0.03942802971860794
STAT,1864,31,45-49,1895,1.4783447100344185
SIM,1840,27,30-34,1867,23
STAT,1844,109,na,1953,4.994512857702244E-4
STAT,1923,42,50-100,1965,0.12972714400657123
STAT,1937,30,50-100,1967,0.7735170973664407
SIM,1875,4,na,1879,2686
SIM,1873,34,30-34,1907,18
SIM,1893,36,40-44,1929,5
STAT,1840,27,20-24,1867,10.18677074094929
STAT,1911,56,na,1967,3162.4867141926643
SIM,1901,24,35-39,1925,8
STAT,1819,48,20-24,1867,0.02102189060645857
STAT,1890,18,20-24,1908,20.423283126353134
STAT,1943,15,50-100,1958,0.3755053712217412
SIM,1842,35,40-44,1877,3
SIM,1886,52,na,1938,2076
STAT,1858,68,na,1926,1133.356557970007
STAT,1835,26,na,1861,1771.7416964197823
SIM,1846,95,na,1941,11
STAT,1879,24,50-100,1903,0.40014457726613584
STAT,1900,64,na,1964,2477.6338315088733
STAT,1778,88,na,1866,38.542711177863374
STAT,1900,17,45-49,1917,0.08561099083526293
STAT,1879,30,na,1909,2375.260523829554
STAT,1844,32,30-34,1876,14.657183194099696
SIM,1873,12,na,1885,2520
SIM,1815,58,na,1873,1050
STAT,1879,49,30-34,1928,0.09358771655666755
SIM,1919,42,na,1961,3806
STAT,1927,1,na,1928,4905.82674326736
SIM,1941,17,40-44,1958,2
STAT,1947,24,30-34,1971,30.66732544853275
SIM,1913,31,45-49,1944,1
STAT,1881,34,15-19,1915,0.12878418179699483
STAT,1910,24,35-39,1934,8.298643786321243
SIM,1811,68,na,1879,722
STAT,1823,49,25-29,1872,0.06675790505662513
SIM,1868,22,25-29,1890,52
STAT,1889,26,50-100,1915,0.7486155899384459
SIM,1795,64,na,1859,782
SIM,1924,17,40-44,1941,2
STAT,1887,36,45-49,1923,2.1162486046382143
STAT,1833,70,na,1903,851.792378248908
STAT,1886,18,na,1904,2514.2638014228755
STAT,1922,48,30-34,1970,0.09648550306892553
STAT,1814,43,15-19,1857,0.041079291233747255
STAT,1937,29,35-39,1966,13.810085954075507
SIM,1816,38,35-39,1854,10
STAT,1823,52,25-29,1875,0.00406469957093333
STAT,1886,39,20-24,1925,0.7616591940577672
SIM,1943,24,na,1967,3597
STAT,1933,17,40-44,1950,1.768842686435202
STAT,1857,22,50-100,1879,0.3506067556905956
STAT,1897,38,25-29,1935,3.6195793519734836
STAT,1918,45,45-49,1963,0.2195140702610661
SIM,1842,28,35-39,1870,10
STAT,1849,41,20-24,1890,0.11498893092131769
STAT,1885,36,40-44,1921,4.139845153007868
SIM,1835,32,30-34,1867,19
STAT,1840,52,25-29,1892,0.0024535853527557334
SIM,1866,31,20-24,1897,2
SIM,1836,19,20-24,1855,23
STAT,1829,37,25-29,1866,2.569364058332927
STAT,1891,62,na,1953,2137.1783129188093
SIM,1877,20,40-44,1897,6
STAT,1883,21,na,1904,2196.331679978886
STAT,1891,64,na,1955,2032.6741830816088
STAT,1916,17,40-44,1933,0.2803362312218506
SIM,1895,36,45-49,1931,3
SIM,1936,22,na,1958,2733
STAT,1894,23,30-34,1917,21.578961717775044
STAT,1928,19,25-29,1947,51.31207724067658
STAT,1964,0,na,1964,4711.565087835276
STAT,1860,40,35-39,1900,1.4042981209432228
STAT,1907,20,15-19,1927,4.6045978138025525
STAT,1824,34,na,1858,1510.3672928923413
STAT,1889,38,35-39,1927,8.20803550920113
SIM,1897,38,35-39,1935,3
SIM,1904,25,30-34,1929,38
STAT,1870,22,30-34,1892,16.488287072588705
STAT,1850,16,25-29,1866,4.903854626871009
SIM,1906,33,25-29,1939,14
STAT,1827,32,30-34,1859,20.31635526369554
STAT,1825,45,40-44,1870,0.1845248011758035
STAT,1943,28,20-24,1971,18.355843373445175
SIM,1912,18,na,1930,3540
SIM,1869,80,na,1949,500
STAT,1820,50,na,1870,1322.830802919738
STAT,1865,46,25-29,1911,0.049586809604931344
SIM,1851,28,45-49,1879,4
SIM,1898,28,40-44,1926,8
STAT,1834,28,35-39,1862,7.775516124797404
STAT,1870,28,45-49,1898,1.0241559632744088
SIM,1817,44,45-49,1861,1
SIM,1896,39,30-34,1935,1
STAT,1893,22,50-100,1915,0.48878411505378444
STAT,1873,21,45-49,1894,0.6706862284371659
SIM,1884,35,45-49,1919,2
STAT,1871,42,na,1913,2161.9115164714954
STAT,1871,21,35-39,1892,5.48168050710475
STAT,1876,35,45-49,1911,1.962622581627899
STAT,1913,25,30-34,1938,37.124315524555655
STAT,1830,42,15-19,1872,0.010503482074458295
SIM,1831,56,na,1887,1260
SIM,1899,27,45-49,1926,1
STAT,1848,37,35-39,1885,5.251012015115853
SIM,1867,35,45-49,1902,2
STAT,1881,28,20-24,1909,10.66310592562804
STAT,1903,35,15-19,1938,0.016445021791388383
STAT,1873,99,na,1972,14.503305471406339
STAT,1924,20,15-19,1944,5.969862710957871
SIM,1921,25,30-34,1946,45
SIM,1795,86,na,1881,59
SIM,1883,29,35-39,1912,11
SIM,1832,33,30-34,1865,20
STAT,1875,36,40-44,1911,4.268981343856562
STAT,1923,27,na,1950,4063.4763348249885
STAT,1831,24,45-49,1855,0.7236835932970596
STAT,1871,43,15-19,1914,0.012840076733517461
STAT,1865,48,na,1913,1907.0965328797593
SIM,1852,32,30-34,1884,20
SIM,1882,48,na,1930,2020
SIM,1888,38,25-29,1926,2
STAT,1853,22,30-34,1875,15.60785060229234
SIM,1873,24,15-19,1897,2
SIM,1883,36,40-44,1919,4
STAT,1830,27,20-24,1857,11.415364533440908
STAT,1892,29,35-39,1921,11.333164494733767
STAT,1895,49,15-19,1944,2.723526862023955E-4
SIM,1861,22,30-34,1883,17
STAT,1841,26,25-29,1867,36.20767321704676
STAT,1870,19,15-19,1889,5.480626374679775
SIM,1848,11,na,1859,2207
SIM,1898,20,45-49,1918,3
SIM,1824,86,na,1910,99
SIM,1878,38,25-29,1916,4
STAT,1875,29,35-39,1904,9.297721010230598
STAT,1952,18,20-24,1970,153.44049166581482
STAT,1869,39,20-24,1908,0.6977981545995207
SIM,1922,17,30-34,1939,16
STAT,1934,38,50-100,1972,0.5467782489189159
SIM,1870,77,na,1947,738
STAT,1842,85,na,1927,195.2145778290965
STAT,1934,25,50-100,1959,1.2660076829730387
STAT,1914,17,30-34,1931,2.3814785100168834
STAT,1891,17,25-29,1908,6.626143683093925
STAT,1860,20,20-24,1880,60.805003927322915
STAT,1940,27,25-29,1967,63.40019736110209
SIM,1831,27,20-24,1858,14
SIM,1856,37,35-39,1893,17
STAT,1854,21,35-39,1875,4.973020822824435
STAT,1929,21,45-49,1950,1.3483161858663897
STAT,1776,113,na,1889,4.10090922135213E-4
SIM,1951,11,na,1962,4352
STAT,1838,48,30-34,1886,0.06705782776228916
SIM,1928,25,na,1953,4365
STAT,1899,32,20-24,1931,3.4994162630748775
STAT,1825,38,35-39,1863,8.697107576300494
SIM,1833,38,35-39,1871,11
STAT,1859,46,40-44,1905,0.12943834107040703
STAT,1904,27,15-19,1931,0.6146866868710109
SIM,1873,63,na,1936,1707
SIM,1882,24,30-34,1906,19
SIM,1862,21,35-39,1883,7
STAT,1844,62,na,1906,1283.084039193254
SIM,1804,88,na,1892,36
STAT,1781,103,na,1884,0.04822633486384188
STAT,1860,28,45-49,1888,0.8553935092383846
STAT,1782,93,na,1875,6.049767960694592
STAT,1906,55,na,1961,2953.0349193898983
SIM,1937,21,45-49,1958,5
SIM,1834,20,20-24,1854,64
SIM,1912,39,25-29,1951,3
STAT,1803,101,na,1904,0.18852117520132308
STAT,1844,35,40-44,1879,3.643418292569673
STAT,1905,18,35-39,1923,0.7471106893520109
SIM,1874,39,35-39,1913,18
STAT,1896,45,15-19,1941,2.845187500792974E-4
SIM,1773,85,na,1858,78
STAT,1866,12,na,1878,2345.2626694523024
STAT,1843,23,25-29,1866,51.467934617330236
SIM,1857,20,15-19,1877,3
SIM,1879,32,45-49,1911,1
STAT,1876,25,35-39,1901,9.474011230807777
STAT,1942,7,na,1949,3917.548024629793
SIM,1886,84,na,1970,591
STAT,1839,17,30-34,1856,1.3902283447276669
STAT,1908,26,45-49,1934,1.5609072760952916
STAT,1818,39,15-19,1857,0.15583761909462848
STAT,1887,16,20-24,1903,18.77613331826268
STAT,1870,44,40-44,1914,2.0539817714451836
SIM,1940,28,45-49,1968,2
STAT,1860,18,35-39,1878,0.4830053668095741
SIM,1820,70,na,1890,666
SIM,1903,35,na,1938,3233
STAT,1864,50,20-24,1914,6.31986530583147E-4
STAT,1836,65,na,1901,1067.192788462762
SIM,1954,15,25-29,1969,58
SIM,1884,25,35-39,1909,14
SIM,1924,0,na,1924,4714
STAT,1917,38,20-24,1955,0.2573655839627689
STAT,1883,17,35-39,1900,0.5080317494524534
STAT,1845,31,35-39,1876,8.570073173845744
STAT,1910,36,45-49,1946,0.6187152585655286
STAT,1946,15,25-29,1961,45.431773804949806
SIM,1829,36,50-100,1865,3
SIM,1914,27,25-29,1941,61
SIM,1851,23,25-29,1874,57
STAT,1909,19,15-19,1928,8.360342515557402
SIM,1939,17,na,1956,3420
SIM,1895,16,20-24,1911,26
SIM,1847,17,30-34,1864,3
SIM,1833,77,na,1910,498
STAT,1914,37,25-29,1951,0.9285380519892918
STAT,1832,75,na,1907,622.473018712376
SIM,1800,54,50-100,1854,1
SIM,1862,26,na,1888,2101
STAT,1904,39,25-29,1943,0.8334801387804327
STAT,1906,47,35-39,1953,0.10812767196503677
STAT,1824,36,35-39,1860,11.155015462509658
STAT,1932,28,45-49,1960,2.1366830308828417
STAT,1940,19,40-44,1959,1.3405911129135215
STAT,1866,39,35-39,1905,6.098434984392903
STAT,1888,39,30-34,1927,5.888000334642563
STAT,1844,94,na,1938,14.030410044884842
STAT,1929,0,na,1929,5431.826175383557
SIM,1852,35,40-44,1887,7
STAT,1803,53,40-44,1856,0.02957662175247871
SIM,1906,24,na,1930,3269
SIM,1868,33,na,1901,2150
SIM,1917,19,15-19,1936,45
STAT,1864,47,20-24,1911,0.010084494906306928
SIM,1853,31,35-39,1884,8
STAT,1849,49,50-100,1898,0.17333005471058152
STAT,1857,30,15-19,1887,0.1089523343312354
STAT,1866,27,40-44,1893,2.609103310191968
STAT,1933,37,na,1970,4841.0126522968685
STAT,1810,74,na,1884,494.6999603691873
SIM,1920,24,45-49,1944,1
STAT,1843,28,45-49,1871,0.9787374289979829
STAT,1911,29,15-19,1940,0.6455869533087194
STAT,1879,39,20-24,1918,0.7535001750808569
STAT,1921,36,20-24,1957,0.2783393999314668
SIM,1842,73,na,1915,777
STAT,1851,25,30-34,1876,21.935333182786426
STAT,1859,93,na,1952,22.033741642113977
STAT,1912,24,45-49,1936,1.0546764909765483
STAT,1949,20,na,1969,4028.6326289043022
SIM,1832,23,20-24,1855,51
SIM,1949,20,25-29,1969,104
SIM,1848,37,40-44,1885,2
STAT,1900,32,na,1932,3127.474271541187
SIM,1899,59,na,1958,2555
STAT,1839,34,15-19,1873,0.11444951777819076
SIM,1832,36,35-39,1868,15
STAT,1934,16,45-49,1950,0.639863276816078
STAT,1849,20,15-19,1869,2.9166934572975816
SIM,1846,41,45-49,1887,3
SIM,1881,17,30-34,1898,1
STAT,1812,48,50-100,1860,0.7950958528597074
STAT,1808,58,na,1866,1079.1503730346544
STAT,1873,17,30-34,1890,1.5283746830560248
STAT,1790,88,na,1878,44.138585688806444
STAT,1772,116,na,1888,1.008234288391335E-4
STAT,1918,20,30-34,1938,29.4578202134962
SIM,1886,38,na,1924,2288
SIM,1914,38,45-49,1952,1
SIM,1880,25,45-49,1905,3
STAT,1898,17,35-39,1915,0.7017040310919032
STAT,1912,41,20-24,1953,0.016179808855876665
STAT,1848,45,20-24,1893,0.00873127049413133
STAT,1840,33,15-19,1873,0.11954675482821778
STAT,1852,51,40-44,1903,0.00803688731228148
STAT,1858,31,20-24,1889,2.02559278880964
STAT,1858,46,na,1904,1673.2858664058442
STAT,1855,28,50-100,1883,0.46884227642660115
SIM,1828,90,na,1918,39
SIM,1837,59,na,1896,1232
SIM,1826,107,na,1933,1
STAT,1819,41,35-39,1860,3.679346915131582
STAT,1892,36,40-44,1928,5.203540495745215
STAT,1915,25,40-44,1940,4.521274178919327
SIM,1788,84,na,1872,91
STAT,1838,41,45-49,1879,1.2091541985764356
STAT,1818,45,40-44,1863,0.37744864627544855
STAT,1890,69,na,1959,1799.7225710971263
STAT,1849,40,na,1889,1695.0361282710244
SIM,1926,20,30-34,1946,42
SIM,1932,23,25-29,1955,116
STAT,1964,8,na,1972,4674.874284803585
STAT,1912,49,25-29,1961,0.04786615697085606
STAT,1875,51,35-39,1926,0.00839539678707068
STAT,1891,27,35-39,1918,11.282556918684563
STAT,1779,111,na,1890,0.001230650050209471
STAT,1885,20,25-29,1905,54.19985725437612
SIM,1922,37,25-29,1959,1
STAT,1861,74,na,1935,870.6032336056647
STAT,1893,45,na,1938,2724.0864646118484
STAT,1872,24,20-24,1896,64.93392715269043
STAT,1928,39,35-39,1967,2.8818704587757735
STAT,1906,27,25-29,1933,58.19021778455459
STAT,1850,26,35-39,1876,8.051658807048005
SIM,1893,20,25-29,1913,74
SIM,1898,21,15-19,1919,3
SIM,1909,23,35-39,1932,9
STAT,1834,30,20-24,1864,2.1881822911496362
SIM,1880,24,20-24,1904,68
STAT,1899,68,na,1967,2256.127306076985
SIM,1839,26,35-39,1865,11
SIM,1917,28,20-24,1945,17
SIM,1916,26,45-49,1942,1
STAT,1868,78,na,1946,704.744155464412
STAT,1877,22,25-29,1899,56.11884499216612
STAT,1884,24,25-29,1908,53.1065019526794
STAT,1778,86,na,1864,58.84684448186559
SIM,1936,19,25-29,1955,30
STAT,1924,23,25-29,1947,102.6581583467781
STAT,1855,51,50-100,1906,0.010747500695976684
SIM,1886,22,35-39,1908,10
STAT,1851,50,35-39,1901,0.006403887437577812
SIM,1906,46,na,1952,3145
SIM,1923,25,40-44,1948,4
STAT,1832,27,30-34,1859,20.674828246958317
STAT,1899,18,40-44,1917,0.23616837663582596
STAT,1854,42,40-44,1896,1.6176964420787856
STAT,1846,48,20-24,1894,0.008354558677208013
STAT,1868,24,40-44,1892,1.8677814186664747
STAT,1949,21,30-34,1970,31.69568823558493
STAT,1822,37,15-19,1859,0.10183518657634136
SIM,1805,81,na,1886,184
SIM,1934,20,25-29,1954,135
SIM,1941,23,na,1964,3438
STAT,1870,25,35-39,1895,8.99231439981619
STAT,1878,38,15-19,1916,0.05495142783875679
SIM,1825,33,25-29,1858,13
STAT,1909,28,20-24,1937,16.41802535248493
STAT,1838,38,20-24,1876,0.627843240328395
STAT,1880,54,20-24,1934,7.133201953770132E-4
SIM,1827,41,35-39,1868,2
SIM,1901,26,na,1927,3223
STAT,1908,38,na,1946,3310.3413671509666
STAT,1846,32,40-44,1878,3.6134380921940488
SIM,1888,18,30-34,1906,1
STAT,1842,49,35-39,1891,0.09761419063551346
STAT,1823,47,na,1870,1370.7734180671403
STAT,1828,42,50-100,1870,0.9319293410386528
SIM,1854,32,40-44,1886,4
SIM,1906,28,45-49,1934,2
SIM,1842,30,20-24,1872,2
SIM,1888,19,na,1907,2726
STAT,1819,52,50-100,1871,0.025794105807232293
STAT,1886,32,35-39,1918,10.108069172842638
STAT,1878,22,35-39,1900,5.738917607076077
STAT,1894,59,na,1953,2361.7370134954117
SIM,1888,0,na,1888,3220
SIM,1894,32,35-39,1926,19
STAT,1784,101,na,1885,0.11188645127532046
SIM,1879,20,35-39,1899,5
SIM,1801,58,na,1859,1022
STAT,1844,29,15-19,1873,0.38432297557710704
STAT,1918,46,15-19,1964,3.712351861234567E-4
STAT,1881,7,na,1888,2404.3748927918546
STAT,1890,40,20-24,1930,0.18528425059826958
STAT,1837,45,45-49,1882,0.15866457411468962
STAT,1876,73,na,1949,1158.3621917186997
SIM,1959,4,na,1963,4856
STAT,1926,20,25-29,1946,106.65634117129277
SIM,1947,6,na,1953,4023
STAT,1830,47,15-19,1877,2.931694080037584E-4
STAT,1906,38,45-49,1944,0.5889565919079467
STAT,1900,10,na,1910,3394.8541315591356
STAT,1849,5,na,1854,2231.0
STAT,1865,37,35-39,1902,6.0717128988337326
STAT,1912,36,50-100,1948,0.3888938614188364
STAT,1896,18,15-19,1914,7.390064959262564
SIM,1863,27,25-29,1890,34
STAT,1792,69,na,1861,616.2209807367726
STAT,1931,38,50-100,1969,0.5247714515273364
STAT,1858,17,40-44,1875,0.15845293005795633
STAT,1890,21,45-49,1911,0.8078569031467969
STAT,1864,31,na,1895,2023.0218051528375
STAT,1902,27,20-24,1929,15.639762612052468
STAT,1817,86,na,1903,98.39392551489655
SIM,1855,15,na,1870,2237
STAT,1892,26,30-34,1918,29.892590963532584
STAT,1944,11,na,1955,3993.997982912983
STAT,1887,33,40-44,1920,4.562391020501341
STAT,1817,38,45-49,1855,6.3570179295627645
STAT,1863,27,15-19,1890,0.3767607519253189
SIM,1875,44,na,1919,2179
SIM,1901,21,30-34,1922,25
SIM,1895,33,40-44,1928,8
STAT,1900,42,40-44,1942,0.20445462403348352
STAT,1871,48,15-19,1919,3.6990998914304815E-4
STAT,1890,37,20-24,1927,0.8903512885210504
STAT,1934,30,25-29,1964,11.93461240970426
SIM,1833,35,30-34,1868,4
STAT,1864,28,20-24,1892,9.870125034404879
STAT,1930,29,25-29,1959,78.99046778839006
SIM,1892,24,25-29,1916,73
STAT,1829,108,na,1937,0.001122752498389917
STAT,1862,49,50-100,1911,0.1937814826838279
SIM,1847,44,30-34,1891,4
STAT,1840,19,35-39,1859,0.4889435322748344
SIM,1825,38,45-49,1863,1
STAT,1851,35,40-44,1886,3.312555056472055
SIM,1832,23,15-19,1855,2
STAT,1818,36,50-100,1854,4.576717454300092
STAT,1878,43,50-100,1921,1.0314649866444583
STAT,1829,27,15-19,1856,0.6537845844399361
STAT,1869,53,50-100,1922,0.01358876728165112
STAT,1924,18,45-49,1942,0.5605511741760679
STAT,1825,35,30-34,1860,7.3800187291537
STAT,1897,22,45-49,1919,0.8810067903036308
STAT,1828,78,na,1906,443.54421612124753
STAT,1855,27,25-29,1882,31.22770158629223
SIM,1909,31,50-100,1940,3
SIM,1828,42,40-44,1870,6
STAT,1924,23,na,1947,4058.559937383283
STAT,1846,15,20-24,1861,15.889019309283347
STAT,1886,32,na,1918,2381.834694401083
STAT,1806,77,na,1883,342.9054065215844
SIM,1910,27,20-24,1937,21
STAT,1846,34,20-24,1880,2.205951102334575
SIM,1855,27,30-34,1882,28
SIM,1952,15,na,1967,4105
STAT,1807,49,40-44,1856,0.6136037211278315
STAT,1849,39,35-39,1888,5.109481006594456
SIM,1877,53,50-100,1930,1
STAT,1905,23,15-19,1928,4.48976416346033
STAT,1921,19,30-34,1940,13.055945345667213
SIM,1886,43,50-100,1929,1
STAT,1927,15,15-19,1942,53.5614388163792
SIM,1883,31,20-24,1914,2
STAT,1833,25,na,1858,1755.0922168038765
SIM,1899,36,35-39,1935,9
SIM,1847,34,20-24,1881,1
STAT,1839,44,30-34,1883,0.7874887785535137
SIM,1838,31,45-49,1869,1
STAT,1939,17,35-39,1956,3.9674923948179472
STAT,1914,29,40-44,1943,4.406425724195384
SIM,1947,17,35-39,1964,5
SIM,1801,91,na,1892,19
SIM,1922,29,40-44,1951,4
SIM,1808,70,na,1878,648
STAT,1875,31,20-24,1906,2.634142247148032
SIM,1826,36,50-100,1862,1
STAT,1820,103,na,1923,0.07645539149436015
STAT,1867,20,30-34,1887,16.09488381629612
SIM,1913,23,15-19,1936,3
SIM,1915,9,na,1924,3870
SIM,1857,39,35-39,1896,11
SIM,1854,34,20-24,1888,4
STAT,1884,60,na,1944,1780.4279772868554
STAT,1834,50,35-39,1884,0.0056848143285302905
STAT,1861,24,45-49,1885,0.5539466049370616
SIM,1861,38,50-100,1899,5
SIM,1810,44,35-39,1854,7
SIM,1854,15,20-24,1869,17
SIM,1935,15,15-19,1950,56
STAT,1812,55,na,1867,1149.8837981033537
STAT,1895,43,40-44,1938,0.19116535129247914
SIM,1891,31,na,1922,2950
STAT,1901,20,20-24,1921,91.66577793767112
STAT,1940,24,20-24,1964,106.9250427536748
SIM,1887,42,45-49,1929,4
STAT,1850,54,35-39,1904,0.005894129680501142
STAT,1861,25,50-100,1886,0.5128070787222876
SIM,1852,35,35-39,1887,12
SIM,1868,42,35-39,1910,1
STAT,1870,25,40-44,1895,2.791714391775781
STAT,1899,35,25-29,1934,3.76284747198353
SIM,1883,73,na,1956,1090
STAT,1877,89,na,1966,257.43435721313114
STAT,1858,22,15-19,1880,2.8071903176107975
SIM,1863,17,15-19,1880,5
STAT,1863,38,15-19,1901,0.04640021857475523
SIM,1884,29,na,1913,2326
STAT,1892,24,50-100,1916,0.4793987957579297
SIM,1840,47,na,1887,1569
SIM,1859,19,15-19,1878,4
STAT,1852,25,50-100,1877,0.5743056146963974
SIM,1846,30,na,1876,1845
SIM,1902,17,20-24,1919,16
STAT,1838,53,50-100,1891,0.010135273880850997
STAT,1859,49,45-49,1908,0.17421122951013834
STAT,1908,40,25-29,1948,0.06310615569114936
STAT,1847,27,30-34,1874,22.27038014857262
STAT,1848,44,na,1892,1642.596175834448
STAT,1862,59,na,1921,1566.116936352387
STAT,1828,52,40-44,1880,0.00856261327839898
STAT,1837,37,15-19,1874,0.04315968584974538
STAT,1861,110,na,1971,0.003470892894504436
STAT,1869,38,na,1907,2143.7064229251296
SIM,1812,83,na,1895,177
STAT,1865,34,30-34,1899,14.859881188559848
SIM,1918,20,40-44,1938,3
STAT,1863,35,45-49,1898,1.6711401484754669
SIM,1865,68,na,1933,1282
SIM,1908,30,25-29,1938,8
STAT,1870,15,50-100,1885,0.04632641253543406
SIM,1819,62,na,1881,974
STAT,1844,35,35-39,1879,5.886829219234863
SIM,1920,21,35-39,1941,12
SIM,1921,28,35-39,1949,22
SIM,1873,37,35-39,1910,20
STAT,1889,46,20-24,1935,0.014034999746521271
STAT,1855,44,15-19,1899,0.009648609280379734
SIM,1892,16,na,1908,3056
STAT,1908,36,na,1944,3342.8547803786455
STAT,1879,42,45-49,1921,1.4760110746581299
STAT,1835,24,35-39,1859,4.770557186399068
STAT,1913,28,35-39,1941,14.079304124311454
SIM,1843,24,35-39,1867,6
SIM,1848,49,50-100,1897,2
SIM,1860,45,na,1905,1901
SIM,1888,35,20-24,1923,1
STAT,1881,17,25-29,1898,5.16887222580714
STAT,1804,68,na,1872,743.9156503401912
STAT,1865,43,20-24,1908,0.13534739324766518
STAT,1791,84,na,1875,102.45565164194996
SIM,1848,96,na,1944,4
STAT,1857,16,35-39,1873,0.48315219389793573
STAT,1865,16,na,1881,2247.4181716634207
STAT,1912,21,35-39,1933,8.548498653587371
STAT,1876,24,50-100,1900,0.3952101278068489
STAT,1819,95,na,1914,6.639618867619384
STAT,1827,35,40-44,1862,4.597994743836657
SIM,1873,24,20-24,1897,64
SIM,1927,29,25-29,1956,80
STAT,1924,48,40-44,1972,0.17684282305830112
SIM,1876,25,45-49,1901,1
STAT,1844,54,40-44,1898,0.007187272539164136
STAT,1915,30,15-19,1945,0.1246207347859829
STAT,1814,47,30-34,1861,0.2626011049732546
SIM,1865,8,na,1873,2403
STAT,1860,23,25-29,1883,44.98176537387407
STAT,1885,36,35-39,1921,6.688927664313333
SIM,1960,2,na,1962,4672
STAT,1826,97,na,1923,2.9322619133558856
SIM,1843,42,30-34,1885,3
STAT,1835,39,15-19,1874,0.04242547752521765
STAT,1889,39,50-100,1928,1.417470758863196
SIM,1780,87,na,1867,53
STAT,1842,46,30-34,1888,0.06983299039203772
STAT,1839,22,20-24,1861,59.03892381085509
SIM,1913,15,30-34,1928,2
STAT,1848,27,25-29,1875,36.381317955496336
STAT,1879,45,15-19,1924,3.989102064294961E-4
STAT,1843,27,50-100,1870,0.5679698756520285
STAT,1920,30,na,1950,3945.190581285814
SIM,1893,22,40-44,1915,3
STAT,1887,30,50-100,1917,0.9757912450692711
SIM,1856,27,25-29,1883,36
SIM,1919,46,50-100,1965,1
STAT,1822,34,45-49,1856,3.8532021375570467
STAT,1931,25,25-29,1956,80.34874245966333
SIM,1913,45,50-100,1958,1
SIM,1862,71,na,1933,1118
SIM,1861,44,40-44,1905,6
SIM,1839,38,50-100,1877,1
STAT,1845,79,na,1924,492.4366982982268
SIM,1884,49,50-100,1933,3
SIM,1946,7,na,1953,4090
STAT,1887,19,25-29,1906,5.954772498363156
SIM,1862,4,na,1866,2520
SIM,1838,23,15-19,1861,2
SIM,1858,23,35-39,1881,10
STAT,1888,41,na,1929,2591.038069516792
SIM,1906,25,40-44,1931,5
STAT,1905,27,30-34,1932,34.37720694162818
SIM,1840,79,na,1919,414
STAT,1865,24,20-24,1889,59.01994237844148
STAT,1894,48,45-49,1942,0.1597418586862066
STAT,1891,33,20-24,1924,3.1473665936652755
SIM,1866,22,15-19,1888,6
STAT,1822,84,na,1906,171.83149791317123
STAT,1859,35,45-49,1894,1.5172121476671447
STAT,1932,33,50-100,1965,1.037694170791914
SIM,1893,36,35-39,1929,17
STAT,1833,34,20-24,1867,2.0756937562365536
STAT,1907,51,na,1958,3052.141111564549
STAT,1818,45,35-39,1863,0.3086612768716379
STAT,1843,25,40-44,1868,2.6983089405468
SIM,1925,36,na,1961,4178
STAT,1874,24,30-34,1898,17.09065653034805
STAT,1900,26,35-39,1926,12.689181562203302
STAT,1931,17,30-34,1948,15.071918433565108
STAT,1881,38,30-34,1919,4.837230020335028
SIM,1855,24,na,1879,1962
SIM,1911,31,35-39,1942,8
STAT,1874,36,25-29,1910,2.7933357380959793
STAT,1918,14,na,1932,4060.894128944183
SIM,1882,36,25-29,1918,3
SIM,1841,34,20-24,1875,1
STAT,1835,42,30-34,1877,0.8594924742793895
STAT,1821,37,20-24,1858,1.6125347283218938
STAT,1867,46,35-39,1913,0.12453263789472684
SIM,1906,37,40-44,1943,1
STAT,1908,32,30-34,1940,14.045853518763339
SIM,1899,24,35-39,1923,8
SIM,1932,27,40-44,1959,8
SIM,1935,23,45-49,1958,2
STAT,1906,24,20-24,1930,94.20320743199554
SIM,1851,31,na,1882,1855
SIM,1879,24,15-19,1903,2
SIM,1915,23,25-29,1938,106
SIM,1826,35,na,1861,1637
SIM,1839,82,na,1921,306
STAT,1855,89,na,1944,74.40276925848482
SIM,1938,4,na,1942,3687
STAT,1888,44,na,1932,2544.5504322457778
STAT,1825,48,45-49,1873,0.24407459570856307
STAT,1898,51,na,1949,2766.779249774318
STAT,1927,36,15-19,1963,0.02257810335430413
STAT,1876,43,30-34,1919,1.1131207062686301
SIM,1946,4,na,1950,4130
SIM,1820,43,40-44,1863,8
STAT,1840,37,30-34,1877,4.389923014485907
STAT,1861,29,15-19,1890,0.3533752329588198
STAT,1897,35,15-19,1932,0.07162032408882024
STAT,1823,33,15-19,1856,0.3259698297273806
STAT,1824,42,20-24,1866,0.20089465617397229
STAT,1837,52,na,1889,1364.1308298797198
STAT,1836,21,25-29,1857,48.05390447378531
STAT,1904,36,20-24,1940,0.22650171339241248
SIM,1883,41,na,1924,2203
STAT,1933,34,25-29,1967,11.751691028541963
SIM,1841,35,25-29,1876,5
SIM,1916,32,30-34,1948,18
STAT,1859,34,40-44,1893,3.2415643725059264
STAT,1890,24,15-19,1914,3.786607718899076
STAT,1809,52,30-34,1861,0.02063841864467878
STAT,1839,34,20-24,1873,2.172381314610528
STAT,1924,27,40-44,1951,5.127357141191549
STAT,1929,24,15-19,1953,6.31986241255216
SIM,1851,25,40-44,1876,5
STAT,1927,35,45-49,1962,0.8021803616537165
SIM,1841,24,na,1865,1873
SIM,1877,27,na,1904,2316
STAT,1884,51,na,1935,2019.6849728146722
SIM,1798,75,na,1873,396
SIM,1884,43,30-34,1927,4
SIM,1881,63,na,1944,1494
SIM,1857,36,30-34,1893,3
SIM,1836,42,na,1878,1549
SIM,1844,21,25-29,1865,63
STAT,1859,46,35-39,1905,0.1058491109325171
STAT,1889,28,25-29,1917,49.16130385739286
SIM,1873,34,na,1907,2274
STAT,1892,39,45-49,1931,2.3345729785900105
STAT,1899,23,15-19,1922,4.257763679526613
SIM,1835,35,40-44,1870,2
STAT,1860,15,30-34,1875,1.4281018342760714
STAT,1851,64,na,1915,1274.7667971883443
STAT,1874,53,50-100,1927,0.01434804830078049
STAT,1919,29,25-29,1948,66.70472044747281
SIM,1833,37,50-100,1870,3
SIM,1796,94,na,1890,7
STAT,1868,20,25-29,1888,52.38375719779231
STAT,1812,43,40-44,1855,8.09545970212196
STAT,1856,34,na,1890,1750.5006941057095
SIM,1847,22,20-24,1869,60
STAT,1907,23,25-29,1930,79.18097188816687
STAT,1823,33,50-100,1856,2.0972774766566085
SIM,1854,1,na,1855,2831
SIM,1895,19,25-29,1914,9
SIM,1827,29,20-24,1856,7
SIM,1928,38,30-34,1966,5
SIM,1835,23,40-44,1858,2
STAT,1921,4,na,1925,4346.646341791623
STAT,1894,26,40-44,1920,3.652762397710632
STAT,1925,47,45-49,1972,0.24882757300933825
SIM,1826,32,na,1858,1674
SIM,1851,34,na,1885,1787
STAT,1927,23,45-49,1950,1.3057013453088415
SIM,1897,26,50-100,1923,6
STAT,1905,20,50-100,1925,0.5600188604231223
SIM,1876,93,na,1969,120
STAT,1823,46,20-24,1869,0.014522677832025932
SIM,1882,35,20-24,1917,3
SIM,1858,35,35-39,1893,7
STAT,1855,24,20-24,1879,56.202105160762464
SIM,1859,37,na,1896,1965
STAT,1823,41,50-100,1864,1.4084092581022831
SIM,1863,24,20-24,1887,56
SIM,1879,49,50-100,1928,4
STAT,1929,19,40-44,1948,1.6773804665623049
SIM,1937,24,15-19,1961,3
STAT,1965,2,na,1967,4639.92734802586
SIM,1819,44,50-100,1863,2
SIM,1903,0,na,1903,3642
SIM,1916,20,30-34,1936,38
STAT,1944,20,40-44,1964,3.4318733112922493
SIM,1900,30,20-24,1930,1
STAT,1874,35,20-24,1909,0.75134741363841
STAT,1905,35,25-29,1940,0.8564321595945984
SIM,1880,27,25-29,1907,41
STAT,1894,15,45-49,1909,0.07975004839557596
SIM,1828,28,25-29,1856,43
SIM,1914,24,20-24,1938,97
STAT,1924,46,50-100,1970,0.2550348025027233
STAT,1907,44,25-29,1951,0.06103576306965785
STAT,1884,26,40-44,1910,2.806074659154326
SIM,1876,20,25-29,1896,55
STAT,1891,19,na,1910,2937.37078288876
STAT,1821,69,na,1890,792.4714943019666
SIM,1871,32,40-44,1903,6
STAT,1789,72,na,1861,481.3084466750979
STAT,1922,11,na,1933,4338.752310259355
STAT,1952,15,50-100,1967,0.4243854808527094
STAT,1840,27,na,1867,1878.432573884208
STAT,1930,26,20-24,1956,21.93799872951724
STAT,1867,29,na,1896,2101.717759550213
STAT,1896,49,30-34,1945,0.06675051103808942
STAT,1908,20,30-34,1928,25.104457992948888
SIM,1935,35,45-49,1970,3
STAT,1941,15,40-44,1956,1.36163337980175
STAT,1851,38,45-49,1889,1.4622486603412372
SIM,1868,42,na,1910,2087
SIM,1871,35,45-49,1906,3
STAT,1849,36,30-34,1885,3.9719112969478183
STAT,1878,25,45-49,1903,1.0993384231978012
STAT,1881,18,50-100,1899,0.044570565476233795
STAT,1925,20,30-34,1945,32.69831730517816
SIM,1918,35,45-49,1953,4
STAT,1836,48,20-24,1884,0.007829431353604142
SIM,1858,74,na,1932,867
SIM,1847,82,na,1929,299
SIM,1905,16,na,1921,3447
STAT,1839,30,na,1869,1815.6347297338334
SIM,1817,50,na,1867,1348
STAT,1915,37,35-39,1952,2.3080751676803617
SIM,1874,24,30-34,1898,22
STAT,1944,28,50-100,1972,1.0157694505054211
STAT,1850,32,20-24,1882,1.990686489481935
SIM,1938,22,15-19,1960,5
SIM,1876,36,40-44,1912,7
STAT,1841,49,40-44,1890,0.11468793792590479
STAT,1893,36,35-39,1929,8.518520662074332
SIM,1816,57,na,1873,1062
SIM,1848,67,na,1915,1130
STAT,1921,15,50-100,1936,0.4053480558556137
SIM,1870,19,20-24,1889,16
STAT,1880,56,na,1936,2027.3929953320655
SIM,1849,60,na,1909,1423
STAT,1771,99,na,1870,0.23614430009931664
STAT,1805,102,na,1907,0.09816333298972504
STAT,1899,39,na,1938,3043.207227734513
SIM,1881,24,15-19,1905,2
SIM,1885,22,na,1907,2238
STAT,1945,19,25-29,1964,44.6901545152233
SIM,1866,64,na,1930,1488
STAT,1872,19,50-100,1891,0.04620508792298032
STAT,1881,21,50-100,1902,0.3730865561677487
SIM,1826,64,na,1890,940
SIM,1892,26,40-44,1918,10
STAT,1868,36,40-44,1904,3.967410898691955
SIM,1897,28,25-29,1925,45
SIM,1932,15,40-44,1947,7
SIM,1844,29,20-24,1873,10
STAT,1904,15,20-24,1919,24.13061997592096
STAT,1934,22,30-34,1956,36.487827881715575
STAT,1836,29,20-24,1865,9.44886990980777
SIM,1876,24,40-44,1900,1
SIM,1923,37,35-39,1960,7
STAT,1893,28,50-100,1921,0.7640465975694262
SIM,1912,15,20-24,1927,28
STAT,1813,79,na,1892,295.6707867184963
STAT,1924,15,40-44,1939,1.5809781609388176
STAT,1905,48,30-34,1953,0.07360531636777301
SIM,1877,32,50-100,1909,4
SIM,1886,25,45-49,1911,2
SIM,1825,35,40-44,1860,5
SIM,1888,11,na,1899,2809
STAT,1829,42,50-100,1871,0.8888200699911044
STAT,1853,79,na,1932,518.461930154549
STAT,1931,25,na,1956,4573.037644191374
STAT,1946,24,15-19,1970,5.592392372063681
STAT,1888,76,na,1964,1336.9255995388353
SIM,1942,22,30-34,1964,32
STAT,1843,45,35-39,1888,0.10314215440270386
SIM,1866,34,25-29,1900,15
SIM,1869,22,40-44,1891,5
STAT,1915,16,35-39,1931,0.8316187259960542
STAT,1921,27,15-19,1948,0.7433362085843356
STAT,1941,27,35-39,1968,14.670920402362759
STAT,1821,46,50-100,1867,0.3805676995597804
SIM,1838,35,na,1873,1654
SIM,1908,56,na,1964,2934
STAT,1819,42,na,1861,1420.2202745419688
STAT,1931,41,30-34,1972,0.1615824818724351
STAT,1918,38,50-100,1956,0.4176292998317765
SIM,1917,19,na,1936,3642
SIM,1913,27,30-34,1940,39
SIM,1859,32,25-29,1891,12
SIM,1830,34,45-49,1864,1
STAT,1846,18,25-29,1864,4.989534854885157
SIM,1889,30,45-49,1919,2
STAT,1867,23,35-39,1890,5.1600795647199655
SIM,1854,18,25-29,1872,6
STAT,1878,46,45-49,1924,0.23275375608734272
SIM,1899,21,30-34,1920,26
STAT,1858,12,na,1870,2068.11608002345
STAT,1862,19,20-24,1881,14.71465901351706
SIM,1907,20,20-24,1927,100
STAT,1856,34,15-19,1890,0.10446447532607953
STAT,1931,38,30-34,1969,2.278009980832496
STAT,1884,46,35-39,1930,0.131066629904152
SIM,1815,72,na,1887,529
STAT,1900,23,30-34,1923,23.272456930116885
STAT,1839,53,20-24,1892,4.8412408798573795E-4
STAT,1831,26,25-29,1857,38.2181185982281
SIM,1942,25,50-100,1967,4
SIM,1837,27,na,1864,1756
SIM,1877,56,na,1933,1998
STAT,1873,11,na,1884,2527.0130854561658
STAT,1866,24,30-34,1890,15.417181055196316
STAT,1880,70,na,1950,1394.6535472367627
STAT,1912,25,15-19,1937,0.6615166662458163
STAT,1883,47,30-34,1930,0.08920610508751514
STAT,1826,45,35-39,1871,0.13446019678113189
STAT,1835,107,na,1942,0.0029424239535273834
SIM,1913,26,na,1939,3375
STAT,1861,32,30-34,1893,13.696740788515031
SIM,1871,31,50-100,1902,1
STAT,1950,17,40-44,1967,1.5625027770045925
SIM,1841,16,25-29,1857,5
SIM,1853,19,20-24,1872,18
STAT,1834,87,na,1921,109.04822094501328
SIM,1866,36,40-44,1902,6
SIM,1867,49,na,1916,1909
SIM,1784,94,na,1878,1
SIM,1860,13,na,1873,2321
SIM,1895,38,25-29,1933,4
SIM,1787,80,na,1867,205
STAT,1905,15,30-34,1920,2.185988966075943
STAT,1926,19,15-19,1945,52.288953189589215
SIM,1934,19,15-19,1953,44
SIM,1909,33,45-49,1942,3
STAT,1802,87,na,1889,57.8680216709314
STAT,1932,37,35-39,1969,3.0701624365290883
SIM,1923,16,35-39,1939,4
STAT,1853,28,45-49,1881,0.8618011548917075
SIM,1861,28,45-49,1889,3
STAT,1845,19,20-24,1864,15.59791579599577
STAT,1941,20,15-19,1961,5.20001564541092
STAT,1880,78,na,1958,886.7726964260044
STAT,1877,49,20-24,1926,0.011518184925690584
STAT,1827,54,40-44,1881,0.007787567127862539
SIM,1893,25,45-49,1918,1
SIM,1918,19,30-34,1937,16
STAT,1853,90,na,1943,58.468782051707585
STAT,1865,27,25-29,1892,36.313436228192245
STAT,1881,53,25-29,1934,0.003178951351580835
SIM,1893,33,30-34,1926,23
SIM,1814,95,na,1909,4
STAT,1904,45,na,1949,3079.0972702954973
SIM,1922,25,25-29,1947,75
SIM,1903,21,40-44,1924,4
SIM,1912,2,na,1914,3719
STAT,1849,32,15-19,1881,0.10816342260198254
SIM,1928,22,15-19,1950,4
STAT,1850,39,40-44,1889,3.0662301032410393
STAT,1808,46,50-100,1854,0.9506420515161068
STAT,1831,98,na,1929,1.9811717260863615
SIM,1826,34,45-49,1860,2
STAT,1897,58,na,1955,2498.527046443532
STAT,1922,15,30-34,1937,13.388969526978642
STAT,1827,38,45-49,1865,1.9435099983078552
STAT,1927,20,40-44,1947,3.937279287994809
SIM,1930,15,30-34,1945,18
STAT,1835,45,35-39,1880,0.10380589420402193
SIM,1904,12,na,1916,3456
STAT,1859,16,45-49,1875,0.05750559545847914
STAT,1891,30,na,1921,2812.7586263157186
STAT,1912,29,30-34,1941,36.208163205913735
STAT,1901,41,45-49,1942,0.13804678698757644
STAT,1885,33,30-34,1918,16.36337954261232
SIM,1848,45,na,1893,1707
STAT,1894,45,40-44,1939,0.11852508568994329
SIM,1822,54,50-100,1876,1
SIM,1920,29,30-34,1949,45
STAT,1887,38,25-29,1925,3.0267741730579645
SIM,1882,33,20-24,1915,2
STAT,1934,37,45-49,1971,0.8887017792216263
SIM,1797,90,na,1887,25
SIM,1841,23,30-34,1864,18
SIM,1905,34,20-24,1939,1
STAT,1837,24,45-49,1861,0.5680125927576223
STAT,1930,9,na,1939,4862.2595774324045
SIM,1887,15,na,1902,2641
STAT,1919,44,na,1963,3789.470062594395
SIM,1830,31,40-44,1861,8
STAT,1920,19,20-24,1939,142.93174850198923
STAT,1860,25,40-44,1885,2.358258594469663
SIM,1937,2,na,1939,3594
STAT,1943,19,15-19,1962,45.43166745907797
STAT,1875,39,45-49,1914,1.9152822005750727
STAT,1895,46,45-49,1941,0.16458076461585755
SIM,1815,40,na,1855,1377
STAT,1901,29,20-24,1930,15.401475360808256
STAT,1879,62,na,1941,1804.7603628577035
STAT,1874,33,20-24,1907,2.598874719221505
STAT,1894,29,45-49,1923,1.3396194176668474
STAT,1850,42,50-100,1892,0.7428289053920405
SIM,1889,35,30-34,1924,11
SIM,1784,91,na,1875,6
SIM,1935,20,40-44,1955,5
STAT,1844,23,40-44,1867,1.8133531912918903
STAT,1890,40,50-100,1930,1.2325430348320705
STAT,1853,47,45-49,1900,0.17420349885427408
SIM,1852,23,40-44,1875,5
SIM,1875,78,na,1953,652
SIM,1927,26,20-24,1953,18
SIM,1927,40,na,1967,4331
SIM,1932,20,15-19,1952,6
SIM,1871,33,45-49,1904,1
SIM,1867,25,35-39,1892,14
STAT,1914,25,25-29,1939,63.097826127839525
SIM,1883,39,45-49,1922,3
STAT,1853,50,45-49,1903,0.010917181859797861
STAT,1885,25,45-49,1910,1.0520839668067763
SIM,1897,47,na,1944,2868
SIM,1897,22,na,1919,3025
STAT,1888,20,35-39,1908,6.551312033376223
STAT,1899,36,na,1935,3064.759980851582
SIM,1880,17,15-19,1897,7
STAT,1808,48,45-49,1856,0.8836041256599322
STAT,1948,24,25-29,1972,100.1313322063156
SIM,1915,27,40-44,1942,5
STAT,1833,23,30-34,1856,14.83471844020467
STAT,1891,35,20-24,1926,0.9099191016913282
STAT,1804,65,na,1869,831.9625348385978
STAT,1914,55,na,1969,3333.3946095443857
SIM,1917,30,na,1947,3719
STAT,1822,32,45-49,1854,5.303106779512256
SIM,1900,33,25-29,1933,16
SIM,1893,24,40-44,1917,1
STAT,1867,43,30-34,1910,1.0123897847513568
STAT,1890,28,30-34,1918,28.983392537036654
STAT,1905,39,40-44,1944,1.2768791120547334
SIM,1837,18,25-29,1855,7
SIM,1919,36,30-34,1955,2
STAT,1923,24,20-24,1947,121.46973548323471
STAT,1908,35,35-39,1943,2.159165878817469
SIM,1875,43,30-34,1918,4
STAT,1868,18,50-100,1886,0.044724649294764246
STAT,1853,44,40-44,1897,1.6455646247746742
SIM,1826,33,40-44,1859,9
STAT,1889,29,na,1918,2763.442225538418
STAT,1870,49,na,1919,2039.125679868555
STAT,1919,26,20-24,1945,18.696327948608147
STAT,1832,52,50-100,1884,0.009524435030997461
SIM,1831,37,30-34,1868,8
STAT,1812,46,45-49,1858,0.7893175157231543
SIM,1931,24,20-24,1955,124
STAT,1944,23,45-49,1967,1.1472641340955554
STAT,1823,37,30-34,1860,8.51898960416081
STAT,1918,42,35-39,1960,0.20225089804110769
SIM,1835,38,45-49,1873,1
STAT,1922,31,45-49,1953,1.6865996711751654
STAT,1824,44,20-24,1868,0.19098858484928077
SIM,1879,28,30-34,1907,35
SIM,1854,37,25-29,1891,2
SIM,1883,34,25-29,1917,12
SIM,1897,35,30-34,1932,8
STAT,1872,17,15-19,1889,5.645664545674693
SIM,1841,32,20-24,1873,2
STAT,1824,49,40-44,1873,0.1955772924086175
STAT,1818,42,30-34,1860,2.75785780155014
STAT,1866,41,na,1907,2022.1731284481211
STAT,1933,31,20-24,1964,3.1071186461358438
STAT,1818,49,50-100,1867,0.5088904881350191
SIM,1826,49,50-100,1875,3
SIM,1896,20,35-39,1916,7
SIM,1830,32,45-49,1862,1
SIM,1869,29,25-29,1898,40
STAT,1848,24,20-24,1872,59.58437374282573
STAT,1824,45,25-29,1869,0.06963134412285653
SIM,1884,26,na,1910,2324
SIM,1866,7,na,1873,2460
SIM,1871,53,na,1924,2019
STAT,1867,26,na,1893,2124.1117253147886
STAT,1875,34,25-29,1909,9.855727472713811
SIM,1847,37,25-29,1884,2
STAT,1846,37,25-29,1883,2.119934753239107
STAT,1814,54,50-100,1868,0.037651541522683504
SIM,1817,84,na,1901,183
STAT,1891,36,25-29,1927,3.3828685630556907
STAT,1923,19,50-100,1942,0.41341162209339066
SIM,1878,16,20-24,1894,18
SIM,1846,86,na,1932,133
SIM,1858,20,30-34,1878,17
STAT,1914,31,50-100,1945,0.789296543141322
SIM,1826,42,30-34,1868,3
STAT,1869,23,45-49,1892,0.6356861445040065
STAT,1885,24,40-44,1909,1.948960178411038
STAT,1876,46,35-39,1922,0.13692340631520591
SIM,1937,19,40-44,1956,1
SIM,1938,27,35-39,1965,18
STAT,1875,26,na,1901,2324.1601736103266
SIM,1848,34,30-34,1882,21
STAT,1890,1,na,1891,3143.8293145891857
SIM,1813,99,na,1912,4
SIM,1913,39,40-44,1952,1
SIM,1947,14,na,1961,4001
SIM,1856,24,20-24,1880,52
STAT,1806,91,na,1897,19.282050012216878
SIM,1881,21,45-49,1902,1
SIM,1916,35,35-39,1951,2
STAT,1907,27,40-44,1934,4.156246185835935
STAT,1847,31,45-49,1878,1.522229511325993
STAT,1834,35,40-44,1869,3.4411575331613977
STAT,1893,5,na,1898,3141.1392966038597
STAT,1839,37,25-29,1876,2.294147183964102
STAT,1833,32,20-24,1865,2.119849620527442
SIM,1888,23,20-24,1911,71
STAT,1889,35,30-34,1924,6.274768977705914
STAT,1932,21,50-100,1953,0.8180788111984436
STAT,1934,25,35-39,1959,19.096080801188883
SIM,1853,97,na,1950,4
STAT,1775,91,na,1866,15.838814470225076
STAT,1878,44,45-49,1922,1.4520070187268055
STAT,1915,34,30-34,1949,15.027367079186824
SIM,1902,29,20-24,1931,18
STAT,1917,30,25-29,1947,9.216305882762285
SIM,1860,16,na,1876,2251
SIM,1909,30,40-44,1939,4
STAT,1941,18,45-49,1959,0.4858842810042717
SIM,1876,39,45-49,1915,5
STAT,1916,33,na,1949,3673.054000280198
SIM,1845,42,40-44,1887,5
STAT,1841,23,15-19,1864,2.8388476089013808
STAT,1843,16,na,1859,2128.868765808086
STAT,1854,45,45-49,1899,0.1716364886620955
STAT,1880,8,na,1888,2615.7904914827222
SIM,1930,31,45-49,1961,3
STAT,1840,46,20-24,1886,0.008536032048152693
STAT,1855,71,na,1926,945.3549048048353
STAT,1872,42,50-100,1914,1.000496821530385
STAT,1945,16,20-24,1961,139.94740870402543
STAT,1836,68,na,1904,965.0399856792081
SIM,1866,47,50-100,1913,1
STAT,1931,29,40-44,1960,5.67929908856457
SIM,1945,26,30-34,1971,45
SIM,1834,42,30-34,1876,4
STAT,1905,41,na,1946,3180.4239783997964
SIM,1904,28,35-39,1932,15
STAT,1904,18,25-29,1922,7.657299842500187
STAT,1906,26,na,1932,3294.189116513818
SIM,1918,15,15-19,1933,7
STAT,1868,39,45-49,1907,1.7799823575166152
STAT,1838,44,15-19,1882,0.009770164152630248
STAT,1875,17,40-44,1892,0.1775143725336713
STAT,1919,22,na,1941,3777.6156920509743
STAT,1844,24,45-49,1868,0.6024598974505676
SIM,1870,23,na,1893,2179
STAT,1829,34,20-24,1863,2.5047687035938955
STAT,1849,36,50-100,1885,0.9149853047945873
STAT,1869,52,na,1921,1958.4541046777967
SIM,1884,37,50-100,1921,3
STAT,1891,44,50-100,1935,1.2186418460773198
STAT,1850,100,na,1950,0.7474005674588309
STAT,1853,23,na,1876,1860.063123576717
SIM,1897,25,20-24,1922,18
SIM,1883,26,30-34,1909,31
STAT,1872,27,25-29,1899,40.11030479348742
SIM,1842,33,25-29,1875,13
STAT,1854,53,na,1907,1525.5889461751076
SIM,1903,67,na,1970,2434
STAT,1846,75,na,1921,725.845355400105
STAT,1861,35,35-39,1896,5.601236984121194
SIM,1923,34,30-34,1957,22
SIM,1953,16,20-24,1969,152
STAT,1859,22,30-34,1881,13.933164627491754
STAT,1868,22,na,1890,2133.219525707389
STAT,1939,22,25-29,1961,87.62470059924563
STAT,1925,23,35-39,1948,10.615850852743337
STAT,1908,47,45-49,1955,0.18564083067135168
SIM,1886,44,45-49,1930,6
STAT,1849,44,25-29,1893,0.45661314740221787
STAT,1869,32,35-39,1901,9.260561771461978
SIM,1885,22,25-29,1907,60
STAT,1866,63,na,1929,1554.1094340672753
SIM,1912,18,25-29,1930,10
STAT,1950,14,na,1964,4386.504742786249
STAT,1826,46,na,1872,1412.3681198292443
STAT,1907,41,20-24,1948,0.0153706418294707
SIM,1877,32,35-39,1909,8
STAT,1876,37,50-100,1913,1.1973627577970714
STAT,1850,35,25-29,1885,2.102268072551812
STAT,1877,81,na,1958,632.1270492816572
SIM,1924,27,50-100,1951,1
SIM,1834,61,na,1895,1166
SIM,1895,66,na,1961,2176
SIM,1838,27,30-34,1865,20
SIM,1947,22,25-29,1969,91
STAT,1923,22,50-100,1945,0.7233265900582286
SIM,1896,29,na,1925,2998
STAT,1937,26,30-34,1963,36.09369308574236
STAT,1864,34,15-19,1898,0.11920691641399053
STAT,1866,34,50-100,1900,0.7912073313432787
STAT,1840,72,na,1912,879.5011118066035
STAT,1916,27,50-100,1943,0.9722064985671762
STAT,1935,29,50-100,1964,1.280419221407724
STAT,1897,18,30-34,1915,2.008443204183078
STAT,1786,83,na,1869,126.61094840490682
SIM,1925,30,25-29,1955,11
SIM,1824,54,na,1878,1207
STAT,1875,26,30-34,1901,24.523862790574917
SIM,1914,41,na,1955,3762
SIM,1835,21,40-44,1856,4
STAT,1834,33,25-29,1867,8.037289802568104
STAT,1863,31,50-100,1894,0.7639721195319253
STAT,1875,22,15-19,1897,3.2018282570563326
STAT,1809,49,15-19,1858,0.0014066646123478673
STAT,1807,54,na,1861,1133.1805602495956
STAT,1929,33,20-24,1962,2.9252797151922327
STAT,1859,43,30-34,1902,0.8605017965144304
STAT,1889,25,20-24,1914,13.774886829966976
STAT,1817,61,na,1878,979.0738473362904
STAT,1911,17,20-24,1928,25.623730142754464
STAT,1941,24,30-34,1965,28.03778336248689
STAT,1857,104,na,1961,0.14852594256538357
STAT,1868,19,15-19,1887,5.385737007010761
SIM,1837,34,20-24,1871,2
SIM,1842,25,30-34,1867,24
SIM,1864,38,na,1902,2093
STAT,1811,101,na,1912,0.2471651223524994
STAT,1818,46,na,1864,1368.970336866933
STAT,1849,46,40-44,1895,0.12374974357872358
SIM,1835,46,na,1881,1510
SIM,1861,25,40-44,1886,3
STAT,1903,31,35-39,1934,13.666735078989587
SIM,1845,43,45-49,1888,1
STAT,1874,27,35-39,1901,9.316344655612559
STAT,1904,20,50-100,1924,0.5557803042371572
SIM,1926,23,35-39,1949,14
STAT,1831,76,na,1907,577.7883751685022
STAT,1896,25,20-24,1921,14.746465503996754
STAT,1853,25,40-44,1878,2.6109055326186486
STAT,1853,45,na,1898,1685.133765096573
SIM,1948,21,20-24,1969,112
SIM,1882,27,35-39,1909,9
STAT,1882,15,25-29,1897,5.233342950957309
STAT,1907,9,na,1916,3599.96790654947
STAT,1918,23,35-39,1941,9.563789564910747
STAT,1834,25,30-34,1859,20.73610003701188
SIM,1856,34,30-34,1890,18
STAT,1885,15,35-39,1900,0.5188331464983813
STAT,1946,21,na,1967,3840.3566814318933
STAT,1866,20,15-19,1886,2.938926957952706
STAT,1850,34,20-24,1884,1.9497713305747755
STAT,1921,48,50-100,1969,0.24022492865854547
SIM,1837,72,na,1909,748
SIM,1942,25,35-39,1967,19
SIM,1864,17,30-34,1881,1
STAT,1902,39,15-19,1941,0.01599575369663596
SIM,1937,33,20-24,1970,2
STAT,1934,17,50-100,1951,0.4787217088409091
SIM,1902,9,na,1911,3483
STAT,1842,53,na,1895,1508.6790707931516
STAT,1847,107,na,1954,0.0034699454919997798
STAT,1848,34,30-34,1882,13.074108476364216
SIM,1829,41,45-49,1870,4
SIM,1890,24,15-19,1914,2
SIM,1833,23,30-34,1856,23
STAT,1767,91,na,1858,12.33080286994403
STAT,1878,66,na,1944,1611.8886652019728
SIM,1839,31,na,1870,1858
SIM,1872,89,na,1961,154
STAT,1846,27,15-19,1873,0.38699164945065495
STAT,1826,42,30-34,1868,1.1326194564931074
STAT,1839,64,na,1903,1159.088897626295
STAT,1882,24,15-19,1906,3.013643291858544
SIM,1816,46,50-100,1862,1
STAT,1787,68,na,1855,678.2336
STAT,1858,47,50-100,1905,0.18129506735307557
SIM,1872,38,30-34,1910,2
STAT,1864,38,30-34,1902,4.477500782031434
SIM,1880,42,50-100,1922,1
STAT,1931,34,15-19,1965,0.15886893130049187
STAT,1852,38,50-100,1890,0.9281782884687536
STAT,1893,33,30-34,1926,20.839182860174823
SIM,1926,44,na,1970,4173
SIM,1907,23,25-29,1930,88
SIM,1876,19,15-19,1895,6
STAT,1878,43,40-44,1921,2.1960766050177156
SIM,1860,38,50-100,1898,1
STAT,1888,73,na,1961,1508.207446403727
SIM,1897,5,na,1902,3349
STAT,1854,48,15-19,1902,2.8441824767276623E-4
STAT,1931,22,na,1953,4474.453723402008
SIM,1886,43,40-44,1929,7
SIM,1918,32,40-44,1950,8
STAT,1845,25,na,1870,1881.6198149310417
STAT,1892,27,na,1919,2823.273189683485
STAT,1796,82,na,1878,180.15209170096153
SIM,1809,94,na,1903,8
SIM,1866,39,50-100,1905,1
SIM,1825,31,25-29,1856,12
STAT,1870,44,45-49,1914,1.3666939330423675
SIM,1872,47,na,1919,2095
STAT,1826,40,35-39,1866,1.851896516778805
STAT,1889,31,15-19,1920,0.16676481612366217
STAT,1898,37,25-29,1935,3.6819948981799135
STAT,1896,17,na,1913,3153.3006021102124
SIM,1874,44,25-29,1918,1
STAT,1884,22,25-29,1906,53.44105222767954
SIM,1909,21,35-39,1930,10
STAT,1805,50,45-49,1855,0.04408065722857811
SIM,1832,27,30-34,1859,32
SIM,1832,29,25-29,1861,38
SIM,1898,40,na,1938,2976
STAT,1828,109,na,1937,4.038789893314057E-4
STAT,1876,19,45-49,1895,0.0633644826763166
SIM,1853,19,15-19,1872,5
STAT,1866,44,25-29,1910,0.5517620765594002
STAT,1850,35,30-34,1885,3.8914324109786635
STAT,1877,45,40-44,1922,0.16950346222095294
STAT,1887,34,15-19,1921,0.14916509197896108
SIM,1866,36,45-49,1902,1
STAT,1813,45,50-100,1858,0.7685796518316369
STAT,1830,37,50-100,1867,0.9743787690170965
STAT,1871,25,20-24,1896,11.061553402720303
STAT,1833,38,35-39,1871,5.327066159693814
STAT,1850,9,na,1859,2095.917841973368
SIM,1918,48,50-100,1966,2
STAT,1871,27,15-19,1898,0.42491214290978757
STAT,1845,19,15-19,1864,5.221336226597046
STAT,1859,19,50-100,1878,0.042371583604381584
STAT,1881,63,na,1944,1627.54237343064
SIM,1858,12,na,1870,2237
SIM,1841,38,35-39,1879,13
STAT,1854,28,25-29,1882,31.703788431910795
SIM,1834,40,35-39,1874,3
SIM,1869,29,20-24,1898,8
SIM,1948,15,35-39,1963,6
STAT,1809,74,na,1883,495.6971686000789
STAT,1820,41,na,1861,1468.650640574132
STAT,1864,47,25-29,1911,0.0484055732922877
STAT,1854,61,na,1915,1345.593686901484
STAT,1815,52,25-29,1867,0.008238231614714181
STAT,1820,52,35-39,1872,0.013644845939691282
STAT,1872,27,na,1899,2262.906838042167
STAT,1872,41,45-49,1913,1.4255388387758894
STAT,1822,76,na,1898,489.36519848902
STAT,1837,43,45-49,1880,1.100665196769503
STAT,1908,17,40-44,1925,0.2562528348617969
STAT,1893,31,35-39,1924,12.188068948778982
STAT,1879,28,30-34,1907,24.77788940957943
SIM,1957,13,na,1970,4694
STAT,1778,110,na,1888,0.0017431780870990213
STAT,1910,37,20-24,1947,0.23810113404169678
STAT,1801,104,na,1905,0.02538067331658839
SIM,1841,36,40-44,1877,8
STAT,1816,39,45-49,1855,6.897091436711876
STAT,1788,87,na,1875,55.87691783540715
STAT,1792,92,na,1884,10.393410444660832
STAT,1905,19,na,1924,3429.354814452094
SIM,1928,18,15-19,1946,53
SIM,1862,28,25-29,1890,38
SIM,1885,32,35-39,1917,10
SIM,1894,38,45-49,1932,2
STAT,1816,50,20-24,1866,0.0019359528787652389
STAT,1877,58,na,1935,1938.672386489791
STAT,1841,43,50-100,1884,0.7415342998286676
STAT,1886,38,45-49,1924,1.9798780813735282
SIM,1864,25,25-29,1889,37
STAT,1849,46,45-49,1895,0.17058959994868192
STAT,1841,44,20-24,1885,0.11005343391760077
STAT,1765,90,na,1855,25.897600000000004
STAT,1886,3,na,1889,2783.287018651861
STAT,1915,49,na,1964,3476.3728886471667
SIM,1844,44,40-44,1888,7
STAT,1845,37,15-19,1882,0.04155926304176236
STAT,1856,25,25-29,1881,32.903276163312775
STAT,1873,22,20-24,1895,66.08076425923282
SIM,1816,44,35-39,1860,3
SIM,1892,22,25-29,1914,67
STAT,1948,21,20-24,1969,120.66032002949076
STAT,1888,10,na,1898,2890.830125843354
SIM,1887,28,30-34,1915,30
STAT,1833,36,40-44,1869,3.3667789198351215
STAT,1883,41,20-24,1924,0.14770508317871228
SIM,1857,43,40-44,1900,6
STAT,1891,18,30-34,1909,1.8588393082777925
STAT,1877,32,35-39,1909,9.927734746793488
SIM,1821,43,na,1864,1431
STAT,1845,35,20-24,1880,0.6400734887651248
STAT,1831,40,45-49,1871,1.1705604710204291
SIM,1837,18,20-24,1855,16
STAT,1863,15,15-19,1878,5.690295946854399
STAT,1846,66,na,1912,1155.6209091932012
SIM,1874,26,25-29,1900,45
SIM,1859,42,35-39,1901,2
STAT,1882,43,25-29,1925,0.5860386820544888
SIM,1843,33,40-44,1876,5
SIM,1888,39,30-34,1927,8
SIM,1855,55,na,1910,1621
STAT,1906,19,50-100,1925,0.06703225375213975
STAT,1913,14,na,1927,3801.351698067781
SIM,1851,21,25-29,1872,67
STAT,1890,32,50-100,1922,1.0582883651054582
SIM,1889,38,35-39,1927,13
SIM,1891,23,20-24,1914,65
SIM,1888,42,na,1930,2519
STAT,1882,27,20-24,1909,10.784137427638099
STAT,1821,33,40-44,1854,13.627860802757917
STAT,1847,32,20-24,1879,2.3351986273964007
SIM,1894,23,45-49,1917,4
STAT,1931,35,50-100,1966,0.5262119605864056
STAT,1871,42,40-44,1913,2.103951058775227
STAT,1850,71,na,1921,939.7027254026237
SIM,1848,37,35-39,1885,9
STAT,1876,21,50-100,1897,0.39890048812969836
SIM,1858,29,45-49,1887,4
STAT,1814,53,20-24,1867,0.0018768588665141906
SIM,1824,39,45-49,1863,1
SIM,1885,14,na,1899,2456
SIM,1913,20,50-100,1933,1
STAT,1841,42,25-29,1883,0.45654839914436457
STAT,1881,44,20-24,1925,0.14290500781205245
SIM,1939,22,30-34,1961,39
STAT,1843,21,25-29,1864,52.215050937602264
STAT,1850,17,30-34,1867,1.3711733798314767
STAT,1895,29,25-29,1924,51.77646266867549
SIM,1917,33,35-39,1950,8
STAT,1827,39,20-24,1866,0.7333925559869995
STAT,1867,41,35-39,1908,1.6134603368174567
STAT,1892,34,25-29,1926,12.013328915830968
SIM,1892,26,45-49,1918,1
STAT,1887,49,15-19,1936,2.3340340343414818E-4
SIM,1836,38,25-29,1874,2
STAT,1858,43,na,1901,1701.701694778036
STAT,1920,29,30-34,1949,40.316962611057946
STAT,1835,33,40-44,1868,3.4092764422032626
SIM,1838,17,25-29,1855,6
STAT,1857,36,25-29,1893,2.154604890250693
STAT,1927,42,na,1969,4400.692157465731
STAT,1871,33,na,1904,2225.4527795877775
SIM,1872,29,25-29,1901,43
STAT,1820,50,40-44,1870,0.01736399305295281
STAT,1803,53,45-49,1856,0.04077151133148931
STAT,1825,43,25-29,1868,0.7015642259230558
SIM,1874,42,30-34,1916,6
SIM,1890,27,20-24,1917,19
STAT,1867,26,40-44,1893,2.6661849754554865
STAT,1863,33,45-49,1896,1.44198268048445
SIM,1853,37,45-49,1890,1
STAT,1824,31,na,1855,1517.422963536916
STAT,1866,42,30-34,1908,1.0001156005818426
SIM,1831,65,na,1896,1017
SIM,1869,83,na,1952,308
STAT,1935,5,na,1940,5192.375813670553
SIM,1894,50,na,1944,2814
STAT,1828,38,25-29,1866,2.674188251629929
STAT,1841,35,na,1876,1762.7662194818859
STAT,1877,34,50-100,1911,0.8905209469781825
STAT,1884,26,45-49,1910,1.040069101686972
SIM,1926,21,na,1947,4062
STAT,1802,54,40-44,1856,0.02882652286557205
STAT,1851,16,35-39,1867,0.4921158662247022
STAT,1852,48,45-49,1900,0.17705328439971238
STAT,1910,39,15-19,1949,0.017170547010553653
SIM,1836,96,na,1932,7
SIM,1842,32,40-44,1874,5
SIM,1861,63,na,1924,1527
STAT,1840,46,25-29,1886,0.04097295191985852
STAT,1856,53,25-29,1909,0.0025786356709048253
STAT,1876,34,40-44,1910,4.193195689253295
SIM,1875,41,35-39,1916,1
SIM,1783,84,na,1867,90
SIM,1916,8,na,1924,3896
STAT,1882,45,20-24,1927,0.011140975613623531
SIM,1810,71,na,1881,600
STAT,1864,17,30-34,1881,1.3921186628795323
STAT,1829,94,na,1923,12.25043925129172
STAT,1906,30,50-100,1936,0.7295366023053262
SIM,1883,17,35-39,1900,2
STAT,1949,22,50-100,1971,0.7253945076652509
STAT,1823,46,25-29,1869,0.06970885034200024
STAT,1842,40,20-24,1882,0.1200435846425641
STAT,1819,45,20-24,1864,0.021984893592134194
SIM,1821,44,45-49,1865,4
SIM,1772,92,na,1864,7
SIM,1872,17,30-34,1889,1
SIM,1838,35,25-29,1873,2
STAT,1824,100,na,1924,0.5604824230698603
STAT,1834,41,na,1875,1589.012192833805
STAT,1901,49,na,1950,2913.3623003629527
STAT,1815,54,20-24,1869,0.0016488737537688242
SIM,1934,30,30-34,1964,28
STAT,1888,40,50-100,1928,1.190907681930172
STAT,1856,96,na,1952,6.353216295422785
STAT,1880,48,20-24,1928,0.011778106028140818
STAT,1886,23,45-49,1909,0.6938628216557674
STAT,1886,38,15-19,1924,0.05577122019237892
STAT,1897,26,25-29,1923,53.6276717820159
SIM,1842,35,45-49,1877,4
STAT,1917,22,30-34,1939,28.85594517132857
SIM,1833,26,35-39,1859,13
SIM,1882,36,30-34,1918,6
STAT,1834,35,45-49,1869,1.567081070928157
SIM,1925,22,30-34,1947,37
SIM,1842,34,35-39,1876,13
SIM,1817,43,40-44,1860,9
STAT,1840,45,15-19,1885,2.882029751933671E-4
STAT,1854,20,50-100,1874,0.3500339569403428
STAT,1870,29,20-24,1899,10.781832058546547
STAT,1804,51,40-44,1855,0.031940595511943476
STAT,1830,44,45-49,1874,1.107295315549718
STAT,1947,22,15-19,1969,5.683778718357086
SIM,1836,88,na,1924,68
STAT,1819,47,15-19,1866,7.112652867760319E-4
STAT,1862,34,40-44,1896,3.464770079574623
STAT,1851,34,35-39,1885,7.57062651833102
STAT,1899,33,25-29,1932,13.204255440954109
SIM,1864,37,20-24,1901,3
STAT,1865,46,30-34,1911,0.08333338916699816
STAT,1900,48,15-19,1948,2.919967696443413E-4
STAT,1886,36,20-24,1922,0.7731060700100311
SIM,1876,22,40-44,1898,2
STAT,1813,44,45-49,1857,4.785521005730241
STAT,1831,37,15-19,1868,0.044345300675736644
STAT,1855,107,na,1962,0.014112124894812384
STAT,1892,17,35-39,1909,0.6491266404129891
STAT,1848,47,40-44,1895,0.12276150766518351
SIM,1880,22,na,1902,2430
SIM,1882,57,na,1939,1821
STAT,1834,34,35-39,1868,7.8645391423415205
SIM,1827,32,45-49,1859,2
STAT,1899,35,50-100,1934,1.6045475420705562
STAT,1825,42,40-44,1867,2.5124217590381126
SIM,1768,87,na,1855,38
SIM,1873,28,30-34,1901,33
STAT,1868,22,40-44,1890,1.8795477140216432
STAT,1902,42,na,1944,3088.0595867675156
STAT,1890,37,25-29,1927,3.325550518273542
STAT,1917,25,50-100,1942,0.9927571150527121
STAT,1949,20,25-29,1969,101.9011700504049
STAT,1926,30,30-34,1956,18.019528339399216
STAT,1865,45,20-24,1910,0.01040403832684131
SIM,1892,55,na,1947,2498
STAT,1881,28,15-19,1909,0.4123853153473754
SIM,1884,34,40-44,1918,4
STAT,1878,12,na,1890,2539.7751187784625
SIM,1892,38,50-100,1930,1
STAT,1850,19,25-29,1869,4.8177128886231655
SIM,1900,16,na,1916,3290
STAT,1819,47,45-49,1866,0.41964687240751825
STAT,1909,16,45-49,1925,0.0927469587661127
STAT,1874,20,15-19,1894,3.2043171061711577
STAT,1871,40,45-49,1911,1.4158119008787313
STAT,1880,35,45-49,1915,2.000341402650403
STAT,1894,31,50-100,1925,1.1179903825329682
STAT,1880,18,25-29,1898,5.617961416378989
STAT,1833,48,na,1881,1437.2085618090596
STAT,1889,44,20-24,1933,0.18271908171676954
SIM,1816,88,na,1904,43
STAT,1869,38,15-19,1907,0.05109510242064238
STAT,1925,47,na,1972,4206.06322900456
SIM,1833,44,35-39,1877,2
SIM,1851,25,45-49,1876,1
STAT,1838,27,30-34,1865,21.847449743386697
SIM,1816,42,40-44,1858,3
SIM,1894,36,20-24,1930,5
STAT,1892,35,35-39,1927,8.44677949740814
STAT,1824,45,30-34,1869,0.11701934333428277
SIM,1831,28,25-29,1859,43
STAT,1875,35,35-39,1910,6.929732577192389
SIM,1902,39,30-34,1941,1
SIM,1785,79,na,1864,219
SIM,1902,22,35-39,1924,10
STAT,1881,46,15-19,1927,3.658931815474138E-4
STAT,1800,106,na,1906,0.004839768695887249
STAT,1861,53,35-39,1914,0.00664516960942495
STAT,1895,55,na,1950,2549.076843995052
SIM,1898,36,50-100,1934,2
STAT,1802,56,na,1858,1031.9262598705836
STAT,1839,51,50-100,1890,0.010118273634798376
STAT,1875,33,40-44,1908,4.191186494104413
STAT,1851,33,na,1884,1802.5396549898576
STAT,1828,37,15-19,1865,0.05332830892006049
STAT,1865,43,25-29,1908,0.5472742352699043
STAT,1891,36,30-34,1927,6.2619056723705695
SIM,1862,57,na,1919,1737
SIM,1883,35,35-39,1918,5
STAT,1865,15,50-100,1880,0.0481910652583912
STAT,1929,29,na,1958,4424.98761077358
STAT,1928,31,50-100,1959,0.9773032206928587
STAT,1963,9,na,1972,4714.9345280147645
STAT,1895,28,15-19,1923,0.5573555726489184
STAT,1860,111,na,1971,0.0011613172994174182
SIM,1861,29,20-24,1890,10
SIM,1883,33,40-44,1916,5
STAT,1890,19,25-29,1909,6.510123740171527
STAT,1918,20,25-29,1938,94.67236305144945
STAT,1861,51,40-44,1912,0.008298210033722098
STAT,1798,77,na,1875,339.85492005831054
SIM,1882,18,30-34,1900,1
STAT,1809,66,na,1875,840.7083469909772
STAT,1871,73,na,1944,1112.3819748842009
SIM,1916,26,50-100,1942,5
STAT,1848,30,15-19,1878,0.12215331482988466
STAT,1830,24,20-24,1854,153.57704334837956
STAT,1933,34,na,1967,4808.752282570864
STAT,1861,26,45-49,1887,0.8836797571780266
STAT,1853,29,20-24,1882,9.040402564372092
STAT,1847,20,na,1867,1956.5982735462926
STAT,1865,30,15-19,1895,0.12323178789686838
SIM,1920,36,na,1956,3826
SIM,1880,23,15-19,1903,3
STAT,1805,84,na,1889,113.41654738256032
STAT,1869,36,20-24,1905,0.7082852713805388
STAT,1874,36,30-34,1910,5.170642777625023
SIM,1926,20,25-29,1946,108
SIM,1846,27,30-34,1873,23
SIM,1851,65,na,1916,1249
SIM,1871,47,50-100,1918,2
STAT,1952,20,30-34,1972,32.669009168404635
STAT,1848,43,20-24,1891,0.11358615414479273
STAT,1873,40,50-100,1913,1.0232624567519568
SIM,1932,29,50-100,1961,1
STAT,1830,26,45-49,1856,1.171512484321081
SIM,1837,50,na,1887,1451
STAT,1841,29,25-29,1870,35.433346311176024
SIM,1863,98,na,1961,6
SIM,1779,79,na,1858,220
STAT,1855,54,20-24,1909,5.082499076797626E-4
SIM,1867,34,40-44,1901,3
STAT,1824,51,50-100,1875,0.01743177906445516
STAT,1872,38,15-19,1910,0.052981785349464634
SIM,1879,36,25-29,1915,5
STAT,1889,48,40-44,1937,0.11121294439192893
SIM,1837,19,30-34,1856,1
STAT,1938,26,na,1964,3507.2366898189775
STAT,1825,44,35-39,1869,1.9353275218195911
STAT,1876,96,na,1972,50.39831110657791
STAT,1860,25,45-49,1885,0.8740864716104301
STAT,1848,49,35-39,1897,0.09875342968693844
STAT,1873,68,na,1941,1465.4013531952412
SIM,1933,17,40-44,1950,2
STAT,1856,22,20-24,1878,59.2177231473179
STAT,1893,30,25-29,1923,12.375633451524461
STAT,1912,40,na,1952,3421.421345263547
STAT,1862,52,40-44,1914,0.008438415806476541
STAT,1885,25,na,1910,2261.3850098267644
SIM,1810,63,na,1873,889
STAT,1957,15,35-39,1972,5.228412628048499
STAT,1889,83,na,1972,898.2043232681233
STAT,1851,15,25-29,1866,5.112380025686702
SIM,1862,25,20-24,1887,13
STAT,1858,32,25-29,1890,7.596218703242732
STAT,1883,42,30-34,1925,1.0631295061179147
STAT,1898,34,20-24,1932,3.4271490603615433
SIM,1814,53,na,1867,1176
STAT,1871,28,25-29,1899,39.47766647221267
STAT,1847,17,25-29,1864,5.2039650927905585
SIM,1859,40,40-44,1899,5
STAT,1907,20,20-24,1927,96.18430057676952
STAT,1901,57,na,1958,2718.250711624723
STAT,1859,19,45-49,1878,0.05649544480584212
SIM,1850,91,na,1941,28
STAT,1812,86,na,1898,95.42857628886847
STAT,1820,53,45-49,1873,0.02254758302806429
STAT,1876,16,40-44,1892,0.17881529243368466
SIM,1891,42,30-34,1933,2
SIM,1889,37,25-29,1926,2
STAT,1844,54,45-49,1898,0.009907688789659497
STAT,1850,36,40-44,1886,3.1632500689312173
STAT,1861,35,na,1896,1865.7617661909455
STAT,1789,80,na,1869,225.48232554294177
STAT,1872,40,35-39,1912,1.7343431307455122
STAT,1841,27,30-34,1868,21.399551416042442
STAT,1853,107,na,1960,0.010278543253364865
SIM,1861,44,45-49,1905,2
STAT,1855,30,50-100,1885,0.6745984444773382
STAT,1914,2,na,1916,3982.8932544652166
SIM,1863,27,30-34,1890,29
STAT,1833,39,45-49,1872,1.4857694474351002
SIM,1918,17,45-49,1935,2
STAT,1816,51,30-34,1867,0.015307349596750895
STAT,1860,22,40-44,1882,1.649231626604317
SIM,1854,33,45-49,1887,2
SIM,1943,20,25-29,1963,83
SIM,1866,32,25-29,1898,14
SIM,1833,29,45-49,1862,2
SIM,1840,61,na,1901,1276
STAT,1799,79,na,1878,288.6702696400859
STAT,1875,36,45-49,1911,1.9440667251165038
SIM,1929,17,20-24,1946,168
STAT,1849,86,na,1935,159.92631841121877
SIM,1880,40,35-39,1920,4
STAT,1825,110,na,1935,1.562399306114827E-4
STAT,1909,15,35-39,1924,0.7807766911660645
SIM,1835,41,35-39,1876,5
STAT,1861,63,na,1924,1399.7450363154633
STAT,1874,19,40-44,1893,0.17565160752322057
STAT,1822,47,20-24,1869,0.0167399055447253
STAT,1835,36,45-49,1871,1.5537595956846693
SIM,1915,20,20-24,1935,112
SIM,1841,35,30-34,1876,9
SIM,1890,15,25-29,1905,9
STAT,1848,46,25-29,1894,0.04161421113613788
SIM,1829,63,na,1892,953
SIM,1883,36,45-49,1919,3
STAT,1833,35,30-34,1868,4.142155643892424
STAT,1823,49,30-34,1872,0.11219036930143621
STAT,1832,86,na,1918,134.15932554493466
SIM,1893,48,50-100,1941,2
STAT,1782,90,na,1872,26.369464260350902
STAT,1844,39,20-24,1883,0.5600861940497507
STAT,1855,27,30-34,1882,18.589750282442957
STAT,1901,49,15-19,1950,2.921223767019908E-4
STAT,1846,51,45-49,1897,0.010281261101119328
STAT,1854,25,20-24,1879,9.87313345430623
SIM,1845,45,na,1890,1595
STAT,1867,29,45-49,1896,0.977800572643412
SIM,1898,44,40-44,1942,3
STAT,1873,29,50-100,1902,0.6090222282831195
SIM,1820,43,45-49,1863,2
STAT,1839,33,na,1872,1759.9474412343225
STAT,1853,48,na,1901,1647.534786018293
STAT,1885,48,50-100,1933,0.2282491967772364
STAT,1938,32,15-19,1970,0.12205122320672383
SIM,1819,53,na,1872,1218
STAT,1893,49,45-49,1942,0.1562325659933124
STAT,1935,20,25-29,1955,118.90336791237102
STAT,1862,35,20-24,1897,0.6270786103305086
STAT,1857,52,30-34,1909,0.004409565838430001
STAT,1872,30,50-100,1902,0.8757695723111093
STAT,1845,22,45-49,1867,0.6097686579328069
SIM,1872,41,50-100,1913,1
SIM,1883,32,30-34,1915,19
SIM,1870,34,40-44,1904,4
STAT,1815,39,25-29,1854,9.620911785506559
SIM,1908,36,na,1944,3257
SIM,1891,27,40-44,1918,8
STAT,1842,22,20-24,1864,61.89608352920304
SIM,1843,36,45-49,1879,1
STAT,1826,109,na,1935,3.883269328357885E-4
STAT,1948,22,30-34,1970,31.17760530068629
STAT,1882,25,na,1907,2208.6951947969023
SIM,1855,17,25-29,1872,3
STAT,1895,26,20-24,1921,14.512162251466265
SIM,1850,22,20-24,1872,50
STAT,1838,24,20-24,1862,60.10646196299573
STAT,1861,50,30-34,1911,0.004736740779529539
SIM,1874,50,na,1924,2090
SIM,1834,21,25-29,1855,57
STAT,1795,89,na,1884,36.911561047727595
STAT,1868,53,na,1921,1910.9251833141202
SIM,1853,22,45-49,1875,4
STAT,1818,49,20-24,1867,0.02486435708224715
SIM,1846,39,25-29,1885,3
STAT,1846,33,45-49,1879,1.4379778358553228
SIM,1841,17,30-34,1858,3
SIM,1833,25,25-29,1858,38
STAT,1865,25,na,1890,2062.5975907242187
STAT,1812,43,45-49,1855,5.386618232884511
SIM,1823,39,25-29,1862,1
SIM,1856,29,40-44,1885,3
STAT,1828,35,20-24,1863,0.7653462378114266
STAT,1872,23,15-19,1895,3.11847623050182
SIM,1856,96,na,1952,1
STAT,1897,39,30-34,1936,1.4387330181192173
STAT,1925,17,40-44,1942,1.5963925687850768
STAT,1868,42,35-39,1910,1.6313015664573058
STAT,1883,27,40-44,1910,2.7734940960437653
STAT,1847,35,25-29,1882,2.24414254726443
STAT,1851,28,50-100,1879,0.5453037446763687
STAT,1881,47,25-29,1928,0.052294550839754074
SIM,1909,29,na,1938,3321
STAT,1821,51,40-44,1872,0.015765076356974397
STAT,1866,66,na,1932,1427.559864059783
STAT,1891,37,40-44,1928,5.1186434778515455
STAT,1832,52,25-29,1884,0.0022337437048666297
STAT,1849,94,na,1943,14.405781529246607
STAT,1864,32,20-24,1896,2.2822215925785367
SIM,1916,31,na,1947,3600
STAT,1848,29,40-44,1877,2.539470051657538
SIM,1864,22,20-24,1886,56
STAT,1836,76,na,1912,598.275014488676
STAT,1889,47,30-34,1936,0.0633853652974617
STAT,1894,30,na,1924,2923.203299300215
STAT,1914,48,45-49,1962,0.2030246221084481
STAT,1824,42,25-29,1866,0.8123131645855882
SIM,1890,0,na,1890,3281
STAT,1873,37,25-29,1910,2.7608861493789245
SIM,1914,44,na,1958,3745
STAT,1861,43,na,1904,1800.016119812319
SIM,1930,5,na,1935,4865
SIM,1824,36,40-44,1860,7
SIM,1881,37,25-29,1918,5
STAT,1889,15,na,1904,2959.2291509776014
STAT,1891,33,25-29,1924,11.926204255165516
SIM,1878,19,20-24,1897,22
SIM,1833,68,na,1901,958
STAT,1856,37,20-24,1893,0.5703464584774038
SIM,1876,42,35-39,1918,7
SIM,1880,30,50-100,1910,1
STAT,1834,32,40-44,1866,3.4385065701131117
STAT,1807,49,45-49,1856,0.8458555976532623
STAT,1824,46,40-44,1870,0.20405243243539273
SIM,1882,39,35-39,1921,12
SIM,1865,22,na,1887,2041
SIM,1898,32,na,1930,3016
STAT,1858,36,40-44,1894,3.262111237728159
SIM,1865,37,40-44,1902,3
STAT,1874,53,na,1927,2045.571505966905
STAT,1909,33,35-39,1942,8.201282544489553
STAT,1917,25,35-39,1942,14.974451055843623
STAT,1885,45,na,1930,2138.614303239656
SIM,1769,92,na,1861,3
SIM,1854,30,na,1884,1935
STAT,1902,45,15-19,1947,3.038012499838855E-4
SIM,1851,42,30-34,1893,4
STAT,1840,43,20-24,1883,0.11390329012619109
SIM,1945,21,45-49,1966,1
STAT,1866,27,35-39,1893,8.40411087035428
STAT,1910,19,20-24,1929,25.23453457213735
STAT,1883,23,20-24,1906,63.60665790101087
STAT,1859,84,na,1943,250.80294592774536
STAT,1876,37,45-49,1913,1.9441586711475989
SIM,1831,41,50-100,1872,1
SIM,1859,43,50-100,1902,1
SIM,1838,32,20-24,1870,5
SIM,1857,50,na,1907,1738
SIM,1861,31,35-39,1892,9
SIM,1908,22,30-34,1930,29
STAT,1853,32,45-49,1885,1.3317613146049065
STAT,1845,37,45-49,1882,1.475353662526933
STAT,1912,29,na,1941,3461.7735174209356
STAT,1863,48,20-24,1911,0.009839753269390773
STAT,1881,17,30-34,1898,1.4538384149464578
STAT,1833,35,25-29,1868,2.237716255106525
SIM,1849,83,na,1932,232
SIM,1896,6,na,1902,3341
STAT,1841,43,na,1884,1622.2826409114641
SIM,1795,89,na,1884,29
SIM,1897,29,30-34,1926,41
STAT,1880,32,40-44,1912,4.3106893616688255
STAT,1883,25,50-100,1908,0.5962882992499561
SIM,1850,71,na,1921,962
STAT,1809,46,45-49,1855,0.8769028747462018
SIM,1813,68,na,1881,738
SIM,1939,25,35-39,1964,17
SIM,1821,35,na,1856,1553
STAT,1868,25,45-49,1893,1.0082622035308606
SIM,1953,9,na,1962,4365
SIM,1875,26,45-49,1901,4
SIM,1907,62,na,1969,2838
SIM,1925,25,35-39,1950,22
SIM,1935,32,40-44,1967,4
STAT,1937,21,45-49,1958,1.035297051800552
STAT,1869,39,25-29,1908,2.6063454330856444
SIM,1859,5,na,1864,2405
STAT,1816,99,na,1915,0.8825355877195531
STAT,1889,29,30-34,1918,29.15903935463769
STAT,1845,50,45-49,1895,0.010369172116760066
SIM,1922,31,na,1953,4059
SIM,1824,32,20-24,1856,5
STAT,1880,50,35-39,1930,0.008680364567872734
STAT,1821,110,na,1931,1.4922220272135298E-4
STAT,1900,32,35-39,1932,13.272426649647507
STAT,1897,38,20-24,1935,0.9690717738989094
SIM,1897,47,50-100,1944,1
STAT,1838,42,20-24,1880,0.12667367360632487
STAT,1850,32,25-29,1882,7.543237489189941
STAT,1887,16,15-19,1903,6.285231076528073
STAT,1856,50,20-24,1906,5.53828110956567E-4
STAT,1892,16,25-29,1908,6.720242807724353
SIM,1909,42,40-44,1951,1
STAT,1916,15,50-100,1931,0.0754389229684556
SIM,1846,24,20-24,1870,58
STAT,1840,33,50-100,1873,0.7691592701026918
STAT,1861,54,45-49,1915,0.011071579725284424
STAT,1853,31,35-39,1884,7.814792123235754
STAT,1884,43,30-34,1927,1.0655079622493793
SIM,1832,27,na,1859,1734
STAT,1897,23,20-24,1920,86.79607256466453
STAT,1759,103,na,1862,0.02115984095322057
STAT,1818,71,na,1889,669.4056938629842
STAT,1889,47,50-100,1936,0.1608207198020866
STAT,1875,32,30-34,1907,16.945319598617917
STAT,1836,44,40-44,1880,1.6469850717444496
STAT,1851,19,45-49,1870,0.057556095992154756
SIM,1895,16,15-19,1911,4
SIM,1858,26,40-44,1884,2
STAT,1834,36,50-100,1870,0.9551595221726366
STAT,1782,104,na,1886,0.030064106089433093
STAT,1864,29,25-29,1893,35.460279274849114
SIM,1917,15,35-39,1932,2
STAT,1817,52,30-34,1869,0.012756435821778593
STAT,1927,32,40-44,1959,4.54812491842275
SIM,1882,20,15-19,1902,5
SIM,1877,39,25-29,1916,2
STAT,1817,39,50-100,1856,3.580683692891409
STAT,1837,18,50-100,1855,0.043105716984256984
STAT,1846,15,15-19,1861,5.3187818943065945
STAT,1925,39,na,1964,4257.184093486099
SIM,1842,36,50-100,1878,1
SIM,1871,22,na,1893,2287
SIM,1895,34,45-49,1929,1
SIM,1850,41,30-34,1891,5
SIM,1871,18,20-24,1889,18
SIM,1848,36,25-29,1884,3
SIM,1867,88,na,1955,88
SIM,1841,39,45-49,1880,1
SIM,1825,39,50-100,1864,5
STAT,1839,53,25-29,1892,0.0023237955139329357
STAT,1846,48,15-19,1894,2.784850442753336E-4
STAT,1849,43,40-44,1892,1.609545795540458
STAT,1865,47,40-44,1912,0.1462805936052337
SIM,1932,6,na,1938,4866
SIM,1949,18,na,1967,4043
STAT,1912,16,50-100,1928,0.07172878602332598
SIM,1887,25,20-24,1912,11
STAT,1807,48,35-39,1855,0.5100440777483978
STAT,1834,31,30-34,1865,13.988000222469951
STAT,1935,23,35-39,1958,12.108364621754033
STAT,1772,92,na,1864,9.034536834217825
SIM,1809,86,na,1895,95
SIM,1951,15,35-39,1966,8
STAT,1852,100,na,1952,0.8066085431604727
STAT,1894,32,35-39,1926,12.306615817777447
SIM,1815,94,na,1909,9
STAT,1889,47,25-29,1936,0.03771691121845052
SIM,1919,31,45-49,1950,5
STAT,1848,46,30-34,1894,0.0699349943889218
STAT,1899,5,na,1904,3392.7139267373323
STAT,1882,40,20-24,1922,0.1474619713353505
SIM,1892,47,na,1939,2699
STAT,1851,33,25-29,1884,7.736921161373658
STAT,1920,16,na,1936,3910.980307779171
STAT,1943,15,35-39,1958,4.205660936892352
STAT,1795,80,na,1875,247.8429381998221
STAT,1863,18,20-24,1881,15.197231625069682
SIM,1864,83,na,1947,295
STAT,1843,42,30-34,1885,0.8539964224154756
STAT,1811,47,45-49,1858,0.785772046002051
SIM,1879,33,20-24,1912,1
STAT,1880,15,20-24,1895,17.704007256657803
STAT,1825,29,45-49,1854,3.657957345100976
STAT,1857,51,20-24,1908,5.521955001561876E-4
SIM,1928,16,20-24,1944,162
SIM,1854,15,15-19,1869,4
STAT,1827,41,35-39,1868,1.6954093293449337
STAT,1852,30,35-39,1882,8.133665971517075
SIM,1856,28,30-34,1884,25
STAT,1842,41,30-34,1883,0.8579486404572776
STAT,1854,43,15-19,1897,0.009872542596081784
STAT,1874,39,35-39,1913,6.760396554841552
STAT,1875,50,25-29,1925,0.0034870587772702173
STAT,1871,27,45-49,1898,1.039847118984045
STAT,1841,26,20-24,1867,10.041472510243773
STAT,1920,29,50-100,1949,1.0241663408571868
SIM,1891,62,na,1953,2135
SIM,1945,18,15-19,1963,40
SIM,1899,27,40-44,1926,7
STAT,1923,21,15-19,1944,5.869378268491902
SIM,1802,76,na,1878,378
SIM,1878,40,na,1918,2366
STAT,1873,25,25-29,1898,40.838378690471345
SIM,1875,75,na,1950,891
STAT,1837,61,na,1898,1179.5906052986616
SIM,1860,30,35-39,1890,10
SIM,1933,23,na,1956,4905
STAT,1856,38,30-34,1894,3.923763687860389
SIM,1909,24,40-44,1933,3
STAT,1861,23,40-44,1884,1.667332295674251
STAT,1899,37,40-44,1936,1.2232097436358471
SIM,1885,30,40-44,1915,5
STAT,1819,56,na,1875,1151.7430031756044
STAT,1877,30,40-44,1907,4.285529823190939
SIM,1931,21,15-19,1952,6
SIM,1880,90,na,1970,218
STAT,1887,34,45-49,1921,1.8265686858511787
SIM,1809,55,na,1864,1140
STAT,1830,51,na,1881,1361.5052444115684
STAT,1846,33,15-19,1879,0.11743116906064319
SIM,1804,63,na,1867,841
STAT,1867,40,25-29,1907,0.5753410032325286
SIM,1878,12,na,1890,2613
SIM,1873,88,na,1961,193
STAT,1937,18,15-19,1955,41.59364183080565
STAT,1879,25,20-24,1904,11.662601103571596
SIM,1842,31,30-34,1873,20
STAT,1914,47,35-39,1961,0.12077408727961884
SIM,1943,23,35-39,1966,13
STAT,1848,28,30-34,1876,21.50217937245107
STAT,1858,53,30-34,1911,0.004343706059326219
SIM,1920,21,40-44,1941,3
STAT,1869,18,20-24,1887,16.33930346000473
SIM,1803,61,na,1864,875
SIM,1929,18,30-34,1947,20
STAT,1785,99,na,1884,0.35760324438180247
STAT,1832,24,25-29,1856,49.5502037592409
SIM,1895,75,na,1970,1680
SIM,1861,43,35-39,1904,5
STAT,1863,36,20-24,1899,0.6432043356088767
STAT,1876,30,25-29,1906,10.069449411320013
SIM,1889,2,na,1891,3126
STAT,1818,51,35-39,1869,0.017996691329759583
STAT,1945,16,na,1961,3799.453706345154
STAT,1837,28,20-24,1865,9.437048408646094
STAT,1820,37,45-49,1857,4.550352895484114
STAT,1922,25,15-19,1947,0.7598224869799909
STAT,1846,37,30-34,1883,3.9241345647708292
STAT,1869,53,40-44,1922,0.009472300327026329
STAT,1888,48,25-29,1936,0.035804890855832265
STAT,1954,18,15-19,1972,52.98268994939517
SIM,1860,70,na,1930,1139
SIM,1861,41,40-44,1902,8
STAT,1856,40,15-19,1896,0.010320911308727643
SIM,1921,46,na,1967,3819
STAT,1843,24,35-39,1867,5.208847564149302
SIM,1809,63,na,1872,936
SIM,1929,7,na,1936,4904
SIM,1939,21,15-19,1960,7
STAT,1820,51,50-100,1871,0.02441864601757502
STAT,1860,21,30-34,1881,14.199493434952599
STAT,1841,66,na,1907,1121.396937846086
SIM,1884,30,25-29,1914,14
STAT,1912,21,40-44,1933,3.052608669079183
SIM,1951,8,na,1959,4353
STAT,1849,33,50-100,1882,0.6887304970354778
SIM,1828,29,30-34,1857,22
STAT,1877,48,15-19,1925,3.871993785645663E-4
STAT,1848,13,na,1861,2122.2948685536066
STAT,1896,24,45-49,1920,0.8651781585369472
SIM,1868,73,na,1941,992
STAT,1885,42,35-39,1927,1.7022022813969133
SIM,1854,19,30-34,1873,1
STAT,1869,83,na,1952,363.0195148909263
SIM,1796,74,na,1870,419
SIM,1896,36,25-29,1932,2
STAT,1891,30,20-24,1921,3.186110961882036
SIM,1872,31,45-49,1903,1
STAT,1854,33,na,1887,1741.5355670227993
STAT,1936,20,50-100,1956,0.5945882892645966
SIM,1870,91,na,1961,86
STAT,1871,24,40-44,1895,1.939360308383252
STAT,1864,17,25-29,1881,4.949438271550138
SIM,1876,17,na,1893,2527
STAT,1872,58,na,1930,1875.1624911788156
SIM,1917,16,na,1933,3893
STAT,1953,11,na,1964,4489.784542384317
SIM,1872,17,25-29,1889,5
STAT,1833,51,30-34,1884,0.0038074870575894393
SIM,1833,26,40-44,1859,3
STAT,1784,104,na,1888,0.027535579021325633
SIM,1887,57,na,1944,2069
STAT,1893,16,45-49,1909,0.07848889838377093
SIM,1839,29,40-44,1868,2
SIM,1889,34,20-24,1923,3
STAT,1883,10,na,1893,2398.2976551706497
STAT,1908,48,20-24,1956,0.00941312319598077
SIM,1930,39,40-44,1969,1
STAT,1821,34,20-24,1855,7.350453217505221
STAT,1844,51,40-44,1895,0.007425867361781226
SIM,1858,43,na,1901,1852
STAT,1838,27,50-100,1865,0.5549878069090605
STAT,1875,17,35-39,1892,0.5325430867674028
SIM,1902,62,na,1964,2654
SIM,1837,19,na,1856,1918
STAT,1851,30,20-24,1881,2.1064058021062335
SIM,1889,35,na,1924,2798
STAT,1869,94,na,1963,48.32844818190631
STAT,1855,7,na,1862,2084.989982268469
STAT,1893,19,45-49,1912,0.0778767119646086
STAT,1922,39,40-44,1961,1.6058609507697956
SIM,1837,81,na,1918,297
STAT,1872,27,30-34,1899,23.87753539283575
SIM,1887,24,15-19,1911,1
STAT,1838,91,na,1929,39.52182021720775
SIM,1857,42,30-34,1899,4
STAT,1869,51,45-49,1920,0.013334180549630278
SIM,1880,38,20-24,1918,2
STAT,1837,53,50-100,1890,0.009380965287084219
STAT,1894,50,na,1944,2654.2470019322413
SIM,1932,20,20-24,1952,124
STAT,1837,46,20-24,1883,0.00796498881513168
STAT,1825,45,45-49,1870,0.25436830091826085
STAT,1895,44,15-19,1939,0.0011662759753962705
STAT,1876,49,45-49,1925,0.2253547030555206
SIM,1820,40,40-44,1860,7
SIM,1905,31,50-100,1936,3
SIM,1925,25,50-100,1950,1
STAT,1813,41,40-44,1854,8.312704813258543
STAT,1821,54,45-49,1875,0.02047146405108236
STAT,1879,39,15-19,1918,0.05489074813717691
STAT,1913,20,45-49,1933,1.0359077782189199
STAT,1849,42,30-34,1891,0.8276500896823992
SIM,1956,11,na,1967,4766
STAT,1867,22,25-29,1889,50.986064457926354
STAT,1899,36,35-39,1935,9.200771107688995
STAT,1841,48,35-39,1889,0.09499616654269584
STAT,1826,28,45-49,1854,3.3822511031680604
SIM,1834,30,na,1864,1694
SIM,1851,24,35-39,1875,4
STAT,1831,101,na,1932,0.3480033842173369
STAT,1923,38,45-49,1961,0.7455235841756984
STAT,1935,35,50-100,1970,0.5555530864858762
STAT,1956,8,na,1964,4912.257831488622
SIM,1894,5,na,1899,3344
SIM,1898,25,30-34,1923,43
SIM,1770,89,na,1859,30
SIM,1834,25,45-49,1859,1
SIM,1874,27,40-44,1901,4
SIM,1923,24,na,1947,3930
STAT,1857,19,40-44,1876,0.15822170269378913
STAT,1872,38,20-24,1910,0.7272953255646987
SIM,1875,22,25-29,1897,68
SIM,1931,38,45-49,1969,1
STAT,1866,28,50-100,1894,0.5552038350785871
SIM,1881,19,25-29,1900,5
STAT,1872,5,na,1877,2628.730888665043
SIM,1877,47,na,1924,2217
STAT,1821,36,15-19,1857,0.12499212749624754
STAT,1799,70,na,1869,677.4494712753224
STAT,1838,27,25-29,1865,36.70009713107023
STAT,1890,18,15-19,1908,6.836607496050925
STAT,1845,34,40-44,1879,3.557403585716494
SIM,1856,65,na,1921,1288
SIM,1877,18,20-24,1895,16
STAT,1840,49,30-34,1889,0.06626099502683004
STAT,1894,61,na,1955,2270.8038106738577
SIM,1870,37,45-49,1907,1
SIM,1847,29,na,1876,1808
STAT,1909,30,30-34,1939,14.31360107882666
STAT,1837,25,20-24,1862,9.64327675723745
SIM,1823,78,na,1901,399
STAT,1880,30,45-49,1910,1.7472894752196717
STAT,1948,4,na,1952,4291.093921143595
STAT,1934,38,20-24,1972,0.3432994413067277
STAT,1855,41,45-49,1896,1.0647717770595342
STAT,1892,36,45-49,1928,2.369658969143156
STAT,1912,48,40-44,1960,0.14270982992316936
SIM,1821,41,40-44,1862,6
SIM,1921,20,45-49,1941,1
STAT,1847,47,25-29,1894,0.042183844398753036
SIM,1790,86,na,1876,47
SIM,1929,36,30-34,1965,2
SIM,1881,32,na,1913,1991
STAT,1821,66,na,1887,886.2652545154767
STAT,1775,89,na,1864,31.969363835602483
STAT,1897,41,15-19,1938,0.0012170759052308568
STAT,1775,111,na,1886,0.001119599912278171
STAT,1924,20,20-24,1944,124.70298006735804
STAT,1846,46,50-100,1892,0.17365744489989898
SIM,1833,22,20-24,1855,58
SIM,1845,25,20-24,1870,13
SIM,1850,60,na,1910,1403
STAT,1914,24,na,1938,3501.8434064265225
STAT,1857,37,40-44,1894,3.260148617440445
STAT,1874,52,30-34,1926,0.005716778004964298
SIM,1885,42,na,1927,2179
SIM,1845,28,20-24,1873,9
STAT,1826,46,45-49,1872,0.22364132830123434
STAT,1884,20,na,1904,2221.0402034469034
STAT,1830,82,na,1912,278.7137031956274
STAT,1836,47,15-19,1883,2.643459393605807E-4
STAT,1855,23,45-49,1878,0.5728187165351717
STAT,1887,49,20-24,1936,0.007002108262312032
SIM,1878,38,30-34,1916,5
STAT,1793,85,na,1878,87.34832991402381
STAT,1939,31,20-24,1970,2.3521792032161675
SIM,1855,35,25-29,1890,1
STAT,1932,15,30-34,1947,15.318324711150947
SIM,1834,43,40-44,1877,6
SIM,1862,17,na,1879,2285
SIM,1881,25,25-29,1906,37
SIM,1883,87,na,1970,370
SIM,1896,18,25-29,1914,9
STAT,1898,38,40-44,1936,1.2023007667438266
SIM,1780,79,na,1859,266
SIM,1846,27,25-29,1873,36
SIM,1857,24,30-34,1881,16
STAT,1893,34,40-44,1927,5.153554153852041
STAT,1907,42,na,1949,3213.8820396454676
SIM,1895,38,30-34,1933,7
STAT,1812,42,35-39,1854,6.8020595581122425
STAT,1851,35,45-49,1886,1.5085163278287035
STAT,1926,46,15-19,1972,4.3050449286620326E-4
SIM,1803,78,na,1881,274
SIM,1925,39,na,1964,4165
SIM,1861,32,na,1893,2065
STAT,1836,45,20-24,1881,0.008136214685352567
STAT,1858,39,45-49,1897,1.4635490499174668
STAT,1888,18,25-29,1906,6.307557282966819
STAT,1878,43,na,1921,2256.574972901327
STAT,1826,43,40-44,1869,2.174990876633604
SIM,1914,30,50-100,1944,1
SIM,1904,20,45-49,1924,5
STAT,1827,51,na,1878,1323.414075288323
SIM,1864,80,na,1944,473
STAT,1873,37,20-24,1910,0.7391734171687153
SIM,1875,26,40-44,1901,3
SIM,1878,16,15-19,1894,8
SIM,1893,32,50-100,1925,2
STAT,1851,16,40-44,1867,0.16403863157254187
STAT,1835,48,45-49,1883,0.153234108004449
SIM,1849,36,45-49,1885,1
SIM,1884,80,na,1964,742
STAT,1840,16,30-34,1856,1.4456592064626146
SIM,1940,15,30-34,1955,10
STAT,1904,14,na,1918,3487.5159622201054
SIM,1863,10,na,1873,2349
SIM,1890,27,25-29,1917,50
STAT,1884,38,50-100,1922,1.140461747954143
SIM,1886,26,20-24,1912,13
STAT,1841,46,40-44,1887,0.11918179528529897
SIM,1886,29,20-24,1915,11
SIM,1849,39,45-49,1888,2
SIM,1874,73,na,1947,1141
STAT,1764,97,na,1861,0.6444421752756171
STAT,1821,36,45-49,1857,4.437219998422813
STAT,1936,22,35-39,1958,8.502687529700966
SIM,1829,39,25-29,1868,2
SIM,1892,24,na,1916,2819
STAT,1825,73,na,1898,671.5483739690785
STAT,1859,52,35-39,1911,0.006456028338904219
STAT,1911,39,30-34,1950,1.6459007633250087
STAT,1880,51,45-49,1931,0.014494336329498527
SIM,1944,22,35-39,1966,12
STAT,1878,29,20-24,1907,11.45486596907133
SIM,1872,24,na,1896,2197
SIM,1829,27,25-29,1856,32
STAT,1860,51,25-29,1911,0.0027324260240694717
STAT,1890,36,15-19,1926,0.0651722106902271
STAT,1857,33,20-24,1890,2.0046097942384735
STAT,1858,51,35-39,1909,0.006415281772946143
STAT,1887,38,30-34,1925,5.602752223437296
STAT,1849,24,30-34,1873,15.300547362016795
STAT,1945,7,na,1952,4078.3069016069517
STAT,1823,45,15-19,1868,4.911236150656621E-4
STAT,1836,96,na,1932,5.422380030805527
STAT,1872,23,45-49,1895,0.6591588090081498
SIM,1859,43,45-49,1902,2
SIM,1865,33,20-24,1898,2
STAT,1878,26,20-24,1904,11.57691845456019
STAT,1928,9,na,1937,4739.0640042028845
SIM,1889,27,na,1916,2798
STAT,1888,36,25-29,1924,3.2286786598390678
SIM,1947,15,15-19,1962,47
STAT,1826,47,50-100,1873,0.2296377032528305
STAT,1907,65,na,1972,2694.8884100069718
SIM,1943,20,30-34,1963,37
STAT,1846,19,30-34,1865,1.3951305434853771
STAT,1882,27,25-29,1909,38.88558411222142
SIM,1792,81,na,1873,143
SIM,1841,19,25-29,1860,6
STAT,1840,41,na,1881,1700.682534221578
STAT,1870,31,35-39,1901,9.412625432149564
STAT,1832,39,25-29,1871,2.160039419721235
STAT,1831,37,20-24,1868,0.6087399599596593
STAT,1873,4,na,1877,2808.666192762463
STAT,1910,17,na,1927,3614.2938663676105
STAT,1892,17,40-44,1909,0.2163755593322165
STAT,1813,42,15-19,1855,0.04913481646522535
STAT,1879,28,25-29,1907,41.6227504223803
STAT,1842,26,40-44,1868,2.6570722826444677
SIM,1871,18,25-29,1889,7
SIM,1862,42,40-44,1904,2
SIM,1905,39,na,1944,3197
SIM,1899,34,na,1933,3005
STAT,1829,66,na,1895,1004.629046736702
SIM,1866,95,na,1961,17
SIM,1868,42,50-100,1910,3
STAT,1863,18,25-29,1881,4.857626545629315
STAT,1915,43,35-39,1958,0.19119773252799774
STAT,1836,29,15-19,1865,0.36542591104410344
STAT,1852,36,45-49,1888,1.5387092155710305
SIM,1840,39,25-29,1879,1
STAT,1832,36,25-29,1868,2.2311703219319448
STAT,1879,93,na,1972,131.03717128953252
SIM,1840,36,25-29,1876,2
SIM,1899,23,25-29,1922,81
SIM,1909,20,25-29,1929,90
SIM,1919,28,na,1947,3804
STAT,1865,0,na,1865,3271.088216430057
SIM,1860,36,45-49,1896,2
SIM,1837,37,30-34,1874,6
STAT,1842,29,40-44,1871,2.6002488975304443
STAT,1884,35,50-100,1919,1.1570317287427105
STAT,1864,46,15-19,1910,3.386828824826169E-4
SIM,1887,28,25-29,1915,44
SIM,1830,29,20-24,1859,9
SIM,1868,30,40-44,1898,4
STAT,1914,44,30-34,1958,0.11925494579353324
SIM,1820,42,35-39,1862,3
SIM,1888,21,50-100,1909,1
STAT,1922,42,na,1964,4027.3651552575893
SIM,1845,14,na,1859,2117
SIM,1850,29,40-44,1879,2
STAT,1813,48,na,1861,1285.979445107461
SIM,1850,26,40-44,1876,3
STAT,1762,93,na,1855,1.22436
STAT,1797,92,na,1889,11.623947166582408
STAT,1939,15,15-19,1954,43.01611364748003
SIM,1831,96,na,1927,5
STAT,1896,28,30-34,1924,31.32974267021036
SIM,1875,44,40-44,1919,7
SIM,1849,32,25-29,1881,19
STAT,1839,50,20-24,1889,5.042668837901798E-4
STAT,1909,20,na,1929,3369.730271801575
SIM,1840,24,25-29,1864,49
STAT,1919,47,50-100,1966,0.23175492435228023
STAT,1939,26,50-100,1965,0.9456051430167822
STAT,1876,65,na,1941,1648.1450653316385
STAT,1878,47,20-24,1925,0.011746411869091974
STAT,1935,20,30-34,1955,36.997429047359056
SIM,1914,25,30-34,1939,50
STAT,1884,25,35-39,1909,9.068768862188053
SIM,1874,43,40-44,1917,5
STAT,1863,47,50-100,1910,0.20299875236722426
SIM,1954,16,na,1970,4148
STAT,1852,15,45-49,1867,0.060739287372930675
SIM,1938,23,20-24,1961,97
SIM,1817,81,na,1898,283
STAT,1877,48,45-49,1925,0.2284478256337567
STAT,1880,33,15-19,1913,0.1409556495831719
SIM,1925,28,na,1953,4067
SIM,1825,34,35-39,1859,11
STAT,1847,51,na,1898,1591.8566193747743
SIM,1845,25,na,1870,1866
SIM,1854,37,30-34,1891,12
SIM,1848,33,20-24,1881,1
STAT,1785,103,na,1888,0.05387624276776548
STAT,1861,38,45-49,1899,1.5560871274421872
STAT,1906,25,30-34,1931,34.875461609362524
STAT,1867,44,40-44,1911,1.9681785312769529
SIM,1834,22,na,1856,1744
SIM,1889,38,40-44,1927,7
STAT,1853,99,na,1952,1.40450662074577
SIM,1926,22,50-100,1948,3
SIM,1859,22,40-44,1881,2
SIM,1840,18,25-29,1858,2
STAT,1866,43,40-44,1909,1.9449425307120303
SIM,1892,25,35-39,1917,19
STAT,1877,46,20-24,1923,0.011797203807368836
SIM,1839,32,50-100,1871,3
SIM,1879,37,50-100,1916,3
SIM,1904,17,15-19,1921,6
STAT,1852,18,45-49,1870,0.059672333274093894
STAT,1857,54,25-29,1911,0.0025653758739507928
SIM,1861,55,na,1916,1785
STAT,1843,21,30-34,1864,16.24699683605166
SIM,1865,14,na,1879,2317
STAT,1875,53,30-34,1928,0.005684416863532355
STAT,1894,44,35-39,1938,0.1507471992398379
SIM,1946,18,30-34,1964,14
STAT,1874,61,na,1935,1804.226565376999
STAT,1830,74,na,1904,662.9338419492275
STAT,1902,49,30-34,1951,0.07127434900084033
STAT,1868,13,na,1881,2398.095287085848
STAT,1949,3,na,1952,4371.301065004253
STAT,1850,38,35-39,1888,5.005952677649328
SIM,1895,35,na,1930,2959
STAT,1837,28,25-29,1865,34.02823286775235
STAT,1913,17,15-19,1930,8.763796704107111
SIM,1902,11,na,1913,3469
SIM,1854,81,na,1935,356
STAT,1833,54,35-39,1887,0.005189045188956898
STAT,1829,37,30-34,1866,4.75605690004313
STAT,1854,28,20-24,1882,8.792410329745653
STAT,1870,41,40-44,1911,2.0915069697443376
STAT,1873,19,25-29,1892,5.404732349191178
STAT,1843,40,35-39,1883,1.3800201574484825
SIM,1810,94,na,1904,8
STAT,1834,33,na,1867,1700.5005700515699
SIM,1818,42,45-49,1860,3
SIM,1871,62,na,1933,1702
STAT,1868,36,35-39,1904,6.410318148416117
STAT,1793,77,na,1870,334.34783899820223
STAT,1878,20,na,1898,2339.79074464201
STAT,1894,46,20-24,1940,0.00824918012794002
STAT,1883,44,25-29,1927,0.586526741114651
SIM,1865,36,25-29,1901,1
STAT,1877,33,45-49,1910,1.7022844179994192
SIM,1862,28,20-24,1890,12
STAT,1840,81,na,1921,376.59743627904015
STAT,1865,28,30-34,1893,21.541178955377784
STAT,1854,40,45-49,1894,1.088596555110749
STAT,1910,44,50-100,1954,0.10356857954928898
SIM,1879,9,na,1888,2595
SIM,1918,32,35-39,1950,12
STAT,1815,74,na,1889,484.4168758285642
STAT,1898,20,na,1918,3042.5336742802606
STAT,1822,35,20-24,1857,1.535807422269412
STAT,1938,18,30-34,1956,11.353596102199372
SIM,1881,83,na,1964,493
SIM,1858,44,40-44,1902,5
STAT,1893,20,na,1913,2851.6990789005513
STAT,1832,36,20-24,1868,0.5973523361399232
SIM,1845,28,25-29,1873,34
STAT,1867,68,na,1935,1355.511959998456
SIM,1891,8,na,1899,3200
STAT,1925,16,na,1941,4211.270267606594
STAT,1776,110,na,1886,0.001666339318392288
STAT,1776,85,na,1861,69.50808498429741
STAT,1846,52,50-100,1898,0.010591845086447761
STAT,1839,40,15-19,1879,0.010941452262299485
SIM,1851,21,30-34,1872,18
STAT,1872,54,20-24,1926,6.804556608389999E-4
STAT,1867,47,45-49,1914,0.20835619662476618
STAT,1888,13,na,1901,2877.639144154657
SIM,1840,21,20-24,1861,60
STAT,1949,18,40-44,1967,1.536415873850723
STAT,1887,71,na,1958,1497.3165975169356
SIM,1921,17,15-19,1938,45
SIM,1883,4,na,1887,2527
SIM,1918,9,na,1927,4062
STAT,1842,47,40-44,1889,0.12193404535100807
STAT,1896,39,15-19,1935,0.0694051452763454
SIM,1940,7,na,1947,3648
SIM,1928,19,25-29,1947,51
STAT,1911,35,15-19,1946,0.017684553301615533
SIM,1812,75,na,1887,395
SIM,1833,42,40-44,1875,4
STAT,1889,20,50-100,1909,0.478432205699718
STAT,1911,22,35-39,1933,8.434244389525386
SIM,1790,89,na,1879,27
STAT,1852,33,40-44,1885,3.3762526766280634
STAT,1827,53,35-39,1880,0.007138366510549168
STAT,1835,46,50-100,1881,0.16360626215890334
STAT,1872,83,na,1955,376.4239839912236
SIM,1860,33,40-44,1893,2
SIM,1915,46,na,1961,3479
STAT,1899,33,30-34,1932,22.508198215845457
STAT,1828,38,20-24,1866,0.7159617460337478
STAT,1895,41,50-100,1936,0.090850111375934
SIM,1825,93,na,1918,7
STAT,1901,28,15-19,1929,0.5978132135230954
STAT,1836,47,45-49,1883,0.155964235495196
STAT,1956,16,25-29,1972,54.17994215661182
STAT,1892,33,40-44,1925,5.108714911269825
SIM,1891,26,25-29,1917,46
STAT,1847,29,25-29,1876,36.87526326810497
STAT,1833,50,50-100,1883,0.00985354853976856
STAT,1845,42,50-100,1887,0.7577766464345204
SIM,1862,48,50-100,1910,2
SIM,1823,36,25-29,1859,1
STAT,1871,45,45-49,1916,0.22322777169555716
SIM,1911,31,40-44,1942,4
STAT,1838,45,25-29,1883,0.04146567904152212
STAT,1877,15,45-49,1892,0.064334284765071
STAT,1868,54,35-39,1922,0.007551636513135939
STAT,1817,50,35-39,1867,0.019202179865583136
STAT,1845,52,40-44,1897,0.007376003524314976
STAT,1862,37,15-19,1899,0.045251470319626154
STAT,1865,3,na,1868,2746.501700771162
STAT,1830,26,15-19,1856,0.4787144870342013
STAT,1878,29,25-29,1907,41.30410587989903
SIM,1866,35,35-39,1901,13
SIM,1878,43,na,1921,2321
STAT,1857,58,na,1915,1472.817259281015
STAT,1948,21,15-19,1969,5.776329842696766
STAT,1816,53,25-29,1869,0.008751236229682957
STAT,1895,29,20-24,1924,14.35916424257803
STAT,1927,21,50-100,1948,0.7682472299987642
STAT,1867,26,45-49,1893,0.9882191135958592
SIM,1841,63,na,1904,1229
STAT,1861,32,na,1893,1872.005323217412
STAT,1898,12,na,1910,3302.582225217288
STAT,1882,47,40-44,1929,0.15664191873436373
SIM,1841,55,na,1896,1454
SIM,1870,35,20-24,1905,3
SIM,1898,28,35-39,1926,14
SIM,1844,32,45-49,1876,2
STAT,1856,106,na,1962,0.035402440319856184
SIM,1855,29,25-29,1884,44
STAT,1920,40,50-100,1960,0.12291955042671983
SIM,1882,17,na,1899,2317
STAT,1830,71,na,1901,797.3451162875431
STAT,1883,26,25-29,1909,39.29990001016544
STAT,1919,32,50-100,1951,0.842680148202857
SIM,1822,40,45-49,1862,4
STAT,1892,31,20-24,1923,3.2108048151378
STAT,1893,16,40-44,1909,0.2197689689168754
SIM,1908,25,35-39,1933,13
SIM,1860,3,na,1863,2637
STAT,1879,15,45-49,1894,0.06480122055583845
STAT,1905,8,na,1913,3548.7846376910525
SIM,1881,22,20-24,1903,62
STAT,1860,24,35-39,1884,4.552410364645661
SIM,1824,35,25-29,1859,2
SIM,1905,36,na,1941,3253
STAT,1881,31,45-49,1912,1.5971171776183422
STAT,1903,31,40-44,1934,5.8525100408989985
SIM,1834,25,40-44,1859,2
SIM,1912,32,na,1944,3355
STAT,1816,39,40-44,1855,15.145341612917816
SIM,1824,39,40-44,1863,6
STAT,1893,37,45-49,1930,2.3894250919695015
STAT,1913,49,40-44,1962,0.1444897745605877
STAT,1840,27,15-19,1867,0.3939635124772866
STAT,1804,54,45-49,1858,0.04145948139029622
SIM,1864,91,na,1955,46
STAT,1853,45,20-24,1898,0.008988016475838941
SIM,1876,36,35-39,1912,15
SIM,1927,32,50-100,1959,4
STAT,1862,19,15-19,1881,4.925669760893498
STAT,1836,32,45-49,1868,1.3919335295215873
STAT,1922,50,na,1972,3951.4176707639895
SIM,1878,32,na,1910,2407
STAT,1814,40,45-49,1854,5.045379381217399
SIM,1870,19,15-19,1889,5
SIM,1917,30,30-34,1947,20
STAT,1831,53,20-24,1884,4.679136366897729E-4
STAT,1806,49,25-29,1855,0.1647717685596891
STAT,1892,35,na,1927,2813.606758361838
STAT,1906,45,50-100,1951,0.19247525549894798
STAT,1926,24,50-100,1950,0.750534457086458
SIM,1835,20,35-39,1855,5
STAT,1882,28,na,1910,2186.08943914837
STAT,1926,33,35-39,1959,10.433490197201815
SIM,1853,34,40-44,1887,3
SIM,1896,15,20-24,1911,22
STAT,1855,38,15-19,1893,0.03957346387473989
STAT,1938,16,50-100,1954,0.34995250988562865
STAT,1825,40,20-24,1865,0.18546362899014218
STAT,1863,98,na,1961,6.451217649451946
SIM,1847,40,na,1887,1675
STAT,1824,109,na,1933,3.7560641997973925E-4
SIM,1776,82,na,1858,141
STAT,1832,54,20-24,1886,4.4728990424918434E-4
STAT,1847,47,20-24,1894,0.00878830132635671
STAT,1883,48,40-44,1931,0.15651678519103962
SIM,1906,30,20-24,1936,3
STAT,1862,73,na,1935,957.13602717457
SIM,1892,41,35-39,1933,4
STAT,1876,50,40-44,1926,0.010414690222502514
STAT,1886,86,na,1972,534.0436649566057
SIM,1827,37,na,1864,1535
STAT,1829,33,15-19,1862,0.13538424103093893
STAT,1849,27,35-39,1876,8.244332978733562
SIM,1886,29,25-29,1915,50
STAT,1840,30,45-49,1870,1.5102031862483418
STAT,1851,32,40-44,1883,3.310003110417901
SIM,1846,55,na,1901,1443
SIM,1857,27,35-39,1884,9
SIM,1906,21,na,1927,3325
STAT,1884,41,35-39,1925,1.6981155495111893
SIM,1855,32,20-24,1887,2
STAT,1938,34,na,1972,3587.49050163759
STAT,1956,5,na,1961,4914.370709165513
SIM,1892,22,30-34,1914,30
SIM,1914,21,15-19,1935,5
SIM,1850,25,25-29,1875,41
STAT,1864,35,25-29,1899,2.454024072744792
SIM,1775,89,na,1864,36
SIM,1863,23,15-19,1886,2
STAT,1888,15,20-24,1903,19.877146109238446
SIM,1875,29,45-49,1904,3
STAT,1881,32,na,1913,2176.6592542053495
SIM,1825,31,30-34,1856,20
STAT,1822,103,na,1925,0.07413023606650403
SIM,1864,37,25-29,1901,3
STAT,1928,28,15-19,1956,0.8213124255400468
STAT,1842,43,25-29,1885,0.46709141335669924
STAT,1823,110,na,1933,1.4541962897986348E-4
STAT,1928,31,45-49,1959,1.8600287218328277
SIM,1903,21,35-39,1924,8
SIM,1934,33,35-39,1967,14
SIM,1939,3,na,1942,3763
STAT,1863,50,35-39,1913,0.007251814971962181
STAT,1928,27,na,1955,4360.400108725452
SIM,1894,20,40-44,1914,1
SIM,1819,38,25-29,1857,2
SIM,1901,19,20-24,1920,29
STAT,1853,25,35-39,1878,8.409915959415988
STAT,1824,48,35-39,1872,0.16221173218755608
STAT,1839,38,30-34,1877,4.2027453845422285
STAT,1833,31,15-19,1864,0.11286292946984885
STAT,1904,54,na,1958,2891.5439179513164
SIM,1861,25,35-39,1886,8
STAT,1862,37,45-49,1899,1.606427005303271
STAT,1940,16,na,1956,3531.1573574613544
STAT,1850,40,na,1890,1643.536356907734
STAT,1854,41,50-100,1895,0.7641870952868922
STAT,1886,20,40-44,1906,2.092309796746587
STAT,1830,41,40-44,1871,1.7346007240436918
STAT,1891,39,35-39,1930,8.187176595804429
SIM,1830,71,na,1901,842
STAT,1897,27,na,1924,3015.170133269911
SIM,1847,38,30-34,1885,4
SIM,1940,13,na,1953,3620
SIM,1906,32,na,1938,3361
STAT,1829,48,15-19,1877,3.1856660127232143E-4
STAT,1862,22,45-49,1884,0.5752395388898951
STAT,1823,78,na,1901,411.1670358813881
STAT,1855,23,15-19,1878,2.7100017893857933
STAT,1809,63,na,1872,940.2112283868864
STAT,1849,45,35-39,1894,0.10191675272384872
SIM,1835,35,35-39,1870,9
STAT,1844,41,35-39,1885,1.3187162411904372
STAT,1888,4,na,1892,2935.874237643048
SIM,1871,15,20-24,1886,20
STAT,1842,25,25-29,1867,37.792813008243314
STAT,1918,24,40-44,1942,3.4043016887918056
SIM,1934,15,35-39,1949,6
STAT,1854,84,na,1938,239.5488441377533
STAT,1894,26,35-39,1920,11.76581243582977
SIM,1878,34,45-49,1912,1
STAT,1829,33,45-49,1862,1.6578182733244329
SIM,1896,33,20-24,1929,4
SIM,1855,0,na,1855,3028
STAT,1888,33,20-24,1921,3.0039107834796956
SIM,1833,37,na,1870,1595
STAT,1906,21,15-19,1927,4.551868466033689
STAT,1852,15,40-44,1867,0.1700700460009876
STAT,1874,32,15-19,1906,0.13749909943240304
STAT,1922,3,na,1925,4434.840318479368
STAT,1819,44,40-44,1863,4.129847472584664
STAT,1880,18,20-24,1898,17.57596227364062
STAT,1902,30,50-100,1932,1.2313095845930224
STAT,1891,20,15-19,1911,3.880587448437802
SIM,1894,35,40-44,1929,5
SIM,1936,31,45-49,1967,1
SIM,1782,82,na,1864,123
SIM,1947,19,30-34,1966,13
STAT,1853,43,35-39,1896,1.3332127742018587
STAT,1886,35,40-44,1921,4.41078697076443
SIM,1824,63,na,1887,944
STAT,1896,42,45-49,1938,0.12959990295263446
STAT,1896,24,15-19,1920,4.093152493261222
STAT,1828,92,na,1920,23.643393510827906
STAT,1865,49,35-39,1914,0.11767296272180776
SIM,1851,40,35-39,1891,3
STAT,1866,46,45-49,1912,0.2061370165152299
STAT,1827,35,35-39,1862,7.429179861973904
SIM,1938,26,25-29,1964,69
STAT,1863,15,20-24,1878,16.998858755965852
SIM,1850,29,45-49,1879,1
STAT,1834,52,30-34,1886,0.0037779947649180224
STAT,1866,41,20-24,1907,0.13895029450521582
STAT,1905,39,na,1944,3209.02797371436
STAT,1888,48,20-24,1936,0.007459352609589788
SIM,1926,24,40-44,1950,3
SIM,1872,58,na,1930,1879
SIM,1898,49,na,1947,2788
STAT,1939,19,30-34,1958,11.516900768440554
SIM,1849,36,40-44,1885,4
STAT,1884,22,30-34,1906,16.62847379955562
STAT,1826,66,na,1892,894.5998281448924
SIM,1937,16,na,1953,3273
STAT,1905,10,na,1915,3536.1975861841715
SIM,1762,100,na,1862,1
STAT,1829,51,45-49,1880,0.01153896741663739
STAT,1810,82,na,1892,211.29037392231356
STAT,1842,29,45-49,1871,0.9637799643691854
STAT,1895,41,45-49,1936,0.12870432481805863
STAT,1947,15,50-100,1962,0.3989289391500154
SIM,1793,74,na,1867,380
SIM,1827,44,40-44,1871,7
STAT,1926,15,35-39,1941,4.883292255064112
SIM,1789,92,na,1881,7
SIM,1962,3,na,1965,4682
STAT,1836,99,na,1935,1.1959562505686985
STAT,1916,39,15-19,1955,0.01839011971344493
STAT,1918,42,40-44,1960,0.2512229935361452
STAT,1844,40,na,1884,1704.8517667908718
STAT,1865,40,20-24,1905,0.1377078682093598
SIM,1884,83,na,1967,567
STAT,1828,50,45-49,1878,0.012281157024656045
STAT,1799,62,na,1861,912.9011881823051
STAT,1827,32,50-100,1859,1.0661552955823888
SIM,1926,42,40-44,1968,1
STAT,1786,75,na,1861,383.6736750738928
STAT,1898,34,25-29,1932,12.986374002010267
STAT,1871,56,na,1927,1910.2058822979513
STAT,1904,38,40-44,1942,1.27374926437279
STAT,1877,42,40-44,1919,2.2022885739725067
STAT,1910,49,20-24,1959,0.009680511546287846
STAT,1822,36,30-34,1858,10.152248008523333
STAT,1842,29,50-100,1871,0.5552742266451104
STAT,1875,46,na,1921,2189.755537459903
STAT,1958,6,na,1964,4876.726900729893
SIM,1907,30,35-39,1937,9
STAT,1894,49,25-29,1943,0.038659565497668046
STAT,1900,72,na,1972,2071.846475169559
SIM,1806,75,na,1881,384
SIM,1931,25,30-34,1956,55
STAT,1837,92,na,1929,26.291513449174474
SIM,1912,47,50-100,1959,1
STAT,1894,41,30-34,1935,1.403421679296945
STAT,1853,35,50-100,1888,0.9296101989978417
STAT,1896,46,25-29,1942,0.04068148075644688
STAT,1856,99,na,1955,1.4012608294806363
STAT,1861,41,35-39,1902,1.426968758264729
STAT,1819,46,50-100,1865,0.44328660373887135
STAT,1858,16,25-29,1874,4.9382976855765515
STAT,1844,45,50-100,1889,0.17513240376720907
STAT,1861,35,40-44,1896,3.466662362530269
STAT,1957,15,30-34,1972,15.187294098219859
SIM,1894,35,45-49,1929,3
STAT,1914,41,25-29,1955,0.06692961944588792
STAT,1847,37,na,1884,1798.5848074103358
STAT,1835,52,45-49,1887,0.009227837762721307
SIM,1920,28,20-24,1948,16
STAT,1921,37,30-34,1958,1.9226616055971788
SIM,1821,66,na,1887,889
SIM,1889,19,30-34,1908,2
STAT,1884,47,45-49,1931,0.2192882522438825
STAT,1935,2,na,1937,5281.578556241585
SIM,1801,100,na,1901,1
SIM,1898,63,na,1961,2404
STAT,1846,17,45-49,1863,0.057857018158058854
STAT,1811,48,20-24,1859,0.039272835030225044
SIM,1948,18,35-39,1966,7
STAT,1846,52,20-24,1898,5.17516881391203E-4
STAT,1905,41,15-19,1946,0.0013150843450802933
SIM,1827,44,45-49,1871,2
STAT,1837,40,45-49,1877,1.1437929439779946
SIM,1814,41,50-100,1855,3
STAT,1856,19,25-29,1875,4.899457031769699
SIM,1830,94,na,1924,5
SIM,1864,19,25-29,1883,7
SIM,1926,24,na,1950,4033
STAT,1941,23,25-29,1964,90.14015812462989
SIM,1885,26,35-39,1911,11
STAT,1886,35,45-49,1921,2.008644098147801
SIM,1789,78,na,1867,278
STAT,1894,39,na,1933,2834.216058768778
STAT,1903,16,45-49,1919,0.08801123339232461
STAT,1771,114,na,1885,2.0825779649663256E-4
STAT,1889,41,20-24,1930,0.1860572660520846
SIM,1830,36,30-34,1866,9
STAT,1873,40,15-19,1913,0.013375980804253026
STAT,1906,17,40-44,1923,0.2516031040652547
SIM,1834,84,na,1918,193
SIM,1905,35,30-34,1940,1
STAT,1831,29,35-39,1860,8.099820950340382
STAT,1826,69,na,1895,801.0103323114009
STAT,1914,16,20-24,1930,26.5541258939338
SIM,1872,35,25-29,1907,4
STAT,1858,54,na,1912,1552.9405238789898
STAT,1879,18,50-100,1897,0.04824940723576725
STAT,1878,48,30-34,1926,0.09400203574911209
SIM,1847,57,na,1904,1430
STAT,1849,23,20-24,1872,59.62313774372116
STAT,1868,51,30-34,1919,0.0053947518592254474
SIM,1828,27,45-49,1855,4
SIM,1844,29,na,1873,1887
SIM,1875,23,40-44,1898,4
STAT,1905,16,na,1921,3456.3128663643342
STAT,1842,17,50-100,1859,0.04480043441418204
STAT,1863,30,45-49,1893,1.459733618061067
SIM,1912,30,45-49,1942,1
SIM,1890,24,20-24,1914,74
STAT,1767,100,na,1867,0.14890304814946487
STAT,1812,100,na,1912,0.45661175915259483
STAT,1867,37,na,1904,2089.752883786792
STAT,1854,64,na,1918,1251.7818569179817
STAT,1880,36,20-24,1916,0.7699104494954749
STAT,1805,81,na,1886,213.9674944884506
STAT,1882,24,20-24,1906,62.95124654457321
STAT,1912,28,20-24,1940,16.929863693661268
SIM,1910,42,45-49,1952,1
STAT,1850,53,25-29,1903,0.002453548094127139
STAT,1901,46,45-49,1947,0.1765274460457749
STAT,1925,30,na,1955,4248.107248702779
SIM,1865,33,25-29,1898,12
SIM,1922,16,20-24,1938,134
STAT,1813,45,20-24,1858,0.03755275320496992
SIM,1855,103,na,1958,1
SIM,1841,66,na,1907,1132
SIM,1867,71,na,1938,1124
STAT,1920,31,40-44,1951,4.066125725137755
SIM,1838,29,25-29,1867,31
STAT,1834,53,40-44,1887,0.0065507138187849675
SIM,1916,14,na,1930,3857
STAT,1827,50,30-34,1877,0.005238298489654748
STAT,1852,83,na,1935,301.6197410632866
STAT,1877,9,na,1886,2591.49227568006
SIM,1829,32,na,1861,1631
STAT,1807,62,na,1869,934.0767529939471
STAT,1940,22,50-100,1962,0.6331605434162492
STAT,1881,32,20-24,1913,2.4655787543311254
SIM,1914,17,40-44,1931,1
STAT,1843,51,25-29,1894,0.0025676309170405785
STAT,1857,33,25-29,1890,7.595996572535242
STAT,1895,40,35-39,1935,2.254896270426568
SIM,1894,45,50-100,1939,1
SIM,1866,16,25-29,1882,6
SIM,1938,23,na,1961,3355
SIM,1939,25,30-34,1964,41
STAT,1889,25,15-19,1914,0.5327304341596665
STAT,1903,1,na,1904,3658.2785224947906
STAT,1870,32,45-49,1902,1.6142030024674252
STAT,1893,34,50-100,1927,1.0888240161367941
SIM,1845,24,40-44,1869,2
SIM,1823,67,na,1890,796
STAT,1960,3,na,1963,4838.863435268671
STAT,1862,38,25-29,1900,2.3086579881423406
STAT,1932,30,20-24,1962,3.0667135987227154
STAT,1829,97,na,1926,3.2929086258665636
STAT,1902,42,45-49,1944,0.13838319092793416
SIM,1906,31,30-34,1937,22
STAT,1867,23,40-44,1890,1.8426280743218353
SIM,1870,38,25-29,1908,2
SIM,1840,39,na,1879,1684
STAT,1782,101,na,1883,0.12216071935535718
STAT,1835,45,40-44,1880,0.12693977890532335
STAT,1837,24,40-44,1861,1.6973942973190606
SIM,1881,18,15-19,1899,3
STAT,1862,28,na,1890,1916.3812231162517
STAT,1873,18,15-19,1891,5.675780548474762
STAT,1887,18,45-49,1905,0.06883218529945119
STAT,1930,42,20-24,1972,0.021952582785716913
STAT,1876,53,45-49,1929,0.013926063559274634
SIM,1850,49,na,1899,1614
STAT,1859,53,45-49,1912,0.01076559140769232
SIM,1851,96,na,1947,4
STAT,1848,24,15-19,1872,2.8524621526361
SIM,1854,39,na,1893,1817
STAT,1884,29,na,1913,2211.9909158819405
STAT,1814,41,20-24,1855,0.5174143701592925
STAT,1843,46,45-49,1889,0.17165486067076277
SIM,1917,22,45-49,1939,2
STAT,1788,84,na,1872,105.41534180767606
SIM,1924,43,na,1967,4126
STAT,1886,6,na,1892,2607.456913631153
STAT,1852,49,20-24,1901,0.008926906902087105
STAT,1915,33,25-29,1948,8.854290065893986
STAT,1859,45,50-100,1904,0.1870098723134589
STAT,1904,45,15-19,1949,3.0874059590298007E-4
STAT,1947,25,15-19,1972,0.75519591200174
STAT,1810,51,30-34,1861,0.020612991901477973
SIM,1917,41,na,1958,3618
STAT,1913,42,20-24,1955,0.016265900343299517
SIM,1910,29,na,1939,3323
SIM,1800,64,na,1864,845
STAT,1904,30,45-49,1934,2.381561287408324
STAT,1819,87,na,1906,87.98239118512632
STAT,1899,15,30-34,1914,2.0730319198838956
SIM,1923,33,25-29,1956,12
SIM,1865,76,na,1941,752
STAT,1890,25,25-29,1915,49.19076125254181
STAT,1862,31,40-44,1893,3.508971737146748
SIM,1793,77,na,1870,295
SIM,1858,46,50-100,1904,2
SIM,1882,88,na,1970,320
SIM,1856,24,15-19,1880,2
SIM,1834,39,na,1873,1563
STAT,1838,20,40-44,1858,1.8706778518732265
STAT,1834,30,na,1864,1754.3068733646014
STAT,1899,2,na,1901,3450.9992662204872
STAT,1909,22,45-49,1931,0.9876535322027957
SIM,1902,41,40-44,1943,2
SIM,1823,47,na,1870,1327
STAT,1879,41,50-100,1920,1.047894603438951
STAT,1918,27,45-49,1945,1.736835527460074
SIM,1877,16,na,1893,2477
STAT,1913,43,30-34,1956,0.11756492570193032
STAT,1892,58,na,1950,2339.5112421974977
STAT,1930,35,15-19,1965,0.023705108796480696
STAT,1823,34,25-29,1857,20.36050126804709
STAT,1946,20,50-100,1966,0.6922201682229218
SIM,1831,34,25-29,1865,4
SIM,1908,4,na,1912,3595
STAT,1820,40,35-39,1860,3.47240406939932
STAT,1831,43,15-19,1874,0.010379612688231402
SIM,1819,93,na,1912,6
SIM,1846,20,40-44,1866,1
STAT,1890,23,na,1913,2723.254091658868
STAT,1819,44,45-49,1863,2.747949160814862
SIM,1857,23,20-24,1880,41
SIM,1858,6,na,1864,2338
STAT,1777,92,na,1869,10.027301586607543
SIM,1926,27,45-49,1953,3
STAT,1895,47,20-24,1942,0.008305917289611772
SIM,1898,24,20-24,1922,80
STAT,1907,24,35-39,1931,8.045850548761004
STAT,1805,53,na,1858,1137.5069102790876
STAT,1869,31,25-29,1900,9.404490536663447
STAT,1910,42,35-39,1952,0.17972941228695305
SIM,1799,68,na,1867,690
SIM,1869,29,50-100,1898,2
SIM,1924,29,na,1953,4037
SIM,1929,28,40-44,1957,5
SIM,1953,6,na,1959,4370
SIM,1877,87,na,1964,271
SIM,1892,35,50-100,1927,4
STAT,1853,23,50-100,1876,0.35475704934818914
SIM,1909,12,na,1921,3637
SIM,1843,67,na,1910,1104
STAT,1924,24,35-39,1948,10.431448111495792
SIM,1883,7,na,1890,2470
SIM,1858,22,25-29,1880,50
STAT,1828,106,na,1934,0.006892552021803442
STAT,1899,30,25-29,1929,13.36680102298519
STAT,1881,66,na,1947,1495.0132329391697
STAT,1840,34,25-29,1874,8.509522691115809
STAT,1879,21,40-44,1900,2.063831831804921
STAT,1885,43,45-49,1928,1.3984313834188569
STAT,1876,46,40-44,1922,0.16743776505074964
STAT,1923,25,30-34,1948,42.78997417976632
SIM,1829,52,na,1881,1267
STAT,1848,40,20-24,1888,0.1172376568962044
SIM,1882,17,20-24,1899,14
STAT,1883,75,na,1958,1046.9380456282827
STAT,1930,37,na,1967,4636.127905658953
STAT,1837,47,30-34,1884,0.0634329933463399
STAT,1874,17,20-24,1891,17.117456077235293
STAT,1913,35,15-19,1948,0.018068784911671902
SIM,1915,24,35-39,1939,12
SIM,1877,31,25-29,1908,16
STAT,1812,63,na,1875,931.2542004866855
SIM,1874,59,na,1933,1814
SIM,1930,33,30-34,1963,19
STAT,1887,57,na,1944,2123.1681638585887
STAT,1860,42,30-34,1902,0.881582197291009
STAT,1872,44,15-19,1916,0.01291776093778427
STAT,1865,9,na,1874,2368.350329314053
SIM,1887,21,40-44,1908,3
SIM,1814,84,na,1898,129
STAT,1825,81,na,1906,305.74507381407483
STAT,1868,35,50-100,1903,1.1179128475803222
STAT,1818,52,45-49,1870,0.02973725572133804
SIM,1863,67,na,1930,1346
STAT,1801,91,na,1892,22.050280404004525
STAT,1778,113,na,1891,2.6589487700003826E-4
SIM,1906,18,30-34,1924,1
STAT,1846,89,na,1935,74.07034468600706
STAT,1861,66,na,1927,1285.7652041473673
STAT,1879,46,25-29,1925,0.057037569165086226
STAT,1898,29,na,1927,3030.1373375989547
STAT,1875,54,40-44,1929,0.009936510051155421
STAT,1909,32,50-100,1941,0.745154989540198
SIM,1932,24,35-39,1956,15
STAT,1816,45,na,1861,1423.1420915902563
STAT,1780,107,na,1887,0.00691326293623939
STAT,1853,40,30-34,1893,0.8612060382742722
STAT,1922,33,30-34,1955,16.747085400092004
STAT,1923,49,50-100,1972,0.24851401083952462
STAT,1952,18,na,1970,4165.779489322786
SIM,1771,96,na,1867,1
STAT,1862,15,35-39,1877,0.512436998283454
STAT,1813,62,na,1875,956.4684190333902
SIM,1864,18,15-19,1882,6
STAT,1840,19,na,1859,2045.4218427436103
STAT,1931,26,35-39,1957,18.319801871327943
SIM,1938,29,30-34,1967,38
STAT,1797,67,na,1864,742.5381059863549
STAT,1882,30,15-19,1912,0.1319605234671469
STAT,1919,30,na,1949,3885.7091093538043
STAT,1921,38,40-44,1959,1.5776026369174612
SIM,1836,30,25-29,1866,13
STAT,1919,41,45-49,1960,0.17062764356864485
STAT,1927,17,na,1944,4323.946576257623
SIM,1917,1,na,1918,4121
STAT,1822,39,35-39,1861,11.546133971074102
STAT,1835,51,35-39,1886,0.005583636158379406
STAT,1854,24,40-44,1878,1.7378533089835686
SIM,1869,58,na,1927,1784
STAT,1820,34,40-44,1854,13.364639890095544
STAT,1827,51,40-44,1878,0.009082469535101898
STAT,1877,49,25-29,1926,0.05528728506431651
STAT,1944,17,45-49,1961,0.5078389953144041
STAT,1815,52,50-100,1867,0.035126904493879424
STAT,1894,42,40-44,1936,0.18957682544171622
SIM,1882,30,20-24,1912,2
SIM,1932,38,na,1970,4638
SIM,1778,86,na,1864,64
STAT,1900,20,30-34,1920,23.483878847508613
STAT,1941,20,20-24,1961,108.62183584043964
STAT,1832,33,20-24,1865,2.1162883568085538
STAT,1850,50,20-24,1900,5.269623473542925E-4
STAT,1836,45,na,1881,1525.4046978570177
STAT,1908,26,50-100,1934,0.8993044186863058
SIM,1952,17,45-49,1969,1
STAT,1856,18,15-19,1874,5.161417133905778
SIM,1844,60,na,1904,1333
SIM,1818,47,50-100,1865,2
STAT,1887,15,40-44,1902,0.1941342498980217
STAT,1907,11,na,1918,3588.4931521260664
SIM,1867,31,35-39,1898,10
SIM,1868,42,40-44,1910,7
STAT,1831,34,50-100,1865,0.7332543684141606
STAT,1874,30,20-24,1904,2.630867102718685
STAT,1929,27,20-24,1956,21.583069608948644
SIM,1892,44,40-44,1936,2
STAT,1940,25,30-34,1965,37.77479043377556
SIM,1901,46,na,1947,3019
STAT,1926,36,50-100,1962,0.4852368366885059
STAT,1900,22,25-29,1922,75.02549905073089
SIM,1922,19,25-29,1941,58
STAT,1885,4,na,1889,2614.469876714516
SIM,1867,57,na,1924,1736
STAT,1878,74,na,1952,1091.4243748474594
SIM,1871,30,45-49,1901,1
STAT,1859,31,35-39,1890,7.666245254156689
STAT,1864,28,15-19,1892,0.3817175458276569
STAT,1937,22,20-24,1959,102.27900690730588
STAT,1927,39,20-24,1966,0.3089944897830179
STAT,1895,21,25-29,1916,70.78544200750615
STAT,1914,19,25-29,1933,8.421530456298491
STAT,1805,51,20-24,1856,0.0021966515178004323
STAT,1884,44,40-44,1928,2.0714451368342597
STAT,1872,42,20-24,1914,0.15040148584220828
STAT,1828,30,25-29,1858,11.865112633568556
SIM,1849,52,na,1901,1610
SIM,1845,27,45-49,1872,1
SIM,1906,15,25-29,1921,9
STAT,1875,27,50-100,1902,0.6208457858966864
STAT,1895,48,30-34,1943,0.06646907521110186
SIM,1827,51,na,1878,1272
STAT,1849,63,na,1912,1286.110137401847
STAT,1836,44,45-49,1880,1.0958833893548798
SIM,1823,92,na,1915,16
SIM,1867,36,50-100,1903,3
SIM,1921,28,40-44,1949,5
SIM,1840,33,20-24,1873,1
STAT,1860,43,40-44,1903,1.714428520895304
STAT,1913,28,40-44,1941,4.370998855515084
STAT,1857,52,50-100,1909,0.01118790668513198
STAT,1809,97,na,1906,2.256784853099613
STAT,1936,22,na,1958,3297.61784169404
SIM,1862,24,40-44,1886,1
STAT,1852,45,40-44,1897,0.1313697979837883
SIM,1844,44,45-49,1888,1
SIM,1895,21,na,1916,2995
SIM,1931,31,25-29,1962,10
SIM,1859,36,35-39,1895,14
STAT,1837,27,45-49,1864,0.8996125072340768
SIM,1865,52,50-100,1917,1
STAT,1933,30,50-100,1963,1.0537877862595588
SIM,1881,29,50-100,1910,1
SIM,1824,32,25-29,1856,9
STAT,1837,21,na,1858,1779.637066072315
SIM,1830,39,35-39,1869,11
STAT,1864,18,50-100,1882,0.042538487784536165
STAT,1915,40,na,1955,3541.7608800401367
STAT,1883,23,25-29,1906,52.83805343370653
SIM,1830,49,na,1879,1514
SIM,1857,81,na,1938,369
STAT,1931,41,25-29,1972,0.09025327853225258
SIM,1874,23,20-24,1897,64
STAT,1947,18,40-44,1965,1.4880694903323393
STAT,1802,103,na,1905,0.048958364927871215
SIM,1893,18,40-44,1911,1
STAT,1878,40,35-39,1918,1.798818797218365
STAT,1955,17,20-24,1972,170.01125060263237
STAT,1853,41,40-44,1894,1.6756282503224778
STAT,1855,18,na,1873,1922.2387741458715
STAT,1918,34,na,1952,3764.085208399886
STAT,1885,18,40-44,1903,0.17169356453125945
STAT,1923,35,40-44,1958,1.641591108692589
SIM,1931,35,40-44,1966,1
SIM,1824,94,na,1918,8
SIM,1862,20,25-29,1882,49
SIM,1865,90,na,1955,56
STAT,1848,27,20-24,1875,10.089629398349723
STAT,1923,31,25-29,1954,10.051544720964754
SIM,1903,28,20-24,1931,13
SIM,1891,23,25-29,1914,73
SIM,1795,78,na,1873,302
STAT,1876,52,35-39,1928,0.008351335062170133
SIM,1856,27,20-24,1883,13
STAT,1839,87,na,1926,117.47243196218166
STAT,1836,48,25-29,1884,0.03758126874423806
STAT,1901,43,40-44,1944,0.20504176970419338
STAT,1864,41,50-100,1905,0.8960096696699289
SIM,1851,43,40-44,1894,7
STAT,1866,23,20-24,1889,60.07763565085256
SIM,1834,22,40-44,1856,2
STAT,1853,37,na,1890,1747.2111220770696
STAT,1831,26,30-34,1857,22.751123038709846
STAT,1913,45,25-29,1958,0.049130155841710495
SIM,1953,0,na,1953,4521
STAT,1842,28,na,1870,1891.3706075420212
SIM,1836,34,40-44,1870,6
STAT,1769,100,na,1869,0.1770876044467411
STAT,1838,23,45-49,1861,0.6126123976784902
SIM,1881,86,na,1967,341
SIM,1923,30,20-24,1953,2
STAT,1899,18,35-39,1917,0.7085050888858759
SIM,1853,31,40-44,1884,4
SIM,1892,78,na,1970,1281
STAT,1895,25,40-44,1920,3.7179845922475985
STAT,1932,33,25-29,1965,11.600264546707539
SIM,1933,34,na,1967,4826
SIM,1886,41,45-49,1927,7
STAT,1838,38,15-19,1876,0.04573693054656134
STAT,1831,36,na,1867,1659.4726716914465
STAT,1847,44,20-24,1891,0.11527554050169864
STAT,1907,49,15-19,1956,3.0816973297319094E-4
SIM,1831,42,na,1873,1537
STAT,1951,17,50-100,1968,0.4214914678184061
STAT,1783,111,na,1894,1.544780484652993E-4
SIM,1914,24,15-19,1938,5
STAT,1824,88,na,1912,72.47718071127221
STAT,1886,45,50-100,1931,0.24758322486105805
STAT,1831,41,20-24,1872,0.12257457274991986
STAT,1911,48,25-29,1959,0.04729828231569825
STAT,1859,50,40-44,1909,0.008051112153547453
STAT,1867,51,na,1918,1918.9987380074026
SIM,1927,23,15-19,1950,9
STAT,1854,20,25-29,1874,49.13776174241935
SIM,1852,20,35-39,1872,9
STAT,1925,20,35-39,1945,10.712292047103313
STAT,1816,90,na,1906,36.739435876671806
SIM,1865,48,na,1913,1908
STAT,1877,27,na,1904,2339.5492501310514
STAT,1878,41,45-49,1919,1.4785344456333989
STAT,1915,18,50-100,1933,0.0738756789211515
STAT,1850,31,15-19,1881,0.10597181480844806
STAT,1900,29,40-44,1929,3.897895141771491
SIM,1886,40,35-39,1926,2
STAT,1924,40,50-100,1964,0.1323889698237343
STAT,1876,93,na,1969,111.83652951239378
SIM,1856,85,na,1941,167
SIM,1897,28,20-24,1925,15
STAT,1888,19,na,1907,2803.4865044183475
STAT,1899,17,25-29,1916,7.336222984956953
STAT,1915,30,20-24,1945,2.365442519266708
STAT,1915,40,30-34,1955,0.12191918108163148
SIM,1777,81,na,1858,147
SIM,1919,32,20-24,1951,2
STAT,1828,34,40-44,1862,4.352773519970641
SIM,1923,31,30-34,1954,26
STAT,1932,32,na,1964,4749.73391260819
STAT,1844,20,35-39,1864,5.189070408194606
SIM,1850,22,25-29,1872,45
STAT,1773,88,na,1861,30.242551140307974
STAT,1911,47,15-19,1958,3.2937568465950435E-4
STAT,1849,18,na,1867,2024.6040205788172
STAT,1919,23,15-19,1942,5.489572308031916
STAT,1773,114,na,1887,2.1094709037452306E-4
STAT,1841,49,45-49,1890,0.15809785849999222
STAT,1804,88,na,1892,46.522542380198
STAT,1858,32,50-100,1890,0.6795148366381667
STAT,1880,23,50-100,1903,0.4040905134859747
STAT,1854,46,20-24,1900,0.008665664823041081
STAT,1877,26,35-39,1903,9.491469196162612
SIM,1947,16,25-29,1963,51
STAT,1862,34,45-49,1896,1.3932068090896281
STAT,1882,16,50-100,1898,0.04514639662297186
STAT,1930,20,45-49,1950,1.3698980450121236
STAT,1857,27,na,1884,1830.7136704367078
STAT,1868,52,40-44,1920,0.009445147588132034
STAT,1913,9,na,1922,3831.6020585401543
STAT,1915,31,30-34,1946,15.219078078355464
STAT,1923,40,20-24,1963,0.01955559801786908
STAT,1871,33,50-100,1904,0.8544825753272938
SIM,1859,90,na,1949,65
SIM,1945,22,20-24,1967,100
STAT,1810,54,35-39,1864,0.02807052067250258
STAT,1827,82,na,1909,258.9296045043962
STAT,1854,47,30-34,1901,0.06938015234361339
SIM,1830,44,50-100,1874,1
STAT,1824,41,15-19,1865,0.01791964798985501
STAT,1882,51,50-100,1933,0.013949629396864368
STAT,1842,22,25-29,1864,51.41707923002217
SIM,1827,41,40-44,1868,3
STAT,1813,46,30-34,1859,0.297819547348748
STAT,1885,21,35-39,1906,5.5088149287872925
STAT,1869,35,40-44,1904,4.040966133598063
STAT,1822,44,50-100,1866,1.5106602757891703
STAT,1889,28,20-24,1917,13.633902358004542
SIM,1907,31,na,1938,3405
STAT,1814,64,na,1878,863.3828125535376
SIM,1838,43,na,1881,1526
STAT,1787,100,na,1887,0.2173905377450443
SIM,1933,20,35-39,1953,11
STAT,1941,21,30-34,1962,28.066120605693996
STAT,1901,26,na,1927,3166.4979678649597
SIM,1852,58,na,1910,1514
SIM,1893,40,40-44,1933,12
STAT,1844,17,40-44,1861,0.1632179443762051
STAT,1933,39,15-19,1972,0.024657302571137
STAT,1803,72,na,1875,546.4030916658529
SIM,1841,86,na,1927,112
SIM,1894,32,40-44,1926,7
STAT,1836,25,35-39,1861,7.998805644979967
STAT,1870,47,15-19,1917,3.6854127902606317E-4
STAT,1886,32,40-44,1918,4.328581478037753
STAT,1821,37,25-29,1858,6.022977414243586
STAT,1846,35,na,1881,1771.0929442363229
STAT,1819,41,40-44,1860,4.5702469320530055
SIM,1937,27,20-24,1964,15
STAT,1845,50,na,1895,1538.4460732289647
SIM,1888,17,20-24,1905,21
STAT,1890,40,15-19,1930,0.016111674835272424
SIM,1894,25,na,1919,3062
SIM,1786,95,na,1881,2
STAT,1880,37,30-34,1917,5.297591912104309
STAT,1885,76,na,1961,1069.7853040850628
STAT,1906,24,15-19,1930,4.50975762565683
STAT,1798,94,na,1892,5.543375541008299
STAT,1885,56,na,1941,1919.6614373678901
STAT,1904,23,50-100,1927,0.5507766956623817
STAT,1876,42,25-29,1918,0.625496076196126
SIM,1878,31,45-49,1909,2
SIM,1880,27,30-34,1907,26
STAT,1941,30,30-34,1971,15.643220565474317
STAT,1858,17,35-39,1875,0.475358762651162
STAT,1888,45,20-24,1933,0.013525636085576675
SIM,1841,16,20-24,1857,21
STAT,1863,17,45-49,1880,0.0618982997355646
SIM,1877,35,40-44,1912,7
SIM,1844,25,35-39,1869,8
STAT,1931,31,15-19,1962,0.1591663872770399
STAT,1829,63,na,1892,1093.686869867153
STAT,1874,84,na,1958,402.7022067705432
STAT,1891,32,15-19,1923,0.16651825076902466
STAT,1879,24,45-49,1903,0.684247201053315
STAT,1913,46,35-39,1959,0.11914967043189247
SIM,1810,74,na,1884,466
STAT,1809,51,25-29,1860,0.012530636847331503
STAT,1833,39,50-100,1872,0.9150513429963055
SIM,1849,33,40-44,1882,3
STAT,1843,78,na,1921,563.6966891537273
SIM,1913,36,35-39,1949,9
SIM,1836,34,na,1870,1646
STAT,1844,53,35-39,1897,0.0059466014858140905
STAT,1915,41,50-100,1956,0.11188483681953287
SIM,1796,71,na,1867,563
STAT,1905,36,35-39,1941,2.09411524872145
SIM,1934,19,na,1953,4645
STAT,1777,103,na,1880,0.048678130129753444
SIM,1848,18,30-34,1866,1
STAT,1870,57,na,1927,1860.2541058470235
STAT,1882,49,35-39,1931,0.1260079564186411
STAT,1931,40,15-19,1971,0.001943515726670354
STAT,1912,18,na,1930,3679.0046616459845
STAT,1897,19,15-19,1916,7.457593463005848
STAT,1910,18,45-49,1928,0.0932355041153472
STAT,1885,40,40-44,1925,2.138333007023007
STAT,1882,28,50-100,1910,0.585967382098524
SIM,1864,60,na,1924,1730
STAT,1879,43,20-24,1922,0.15568427098221893
SIM,1882,33,25-29,1915,8
STAT,1816,54,35-39,1870,0.020849042994326217
STAT,1904,47,50-100,1951,0.18682059341828902
STAT,1845,15,35-39,1860,0.49430868082351564
STAT,1865,70,na,1935,1204.4618034850046
STAT,1883,45,35-39,1928,0.13091366549603733
STAT,1875,15,na,1890,2462.585397163068
STAT,1872,45,25-29,1917,0.055160954919372104
SIM,1913,17,25-29,1930,9
STAT,1916,17,35-39,1933,0.8410086449721519
STAT,1827,54,45-49,1881,0.010735197686049849
STAT,1929,42,15-19,1971,0.0018788819212148169
SIM,1847,16,20-24,1863,18
SIM,1886,21,25-29,1907,56
STAT,1931,23,30-34,1954,35.107092854441575
STAT,1865,27,20-24,1892,10.070803761734357
STAT,1859,28,40-44,1887,2.280916451930018
SIM,1841,41,50-100,1882,3
SIM,1870,46,50-100,1916,2
SIM,1842,15,25-29,1857,8
SIM,1946,17,20-24,1963,137
STAT,1827,31,na,1858,1626.7755102886265
STAT,1905,17,25-29,1922,7.735965058698562
STAT,1894,33,45-49,1927,2.1101853422981574
SIM,1915,15,na,1930,3789
STAT,1851,107,na,1958,0.006832558499669605
STAT,1926,32,na,1958,4320.7362315889
SIM,1858,16,30-34,1874,1
STAT,1830,27,25-29,1857,41.16167108545511
STAT,1942,23,40-44,1965,3.3291605997898297
STAT,1870,40,30-34,1910,1.0749511003349952
STAT,1805,54,25-29,1859,0.009925082223936899
SIM,1909,6,na,1915,3685
STAT,1820,49,50-100,1869,0.3932491095392873
SIM,1833,29,40-44,1862,4
SIM,1893,21,35-39,1914,4
STAT,1874,33,25-29,1907,9.847823509789057
STAT,1859,53,na,1912,1597.2617332083357
SIM,1805,73,na,1878,504
SIM,1823,98,na,1921,3
STAT,1869,60,na,1929,1743.9952651879382
SIM,1895,52,na,1947,2670
STAT,1843,22,40-44,1865,1.8870434457471292
STAT,1880,17,45-49,1897,0.06493046690127222
STAT,1865,42,15-19,1907,0.011840381467753956
STAT,1920,35,20-24,1955,0.2731455204604039
SIM,1938,18,40-44,1956,1
STAT,1858,40,15-19,1898,0.010345121853972598
SIM,1826,30,35-39,1856,7
SIM,1835,42,45-49,1877,1
SIM,1879,15,20-24,1894,13
SIM,1827,46,50-100,1873,4
STAT,1900,23,35-39,1923,7.624286991965966
SIM,1885,45,na,1930,2149
STAT,1894,45,45-49,1939,0.16338738462814043
STAT,1916,25,na,1941,3683.8711427691424
STAT,1854,27,45-49,1881,0.8381606153600382
STAT,1907,21,30-34,1928,24.78856939002716
STAT,1895,15,na,1910,3128.0327846728283
SIM,1881,52,na,1933,1787
SIM,1815,80,na,1895,236
STAT,1896,62,na,1958,2348.869164157037
STAT,1918,37,na,1955,3746.0415510580237
STAT,1825,29,40-44,1854,9.869057155631733
STAT,1874,18,30-34,1892,1.5348992059271103
STAT,1811,44,40-44,1855,7.93299180356548
STAT,1853,44,45-49,1897,1.0949382416019693
SIM,1915,21,30-34,1936,26
SIM,1894,39,25-29,1933,3
SIM,1904,21,20-24,1925,105
STAT,1860,46,45-49,1906,0.18170571867570634
STAT,1939,16,25-29,1955,40.98528194410405
STAT,1826,100,na,1926,0.5794640578050554
STAT,1928,44,na,1972,4458.283836608723
STAT,1827,42,45-49,1869,1.376816974201946
SIM,1845,20,25-29,1865,57
SIM,1859,100,na,1959,2
STAT,1949,21,35-39,1970,10.38382085061464
SIM,1867,28,40-44,1895,2
SIM,1851,22,40-44,1873,1
SIM,1889,15,15-19,1904,6
SIM,1900,61,na,1961,2517
STAT,1890,22,20-24,1912,79.59579205380797
STAT,1938,17,20-24,1955,126.32591508020282
STAT,1893,46,40-44,1939,0.11608025625104944
STAT,1839,37,20-24,1876,0.6142131626254136
STAT,1901,71,na,1972,2168.8715438264358
STAT,1924,46,45-49,1970,0.24506601583669327
STAT,1904,35,50-100,1939,0.36243442446812796
SIM,1841,32,25-29,1873,15
SIM,1861,32,45-49,1893,1
STAT,1874,30,na,1904,2322.57891404104
STAT,1903,38,25-29,1941,0.831105724194216
SIM,1893,40,na,1933,2889
STAT,1886,39,25-29,1925,2.8448727600024486
SIM,1927,22,35-39,1949,13
STAT,1866,26,25-29,1892,36.97051288228809
SIM,1963,2,na,1965,4683
STAT,1823,31,20-24,1854,8.455609608598824
STAT,1917,43,35-39,1960,0.19819896146826696
SIM,1902,42,na,1944,3108
STAT,1859,16,40-44,1875,0.1610157064387344
STAT,1936,29,20-24,1965,16.483906084864433
SIM,1878,18,na,1896,2570
STAT,1804,103,na,1907,0.0486342440216004
STAT,1839,16,20-24,1855,15.555060779761067
STAT,1833,53,25-29,1886,0.0021776251147846695
SIM,1887,23,na,1910,2466
SIM,1839,93,na,1932,20
STAT,1922,44,20-24,1966,0.019087102461825618
SIM,1829,86,na,1915,107
STAT,1925,29,45-49,1954,1.9141164751629767
SIM,1899,17,30-34,1916,3
SIM,1831,31,20-24,1862,2
STAT,1898,40,na,1938,2995.8100624599074
STAT,1828,37,45-49,1865,1.8931547415197498
SIM,1855,38,na,1893,1877
STAT,1835,49,20-24,1884,0.007692378485633977
STAT,1837,20,25-29,1857,48.33078735782694
SIM,1858,41,35-39,1899,1
SIM,1872,27,na,1899,2206
STAT,1871,46,20-24,1917,0.011270430103684793
SIM,1908,33,na,1941,3268
SIM,1870,34,45-49,1904,1
STAT,1843,43,40-44,1886,1.649537445793568
STAT,1943,22,45-49,1965,1.130851022973412
STAT,1823,43,20-24,1866,0.20001012412169725
SIM,1854,53,na,1907,1683
SIM,1885,34,50-100,1919,5
SIM,1807,51,na,1858,1124
STAT,1869,63,na,1932,1631.6334548641503
STAT,1912,12,na,1924,3771.7762756188217
SIM,1933,29,45-49,1962,2
STAT,1927,17,45-49,1944,0.5868324120853852
SIM,1870,15,na,1885,2379
STAT,1913,0,na,1913,4336.209616265435
SIM,1929,39,30-34,1968,2
STAT,1867,82,na,1949,413.85884051609
STAT,1933,28,50-100,1961,1.2479387465509768
STAT,1902,28,50-100,1930,0.8498028531183052
SIM,1868,26,35-39,1894,9
STAT,1822,32,15-19,1854,0.43307345443271655
SIM,1934,22,45-49,1956,2
STAT,1895,28,45-49,1923,1.363963341927198
STAT,1910,31,na,1941,3458.0771154872887
STAT,1921,18,20-24,1939,145.62109567091716
STAT,1904,18,20-24,1922,23.956094243965598
SIM,1819,37,45-49,1856,1
STAT,1911,41,40-44,1952,0.2267751690056568
STAT,1858,36,45-49,1894,1.485544536291375
STAT,1861,97,na,1958,6.563335618523137
SIM,1825,32,40-44,1857,3
STAT,1851,19,40-44,1870,0.16115710796741137
STAT,1873,34,20-24,1907,2.569793993274253
SIM,1767,91,na,1858,14
STAT,1769,109,na,1878,0.002639601123831106
STAT,1857,30,20-24,1887,2.0680385542828135
SIM,1840,43,30-34,1883,5
STAT,1878,28,45-49,1906,1.0880868137279234
SIM,1892,23,40-44,1915,3
STAT,1884,23,40-44,1907,1.9393072848283932
SIM,1805,70,na,1875,635
STAT,1880,44,50-100,1924,1.035936976338245
STAT,1915,18,30-34,1933,2.4034225762085626
STAT,1899,41,15-19,1940,0.001247129728008126
SIM,1903,22,15-19,1925,4
STAT,1936,4,na,1940,3649.8657410299406
STAT,1921,33,15-19,1954,0.13453801325335601
STAT,1863,51,45-49,1914,0.01210896666620902
SIM,1909,27,45-49,1936,1
SIM,1869,38,na,1907,2159
STAT,1915,34,35-39,1949,8.716242932036605
SIM,1876,35,50-100,1911,1
SIM,1881,34,20-24,1915,2
STAT,1926,22,45-49,1948,1.2914988801684606
SIM,1853,38,25-29,1891,2
STAT,1939,29,50-100,1968,0.9442441242579002
STAT,1849,21,50-100,1870,0.35794214235379085
STAT,1919,22,35-39,1941,9.740329952940817
SIM,1836,37,45-49,1873,1
SIM,1836,31,na,1867,1718
STAT,1831,44,25-29,1875,0.47629539667482856
SIM,1839,24,15-19,1863,2
SIM,1887,41,50-100,1928,1
SIM,1912,18,20-24,1930,19
STAT,1806,53,30-34,1859,0.016472933582627417
STAT,1813,49,35-39,1862,0.4093648797728949
SIM,1849,38,na,1887,1737
SIM,1924,33,40-44,1957,7
STAT,1848,106,na,1954,0.008747159117983232
STAT,1821,33,45-49,1854,5.47985235027745
SIM,1913,33,30-34,1946,27
SIM,1940,18,30-34,1958,10
STAT,1852,51,35-39,1903,0.006572220948096758
SIM,1807,54,na,1861,1077
SIM,1923,34,35-39,1957,13
STAT,1932,18,30-34,1950,15.20753427828137
SIM,1928,28,25-29,1956,81
STAT,1814,98,na,1912,1.340334939535936
SIM,1854,50,na,1904,1736
STAT,1821,46,na,1867,1420.81362223896
STAT,1901,3,na,1904,3495.652782097919
STAT,1863,75,na,1938,854.8792922305626
STAT,1905,45,30-34,1950,0.0752850895498922
SIM,1847,71,na,1918,954
STAT,1898,15,15-19,1913,7.624524195097337
STAT,1860,49,15-19,1909,3.00691521850526E-4
STAT,1898,43,na,1941,2944.45835152006
SIM,1904,20,na,1924,3178
STAT,1895,44,50-100,1939,0.08922010559818665
SIM,1872,32,20-24,1904,2
STAT,1914,44,na,1958,3464.364655468297
STAT,1916,33,40-44,1949,3.800545257018094
SIM,1930,29,na,1959,4423
SIM,1931,22,na,1953,4438
STAT,1913,34,50-100,1947,0.7702740617613363
SIM,1886,28,45-49,1914,1
SIM,1865,30,20-24,1895,2
STAT,1859,70,na,1929,1057.8120819031499
SIM,1816,68,na,1884,715
STAT,1872,20,45-49,1892,0.6651470301781204
SIM,1931,4,na,1935,4967
STAT,1770,91,na,1861,12.556229340183362
STAT,1899,28,na,1927,3078.74965468773
STAT,1841,45,30-34,1886,0.06825674602286362
STAT,1941,24,35-39,1965,9.185455047401172
STAT,1906,43,25-29,1949,0.060899002806826176
STAT,1817,53,40-44,1870,0.02211431625048019
STAT,1848,16,na,1864,2062.1404638709027
SIM,1922,35,30-34,1957,1
STAT,1905,33,30-34,1938,13.628432923692474
STAT,1858,103,na,1961,0.3042704368167129
STAT,1868,43,45-49,1911,1.3401834384113962
SIM,1788,76,na,1864,318
SIM,1858,97,na,1955,1
STAT,1912,43,15-19,1955,0.0013904849411730954
STAT,1830,45,20-24,1875,0.009025234091098162
STAT,1930,24,25-29,1954,111.09294807263277
STAT,1873,44,30-34,1917,1.087545755050934
STAT,1874,54,25-29,1928,0.003325879442110695
SIM,1876,43,45-49,1919,2
STAT,1917,32,45-49,1949,1.5565809786302138
SIM,1896,37,na,1933,2990
SIM,1925,32,45-49,1957,2
STAT,1951,19,45-49,1970,0.5616121543226827
SIM,1787,91,na,1878,13
STAT,1812,83,na,1895,170.74344392935322
STAT,1842,44,35-39,1886,1.3003802683268149
SIM,1923,18,30-34,1941,19
SIM,1850,44,35-39,1894,2
STAT,1860,27,50-100,1887,0.4963923220685156
STAT,1869,38,45-49,1907,1.8138759202185974
SIM,1890,15,na,1905,3036
SIM,1830,40,na,1870,1644
STAT,1931,35,30-34,1966,2.284263167823687
SIM,1803,92,na,1895,13
STAT,1902,2,na,1904,3553.719621423047
STAT,1853,68,na,1921,1133.323270417568
STAT,1832,43,30-34,1875,0.8418972372188944
SIM,1812,46,50-100,1858,3
STAT,1841,97,na,1938,3.6756429267583344
STAT,1882,46,30-34,1928,0.08923604732548063
STAT,1899,37,45-49,1936,0.5570418722637175
STAT,1914,35,30-34,1949,1.735106704489261
STAT,1926,37,15-19,1963,0.022173591088777124
STAT,1956,15,15-19,1971,56.7547967398219
SIM,1877,38,45-49,1915,1
STAT,1906,28,30-34,1934,34.51851504420125
STAT,1921,45,15-19,1966,3.9418273464883366E-4
SIM,1831,25,na,1856,1735
STAT,1877,45,45-49,1922,0.2336613149569415
SIM,1838,46,na,1884,1480
SIM,1908,32,45-49,1940,1
SIM,1834,53,na,1887,1307
STAT,1870,43,35-39,1913,1.6641064680419024
SIM,1818,46,na,1864,1293
STAT,1902,32,35-39,1934,13.500879337097388
STAT,1854,30,na,1884,1796.6402771299056
SIM,1939,28,na,1967,3478
STAT,1858,23,na,1881,1818.1861992300605
SIM,1889,58,na,1947,2283
SIM,1849,47,50-100,1896,1
STAT,1844,23,na,1867,1860.6221259932436
STAT,1898,31,20-24,1929,3.4708707693741463
STAT,1900,41,30-34,1941,0.10510476714741208
SIM,1841,32,na,1873,1810
STAT,1803,52,35-39,1855,0.024676055258402038
SIM,1798,83,na,1881,128
SIM,1924,17,35-39,1941,8
SIM,1794,90,na,1884,27
SIM,1910,32,35-39,1942,10
STAT,1924,29,50-100,1953,1.0871038514797302
SIM,1859,8,na,1867,2342
STAT,1811,50,35-39,1861,0.02845698676515438
STAT,1911,26,15-19,1937,0.6524657323763456
SIM,1894,59,na,1953,2515
SIM,1836,19,15-19,1855,4
STAT,1946,18,25-29,1964,45.39316768165093
STAT,1855,45,25-29,1900,0.04120114190942383
STAT,1850,57,na,1907,1414.784880313053
STAT,1863,78,na,1941,648.8292915041028
SIM,1852,42,45-49,1894,4
SIM,1847,19,25-29,1866,8
STAT,1936,27,30-34,1963,35.418236885892
STAT,1887,19,20-24,1906,18.629685934511418
STAT,1896,43,20-24,1939,0.013669725625344974
STAT,1898,19,30-34,1917,2.0273522798743118
SIM,1806,58,na,1864,1037
SIM,1944,27,30-34,1971,43
SIM,1878,66,na,1944,1632
STAT,1816,76,na,1892,441.4868782019535
STAT,1849,60,na,1909,1374.6776173609276
STAT,1901,22,40-44,1923,2.7553932408872215
STAT,1908,29,45-49,1937,1.5314513890914006
SIM,1857,100,na,1957,1
STAT,1847,54,30-34,1901,0.004259376533583336
STAT,1866,45,35-39,1911,0.12315413920739977
STAT,1936,25,na,1961,3389.198565076387
SIM,1828,28,20-24,1856,9
STAT,1838,23,na,1861,1878.3494822389384
STAT,1876,31,35-39,1907,9.916837322480035
SIM,1865,45,na,1910,1951
STAT,1785,90,na,1875,29.613464377829633
STAT,1791,76,na,1867,348.94200110465755
STAT,1839,19,25-29,1858,4.884663831022528
STAT,1894,48,15-19,1942,2.7074868514269796E-4
STAT,1824,30,50-100,1854,3.0114877836927576
SIM,1921,46,50-100,1967,3
STAT,1868,40,40-44,1908,2.049266425081598
SIM,1946,21,na,1967,3802
STAT,1806,69,na,1875,691.0584733417302
STAT,1837,43,15-19,1880,0.01015608096004517
STAT,1913,46,50-100,1959,0.20902256406583836
SIM,1883,16,25-29,1899,8
STAT,1843,25,45-49,1868,1.000125832972034
STAT,1844,50,30-34,1894,0.0042387947054829305
STAT,1920,38,25-29,1958,1.017432780563189
STAT,1882,42,15-19,1924,0.01267905759707981
STAT,1858,54,40-44,1912,0.007592912334536079
STAT,1891,17,20-24,1908,20.730090999600492
SIM,1948,15,30-34,1963,15
STAT,1894,30,40-44,1924,5.31242730137134
SIM,1867,26,na,1893,2075
STAT,1851,52,30-34,1903,0.00434186470338415
STAT,1881,48,50-100,1929,0.22120770929065164
STAT,1893,42,25-29,1935,0.7687520785066747
STAT,1848,43,25-29,1891,0.4592831391520963
STAT,1875,16,25-29,1891,5.513282964900405
STAT,1931,38,35-39,1969,3.0231636268068764
STAT,1934,19,45-49,1953,0.6348725632724608
STAT,1884,30,15-19,1914,0.1340118364279303
SIM,1832,26,20-24,1858,11
STAT,1870,71,na,1941,1235.5842061438093
SIM,1839,28,30-34,1867,21
STAT,1864,44,20-24,1908,0.13227762201607202
SIM,1888,73,na,1961,1467
SIM,1881,44,30-34,1925,2
STAT,1826,51,25-29,1877,0.003260027315307309
STAT,1865,56,na,1921,1750.9132847858261
STAT,1844,24,50-100,1868,0.35231574292749385
SIM,1846,72,na,1918,845
SIM,1919,16,15-19,1935,38
SIM,1856,39,50-100,1895,1
STAT,1868,18,40-44,1886,0.16697206463721667
SIM,1879,18,25-29,1897,8
STAT,1917,40,30-34,1957,0.1263835860077603
STAT,1851,51,50-100,1902,0.011128084567906732
SIM,1836,45,50-100,1881,2
STAT,1828,45,50-100,1873,0.21241251801844527
STAT,1846,30,45-49,1876,1.4834775392697708
STAT,1878,44,15-19,1922,0.013397989579415643
SIM,1836,65,na,1901,1070
STAT,1924,4,na,1928,4541.038759339888
SIM,1887,26,na,1913,2496
SIM,1881,6,na,1887,2208
STAT,1923,47,40-44,1970,0.17425263109094538
SIM,1878,42,50-100,1920,1
STAT,1890,77,na,1967,1356.0117022925308
SIM,1854,18,20-24,1872,14
SIM,1870,31,40-44,1901,6
SIM,1921,21,20-24,1942,124
SIM,1910,20,na,1930,3325
SIM,1884,31,35-39,1915,8
SIM,1916,29,45-49,1945,1
STAT,1933,33,40-44,1966,4.978999417896702
STAT,1861,39,20-24,1900,0.598626793498846
STAT,1845,38,25-29,1883,2.1088447503830037
SIM,1916,20,35-39,1936,13
STAT,1881,35,25-29,1916,2.6511841076486036
SIM,1852,27,na,1879,1929
SIM,1878,63,na,1941,1765
SIM,1905,16,20-24,1921,25
STAT,1852,41,25-29,1893,0.4901007577151193
SIM,1906,34,35-39,1940,7
STAT,1878,21,25-29,1899,56.46831090302211
SIM,1873,27,20-24,1900,7
STAT,1833,50,20-24,1883,4.814437587897233E-4
STAT,1923,43,25-29,1966,0.07872916576331984
STAT,1847,82,na,1929,343.3060802564039
SIM,1850,40,50-100,1890,1
SIM,1895,19,20-24,1914,27
STAT,1855,42,20-24,1897,0.11233875429877282
STAT,1913,21,20-24,1934,102.0731716318605
SIM,1840,17,15-19,1857,6
SIM,1920,6,na,1926,4155
STAT,1842,40,50-100,1882,0.7985507869649895
STAT,1835,49,na,1884,1442.1504757792845
STAT,1901,47,20-24,1948,0.00890883190161907
STAT,1921,30,45-49,1951,1.667736307623804
SIM,1817,40,35-39,1857,1
STAT,1814,44,25-29,1858,1.8254896367622528
STAT,1911,44,45-49,1955,0.1481860936292143
STAT,1852,38,na,1890,1781.127872402829
STAT,1885,22,na,1907,2225.9349332112556
SIM,1908,7,na,1915,3576
STAT,1822,50,45-49,1872,0.020273563246959232
SIM,1794,79,na,1873,260
STAT,1849,26,25-29,1875,36.40498666850306
SIM,1918,37,30-34,1955,2
STAT,1903,35,20-24,1938,0.22574527073401526
STAT,1844,42,45-49,1886,1.0760461661202974
STAT,1939,32,30-34,1971,15.18448853122481
STAT,1832,83,na,1915,240.04157003706075
STAT,1905,48,35-39,1953,0.1064539700016331
SIM,1852,72,na,1924,933
STAT,1784,94,na,1878,3.392061929347032
STAT,1890,34,20-24,1924,3.0953756452839927
SIM,1882,37,40-44,1919,5
STAT,1821,91,na,1912,31.291744688467254
STAT,1876,11,na,1887,2544.957470771634
SIM,1870,5,na,1875,2575
SIM,1894,16,35-39,1910,3
STAT,1825,50,na,1875,1403.4185735399726
SIM,1863,64,na,1927,1481
STAT,1789,100,na,1889,0.2009089480023367
SIM,1868,23,30-34,1891,19
STAT,1888,29,15-19,1917,0.5027177591656347
STAT,1867,52,25-29,1919,0.003125041898404609
STAT,1928,32,20-24,1960,2.8815155684033043
SIM,1939,28,35-39,1967,18
SIM,1886,25,40-44,1911,6
SIM,1871,37,30-34,1908,8
STAT,1861,20,35-39,1881,4.771218711092096
SIM,1914,19,na,1933,4041
SIM,1869,41,45-49,1910,2
STAT,1819,48,25-29,1867,0.10090507020405992
STAT,1800,54,40-44,1854,0.029516666249182106
SIM,1944,23,15-19,1967,5
SIM,1857,26,25-29,1883,47
SIM,1928,33,na,1961,4455
SIM,1890,12,na,1902,3097
STAT,1833,32,25-29,1865,8.032670746245493
SIM,1930,36,35-39,1966,7
STAT,1878,25,40-44,1903,2.9659814777369067
STAT,1936,23,15-19,1959,4.805313949854849
STAT,1824,49,45-49,1873,0.2696042117437455
STAT,1825,41,30-34,1866,1.3131941863436116
SIM,1845,79,na,1924,480
SIM,1876,85,na,1961,405
STAT,1883,20,20-24,1903,64.18450155596715
STAT,1850,16,20-24,1866,15.341857575956062
STAT,1900,44,35-39,1944,0.16257768782058918
STAT,1836,42,na,1878,1579.407475696296
STAT,1940,31,25-29,1971,9.041027845474117
SIM,1940,30,20-24,1970,3
STAT,1874,37,40-44,1911,4.22661699405175
STAT,1897,28,50-100,1925,0.805352339430901
STAT,1921,16,30-34,1937,13.158577727393544
SIM,1918,26,na,1944,3755
STAT,1869,50,35-39,1919,0.007985570760426318
STAT,1940,21,15-19,1961,5.12395911305322
STAT,1834,64,na,1898,1075.968038560362
SIM,1954,8,na,1962,4435
STAT,1836,41,40-44,1877,1.711519460620225
STAT,1775,80,na,1855,214.65852000000004
STAT,1914,45,40-44,1959,0.14838456530650704
SIM,1913,34,na,1947,3399
STAT,1803,58,na,1861,997.6466007986907
SIM,1929,18,na,1947,4526
STAT,1888,29,50-100,1917,0.7088008021234488
SIM,1891,20,20-24,1911,69
STAT,1907,46,45-49,1953,0.18522909326162473
STAT,1840,21,50-100,1861,0.3637652298147468
STAT,1863,33,15-19,1896,0.11775822110204334
STAT,1858,50,25-29,1908,0.002664610760204342
STAT,1932,40,30-34,1972,0.16414706114136582
SIM,1870,12,na,1882,2458
STAT,1905,30,na,1935,3283.8712066037383
STAT,1908,20,35-39,1928,8.224468653685678
STAT,1851,31,30-34,1882,13.465242337279797
SIM,1829,83,na,1912,168
SIM,1903,27,na,1930,3205
STAT,1858,33,40-44,1891,3.202664865590912
STAT,1812,46,15-19,1858,0.0013378251718101366
STAT,1780,104,na,1884,0.028090945756759654
STAT,1858,20,50-100,1878,0.3520321686699956
STAT,1846,18,20-24,1864,15.60991076172255
SIM,1841,35,na,1876,1771
SIM,1866,33,40-44,1899,4
STAT,1890,47,50-100,1937,0.15927011450024353
STAT,1768,87,na,1855,31.562700000000003
STAT,1878,77,na,1955,850.0886388150767
STAT,1848,39,50-100,1887,0.8927551624175881
SIM,1876,40,40-44,1916,7
SIM,1862,27,45-49,1889,1
SIM,1898,18,na,1916,3192
SIM,1844,41,40-44,1885,3
STAT,1836,90,na,1926,49.78695317274406
STAT,1871,45,50-100,1916,0.23230822304401819
STAT,1840,31,20-24,1871,2.316749466080713
STAT,1861,12,na,1873,2152.488856754502
SIM,1895,31,45-49,1926,3
STAT,1841,41,15-19,1882,0.009944843658398336
SIM,1894,33,50-100,1927,1
SIM,1790,80,na,1870,187
STAT,1889,69,na,1958,1793.517942126563
STAT,1857,18,30-34,1875,1.3869582526172768
STAT,1855,49,na,1904,1560.1506181383397
STAT,1906,40,20-24,1946,0.015323710330466984
STAT,1922,36,35-39,1958,2.6025631088206844
SIM,1898,27,25-29,1925,53
STAT,1892,32,30-34,1924,20.6549641805406
STAT,1924,21,30-34,1945,32.13838907188009
STAT,1838,54,20-24,1892,4.894495623240299E-4
STAT,1890,47,35-39,1937,0.09078915349242572
SIM,1843,30,35-39,1873,8
SIM,1872,78,na,1950,654
SIM,1871,93,na,1964,73
STAT,1799,93,na,1892,9.770932620001853
STAT,1884,40,25-29,1924,0.6055280576575208
SIM,1922,48,na,1970,3993
SIM,1801,66,na,1867,772
SIM,1941,0,na,1941,3927
STAT,1806,109,na,1915,2.3673718030123834E-4
STAT,1810,51,na,1861,1253.9214224552795
STAT,1853,47,15-19,1900,2.952599190341389E-4
STAT,1889,44,25-29,1933,0.7388206253280699
SIM,1885,11,na,1896,2468
STAT,1847,28,15-19,1875,0.398364718311271
STAT,1886,33,50-100,1919,0.9106675123894659
SIM,1800,81,na,1881,159
SIM,1932,21,30-34,1953,48
STAT,1932,18,na,1950,4592.351439549142
STAT,1931,33,na,1964,4678.849688668917
SIM,1865,18,30-34,1883,3
STAT,1930,28,40-44,1958,5.596543265604858
SIM,1885,42,40-44,1927,5
STAT,1862,34,50-100,1896,0.7320239121215507
STAT,1921,26,na,1947,3958.0616837054704
STAT,1887,31,45-49,1918,1.8498710585136318
STAT,1818,57,na,1875,1133.940419787246
STAT,1914,31,15-19,1945,0.12267659507903679
STAT,1886,16,35-39,1902,0.5490249593149436
STAT,1919,49,40-44,1968,0.16060213023533998
STAT,1850,39,45-49,1889,1.396341523918764
STAT,1899,34,40-44,1933,5.566303592098831
SIM,1843,13,na,1856,2179
SIM,1766,100,na,1866,1
SIM,1936,32,20-24,1968,4
STAT,1863,37,30-34,1900,4.425753785242058
SIM,1903,26,30-34,1929,37
STAT,1874,51,20-24,1925,7.158934020717798E-4
STAT,1829,52,20-24,1881,5.234435379434219E-4
SIM,1887,77,na,1964,1055
STAT,1901,0,na,1901,3882.679445523317
STAT,1826,35,na,1861,1580.3332167332262
STAT,1860,50,50-100,1910,0.011761911105882778
STAT,1835,30,35-39,1865,8.213222895727672
SIM,1911,56,na,1967,3209
SIM,1818,91,na,1909,23
STAT,1912,47,30-34,1959,0.08091601874097769
SIM,1918,0,na,1918,4259
SIM,1858,19,35-39,1877,3
SIM,1861,86,na,1947,142
STAT,1823,72,na,1895,664.5834116303939
SIM,1883,19,na,1902,2384
STAT,1947,17,na,1964,3917.1508678707023
SIM,1816,65,na,1881,804
STAT,1869,15,50-100,1884,0.04596016127833926
STAT,1820,38,20-24,1858,1.6441193170845876
STAT,1851,16,50-100,1867,0.043938908486370325
SIM,1828,40,45-49,1868,1
STAT,1838,17,50-100,1855,0.044136631583559044
STAT,1887,66,na,1953,1731.6085196911886
SIM,1865,32,20-24,1897,2
STAT,1906,18,30-34,1924,2.1867967899508605
STAT,1846,68,na,1914,1077.4899982420836
STAT,1860,52,50-100,1912,0.011533554389810106
STAT,1898,20,15-19,1918,4.244053028332355
SIM,1859,21,40-44,1880,1
SIM,1862,31,40-44,1893,6
STAT,1842,38,45-49,1880,1.6480802549299631
SIM,1876,30,30-34,1906,21
STAT,1827,48,20-24,1875,0.010374642723296173
SIM,1845,34,45-49,1879,2
STAT,1824,47,40-44,1871,0.20118661966562587
STAT,1850,73,na,1923,836.1806236798659
STAT,1891,71,na,1962,1750.9785274239584
SIM,1954,15,20-24,1969,157
STAT,1845,48,50-100,1893,0.1708223569840209
STAT,1849,23,50-100,1872,0.35282054596608997
STAT,1838,27,15-19,1865,0.3936257208199098
STAT,1951,19,20-24,1970,152.42156932949828
STAT,1902,30,30-34,1932,23.463488915580868
STAT,1822,35,50-100,1857,2.446103873134051
STAT,1824,41,na,1865,1469.3827828662465
STAT,1857,5,na,1862,2201.0834075853036
STAT,1948,23,30-34,1971,31.167316690937056
STAT,1900,22,20-24,1922,90.3159927713805
STAT,1887,40,50-100,1927,1.1273999788326134
SIM,1827,58,na,1885,1092
STAT,1821,47,50-100,1868,0.3750338898429207
SIM,1874,36,na,1910,2265
STAT,1803,95,na,1898,4.392546240897433
STAT,1930,34,25-29,1964,11.254327684984595
STAT,1911,49,na,1960,3265.638732529287
STAT,1857,32,20-24,1889,2.0255335558706165
STAT,1828,55,na,1883,1234.2569462346016
STAT,1920,21,35-39,1941,9.919289571226336
SIM,1914,18,30-34,1932,5
STAT,1878,28,50-100,1906,0.6268926376893171
STAT,1915,43,50-100,1958,0.11154719917271862
STAT,1847,25,15-19,1872,0.40707020486140105
STAT,1926,45,15-19,1971,4.3145801507952906E-4
STAT,1836,23,50-100,1859,0.337415106478637
STAT,1846,32,45-49,1878,1.4529871935648475
STAT,1854,31,40-44,1885,3.231361281220634
STAT,1923,44,35-39,1967,0.22161926764952722
SIM,1939,26,35-39,1965,13
STAT,1889,35,20-24,1924,0.9075575742712076
STAT,1898,28,25-29,1926,53.90577773136182
SIM,1840,24,na,1864,1812
STAT,1844,24,35-39,1868,5.04163769120242
SIM,1907,20,30-34,1927,28
STAT,1861,21,30-34,1882,14.45915262158482
STAT,1830,45,15-19,1875,3.0084087174005777E-4
STAT,1940,19,45-49,1959,0.4787824238983184
SIM,1921,31,45-49,1952,2
STAT,1873,54,25-29,1927,0.0033030650879241575
STAT,1914,24,15-19,1938,5.1045975225487785
STAT,1941,26,25-29,1967,64.34705969836985
SIM,1922,24,15-19,1946,4
STAT,1862,46,50-100,1908,0.19847568519379113
STAT,1891,38,40-44,1929,5.093255006201401
SIM,1962,0,na,1962,4684
STAT,1837,34,45-49,1871,1.351842631236453
STAT,1918,39,30-34,1957,1.8108801139622768
SIM,1886,21,na,1907,2319
SIM,1926,39,30-34,1965,1
STAT,1876,34,50-100,1910,0.8859230027509561
SIM,1852,24,35-39,1876,12
STAT,1832,60,na,1892,1153.1924439893976
SIM,1830,39,30-34,1869,4
SIM,1897,35,20-24,1932,1
STAT,1967,0,na,1967,4673.072196463758
STAT,1832,53,50-100,1885,0.009337652536818663
STAT,1822,39,30-34,1861,8.700226541795496
STAT,1919,13,na,1932,4130.055191964467
STAT,1831,37,30-34,1868,4.208771679650328
STAT,1900,44,40-44,1944,0.2019434959847343
STAT,1829,72,na,1901,774.0897202825296
SIM,1915,34,25-29,1949,14
SIM,1824,77,na,1901,474
STAT,1922,28,40-44,1950,4.965370504134234
SIM,1912,19,35-39,1931,1
STAT,1879,16,20-24,1895,17.548715015505724
SIM,1932,31,20-24,1963,1
SIM,1909,23,45-49,1932,1
STAT,1850,37,40-44,1887,3.1305736957191566
SIM,1854,32,45-49,1886,1
SIM,1903,66,na,1969,2482
SIM,1912,33,45-49,1945,1
STAT,1837,91,na,1928,36.58000591197718
STAT,1833,45,40-44,1878,0.12519285159791768
STAT,1807,107,na,1914,0.0016916824998430755
STAT,1843,49,50-100,1892,0.17348986238352446
STAT,1909,42,35-39,1951,0.17788234119071883
SIM,1849,69,na,1918,1051
STAT,1883,39,45-49,1922,1.8271275906700173
STAT,1782,84,na,1866,93.85211500434485
STAT,1907,28,na,1935,3299.566838607191
STAT,1903,14,na,1917,3459.7407527428204
SIM,1795,63,na,1858,821
STAT,1917,19,45-49,1936,0.5034307155017687
STAT,1863,24,45-49,1887,0.5821548054383775
STAT,1879,28,15-19,1907,0.446423481632864
STAT,1816,48,45-49,1864,0.6115365538592313
STAT,1853,22,na,1875,1873.5149609966747
SIM,1920,30,na,1950,3870
STAT,1808,94,na,1902,7.768294470003796
STAT,1882,19,na,1901,2309.2130071541715
STAT,1918,48,50-100,1966,0.22674121024367389
STAT,1858,53,na,1911,1571.2137396713679
SIM,1879,83,na,1962,610
STAT,1851,50,30-34,1901,0.004427830740547215
STAT,1929,23,20-24,1952,132.43518081664118
STAT,1935,15,45-49,1950,0.6480982146247236
STAT,1833,23,20-24,1856,57.392835975266394
STAT,1875,40,15-19,1915,0.013538205467600326
STAT,1889,34,50-100,1923,1.059442683977691
STAT,1900,31,35-39,1931,13.32666618100419
SIM,1865,27,25-29,1892,36
SIM,1925,19,45-49,1944,1
SIM,1866,33,na,1899,2100
SIM,1924,44,na,1968,4124
STAT,1894,39,20-24,1933,0.9273232033799874
SIM,1930,28,40-44,1958,4
STAT,1946,15,20-24,1961,142.13467897667468
SIM,1836,19,na,1855,1907
SIM,1882,87,na,1969,371
STAT,1778,79,na,1857,230.26599624343285
SIM,1881,15,15-19,1896,5
SIM,1910,30,30-34,1940,14
STAT,1849,17,na,1866,2036.5995921767383
SIM,1936,19,20-24,1955,90
STAT,1847,52,50-100,1899,0.011053275252410249
STAT,1928,19,20-24,1947,160.53138619551981
SIM,1848,35,25-29,1883,1
STAT,1873,15,15-19,1888,5.758323438457751
SIM,1907,15,35-39,1922,2
SIM,1795,95,na,1890,1
STAT,1835,31,30-34,1866,14.01385385057185
STAT,1908,61,na,1969,2890.69421188993
SIM,1841,23,20-24,1864,59
SIM,1926,20,40-44,1946,3
STAT,1811,98,na,1909,1.4071028452229994
SIM,1899,30,25-29,1929,20
STAT,1915,36,25-29,1951,0.9440778081063451
STAT,1913,42,25-29,1955,0.06577081359126416
STAT,1859,35,35-39,1894,5.383092017144381
STAT,1879,31,na,1910,2365.949502576144
STAT,1910,41,45-49,1951,0.14940269364047418
SIM,1929,29,30-34,1958,63
SIM,1874,68,na,1942,1401
STAT,1779,80,na,1859,235.94992775442105
STAT,1858,25,50-100,1883,0.49270618155695883
SIM,1843,31,30-34,1874,19
SIM,1893,22,30-34,1915,26
STAT,1847,19,50-100,1866,0.04446260993519254
STAT,1914,29,45-49,1943,1.6332378148468252
STAT,1776,104,na,1880,0.027512497380996936
STAT,1869,42,40-44,1911,2.0542883042321827
STAT,1856,103,na,1959,0.21980869635261072
SIM,1856,39,na,1895,1841
STAT,1861,57,na,1918,1576.5086141581653
STAT,1872,38,30-34,1910,5.0284524925579435
SIM,1852,25,na,1877,1985
STAT,1839,39,na,1878,1671.5167129101071
STAT,1885,22,30-34,1907,16.764553234918104
SIM,1837,20,na,1857,1793
SIM,1895,33,45-49,1928,3
SIM,1778,83,na,1861,105
SIM,1920,18,30-34,1938,18
STAT,1938,29,30-34,1967,36.63088270056335
SIM,1923,36,25-29,1959,1
SIM,1917,25,45-49,1942,1
STAT,1887,33,45-49,1920,1.8345673997139316
STAT,1912,18,30-34,1930,2.321760723675703
SIM,1922,29,45-49,1951,1
STAT,1781,112,na,1893,1.711547250801613E-4
STAT,1830,49,50-100,1879,0.17541617950763327
SIM,1920,14,na,1934,4111
STAT,1918,23,45-49,1941,1.1428428684134102
STAT,1900,65,na,1965,2438.784533030813
STAT,1904,33,45-49,1937,1.3508633217260055
SIM,1804,89,na,1893,28
SIM,1924,28,na,1952,4043
STAT,1866,88,na,1954,119.57250179721325
SIM,1845,55,na,1900,1460
STAT,1920,4,na,1924,4278.136852806935
SIM,1827,42,na,1869,1467
STAT,1904,19,35-39,1923,0.7394171065004936
SIM,1799,93,na,1892,7
STAT,1865,48,40-44,1913,0.14511912569200813
SIM,1878,33,45-49,1911,1
STAT,1860,43,35-39,1903,1.380226798103473
STAT,1917,41,30-34,1958,0.12621549583836994
SIM,1906,36,25-29,1942,1
STAT,1857,49,45-49,1906,0.1720914237815089
STAT,1858,69,na,1927,1088.3736361841773
SIM,1863,38,30-34,1901,4
STAT,1839,28,50-100,1867,0.5334727754027497
STAT,1862,74,na,1936,894.3096183508314
STAT,1894,20,30-34,1914,21.77499883905512
STAT,1907,34,25-29,1941,8.090251473874119
STAT,1909,25,45-49,1934,1.5832501141767843
STAT,1820,36,50-100,1856,2.9960420901600333
SIM,1826,31,30-34,1857,15
SIM,1894,72,na,1966,1897
STAT,1835,25,na,1860,1784.5547998829406
STAT,1917,47,15-19,1964,3.634698470193768E-4
STAT,1839,19,30-34,1858,1.3738996847675333
STAT,1887,50,na,1937,2307.5674552976375
SIM,1905,29,45-49,1934,1
SIM,1847,19,30-34,1866,1
SIM,1889,36,25-29,1925,4
STAT,1878,14,na,1892,2531.5529003345437
SIM,1828,42,45-49,1870,1
SIM,1886,32,40-44,1918,4
STAT,1851,3,na,1854,2519.0
STAT,1881,17,15-19,1898,5.413164748845468
STAT,1844,61,na,1905,1311.7993264492275
STAT,1878,32,40-44,1910,4.264954790554762
SIM,1766,98,na,1864,1
STAT,1848,75,na,1923,741.6487068524275
SIM,1872,17,15-19,1889,5
STAT,1919,45,na,1964,3782.066376118784
SIM,1861,61,na,1922,1590
STAT,1895,32,40-44,1927,5.346303177191237
SIM,1813,93,na,1906,14
SIM,1931,19,45-49,1950,1
STAT,1810,52,35-39,1862,0.029219938038641924
SIM,1932,34,25-29,1966,16
SIM,1817,41,30-34,1858,5
SIM,1869,89,na,1958,105
SIM,1936,13,na,1949,2986
SIM,1927,16,15-19,1943,57
STAT,1878,73,na,1951,1168.098350579498
STAT,1871,46,15-19,1917,3.756806729946395E-4
STAT,1913,31,45-49,1944,1.4847079842844828
STAT,1876,32,30-34,1908,17.02768364432695
SIM,1884,32,30-34,1916,26
STAT,1859,23,40-44,1882,1.6182982771610874
STAT,1938,16,25-29,1954,40.47784847967738
STAT,1923,19,45-49,1942,0.551215496124521
SIM,1946,16,25-29,1962,54
SIM,1836,41,40-44,1877,6
STAT,1924,34,25-29,1958,10.174622801403666
SIM,1857,56,na,1913,1620
STAT,1848,34,20-24,1882,2.024092511300607
STAT,1853,38,20-24,1891,0.5688321014979598
SIM,1819,43,50-100,1862,1
STAT,1901,32,50-100,1933,1.211539541267288
STAT,1919,16,15-19,1935,9.528857808862332
STAT,1924,45,50-100,1969,0.2555996777906407
STAT,1904,37,50-100,1941,0.35902472316793793
SIM,1902,31,35-39,1933,19
SIM,1869,43,45-49,1912,3
STAT,1895,31,50-100,1926,1.1341633676063956
STAT,1874,38,40-44,1912,4.2056529737612545
SIM,1900,20,20-24,1920,81
STAT,1833,107,na,1940,0.0028630085685476276
STAT,1831,42,50-100,1873,0.8046415721956013
STAT,1898,36,50-100,1934,1.5776273488281782
STAT,1865,52,25-29,1917,0.0030244358712600084
SIM,1856,34,20-24,1890,2
STAT,1828,41,40-44,1869,2.0176910406674677
STAT,1933,24,25-29,1957,115.66943332212948
SIM,1909,39,30-34,1948,1
SIM,1802,82,na,1884,138
SIM,1886,53,na,1939,2045
SIM,1901,18,20-24,1919,25
STAT,1899,51,na,1950,2800.9338822124846
STAT,1858,19,40-44,1877,0.15659185160676853
STAT,1892,15,25-29,1907,6.734924944102496
SIM,1867,23,40-44,1890,4
STAT,1904,44,25-29,1948,0.05959973096381188
SIM,1833,24,25-29,1857,45
STAT,1864,17,15-19,1881,5.183359852536914
STAT,1833,41,50-100,1874,0.7890851974702822
STAT,1952,15,na,1967,4169.322414498853
STAT,1767,95,na,1862,1.7318405452360088
SIM,1941,24,25-29,1965,101
STAT,1836,46,50-100,1882,0.16440137258620377
STAT,1922,46,50-100,1968,0.24609482296572288
STAT,1930,31,45-49,1961,1.9196574776282938
STAT,1770,99,na,1869,0.2476807966007103
SIM,1882,38,40-44,1920,5
STAT,1841,37,na,1878,1726.5355722316285
STAT,1815,80,na,1895,264.75998679979284
STAT,1894,36,na,1930,2876.811119525286
SIM,1877,17,na,1894,2460
SIM,1865,75,na,1940,829
STAT,1803,79,na,1882,281.42718215138456
STAT,1807,47,40-44,1854,0.6339588222727908
STAT,1824,51,25-29,1875,0.004088234800607882
SIM,1850,35,40-44,1885,3
STAT,1883,36,na,1919,2191.8205969191827
STAT,1921,27,na,1948,3944.525112747197
STAT,1841,47,40-44,1888,0.11766461103131715
STAT,1887,25,45-49,1912,1.1809896184080826
STAT,1915,42,35-39,1957,0.19150030300674842
STAT,1855,27,15-19,1882,0.3349317170075531
SIM,1891,22,20-24,1913,74
STAT,1839,44,20-24,1883,0.10878223550902591
SIM,1903,29,35-39,1932,14
SIM,1863,68,na,1931,1282
STAT,1868,33,35-39,1901,9.09583386968475
STAT,1825,38,45-49,1863,2.451259837711436
STAT,1844,48,20-24,1892,0.008318261245205252
STAT,1939,16,50-100,1955,0.3543395418338614
STAT,1888,18,15-19,1906,6.605666622015945
SIM,1876,33,35-39,1909,10
STAT,1865,23,na,1888,2040.1888396532547
SIM,1862,34,45-49,1896,1
SIM,1915,22,30-34,1937,28
STAT,1784,110,na,1894,2.461124781471892E-4
STAT,1926,16,50-100,1942,0.4350576584966646
STAT,1854,34,45-49,1888,1.2594992168457424
STAT,1890,54,na,1944,2418.6431841654057
STAT,1791,77,na,1868,317.38717594476344
SIM,1804,57,na,1861,1011
STAT,1892,29,45-49,1921,1.304108326365325
STAT,1847,85,na,1932,201.7050162427452
STAT,1877,39,20-24,1916,0.7480707063597904
STAT,1849,16,35-39,1865,0.4897190814630772
SIM,1904,31,45-49,1935,3
SIM,1939,23,30-34,1962,29
SIM,1824,31,20-24,1855,2
SIM,1920,40,40-44,1960,2
STAT,1853,105,na,1958,0.04006780176142916
STAT,1904,41,45-49,1945,0.14144356259771632
SIM,1844,54,na,1898,1481
STAT,1937,26,na,1963,3450.8293104946783
STAT,1842,35,40-44,1877,3.733535020415736
STAT,1883,22,20-24,1905,63.803811679099276
STAT,1902,33,35-39,1935,13.443905626294839
STAT,1880,49,20-24,1929,0.01167893437538387
STAT,1875,19,40-44,1894,0.17656239934421966
SIM,1918,32,na,1950,3735
SIM,1879,67,na,1946,1527
SIM,1902,23,35-39,1925,8
STAT,1912,40,40-44,1952,0.2304249743327729
STAT,1931,18,40-44,1949,1.7250330204218534
STAT,1894,15,35-39,1909,0.6699005306394584
STAT,1919,29,20-24,1948,18.49921735267547
SIM,1875,53,na,1928,2025
STAT,1895,21,na,1916,2924.433964396647
STAT,1899,35,na,1934,3079.046757807811
SIM,1921,34,25-29,1955,14
STAT,1933,12,na,1945,5010.767292207786
STAT,1779,102,na,1881,0.08256280365101143
STAT,1840,95,na,1935,9.259235040034056
STAT,1778,95,na,1873,2.1704861882310538
SIM,1833,38,45-49,1871,2
STAT,1920,24,15-19,1944,5.555881255356414
STAT,1882,31,50-100,1913,0.8457007913830851
SIM,1865,16,na,1881,2245
SIM,1908,32,40-44,1940,3
STAT,1894,38,50-100,1932,1.4845776734285823
SIM,1856,37,25-29,1893,2
SIM,1927,29,20-24,1956,24
SIM,1910,52,na,1962,3099
STAT,1910,18,20-24,1928,25.30412090462507
STAT,1913,34,25-29,1947,8.61080570885295
STAT,1930,31,20-24,1961,2.9756169826800685
SIM,1837,36,na,1873,1683
STAT,1883,36,40-44,1919,4.072493126638942
SIM,1846,15,20-24,1861,20
STAT,1836,38,20-24,1874,0.5913247510924915
STAT,1812,50,50-100,1862,0.04947105237667255
STAT,1917,16,40-44,1933,0.28503133009003206
STAT,1842,54,na,1896,1491.1331331998276
STAT,1856,54,50-100,1910,0.010867144026413781
SIM,1913,36,40-44,1949,2
STAT,1848,37,25-29,1885,2.1375465623951015
SIM,1835,77,na,1912,520
SIM,1910,33,35-39,1943,16
SIM,1819,41,40-44,1860,6
SIM,1906,15,na,1921,3563
STAT,1922,32,25-29,1954,9.866179712985685
SIM,1822,37,30-34,1859,4
STAT,1908,45,na,1953,3184.1133770295196
SIM,1784,95,na,1879,1
STAT,1905,28,40-44,1933,4.075015573336338
SIM,1854,91,na,1945,33
STAT,1923,41,30-34,1964,0.14137724024878315
STAT,1799,57,na,1856,1043.7917742368313
SIM,1835,24,35-39,1859,7
SIM,1948,21,30-34,1969,33
STAT,1852,80,na,1932,469.9923556040523
SIM,1885,20,30-34,1905,23
STAT,1840,44,50-100,1884,0.7480589027035447
STAT,1854,46,15-19,1900,2.8885524001445837E-4
STAT,1856,19,30-34,1875,1.3780605389319813
SIM,1930,32,25-29,1962,11
STAT,1905,36,40-44,1941,1.2960691604592693
SIM,1841,37,40-44,1878,5
SIM,1925,16,40-44,1941,1
STAT,1825,50,50-100,1875,0.01588395135015709
STAT,1869,53,na,1922,1937.3223848883251
STAT,1833,37,40-44,1870,3.3317012475853973
STAT,1928,42,45-49,1970,0.20045310704222663
SIM,1926,23,45-49,1949,1
STAT,1881,28,30-34,1909,22.888665489632686
SIM,1870,22,na,1892,2188
SIM,1896,18,15-19,1914,7
STAT,1881,20,50-100,1901,0.3741829121002024
SIM,1891,36,40-44,1927,7
STAT,1792,78,na,1870,278.11995138143703
STAT,1864,22,na,1886,2028.9467702245558
STAT,1846,24,45-49,1870,0.5979631537458421
SIM,1851,9,na,1860,2209
STAT,1891,42,25-29,1933,0.7499540836172912
STAT,1913,39,50-100,1952,0.3873941681388633
SIM,1874,39,45-49,1913,4
STAT,1907,22,30-34,1929,24.713955796163173
SIM,1840,56,na,1896,1408
STAT,1803,63,na,1866,857.4215579352556
STAT,1874,24,20-24,1898,66.12065142386
STAT,1896,28,15-19,1924,0.5644682874437937
STAT,1816,45,40-44,1861,0.4654188055245347
STAT,1924,17,50-100,1941,0.42151775715579914
SIM,1935,12,na,1947,5118
STAT,1856,9,na,1865,2131.480153812712
STAT,1911,39,20-24,1950,0.2380565259950807
STAT,1853,21,50-100,1874,0.35990675631176194
STAT,1921,33,45-49,1954,1.6474559751545066
STAT,1921,19,35-39,1940,4.494669628106999
SIM,1826,46,50-100,1872,5
STAT,1827,44,50-100,1871,0.9384361569369166
STAT,1829,37,15-19,1866,0.050111716509375306
SIM,1816,42,na,1858,1379
STAT,1866,39,45-49,1905,1.7188299235106765
STAT,1850,89,na,1939,73.95792278047655
STAT,1888,26,15-19,1914,0.5080742558868734
STAT,1917,44,35-39,1961,0.1978521132856975
SIM,1905,26,40-44,1931,7
SIM,1841,26,25-29,1867,32
SIM,1878,30,40-44,1908,5
STAT,1863,1,na,1864,3008.102981556949
STAT,1850,49,35-39,1899,0.09650246016403952
STAT,1835,41,na,1876,1591.9885462474717
STAT,1918,20,40-44,1938,3.44618742364271
STAT,1829,48,30-34,1877,0.07709318246846479
STAT,1887,34,na,1921,2499.544426279491
SIM,1934,22,40-44,1956,4
STAT,1868,16,45-49,1884,0.06034159635471597
STAT,1898,66,na,1964,2302.5432349381504
SIM,1811,43,na,1854,1386
SIM,1899,28,na,1927,3049
SIM,1906,33,20-24,1939,2
STAT,1896,42,50-100,1938,0.09148228417499947
STAT,1822,47,30-34,1869,0.13503523306321555
STAT,1904,16,30-34,1920,2.164714711846125
SIM,1815,57,na,1872,1067
SIM,1961,4,na,1965,4707
STAT,1903,37,20-24,1940,0.2236215101550828
SIM,1881,22,na,1903,1968
STAT,1889,49,40-44,1938,0.11027653140014888
STAT,1932,33,20-24,1965,3.0613499761396015
SIM,1923,27,na,1950,3961
STAT,1900,39,45-49,1939,0.5582404313743952
SIM,1915,51,na,1966,3411
SIM,1885,36,na,1921,2255
STAT,1883,20,na,1903,2202.785842497404
STAT,1857,46,40-44,1903,0.1278633327447274
SIM,1852,41,na,1893,1803
STAT,1925,18,40-44,1943,1.5922100202548601
SIM,1918,18,15-19,1936,48
STAT,1952,20,40-44,1972,3.821855375688794
SIM,1801,65,na,1866,818
STAT,1839,55,na,1894,1378.6937261701937
STAT,1935,35,15-19,1970,0.025409915691193604
STAT,1885,49,20-24,1934,0.011058339454459137
SIM,1770,87,na,1857,39
SIM,1859,15,30-34,1874,5
STAT,1772,107,na,1879,0.006764120277125264
SIM,1960,11,na,1971,4667
STAT,1880,44,15-19,1924,0.013541660810951851
SIM,1866,92,na,1958,32
STAT,1896,39,30-34,1935,6.58717847009495
STAT,1926,22,40-44,1948,3.859391256713436
SIM,1912,16,30-34,1928,2
STAT,1833,26,25-29,1859,34.34753793313342
STAT,1851,28,45-49,1879,0.9464743695919237
STAT,1869,45,45-49,1914,0.2179585873261448
SIM,1898,17,35-39,1915,2
SIM,1933,29,20-24,1962,24
STAT,1893,19,na,1912,3010.9975317406893
STAT,1906,41,50-100,1947,0.10137431689542956
SIM,1869,35,45-49,1904,1
STAT,1852,49,45-49,1901,0.17556249574506683
STAT,1945,19,20-24,1964,139.81450058961153
SIM,1892,49,na,1941,2656
SIM,1796,80,na,1876,208
SIM,1806,96,na,1902,1
SIM,1924,15,35-39,1939,3
STAT,1871,48,50-100,1919,0.22712492412801563
STAT,1837,104,na,1941,0.04210491490176946
STAT,1849,33,na,1882,1793.7606257534155
SIM,1895,14,na,1909,3227
STAT,1840,16,15-19,1856,5.382710605810713
STAT,1853,22,35-39,1875,5.113286176742664
SIM,1848,27,25-29,1875,42
SIM,1917,34,35-39,1951,8
STAT,1904,30,40-44,1934,5.922711716200589
STAT,1898,33,20-24,1931,3.442156864289846
STAT,1913,38,40-44,1951,1.3883718329861812
STAT,1823,46,50-100,1869,0.29723079452731904
STAT,1857,68,na,1925,1138.126309071458
SIM,1876,25,35-39,1901,9
STAT,1891,28,50-100,1919,0.7453636639710409
SIM,1861,22,35-39,1883,6
STAT,1868,30,30-34,1898,15.874850888709497
STAT,1924,31,20-24,1955,2.690145626434373
STAT,1928,20,50-100,1948,0.7808121915772541
STAT,1853,54,na,1907,1552.8949128232632
SIM,1947,13,na,1960,4003
SIM,1913,28,40-44,1941,6
STAT,1850,41,25-29,1891,0.45412559479351866
STAT,1852,37,na,1889,1799.7189693562793
STAT,1817,49,50-100,1866,0.5324004036952705
STAT,1916,15,35-39,1931,0.8449160937895406
STAT,1873,42,na,1915,2213.538465576551
STAT,1946,23,20-24,1969,116.85899651926539
STAT,1828,44,45-49,1872,1.2769060025671035
SIM,1902,17,na,1919,3391
STAT,1904,41,20-24,1945,0.015009005732132359
SIM,1930,26,15-19,1956,3
STAT,1925,29,20-24,1954,20.224534858271447
SIM,1897,38,25-29,1935,4
STAT,1833,48,45-49,1881,0.15112365414197074
STAT,1902,43,50-100,1945,0.0970961586269584
STAT,1879,15,na,1894,2505.4513759657048
STAT,1806,53,50-100,1859,0.04179496360993906
STAT,1914,38,35-39,1952,2.2696959032757387
STAT,1906,43,20-24,1949,0.015061043897345413
SIM,1874,25,25-29,1899,46
SIM,1888,16,15-19,1904,5
STAT,1878,40,40-44,1918,2.2343764474876937
SIM,1925,45,na,1970,4128
STAT,1911,47,20-24,1958,0.009881279231687376
STAT,1880,32,50-100,1912,0.9107466348407669
STAT,1889,30,15-19,1919,0.16742110686256342
SIM,1807,81,na,1888,163
SIM,1835,32,35-39,1867,10
STAT,1921,35,50-100,1956,0.44367921858172915
SIM,1905,15,25-29,1920,10
STAT,1902,36,15-19,1938,0.016236151777243225
SIM,1933,18,40-44,1951,4
SIM,1849,85,na,1934,154
STAT,1929,35,15-19,1964,0.02333208950645632
SIM,1845,71,na,1916,968
STAT,1832,53,25-29,1885,0.002189938038788452
SIM,1846,56,na,1902,1421
SIM,1912,30,40-44,1942,9
SIM,1931,14,na,1945,4874
SIM,1860,76,na,1936,742
STAT,1841,69,na,1910,1004.0808253895584
STAT,1820,75,na,1895,548.4298838539032
SIM,1935,28,na,1963,4814
STAT,1893,27,50-100,1920,0.7667455418768331
STAT,1933,28,40-44,1961,5.843871719943221
SIM,1887,16,20-24,1903,18
SIM,1836,44,45-49,1880,2
STAT,1849,92,na,1941,30.02051551630647
STAT,1909,45,15-19,1954,3.2276219604243834E-4
STAT,1840,27,30-34,1867,21.866198229239973
STAT,1869,69,na,1938,1341.9756684045576
STAT,1935,32,35-39,1967,11.943029162200956
STAT,1821,92,na,1913,22.490628577388954
STAT,1914,16,15-19,1930,8.88888113700475
SIM,1889,20,15-19,1909,3
STAT,1931,26,40-44,1957,5.687485141724194
STAT,1922,26,15-19,1948,0.7572922780983474
STAT,1894,23,35-39,1917,7.069481216315112
STAT,1889,38,25-29,1927,3.3412717465135526
STAT,1871,35,na,1906,2227.4301513713795
STAT,1860,51,35-39,1911,0.006641313319964335
SIM,1840,40,na,1880,1676
STAT,1872,22,45-49,1894,0.6612019229500656
STAT,1950,21,20-24,1971,124.66702035929983
SIM,1860,41,35-39,1901,2
STAT,1864,17,50-100,1881,0.04279052397072373
STAT,1827,32,35-39,1859,11.783986312358945
STAT,1875,49,na,1924,2137.9650325921984
STAT,1895,35,45-49,1930,2.4809098265240865
SIM,1889,28,25-29,1917,52
SIM,1922,16,15-19,1938,51
STAT,1796,76,na,1872,401.86086729383635
SIM,1931,16,40-44,1947,1
STAT,1866,25,25-29,1891,37.09403602224216
SIM,1922,38,35-39,1960,5
STAT,1923,16,40-44,1939,1.5555364136244276
SIM,1828,34,45-49,1862,1
SIM,1928,25,20-24,1953,22
STAT,1848,48,40-44,1896,0.12178678129432195
STAT,1792,62,na,1854,800.0000000000001
STAT,1842,21,20-24,1863,62.34371137688908
STAT,1923,34,na,1957,4091.03545971581
SIM,1850,21,20-24,1871,61
SIM,1894,56,na,1950,2610
STAT,1831,49,25-29,1880,0.04127448232241264
SIM,1886,40,40-44,1926,6
SIM,1897,21,na,1918,3030
SIM,1890,42,na,1932,2755
STAT,1867,32,50-100,1899,0.8127102469051999
STAT,1943,27,na,1970,3768.8752321333873
STAT,1804,104,na,1908,0.022603251251479002
STAT,1814,49,25-29,1863,0.15126339074939454
SIM,1884,34,50-100,1918,4
STAT,1891,39,na,1930,2727.1335079749097
STAT,1902,29,na,1931,3158.849634217252
SIM,1824,34,25-29,1858,15
SIM,1805,74,na,1879,460
SIM,1922,18,40-44,1940,1
SIM,1925,19,20-24,1944,147
SIM,1809,88,na,1897,61
STAT,1870,38,20-24,1908,0.7100120833295444
STAT,1875,29,45-49,1904,1.069889649205907
SIM,1934,30,40-44,1964,5
SIM,1895,22,40-44,1917,2
STAT,1890,18,30-34,1908,1.8361389440049154
SIM,1818,38,na,1856,1413
SIM,1847,15,15-19,1862,5
STAT,1914,15,25-29,1929,8.506275526859993
SIM,1876,47,50-100,1923,2
STAT,1883,25,25-29,1908,39.43120592589869
STAT,1944,22,35-39,1966,9.603957880904469
SIM,1828,31,40-44,1859,7
STAT,1783,85,na,1868,69.67769234038488
STAT,1913,31,20-24,1944,2.301411759047698
STAT,1839,47,25-29,1886,0.039130821421471534
STAT,1847,69,na,1916,1079.8018412888216
STAT,1880,87,na,1967,398.2516665791776
STAT,1917,19,20-24,1936,136.63112365862943
STAT,1931,22,25-29,1953,113.1778724323801
SIM,1816,38,45-49,1854,1
STAT,1872,57,na,1929,1905.5367469247967
STAT,1869,50,40-44,1919,0.009765212221658768
STAT,1926,31,30-34,1957,18.00961759881255
STAT,1937,32,45-49,1969,1.470514619338859
SIM,1884,35,35-39,1919,11
SIM,1883,29,45-49,1912,1
STAT,1863,48,30-34,1911,0.0793740067688372
SIM,1836,41,50-100,1877,3
SIM,1882,27,25-29,1909,34
SIM,1937,30,na,1967,3397
STAT,1867,52,35-39,1919,0.007595588024158524
SIM,1891,28,40-44,1919,3
STAT,1921,41,45-49,1962,0.17735666561763216
STAT,1838,92,na,1930,28.405913062915914
SIM,1831,24,15-19,1855,2
SIM,1932,32,35-39,1964,15
STAT,1878,46,na,1924,2218.8936052822432
SIM,1817,44,35-39,1861,2
STAT,1768,109,na,1877,0.001843504832936912
SIM,1867,26,45-49,1893,1
STAT,1902,31,45-49,1933,2.3342738276437167
SIM,1904,51,na,1955,2869
STAT,1865,44,25-29,1909,0.5438154621029984
STAT,1882,41,20-24,1923,0.14664945587329262
SIM,1891,25,25-29,1916,56
STAT,1920,29,20-24,1949,18.782398786684137
SIM,1940,1,na,1941,3749
STAT,1839,15,15-19,1854,5.237841578379641
STAT,1866,16,35-39,1882,0.4934521332321215
STAT,1874,42,25-29,1916,0.6192595144184182
STAT,1781,99,na,1880,0.32010201391162013
STAT,1838,22,45-49,1860,0.6170427647292461
STAT,1876,35,35-39,1911,6.963415082111676
SIM,1853,10,na,1863,2313
STAT,1838,17,na,1855,2067.912146885935
STAT,1919,27,30-34,1946,39.994956910990055
SIM,1930,36,40-44,1966,3
STAT,1808,47,50-100,1855,0.9349610785264781
STAT,1913,36,15-19,1949,0.017984945749681742
SIM,1831,27,30-34,1858,29
STAT,1919,41,40-44,1960,0.25643347140239203
SIM,1918,29,30-34,1947,49
STAT,1807,51,25-29,1858,0.012795872280786661
SIM,1857,24,na,1881,1966
SIM,1927,27,30-34,1954,57
STAT,1907,38,40-44,1945,1.3044397525487796
STAT,1883,28,40-44,1911,2.7637313968256922
SIM,1885,68,na,1953,1412
SIM,1874,16,35-39,1890,1
SIM,1863,15,20-24,1878,22
SIM,1832,33,20-24,1865,1
SIM,1838,17,15-19,1855,9
SIM,1915,38,40-44,1953,2
SIM,1898,5,na,1903,3306
STAT,1822,48,20-24,1870,0.0165021977672046
STAT,1846,37,15-19,1883,0.04134625026303899
STAT,1846,109,na,1955,5.016306834291263E-4
STAT,1906,41,30-34,1947,0.11031910980475763
SIM,1904,24,20-24,1928,98
STAT,1891,24,20-24,1915,80.07539874995646
STAT,1851,17,50-100,1868,0.04368010831538562
STAT,1924,32,35-39,1956,10.072841107716716
STAT,1822,93,na,1915,15.095878626908188
STAT,1929,27,15-19,1956,0.8347043562100234
SIM,1876,16,na,1892,2533
SIM,1827,74,na,1901,595
SIM,1934,31,30-34,1965,22
STAT,1819,38,20-24,1857,1.8427294808050747
STAT,1918,48,20-24,1966,0.011078561199720767
STAT,1901,50,na,1951,2888.0988002897625
STAT,1836,105,na,1941,0.01851568209087963
STAT,1930,20,40-44,1950,4.093671793829969
SIM,1874,17,25-29,1891,7
STAT,1866,17,25-29,1883,5.066052404034584
SIM,1857,6,na,1863,2379
STAT,1879,23,45-49,1902,0.686430048607888
STAT,1914,14,na,1928,3846.1616148557014
STAT,1833,41,25-29,1874,0.479640025006707
SIM,1848,26,35-39,1874,9
STAT,1886,29,20-24,1915,11.625755278094658
STAT,1937,28,25-29,1965,60.57505231199551
STAT,1830,26,na,1856,1703.3013724438988
SIM,1848,48,50-100,1896,4
SIM,1872,54,50-100,1926,1
STAT,1872,6,na,1878,2608.042776571249
STAT,1874,27,25-29,1901,40.84335567011944
STAT,1879,36,15-19,1915,0.05571569397877543
STAT,1905,64,na,1969,2664.601540012197
SIM,1903,35,50-100,1938,1
STAT,1918,28,na,1946,3752.894598428998
STAT,1824,33,20-24,1857,5.471649322394822
SIM,1872,28,30-34,1900,21
STAT,1896,20,40-44,1916,2.617225691271694
STAT,1768,96,na,1864,0.8805977892274124
STAT,1874,49,45-49,1923,0.22310778483974272
SIM,1830,41,na,1871,1628
SIM,1865,35,25-29,1900,1
STAT,1879,90,na,1969,240.633743139556
STAT,1890,15,15-19,1905,6.886413775621741
SIM,1906,26,50-100,1932,3
STAT,1797,98,na,1895,0.7909713837111934
SIM,1835,21,30-34,1856,21
STAT,1851,74,na,1925,813.8262024467049
STAT,1856,51,20-24,1907,5.485944353080273E-4
SIM,1780,86,na,1866,64
STAT,1940,28,35-39,1968,14.454605021562134
STAT,1793,84,na,1877,107.93071779812652
STAT,1910,40,30-34,1950,0.11540194765866627
STAT,1855,88,na,1943,97.22928957108947
STAT,1829,40,na,1869,1639.9384638515926
SIM,1856,55,na,1911,1624
SIM,1784,107,na,1891,1
SIM,1869,32,40-44,1901,5
STAT,1848,91,na,1939,41.74697091424068
STAT,1907,25,35-39,1932,13.478395882111922
STAT,1951,19,50-100,1970,0.421209115742012
SIM,1894,29,20-24,1923,14
SIM,1913,28,na,1941,3373
STAT,1855,15,20-24,1870,15.111597801017961
STAT,1913,23,45-49,1936,1.0698007730621346
SIM,1834,55,na,1889,1263
SIM,1902,20,30-34,1922,28
STAT,1905,32,25-29,1937,8.02889369817044
SIM,1830,35,50-100,1865,3
SIM,1859,30,30-34,1889,23
STAT,1811,48,45-49,1859,0.7723657262829289
STAT,1899,40,25-29,1939,0.05831283218459804
SIM,1915,25,35-39,1940,14
STAT,1851,95,na,1946,9.749836804302356
STAT,1855,38,30-34,1893,3.755881040012899
STAT,1914,18,40-44,1932,0.2725684248698806
SIM,1913,32,25-29,1945,4
SIM,1835,93,na,1928,15
STAT,1926,30,40-44,1956,4.47576464592757
SIM,1874,48,50-100,1922,4
SIM,1921,23,45-49,1944,1
STAT,1891,46,40-44,1937,0.11324179099707016
STAT,1905,21,45-49,1926,0.9548263524455435
SIM,1855,16,25-29,1871,8
SIM,1777,82,na,1859,120
STAT,1826,51,35-39,1877,0.007923677582441129
SIM,1903,18,30-34,1921,4
STAT,1872,36,na,1908,2244.695072776205
SIM,1844,46,50-100,1890,3
STAT,1862,28,20-24,1890,9.42037043865214
STAT,1938,27,40-44,1965,4.361817995321426
SIM,1934,25,45-49,1959,1
SIM,1843,34,35-39,1877,10
STAT,1950,22,35-39,1972,10.5532654390667
SIM,1870,28,20-24,1898,9
STAT,1955,17,15-19,1972,56.91054582615942
SIM,1898,45,50-100,1943,1
SIM,1853,28,20-24,1881,14
STAT,1845,28,20-24,1873,9.98583420613562
STAT,1817,55,na,1872,1122.0557718296475
SIM,1937,26,25-29,1963,68
STAT,1805,59,na,1864,1010.2100640430997
STAT,1926,25,45-49,1951,1.969965428458564
STAT,1946,26,25-29,1972,69.29737387812492
STAT,1813,41,na,1854,1378.059360794677
STAT,1836,51,40-44,1887,0.006861172703821743
STAT,1841,40,20-24,1881,0.11584034346692425
STAT,1835,34,35-39,1869,7.879074949243515
SIM,1845,43,50-100,1888,1
SIM,1909,20,40-44,1929,7
STAT,1930,31,na,1961,4613.855424091592
STAT,1922,49,na,1971,3963.9845829292617
STAT,1892,40,15-19,1932,0.01650196960728264
STAT,1811,53,40-44,1864,0.03276409442623578
SIM,1815,89,na,1904,37
STAT,1850,23,20-24,1873,57.81162593547694
STAT,1928,42,20-24,1970,0.021270687596984323
SIM,1861,48,50-100,1909,4
STAT,1866,22,20-24,1888,60.51211261946026
SIM,1851,40,na,1891,1734
STAT,1937,3,na,1940,3727.1351764329593
STAT,1842,24,25-29,1866,50.68138064611438
STAT,1900,40,25-29,1940,0.05903243619914881
SIM,1913,21,45-49,1934,1
SIM,1919,19,20-24,1938,132
STAT,1846,21,40-44,1867,1.8259448097811282
SIM,1854,21,40-44,1875,2
SIM,1895,7,na,1902,3263
STAT,1929,26,25-29,1955,77.85955213965094
SIM,1874,22,20-24,1896,67
SIM,1794,78,na,1872,289
SIM,1820,63,na,1883,912
STAT,1823,56,na,1879,1172.274315467018
STAT,1841,48,30-34,1889,0.06568306369404085
STAT,1936,16,15-19,1952,41.14022272357533
SIM,1848,23,30-34,1871,19
STAT,1861,4,na,1865,2403.3096711928074
SIM,1906,47,na,1953,3113
STAT,1862,23,50-100,1885,0.33398207062079877
STAT,1841,96,na,1937,5.874918767295347
STAT,1911,20,30-34,1931,25.89838775902757
STAT,1865,28,50-100,1893,0.5472076515612337
SIM,1944,16,15-19,1960,40
STAT,1871,94,na,1965,59.455498128408
STAT,1777,78,na,1855,268.32315
SIM,1908,40,40-44,1948,1
STAT,1815,50,20-24,1865,0.0017864804935563024
STAT,1858,54,35-39,1912,0.006209157297234046
SIM,1790,64,na,1854,727
SIM,1855,17,15-19,1872,4
SIM,1953,17,30-34,1970,15
SIM,1862,41,50-100,1903,1
SIM,1907,23,35-39,1930,6
STAT,1850,45,40-44,1895,0.12172678109175629
STAT,1906,46,25-29,1952,0.044822082335423404
STAT,1949,11,na,1960,4316.8945522004415
SIM,1938,19,30-34,1957,17
SIM,1919,42,45-49,1961,1
SIM,1928,39,40-44,1967,1
SIM,1865,38,40-44,1903,5
STAT,1955,12,na,1967,4925.886237430751
SIM,1917,31,30-34,1948,23
SIM,1824,37,40-44,1861,4
STAT,1901,27,45-49,1928,1.4681393332533519
STAT,1866,21,50-100,1887,0.3606706796420027
SIM,1836,62,na,1898,1162
STAT,1847,17,15-19,1864,5.449916183625016
STAT,1945,17,30-34,1962,12.578336990986989
SIM,1834,37,50-100,1871,1
STAT,1922,39,45-49,1961,0.731298777880161
SIM,1855,92,na,1947,27
SIM,1850,24,25-29,1874,60
SIM,1910,31,45-49,1941,1
STAT,1929,29,40-44,1958,5.505667753127543
STAT,1882,49,30-34,1931,0.08712550125569149
STAT,1819,53,50-100,1872,0.025284888922278304
STAT,1837,31,40-44,1868,3.4682768186396635
STAT,1832,92,na,1924,25.183673045126458
STAT,1833,77,na,1910,524.7638646066885
STAT,1950,22,50-100,1972,0.7374749597663124
SIM,1889,24,30-34,1913,27
STAT,1906,19,45-49,1925,0.08937633833618637
STAT,1848,52,25-29,1900,0.0025381651676539105
STAT,1861,24,35-39,1885,4.6356580648481405
SIM,1955,8,na,1963,4548
SIM,1911,21,na,1932,3477
STAT,1884,21,na,1905,2214.532555650803
STAT,1863,49,20-24,1912,0.009756902546862503
SIM,1930,21,45-49,1951,2
STAT,1949,19,40-44,1968,1.5358781282948757
STAT,1888,35,na,1923,2654.2651741123354
STAT,1905,34,15-19,1939,0.11067370265222214
STAT,1808,78,na,1886,334.6841554241298
SIM,1950,12,na,1962,4275
SIM,1917,7,na,1924,4006
STAT,1893,42,35-39,1935,2.1677981931948764
SIM,1908,35,45-49,1943,3
SIM,1937,29,40-44,1966,3
STAT,1955,16,25-29,1971,54.35743084359142
SIM,1888,17,na,1905,2739
SIM,1876,91,na,1967,154
STAT,1878,8,na,1886,2612.556578724628
STAT,1872,27,15-19,1899,0.43020179429651445
STAT,1932,34,35-39,1966,11.461727085297674
SIM,1857,40,na,1897,1861
STAT,1857,84,na,1941,247.7511706602739
STAT,1892,72,na,1964,1739.923532910337
STAT,1804,64,na,1868,863.569166326134
STAT,1902,41,35-39,1943,0.16839740540584242
STAT,1922,21,45-49,1943,1.2227202927028173
SIM,1868,40,na,1908,2104
STAT,1847,16,25-29,1863,5.2347980533246385
STAT,1887,22,40-44,1909,2.201536792501874
STAT,1883,16,35-39,1899,0.5092794841887155
SIM,1919,38,25-29,1957,1
STAT,1882,48,40-44,1930,0.1553981818996129
STAT,1822,43,15-19,1865,0.020278397291580926
SIM,1875,0,na,1875,3408
STAT,1903,21,35-39,1924,7.866757042739274
STAT,1864,28,30-34,1892,21.18650905552517
SIM,1930,17,25-29,1947,67
STAT,1922,28,na,1950,3990.7426217670586
SIM,1928,9,na,1937,4740
STAT,1911,38,30-34,1949,1.6543877725984375
STAT,1820,47,20-24,1867,0.01978624311207979
SIM,1888,4,na,1892,2856
STAT,1919,44,45-49,1963,0.16981503900856232
SIM,1845,31,40-44,1876,9
STAT,1894,20,na,1914,2891.203237407604
STAT,1838,50,50-100,1888,0.010659804634649729
STAT,1869,32,na,1901,2182.1306265071275
STAT,1927,26,15-19,1953,0.8136422748459727
STAT,1898,34,na,1932,3025.5515889212925
STAT,1920,15,50-100,1935,0.08004285813603843
SIM,1934,27,na,1961,4718
STAT,1857,102,na,1959,0.4388719390753095
STAT,1844,21,30-34,1865,15.725449940453796
SIM,1864,69,na,1933,1349
SIM,1913,37,30-34,1950,2
SIM,1900,34,50-100,1934,2
STAT,1900,47,45-49,1947,0.17365707627949417
SIM,1841,41,na,1882,1687
SIM,1849,21,na,1870,1912
STAT,1861,39,45-49,1900,1.5481044004784081
SIM,1863,22,45-49,1885,1
STAT,1849,39,45-49,1888,1.4400955114254252
STAT,1909,46,50-100,1955,0.19677703119288287
STAT,1821,40,40-44,1861,3.9867902150446306
SIM,1853,1,na,1854,2904
SIM,1896,17,25-29,1913,8
STAT,1884,25,50-100,1909,0.6012297064600785
STAT,1906,44,35-39,1950,0.17064331410704064
STAT,1922,17,25-29,1939,47.38203259031834
STAT,1898,39,40-44,1937,1.1961329638104305
SIM,1932,3,na,1935,4913
STAT,1864,25,15-19,1889,0.3871603304780236
STAT,1947,19,30-34,1966,12.962923572758264
SIM,1919,45,50-100,1964,3
STAT,1917,40,40-44,1957,0.24726398315214856
STAT,1854,39,na,1893,1679.4507821714321
SIM,1862,41,45-49,1903,2
SIM,1949,17,40-44,1966,2
STAT,1865,37,25-29,1902,2.4716319439740793
SIM,1878,26,20-24,1904,13
SIM,1911,21,35-39,1932,10
STAT,1814,63,na,1877,896.1831145459182
STAT,1906,16,40-44,1922,0.252221045627041
STAT,1779,96,na,1875,1.4968906471541334
SIM,1930,13,na,1943,4783
STAT,1802,78,na,1880,307.6093961633322
STAT,1900,25,25-29,1925,55.81592095597126
SIM,1917,46,50-100,1963,2
SIM,1939,20,15-19,1959,4
SIM,1860,44,na,1904,1908
SIM,1882,24,20-24,1906,62
STAT,1859,91,na,1950,43.68828140906915
SIM,1876,54,na,1930,2065
STAT,1937,22,50-100,1959,0.6052371012913579
STAT,1909,46,na,1955,3196.210241006402
STAT,1950,20,30-34,1970,32.23514116688419
STAT,1886,49,na,1935,2198.7335739141527
STAT,1882,35,na,1917,2186.3003994621326
STAT,1847,41,15-19,1888,0.010349536982565946
STAT,1811,93,na,1904,12.65895435701545
SIM,1871,87,na,1958,226
STAT,1923,28,35-39,1951,16.227991046727187
STAT,1952,15,45-49,1967,0.5658473078036125
SIM,1931,28,35-39,1959,21
SIM,1887,20,40-44,1907,2
STAT,1857,35,25-29,1892,2.164648860965573
STAT,1937,25,20-24,1962,16.821976208312652
SIM,1917,10,na,1927,3988
STAT,1927,29,30-34,1956,44.82393632492132
STAT,1885,16,45-49,1901,0.06163118980013599
STAT,1888,17,25-29,1905,6.324126494382101
STAT,1838,38,30-34,1876,4.340849990083052
STAT,1852,41,35-39,1893,1.3820314334916641
STAT,1912,50,na,1962,3304.580672303511
SIM,1946,12,na,1958,4073
STAT,1852,54,40-44,1906,0.007778660278421911
SIM,1898,16,20-24,1914,22
STAT,1797,77,na,1874,341.9728014086728
STAT,1913,20,40-44,1933,3.0956073469440817
STAT,1916,38,45-49,1954,0.6562155580001029
SIM,1877,31,50-100,1908,1
STAT,1831,29,30-34,1860,21.139018732430873
STAT,1792,99,na,1891,0.31892899614247844
STAT,1865,34,20-24,1899,2.30056024752711
STAT,1793,63,na,1856,842.7507204799999
STAT,1856,54,25-29,1910,0.0025486461380522032
SIM,1797,59,na,1856,1049
STAT,1830,96,na,1926,5.12925254446235
STAT,1877,72,na,1949,1238.0373168723584
STAT,1891,27,25-29,1918,49.463335904021584
STAT,1908,29,20-24,1937,16.181299520861234
STAT,1843,92,na,1935,30.048193974801233
STAT,1861,48,20-24,1909,0.009295436555107901
STAT,1865,41,20-24,1906,0.13694909785552625
SIM,1904,27,25-29,1931,56
STAT,1875,54,35-39,1929,0.008125650761505966
STAT,1869,31,50-100,1900,0.8412726252810525
SIM,1871,21,40-44,1892,8
STAT,1855,15,50-100,1870,0.041760118172355386
STAT,1820,49,25-29,1869,0.09222780354099358
SIM,1924,38,45-49,1962,3
SIM,1829,26,25-29,1855,35
STAT,1860,18,45-49,1878,0.05750062825240216
SIM,1850,18,na,1868,2032
STAT,1896,23,45-49,1919,0.8679382020193687
SIM,1859,33,35-39,1892,8
STAT,1891,49,45-49,1940,0.15241227196197465
SIM,1916,29,20-24,1945,19
SIM,1852,21,30-34,1873,21
STAT,1827,92,na,1919,23.113314065542603
STAT,1941,23,20-24,1964,108.51107920109008
SIM,1849,16,25-29,1865,7
STAT,1829,32,45-49,1861,1.7016995364128318
STAT,1953,16,15-19,1969,51.8788504293978
SIM,1935,29,30-34,1964,65
STAT,1880,48,30-34,1928,0.09501005177740744
STAT,1842,27,40-44,1869,2.6379945036550816
STAT,1863,21,40-44,1884,1.7776723178016371
STAT,1898,36,25-29,1934,3.699716540408468
SIM,1883,72,na,1955,1124
SIM,1893,25,35-39,1918,24
STAT,1867,31,15-19,1898,0.12683188107793278
STAT,1910,29,50-100,1939,0.9012452002222695
STAT,1877,52,40-44,1929,0.010265492575509435
SIM,1857,39,45-49,1896,1
STAT,1931,24,15-19,1955,6.4815294691340535
STAT,1941,31,na,1972,3753.1201530945887
SIM,1915,31,20-24,1946,2
SIM,1830,78,na,1908,482
STAT,1931,28,30-34,1959,47.766804563057235
STAT,1897,49,na,1946,2783.6519807767863
SIM,1837,32,45-49,1869,1
STAT,1905,37,30-34,1942,1.5703963574969804
SIM,1832,36,25-29,1868,2
STAT,1849,17,25-29,1866,5.027726830761488
SIM,1934,34,35-39,1968,16
STAT,1813,78,na,1891,330.44703240924514
SIM,1857,17,25-29,1874,5
STAT,1824,36,25-29,1860,4.540908473778391
STAT,1926,34,35-39,1960,10.426499758769694
STAT,1789,95,na,1884,2.336703421288627
STAT,1893,35,na,1928,2850.7310005744603
STAT,1868,68,na,1936,1378.3990895803151
SIM,1937,23,20-24,1960,92
STAT,1885,25,35-39,1910,9.142983306705043
STAT,1911,34,15-19,1945,0.11717418261258304
STAT,1932,31,30-34,1963,19.797758270175297
STAT,1862,41,40-44,1903,1.8207529331796712
STAT,1934,26,50-100,1960,1.26547595974619
SIM,1850,27,40-44,1877,2
SIM,1867,32,30-34,1899,23
SIM,1923,33,20-24,1956,2
STAT,1926,39,50-100,1965,0.483763205639944
STAT,1930,38,40-44,1968,1.8428620627050956
STAT,1917,42,45-49,1959,0.1640709571215742
SIM,1932,30,30-34,1962,26
STAT,1899,15,35-39,1914,0.713666713647101
STAT,1953,19,30-34,1972,13.920107640489357
STAT,1932,36,25-29,1968,1.2509193585041751
STAT,1879,39,50-100,1918,1.2001112053156533
STAT,1932,27,na,1959,4635.40514941987
SIM,1904,32,50-100,1936,1
SIM,1869,20,35-39,1889,6
STAT,1942,28,45-49,1970,1.7120327950012808
SIM,1858,41,40-44,1899,5
SIM,1837,25,20-24,1862,12
SIM,1886,35,45-49,1921,2
STAT,1769,108,na,1877,0.004212107048097254
STAT,1861,73,na,1934,931.7642382011907
STAT,1907,31,20-24,1938,2.162283124851403
STAT,1863,30,50-100,1893,0.7669786759416165
STAT,1865,87,na,1952,151.2414837023791
STAT,1833,49,35-39,1882,0.08850808966568338
SIM,1826,34,35-39,1860,7
SIM,1892,41,30-34,1933,3
STAT,1890,41,50-100,1931,1.2257517227101455
STAT,1862,58,na,1920,1593.6228670374537
SIM,1941,21,20-24,1962,99
SIM,1963,1,na,1964,4686
STAT,1888,42,15-19,1930,0.015392935494487718
SIM,1816,74,na,1890,432
SIM,1929,27,40-44,1956,6
STAT,1850,26,25-29,1876,35.29890494042576
SIM,1833,21,20-24,1854,61
STAT,1901,9,na,1910,3430.849491296367
STAT,1918,32,35-39,1950,9.173496811380494
SIM,1903,15,15-19,1918,7
SIM,1940,31,30-34,1971,27
STAT,1887,38,15-19,1925,0.05903283686337224
SIM,1898,18,25-29,1916,8
SIM,1921,20,40-44,1941,3
STAT,1930,23,45-49,1953,1.357565053806185
STAT,1781,78,na,1859,265.8327682088068
STAT,1931,27,30-34,1958,47.78974364000445
SIM,1819,44,45-49,1863,3
STAT,1851,36,na,1887,1764.4044913121952
STAT,1801,106,na,1907,0.004620151044879309
SIM,1839,100,na,1939,1
STAT,1844,18,na,1862,2036.3281253812927
STAT,1863,44,15-19,1907,0.01131307537215111
SIM,1945,25,20-24,1970,18
STAT,1874,46,40-44,1920,0.16576831258669797
SIM,1846,38,30-34,1884,4
STAT,1844,15,45-49,1859,0.05898490468327257
STAT,1869,52,45-49,1921,0.013200038693300997
STAT,1922,36,40-44,1958,1.6107526964196057
SIM,1846,40,na,1886,1693
STAT,1859,32,30-34,1891,13.163309499056847
SIM,1824,93,na,1917,13
STAT,1842,59,na,1901,1383.965279493353
STAT,1829,25,20-24,1854,33.65937438553144
SIM,1926,32,35-39,1958,15
SIM,1849,15,25-29,1864,7
SIM,1865,91,na,1956,46
SIM,1905,16,15-19,1921,9
SIM,1876,15,30-34,1891,2
STAT,1877,23,35-39,1900,5.702943469774334
STAT,1885,86,na,1971,493.6819354462489
STAT,1841,43,25-29,1884,0.45073653802325697
STAT,1851,50,50-100,1901,0.011234248213524539
STAT,1896,16,20-24,1912,22.18900555008906
STAT,1915,33,20-24,1948,2.3366778035808746
STAT,1834,53,35-39,1887,0.005356892153883372
STAT,1840,74,na,1914,772.8753046273746
SIM,1925,42,45-49,1967,1
SIM,1866,17,na,1883,2321
STAT,1881,72,na,1953,1151.9419820317673
STAT,1844,88,na,1932,96.37434071866608
STAT,1840,39,25-29,1879,2.3228240734163244
STAT,1871,20,25-29,1891,53.93288844150337
SIM,1887,39,50-100,1926,1
STAT,1859,26,45-49,1885,0.8576919143913235
STAT,1897,71,na,1968,2009.247930873761
SIM,1913,38,30-34,1951,2
SIM,1885,23,35-39,1908,4
SIM,1846,18,na,1864,2041
SIM,1910,4,na,1914,3689
STAT,1880,31,45-49,1911,1.7404401004768106
STAT,1895,40,40-44,1935,2.8008864072134503
STAT,1850,48,45-49,1898,0.1640569348699151
STAT,1849,15,20-24,1864,15.916337801949487
SIM,1925,13,na,1938,4419
SIM,1842,28,45-49,1870,1
STAT,1859,54,na,1913,1578.6855792511233
STAT,1952,16,50-100,1968,0.4242793844824962
STAT,1815,53,25-29,1868,0.008074791082577332
STAT,1863,21,na,1884,2017.594589567465
STAT,1877,20,30-34,1897,17.56586991799964
STAT,1855,22,45-49,1877,0.5769612986595473
STAT,1878,35,45-49,1913,1.979118635604044
STAT,1911,23,35-39,1934,8.408182574361753
STAT,1842,22,na,1864,1920.4316674119882
SIM,1889,27,35-39,1916,16
SIM,1889,38,50-100,1927,1
STAT,1933,21,20-24,1954,139.75872930965178
STAT,1905,48,50-100,1953,0.1867506782358102
STAT,1868,15,30-34,1883,1.481058686056785
STAT,1904,48,40-44,1952,0.12919273270673284
STAT,1924,38,40-44,1962,1.666063659054257
STAT,1845,110,na,1955,1.946473937693234E-4
SIM,1922,15,25-29,1937,60
STAT,1857,38,40-44,1895,3.24397828029794
STAT,1924,30,30-34,1954,17.444691606278692
SIM,1897,53,na,1950,2704
SIM,1941,15,35-39,1956,4
SIM,1932,38,40-44,1970,2
SIM,1905,38,35-39,1943,6
STAT,1832,30,15-19,1862,0.1152340016857248
STAT,1834,52,50-100,1886,0.009585490825071607
STAT,1836,22,35-39,1858,4.86332830581193
STAT,1905,38,30-34,1943,1.5626071915637956
STAT,1858,51,30-34,1909,0.004435709109569748
STAT,1831,26,15-19,1857,0.40990721163166705
SIM,1889,33,20-24,1922,1
STAT,1842,81,na,1923,385.08520986527276
STAT,1909,22,40-44,1931,2.9514089910387042
SIM,1844,22,35-39,1866,5
STAT,1882,44,25-29,1926,0.5823349175839045
SIM,1870,41,40-44,1911,4
STAT,1935,23,50-100,1958,0.8461471725336996
STAT,1854,18,50-100,1872,0.04195325576940178
SIM,1907,32,na,1939,3387
STAT,1860,52,25-29,1912,0.002704937818267333
STAT,1879,16,45-49,1895,0.06465995389502674
STAT,1944,12,na,1956,3993.398883215546
STAT,1787,99,na,1886,0.355108853188677
STAT,1879,39,30-34,1918,5.209630394071773
SIM,1900,23,25-29,1923,74
STAT,1912,27,20-24,1939,16.98966732263695
SIM,1867,35,35-39,1902,14
STAT,1933,15,35-39,1948,5.331182653904985
SIM,1831,63,na,1894,1083
STAT,1838,35,15-19,1873,0.047184113335521326
STAT,1934,19,20-24,1953,172.30444831617731
STAT,1812,56,na,1868,1127.3345768225472
SIM,1783,78,na,1861,280
SIM,1942,19,20-24,1961,124
STAT,1861,20,40-44,1881,1.7037686019217526
SIM,1921,31,20-24,1952,2
SIM,1913,48,50-100,1961,2
SIM,1917,22,40-44,1939,3
STAT,1807,93,na,1900,10.483581802288883
SIM,1857,15,20-24,1872,19
SIM,1887,39,30-34,1926,4
SIM,1910,36,na,1946,3327
SIM,1821,40,45-49,1861,4
SIM,1825,78,na,1903,367
STAT,1834,28,45-49,1862,0.8947293869111308
STAT,1925,42,40-44,1967,0.2861111403538991
STAT,1908,18,40-44,1926,0.25558145243445907
SIM,1920,27,20-24,1947,20
STAT,1809,73,na,1882,544.9796811681114
SIM,1914,28,35-39,1942,17
STAT,1843,40,30-34,1883,0.8761615099451237
STAT,1889,30,na,1919,2805.4586294150313
STAT,1843,22,50-100,1865,0.36928445851990205
SIM,1842,26,na,1868,1858
STAT,1822,77,na,1899,446.4870197974118
STAT,1852,46,40-44,1898,0.1304423272100228
SIM,1850,45,na,1895,1675
SIM,1947,22,15-19,1969,5
SIM,1853,30,25-29,1883,14
STAT,1910,17,45-49,1927,0.09348042282314385
STAT,1938,19,40-44,1957,1.3024157306900739
STAT,1828,51,45-49,1879,0.012040012226252166
STAT,1928,43,20-24,1971,0.021237079910581096
STAT,1889,45,25-29,1934,0.06784699542849738
SIM,1899,42,40-44,1941,1
SIM,1835,40,na,1875,1608
SIM,1837,41,na,1878,1607
STAT,1829,44,15-19,1873,0.011268240366817013
STAT,1868,29,15-19,1897,0.4063044327344098
STAT,1921,49,50-100,1970,0.23948263362899055
STAT,1827,48,50-100,1875,0.2123343459965892
STAT,1941,25,35-39,1966,14.683692439567308
STAT,1861,31,35-39,1892,7.976912954518853
SIM,1857,36,40-44,1893,2
SIM,1860,37,50-100,1897,2
STAT,1909,38,15-19,1947,0.017081715269597807
STAT,1887,37,15-19,1924,0.059327099275780094
SIM,1855,101,na,1956,1
STAT,1835,30,40-44,1865,3.517150891384773
STAT,1894,5,na,1899,3184.6530269213013
SIM,1791,70,na,1861,588
STAT,1839,93,na,1932,19.486677255610992
SIM,1857,18,25-29,1875,5
SIM,1871,17,na,1888,2435
SIM,1900,22,35-39,1922,7
STAT,1759,97,na,1856,0.37476435239999994
STAT,1895,42,45-49,1937,0.12796684903685115
STAT,1834,62,na,1896,1131.2858580802226
SIM,1863,95,na,1958,19
SIM,1834,43,35-39,1877,2
SIM,1858,35,na,1893,1919
SIM,1851,40,30-34,1891,4
STAT,1842,28,40-44,1870,2.6190537031188375
STAT,1870,34,40-44,1904,3.979996757350755
STAT,1901,19,45-49,1920,0.08591188414108099
STAT,1841,41,20-24,1882,0.11436569589459031
STAT,1780,98,na,1878,0.4860181283103475
STAT,1873,31,15-19,1904,0.1371139581535763
SIM,1810,80,na,1890,225
SIM,1898,65,na,1963,2366
STAT,1893,34,35-39,1927,12.034538829275236
STAT,1843,23,na,1866,1922.3311198450579
STAT,1913,49,45-49,1962,0.1991798295992891
STAT,1849,18,25-29,1867,4.998113519728303
STAT,1903,17,50-100,1920,0.06584670440288509
STAT,1894,34,50-100,1928,1.1039073314971009
STAT,1827,86,na,1913,123.13003828254217
SIM,1851,62,na,1913,1353
STAT,1921,48,40-44,1969,0.16745320772140937
SIM,1850,28,40-44,1878,2
STAT,1880,47,30-34,1927,0.09577046930367861
STAT,1900,21,30-34,1921,23.415071082485422
SIM,1884,67,na,1951,1501
STAT,1947,17,40-44,1964,1.4885458249963381
SIM,1913,2,na,1915,3789
STAT,1944,26,15-19,1970,0.7211060881805941
STAT,1834,51,30-34,1885,0.0038535631380552863
STAT,1835,41,35-39,1876,1.3712208158045227
STAT,1942,26,na,1968,3715.8241589703352
SIM,1946,19,40-44,1965,1
SIM,1905,52,na,1957,2918
STAT,1935,28,15-19,1963,0.9086021474497465
STAT,1826,43,35-39,1869,1.751009538731063
STAT,1877,35,na,1912,2331.5390114362494
SIM,1808,76,na,1884,351
SIM,1899,20,20-24,1919,89
SIM,1874,32,25-29,1906,9
STAT,1844,47,45-49,1891,0.1649017851211853
STAT,1855,29,50-100,1884,0.4654759888818583
STAT,1921,17,20-24,1938,146.00362516885966
STAT,1917,43,45-49,1960,0.16381172500932217
STAT,1856,73,na,1929,878.8110527368442
STAT,1831,38,na,1869,1625.4147740616243
SIM,1922,27,30-34,1949,58
STAT,1854,60,na,1914,1373.3490716393148
STAT,1855,34,15-19,1889,0.10058389999811476
STAT,1857,42,25-29,1899,0.4776581489662479
SIM,1764,96,na,1860,2
STAT,1913,27,25-29,1940,61.94246343384534
STAT,1934,35,45-49,1969,0.8902412322554206
STAT,1923,48,50-100,1971,0.2492842993244372
SIM,1939,16,30-34,1955,11
STAT,1833,33,25-29,1866,7.948583196182655
SIM,1843,30,40-44,1873,3
SIM,1904,32,20-24,1936,2
STAT,1817,50,30-34,1867,0.013276935786757836
STAT,1845,21,50-100,1866,0.3591687033171497
STAT,1822,55,na,1877,1174.4378075625775
STAT,1850,30,20-24,1880,2.2334728129971713
SIM,1811,43,40-44,1854,6
SIM,1921,27,25-29,1948,70
STAT,1879,20,40-44,1899,2.0698966289276797
STAT,1864,60,na,1924,1610.2523264398728
SIM,1884,57,na,1941,1952
STAT,1831,25,15-19,1856,0.42542940674422425
SIM,1816,47,50-100,1863,3
STAT,1806,108,na,1914,6.09503309135291E-4
STAT,1914,27,30-34,1941,37.30881761408741
STAT,1826,30,15-19,1856,0.2149196455304268
SIM,1867,1,na,1868,3002
STAT,1938,19,50-100,1957,0.3488612716004845
STAT,1881,34,50-100,1915,0.8285925236037265
STAT,1917,49,na,1966,3603.669808717073
STAT,1930,24,20-24,1954,133.7341306892847
STAT,1864,29,30-34,1893,21.109390162563074
STAT,1914,23,50-100,1937,0.6329891862310053
SIM,1896,52,na,1948,2711
SIM,1866,38,na,1904,2066
STAT,1932,18,35-39,1950,5.235380558763689
STAT,1878,20,35-39,1898,5.773159257844227
STAT,1862,52,35-39,1914,0.006900573689434049
STAT,1881,40,na,1921,2129.4557606879935
STAT,1845,30,25-29,1875,8.758321432539159
STAT,1954,11,na,1965,4588.067261414601
SIM,1821,58,na,1879,1106
SIM,1885,19,15-19,1904,4
SIM,1907,6,na,1913,3686
STAT,1800,107,na,1907,0.0018798145591695664
STAT,1943,9,na,1952,3953.4424240230514
SIM,1920,15,15-19,1935,50
STAT,1839,51,20-24,1890,4.943782101990543E-4
STAT,1820,35,40-44,1855,11.671095898892208
STAT,1884,41,30-34,1925,1.0781172114701936
STAT,1750,110,na,1860,0.060566632513093466
STAT,1815,51,20-24,1866,0.0017510377715818694
STAT,1879,36,na,1915,2337.5643727407223
SIM,1818,46,50-100,1864,1
STAT,1900,35,50-100,1935,1.624348309921385
SIM,1940,18,35-39,1958,6
STAT,1902,48,30-34,1950,0.07187957502253006
SIM,1923,35,35-39,1958,6
STAT,1890,49,na,1939,2544.8425914237473
STAT,1833,46,30-34,1879,0.06988524175600458
STAT,1935,30,45-49,1965,2.0588463832480106
SIM,1876,38,na,1914,2324
SIM,1900,26,40-44,1926,4
STAT,1939,22,15-19,1961,5.049749396552545
STAT,1932,32,30-34,1964,19.786275570378592
STAT,1919,19,30-34,1938,12.656423206334262
STAT,1849,36,40-44,1885,3.262369662258237
STAT,1815,41,50-100,1856,3.1261873623197185
STAT,1816,43,na,1859,1438.163761191563
STAT,1831,47,35-39,1878,0.10293330374007678
STAT,1912,15,15-19,1927,8.707731559978868
STAT,1915,35,35-39,1950,2.3299952372252504
STAT,1845,52,45-49,1897,0.010167855334847703
STAT,1838,54,50-100,1892,0.010017400645616707
STAT,1927,38,20-24,1965,0.30934095164886455
SIM,1875,44,35-39,1919,1
STAT,1829,28,25-29,1857,51.80449167206144
SIM,1831,23,15-19,1854,2
SIM,1833,43,na,1876,1515
SIM,1858,44,35-39,1902,1
SIM,1932,33,35-39,1965,13
STAT,1874,31,20-24,1905,2.620554103676027
STAT,1841,51,50-100,1892,0.010382614328546097
STAT,1882,42,20-24,1924,0.14580915449113874
SIM,1910,24,45-49,1934,2
STAT,1809,51,35-39,1860,0.030456409311267352
STAT,1918,50,na,1968,3659.8924929468335
STAT,1809,89,na,1898,44.13114380475365
SIM,1817,40,40-44,1857,7
STAT,1857,39,40-44,1896,3.227336671720011
STAT,1784,70,na,1854,517.0
SIM,1915,33,35-39,1948,11
STAT,1839,61,na,1900,1245.9540730551855
SIM,1929,17,15-19,1946,53
STAT,1835,54,40-44,1889,0.006434124393156691
STAT,1807,88,na,1895,49.2456582290027
STAT,1834,25,40-44,1859,2.466704789806539
STAT,1908,39,50-100,1947,0.36753300471712536
SIM,1814,88,na,1902,47
STAT,1844,33,50-100,1877,0.7612294671028356
SIM,1840,29,50-100,1869,1
SIM,1930,22,20-24,1952,118
STAT,1867,44,35-39,1911,1.5845121095522632
STAT,1876,42,35-39,1918,1.763831671795179
SIM,1838,18,15-19,1856,3
STAT,1872,48,35-39,1920,0.1310803356809711
SIM,1889,82,na,1971,916
STAT,1907,37,40-44,1944,1.3109420249927433
STAT,1848,44,25-29,1892,0.45638046971265506
STAT,1896,19,25-29,1915,7.037150715540594
STAT,1840,23,15-19,1863,2.900752607005881
STAT,1854,104,na,1958,0.08599357690830634
STAT,1884,15,na,1899,2368.708105956561
STAT,1920,17,15-19,1937,48.10376787574693
SIM,1830,25,na,1855,1799
SIM,1837,28,25-29,1865,38
SIM,1882,31,20-24,1913,2
STAT,1807,102,na,1909,0.10516621311004416
SIM,1929,39,35-39,1968,8
SIM,1846,93,na,1939,29
STAT,1896,48,20-24,1944,0.008345122982014787
STAT,1891,43,15-19,1934,0.016031277610811193
STAT,1907,33,35-39,1940,8.03402039115181
STAT,1850,47,45-49,1897,0.16536997245117754
SIM,1843,41,35-39,1884,7
STAT,1928,38,25-29,1966,1.1744477747857132
STAT,1892,18,na,1910,2979.9811331364754
SIM,1867,42,35-39,1909,4
SIM,1906,35,35-39,1941,7
STAT,1885,32,50-100,1917,0.8623514030786315
STAT,1898,4,na,1902,3364.1943413806607
SIM,1826,95,na,1921,11
STAT,1772,85,na,1857,69.43843382676701
STAT,1904,34,20-24,1938,2.08481263247209
SIM,1884,31,40-44,1915,6
SIM,1912,34,20-24,1946,4
STAT,1897,65,na,1962,2295.9202057803327
SIM,1900,37,na,1937,3085
STAT,1879,68,na,1947,1508.9912840493694
STAT,1876,31,40-44,1907,4.246690205695219
SIM,1946,17,15-19,1963,43
STAT,1846,32,50-100,1878,0.7634339444485355
STAT,1938,17,15-19,1955,42.28706484847241
STAT,1859,42,35-39,1901,1.3635361500161658
STAT,1885,45,40-44,1930,0.16273630229400107
STAT,1935,6,na,1941,5175.967906099354
SIM,1919,17,30-34,1936,19
STAT,1820,46,20-24,1866,0.020078806377625012
STAT,1897,39,50-100,1936,0.331432267914301
SIM,1920,19,20-24,1939,134
STAT,1830,45,50-100,1875,0.18471645041773482
SIM,1922,36,50-100,1958,1
STAT,1818,54,40-44,1872,0.02072722662548151
STAT,1899,20,50-100,1919,0.5310808935500388
STAT,1874,26,50-100,1900,0.6197627602428658
STAT,1913,32,20-24,1945,2.2920450131883743
STAT,1912,19,20-24,1931,25.753812003166065
STAT,1860,15,40-44,1875,0.1638805448926066
STAT,1925,19,50-100,1944,0.425311890154892
SIM,1834,92,na,1926,20
STAT,1886,31,25-29,1917,10.265170000041005
SIM,1936,17,30-34,1953,11
SIM,1905,30,na,1935,3304
SIM,1957,12,na,1969,4694
STAT,1854,41,45-49,1895,1.0825983880920884
STAT,1951,8,na,1959,4421.415522132714
SIM,1901,31,40-44,1932,9
STAT,1936,28,20-24,1964,16.492317166619397
STAT,1784,80,na,1864,200.3788226661095
SIM,1898,19,25-29,1917,9
STAT,1846,45,50-100,1891,0.17489218371694049
STAT,1906,65,na,1971,2657.5714180263153
SIM,1884,42,35-39,1926,3
STAT,1839,71,na,1910,890.0078147838487
STAT,1875,52,30-34,1927,0.005746420743353135
STAT,1818,41,35-39,1859,4.518258086935876
STAT,1909,40,45-49,1949,0.14868655176967807
STAT,1929,17,50-100,1946,0.45172071559462834
STAT,1929,28,na,1957,4427.2455059816275
SIM,1867,7,na,1874,2422
SIM,1842,25,40-44,1867,2
STAT,1827,76,na,1903,525.7610180597406
SIM,1837,21,40-44,1858,5
SIM,1905,62,na,1967,2690
STAT,1856,52,20-24,1908,5.430755752888287E-4
SIM,1873,73,na,1946,1086
SIM,1841,30,20-24,1871,2
SIM,1941,23,35-39,1964,10
STAT,1857,28,50-100,1885,0.48718785945253185
STAT,1885,32,35-39,1917,9.531385504933546
STAT,1877,29,na,1906,2322.828053676745
SIM,1842,20,na,1862,1876
SIM,1884,5,na,1889,2572
STAT,1882,7,na,1889,2408.58865441911
STAT,1918,36,15-19,1954,0.019212892256558582
STAT,1896,35,15-19,1931,0.07077662964704841
STAT,1830,41,45-49,1871,1.1541817550471283
STAT,1879,35,15-19,1914,0.05597541992723783
STAT,1823,32,50-100,1855,2.4463695208300895
STAT,1854,17,na,1871,1977.3043151006782
STAT,1919,48,25-29,1967,0.054201844854454145
SIM,1855,60,na,1915,1461
STAT,1868,18,35-39,1886,0.5009161649091998
STAT,1928,17,30-34,1945,14.510261512099033
SIM,1852,46,50-100,1898,2
SIM,1894,31,25-29,1925,14
STAT,1840,36,20-24,1876,0.6415683682210909
SIM,1915,37,40-44,1952,3
STAT,1819,40,25-29,1859,1.3481015110065537
STAT,1900,24,35-39,1924,7.600041759331515
STAT,1826,37,50-100,1863,1.330581459718175
SIM,1893,32,35-39,1925,18
STAT,1922,22,20-24,1944,120.47107572993015
STAT,1834,40,na,1874,1609.5011423762548
STAT,1861,47,20-24,1908,0.009369833029361023
SIM,1860,23,na,1883,2043
STAT,1842,75,na,1917,733.0929010240769
SIM,1935,26,15-19,1961,4
SIM,1826,41,35-39,1867,1
STAT,1819,73,na,1892,593.1482242131923
STAT,1891,48,45-49,1939,0.1537064805280206
STAT,1908,45,45-49,1953,0.18836977968596416
STAT,1911,41,50-100,1952,0.1065129723322323
STAT,1913,44,15-19,1957,0.0014097200648680948
STAT,1824,40,20-24,1864,0.2113811356331818
SIM,1869,68,na,1937,1342
SIM,1846,39,30-34,1885,5
STAT,1838,39,30-34,1877,4.296009009685494
SIM,1878,29,25-29,1907,43
STAT,1929,40,50-100,1969,0.1441334300265778
SIM,1900,15,na,1915,3295
SIM,1775,86,na,1861,56
STAT,1860,88,na,1948,105.40080447564623
STAT,1891,31,20-24,1922,3.173621406911459
SIM,1825,56,na,1881,1147
STAT,1924,33,35-39,1957,10.066595946229933
SIM,1898,15,20-24,1913,15
STAT,1847,90,na,1937,58.009998393333795
SIM,1786,81,na,1867,146
STAT,1908,42,40-44,1950,0.21856366036640804
STAT,1943,28,50-100,1971,1.0009071341013651
STAT,1811,61,na,1872,994.0199496315777
STAT,1831,44,30-34,1875,0.8527224002353805
STAT,1881,37,20-24,1918,0.7031251702222354
STAT,1913,46,40-44,1959,0.1457030252207063
STAT,1903,40,50-100,1943,0.09959612525010587
SIM,1826,73,na,1899,609
SIM,1934,33,45-49,1967,2
SIM,1788,82,na,1870,140
SIM,1850,23,25-29,1873,56
STAT,1860,41,30-34,1901,0.8866627749917118
STAT,1861,40,25-29,1901,0.5088402969861106
STAT,1930,36,15-19,1966,0.023685670607267586
STAT,1875,26,40-44,1901,2.917285781901866
SIM,1867,20,25-29,1887,44
STAT,1823,40,15-19,1863,0.01894867021692348
STAT,1903,29,20-24,1932,15.654765343898491
SIM,1829,39,30-34,1868,3
STAT,1846,41,na,1887,1670.5860270455203
SIM,1932,25,35-39,1957,20
SIM,1806,59,na,1865,1018
SIM,1929,19,40-44,1948,1
STAT,1893,31,30-34,1924,21.01301988802476
STAT,1843,43,35-39,1886,1.3279852495515454
STAT,1922,6,na,1928,4382.3593674330195
STAT,1925,45,45-49,1970,0.24999869670402322
STAT,1900,37,40-44,1937,1.2383046482937365
SIM,1886,16,na,1902,2471
STAT,1826,40,30-34,1866,1.1757512668532193
STAT,1926,33,45-49,1959,1.7965866649623852
STAT,1872,73,na,1945,1126.2298089699043
STAT,1811,45,40-44,1856,0.5900078749132965
STAT,1941,22,30-34,1963,28.05685878589411
STAT,1951,18,45-49,1969,0.5618087873982722
STAT,1852,59,na,1911,1476.5903180645744
STAT,1837,46,15-19,1883,2.654993936287433E-4
STAT,1891,45,40-44,1936,0.11404696255269214
STAT,1882,45,15-19,1927,3.713655271216801E-4
STAT,1877,15,35-39,1892,0.5404080921513507
STAT,1963,0,na,1963,4752.51004551814
STAT,1820,43,40-44,1863,3.93510283965269
STAT,1839,54,25-29,1893,0.0022967697721058954
STAT,1874,47,30-34,1921,0.09302772091365732
STAT,1931,15,25-29,1946,53.834578130774716
SIM,1896,36,na,1932,3013
STAT,1879,52,na,1931,2114.788497268914
SIM,1845,41,45-49,1886,3
STAT,1814,46,20-24,1860,0.0330875564685655
STAT,1824,54,40-44,1878,0.011447310893679346
SIM,1908,8,na,1916,3572
STAT,1836,40,25-29,1876,0.4949307377770066
STAT,1761,103,na,1864,0.0317198163668828
STAT,1853,51,40-44,1904,0.007844742708512101
STAT,1901,16,40-44,1917,0.24244431639553402
STAT,1859,20,25-29,1879,49.92176753885473
STAT,1924,25,35-39,1949,16.627636162041664
STAT,1892,56,na,1948,2412.900883552756
STAT,1911,49,25-29,1960,0.047152130623342746
STAT,1929,38,30-34,1967,2.208365134004966
STAT,1938,27,na,1965,3505.658433308558
SIM,1878,22,40-44,1900,3
STAT,1852,30,40-44,1882,3.4830822059910393
SIM,1864,90,na,1954,66
SIM,1920,5,na,1925,4170
STAT,1858,39,50-100,1897,0.9013663095440948
SIM,1843,75,na,1918,703
SIM,1900,29,45-49,1929,3
STAT,1880,49,na,1929,2189.6451468697837
SIM,1855,17,na,1872,2221
SIM,1903,19,20-24,1922,29
SIM,1923,32,30-34,1955,22
STAT,1848,70,na,1918,1010.8076763755691
SIM,1852,44,40-44,1896,7
STAT,1850,33,25-29,1883,7.465315845926609
SIM,1920,51,na,1971,3707
STAT,1883,32,25-29,1915,9.483290483664419
STAT,1878,47,15-19,1925,3.915467178852317E-4
SIM,1941,27,40-44,1968,4
SIM,1876,22,30-34,1898,28
SIM,1901,34,45-49,1935,1
STAT,1932,35,35-39,1967,3.0754807232566077
STAT,1855,18,25-29,1873,4.745405771968053
STAT,1877,31,50-100,1908,0.9018817302495413
STAT,1904,46,15-19,1950,3.065608872959051E-4
STAT,1851,18,40-44,1869,0.16211194733722772
SIM,1860,30,40-44,1890,5
STAT,1933,27,40-44,1960,5.846678125443433
STAT,1871,42,45-49,1913,1.399942875550932
SIM,1921,24,20-24,1945,111
SIM,1938,17,40-44,1955,1
STAT,1834,56,na,1890,1262.4444964492254
STAT,1811,49,20-24,1860,0.03860345250253077
SIM,1884,34,35-39,1918,9
SIM,1857,18,na,1875,2179
SIM,1863,18,25-29,1881,3
STAT,1809,100,na,1909,0.4459784791439165
STAT,1923,46,25-29,1969,0.05877280956246738
STAT,1848,16,50-100,1864,0.044012491814533275
STAT,1858,41,15-19,1899,0.010288120232557207
STAT,1915,32,30-34,1947,15.15713643057656
STAT,1844,44,40-44,1888,1.576260903494066
STAT,1855,47,20-24,1902,0.008459219788124858
SIM,1841,62,na,1903,1264
STAT,1897,55,na,1952,2612.3810926520177
SIM,1859,25,35-39,1884,11
SIM,1928,36,25-29,1964,1
STAT,1876,34,35-39,1910,9.79191735151351
STAT,1864,41,15-19,1905,0.011712545557444677
STAT,1878,42,45-49,1920,1.470062443259919
STAT,1899,33,50-100,1932,1.1811781399946149
STAT,1817,53,35-39,1870,0.01808413716242387
STAT,1926,26,na,1952,4257.445304632623
STAT,1804,51,45-49,1855,0.044030260208489894
SIM,1891,32,25-29,1923,21
STAT,1826,40,40-44,1866,2.3003061601722607
STAT,1862,30,25-29,1892,8.3202239112157
STAT,1829,93,na,1922,17.913665445108233
STAT,1868,22,30-34,1890,16.066270296991725
STAT,1926,38,15-19,1964,0.022151195761777466
SIM,1945,7,na,1952,3948
STAT,1885,48,45-49,1933,0.2193274044295403
STAT,1918,34,50-100,1952,0.8228655656025083
STAT,1816,41,25-29,1857,2.001779907534911
STAT,1914,20,na,1934,3554.819394707291
SIM,1818,44,na,1862,1315
SIM,1883,22,25-29,1905,61
STAT,1835,39,50-100,1874,0.9275750959276273
STAT,1861,44,40-44,1905,1.7406869017675284
STAT,1843,101,na,1944,0.4116794644028145
STAT,1870,72,na,1942,1169.0232849588422
SIM,1883,26,40-44,1909,4
SIM,1817,43,35-39,1860,6
SIM,1835,44,50-100,1879,3
STAT,1905,44,50-100,1949,0.09879893887592099
STAT,1842,23,25-29,1865,51.047904601150606
SIM,1893,34,na,1927,2944
SIM,1926,34,50-100,1960,4
STAT,1913,24,20-24,1937,105.386387190116
SIM,1856,61,na,1917,1449
SIM,1886,42,45-49,1928,3
SIM,1911,29,20-24,1940,16
STAT,1931,21,50-100,1952,0.808659197785504
SIM,1879,19,15-19,1898,7
SIM,1830,30,45-49,1860,2
STAT,1818,56,na,1874,1156.6217727508918
STAT,1860,72,na,1932,969.5997801184666
STAT,1859,38,na,1897,1767.4189196800187
STAT,1928,35,20-24,1963,0.3152986170937346
STAT,1936,19,30-34,1955,10.963037681659756
SIM,1835,56,na,1891,1304
SIM,1866,15,25-29,1881,7
SIM,1874,29,40-44,1903,2
STAT,1861,23,35-39,1884,4.66918279733299
SIM,1915,30,30-34,1945,15
STAT,1910,43,35-39,1953,0.17865103581323138
STAT,1812,50,40-44,1862,0.03448470754508013
STAT,1843,35,50-100,1878,1.0557473480877844
STAT,1925,28,45-49,1953,1.921109313062524
STAT,1832,51,20-24,1883,4.746720268389357E-4
SIM,1933,28,45-49,1961,3
STAT,1877,67,na,1944,1554.0159544905875
STAT,1850,44,40-44,1894,1.5621211884685606
STAT,1902,13,na,1915,3437.5308227249666
STAT,1884,44,35-39,1928,1.667648463504742
SIM,1913,25,25-29,1938,62
SIM,1800,80,na,1880,211
STAT,1824,62,na,1886,1004.4717722821492
SIM,1944,19,30-34,1963,16
STAT,1824,43,25-29,1867,0.7919744046985046
SIM,1803,94,na,1897,9
STAT,1898,13,na,1911,3297.463222768201
SIM,1878,40,45-49,1918,1
STAT,1843,30,15-19,1873,0.12610604424740254
SIM,1943,26,na,1969,3675
SIM,1891,24,25-29,1915,81
SIM,1868,20,30-34,1888,17
SIM,1847,41,na,1888,1655
STAT,1824,53,50-100,1877,0.01675197249354713
STAT,1891,34,25-29,1925,11.874206004612994
STAT,1842,31,25-29,1873,8.903166421465533
SIM,1825,49,50-100,1874,1
STAT,1863,36,15-19,1899,0.0468559508733471
STAT,1867,41,30-34,1908,1.024370432064014
STAT,1895,48,na,1943,2739.262014592294
SIM,1831,46,50-100,1877,3
SIM,1901,32,na,1933,3197
SIM,1867,18,na,1885,2230
STAT,1842,91,na,1933,41.26536962003776
STAT,1947,4,na,1951,4232.623455420491
SIM,1851,35,50-100,1886,1
STAT,1889,52,na,1941,2497.879359295056
STAT,1939,22,na,1961,3464.2166302651644
STAT,1901,66,na,1967,2435.3938685626185
STAT,1907,30,30-34,1937,14.021680427943759
STAT,1901,46,50-100,1947,0.18370822321033334
STAT,1850,30,50-100,1880,0.7570717940560264
SIM,1832,42,na,1874,1548
STAT,1919,45,50-100,1964,0.232845694478703
STAT,1915,48,40-44,1963,0.14965280637439424
STAT,1922,38,30-34,1960,1.9573162027717996
SIM,1850,31,25-29,1881,12
SIM,1930,38,30-34,1968,1
SIM,1881,19,30-34,1900,2
STAT,1830,49,30-34,1879,0.06913797320929654
STAT,1959,10,na,1969,4854.338043276265
STAT,1821,51,35-39,1872,0.012892001723517912
STAT,1835,33,35-39,1868,7.96131533667133
SIM,1939,24,30-34,1963,32
STAT,1883,24,25-29,1907,52.670028423787336
STAT,1859,16,na,1875,2020.754967594728
SIM,1903,27,20-24,1930,13
SIM,1874,90,na,1964,129
STAT,1934,32,40-44,1966,5.04740395723635
STAT,1902,35,na,1937,3195.714919713994
SIM,1877,2,na,1879,3021
SIM,1921,35,25-29,1956,1
SIM,1844,18,15-19,1862,8
STAT,1836,18,15-19,1854,9.733206650875305
STAT,1841,44,15-19,1885,0.009569864335798463
STAT,1892,19,40-44,1911,0.21521518156450747
STAT,1913,35,25-29,1948,0.9264357671945324
STAT,1913,51,na,1964,3343.5483364417746
SIM,1820,57,na,1877,1105
STAT,1855,52,50-100,1907,0.010639380838975155
SIM,1871,31,45-49,1902,3
STAT,1870,37,45-49,1907,1.845309825814663
STAT,1931,32,na,1963,4681.752375141504
SIM,1824,33,25-29,1857,10
SIM,1851,43,35-39,1894,3
SIM,1900,21,na,1921,3078
STAT,1897,40,15-19,1937,0.0012238191487404168
SIM,1817,53,na,1870,1274
SIM,1955,11,na,1966,4546
STAT,1944,5,na,1949,4046.9283463587067
STAT,1860,94,na,1954,15.344504510500153
STAT,1938,11,na,1949,3697.4581249336766
STAT,1899,42,15-19,1941,0.0012399836746666392
STAT,1910,46,15-19,1956,3.253929402184461E-4
STAT,1892,34,na,1926,2798.8525807049787
STAT,1906,28,35-39,1934,13.2264318826075
STAT,1888,3,na,1891,2950.33085885142
STAT,1890,31,15-19,1921,0.1651568988828957
STAT,1875,37,50-100,1912,1.1915710339799361
STAT,1857,0,na,1857,2945.487204246254
SIM,1796,58,na,1854,962
STAT,1905,25,25-29,1930,58.13979549822489
STAT,1893,47,40-44,1940,0.11521197593429157
STAT,1950,15,35-39,1965,4.689993427829846
SIM,1843,33,35-39,1876,6
STAT,1881,5,na,1886,2442.671246730654
STAT,1872,45,30-34,1917,0.09270105013293968
STAT,1926,1,na,1927,4837.47062864786
STAT,1940,17,30-34,1957,11.690124592431905
SIM,1858,47,50-100,1905,2
STAT,1876,51,25-29,1927,0.003470895023412969
STAT,1857,90,na,1947,58.71657350501178
SIM,1776,81,na,1857,164
STAT,1857,51,50-100,1908,0.011301600789070025
STAT,1750,116,na,1866,0.003668316973976111
STAT,1911,22,45-49,1933,1.00786576132856
SIM,1910,15,na,1925,3564
STAT,1942,17,50-100,1959,0.3698570180944931
SIM,1883,3,na,1886,2681
STAT,1882,51,na,1933,1988.7697486683164
STAT,1812,77,na,1889,369.4601759739593
STAT,1833,45,na,1878,1493.4600429453924
STAT,1898,43,25-29,1941,0.05661440252891077
STAT,1907,15,50-100,1922,0.06829043703944437
SIM,1850,23,na,1873,1864
STAT,1858,15,25-29,1873,4.967556593914708
STAT,1805,54,30-34,1859,0.01667965223153894
SIM,1833,28,40-44,1861,6
SIM,1941,20,30-34,1961,29
SIM,1820,79,na,1899,303
STAT,1896,30,45-49,1926,2.194718963824215
SIM,1833,35,40-44,1868,5
SIM,1823,41,50-100,1864,1
SIM,1835,31,35-39,1866,7
STAT,1825,42,na,1867,1545.3777151570453
SIM,1932,22,30-34,1954,46
STAT,1953,10,na,1963,4490.32338119006
SIM,1861,39,na,1900,2023
SIM,1826,57,na,1883,1192
STAT,1907,15,30-34,1922,2.2217160033808834
SIM,1953,18,20-24,1971,128
STAT,1869,45,50-100,1914,0.226824698980449
STAT,1933,20,30-34,1953,36.23054914870927
STAT,1894,22,35-39,1916,7.091393622608976
SIM,1895,51,na,1946,2698
STAT,1912,43,45-49,1955,0.15069379491973914
SIM,1850,20,20-24,1870,53
STAT,1915,44,25-29,1959,0.06768454432348062
SIM,1817,40,30-34,1857,3
STAT,1890,17,50-100,1907,0.05658694336638598
SIM,1882,7,na,1889,2396
SIM,1877,17,15-19,1894,9
STAT,1840,40,15-19,1880,0.011310692610145128
SIM,1751,106,na,1857,1
STAT,1869,17,15-19,1886,5.501918908341911
STAT,1919,9,na,1928,4155.885968974441
SIM,1927,15,15-19,1942,49
SIM,1929,17,25-29,1946,61
SIM,1938,29,35-39,1967,17
STAT,1890,70,na,1960,1755.1434430110512
STAT,1913,48,30-34,1961,0.08195071722194722
STAT,1882,88,na,1970,342.5295524917641
SIM,1852,89,na,1941,62
SIM,1917,33,45-49,1950,3
STAT,1831,46,20-24,1877,0.008937036863314152
SIM,1868,99,na,1967,2
STAT,1909,51,na,1960,3147.667421626678
STAT,1830,41,35-39,1871,1.3964667375485147
STAT,1802,94,na,1896,6.818001922484937
SIM,1845,39,na,1884,1692
STAT,1835,50,25-29,1885,0.0023432179284133426
SIM,1950,17,40-44,1967,2
STAT,1872,34,15-19,1906,0.1338752007319848
STAT,1896,18,50-100,1914,0.06100767856774576
STAT,1862,52,45-49,1914,0.011632395631686483
STAT,1910,48,na,1958,3228.1253387967527
SIM,1915,29,na,1944,3515
STAT,1899,29,na,1928,3067.543005944664
STAT,1857,89,na,1946,78.23869191052627
STAT,1828,87,na,1915,100.01369084708077
STAT,1827,31,35-39,1858,12.319911835658912
SIM,1900,30,50-100,1930,4
SIM,1883,66,na,1949,1487
SIM,1921,20,na,1941,3835
STAT,1825,35,40-44,1860,6.061653297088952
STAT,1834,21,25-29,1855,47.73327261098402
SIM,1889,25,20-24,1914,13
SIM,1928,33,20-24,1961,2
STAT,1941,25,na,1966,3663.8428810761866
SIM,1895,32,45-49,1927,2
STAT,1942,17,40-44,1959,1.3807998699954358
STAT,1892,26,40-44,1918,3.555933718387822
STAT,1916,27,40-44,1943,4.552667411460698
SIM,1854,54,na,1908,1661
SIM,1842,21,25-29,1863,53
SIM,1906,53,na,1959,3045
STAT,1870,56,na,1926,1888.0269827634738
STAT,1873,52,20-24,1925,7.038301418382761E-4
STAT,1833,61,na,1894,1134.4300480926586
SIM,1915,15,30-34,1930,2
SIM,1898,23,20-24,1921,87
STAT,1844,24,na,1868,1847.2628591286132
SIM,1870,16,na,1886,2362
SIM,1843,30,30-34,1873,23
SIM,1894,19,na,1913,3212
STAT,1922,34,15-19,1956,0.13650367468445143
STAT,1887,32,45-49,1919,1.842342083305481
STAT,1804,51,35-39,1855,0.0261196459228055
SIM,1843,91,na,1934,44
SIM,1874,4,na,1878,2644
SIM,1927,14,na,1941,4558
STAT,1941,7,na,1948,3866.885257040696
SIM,1895,73,na,1968,1831
SIM,1858,30,25-29,1888,17
STAT,1824,94,na,1918,10.551403586197647
SIM,1835,72,na,1907,757
STAT,1866,36,40-44,1902,3.831107956063245
STAT,1872,47,20-24,1919,0.011325381282189344
STAT,1938,28,30-34,1966,36.649573983294836
STAT,1896,15,45-49,1911,0.08193617830681993
STAT,1899,16,25-29,1915,7.354240875100948
SIM,1869,42,45-49,1911,3
SIM,1885,15,35-39,1900,1
STAT,1774,116,na,1890,1.1140418910330983E-4
STAT,1902,19,na,1921,3348.950576241397
STAT,1900,30,50-100,1930,1.2104742021961046
STAT,1946,19,50-100,1965,0.3923106995493865
SIM,1861,21,35-39,1882,10
STAT,1882,51,25-29,1933,0.0032715742980090456
STAT,1884,31,15-19,1915,0.1334865100291329
STAT,1831,33,15-19,1864,0.11539797104469013
SIM,1887,22,na,1909,2455
STAT,1843,76,na,1919,683.5094703532811
STAT,1869,30,35-39,1899,9.334999483015519
STAT,1902,21,40-44,1923,2.7864130048314353
STAT,1901,39,15-19,1940,0.01586543580887572
SIM,1914,9,na,1923,4184
STAT,1870,30,25-29,1900,9.557478108658872
STAT,1880,43,15-19,1923,0.013627788433853809
SIM,1927,28,20-24,1955,24
SIM,1828,41,45-49,1869,1
SIM,1954,10,na,1964,4435
STAT,1868,25,35-39,1893,8.762156621057375
STAT,1919,28,20-24,1947,18.566800506519193
SIM,1899,66,na,1965,2347
STAT,1820,110,na,1930,1.4721481082906747E-4
STAT,1902,44,15-19,1946,0.0012612093850294594
STAT,1941,20,50-100,1961,0.6427708583501839
STAT,1851,106,na,1957,0.01383165006613548
STAT,1895,47,15-19,1942,2.768636661150116E-4
STAT,1853,40,25-29,1893,0.48103400532855256
STAT,1896,70,na,1966,2022.5555539646043
STAT,1842,20,20-24,1862,62.79457643569741
STAT,1917,48,15-19,1965,3.624594008446629E-4
SIM,1857,22,20-24,1879,68
STAT,1891,47,30-34,1938,0.063550298390885
STAT,1853,21,35-39,1874,5.150265080017188
STAT,1920,25,15-19,1945,0.7365836965534979
STAT,1898,32,20-24,1930,3.456744325342794
STAT,1817,40,15-19,1857,0.03780575542426808
STAT,1873,19,50-100,1892,0.046726783213517725
STAT,1924,22,30-34,1946,32.04165252077372
STAT,1863,16,na,1879,2188.002568333307
STAT,1873,19,30-34,1892,1.5201783229476045
STAT,1821,76,na,1897,511.5967249058327
SIM,1851,24,na,1875,1867
STAT,1867,53,25-29,1920,0.0030913226963208227
STAT,1939,26,30-34,1965,37.224350845121016
SIM,1901,16,na,1917,3410
SIM,1922,23,50-100,1945,4
STAT,1843,40,40-44,1883,1.714171845229408
SIM,1884,31,30-34,1915,23
STAT,1810,50,30-34,1860,0.021030783821613643
SIM,1846,18,25-29,1864,9
STAT,1838,18,25-29,1856,5.075068820214075
STAT,1846,17,50-100,1863,0.043392763618544127
STAT,1919,15,15-19,1934,9.549676102766364
STAT,1909,33,45-49,1942,1.4122134181877446
STAT,1833,42,15-19,1875,0.010183192275030548
STAT,1943,25,45-49,1968,1.7396047803419559
STAT,1876,31,30-34,1907,17.097269531319423
STAT,1813,57,na,1870,1093.6056180321132
SIM,1775,80,na,1855,221
STAT,1922,33,na,1955,4020.1704044416374
SIM,1897,34,50-100,1931,1
SIM,1906,31,na,1937,3381
STAT,1808,72,na,1880,591.0420581059799
SIM,1864,74,na,1938,979
STAT,1920,39,25-29,1959,1.0162932558489584
STAT,1888,30,45-49,1918,1.9617664910872055
STAT,1822,35,15-19,1857,0.11188002497006846
SIM,1834,40,40-44,1874,5
STAT,1852,42,25-29,1894,0.48729248037341166
SIM,1812,44,na,1856,1347
STAT,1863,40,35-39,1903,1.5188974818310872
STAT,1873,53,25-29,1926,0.0033419317542258023
STAT,1921,37,25-29,1958,1.0386792524944906
SIM,1868,23,35-39,1891,3
SIM,1911,0,na,1911,3983
STAT,1832,29,50-100,1861,0.5131267180991749
STAT,1882,56,na,1938,1874.9337127144847
STAT,1915,15,30-34,1930,2.4209320700366916
STAT,1850,46,30-34,1896,0.06834090756629074
STAT,1876,20,50-100,1896,0.4000727011440505
STAT,1930,42,25-29,1972,0.08876479012985894
STAT,1909,46,15-19,1955,3.2048349493837873E-4
STAT,1866,32,25-29,1898,8.921196056532146
SIM,1916,25,40-44,1941,4
SIM,1865,24,20-24,1889,61
SIM,1838,16,25-29,1854,6
STAT,1809,95,na,1904,5.585222700103613
STAT,1887,45,15-19,1932,4.268113768625157E-4
STAT,1900,30,20-24,1930,3.5710764060500257
STAT,1893,31,40-44,1924,5.219300402739052
STAT,1883,14,na,1897,2383.31949177933
STAT,1857,24,20-24,1881,53.14515340731952
STAT,1846,31,45-49,1877,1.4681532162891142
SIM,1848,39,40-44,1887,3
SIM,1864,19,30-34,1883,2
STAT,1829,35,na,1864,1713.2541065845096
STAT,1820,39,20-24,1859,1.537066786943762
SIM,1848,24,20-24,1872,70
SIM,1879,30,45-49,1909,1
SIM,1948,17,35-39,1965,8
STAT,1874,37,na,1911,2274.770243871943
STAT,1877,41,25-29,1918,0.6323658599222093
STAT,1876,66,na,1942,1598.45349161189
STAT,1849,22,20-24,1871,60.05432781745045
STAT,1947,25,na,1972,4007.45881275998
SIM,1899,33,50-100,1932,1
SIM,1958,7,na,1965,4848
SIM,1910,21,40-44,1931,3
STAT,1847,29,30-34,1876,21.95172558118469
SIM,1825,94,na,1919,6
SIM,1896,30,45-49,1926,3
STAT,1920,28,50-100,1948,1.0279079257067592
SIM,1923,15,30-34,1938,16
STAT,1935,23,45-49,1958,1.4469116099011512
STAT,1845,89,na,1934,73.99774115941787
STAT,1861,20,30-34,1881,14.563720132133547
STAT,1921,44,25-29,1965,0.0757352590620579
SIM,1887,19,25-29,1906,10
STAT,1821,51,45-49,1872,0.02173223144649061
STAT,1810,101,na,1911,0.2584050840036649
STAT,1835,30,30-34,1865,14.16012797252806
STAT,1898,21,15-19,1919,4.231617952959343
STAT,1769,114,na,1883,2.551131396879173E-4
STAT,1817,50,40-44,1867,0.02348152275290487
STAT,1845,52,35-39,1897,0.006031778596877828
STAT,1905,22,20-24,1927,94.07626462150971
STAT,1884,85,na,1969,537.6299394997446
STAT,1863,31,45-49,1894,1.4540114622782674
SIM,1859,18,35-39,1877,2
STAT,1914,36,50-100,1950,0.3978514543760156
SIM,1907,16,na,1923,3558
SIM,1924,27,40-44,1951,4
STAT,1867,89,na,1956,104.64844515362161
SIM,1913,22,20-24,1935,106
STAT,1926,40,45-49,1966,0.1943866585550781
SIM,1824,30,20-24,1854,1
STAT,1917,35,45-49,1952,0.6752414751074841
SIM,1855,29,30-34,1884,26
STAT,1935,36,15-19,1971,0.025389079560326818
SIM,1811,96,na,1907,3
SIM,1939,27,35-39,1966,21
SIM,1943,23,45-49,1966,1
SIM,1854,7,na,1861,2317
SIM,1907,27,40-44,1934,5
STAT,1867,41,40-44,1908,2.0041361481852764
STAT,1826,52,25-29,1878,0.0031959756525723553
STAT,1900,48,20-24,1948,0.008759910794839466
STAT,1939,33,30-34,1972,15.175074148335447
STAT,1883,21,20-24,1904,63.99644096640818
SIM,1886,20,35-39,1906,8
STAT,1930,27,25-29,1957,79.06872647157267
STAT,1912,37,50-100,1949,0.3870310598226402
SIM,1829,87,na,1916,79
STAT,1908,29,na,1937,3320.796805913842
SIM,1954,16,20-24,1970,152
SIM,1857,29,40-44,1886,2
SIM,1925,29,na,1954,4043
STAT,1911,31,35-39,1942,8.438934785260386
STAT,1843,52,25-29,1895,0.00254180055001515
STAT,1874,43,15-19,1917,0.013237505342852311
STAT,1832,39,na,1871,1591.4040033847036
SIM,1937,16,20-24,1953,111
STAT,1857,20,15-19,1877,2.877582059108167
STAT,1868,32,35-39,1900,9.134380957324655
SIM,1860,30,30-34,1890,22
STAT,1826,91,na,1917,31.628911565570807
SIM,1848,42,na,1890,1710
SIM,1844,76,na,1920,602
STAT,1907,44,na,1951,3174.408883323979
STAT,1857,74,na,1931,826.5159017808984
SIM,1889,0,na,1889,3316
STAT,1877,19,15-19,1896,5.7865415293285976
STAT,1837,41,45-49,1878,1.129232459801155
STAT,1849,29,40-44,1878,2.5228769058640332
STAT,1870,51,50-100,1921,0.014047044182004715
STAT,1841,50,25-29,1891,0.002458240885756921
SIM,1894,29,na,1923,3024
STAT,1860,78,na,1938,599.87574261675
STAT,1842,15,50-100,1857,0.04533288308399829
SIM,1915,45,na,1960,3487
STAT,1876,20,25-29,1896,56.16219991997227
SIM,1862,89,na,1951,76
SIM,1876,32,35-39,1908,14
STAT,1946,16,20-24,1962,142.09914530693044
STAT,1857,52,na,1909,1595.0366660863356
STAT,1898,47,40-44,1945,0.12292191664051591
SIM,1875,37,na,1912,2247
STAT,1859,7,na,1866,2166.1033770428453
SIM,1886,28,50-100,1914,4
SIM,1871,40,35-39,1911,5
SIM,1875,41,40-44,1916,4
SIM,1883,88,na,1971,326
STAT,1851,25,40-44,1876,2.609361998225519
STAT,1929,16,20-24,1945,163.86416969855537
STAT,1870,54,45-49,1924,0.013064281068436141
STAT,1893,43,25-29,1936,0.053063419119721504
SIM,1839,34,20-24,1873,2
STAT,1880,36,15-19,1916,0.05608619874162847
STAT,1928,43,na,1971,4466.099510752544
SIM,1924,23,35-39,1947,11
STAT,1894,41,25-29,1935,0.7838931934452279
SIM,1824,38,50-100,1862,1
SIM,1854,31,45-49,1885,1
STAT,1916,23,35-39,1939,9.29180773738051
STAT,1897,20,45-49,1917,0.8862633785496008
STAT,1813,45,15-19,1858,0.0012517573390772568
STAT,1852,30,30-34,1882,14.022966684903826
SIM,1865,20,15-19,1885,3
STAT,1945,18,20-24,1963,139.86345279809083
STAT,1888,27,50-100,1915,0.7139032019504679
SIM,1844,86,na,1930,135
STAT,1844,46,50-100,1890,0.1729029682672524
SIM,1891,21,20-24,1912,69
STAT,1934,15,40-44,1949,1.7955318702387337
STAT,1866,29,40-44,1895,2.5904555604098873
SIM,1838,29,30-34,1867,29
STAT,1898,25,20-24,1923,15.104277744236414
STAT,1827,50,25-29,1877,0.003117004029918613
STAT,1911,27,15-19,1938,0.6502342995716187
STAT,1809,57,na,1866,1115.857891339827
SIM,1938,26,30-34,1964,43
SIM,1805,58,na,1863,1045
SIM,1908,19,20-24,1927,27
STAT,1806,102,na,1908,0.09755354241643914
STAT,1867,67,na,1934,1406.0889806317816
STAT,1916,20,30-34,1936,28.620077839268347
STAT,1785,109,na,1894,5.133948987669859E-4
STAT,1891,55,na,1946,2417.791378471369
SIM,1885,15,na,1900,2413
STAT,1879,30,45-49,1909,1.7357469016957612
STAT,1912,37,25-29,1949,0.9076320936888074
STAT,1816,38,50-100,1854,4.535924215041652
STAT,1924,29,na,1953,4091.4806227860754
STAT,1932,11,na,1943,4963.968033229742
SIM,1864,15,15-19,1879,6
STAT,1859,48,na,1907,1674.897242900351
STAT,1872,22,50-100,1894,0.38666780593201866
SIM,1874,52,na,1926,2029
SIM,1848,20,na,1868,1958
STAT,1850,42,15-19,1892,0.009710182479387852
SIM,1852,31,35-39,1883,12
SIM,1907,26,na,1933,3356
STAT,1791,100,na,1891,0.1948656307107316
STAT,1812,62,na,1874,966.632967081882
SIM,1854,45,50-100,1899,1
STAT,1851,90,na,1941,57.815083694462174
STAT,1794,79,na,1873,267.3683195631268
SIM,1924,20,30-34,1944,37
STAT,1907,28,50-100,1935,0.8844279231461637
STAT,1903,25,15-19,1928,0.613928234441563
STAT,1878,51,35-39,1929,0.008507110463228737
STAT,1833,30,20-24,1863,2.164907132351374
STAT,1933,23,35-39,1956,11.795192357852484
SIM,1892,41,40-44,1933,7
STAT,1893,40,20-24,1933,0.19227660260910379
SIM,1836,35,na,1871,1658
SIM,1825,72,na,1897,642
STAT,1905,47,35-39,1952,0.10730597947869393
SIM,1917,30,40-44,1947,5
STAT,1818,50,25-29,1868,0.007553754631883556
SIM,1795,79,na,1874,275
SIM,1890,1,na,1891,3202
STAT,1889,14,na,1903,3002.1574019398054
SIM,1857,25,25-29,1882,42
SIM,1930,6,na,1936,4852
STAT,1853,38,na,1891,1738.5449549115683
STAT,1880,92,na,1972,171.28033826737482
STAT,1884,41,40-44,1925,2.1092893819031118
STAT,1875,41,15-19,1916,0.013463609955473852
STAT,1846,44,15-19,1890,0.009605500201954274
STAT,1885,41,25-29,1926,0.6071196445920481
STAT,1948,16,30-34,1964,13.182175469728818
STAT,1851,42,40-44,1893,1.6474002246438284
SIM,1871,43,50-100,1914,1
SIM,1905,27,30-34,1932,40
STAT,1838,49,na,1887,1538.6951432922972
STAT,1863,43,50-100,1906,0.8709546360277544
SIM,1806,80,na,1886,211
STAT,1777,94,na,1871,3.757875185424467
STAT,1920,36,20-24,1956,0.2729215411336265
STAT,1868,15,na,1883,2346.8489903420646
SIM,1904,35,25-29,1939,4
STAT,1799,78,na,1877,317.3700425916486
SIM,1871,60,na,1931,1776
STAT,1932,33,na,1965,4746.7890775823735
SIM,1884,20,25-29,1904,53
STAT,1901,34,na,1935,3128.3727989124513
STAT,1881,24,15-19,1905,2.9903468790822045
SIM,1874,74,na,1948,1044
STAT,1895,20,35-39,1915,7.236901959898346
STAT,1787,94,na,1881,4.130149903359265
STAT,1865,51,25-29,1916,0.0030551708904176097
SIM,1943,20,40-44,1963,2
STAT,1891,33,na,1924,2778.554370021247
STAT,1914,30,na,1944,3624.7373083790735
STAT,1918,21,50-100,1939,0.672424724947168
STAT,1886,43,50-100,1929,1.0468528872384386
STAT,1909,30,40-44,1939,3.555271173466187
SIM,1816,95,na,1911,1
SIM,1820,73,na,1893,550
STAT,1856,15,15-19,1871,5.25370437766968
SIM,1880,38,30-34,1918,5
STAT,1934,4,na,1938,5157.300725484003
STAT,1790,98,na,1888,0.5702569543272324
SIM,1856,71,na,1927,1011
SIM,1868,67,na,1935,1386
SIM,1898,26,25-29,1924,52
STAT,1902,24,45-49,1926,0.9238133021075932
STAT,1831,109,na,1940,4.3389444291819907E-4
STAT,1915,41,20-24,1956,0.016819289515713556
SIM,1922,15,na,1937,4058
STAT,1871,19,na,1890,2352.655051126365
SIM,1785,80,na,1865,171
SIM,1874,89,na,1963,165
STAT,1889,42,20-24,1931,0.1849911579176062
STAT,1867,50,20-24,1917,6.639407918605931E-4
SIM,1937,14,na,1951,3496
STAT,1844,31,35-39,1875,8.59026459675418
STAT,1844,40,25-29,1884,0.473677621782608
STAT,1772,95,na,1867,2.0727327237189317
STAT,1938,17,25-29,1955,40.37867775090217
STAT,1834,40,15-19,1874,0.010572654317254756
STAT,1828,49,na,1877,1379.5184873530752
STAT,1800,77,na,1877,346.4905724092679
STAT,1874,22,na,1896,2283.529002528182
STAT,1889,36,na,1925,2760.935095551303
SIM,1891,17,25-29,1908,9
SIM,1927,19,30-34,1946,18
SIM,1872,23,na,1895,2210
STAT,1916,0,na,1916,4500.534411551451
SIM,1957,5,na,1962,4698
SIM,1851,40,40-44,1891,5
STAT,1879,19,25-29,1898,5.5655018945942984
SIM,1836,57,na,1893,1270
SIM,1873,2,na,1875,3008
STAT,1918,7,na,1925,4110.126270997538
STAT,1937,33,20-24,1970,2.277997715121827
SIM,1919,11,na,1930,4130
SIM,1946,17,25-29,1963,51
STAT,1853,16,na,1869,2059.9106185895107
STAT,1861,89,na,1950,82.41203590108073
SIM,1800,59,na,1859,1016
SIM,1892,8,na,1900,3140
STAT,1878,2,na,1880,3186.194933667397
STAT,1861,47,45-49,1908,0.18427337591754017
STAT,1818,72,na,1890,608.8713369669546
SIM,1833,31,25-29,1864,14
SIM,1930,25,25-29,1955,79
STAT,1857,27,25-29,1884,32.44962721238285
SIM,1870,38,na,1908,2179
STAT,1919,51,na,1970,3716.394374691259
STAT,1825,52,40-44,1877,0.010640910923919384
STAT,1848,41,20-24,1889,0.11574522152391571
SIM,1893,66,na,1959,2075
STAT,1931,37,35-39,1968,3.0262201091170855
STAT,1904,37,25-29,1941,0.8419540316074079
SIM,1891,37,na,1928,2901
STAT,1899,14,na,1913,3332.5274022224844
STAT,1892,22,25-29,1914,67.72194707741706
STAT,1939,29,35-39,1968,14.242695629249745
STAT,1873,50,20-24,1923,7.177655111469043E-4
SIM,1857,36,50-100,1893,3
SIM,1916,28,45-49,1944,1
STAT,1883,17,25-29,1900,5.246637499342652
SIM,1931,17,30-34,1948,18
STAT,1846,48,30-34,1894,0.06739343750195623
STAT,1783,110,na,1893,3.9771903005921406E-4
SIM,1891,39,45-49,1930,3
SIM,1939,31,30-34,1970,21
SIM,1801,81,na,1882,183
SIM,1889,66,na,1955,1868
SIM,1853,68,na,1921,1198
STAT,1921,30,40-44,1951,4.147498290688789
SIM,1912,37,25-29,1949,1
STAT,1852,106,na,1958,0.01756180576517269
STAT,1849,23,na,1872,1849.90964379008
STAT,1857,23,50-100,1880,0.348089399184737
SIM,1890,52,na,1942,2529
STAT,1943,22,40-44,1965,3.3793266240693507
SIM,1883,15,25-29,1898,5
SIM,1874,36,40-44,1910,6
SIM,1821,47,50-100,1868,1
STAT,1825,31,25-29,1856,19.965851195341116
SIM,1907,16,35-39,1923,4
STAT,1855,23,na,1878,1756.3770543847124
STAT,1875,15,25-29,1890,5.525328180333531
SIM,1896,3,na,1899,3379
SIM,1902,22,45-49,1924,4
STAT,1923,17,30-34,1940,13.522177505809426
SIM,1839,46,50-100,1885,1
STAT,1868,49,20-24,1917,0.010597733695710777
STAT,1849,25,25-29,1874,36.66826480983769
STAT,1926,42,35-39,1968,0.23454113065663332
STAT,1904,52,na,1956,2919.0640257394307
STAT,1834,24,na,1858,1744.5789990123342
STAT,1887,29,na,1916,2503.3329197857784
STAT,1931,34,50-100,1965,1.0221566567546676
STAT,1915,18,35-39,1933,0.8274077572158566
STAT,1935,20,40-44,1955,4.328225027040788
STAT,1819,57,na,1876,1129.157322883331
STAT,1870,28,50-100,1898,0.5900593823232188
SIM,1841,33,25-29,1874,13
STAT,1957,5,na,1962,4896.444644914522
STAT,1852,53,na,1905,1609.6508648073532
STAT,1948,18,50-100,1966,0.4049466598495811
SIM,1870,30,25-29,1900,18
STAT,1795,97,na,1892,1.0378086878116004
STAT,1871,42,35-39,1913,1.6938178511538418
STAT,1899,30,20-24,1929,3.527545068305603
STAT,1881,41,15-19,1922,0.012653549322063588
STAT,1888,51,na,1939,2414.5204160007456
STAT,1870,21,35-39,1891,5.418034152345903
STAT,1873,2,na,1875,3155.7920878007085
STAT,1946,19,25-29,1965,45.377280072962364
SIM,1845,49,na,1894,1554
SIM,1900,31,na,1931,3093
SIM,1893,36,50-100,1929,1
SIM,1850,61,na,1911,1371
SIM,1923,18,35-39,1941,8
STAT,1921,46,15-19,1967,3.933115908052598E-4
STAT,1908,28,45-49,1936,1.5370462373955203
SIM,1879,17,25-29,1896,6
STAT,1885,36,50-100,1921,1.161087758677012
SIM,1820,37,20-24,1857,3
SIM,1794,94,na,1888,5
STAT,1852,33,35-39,1885,7.884198500942232
STAT,1859,22,50-100,1881,0.3189827412679058
STAT,1917,44,na,1961,3649.1072998831023
STAT,1923,43,20-24,1966,0.019470654147227397
SIM,1859,22,30-34,1881,16
STAT,1939,28,na,1967,3555.6196857599116
STAT,1802,84,na,1886,109.17168520540292
STAT,1884,51,35-39,1935,0.008075352207141813
STAT,1921,41,20-24,1962,0.018819854095854783
SIM,1855,9,na,1864,2341
STAT,1792,83,na,1875,121.96438254275861
STAT,1843,38,na,1881,1787.0483590600118
SIM,1906,32,30-34,1938,19
STAT,1882,41,na,1923,2134.220658002126
STAT,1870,51,40-44,1921,0.009791750674737374
SIM,1804,95,na,1899,7
STAT,1771,84,na,1855,69.5998
SIM,1915,30,na,1945,3630
SIM,1860,38,na,1898,1957
STAT,1813,47,50-100,1860,0.7429033133071394
STAT,1822,54,30-34,1876,0.007679342525137761
STAT,1867,52,na,1919,1899.6936107030476
STAT,1913,49,35-39,1962,0.11815752619819901
STAT,1915,15,na,1930,3836.149126122136
SIM,1857,34,na,1891,1875
SIM,1899,31,25-29,1930,20
STAT,1822,39,na,1861,1450.61154580802
SIM,1850,16,25-29,1866,5
STAT,1804,58,na,1862,1042.9723953800078
SIM,1819,87,na,1906,61
STAT,1919,45,20-24,1964,0.011376825913567104
SIM,1915,28,50-100,1943,1
STAT,1859,51,25-29,1910,0.0026831873545608747
STAT,1851,51,30-34,1902,0.004385987740049045
SIM,1882,23,na,1905,2151
STAT,1934,18,45-49,1952,0.6366232772849948
STAT,1932,18,50-100,1950,0.46744460614038447
STAT,1941,31,20-24,1972,2.420502386631648
STAT,1956,16,30-34,1972,15.23908461764292
SIM,1839,37,25-29,1876,1
SIM,1884,52,na,1936,2105
STAT,1851,21,25-29,1872,50.49383619667326
SIM,1878,25,45-49,1903,1
SIM,1858,19,na,1877,2131
STAT,1922,25,25-29,1947,70.84282758873648
STAT,1860,30,15-19,1890,0.11021371842017856
SIM,1875,15,na,1890,2467
STAT,1873,74,na,1947,1064.1855049421133
SIM,1838,42,na,1880,1539
STAT,1842,16,25-29,1858,5.2126202932919385
STAT,1900,33,25-29,1933,13.367201311845532
STAT,1819,35,na,1854,1480.9002918523304
SIM,1912,17,20-24,1929,18
STAT,1841,54,40-44,1895,0.0070048533247284595
STAT,1858,37,na,1895,1747.2624405167135
STAT,1892,43,40-44,1935,2.641686774824508
STAT,1904,17,20-24,1921,24.019024087073735
STAT,1900,71,na,1971,2134.2739893582893
SIM,1860,33,35-39,1893,11
STAT,1813,49,30-34,1862,0.2830465738861318
STAT,1920,48,na,1968,3825.9750726203893
SIM,1835,48,50-100,1883,1
SIM,1882,34,25-29,1916,13
STAT,1837,38,na,1875,1629.1049143362325
STAT,1874,34,25-29,1908,9.804886999286378
SIM,1850,38,45-49,1888,2
STAT,1918,16,45-49,1934,0.10330378097858446
SIM,1807,91,na,1898,23
SIM,1900,53,na,1953,2728
STAT,1897,16,15-19,1913,7.516217374089314
STAT,1917,32,40-44,1949,3.871065778609753
SIM,1929,15,25-29,1944,62
SIM,1925,32,40-44,1957,9
SIM,1820,47,na,1867,1340
STAT,1837,50,35-39,1887,0.005674800326908322
STAT,1820,46,45-49,1866,0.39488317710736376
STAT,1887,49,30-34,1936,0.056483671225558855
STAT,1852,75,na,1927,782.1568184790738
SIM,1817,43,na,1860,1439
SIM,1887,30,45-49,1917,2
STAT,1902,45,na,1947,3029.8367365712334
SIM,1865,85,na,1950,184
STAT,1865,40,45-49,1905,1.2977469543881237
STAT,1868,41,25-29,1909,0.5818316883215796
STAT,1893,28,35-39,1921,11.524650094378554
SIM,1825,57,na,1882,1124
STAT,1921,45,25-29,1966,0.05676236107169078
STAT,1923,44,na,1967,4087.459435961951
SIM,1830,35,25-29,1865,1
SIM,1930,20,45-49,1950,1
SIM,1933,21,25-29,1954,126
STAT,1889,67,na,1956,1875.021393431487
SIM,1853,42,40-44,1895,7
SIM,1827,34,40-44,1861,4
STAT,1896,29,15-19,1925,0.5624136228774982
SIM,1806,74,na,1880,423
SIM,1802,60,na,1862,977
STAT,1840,89,na,1929,73.16102777176214
STAT,1941,15,30-34,1956,11.865661836679271
STAT,1866,21,20-24,1887,60.94973169301615
STAT,1829,38,15-19,1867,0.04921560209398484
SIM,1848,24,30-34,1872,21
STAT,1869,54,20-24,1923,6.562246148170979E-4
STAT,1882,49,40-44,1931,0.1540897292080182
SIM,1887,40,45-49,1927,9
STAT,1871,100,na,1971,8.057294561990838
SIM,1877,45,50-100,1922,1
STAT,1848,69,na,1917,1057.2527915064475
SIM,1874,21,20-24,1895,60
SIM,1791,71,na,1862,546
SIM,1915,30,20-24,1945,3
SIM,1860,40,35-39,1900,1
STAT,1849,24,25-29,1873,49.1733252577561
SIM,1834,93,na,1927,15
STAT,1871,57,na,1928,1882.1067537693484
SIM,1873,40,45-49,1913,5
STAT,1845,48,25-29,1893,0.04006257203935972
STAT,1897,50,na,1947,2759.5132761565856
SIM,1881,25,30-34,1906,21
STAT,1925,21,25-29,1946,104.77885864275987
SIM,1842,25,na,1867,1872
STAT,1882,17,20-24,1899,16.296953743336783
STAT,1813,42,20-24,1855,0.5650503588312309
STAT,1850,48,35-39,1898,0.09732191065172703
STAT,1826,37,35-39,1863,7.665366436790708
STAT,1843,34,30-34,1877,14.832055527303542
STAT,1777,104,na,1881,0.030505123808412596
STAT,1923,31,15-19,1954,0.1397512836257319
SIM,1855,8,na,1863,2351
STAT,1847,38,35-39,1885,5.343786332572144
STAT,1858,75,na,1933,763.4795635754509
SIM,1843,35,35-39,1878,11
STAT,1852,74,na,1926,843.1866696266505
STAT,1873,19,20-24,1892,16.908868685277724
SIM,1855,38,35-39,1893,12
SIM,1910,14,na,1924,3623
STAT,1894,14,na,1908,3128.157489244061
SIM,1919,23,15-19,1942,7
STAT,1871,35,20-24,1906,0.7287897677681564
SIM,1877,70,na,1947,1320
STAT,1852,32,30-34,1884,13.73474856854339
STAT,1840,26,30-34,1866,22.02433293974735
SIM,1853,43,50-100,1896,3
STAT,1898,28,na,1926,3041.207332288483
SIM,1851,34,30-34,1885,27
SIM,1860,32,30-34,1892,20
SIM,1834,37,35-39,1871,12
STAT,1835,35,35-39,1870,5.570304166427922
STAT,1893,20,25-29,1913,69.02490609461235
STAT,1845,42,40-44,1887,1.6133708721198228
STAT,1855,21,45-49,1876,0.5811338396280772
STAT,1781,106,na,1887,0.011868640388678962
SIM,1856,33,na,1889,1869
SIM,1839,26,30-34,1865,29
SIM,1874,58,na,1932,1839
STAT,1880,33,20-24,1913,2.6754976804421484
SIM,1870,44,na,1914,2102
SIM,1866,22,25-29,1888,52
STAT,1864,35,30-34,1899,4.542555223420769
STAT,1887,56,na,1943,2154.8662463422834
SIM,1835,40,25-29,1875,3
STAT,1879,21,na,1900,2342.37541752133
STAT,1867,38,35-39,1905,6.24256727398948
STAT,1898,17,30-34,1915,2.0382831746921357
SIM,1925,20,35-39,1945,17
STAT,1817,53,45-49,1870,0.030484688317016076
STAT,1886,43,40-44,1929,2.2288387529648923
STAT,1861,32,25-29,1893,8.035084032304644
STAT,1932,17,na,1949,4604.41500686713
SIM,1825,44,30-34,1869,3
SIM,1907,31,25-29,1938,8
STAT,1894,31,25-29,1925,12.497886721441201
STAT,1847,29,20-24,1876,10.226615231390996
STAT,1883,42,na,1925,2137.266313204839
STAT,1891,61,na,1952,2185.008141128104
STAT,1871,17,45-49,1888,0.0615724702383356
STAT,1912,47,25-29,1959,0.048148374323972676
SIM,1837,42,na,1879,1579
STAT,1880,28,25-29,1908,41.89953827465781
STAT,1884,44,45-49,1928,1.3783138392457996
STAT,1803,73,na,1876,496.99186008650975
STAT,1861,25,35-39,1886,7.735028422344087
STAT,1879,40,45-49,1919,1.4927423695823203
STAT,1851,45,45-49,1896,0.1747880397237367
STAT,1819,52,40-44,1871,0.01798025617843318
SIM,1839,33,50-100,1872,5
STAT,1858,22,25-29,1880,48.71117193928017
SIM,1797,96,na,1893,2
SIM,1889,25,30-34,1914,30
STAT,1876,40,20-24,1916,0.15644609470187204
SIM,1949,20,20-24,1969,120
STAT,1933,16,35-39,1949,5.319560675719472
SIM,1894,43,40-44,1937,1
STAT,1922,20,45-49,1942,1.226313390938266
STAT,1824,63,na,1887,967.7081054166224
SIM,1855,29,20-24,1884,9
SIM,1858,43,30-34,1901,4
SIM,1888,28,20-24,1916,15
STAT,1807,87,na,1894,63.19865792587803
STAT,1798,93,na,1891,8.106009330869329
STAT,1829,47,30-34,1876,0.07810743750200037
SIM,1846,19,na,1865,2019
STAT,1843,50,35-39,1893,0.006300307559441711
STAT,1866,98,na,1964,9.808280542091829
SIM,1875,38,35-39,1913,13
STAT,1827,40,25-29,1867,0.6119050507180138
STAT,1859,43,25-29,1902,0.480640645064689
STAT,1817,44,30-34,1861,2.6810111686501377
SIM,1916,25,50-100,1941,3
SIM,1941,16,35-39,1957,2
SIM,1924,34,na,1958,4112
SIM,1890,18,35-39,1908,1
STAT,1853,26,40-44,1879,2.592159230894447
STAT,1862,39,15-19,1901,0.04479603439871311
STAT,1866,94,na,1960,33.0696715279582
SIM,1816,80,na,1896,227
STAT,1780,83,na,1863,108.35590644828142
STAT,1830,34,20-24,1864,2.1893878028052978
STAT,1886,25,40-44,1911,3.010229444205916
SIM,1892,35,30-34,1927,5
STAT,1840,19,40-44,1859,0.1629811868613611
SIM,1877,28,45-49,1905,1
STAT,1896,38,30-34,1934,6.621144943655901
STAT,1836,29,45-49,1865,0.8942721151699484
STAT,1859,49,50-100,1908,0.18129778770093477
STAT,1858,40,25-29,1898,0.48104813408165914
SIM,1920,29,25-29,1949,64
STAT,1911,59,na,1970,3088.933082231195
SIM,1861,26,40-44,1887,6
STAT,1884,35,30-34,1919,5.022624265372161
STAT,1917,20,35-39,1937,9.509897868079436
STAT,1855,28,15-19,1883,0.33252690727943895
SIM,1821,37,25-29,1858,5
STAT,1912,29,25-29,1941,60.82371728521414
SIM,1894,25,40-44,1919,3
STAT,1886,49,25-29,1935,0.056291562583224805
STAT,1896,22,45-49,1918,0.8706284439110538
STAT,1830,31,40-44,1861,3.6875644991108856
SIM,1840,24,30-34,1864,14
SIM,1861,30,25-29,1891,14
STAT,1928,41,45-49,1969,0.20074217577534306
STAT,1833,71,na,1904,810.3441611233162
SIM,1911,29,30-34,1940,47
STAT,1831,40,15-19,1871,0.010801020098759146
STAT,1818,42,25-29,1860,1.5404250846459626
STAT,1912,15,50-100,1927,0.07188549640548997
STAT,1844,50,25-29,1894,0.0025222579822591967
STAT,1807,101,na,1908,0.20469113844455622
STAT,1876,36,35-39,1912,6.931104836130679
STAT,1843,43,45-49,1886,1.0975817073128473
SIM,1865,16,30-34,1881,2
STAT,1869,49,25-29,1918,0.05157181689205544
STAT,1892,19,na,1911,2971.7861850203503
STAT,1838,55,na,1893,1410.2309346908319
SIM,1827,29,45-49,1856,5
SIM,1906,28,35-39,1934,18
SIM,1936,23,na,1959,2709
STAT,1907,23,30-34,1930,24.637589672753034
STAT,1878,83,na,1961,565.0355244910072
SIM,1875,30,25-29,1905,15
STAT,1873,36,na,1909,2270.039616002955
STAT,1778,89,na,1867,31.192616156244828
STAT,1911,27,na,1938,3450.478389468686
STAT,1947,18,30-34,1965,12.967462184522837
STAT,1881,31,15-19,1912,0.1304271405428162
STAT,1879,46,30-34,1925,0.0958548046596047
STAT,1899,20,20-24,1919,89.74735068925325
SIM,1851,43,45-49,1894,1
SIM,1817,58,na,1875,1168
SIM,1822,36,30-34,1858,8
SIM,1876,69,na,1945,1443
SIM,1887,40,50-100,1927,1
STAT,1770,109,na,1879,0.00226006856282182
STAT,1835,42,25-29,1877,0.4800768794896568
SIM,1837,31,45-49,1868,1
STAT,1839,32,15-19,1871,0.11685119439191041
STAT,1814,40,15-19,1854,0.04655483031550539
SIM,1884,36,35-39,1920,7
STAT,1829,31,45-49,1860,1.747508988355878
SIM,1905,31,na,1936,3284
STAT,1853,30,25-29,1883,7.986450051868116
STAT,1874,54,30-34,1928,0.0055893252274162525
STAT,1933,20,20-24,1953,140.16942572703192
STAT,1857,16,30-34,1873,1.4034421123466134
STAT,1903,36,na,1939,3206.858142512314
STAT,1903,29,30-34,1932,33.60340690361124
SIM,1959,7,na,1966,4855
STAT,1862,33,50-100,1895,0.7352295127973469
STAT,1828,27,45-49,1855,1.9655705880153453
STAT,1848,26,30-34,1874,21.814308259106753
STAT,1895,44,20-24,1939,0.013412172992653999
STAT,1905,15,na,1920,3463.86409008071
SIM,1932,23,30-34,1955,35
STAT,1849,17,35-39,1866,0.4868346360732596
STAT,1854,17,45-49,1871,0.05626909935439979
SIM,1867,36,35-39,1903,11
STAT,1885,21,na,1906,2232.655225439828
STAT,1781,102,na,1883,0.07695650799279027
STAT,1828,53,20-24,1881,5.354431975391079E-4
STAT,1913,46,30-34,1959,0.08238348637557429
STAT,1819,72,na,1891,630.6732846498594
SIM,1865,53,na,1918,1807
SIM,1836,27,45-49,1863,2
STAT,1933,29,50-100,1962,1.2473022977902357
STAT,1841,90,na,1931,53.94205199548823
STAT,1860,21,25-29,1881,45.63472748077299
SIM,1852,32,25-29,1884,21
SIM,1898,25,25-29,1923,61
STAT,1782,94,na,1876,3.703546950178015
STAT,1847,91,na,1938,42.63734881910034
STAT,1924,23,30-34,1947,31.94264381448451
STAT,1834,45,45-49,1879,0.17466425152467566
STAT,1879,22,45-49,1901,0.6885576918757843
SIM,1941,20,20-24,1961,101
SIM,1893,26,35-39,1919,11
STAT,1840,17,15-19,1857,5.351006440342489
SIM,1793,78,na,1871,269
SIM,1859,85,na,1944,251
SIM,1896,36,30-34,1932,9
SIM,1923,33,50-100,1956,3
STAT,1891,49,35-39,1940,0.09041405976450505
SIM,1863,21,45-49,1884,1
SIM,1932,18,35-39,1950,6
STAT,1833,53,30-34,1886,0.003659620019839572
STAT,1890,17,30-34,1907,1.8409622651395805
STAT,1869,44,50-100,1913,0.953018500917464
STAT,1963,1,na,1964,4724.422711149128
SIM,1866,39,na,1905,2060
STAT,1865,8,na,1873,2387.137098277497
SIM,1863,90,na,1953,56
SIM,1912,49,na,1961,3170
SIM,1859,53,na,1912,1772
STAT,1891,30,45-49,1921,2.0554532952764553
STAT,1913,39,40-44,1952,1.3812494854829618
STAT,1879,37,na,1916,2326.3674393952965
SIM,1826,94,na,1920,20
SIM,1947,19,35-39,1966,5
STAT,1862,37,na,1899,1898.5355342354326
STAT,1903,36,20-24,1939,0.22469781267780944
SIM,1868,35,40-44,1903,2
STAT,1882,6,na,1888,2427.694611007741
STAT,1895,18,45-49,1913,0.08031858270985195
SIM,1831,26,30-34,1857,27
STAT,1839,92,na,1931,27.770667315962655
STAT,1895,39,25-29,1934,3.5137497937085667
SIM,1831,57,na,1888,1235
STAT,1907,47,45-49,1954,0.1838435796440279
STAT,1875,46,45-49,1921,0.22969728023170366
SIM,1927,31,50-100,1958,4
STAT,1939,19,35-39,1958,3.964834619272566
STAT,1819,88,na,1907,68.55763885927412
STAT,1851,27,50-100,1878,0.5492473405817454
STAT,1885,26,35-39,1911,9.112537172293713
SIM,1921,39,40-44,1960,3
SIM,1818,39,45-49,1857,1
SIM,1906,15,30-34,1921,2
STAT,1845,27,45-49,1872,0.9519270176440993
STAT,1924,18,35-39,1942,4.708630735476151
SIM,1915,23,30-34,1938,39
SIM,1840,93,na,1933,11
STAT,1838,21,45-49,1859,0.6215051718632242
STAT,1860,34,30-34,1894,13.290099811291167
STAT,1809,45,35-39,1854,0.5299423119849723
STAT,1872,41,15-19,1913,0.013153761834924834
SIM,1898,30,20-24,1928,1
SIM,1893,33,25-29,1926,16
STAT,1892,46,45-49,1938,0.15793331859369064
STAT,1907,30,20-24,1937,2.170792631968722
SIM,1913,50,na,1963,3233
STAT,1871,41,na,1912,2174.370660355332
STAT,1823,102,na,1925,0.1542798483568779
STAT,1899,46,30-34,1945,0.07089082025272174
SIM,1857,24,25-29,1881,53
STAT,1867,36,na,1903,2099.8109783732025
STAT,1924,30,20-24,1954,2.7007324978258502
STAT,1849,42,25-29,1891,0.46229104297532403
STAT,1881,27,30-34,1908,22.969518193674418
STAT,1862,50,45-49,1912,0.01186270933869573
SIM,1826,35,35-39,1861,7
STAT,1934,12,na,1946,5062.849519892368
STAT,1937,31,45-49,1968,1.4713680127862743
STAT,1811,92,na,1903,18.04040809037401
STAT,1838,45,30-34,1883,0.06968537794973118
SIM,1882,16,30-34,1898,1
STAT,1791,67,na,1858,689.1544342695951
STAT,1885,33,25-29,1918,9.59944644551017
STAT,1899,15,25-29,1914,7.370308146861105
STAT,1874,16,30-34,1890,1.542710847261799
STAT,1823,52,30-34,1875,0.006830953511432031
STAT,1839,50,45-49,1889,0.009917248338177831
SIM,1898,15,30-34,1913,2
SIM,1950,21,25-29,1971,103
STAT,1821,44,20-24,1865,0.24957062626225224
STAT,1841,16,20-24,1857,15.736832816491066
SIM,1857,21,20-24,1878,59
STAT,1879,29,15-19,1908,0.4447985001597202
STAT,1866,24,25-29,1890,49.548165869338895
STAT,1901,44,45-49,1945,0.13556999244124834
SIM,1864,19,20-24,1883,13
SIM,1830,32,20-24,1862,2
STAT,1888,14,na,1902,2872.7759340010357
SIM,1877,25,40-44,1902,2
SIM,1929,20,20-24,1949,135
STAT,1846,38,15-19,1884,0.04091914349782179
SIM,1848,27,35-39,1875,9
SIM,1865,24,30-34,1889,24
SIM,1836,25,na,1861,1761
SIM,1860,54,na,1914,1746
STAT,1869,31,na,1900,2191.0481926512184
STAT,1893,41,35-39,1934,2.1802912621268637
STAT,1926,26,50-100,1952,1.1312005640097116
SIM,1864,68,na,1932,1406
SIM,1842,31,25-29,1873,12
STAT,1856,19,20-24,1875,15.328099566623695
STAT,1870,22,25-29,1892,52.990516220119645
STAT,1835,32,30-34,1867,13.86909074029544
STAT,1922,27,na,1949,4004.8396573609675
SIM,1844,34,40-44,1878,6
SIM,1881,28,35-39,1909,13
STAT,1942,21,25-29,1963,91.51783802623613
STAT,1918,47,20-24,1965,0.01110944545809427
STAT,1845,19,45-49,1864,0.057472043698723815
STAT,1836,34,40-44,1870,3.3904562113230403
STAT,1822,32,20-24,1854,8.220224064961018
STAT,1941,18,35-39,1959,4.081428716627459
SIM,1883,37,50-100,1920,2
STAT,1924,3,na,1927,4563.399416480644
SIM,1880,26,25-29,1906,41
STAT,1890,43,30-34,1933,1.3183054283293116
STAT,1867,44,45-49,1911,1.3096015238479137
STAT,1871,32,40-44,1903,4.061523441374177
STAT,1867,30,25-29,1897,9.158223061238042
STAT,1896,40,45-49,1936,0.13106898014024915
STAT,1868,51,25-29,1919,0.0032101002489312047
STAT,1903,39,25-29,1942,0.8268421518290996
SIM,1852,19,na,1871,2131
SIM,1875,44,45-49,1919,4
STAT,1880,5,na,1885,2678.534291405005
STAT,1863,22,na,1885,2003.1082604143699
SIM,1929,28,30-34,1957,44
STAT,1844,32,25-29,1876,8.59851992966299
STAT,1924,32,50-100,1956,0.9113395589478032
STAT,1933,37,45-49,1970,0.8772015842607708
STAT,1862,16,40-44,1878,0.16980625795276794
SIM,1884,43,25-29,1927,3
STAT,1876,43,25-29,1919,0.6217430997389493
SIM,1890,20,na,1910,2862
SIM,1957,6,na,1963,4698
STAT,1865,22,15-19,1887,2.866455858244732
SIM,1918,20,45-49,1938,1
STAT,1809,52,25-29,1861,0.012280711802440872
STAT,1875,22,25-29,1897,55.5590427093873
SIM,1841,31,na,1872,1841
SIM,1874,24,25-29,1898,53
SIM,1816,64,na,1880,842
STAT,1853,49,15-19,1902,2.904492063015754E-4
STAT,1887,44,15-19,1931,0.014393098855585595
STAT,1853,31,50-100,1884,0.7070427430253408
STAT,1903,20,na,1923,3197.66945855987
STAT,1861,22,30-34,1883,14.355335905761844
STAT,1880,25,20-24,1905,11.740156437581698
STAT,1854,43,20-24,1897,0.11353423372285786
SIM,1848,10,na,1858,2220
STAT,1897,28,20-24,1925,14.76952346463559
SIM,1924,31,25-29,1955,14
STAT,1864,29,20-24,1893,9.834197779279652
SIM,1812,50,na,1862,1248
SIM,1877,44,50-100,1921,2
SIM,1839,34,30-34,1873,27
STAT,1874,49,35-39,1923,0.1323520759369007
STAT,1803,57,na,1860,1017.6017715385622
STAT,1887,28,na,1915,2512.4783409468246
STAT,1877,35,40-44,1912,4.332095707062465
STAT,1891,65,na,1956,2000.8018518908893
SIM,1833,40,50-100,1873,1
STAT,1812,48,15-19,1860,0.001294943297958986
STAT,1890,25,30-34,1915,29.28310190748809
SIM,1781,81,na,1862,162
STAT,1840,29,35-39,1869,8.258571071958901
STAT,1928,28,na,1956,4358.307116673262
SIM,1928,17,30-34,1945,21
SIM,1952,19,15-19,1971,49
SIM,1934,28,na,1962,4658
STAT,1787,93,na,1880,6.746626651245165
STAT,1873,28,35-39,1901,9.219869252079729
SIM,1854,32,50-100,1886,3
STAT,1823,34,30-34,1857,34.70685646490814
STAT,1858,18,40-44,1876,0.15751964229991502
STAT,1872,21,45-49,1893,0.6631981493796983
SIM,1811,65,na,1876,824
SIM,1831,34,30-34,1865,11
STAT,1916,16,35-39,1932,0.8430741767050792
STAT,1895,47,25-29,1942,0.039868401130386324
SIM,1821,34,20-24,1855,2
SIM,1930,34,na,1964,4542
STAT,1908,25,40-44,1933,4.225350557914177
STAT,1826,50,35-39,1876,0.008082478808190664
SIM,1860,35,35-39,1895,7
STAT,1808,107,na,1915,0.0018330218684985565
SIM,1800,65,na,1865,814
STAT,1780,112,na,1892,2.5667324088821016E-4
STAT,1944,19,15-19,1963,46.106275315826714
SIM,1836,24,40-44,1860,4
SIM,1849,22,25-29,1871,49
STAT,1825,40,50-100,1865,1.2337362910683025
STAT,1832,54,na,1886,1294.3167944167071
STAT,1857,54,30-34,1911,0.0043112567186074655
SIM,1804,79,na,1883,256
SIM,1895,36,na,1931,2943
STAT,1836,26,40-44,1862,2.465444124391142
STAT,1809,58,na,1867,1093.975918090653
STAT,1849,53,40-44,1902,0.0074663959842118455
STAT,1916,31,25-29,1947,9.051135331241577
STAT,1866,17,35-39,1883,0.49054570016738436
STAT,1939,27,na,1966,3557.327202817263
SIM,1862,45,50-100,1907,2
STAT,1836,52,40-44,1888,0.006726625107099799
STAT,1911,55,na,1966,3181.8002416595377
SIM,1839,37,na,1876,1759
STAT,1814,73,na,1887,519.4594292087179
STAT,1852,35,35-39,1887,5.516347817398017
STAT,1950,20,20-24,1970,124.71191664929356
STAT,1834,31,25-29,1865,8.205949062399368
SIM,1852,25,35-39,1877,10
SIM,1853,96,na,1949,4
STAT,1890,76,na,1966,1421.8579436635914
STAT,1908,21,25-29,1929,80.44500977821689
STAT,1834,89,na,1923,65.02354805203828
SIM,1916,21,25-29,1937,91
STAT,1768,115,na,1883,1.1165487975260174E-4
STAT,1898,44,na,1942,2925.849374738453
STAT,1843,36,50-100,1879,1.0448414779820374
STAT,1844,25,35-39,1869,8.412443380816104
SIM,1871,33,20-24,1904,2
STAT,1901,26,45-49,1927,1.4731776006475665
STAT,1881,71,na,1952,1217.5303415299882
SIM,1834,43,45-49,1877,2
SIM,1878,32,45-49,1910,3
STAT,1856,40,na,1896,1727.3276552008929
STAT,1838,39,20-24,1877,0.6213576196558024
SIM,1844,26,40-44,1870,2
STAT,1870,15,35-39,1885,0.5188559165285107
SIM,1884,33,30-34,1917,22
SIM,1895,37,25-29,1932,4
STAT,1781,77,na,1858,292.2620229435962
STAT,1906,18,50-100,1924,0.06721710077928282
STAT,1934,28,na,1962,4758.38278541344
SIM,1864,27,20-24,1891,14
STAT,1900,3,na,1903,3464.7289773611874
STAT,1931,34,30-34,1965,19.477929584765977
STAT,1808,52,40-44,1860,0.03828990622661052
SIM,1818,75,na,1893,393
SIM,1906,25,30-34,1931,47
STAT,1873,25,30-34,1898,24.310955441208357
STAT,1899,19,40-44,1918,0.2355189136000774
STAT,1853,29,45-49,1882,0.8556134225995853
SIM,1854,85,na,1939,181
SIM,1840,27,35-39,1867,9
SIM,1897,18,20-24,1915,23
STAT,1874,19,35-39,1893,0.526954792059606
STAT,1889,18,20-24,1907,20.622117987470265
SIM,1890,15,30-34,1905,5
STAT,1858,101,na,1959,0.8280654269339486
STAT,1869,46,20-24,1915,0.011004397012516005
SIM,1872,18,15-19,1890,5
SIM,1898,22,20-24,1920,82
STAT,1856,27,20-24,1883,8.994498709371433
SIM,1924,16,35-39,1940,5
STAT,1849,32,25-29,1881,7.7796028147268705
STAT,1855,37,30-34,1892,3.774603071246281
SIM,1940,25,30-34,1965,44
SIM,1914,17,30-34,1931,4
STAT,1924,26,35-39,1950,16.57226613362206
SIM,1857,32,25-29,1889,13
SIM,1861,29,45-49,1890,5
STAT,1858,45,30-34,1903,0.07250545976283043
STAT,1871,29,15-19,1900,0.4218752162808581
STAT,1876,33,30-34,1909,16.955826819347887
SIM,1846,39,20-24,1885,3
SIM,1938,20,45-49,1958,1
STAT,1882,29,na,1911,2178.1320735898717
SIM,1903,29,25-29,1932,62
STAT,1831,25,25-29,1856,39.66534635339527
STAT,1872,33,15-19,1905,0.13446145266560683
STAT,1895,15,40-44,1910,0.22653047755805658
STAT,1906,17,30-34,1923,2.192541248020673
STAT,1880,9,na,1889,2595.204220314753
SIM,1897,48,50-100,1945,1
STAT,1864,18,15-19,1882,5.152829863005473
SIM,1903,49,50-100,1952,2
SIM,1946,15,25-29,1961,49
STAT,1793,62,na,1855,874.7672000000001
STAT,1852,27,35-39,1879,8.538704794328059
SIM,1847,56,na,1903,1457
STAT,1792,84,na,1876,98.70577479185454
STAT,1858,7,na,1865,2144.2566694978073
STAT,1803,104,na,1907,0.022036190392803082
STAT,1875,71,na,1946,1295.474748632924
STAT,1918,29,15-19,1947,0.7046496070570345
SIM,1775,81,na,1856,183
SIM,1838,29,20-24,1867,12
SIM,1883,43,40-44,1926,5
STAT,1875,43,40-44,1918,2.1672381654874364
SIM,1817,42,30-34,1859,1
SIM,1873,22,15-19,1895,2
STAT,1869,47,na,1916,2047.7457723999823
STAT,1916,23,25-29,1939,91.15192079585401
SIM,1853,7,na,1860,2375
STAT,1938,15,25-29,1953,40.5662829765663
STAT,1888,20,45-49,1908,0.7828612481777087
STAT,1832,27,35-39,1859,7.921957452191763
STAT,1923,12,na,1935,4395.718560472116
SIM,1945,21,15-19,1966,4
SIM,1937,19,25-29,1956,46
SIM,1904,30,45-49,1934,2
SIM,1936,3,na,1939,3045
SIM,1818,36,40-44,1854,4
STAT,1846,74,na,1920,782.4813559432797
STAT,1905,44,30-34,1949,0.10751649254208352
SIM,1875,16,na,1891,2444
STAT,1910,33,na,1943,3429.4690500575875
STAT,1780,99,na,1879,0.2975305777890285
SIM,1896,20,45-49,1916,4
SIM,1924,23,25-29,1947,98
STAT,1799,94,na,1893,6.681949981514467
STAT,1898,25,30-34,1923,32.421769338277386
STAT,1851,37,na,1888,1746.1781929169397
SIM,1896,39,35-39,1935,7
STAT,1877,27,40-44,1904,2.9366021503003346
STAT,1867,51,35-39,1918,0.0076727761522501605
STAT,1813,45,25-29,1858,0.180253206975544
STAT,1848,29,35-39,1877,8.179817097585145
STAT,1880,36,25-29,1916,2.8756920188175346
SIM,1906,18,35-39,1924,1
SIM,1947,16,30-34,1963,17
STAT,1834,42,40-44,1876,1.6784573571255073
STAT,1875,32,25-29,1907,9.940836950300174
SIM,1819,88,na,1907,44
SIM,1862,38,25-29,1900,1
SIM,1856,17,20-24,1873,15
STAT,1857,24,30-34,1881,13.736790905381104
SIM,1860,27,35-39,1887,7
STAT,1823,77,na,1900,454.87607823941306
SIM,1946,13,na,1959,4070
SIM,1925,27,50-100,1952,1
STAT,1929,19,25-29,1948,51.96883909207127
STAT,1836,91,na,1927,36.593410581966886
STAT,1881,54,20-24,1935,6.545792279013743E-4
SIM,1843,32,30-34,1875,15
STAT,1866,47,35-39,1913,0.12136998164563072
SIM,1872,35,30-34,1907,8
STAT,1921,6,na,1927,4316.359219563238
STAT,1939,16,30-34,1955,11.527848771391394
STAT,1899,13,na,1912,3338.1689076764574
SIM,1842,42,40-44,1884,5
SIM,1865,31,20-24,1896,2
SIM,1883,32,25-29,1915,12
STAT,1848,17,20-24,1865,15.832848897697357
STAT,1859,36,35-39,1895,5.358114470184829
STAT,1864,53,30-34,1917,0.004945106973673185
STAT,1880,22,na,1902,2350.8545849861684
STAT,1932,25,30-34,1957,48.52588451328401
SIM,1932,15,30-34,1947,18
SIM,1866,70,na,1936,1168
STAT,1882,41,50-100,1923,0.9755376661259956
SIM,1884,20,na,1904,2336
STAT,1828,45,20-24,1873,0.010378462203342645
STAT,1909,45,na,1954,3218.9359286627628
SIM,1822,39,35-39,1861,9
STAT,1841,48,40-44,1889,0.11616674053288849
STAT,1905,31,na,1936,3298.8223942827585
STAT,1834,93,na,1927,18.08924401546517
STAT,1849,21,20-24,1870,60.4886362255499
STAT,1850,53,30-34,1903,0.0041233239201481095
SIM,1881,16,na,1897,2105
STAT,1861,50,25-29,1911,0.002818556469745297
SIM,1898,33,25-29,1931,17
SIM,1870,24,40-44,1894,2
STAT,1917,12,na,1929,4014.6544420495998
STAT,1815,42,na,1857,1363.6106507237957
STAT,1862,24,40-44,1886,1.6943945222239887
STAT,1818,46,40-44,1864,0.371631642041591
STAT,1857,31,20-24,1888,2.046675716017072
STAT,1924,15,30-34,1939,13.777094853246338
SIM,1876,53,na,1929,2087
STAT,1895,36,20-24,1931,0.9548762012154989
STAT,1896,19,50-100,1915,0.06083990745168446
STAT,1831,32,15-19,1863,0.11684502471548469
SIM,1918,30,50-100,1948,4
STAT,1830,28,15-19,1858,0.4161255748493245
STAT,1918,22,45-49,1940,1.146385198677324
STAT,1901,8,na,1909,3437.3460753788327
SIM,1885,27,40-44,1912,2
STAT,1888,39,35-39,1927,7.814008101849049
STAT,1921,27,25-29,1948,69.305712541503
STAT,1937,21,15-19,1958,4.8979839204556805
SIM,1840,16,30-34,1856,2
STAT,1852,43,na,1895,1743.3309902295798
SIM,1940,28,na,1968,3437
STAT,1867,83,na,1950,352.1276558647101
STAT,1908,22,50-100,1930,0.5713269602270326
SIM,1865,27,35-39,1892,7
STAT,1900,17,35-39,1917,0.7191324562543329
SIM,1861,34,40-44,1895,5
STAT,1924,33,25-29,1957,10.181444369130983
STAT,1863,44,50-100,1907,0.865450202728059
STAT,1814,44,30-34,1858,3.268215304057309
SIM,1923,21,15-19,1944,7
STAT,1840,52,30-34,1892,0.0041233865353439885
STAT,1843,35,45-49,1878,1.714217640360091
SIM,1921,21,na,1942,3795
STAT,1825,46,35-39,1871,0.14883253063023846
STAT,1916,37,45-49,1953,0.6594866115936071
SIM,1880,23,20-24,1903,66
SIM,1887,32,na,1919,2490
STAT,1860,32,40-44,1892,3.3295560439692204
STAT,1907,50,na,1957,3063.6604749503626
SIM,1891,39,35-39,1930,22
SIM,1884,41,35-39,1925,2
SIM,1833,23,25-29,1856,46
STAT,1874,50,50-100,1924,0.014791732925102222
STAT,1863,33,20-24,1896,2.235184246556971
STAT,1903,18,15-19,1921,7.955334678466206
STAT,1951,15,40-44,1966,1.5744028524781737
STAT,1907,29,50-100,1936,0.873791474304386
STAT,1851,31,25-29,1882,7.899277307351272
STAT,1860,37,35-39,1897,5.430303878413764
STAT,1872,28,15-19,1900,0.4286874839805907
STAT,1879,42,15-19,1921,0.013619480307135126
STAT,1919,38,25-29,1957,0.9982618527079787
STAT,1834,37,50-100,1871,0.9452927243085933
SIM,1822,44,30-34,1866,2
SIM,1847,36,30-34,1883,5
STAT,1946,21,45-49,1967,1.1832703118396521
SIM,1868,98,na,1966,5
STAT,1858,38,50-100,1896,0.906014162196161
SIM,1851,35,45-49,1886,2
STAT,1852,37,50-100,1889,0.937866448885743
STAT,1883,39,35-39,1922,6.482676771843122
STAT,1892,37,35-39,1929,8.367314101489978
SIM,1794,84,na,1878,92
SIM,1952,13,na,1965,4394
SIM,1911,18,15-19,1929,6
SIM,1835,71,na,1906,797
STAT,1853,34,40-44,1887,3.2438893994125277
STAT,1825,41,na,1866,1565.21102422115
STAT,1922,32,50-100,1954,0.8825727322793269
STAT,1915,21,15-19,1936,5.213397289973578
STAT,1916,27,na,1943,3659.0469666903473
SIM,1932,33,25-29,1965,12
STAT,1951,20,35-39,1971,10.635341513156801
SIM,1838,52,na,1890,1355
SIM,1875,47,na,1922,2140
SIM,1835,19,na,1854,1916
SIM,1820,42,na,1862,1417
SIM,1856,40,45-49,1896,1
STAT,1881,35,30-34,1916,4.907511034714176
SIM,1929,23,25-29,1952,123
STAT,1918,35,50-100,1953,0.4220218179339751
SIM,1900,52,na,1952,2759
SIM,1852,22,30-34,1874,19
STAT,1809,50,35-39,1859,0.031076234615528362
STAT,1913,42,15-19,1955,0.0014144261932030368
STAT,1912,13,na,1925,3765.9300223916125
SIM,1837,73,na,1910,716
STAT,1857,27,35-39,1884,7.401740285455315
STAT,1937,17,30-34,1954,11.200339514075564
STAT,1825,41,25-29,1866,0.7334958548326611
SIM,1891,28,50-100,1919,4
STAT,1898,49,50-100,1947,0.17346810045910824
STAT,1913,1,na,1914,4019.4928658934077
STAT,1851,96,na,1947,6.2967371033225925
STAT,1892,71,na,1963,1792.349763492492
SIM,1856,29,35-39,1885,8
STAT,1922,48,25-29,1970,0.05741286077693285
STAT,1911,26,50-100,1937,0.9199361391846995
STAT,1876,41,35-39,1917,1.7739966727299212
STAT,1840,58,na,1898,1377.2319267839362
SIM,1856,22,15-19,1878,3
SIM,1896,28,30-34,1924,40
STAT,1837,43,20-24,1880,0.11679492473232414
SIM,1893,72,na,1965,1808
STAT,1813,56,na,1869,1115.48018444916
STAT,1849,50,25-29,1899,0.0025897388128062046
STAT,1849,55,na,1904,1490.3889750944566
STAT,1840,25,na,1865,1905.7001851243683
SIM,1878,17,na,1895,2567
STAT,1861,95,na,1956,12.027690025676202
SIM,1945,17,30-34,1962,11
STAT,1851,36,35-39,1887,5.296950484661173
STAT,1840,53,20-24,1893,5.056481833369776E-4
STAT,1844,22,30-34,1866,15.61254120988134
SIM,1805,64,na,1869,849
STAT,1881,47,50-100,1928,0.22297815584808547
SIM,1826,67,na,1893,842
STAT,1923,43,50-100,1966,0.12952217511904082
STAT,1840,34,30-34,1874,14.505476988866059
SIM,1835,44,40-44,1879,4
SIM,1889,35,25-29,1924,2
STAT,1899,47,45-49,1946,0.17154020058721703
SIM,1870,42,40-44,1912,7
STAT,1942,27,45-49,1969,1.7128549653846654
SIM,1932,26,35-39,1958,26
STAT,1869,20,30-34,1889,16.455533324508345
SIM,1862,73,na,1935,992
SIM,1956,12,na,1968,4764
STAT,1859,47,40-44,1906,0.1284701422792004
STAT,1909,20,25-29,1929,81.56376571996219
STAT,1848,22,15-19,1870,2.8938689245036286
STAT,1920,32,na,1952,3913.73145168995
SIM,1889,67,na,1956,1809
SIM,1900,22,25-29,1922,73
STAT,1922,47,35-39,1969,0.13993416611165674
SIM,1879,36,30-34,1915,6
SIM,1912,24,20-24,1936,87
STAT,1862,42,40-44,1904,1.810320018872552
STAT,1852,105,na,1957,0.03381757671751495
STAT,1890,21,15-19,1911,3.821965990109296
STAT,1836,30,25-29,1866,8.347297287534303
SIM,1909,4,na,1913,3701
SIM,1872,94,na,1966,62
STAT,1880,86,na,1966,452.2144124123423
SIM,1939,31,20-24,1970,2
SIM,1851,30,na,1881,1871
STAT,1888,28,30-34,1916,28.00433238053819
STAT,1928,33,50-100,1961,0.9761308082662653
SIM,1893,65,na,1958,2116
STAT,1897,29,50-100,1926,0.8024208569153723
SIM,1920,19,30-34,1939,15
SIM,1843,11,na,1854,2191
STAT,1841,19,25-29,1860,4.941744629733495
SIM,1847,25,na,1872,1859
STAT,1858,43,40-44,1901,1.656079379368557
STAT,1827,44,40-44,1871,1.9980103214713105
STAT,1838,70,na,1908,956.930727787521
STAT,1837,105,na,1942,0.018508899541668844
STAT,1845,16,40-44,1861,0.1637990770482595
STAT,1908,49,50-100,1957,0.1920599424030906
SIM,1866,43,40-44,1909,6
STAT,1904,42,20-24,1946,0.014923004129287239
STAT,1925,30,35-39,1955,10.264473462378694
STAT,1826,43,45-49,1869,1.4472118870977906
STAT,1912,19,30-34,1931,2.3153758816855965
STAT,1910,34,45-49,1944,1.420656187504442
SIM,1889,21,15-19,1910,3
STAT,1947,19,na,1966,3914.5268155101253
SIM,1820,41,na,1861,1437
SIM,1877,20,30-34,1897,17
SIM,1929,30,45-49,1959,1
STAT,1857,49,35-39,1906,0.10208813289406282
SIM,1885,46,na,1931,2136
STAT,1839,36,30-34,1875,4.290938288273243
SIM,1801,75,na,1876,400
SIM,1892,30,25-29,1922,21
SIM,1843,40,35-39,1883,4
STAT,1894,35,40-44,1929,5.370151289535628
STAT,1889,41,45-49,1930,1.7533874679824737
STAT,1918,38,na,1956,3742.2580490914543
SIM,1829,37,30-34,1866,7
STAT,1821,47,25-29,1868,0.08795583022214562
STAT,1904,49,40-44,1953,0.12810492989734212
STAT,1931,41,15-19,1972,0.0019409308507538823
STAT,1842,16,35-39,1858,0.5047378644254061
STAT,1893,34,45-49,1927,2.072277978987945
STAT,1815,54,25-29,1869,0.007914593648896549
SIM,1830,39,40-44,1869,3
STAT,1837,69,na,1906,926.398071927362
SIM,1844,30,25-29,1874,13
STAT,1921,34,20-24,1955,2.54254962230767
SIM,1940,28,35-39,1968,17
STAT,1908,39,na,1947,3293.3593159374836
STAT,1834,25,na,1859,1781.216696817982
STAT,1835,40,35-39,1875,1.3889015323108396
STAT,1896,46,30-34,1942,0.06836748915238926
SIM,1871,54,na,1925,1994
SIM,1892,36,45-49,1928,3
STAT,1855,55,na,1910,1464.4308225261893
SIM,1831,26,na,1857,1712
SIM,1903,26,20-24,1929,14
STAT,1932,28,35-39,1960,18.56853435603171
SIM,1784,85,na,1869,53
SIM,1855,39,na,1894,1864
STAT,1877,53,40-44,1930,0.01015472791061969
STAT,1842,38,35-39,1880,5.8474140729547495
STAT,1882,45,25-29,1927,0.053476680450854346
STAT,1863,20,50-100,1883,0.3503969552530107
STAT,1912,26,20-24,1938,17.04797138477287
STAT,1892,25,50-100,1917,0.7618945485727457
SIM,1920,26,20-24,1946,17
SIM,1923,28,35-39,1951,15
SIM,1864,25,30-34,1889,21
STAT,1915,28,35-39,1943,14.414297507265822
STAT,1898,26,50-100,1924,0.8208632080734699
STAT,1883,20,45-49,1903,0.649479289372227
STAT,1921,49,40-44,1970,0.16693577730955017
SIM,1850,55,na,1905,1528
STAT,1856,25,30-34,1881,19.58721443715663
STAT,1916,20,20-24,1936,110.72589207873251
SIM,1848,20,15-19,1868,4
STAT,1797,99,na,1896,0.4611284069897887
SIM,1862,18,na,1880,2264
SIM,1919,27,30-34,1946,47
SIM,1868,27,40-44,1895,4
STAT,1868,45,40-44,1913,0.15595795385364772
SIM,1848,34,25-29,1882,13
STAT,1896,64,na,1960,2285.1817508842173
STAT,1892,50,na,1942,2583.887311426584
STAT,1925,25,40-44,1950,5.236691197211863
SIM,1848,104,na,1952,1
STAT,1869,25,40-44,1894,2.757837845949665
SIM,1850,38,35-39,1888,13
STAT,1848,17,na,1865,2049.994456538704
SIM,1895,34,20-24,1929,2
STAT,1888,45,na,1933,2535.877200880013
SIM,1897,23,15-19,1920,4
STAT,1904,24,20-24,1928,92.77976306974747
STAT,1879,40,50-100,1919,1.0537004931562415
STAT,1878,49,15-19,1927,3.851671903581444E-4
SIM,1867,24,na,1891,2060
STAT,1890,47,25-29,1937,0.03735325134566517
STAT,1910,16,45-49,1926,0.09371001235340967
STAT,1865,26,30-34,1891,21.691456533288463
SIM,1790,85,na,1875,65
SIM,1883,35,na,1918,2280
STAT,1833,40,na,1873,1586.5182284959521
STAT,1887,34,20-24,1921,2.831322183770746
STAT,1888,19,15-19,1907,6.5875010388054
SIM,1810,79,na,1889,284
SIM,1935,34,na,1969,4916
STAT,1858,48,35-39,1906,0.10252354197482674
STAT,1852,40,35-39,1892,1.3896886177756076
SIM,1885,35,40-44,1920,5
SIM,1931,20,na,1951,4455
STAT,1773,86,na,1859,46.17419608796776
STAT,1904,24,50-100,1928,0.5490252257701754
SIM,1903,29,na,1932,3168
STAT,1812,53,45-49,1865,0.0447653179796864
STAT,1889,23,15-19,1912,3.8356704096946252
STAT,1898,35,25-29,1933,3.7169632498879492
SIM,1928,31,45-49,1959,5
STAT,1832,82,na,1914,282.12304315389576
SIM,1862,40,na,1902,2027
STAT,1831,27,15-19,1858,0.3979907951819607
STAT,1858,46,45-49,1904,0.17552151643804673
STAT,1859,40,20-24,1899,0.12094119244255551
SIM,1933,25,40-44,1958,6
STAT,1880,40,35-39,1920,1.8181081473387666
SIM,1889,28,35-39,1917,17
STAT,1950,16,35-39,1966,4.688820929472892
STAT,1832,54,25-29,1886,0.002146991440244898
STAT,1865,72,na,1937,1084.1256076025197
SIM,1818,44,40-44,1862,5
SIM,1873,26,30-34,1899,28
SIM,1852,74,na,1926,806
STAT,1898,28,35-39,1926,12.29587520502432
SIM,1869,39,25-29,1908,2
STAT,1849,37,50-100,1886,0.9055335065960589
STAT,1929,22,20-24,1951,132.84567394914404
STAT,1905,40,15-19,1945,0.001322370607125555
STAT,1903,51,na,1954,2907.854588552228
STAT,1817,45,45-49,1862,0.5450048510395107
SIM,1941,29,50-100,1970,4
SIM,1924,20,20-24,1944,119
STAT,1861,30,35-39,1891,8.008305512126391
STAT,1922,40,15-19,1962,0.0016699113937874391
STAT,1886,71,na,1957,1390.3236277591666
SIM,1896,19,15-19,1915,8
STAT,1874,30,45-49,1904,1.6972492547852933
STAT,1841,44,25-29,1885,0.44499866189422077
SIM,1871,5,na,1876,2670
SIM,1869,21,35-39,1890,6
STAT,1916,31,na,1947,3703.694011206981
STAT,1821,41,40-44,1862,3.8704566053985574
SIM,1937,22,20-24,1959,97
STAT,1857,34,25-29,1891,7.562878027478984
STAT,1930,39,40-44,1969,1.8407980571948659
SIM,1915,14,na,1929,3839
STAT,1844,55,na,1899,1451.5539059437958
STAT,1940,31,15-19,1971,0.12570159928410707
STAT,1929,15,30-34,1944,14.764263284934989
STAT,1816,48,35-39,1864,0.3627759222866431
STAT,1853,54,45-49,1907,0.010466557723735743
SIM,1895,20,na,1915,2997
STAT,1822,46,30-34,1868,0.13698099902185462
SIM,1870,20,25-29,1890,59
STAT,1928,12,na,1940,4716.919728249042
STAT,1852,33,45-49,1885,1.3576133798935366
STAT,1930,32,20-24,1962,2.973891124830114
STAT,1854,50,35-39,1904,0.006288420851394757
SIM,1860,33,45-49,1893,2
STAT,1820,97,na,1917,2.8619783846630122
STAT,1869,16,na,1885,2355.361195176236
SIM,1855,91,na,1946,35
STAT,1837,48,15-19,1885,2.5878280401364114E-4
SIM,1839,37,35-39,1876,15
SIM,1882,30,45-49,1912,1
STAT,1884,36,45-49,1920,1.8699561101957427
STAT,1878,44,20-24,1922,0.1540768718414542
SIM,1838,35,30-34,1873,7
STAT,1872,51,na,1923,2051.4070343637295
SIM,1841,19,na,1860,2053
STAT,1853,91,na,1944,42.974554808005074
STAT,1856,36,na,1892,1751.5633348258998
STAT,1859,33,30-34,1892,13.10776033297083
STAT,1846,10,na,1856,2140.9002127574995
SIM,1859,37,40-44,1896,8
SIM,1835,78,na,1913,469
STAT,1875,16,na,1891,2457.216960997252
SIM,1815,104,na,1919,1
SIM,1921,14,na,1935,4169
SIM,1865,34,25-29,1899,8
STAT,1853,37,45-49,1890,1.4783853553740094
STAT,1822,39,40-44,1861,7.146019385311668
SIM,1860,24,30-34,1884,19
STAT,1837,17,45-49,1854,0.07177927645679943
STAT,1862,20,25-29,1882,47.908965561310254
SIM,1937,15,30-34,1952,16
STAT,1897,26,30-34,1923,31.924380470386588
STAT,1852,24,30-34,1876,15.846868079310088
SIM,1849,91,na,1940,27
STAT,1849,54,na,1903,1509.3050019660702
STAT,1833,48,35-39,1881,0.08964962546343704
STAT,1887,39,15-19,1926,0.05872999841026313
SIM,1904,20,15-19,1924,2
STAT,1808,46,35-39,1854,0.5418969365487489
STAT,1860,35,45-49,1895,1.5450542241387795
STAT,1863,36,25-29,1899,2.40243209530585
SIM,1844,55,na,1899,1457
SIM,1859,41,50-100,1900,1
SIM,1895,29,25-29,1924,42
STAT,1839,39,35-39,1878,5.519878477963178
STAT,1835,46,40-44,1881,0.11404475611587879
STAT,1919,35,20-24,1954,0.2690273169734319
STAT,1889,27,30-34,1916,29.368944700277
STAT,1904,45,25-29,1949,0.04445868284349468
STAT,1907,33,25-29,1940,8.125679436216016
STAT,1807,56,na,1863,1089.3659298990272
SIM,1910,32,45-49,1942,1
SIM,1894,6,na,1900,3335
STAT,1843,70,na,1913,1012.2554436226068
STAT,1895,20,na,1915,2933.0277356621373
STAT,1831,44,na,1875,1523.3326358433515
SIM,1851,37,35-39,1888,13
SIM,1891,36,30-34,1927,8
STAT,1801,78,na,1879,324.4363714323729
SIM,1861,37,45-49,1898,1
STAT,1908,35,na,1943,3358.437932384911
STAT,1792,77,na,1869,305.7708053051849
STAT,1878,21,35-39,1899,5.756243901218745
SIM,1913,20,45-49,1933,5
STAT,1879,38,30-34,1917,5.2364936062719485
STAT,1779,112,na,1891,4.779967860018606E-4
SIM,1887,38,30-34,1925,3
STAT,1920,18,15-19,1938,47.97773600391247
SIM,1888,26,30-34,1914,39
SIM,1850,92,na,1942,19
SIM,1811,64,na,1875,860
STAT,1847,84,na,1931,244.7698180262908
STAT,1845,45,20-24,1890,0.008536845041434066
SIM,1828,38,25-29,1866,1
STAT,1871,38,25-29,1909,2.683118657400166
SIM,1838,38,35-39,1876,15
STAT,1771,108,na,1879,0.0034384905987898664
STAT,1888,82,na,1970,923.9384137513642
SIM,1828,92,na,1920,20
STAT,1800,54,30-34,1854,0.0166893300129385
STAT,1930,42,15-19,1972,0.0019089203453386942
SIM,1834,34,30-34,1868,26
STAT,1778,85,na,1863,72.71326390938538
SIM,1859,84,na,1943,300
SIM,1856,40,na,1896,1859
STAT,1906,43,30-34,1949,0.10902885941774294
STAT,1934,20,35-39,1954,11.992858302158343
STAT,1826,34,30-34,1860,20.627701340241178
STAT,1836,49,15-19,1885,2.5765852977053687E-4
SIM,1897,27,30-34,1924,36
STAT,1902,32,45-49,1934,2.3247733331652056
STAT,1893,25,30-34,1918,30.388202615428153
STAT,1853,34,50-100,1887,0.6853570523037771
STAT,1819,41,na,1860,1438.160723737673
STAT,1875,37,35-39,1912,6.864539216453837
STAT,1809,49,50-100,1858,0.8636927975187073
SIM,1840,18,20-24,1858,10
STAT,1897,29,35-39,1926,12.10347593170293
STAT,1901,46,15-19,1947,2.991988092637555E-4
STAT,1887,29,25-29,1916,44.37188695715418
SIM,1896,46,na,1942,2838
STAT,1838,104,na,1942,0.04549104997448103
STAT,1896,42,15-19,1938,0.001195846939345528
SIM,1885,31,25-29,1916,14
STAT,1905,20,45-49,1925,0.95763221483501
STAT,1913,20,15-19,1933,4.9008732633469405
STAT,1843,32,40-44,1875,3.761355253618655
SIM,1935,13,na,1948,5105
STAT,1851,40,50-100,1891,0.7825306729112319
SIM,1939,27,na,1966,3466
SIM,1851,32,40-44,1883,6
SIM,1959,3,na,1962,4856
STAT,1883,36,30-34,1919,4.9582307129605585
STAT,1835,33,45-49,1868,1.3708924529646116
STAT,1922,44,30-34,1966,0.1381740220124606
SIM,1817,49,50-100,1866,3
SIM,1937,4,na,1941,3571
STAT,1882,15,30-34,1897,1.4719719676380483
STAT,1912,44,20-24,1956,0.015962592451895997
SIM,1921,32,20-24,1953,2
SIM,1942,20,35-39,1962,8
STAT,1921,17,na,1938,3963.874857882208
SIM,1843,33,45-49,1876,1
STAT,1830,37,25-29,1867,2.2850296370895458
STAT,1869,16,50-100,1885,0.04568945592840984
SIM,1826,63,na,1889,974
STAT,1835,26,50-100,1861,0.5239408288946485
SIM,1857,37,50-100,1894,3
SIM,1907,35,40-44,1942,1
STAT,1816,45,30-34,1861,0.26315736248980487
STAT,1867,35,30-34,1902,4.772234163480583
SIM,1869,19,20-24,1888,18
SIM,1863,58,na,1921,1710
STAT,1850,53,50-100,1903,0.010461656530706081
SIM,1866,38,50-100,1904,1
STAT,1883,51,50-100,1934,0.014050043064300938
STAT,1933,23,25-29,1956,115.70993179825882
SIM,1846,37,30-34,1883,7
SIM,1941,23,25-29,1964,84
STAT,1837,46,25-29,1883,0.03823194452921804
SIM,1930,35,na,1965,4585
STAT,1899,6,na,1905,3381.992950728842
STAT,1817,47,35-39,1864,0.31323570643429277
SIM,1889,32,20-24,1921,2
SIM,1900,15,35-39,1915,2
SIM,1861,34,50-100,1895,5
STAT,1827,47,45-49,1874,0.2067665290407092
SIM,1856,26,30-34,1882,26
STAT,1850,18,35-39,1868,0.46926295122760797
STAT,1945,25,20-24,1970,18.935178389782365
SIM,1827,52,na,1879,1238
STAT,1909,36,50-100,1945,0.37713648448278886
SIM,1923,28,na,1951,3954
SIM,1845,77,na,1922,598
STAT,1857,46,30-34,1903,0.07229655743354998
STAT,1894,38,45-49,1932,2.4105097122767427
STAT,1884,38,35-39,1922,6.570102973675106
SIM,1847,39,35-39,1886,14
STAT,1910,31,40-44,1941,3.5781065507518934
STAT,1859,17,na,1876,2008.8527208355956
STAT,1813,63,na,1876,921.4616748967682
STAT,1882,57,na,1939,1847.3534378004547
SIM,1864,28,35-39,1892,9
SIM,1854,28,25-29,1882,37
SIM,1892,38,35-39,1930,14
STAT,1817,77,na,1894,383.32611920501455
STAT,1883,35,na,1918,2202.0380534873634
STAT,1936,2,na,1938,3698.3868231138404
SIM,1906,21,15-19,1927,4
STAT,1861,36,40-44,1897,3.45057704916813
SIM,1842,36,35-39,1878,13
STAT,1840,96,na,1936,5.979891765905195
SIM,1855,18,15-19,1873,5
STAT,1847,18,15-19,1865,5.417816177303467
SIM,1916,46,na,1962,3491
SIM,1881,19,20-24,1900,12
SIM,1844,29,45-49,1873,5
STAT,1901,65,na,1966,2478.3183422503957
STAT,1863,47,30-34,1910,0.0800092804556551
STAT,1899,44,40-44,1943,0.19948180949880312
SIM,1832,26,na,1858,1759
SIM,1861,88,na,1949,87
STAT,1840,30,15-19,1870,0.12332938746219593
STAT,1914,41,15-19,1955,0.001439346750880836
STAT,1856,28,35-39,1884,7.344712912463494
SIM,1798,81,na,1879,194
STAT,1864,32,na,1896,2014.788106405866
STAT,1834,36,35-39,1870,5.502592636901726
STAT,1846,28,25-29,1874,35.82249707390148
STAT,1863,43,15-19,1906,0.011385028753875603
SIM,1865,39,40-44,1904,2
STAT,1782,105,na,1887,0.018840273363065037
STAT,1936,33,15-19,1969,0.11782088657140861
SIM,1937,18,35-39,1955,3
SIM,1898,16,na,1914,3203
STAT,1812,78,na,1890,336.04989226063424
STAT,1896,49,na,1945,2750.8602874427024
SIM,1867,33,30-34,1900,18
STAT,1870,40,25-29,1910,0.6004231395806793
SIM,1839,92,na,1931,22
STAT,1885,30,20-24,1915,2.564512639031189
STAT,1955,15,25-29,1970,54.37102359949128
SIM,1876,32,na,1908,2363
STAT,1884,30,25-29,1914,9.63873770634857
STAT,1923,21,50-100,1944,0.7255103762908646
STAT,1821,38,15-19,1859,0.11016902262054089
STAT,1842,35,30-34,1877,4.545551687994371
STAT,1882,18,35-39,1900,0.5030793881009432
STAT,1842,44,na,1886,1659.7458079526975
SIM,1938,18,30-34,1956,17
SIM,1824,38,40-44,1862,6
SIM,1847,27,20-24,1874,14
STAT,1803,105,na,1908,0.00968688893477231
STAT,1893,21,15-19,1914,3.966201301475425
STAT,1935,29,15-19,1964,0.9081387603545471
STAT,1911,28,na,1939,3438.3327055377567
STAT,1855,41,15-19,1896,0.00982488444581246
STAT,1866,42,25-29,1908,0.5586231305385249
STAT,1881,19,50-100,1900,0.04444799642117416
SIM,1891,29,40-44,1920,4
SIM,1813,60,na,1873,986
SIM,1897,31,na,1928,3044
SIM,1798,77,na,1875,327
STAT,1883,29,40-44,1912,2.7536714145412455
STAT,1921,40,45-49,1961,0.17759286412692096
SIM,1825,41,na,1866,1441
STAT,1876,34,45-49,1910,1.6861115317730409
SIM,1871,36,25-29,1907,2
STAT,1816,38,40-44,1854,16.172786023898475
STAT,1839,27,20-24,1866,9.854221099520775
SIM,1876,34,50-100,1910,1
SIM,1936,2,na,1938,3058
STAT,1930,17,25-29,1947,52.92982551916486
STAT,1929,18,35-39,1947,5.046017656888375
SIM,1828,37,na,1865,1521
SIM,1898,71,na,1969,2055
STAT,1868,34,50-100,1902,0.8193568611211645
SIM,1849,36,na,1885,1779
SIM,1944,27,na,1971,3780
STAT,1860,73,na,1933,911.9085932014178
SIM,1893,30,20-24,1923,2
STAT,1855,45,30-34,1900,0.069240808598448
SIM,1881,87,na,1968,296
STAT,1798,62,na,1860,889.1755894591876
STAT,1890,44,20-24,1934,0.18095733623268886
SIM,1831,41,na,1872,1552
SIM,1875,43,na,1918,2194
STAT,1908,30,35-39,1938,8.212427167428899
STAT,1864,54,50-100,1918,0.01240075849298884
SIM,1831,29,35-39,1860,12
STAT,1964,2,na,1966,4680.956343520652
STAT,1864,54,20-24,1918,6.059002760896086E-4
STAT,1876,47,40-44,1923,0.16618533056817006
SIM,1817,43,45-49,1860,4
STAT,1928,31,15-19,1959,0.1518975757795887
SIM,1796,70,na,1866,610
SIM,1908,32,na,1940,3288
STAT,1886,17,40-44,1903,0.18255995995821125
STAT,1940,0,na,1940,4303.11971883065
SIM,1843,26,50-100,1869,1
SIM,1923,25,30-34,1948,43
STAT,1869,28,45-49,1897,1.0117281638816187
SIM,1848,31,20-24,1879,2
STAT,1838,37,30-34,1875,4.386159012684077
SIM,1848,14,na,1862,2174
STAT,1886,46,20-24,1932,0.012011496597400712
STAT,1877,31,25-29,1908,10.082032794645949
STAT,1750,115,na,1865,0.005853666162375908
SIM,1917,20,25-29,1937,97
STAT,1907,26,35-39,1933,13.433512823824486
STAT,1868,48,45-49,1916,0.21019190393711865
STAT,1899,49,35-39,1948,0.10010312711750946
STAT,1899,23,25-29,1922,73.88193717010326
SIM,1875,35,30-34,1910,8
SIM,1916,30,35-39,1946,11
STAT,1878,15,50-100,1893,0.04840504362675856
SIM,1954,6,na,1960,4435
STAT,1865,17,na,1882,2234.180878632324
STAT,1892,32,25-29,1924,12.117070435767483
STAT,1878,47,25-29,1925,0.05638277434154163
STAT,1915,25,30-34,1940,38.00762622923472
STAT,1872,18,25-29,1890,5.359127181489241
SIM,1866,91,na,1957,37
STAT,1823,53,20-24,1876,8.301215795246631E-4
STAT,1889,20,na,1909,2774.7475085703263
STAT,1865,29,35-39,1894,8.2238721067046
SIM,1879,39,35-39,1918,15
SIM,1873,17,20-24,1890,14
STAT,1829,62,na,1891,1120.305324374286
STAT,1947,20,45-49,1967,1.2022215231507527
SIM,1912,27,25-29,1939,50
STAT,1909,39,15-19,1948,0.016994086070264768
STAT,1929,25,25-29,1954,78.11969070971435
STAT,1959,6,na,1965,4856.765972192382
SIM,1845,92,na,1937,28
SIM,1867,17,na,1884,2248
STAT,1930,35,25-29,1965,1.2154254290841175
STAT,1904,27,25-29,1931,57.31094265474327
SIM,1860,20,15-19,1880,6
STAT,1839,24,50-100,1863,0.34436460518840056
STAT,1822,42,15-19,1864,0.020827695035179332
SIM,1825,42,40-44,1867,5
SIM,1880,18,25-29,1898,8
STAT,1848,40,45-49,1888,1.104837466115883
SIM,1904,14,na,1918,3439
STAT,1913,50,na,1963,3356.1675263408156
STAT,1927,36,50-100,1963,0.4936393791274147
SIM,1915,26,35-39,1941,13
STAT,1902,14,na,1916,3431.7213956345613
STAT,1862,19,45-49,1881,0.05421759784430767
SIM,1807,60,na,1867,938
SIM,1883,37,35-39,1920,18
SIM,1844,92,na,1936,20
STAT,1899,41,25-29,1940,0.057991528479260875
SIM,1928,31,na,1959,4453
SIM,1841,15,30-34,1856,1
SIM,1953,1,na,1954,4419
STAT,1841,17,35-39,1858,0.48419601342502805
SIM,1820,78,na,1898,348
STAT,1865,51,50-100,1916,0.013026909305208124
STAT,1948,24,30-34,1972,31.15640813009523
SIM,1872,27,30-34,1899,28
STAT,1881,53,30-34,1934,0.005342404406229336
SIM,1823,93,na,1916,11
STAT,1865,17,20-24,1882,15.682867331324964
STAT,1914,22,50-100,1936,0.6349511853938722
STAT,1830,59,na,1889,1162.044279951738
STAT,1909,24,na,1933,3328.7738143218066
SIM,1892,33,40-44,1925,4
SIM,1826,32,30-34,1858,23
SIM,1873,51,50-100,1924,1
SIM,1814,78,na,1892,339
SIM,1820,36,45-49,1856,3
STAT,1873,43,na,1916,2200.257234783091
STAT,1843,37,35-39,1880,5.957063966737679
STAT,1817,42,40-44,1859,5.687003926319413
SIM,1915,33,25-29,1948,11
STAT,1864,27,30-34,1891,21.261349004019326
STAT,1867,37,50-100,1904,1.0890084227243981
STAT,1852,20,15-19,1872,3.0208367943961734
STAT,1885,23,30-34,1908,16.712750765422204
STAT,1927,37,20-24,1964,0.3096537018877713
SIM,1890,21,na,1911,2823
SIM,1893,23,30-34,1916,31
SIM,1938,15,15-19,1953,40
SIM,1937,25,25-29,1962,68
STAT,1884,33,40-44,1917,4.0314124470963
STAT,1937,32,50-100,1969,0.7726432697983708
STAT,1821,82,na,1903,251.95389748457887
STAT,1822,35,25-29,1857,5.736393303344608
SIM,1850,35,30-34,1885,10
SIM,1858,44,45-49,1902,2
STAT,1923,13,na,1936,4388.905196703384
STAT,1880,45,50-100,1925,0.24655984390064753
STAT,1959,11,na,1970,4853.7555227110715
STAT,1864,37,20-24,1901,0.6508360128216515
SIM,1961,9,na,1970,4704
STAT,1788,88,na,1876,45.22118960419502
STAT,1872,26,na,1898,2270.6725381225483
SIM,1800,96,na,1896,1
SIM,1834,32,40-44,1866,4
STAT,1873,21,15-19,1894,3.1730123802082955
SIM,1920,45,na,1965,3791
SIM,1905,22,25-29,1927,82
SIM,1859,26,35-39,1885,11
STAT,1815,46,25-29,1861,0.14250504232172634
STAT,1832,43,20-24,1875,0.11629811881480726
STAT,1901,28,na,1929,3144.5605915371148
STAT,1893,23,40-44,1916,2.4899687944718734
SIM,1843,69,na,1912,1009
STAT,1914,45,30-34,1959,0.08389968427736455
SIM,1909,24,35-39,1933,7
STAT,1875,34,30-34,1909,16.800240536786127
STAT,1866,50,25-29,1916,0.0031293879145396827
STAT,1927,33,na,1960,4392.8304706630415
STAT,1882,37,25-29,1919,2.64670220818268
SIM,1869,74,na,1943,943
STAT,1900,32,25-29,1932,13.423849958671125
STAT,1857,6,na,1863,2183.7608811676073
SIM,1837,33,20-24,1870,2
STAT,1838,33,15-19,1871,0.11944425321279277
STAT,1807,60,na,1867,1006.3968752651239
STAT,1932,36,35-39,1968,3.0729588290635363
SIM,1926,21,30-34,1947,41
STAT,1826,32,40-44,1858,5.738460483071804
STAT,1850,34,25-29,1884,7.388199133238191
STAT,1870,20,35-39,1890,5.433955642378071
STAT,1937,32,20-24,1969,2.2794109499107718
STAT,1876,26,45-49,1902,1.0865450977897253
SIM,1919,35,30-34,1954,2
STAT,1803,94,na,1897,6.602949673647755
STAT,1820,76,na,1896,504.71453781190854
SIM,1812,81,na,1893,238
SIM,1857,55,na,1912,1642
SIM,1941,8,na,1949,3728
STAT,1811,99,na,1910,0.8203268877365569
STAT,1857,52,25-29,1909,0.0026238738620417306
STAT,1828,41,50-100,1869,0.9476799022217731
SIM,1845,20,35-39,1865,5
STAT,1851,17,40-44,1868,0.16307244403257956
STAT,1846,49,20-24,1895,0.008284213293145921
SIM,1931,36,25-29,1967,2
STAT,1946,25,25-29,1971,69.32649100434676
SIM,1846,26,25-29,1872,41
SIM,1890,37,25-29,1927,1
STAT,1824,44,25-29,1868,0.7722581810453487
STAT,1952,10,na,1962,4448.391078134541
SIM,1912,16,na,1928,3541
STAT,1835,49,45-49,1884,0.15128343780955236
SIM,1918,22,35-39,1940,9
SIM,1928,35,25-29,1963,3
STAT,1914,38,25-29,1952,0.9239325032514248
STAT,1883,28,50-100,1911,0.5901853532116451
STAT,1923,36,25-29,1959,1.078831696574566
SIM,1799,60,na,1859,926
SIM,1894,51,na,1945,2783
SIM,1858,8,na,1866,2302
SIM,1922,38,25-29,1960,1
STAT,1837,20,35-39,1857,4.926724308211995
SIM,1888,49,50-100,1937,2
SIM,1866,29,45-49,1895,1
STAT,1820,42,na,1862,1450.238765547547
SIM,1895,29,na,1924,2980
SIM,1842,33,30-34,1875,19
STAT,1884,15,50-100,1899,0.04594836020734889
SIM,1867,25,30-34,1892,31
STAT,1786,77,na,1863,317.4199782518403
SIM,1894,20,30-34,1914,26
SIM,1887,38,50-100,1925,1
SIM,1920,35,na,1955,3827
STAT,1866,48,50-100,1914,0.21122705836061823
SIM,1882,56,na,1938,1846
STAT,1841,36,25-29,1877,2.345181665097366
STAT,1931,35,20-24,1966,0.33038671972670225
SIM,1826,33,45-49,1859,1
STAT,1833,108,na,1941,0.001112021158109584
STAT,1943,27,50-100,1970,1.0013878002454828
SIM,1843,25,45-49,1868,5
SIM,1817,90,na,1907,29
SIM,1866,32,na,1898,2103
SIM,1860,22,40-44,1882,1
STAT,1929,33,25-29,1962,11.084658348059365
STAT,1861,58,na,1919,1551.379066848484
SIM,1893,24,45-49,1917,1
STAT,1821,43,45-49,1864,2.423495556953096
SIM,1862,42,45-49,1904,4
STAT,1837,43,50-100,1880,0.7769401366696975
STAT,1918,21,30-34,1939,29.371508800270654
SIM,1936,25,20-24,1961,7
STAT,1845,34,na,1879,1777.7948163685705
STAT,1907,29,na,1936,3288.6470603574467
SIM,1919,28,25-29,1947,67
SIM,1869,36,20-24,1905,2
STAT,1904,16,20-24,1920,24.078015224373452
STAT,1942,16,na,1958,3634.632005826912
STAT,1834,33,30-34,1867,13.700500781990662
SIM,1787,75,na,1862,365
SIM,1889,39,40-44,1928,5
STAT,1885,24,45-49,1909,0.6521960901300955
SIM,1912,16,20-24,1928,28
STAT,1827,29,15-19,1856,0.6564948324612458
STAT,1890,17,na,1907,2917.143306929711
STAT,1929,17,20-24,1946,163.4627024827939
SIM,1874,37,na,1911,2252
SIM,1858,33,50-100,1891,4
SIM,1870,37,na,1907,2178
STAT,1852,22,40-44,1874,1.8807916756227057
STAT,1884,39,50-100,1923,1.1346111791871378
STAT,1886,20,30-34,1906,17.884948857003277
SIM,1836,20,25-29,1856,52
SIM,1889,31,45-49,1920,2
STAT,1883,73,na,1956,1131.0259427939793
SIM,1916,7,na,1923,3907
SIM,1941,13,na,1954,3700
STAT,1801,93,na,1894,11.120835287815822
STAT,1877,16,35-39,1893,0.539230002510461
STAT,1917,25,45-49,1942,1.723111520506917
SIM,1887,27,25-29,1914,56
STAT,1776,105,na,1881,0.01724125673374935
STAT,1905,17,35-39,1922,0.7490732612966078
STAT,1820,53,40-44,1873,0.016356551741034155
STAT,1916,35,40-44,1951,1.4619218529010505
SIM,1937,17,20-24,1954,104
STAT,1835,25,45-49,1860,0.9159718001014887
SIM,1878,9,na,1887,2651
SIM,1857,89,na,1946,71
SIM,1936,27,30-34,1963,30
STAT,1892,40,25-29,1932,0.767341535489717
STAT,1928,25,20-24,1953,21.39113766713069
STAT,1845,24,na,1869,1842.9208664936232
STAT,1940,15,na,1955,3532.0403675532425
STAT,1915,48,na,1963,3487.1481765125914
STAT,1829,33,20-24,1862,2.569746043651607
STAT,1881,29,20-24,1910,10.624292220058754
STAT,1943,5,na,1948,3993.066885218409
STAT,1832,61,na,1893,1129.8864246963713
STAT,1874,42,15-19,1916,0.013317409801662277
SIM,1897,3,na,1900,3367
STAT,1879,27,25-29,1906,41.76978004814977
SIM,1925,25,45-49,1950,5
STAT,1896,24,20-24,1920,85.50084624942943
STAT,1910,36,15-19,1946,0.01742860090551842
STAT,1903,29,na,1932,3184.6410449258874
STAT,1924,37,40-44,1961,1.6677480846197223
SIM,1861,19,15-19,1880,4
SIM,1872,16,25-29,1888,7
STAT,1892,18,40-44,1910,0.21580865536676613
SIM,1880,6,na,1886,2728
STAT,1895,19,20-24,1914,21.73852194405851
STAT,1942,10,na,1952,3894.9478738228017
STAT,1786,108,na,1894,9.014027398911045E-4
STAT,1954,18,25-29,1972,50.59161640819991
SIM,1880,21,na,1901,2432
SIM,1799,94,na,1893,6
STAT,1918,17,45-49,1935,0.10305068671518693
SIM,1833,27,40-44,1860,2
SIM,1821,41,45-49,1862,4
SIM,1836,28,20-24,1864,10
SIM,1884,21,15-19,1905,3
STAT,1870,52,40-44,1922,0.009693245662949516
STAT,1863,25,20-24,1888,9.883372220920709
SIM,1802,81,na,1883,174
STAT,1865,42,20-24,1907,0.13616437952481406
STAT,1934,17,45-49,1951,0.6382956117878786
STAT,1937,18,25-29,1955,39.71654845259888
STAT,1818,46,50-100,1864,0.5331351122590958
SIM,1876,2,na,1878,3097
SIM,1797,65,na,1862,816
SIM,1899,29,na,1928,3031
STAT,1852,81,na,1933,410.85791742195033
SIM,1863,89,na,1952,69
STAT,1856,102,na,1958,0.36992375690442725
STAT,1864,16,25-29,1880,5.4711683676998435
SIM,1886,19,20-24,1905,13
SIM,1817,59,na,1876,1141
SIM,1878,34,20-24,1912,2
STAT,1881,16,25-29,1897,5.181567065116673
SIM,1849,43,40-44,1892,4
SIM,1868,31,25-29,1899,11
STAT,1862,44,45-49,1906,1.189769875665263
SIM,1857,44,30-34,1901,1
SIM,1913,47,50-100,1960,2
SIM,1853,69,na,1922,1143
SIM,1914,35,na,1949,3841
SIM,1913,17,35-39,1930,4
STAT,1853,19,15-19,1872,5.232065510085078
STAT,1885,15,30-34,1900,1.5070867860551374
SIM,1852,30,35-39,1882,8
STAT,1890,21,na,1911,2739.942255488423
SIM,1821,64,na,1885,968
STAT,1868,90,na,1958,100.57833549985986
STAT,1887,35,na,1922,2512.720798190172
STAT,1918,30,45-49,1948,1.5923203265820467
STAT,1802,57,na,1859,1011.6901859145219
STAT,1810,76,na,1886,409.27397646276165
STAT,1879,48,20-24,1927,0.011700299999586135
STAT,1885,6,na,1891,2458.696770506326
STAT,1874,21,na,1895,2290.4231762888107
STAT,1905,24,25-29,1929,77.65992973178128
SIM,1863,99,na,1962,6
STAT,1907,13,na,1920,3577.5924205685387
STAT,1927,43,na,1970,4393.739063856933
STAT,1880,32,45-49,1912,1.7333565092678704
STAT,1853,48,50-100,1901,0.17985030202165933
STAT,1859,28,35-39,1887,7.3469972128564685
STAT,1828,28,20-24,1856,17.06452858516124
STAT,1909,19,45-49,1928,0.09202356437857008
STAT,1933,35,40-44,1968,1.929586059252075
SIM,1859,30,20-24,1889,2
STAT,1820,38,45-49,1858,4.251845018185132
SIM,1926,30,45-49,1956,2
SIM,1906,27,50-100,1933,5
STAT,1884,16,40-44,1900,0.17116662800993807
SIM,1926,20,na,1946,4106
STAT,1918,8,na,1926,4100.960689413214
STAT,1813,41,45-49,1854,5.531170428771127
SIM,1932,37,40-44,1969,2
SIM,1912,10,na,1922,3641
SIM,1925,40,40-44,1965,3
SIM,1937,33,25-29,1970,11
SIM,1945,18,25-29,1963,46
STAT,1925,27,45-49,1952,1.9278955052409723
STAT,1844,30,35-39,1874,8.679928255634886
SIM,1853,48,50-100,1901,4
STAT,1932,40,20-24,1972,0.022674969789402664
STAT,1923,38,35-39,1961,2.6451291342082737
STAT,1914,3,na,1917,3949.9945561833338
STAT,1790,82,na,1872,157.09456890345888
STAT,1843,15,40-44,1858,0.17063536051531114
SIM,1812,43,45-49,1855,2
STAT,1908,27,45-49,1935,1.555568973211046
SIM,1845,18,20-24,1863,21
STAT,1833,41,15-19,1874,0.010314839936359775
SIM,1863,26,25-29,1889,44
SIM,1916,1,na,1917,4006
STAT,1891,35,25-29,1926,3.398638244510219
STAT,1858,29,45-49,1887,0.8308841184414417
STAT,1863,43,na,1906,1905.4204065484855
SIM,1862,18,20-24,1880,19
STAT,1838,26,25-29,1864,36.96550948920268
STAT,1902,51,na,1953,2884.3047846916543
SIM,1805,95,na,1900,3
STAT,1862,36,na,1898,1907.6732892911373
STAT,1845,22,35-39,1867,5.102800471462416
SIM,1856,18,na,1874,2158
STAT,1925,14,na,1939,4507.611351029849
SIM,1931,38,35-39,1969,10
STAT,1868,23,30-34,1891,16.01662552177402
SIM,1926,30,na,1956,4178
STAT,1861,54,40-44,1915,0.008031586640847441
SIM,1894,41,na,1935,2983
SIM,1873,37,25-29,1910,2
STAT,1854,18,20-24,1872,15.181487873521444
STAT,1798,78,na,1876,309.1218396374374
STAT,1833,39,na,1872,1591.965956295972
STAT,1886,16,na,1902,2527.059773276704
STAT,1861,23,45-49,1884,0.5579527053615576
STAT,1860,33,40-44,1893,3.3155053174636695
STAT,1837,18,20-24,1855,15.598525255654458
STAT,1905,21,50-100,1926,0.5583780051620826
SIM,1874,28,40-44,1902,6
SIM,1932,30,na,1962,4611
STAT,1856,47,25-29,1903,0.042419206611097736
SIM,1925,22,25-29,1947,108
SIM,1870,44,45-49,1914,7
SIM,1906,16,na,1922,3559
SIM,1916,27,45-49,1943,1
STAT,1844,23,45-49,1867,0.6068168423788478
SIM,1872,23,15-19,1895,5
STAT,1937,25,30-34,1962,36.10885880644106
SIM,1876,23,30-34,1899,23
SIM,1876,48,50-100,1924,4
SIM,1884,26,45-49,1910,1
STAT,1899,20,na,1919,3080.0923697686176
STAT,1960,1,na,1961,4843.560603127418
STAT,1874,90,na,1964,179.8326349998071
STAT,1802,105,na,1907,0.010002382366135678
STAT,1913,13,na,1926,3807.7868578575594
STAT,1942,25,40-44,1967,4.6252534601437105
STAT,1943,15,45-49,1958,0.5006738282956552
SIM,1878,41,50-100,1919,2
STAT,1823,36,20-24,1859,1.3063227315464683
STAT,1890,27,20-24,1917,13.5501431557878
STAT,1868,30,20-24,1898,2.457694676462278
STAT,1913,16,30-34,1929,2.359513772797244
SIM,1921,16,30-34,1937,16
SIM,1865,54,na,1919,1786
STAT,1871,50,35-39,1921,0.008178623234971462
STAT,1850,41,15-19,1891,0.00976614247577404
STAT,1877,54,50-100,1931,0.014398340767432807
STAT,1902,41,na,1943,3105.856142463834
SIM,1886,22,na,1908,2286
STAT,1829,52,50-100,1881,0.010713143985747294
STAT,1855,26,25-29,1881,31.453537989053636
SIM,1911,17,15-19,1928,7
SIM,1816,43,30-34,1859,3
STAT,1917,22,25-29,1939,92.73804027770954
STAT,1919,14,na,1933,4123.075398690047
SIM,1945,25,30-34,1970,38
STAT,1869,53,45-49,1922,0.013057610275800274
STAT,1948,20,15-19,1968,5.778410070322084
STAT,1864,23,15-19,1887,2.809872272110304
STAT,1903,17,15-19,1920,7.976232407373522
STAT,1833,49,na,1882,1418.9128988465475
SIM,1883,34,30-34,1917,20
STAT,1848,76,na,1924,682.5318884292203
STAT,1914,46,50-100,1960,0.21239900485924787
STAT,1855,48,35-39,1903,0.0979072882226326
SIM,1922,22,25-29,1944,104
STAT,1838,47,20-24,1885,0.008420142577497939
SIM,1929,25,15-19,1954,3
SIM,1842,43,40-44,1885,3
STAT,1871,72,na,1943,1182.7559541565133
SIM,1807,59,na,1866,978
STAT,1827,39,na,1866,1527.915983624707
STAT,1892,34,30-34,1926,20.478124622688515
SIM,1908,25,45-49,1933,2
STAT,1879,24,20-24,1903,67.62042494553282
STAT,1899,27,40-44,1926,3.8780973792429796
SIM,1844,22,25-29,1866,52
STAT,1904,46,na,1950,3057.3588435672127
STAT,1914,48,35-39,1962,0.12043833531698149
STAT,1840,54,20-24,1894,4.997674949647684E-4
STAT,1835,20,15-19,1855,3.6677612664242196
STAT,1856,21,15-19,1877,2.855411469615613
STAT,1806,52,50-100,1858,0.04264291097062941
STAT,1845,20,25-29,1865,50.78473167829454
STAT,1944,21,50-100,1965,0.6713577468673388
SIM,1846,87,na,1933,104
SIM,1912,22,15-19,1934,3
SIM,1932,32,50-100,1964,2
STAT,1825,43,30-34,1868,1.2560262703038654
STAT,1814,47,35-39,1861,0.3797949867036802
STAT,1846,33,20-24,1879,2.228976428844539
SIM,1909,21,30-34,1930,28
STAT,1905,48,25-29,1953,0.04379820435870283
STAT,1873,73,na,1946,1138.9459147888538
STAT,1906,36,25-29,1942,0.8589859896746042
STAT,1899,43,50-100,1942,0.09428959171525265
SIM,1854,33,20-24,1887,2
SIM,1850,17,na,1867,2053
STAT,1881,38,35-39,1919,6.41952316935456
STAT,1876,87,na,1963,324.4854830941748
SIM,1853,22,35-39,1875,6
SIM,1904,31,20-24,1935,1
STAT,1840,34,50-100,1874,0.7612138548425308
SIM,1833,43,30-34,1876,3
STAT,1911,21,45-49,1932,1.0109085962031314
STAT,1839,24,na,1863,1805.5734321640457
STAT,1871,18,20-24,1889,16.612345336800946
STAT,1909,31,30-34,1940,14.257491762597658
STAT,1904,22,15-19,1926,4.469594000406249
STAT,1824,41,20-24,1865,0.20607594075299226
STAT,1944,20,45-49,1964,1.1484351400506543
STAT,1851,58,na,1909,1450.2047382705696
STAT,1917,43,na,1960,3655.504432640223
STAT,1877,20,20-24,1897,67.95916586015842
SIM,1887,24,20-24,1911,59
STAT,1785,108,na,1893,0.001321785996156087
STAT,1836,22,25-29,1858,47.70887743966354
SIM,1917,24,40-44,1941,2
STAT,1831,75,na,1906,627.8329387133429
STAT,1932,33,30-34,1965,19.774008079524954
STAT,1861,88,na,1949,107.6957723835719
STAT,1883,50,25-29,1933,0.0033265600757556523
SIM,1903,19,30-34,1922,2
SIM,1892,22,na,1914,2847
STAT,1838,48,na,1886,1558.53529763114
STAT,1818,93,na,1911,14.090249674883779
STAT,1937,19,20-24,1956,124.2109344881959
SIM,1883,40,25-29,1923,3
SIM,1933,27,45-49,1960,3
STAT,1897,15,50-100,1912,0.06218467530381896
STAT,1839,65,na,1904,1126.8198627163788
STAT,1929,30,20-24,1959,2.930404936569931
STAT,1931,31,50-100,1962,1.0240704771853282
SIM,1864,21,15-19,1885,2
SIM,1913,24,25-29,1937,78
SIM,1904,16,30-34,1920,2
STAT,1877,73,na,1950,1164.374096518453
SIM,1867,28,35-39,1895,7
STAT,1786,102,na,1888,0.08358093483163007
STAT,1952,16,na,1968,4168.280083895229
STAT,1872,39,20-24,1911,0.7235643005445522
SIM,1930,21,20-24,1951,138
SIM,1881,27,20-24,1908,10
SIM,1852,20,40-44,1872,2
STAT,1858,90,na,1948,58.470499375175095
STAT,1812,51,40-44,1863,0.03380094440867123
STAT,1872,15,20-24,1887,17.0659746337312
SIM,1812,77,na,1889,337
SIM,1873,3,na,1876,2837
STAT,1888,72,na,1960,1559.2091786369413
STAT,1903,35,45-49,1938,0.5837982041664034
STAT,1834,43,40-44,1877,1.6570905949693
SIM,1843,20,15-19,1863,5
SIM,1945,19,20-24,1964,130
STAT,1914,22,25-29,1936,89.13443809472558
SIM,1853,20,25-29,1873,62
STAT,1928,28,25-29,1956,76.5759049725949
STAT,1840,37,35-39,1877,5.82589878602119
SIM,1908,11,na,1919,3560
STAT,1875,44,40-44,1919,2.153541220281556
STAT,1943,16,40-44,1959,1.4015365883666728
STAT,1828,52,45-49,1880,0.011803602427249732
STAT,1918,28,15-19,1946,0.7072239020605352
STAT,1900,19,40-44,1919,0.23842531257573937
STAT,1898,31,45-49,1929,2.2391601691658076
STAT,1895,54,na,1949,2581.5004901513535
STAT,1864,31,15-19,1895,0.12072769360224404
SIM,1851,36,50-100,1887,3
STAT,1775,115,na,1890,1.7267063026392824E-4
STAT,1906,38,35-39,1944,2.089627039447994
SIM,1877,21,25-29,1898,59
SIM,1900,30,25-29,1930,13
STAT,1891,32,20-24,1923,3.1607047677853295
SIM,1893,21,40-44,1914,4
SIM,1894,23,35-39,1917,8
STAT,1779,95,na,1874,2.4451805794931776
STAT,1872,20,na,1892,2255.924838914823
STAT,1813,108,na,1921,7.746861537958983E-4
STAT,1834,50,30-34,1884,0.003930643048231101
SIM,1868,30,30-34,1898,23
SIM,1880,15,20-24,1895,18
STAT,1897,59,na,1956,2476.7149053280805
SIM,1826,30,40-44,1856,3
STAT,1848,26,50-100,1874,0.5541459182724334
SIM,1914,38,35-39,1952,8
STAT,1816,92,na,1908,19.408485074369334
STAT,1926,19,45-49,1945,0.5755524778053169
STAT,1865,88,na,1953,117.8503889305678
SIM,1832,36,na,1868,1653
SIM,1866,26,40-44,1892,2
SIM,1846,23,20-24,1869,61
STAT,1909,24,40-44,1933,2.93293265779992
STAT,1861,53,45-49,1914,0.01120185732598564
STAT,1886,23,35-39,1909,5.806535786011899
SIM,1893,31,35-39,1924,12
SIM,1839,40,45-49,1879,1
SIM,1824,62,na,1886,969
STAT,1875,40,25-29,1915,0.6295265121988287
STAT,1891,42,15-19,1933,0.01612804588612796
SIM,1879,18,15-19,1897,5
STAT,1889,48,50-100,1937,0.15954380328685802
STAT,1848,49,40-44,1897,0.12076133659582376
STAT,1895,43,45-49,1938,0.12719904794263004
STAT,1842,41,25-29,1883,0.4792145578917959
STAT,1808,53,40-44,1861,0.037529931075667
SIM,1839,22,15-19,1861,2
STAT,1847,54,20-24,1901,5.280219038702681E-4
SIM,1936,28,25-29,1964,53
SIM,1877,29,20-24,1906,15
SIM,1883,44,40-44,1927,7
SIM,1926,28,15-19,1954,3
SIM,1951,16,40-44,1967,1
SIM,1812,43,na,1855,1355
STAT,1921,16,20-24,1937,146.3622125897044
STAT,1832,23,na,1855,1710.7491592010936
STAT,1907,49,20-24,1956,0.00924510012149364
STAT,1865,45,25-29,1910,0.049939381639304836
STAT,1903,16,50-100,1919,0.06600842504424342
STAT,1885,31,35-39,1916,9.570336775610286
STAT,1869,21,25-29,1890,52.5055352078703
STAT,1853,1,na,1854,2832.0
STAT,1935,21,30-34,1956,36.98410997290201
SIM,1847,35,na,1882,1770
SIM,1943,21,30-34,1964,40
SIM,1946,23,25-29,1969,117
SIM,1827,32,35-39,1859,8
SIM,1880,37,na,1917,2413
STAT,1874,86,na,1960,322.6300968072469
SIM,1914,36,25-29,1950,1
SIM,1931,28,25-29,1959,85
STAT,1851,33,30-34,1884,13.18848729178964
STAT,1886,21,25-29,1907,57.31073286221284
STAT,1931,38,25-29,1969,1.2306490633494336
STAT,1885,21,40-44,1906,1.9671590169710074
STAT,1924,41,25-29,1965,0.08036469986418232
SIM,1830,31,na,1861,1759
STAT,1938,23,25-29,1961,86.32349035235826
STAT,1868,21,na,1889,2148.646809801765
STAT,1879,54,50-100,1933,0.014502843376835106
SIM,1852,56,na,1908,1563
STAT,1814,42,na,1856,1326.915886061522
STAT,1866,28,40-44,1894,2.5999192665400916
SIM,1875,84,na,1959,453
STAT,1896,49,35-39,1945,0.09653999534677148
STAT,1818,40,35-39,1858,4.700070488246714
STAT,1855,24,na,1879,1743.7662671342312
SIM,1859,20,na,1879,2052
STAT,1880,55,na,1935,2055.304023977683
SIM,1884,51,na,1935,2132
SIM,1919,29,20-24,1948,20
STAT,1816,51,25-29,1867,0.009108505457387624
SIM,1895,67,na,1962,2131
SIM,1909,32,35-39,1941,12
STAT,1897,48,25-29,1945,0.040534083929118406
SIM,1838,21,na,1859,1764
SIM,1894,21,25-29,1915,75
STAT,1839,52,20-24,1891,4.894047654044518E-4
STAT,1944,18,15-19,1962,46.12241816218348
STAT,1928,27,30-34,1955,45.60728135023668
STAT,1900,22,30-34,1922,23.344591718527127
STAT,1853,52,40-44,1905,0.007765824596864469
STAT,1879,8,na,1887,2615.1158510727787
STAT,1838,41,15-19,1879,0.011157132950114085
STAT,1879,34,15-19,1913,0.1394139914235917
STAT,1883,69,na,1952,1358.750155823
STAT,1824,43,50-100,1867,1.302925625346196
STAT,1917,26,40-44,1943,4.633421391711528
STAT,1913,29,na,1942,3500.249772602926
SIM,1917,25,na,1942,3687
SIM,1827,30,25-29,1857,7
STAT,1909,33,50-100,1942,0.7420104354843386
STAT,1771,85,na,1856,56.32711814
STAT,1831,38,20-24,1869,0.6016407163719308
STAT,1951,17,45-49,1968,0.5619886237578746
STAT,1891,34,na,1925,2766.4398729679556
SIM,1832,97,na,1929,2
SIM,1854,25,20-24,1879,13
STAT,1863,28,25-29,1891,35.00402507321518
SIM,1886,21,35-39,1907,6
STAT,1922,2,na,1924,4471.777198135971
STAT,1846,25,20-24,1871,10.151754126096003
STAT,1936,27,20-24,1963,16.500237280514053
STAT,1946,18,35-39,1964,4.395419045700605
SIM,1952,18,15-19,1970,44
SIM,1876,30,20-24,1906,2
STAT,1828,93,na,1921,16.590569226547935
STAT,1882,20,na,1902,2187.042844130048
SIM,1882,22,na,1904,2166
SIM,1871,28,25-29,1899,48
STAT,1859,25,30-34,1884,19.593306313336047
SIM,1859,33,25-29,1892,10
STAT,1861,15,45-49,1876,0.05959903843814996
SIM,1826,40,35-39,1866,2
SIM,1875,33,40-44,1908,5
STAT,1832,108,na,1940,0.0011075672868817827
STAT,1954,15,20-24,1969,158.41201494288467
STAT,1838,23,20-24,1861,60.54114740133731
STAT,1843,18,45-49,1861,0.05987068469985408
SIM,1806,81,na,1887,165
SIM,1868,33,35-39,1901,10
SIM,1911,1,na,1912,3900
STAT,1822,92,na,1914,21.513294323654264
STAT,1858,26,40-44,1884,2.2906879607579698
STAT,1847,59,na,1906,1429.9789610179143
STAT,1911,28,15-19,1939,0.6479454748371265
STAT,1844,32,50-100,1876,0.7691750453210013
STAT,1895,45,50-100,1940,0.1724933783497499
STAT,1807,48,40-44,1855,0.6237110422082629
STAT,1914,28,30-34,1942,37.17749057608582
STAT,1844,17,35-39,1861,0.48965380477824244
SIM,1864,37,na,1901,2103
SIM,1867,34,45-49,1901,1
SIM,1867,55,na,1922,1796
STAT,1854,42,45-49,1896,1.0763950993283211
STAT,1829,41,na,1870,1619.080985756656
STAT,1933,39,20-24,1972,0.3384774745270751
STAT,1807,94,na,1901,7.169302251313276
SIM,1844,21,na,1865,1926
SIM,1869,84,na,1953,250
STAT,1922,21,20-24,1943,120.83478844314403
STAT,1867,33,40-44,1900,3.8304366782428003
STAT,1916,1,na,1917,4171.815378131733
STAT,1875,51,30-34,1926,0.0058048172044296974
STAT,1908,60,na,1968,2922.136399549078
SIM,1859,44,50-100,1903,1
STAT,1871,88,na,1959,191.4234542046182
SIM,1836,56,na,1892,1285
SIM,1922,28,30-34,1950,51
STAT,1910,28,15-19,1938,0.6415443846383353
STAT,1922,34,na,1956,4017.476890270659
SIM,1800,58,na,1858,1038
SIM,1849,54,na,1903,1573
STAT,1947,15,15-19,1962,48.32360194093596
STAT,1878,3,na,1881,3005.856300421822
STAT,1878,18,50-100,1896,0.048054952096672696
STAT,1933,38,45-49,1971,0.8763156106606677
STAT,1926,39,15-19,1965,0.02212638642252427
STAT,1867,73,na,1940,1053.537180050618
STAT,1926,32,45-49,1958,1.7977012397310184
STAT,1909,16,40-44,1925,0.25969154769560504
SIM,1929,10,na,1939,4879
SIM,1899,50,na,1949,2818
STAT,1813,94,na,1907,8.452660474595215
STAT,1843,60,na,1903,1375.9450492061655
STAT,1847,108,na,1955,0.0013477615285476345
STAT,1872,45,50-100,1917,0.2352001844404561
STAT,1844,20,40-44,1864,1.8529805003677196
SIM,1893,18,35-39,1911,2
SIM,1955,15,15-19,1970,45
STAT,1788,78,na,1866,297.02527334629485
STAT,1928,17,20-24,1945,161.3969248169436
STAT,1820,52,45-49,1872,0.02300131169484223
SIM,1921,19,35-39,1940,2
SIM,1879,36,na,1915,2317
STAT,1860,19,50-100,1879,0.04287146216399665
SIM,1835,22,30-34,1857,25
SIM,1858,72,na,1930,997
STAT,1871,31,40-44,1902,4.078121395453673
STAT,1918,46,45-49,1964,0.21902894416578908
STAT,1954,17,30-34,1971,14.234358362854966
STAT,1925,47,15-19,1972,4.217412941955725E-4
SIM,1937,30,20-24,1967,5
STAT,1878,19,20-24,1897,17.341667734152093
STAT,1885,18,35-39,1903,0.5150806637712206
STAT,1914,35,20-24,1949,0.2509589177582288
SIM,1954,11,na,1965,4435
STAT,1884,19,45-49,1903,0.060654123524259265
SIM,1936,17,20-24,1953,95
SIM,1916,24,40-44,1940,4
STAT,1913,19,35-39,1932,0.8059560167824176
STAT,1833,45,30-34,1878,0.0707866124832569
SIM,1930,32,50-100,1962,6
SIM,1855,54,na,1909,1646
SIM,1848,38,40-44,1886,8
SIM,1910,5,na,1915,3677
STAT,1915,14,na,1929,3891.7984739802455
SIM,1944,27,20-24,1971,19
STAT,1909,14,na,1923,3645.9031485867317
STAT,1838,76,na,1914,646.1523314451861
STAT,1857,30,45-49,1887,1.3341521095826627
STAT,1883,40,15-19,1923,0.012915083077880177
SIM,1917,16,40-44,1933,1
SIM,1860,17,na,1877,2249
STAT,1908,24,40-44,1932,2.9012040986808563
SIM,1904,24,30-34,1928,34
SIM,1934,32,45-49,1966,2
STAT,1859,41,35-39,1900,1.3713942390056684
STAT,1843,39,na,1882,1768.5881495109218
STAT,1883,42,25-29,1925,0.5938200869279064
STAT,1894,20,20-24,1914,84.24352250222182
SIM,1831,39,25-29,1870,5
STAT,1823,39,25-29,1862,4.077009057601382
STAT,1897,22,15-19,1919,4.168037651816629
STAT,1849,54,40-44,1903,0.007379561798915461
SIM,1895,26,20-24,1921,17
STAT,1873,44,20-24,1917,0.15023154827691634
STAT,1885,37,40-44,1922,4.120015294724961
SIM,1918,8,na,1926,4070
SIM,1928,28,35-39,1956,16
STAT,1887,26,20-24,1913,12.436771261230184
SIM,1893,37,40-44,1930,3
STAT,1906,46,35-39,1952,0.10894256233127472
SIM,1830,72,na,1902,786
STAT,1904,40,45-49,1944,0.14222723466069678
STAT,1927,22,35-39,1949,10.960525788663523
SIM,1926,22,45-49,1948,2
SIM,1935,22,35-39,1957,14
SIM,1891,42,25-29,1933,7
SIM,1921,17,25-29,1938,57
STAT,1833,38,40-44,1871,3.2969752593706056
STAT,1872,23,20-24,1895,65.14107577365064
SIM,1865,30,45-49,1895,1
STAT,1806,53,20-24,1859,0.002042099280034744
STAT,1822,49,35-39,1871,0.18979256166088015
SIM,1880,45,50-100,1925,3
STAT,1850,31,20-24,1881,2.011464922127512
SIM,1841,38,40-44,1879,4
STAT,1836,54,45-49,1890,0.008912575309165888
STAT,1913,17,25-29,1930,8.368292390535657
STAT,1825,75,na,1900,582.051809298516
SIM,1858,36,45-49,1894,1
STAT,1901,24,40-44,1925,2.738144000311922
SIM,1832,43,50-100,1875,4
SIM,1844,82,na,1926,278
SIM,1873,34,20-24,1907,4
SIM,1925,26,40-44,1951,5
SIM,1861,22,25-29,1883,43
SIM,1906,36,35-39,1942,5
SIM,1889,33,na,1922,2779
STAT,1907,48,45-49,1955,0.18238386162165424
SIM,1830,62,na,1892,1138
SIM,1943,24,35-39,1967,11
STAT,1846,36,25-29,1882,2.142062256347173
SIM,1892,18,na,1910,3044
SIM,1946,20,20-24,1966,111
SIM,1849,21,30-34,1870,22
SIM,1880,37,30-34,1917,11
STAT,1871,20,35-39,1891,5.497789028959602
SIM,1821,33,45-49,1854,1
SIM,1822,43,na,1865,1459
STAT,1842,43,30-34,1885,0.8362443011364723
STAT,1945,23,15-19,1968,5.50963793223236
SIM,1792,83,na,1875,89
STAT,1940,18,30-34,1958,11.686383752562328
SIM,1911,4,na,1915,3829
STAT,1797,83,na,1880,136.4044599633951
STAT,1864,38,na,1902,1979.3105655864856
STAT,1924,45,40-44,1969,0.17817045956724403
SIM,1904,52,na,1956,2862
SIM,1950,11,na,1961,4276
STAT,1889,24,50-100,1913,0.4726172333698354
STAT,1842,23,na,1865,1906.6429680399694
STAT,1845,43,50-100,1888,0.7481301497254089
STAT,1909,52,na,1961,3134.636078501143
STAT,1888,38,20-24,1926,0.8560082215400122
SIM,1825,88,na,1913,45
STAT,1881,23,15-19,1904,2.9998865182101135
STAT,1851,43,40-44,1894,1.6375158232959655
SIM,1897,52,na,1949,2726
SIM,1944,17,na,1961,3673
STAT,1841,65,na,1906,1156.2581201691871
STAT,1884,52,na,1936,1999.4217359305
STAT,1929,41,50-100,1970,0.14394173256464252
STAT,1897,18,na,1915,3182.5294637350503
STAT,1873,15,na,1888,2450.6078940550187
SIM,1877,48,na,1925,2197
STAT,1815,58,na,1873,1069.0809430479255
SIM,1904,18,20-24,1922,17
STAT,1894,16,35-39,1910,0.6684401474826641
SIM,1882,39,40-44,1921,8
STAT,1823,40,na,1863,1488.8708210956888
STAT,1864,38,35-39,1902,5.942123878794416
SIM,1825,35,50-100,1860,4
STAT,1934,37,15-19,1971,0.0250338559129578
STAT,1872,37,30-34,1909,5.053517941548024
STAT,1836,32,35-39,1868,8.083509200333548
STAT,1884,4,na,1888,2605.5590681895305
SIM,1854,36,25-29,1890,1
SIM,1886,43,45-49,1929,2
SIM,1858,33,40-44,1891,3
STAT,1777,79,na,1856,244.0586875455
STAT,1935,24,35-39,1959,12.10412669413642
SIM,1866,60,na,1926,1650
SIM,1810,48,na,1858,1314
STAT,1836,37,45-49,1873,1.5451823756149914
SIM,1858,68,na,1926,1237
STAT,1930,19,35-39,1949,5.0977080333212195
SIM,1810,58,na,1868,1065
STAT,1933,31,25-29,1964,11.773694139549086
STAT,1901,41,40-44,1942,0.20746823939421719
STAT,1837,38,25-29,1875,2.1900551229927534
STAT,1930,30,45-49,1960,1.9207138702569353
SIM,1845,38,25-29,1883,2
STAT,1868,24,45-49,1892,0.6250305942449106
STAT,1870,38,50-100,1908,1.1308470592217987
STAT,1890,19,20-24,1909,20.367119097755655
SIM,1908,22,25-29,1930,83
STAT,1774,112,na,1886,7.223470497376344E-4
STAT,1850,42,na,1892,1625.1148984790125
SIM,1841,31,20-24,1872,2
SIM,1850,43,30-34,1893,4
STAT,1941,30,20-24,1971,2.4218343955492
SIM,1835,25,35-39,1860,11
SIM,1835,39,45-49,1874,1
SIM,1844,37,45-49,1881,1
STAT,1808,73,na,1881,537.5941247914561
STAT,1815,51,50-100,1866,0.03583790497279249
STAT,1876,21,15-19,1897,3.227104577454884
STAT,1848,38,na,1886,1731.034242833151
STAT,1905,39,45-49,1944,0.5814825584361519
SIM,1877,31,35-39,1908,17
STAT,1854,35,20-24,1889,0.5635772349318275
SIM,1914,35,30-34,1949,2
STAT,1871,25,50-100,1896,0.6031642071561201
STAT,1823,37,35-39,1860,11.30561311194651
SIM,1849,26,40-44,1875,2
STAT,1874,39,40-44,1913,4.184077974005861
SIM,1867,31,40-44,1898,4
STAT,1879,38,50-100,1917,1.206299521862809
STAT,1797,93,na,1890,7.1159479764384175
STAT,1892,44,40-44,1936,0.1822847821173343
SIM,1920,25,45-49,1945,1
STAT,1904,27,50-100,1931,0.8666700325683678
STAT,1898,72,na,1970,1990.5808208770513
SIM,1852,36,40-44,1888,2
STAT,1827,39,45-49,1866,1.8966211595134204
STAT,1848,45,25-29,1893,0.041910096416840764
STAT,1921,19,25-29,1940,46.41816627287329
SIM,1844,32,35-39,1876,11
STAT,1837,60,na,1897,1203.9218662148637
SIM,1935,20,45-49,1955,1
STAT,1919,33,15-19,1952,0.13042104481840291
STAT,1868,31,35-39,1899,9.171709816276909
STAT,1922,24,25-29,1946,99.44883880688604
SIM,1861,30,na,1891,2074
STAT,1859,31,40-44,1890,3.2829184927219215
STAT,1825,53,40-44,1878,0.010431607676423038
STAT,1890,28,35-39,1918,11.105543405534997
STAT,1902,38,15-19,1940,0.016078235042403494
STAT,1909,34,35-39,1943,8.165524952595579
SIM,1896,38,20-24,1934,5
STAT,1829,34,na,1863,1709.1063075679879
STAT,1860,40,30-34,1900,0.8915753551988573
STAT,1844,36,40-44,1880,3.605781781607428
STAT,1830,25,na,1855,1704.362168705149
STAT,1841,68,na,1909,1045.5798912742328
SIM,1930,24,25-29,1954,114
SIM,1928,27,20-24,1955,19
STAT,1930,37,50-100,1967,0.517383575844262
SIM,1831,28,20-24,1859,8
SIM,1892,39,50-100,1931,1
STAT,1910,49,na,1959,3218.150431499871
STAT,1861,17,35-39,1878,0.49475193846741555
STAT,1875,23,50-100,1898,0.3945531489749726
STAT,1802,54,50-100,1856,0.04135393697788575
STAT,1900,49,na,1949,2887.5896471506057
STAT,1912,25,45-49,1937,1.6188668905649162
STAT,1855,8,na,1863,2068.5811111080156
STAT,1887,37,25-29,1924,3.0418618076237776
SIM,1826,36,na,1862,1612
STAT,1938,20,20-24,1958,104.02262646647796
SIM,1917,27,45-49,1944,1
SIM,1835,20,40-44,1855,1
STAT,1905,46,35-39,1951,0.1081146772646334
SIM,1858,38,35-39,1896,11
STAT,1861,50,40-44,1911,0.008377376239182365
STAT,1810,80,na,1890,280.1293683821466
STAT,1898,65,na,1963,2343.126180382373
STAT,1836,19,15-19,1855,7.053806558403235
SIM,1885,38,45-49,1923,3
STAT,1870,49,15-19,1919,3.625365824546978E-4
SIM,1938,0,na,1938,3821
STAT,1906,35,30-34,1941,1.5974500728469536
STAT,1943,19,45-49,1962,0.5000732885604159
STAT,1874,32,20-24,1906,2.609888448474066
SIM,1882,32,20-24,1914,1
SIM,1855,23,na,1878,2016
STAT,1875,18,40-44,1893,0.1770492848776331
STAT,1940,25,20-24,1965,17.59808110683406
STAT,1876,25,30-34,1901,24.725398512776998
STAT,1830,30,40-44,1860,3.7473877966787352
SIM,1899,34,40-44,1933,13
SIM,1867,49,50-100,1916,1
STAT,1877,38,45-49,1915,1.9445557887233103
STAT,1897,28,na,1925,3004.5567344008023
STAT,1900,36,40-44,1936,1.2442646760922182
SIM,1845,42,45-49,1887,2
STAT,1909,27,45-49,1936,1.5593447938004639
STAT,1908,25,50-100,1933,0.902309108015999
SIM,1844,19,15-19,1863,5
STAT,1874,46,30-34,1920,0.09372881243063848
STAT,1927,20,45-49,1947,1.3175631733399389
STAT,1928,30,50-100,1958,0.977841033261152
SIM,1885,67,na,1952,1485
STAT,1853,22,25-29,1875,50.1609449702603
SIM,1831,37,35-39,1868,13
STAT,1872,67,na,1939,1503.1072030846924
STAT,1880,24,45-49,1904,0.6887973884216303
SIM,1884,25,30-34,1909,27
STAT,1912,44,na,1956,3356.8893011621362
SIM,1909,30,45-49,1939,1
STAT,1935,17,45-49,1952,0.6451009813835759
SIM,1928,15,20-24,1943,149
STAT,1923,28,25-29,1951,71.14438490998616
SIM,1890,17,20-24,1907,18
SIM,1815,88,na,1903,48
STAT,1931,29,45-49,1960,2.1050272065944116
STAT,1910,15,na,1925,3631.0864027800035
SIM,1899,20,30-34,1919,30
STAT,1940,23,50-100,1963,0.6329516004369217
STAT,1831,36,30-34,1867,4.258391116860115
SIM,1885,30,30-34,1915,27
STAT,1863,15,na,1878,2200.966259602365
SIM,1871,32,45-49,1903,2
SIM,1896,15,na,1911,3241
STAT,1905,47,50-100,1952,0.18824534628531567
SIM,1917,6,na,1923,4012
SIM,1830,27,25-29,1857,38
STAT,1819,51,40-44,1870,0.0183423643112848
STAT,1843,51,35-39,1894,0.006240769653004987
STAT,1907,41,25-29,1948,0.06215085529899034
SIM,1840,26,20-24,1866,18
STAT,1864,40,50-100,1904,0.9009740366116591
SIM,1848,16,30-34,1864,1
SIM,1934,5,na,1939,5079
STAT,1941,23,30-34,1964,28.047600022494766
STAT,1909,15,45-49,1924,0.09294958886984894
STAT,1947,16,50-100,1963,0.39882920691522783
STAT,1823,46,na,1869,1388.4464962823658
SIM,1848,41,na,1889,1726
SIM,1876,60,na,1936,1859
SIM,1875,36,45-49,1911,3
STAT,1835,24,30-34,1859,14.56170088693161
STAT,1846,43,15-19,1889,0.009729354889700162
STAT,1873,47,25-29,1920,0.05497561953486405
SIM,1872,29,20-24,1901,10
SIM,1876,33,25-29,1909,15
SIM,1881,21,15-19,1902,2
SIM,1927,15,na,1942,4248
STAT,1838,28,15-19,1866,0.39079948814442284
STAT,1892,40,na,1932,2761.8015129962305
STAT,1889,46,25-29,1935,0.06736799564077223
STAT,1846,108,na,1954,0.001291497859038455
STAT,1870,26,40-44,1896,2.7824179828511673
STAT,1917,29,45-49,1946,1.6992677296667211
STAT,1904,26,30-34,1930,34.23410039372741
STAT,1939,30,15-19,1969,0.1239901661741073
STAT,1915,26,25-29,1941,63.633908230072606
STAT,1866,44,30-34,1910,0.9878321007662484
STAT,1941,16,25-29,1957,42.17577156826764
STAT,1862,27,45-49,1889,0.898022634028797
SIM,1827,73,na,1900,639
SIM,1843,24,30-34,1867,15
STAT,1912,49,30-34,1961,0.08044173679575227
SIM,1874,44,30-34,1918,2
STAT,1802,88,na,1890,46.832589938284755
SIM,1949,21,35-39,1970,15
STAT,1876,23,40-44,1899,2.025966178612983
SIM,1934,15,45-49,1949,1
SIM,1925,17,45-49,1942,1
STAT,1873,27,20-24,1900,11.249386336292302
STAT,1917,17,45-49,1934,0.10154747649594154
STAT,1868,33,25-29,1901,9.199607000193126
STAT,1897,45,20-24,1942,0.008637318469203728
STAT,1878,9,na,1887,2591.995758450065
SIM,1954,15,30-34,1969,21
SIM,1864,75,na,1939,896
STAT,1841,75,na,1916,704.3492830739362
STAT,1877,30,30-34,1907,17.253638698047695
SIM,1912,26,30-34,1938,45
STAT,1946,15,30-34,1961,12.778504697217624
STAT,1822,36,50-100,1858,2.3387122833199068
STAT,1886,42,40-44,1928,2.242292508012971
STAT,1926,15,45-49,1941,0.5813442083697989
STAT,1912,34,na,1946,3484.780646352182
SIM,1872,38,35-39,1910,10
SIM,1876,26,35-39,1902,11
SIM,1928,25,30-34,1953,57
STAT,1877,23,25-29,1900,55.945437761140305
SIM,1923,26,25-29,1949,64
STAT,1847,35,30-34,1882,4.1540511209308635
SIM,1925,29,45-49,1954,5
SIM,1835,32,25-29,1867,14
STAT,1854,42,50-100,1896,0.7598083032308985
STAT,1854,38,na,1892,1688.110790526834
SIM,1913,16,20-24,1929,22
STAT,1946,22,20-24,1968,116.89757271826242
SIM,1840,62,na,1902,1234
STAT,1901,20,25-29,1921,76.14676564599017
SIM,1817,80,na,1897,330
SIM,1940,26,25-29,1966,62
STAT,1915,47,40-44,1962,0.15007000097711057
STAT,1904,15,na,1919,3437.6475041691906
STAT,1894,23,25-29,1917,69.35106817858004
STAT,1905,16,20-24,1921,24.26164177536307
SIM,1904,27,35-39,1931,7
SIM,1886,39,25-29,1925,2
STAT,1929,39,30-34,1968,2.205891765054879
STAT,1845,41,40-44,1886,1.6341739059424703
STAT,1857,53,na,1910,1577.8262204592634
STAT,1832,26,20-24,1858,9.764964183690369
STAT,1878,43,45-49,1921,1.4612420686003598
STAT,1791,98,na,1889,0.5678403615492049
STAT,1872,26,25-29,1898,40.24795279203619
SIM,1809,61,na,1870,1005
STAT,1846,19,na,1865,2009.2245796274956
STAT,1829,29,50-100,1858,0.7002391204191544
SIM,1944,11,na,1955,3956
STAT,1840,80,na,1920,430.8007919181864
STAT,1868,48,50-100,1916,0.21874208272107587
STAT,1827,32,25-29,1859,11.918428208178629
STAT,1903,30,na,1933,3233.0615123809594
STAT,1898,23,50-100,1921,0.5198819438185018
STAT,1848,48,na,1896,1600.4723515900978
STAT,1853,60,na,1913,1414.3793838826616
SIM,1870,27,45-49,1897,3
STAT,1915,40,20-24,1955,0.016841688962033065
SIM,1830,31,45-49,1861,1
STAT,1915,33,50-100,1948,0.7920547976198309
STAT,1919,31,50-100,1950,0.8461238723633762
SIM,1911,31,na,1942,3514
STAT,1860,42,50-100,1902,0.81010255789513
SIM,1905,38,25-29,1943,3
STAT,1833,34,25-29,1867,7.865352500682226
SIM,1843,38,na,1881,1737
STAT,1901,28,20-24,1929,15.457741540013902
SIM,1855,35,30-34,1890,6
SIM,1904,34,25-29,1938,19
STAT,1785,98,na,1883,0.5841472187621328
STAT,1867,36,45-49,1903,1.77673422533512
STAT,1862,22,35-39,1884,4.813846287545066
SIM,1905,24,15-19,1929,3
SIM,1899,36,30-34,1935,1
STAT,1915,33,30-34,1948,15.093173314839522
STAT,1931,36,35-39,1967,3.028976477711803
SIM,1923,33,30-34,1956,17
STAT,1811,53,50-100,1864,0.04700269617527332
STAT,1861,3,na,1864,2547.49806147213
SIM,1853,41,40-44,1894,4
STAT,1883,44,30-34,1927,1.0500720644734138
SIM,1870,22,35-39,1892,8
STAT,1853,20,35-39,1873,5.187511411955024
SIM,1940,6,na,1946,3651
STAT,1878,50,35-39,1928,0.008588269611053191
SIM,1885,23,25-29,1908,63
STAT,1878,52,na,1930,2106.2654600970263
STAT,1867,19,45-49,1886,0.058537468114822695
STAT,1932,26,25-29,1958,81.48121249639107
SIM,1932,30,20-24,1962,2
STAT,1945,6,na,1951,4089.2661348483452
STAT,1816,53,30-34,1869,0.014706938805516108
STAT,1828,86,na,1914,125.95389565780587
STAT,1878,39,25-29,1917,2.803055404606007
STAT,1783,79,na,1862,220.65304705200037
SIM,1908,29,45-49,1937,2
SIM,1841,34,25-29,1875,19
STAT,1949,21,na,1970,4027.182321157895
STAT,1854,20,35-39,1874,5.00898533754803
SIM,1817,37,35-39,1854,13
STAT,1916,49,15-19,1965,3.548299713614552E-4
STAT,1832,46,25-29,1878,0.041821734820751875
STAT,1927,36,45-49,1963,0.8015225737571601
STAT,1882,34,20-24,1916,2.4635131869177505
SIM,1863,37,30-34,1900,10
SIM,1840,20,15-19,1860,2
SIM,1923,36,35-39,1959,6
SIM,1926,24,35-39,1950,15
SIM,1876,21,40-44,1897,3
STAT,1893,26,45-49,1919,1.3353941521052544
STAT,1933,15,50-100,1948,0.4759983630503354
SIM,1866,21,30-34,1887,18
STAT,1876,28,35-39,1904,9.377045753905579
SIM,1868,34,na,1902,2132
STAT,1924,48,45-49,1972,0.24377865817653188
STAT,1866,67,na,1933,1380.7073493213413
STAT,1886,28,45-49,1914,1.1043194265107723
STAT,1863,53,na,1916,1759.3111247442753
SIM,1961,0,na,1961,4716
SIM,1940,21,15-19,1961,7
STAT,1775,105,na,1880,0.01848542449567644
SIM,1849,20,na,1869,1929
STAT,1961,3,na,1964,4799.8867856607285
STAT,1815,43,20-24,1858,0.42666064158991934
STAT,1935,22,45-49,1957,1.4473892483531081
STAT,1944,4,na,1948,4062.446893491846
SIM,1896,37,50-100,1933,1
SIM,1898,29,40-44,1927,5
STAT,1896,33,na,1929,2966.8131997531386
STAT,1896,27,25-29,1923,52.81468645969035
SIM,1861,20,35-39,1881,6
STAT,1890,55,na,1945,2388.265025772289
SIM,1884,28,35-39,1912,14
SIM,1886,15,na,1901,2485
STAT,1868,37,40-44,1905,3.9484070004872205
SIM,1894,28,45-49,1922,1
SIM,1906,33,30-34,1939,18
STAT,1907,45,40-44,1952,0.13532497371045005
SIM,1804,58,na,1862,993
SIM,1859,23,30-34,1882,20
SIM,1876,22,na,1898,2354
STAT,1818,49,45-49,1867,0.4889990040598773
STAT,1829,36,25-29,1865,2.615734384188919
STAT,1828,48,25-29,1876,0.04787996218050996
STAT,1874,52,25-29,1926,0.003401719110664552
SIM,1858,35,30-34,1893,5
SIM,1889,29,na,1918,2775
STAT,1838,48,35-39,1886,0.09698446168362544
STAT,1830,33,45-49,1863,1.4354387737427594
SIM,1943,22,45-49,1965,1
SIM,1927,37,30-34,1964,4
STAT,1878,36,20-24,1914,0.7617420287976127
STAT,1932,21,15-19,1953,6.618256820680977
SIM,1862,20,35-39,1882,7
STAT,1805,49,35-39,1854,0.4143632886186378
STAT,1840,28,20-24,1868,10.113629727029277
STAT,1819,37,45-49,1856,5.182603151257843
STAT,1880,21,40-44,1901,2.0775561430143052
SIM,1819,54,na,1873,1192
SIM,1890,34,20-24,1924,3
STAT,1846,47,30-34,1893,0.06793282412551277
STAT,1913,30,45-49,1943,1.4905509439849038
SIM,1856,49,na,1905,1750
STAT,1888,36,30-34,1924,5.976490318041136
SIM,1919,38,35-39,1957,7
STAT,1940,16,40-44,1956,1.3418654831416883
STAT,1891,46,30-34,1937,0.06402923708427541
STAT,1930,16,30-34,1946,14.924030671474936
STAT,1915,36,35-39,1951,2.3191840593245265
SIM,1900,19,15-19,1919,5
STAT,1855,33,15-19,1888,0.10163377691363262
STAT,1910,42,45-49,1952,0.14854661620591422
STAT,1913,26,50-100,1939,0.9399235563322776
SIM,1876,37,40-44,1913,6
SIM,1834,35,45-49,1869,2
SIM,1922,36,35-39,1958,8
STAT,1866,40,15-19,1906,0.012149579138447797
SIM,1850,25,50-100,1875,1
STAT,1843,102,na,1945,0.21151267522087808
SIM,1861,23,na,1884,2057
SIM,1845,61,na,1906,1320
STAT,1888,37,50-100,1925,1.370173392223466
STAT,1921,42,20-24,1963,0.01879275350595675
SIM,1908,20,35-39,1928,11
STAT,1833,46,na,1879,1474.448299147887
SIM,1914,45,na,1959,3738
SIM,1873,89,na,1962,163
STAT,1881,34,na,1915,2158.023566593219
SIM,1775,87,na,1862,46
STAT,1826,35,45-49,1861,2.2871067892115358
STAT,1914,36,35-39,1950,2.291988335571892
SIM,1786,80,na,1866,188
STAT,1866,20,45-49,1886,0.6212071057069803
STAT,1831,29,40-44,1860,2.5146347995055005
SIM,1816,43,na,1859,1361
STAT,1856,33,15-19,1889,0.10555485699887789
SIM,1921,26,50-100,1947,2
STAT,1868,26,35-39,1894,8.732978639509252
SIM,1880,22,45-49,1902,1
SIM,1919,25,20-24,1944,16
STAT,1844,39,45-49,1883,1.4484348363155823
STAT,1856,26,50-100,1882,0.4939987932084089
STAT,1919,37,30-34,1956,1.8497146301240535
SIM,1875,74,na,1949,980
STAT,1929,37,40-44,1966,1.8156969736719093
SIM,1807,69,na,1876,652
STAT,1859,34,45-49,1893,1.303454328037855
STAT,1874,35,25-29,1909,2.806357235669487
STAT,1945,17,20-24,1962,139.90822342958836
STAT,1808,79,na,1887,304.4186672491258
STAT,1933,33,na,1966,4811.976306696348
STAT,1848,42,20-24,1890,0.11427178485391622
STAT,1887,48,30-34,1935,0.10098385172966158
SIM,1936,29,na,1965,2781
SIM,1867,21,15-19,1888,2
SIM,1878,88,na,1966,331
SIM,1931,35,30-34,1966,1
STAT,1871,34,45-49,1905,1.6191827469833333
SIM,1893,15,30-34,1908,2
STAT,1850,79,na,1929,492.17171681703223
SIM,1923,23,20-24,1946,102
SIM,1961,3,na,1964,4710
STAT,1842,25,50-100,1867,0.571512122528203
STAT,1966,0,na,1966,4672.518058017018
SIM,1885,74,na,1959,1130
SIM,1849,29,45-49,1878,4
SIM,1889,17,30-34,1906,2
STAT,1894,21,35-39,1915,7.112803160120941
STAT,1852,25,45-49,1877,0.9968124186373875
STAT,1893,66,na,1959,2061.5920676318233
SIM,1860,25,45-49,1885,3
SIM,1839,29,35-39,1868,10
STAT,1805,58,na,1863,1030.416532240333
STAT,1840,15,25-29,1855,5.170245202223568
STAT,1795,64,na,1859,799.7889870943113
STAT,1851,53,35-39,1904,0.006211799978567612
SIM,1928,32,20-24,1960,1
STAT,1827,30,35-39,1857,12.889604834473582
STAT,1861,39,50-100,1900,0.9534420116134044
SIM,1882,35,25-29,1917,3
STAT,1877,1,na,1878,3376.6970855963764
SIM,1876,24,45-49,1900,1
STAT,1922,17,35-39,1939,4.5880007743032545
STAT,1832,24,30-34,1856,15.417815155713232
SIM,1852,39,45-49,1891,1
STAT,1839,34,na,1873,1741.7671841663712
SIM,1877,42,40-44,1919,3
STAT,1906,31,15-19,1937,0.11294391015756484
STAT,1851,68,na,1919,1120.6523794890595
STAT,1918,24,35-39,1942,9.533376714094334
STAT,1868,21,40-44,1889,1.8931404625426993
STAT,1858,21,30-34,1879,15.266358298210994
SIM,1858,41,na,1899,1882
STAT,1854,38,25-29,1892,2.0630097300258377
STAT,1870,93,na,1963,68.57214965474887
STAT,1837,42,45-49,1879,1.1148573305878864
SIM,1835,30,35-39,1865,7
STAT,1772,91,na,1863,14.757974507853612
SIM,1870,75,na,1945,886
STAT,1829,43,15-19,1872,0.01144177565983833
SIM,1930,17,35-39,1947,4
STAT,1941,26,35-39,1967,14.677525288742688
STAT,1859,21,15-19,1880,2.856299539390414
SIM,1837,36,25-29,1873,4
SIM,1843,42,na,1885,1661
STAT,1903,67,na,1970,2460.120041257368
SIM,1827,80,na,1907,346
SIM,1838,49,50-100,1887,3
STAT,1824,35,na,1859,1540.4158748973969
STAT,1865,49,40-44,1914,0.14389722265368143
SIM,1936,23,15-19,1959,3
SIM,1912,19,25-29,1931,9
STAT,1904,19,25-29,1923,7.636242267933311
SIM,1834,24,na,1858,1715
STAT,1841,33,20-24,1874,2.220707051507313
SIM,1789,94,na,1883,5
STAT,1913,18,20-24,1931,26.1118631484053
SIM,1926,29,na,1955,4064
STAT,1923,18,30-34,1941,13.486749400744204
SIM,1921,18,20-24,1939,147
SIM,1948,16,35-39,1964,3
STAT,1842,46,35-39,1888,0.10099812664582447
SIM,1871,25,20-24,1896,14
STAT,1887,17,50-100,1904,0.0517597495183264
STAT,1928,23,15-19,1951,6.259900949564048
SIM,1931,18,30-34,1949,20
SIM,1837,35,na,1872,1696
SIM,1848,30,45-49,1878,1
STAT,1877,33,35-39,1910,9.885839706162018
SIM,1904,17,25-29,1921,8
SIM,1821,37,50-100,1858,3
STAT,1945,27,30-34,1972,40.609555062515014
STAT,1900,25,35-39,1925,12.73157771599758
SIM,1830,24,20-24,1854,57
STAT,1896,34,15-19,1930,0.17627831021957008
STAT,1869,29,20-24,1898,10.650998034515702
SIM,1945,15,20-24,1960,132
STAT,1879,49,35-39,1928,0.1353541355771807
STAT,1849,28,40-44,1877,2.541122162994333
SIM,1895,30,40-44,1925,6
STAT,1940,28,25-29,1968,63.36976526636873
STAT,1904,29,35-39,1933,12.979159001796091
STAT,1927,18,15-19,1945,53.17405343948718
STAT,1822,61,na,1883,1024.7809169347288
STAT,1917,24,50-100,1941,0.6564859214585361
SIM,1936,29,20-24,1965,22
STAT,1833,51,25-29,1884,0.0022656121116060067
STAT,1853,15,35-39,1868,0.49532443191422976
SIM,1931,25,20-24,1956,29
STAT,1877,66,na,1943,1606.7494721671123
STAT,1915,23,20-24,1938,108.23807626588535
SIM,1905,28,30-34,1933,40
STAT,1859,85,na,1944,206.67667562121784
SIM,1877,1,na,1878,3220
STAT,1819,54,45-49,1873,0.023816902426108708
STAT,1801,62,na,1863,933.2271771827359
SIM,1885,33,35-39,1918,12
STAT,1868,52,na,1920,1931.768970505878
STAT,1855,39,20-24,1894,0.5404488640725013
STAT,1916,39,20-24,1955,0.25244615703194445
SIM,1839,36,50-100,1875,2
STAT,1845,24,40-44,1869,1.796101630668647
STAT,1897,34,15-19,1931,0.17837963987144592
SIM,1896,7,na,1903,3330
SIM,1860,75,na,1935,806
STAT,1921,48,na,1969,3901.925811508259
STAT,1923,25,20-24,1948,19.934496724608255
SIM,1857,28,40-44,1885,5
SIM,1899,23,35-39,1922,8
STAT,1892,30,15-19,1922,0.1698234244276188
STAT,1816,98,na,1914,1.5138091351816545
STAT,1928,29,20-24,1957,21.225961783059457
SIM,1912,29,35-39,1941,16
STAT,1883,47,35-39,1930,0.12901709419330337
SIM,1859,40,30-34,1899,4
STAT,1870,29,45-49,1899,1.0204280355680897
STAT,1855,23,20-24,1878,56.608554582665995
SIM,1934,16,40-44,1950,1
SIM,1868,38,45-49,1906,1
SIM,1925,44,na,1969,4138
STAT,1823,87,na,1910,92.71304036554156
SIM,1871,23,na,1894,2269
STAT,1867,16,40-44,1883,0.1668356061986151
STAT,1850,38,40-44,1888,3.0982348694423782
SIM,1953,17,20-24,1970,148
SIM,1902,16,na,1918,3392
SIM,1908,26,40-44,1934,4
STAT,1914,26,40-44,1940,4.453376532106384
STAT,1937,15,20-24,1952,125.15964598194347
STAT,1833,26,50-100,1859,0.5194118337658905
STAT,1831,39,35-39,1870,5.456074836379506
STAT,1905,26,15-19,1931,0.6215000117813343
SIM,1954,17,20-24,1971,156
STAT,1956,15,50-100,1971,0.4685315238455375
STAT,1835,22,40-44,1857,1.728261109638837
SIM,1853,24,40-44,1877,1
STAT,1866,54,40-44,1920,0.008917312971457909
STAT,1931,16,15-19,1947,56.256015285916334
STAT,1827,36,40-44,1863,4.485506848870145
STAT,1869,31,35-39,1900,9.298406285042098
SIM,1904,45,na,1949,3033
STAT,1856,44,20-24,1900,0.1159187134184495
STAT,1902,49,20-24,1951,0.008835663426280022
STAT,1847,53,na,1900,1558.8392007580164
SIM,1900,34,40-44,1934,10
STAT,1847,37,20-24,1884,0.5884764571840276
SIM,1795,94,na,1889,2
SIM,1876,31,35-39,1907,20
STAT,1801,99,na,1900,0.720653534517969
STAT,1842,102,na,1944,0.20877359943615087
SIM,1917,32,45-49,1949,1
STAT,1835,72,na,1907,787.9577295600512
STAT,1890,48,na,1938,2566.452118259491
SIM,1843,22,40-44,1865,1
SIM,1899,39,35-39,1938,7
SIM,1818,42,35-39,1860,1
SIM,1850,24,na,1874,1828
STAT,1946,17,20-24,1963,142.05935754624454
STAT,1887,30,40-44,1917,4.618554467747345
STAT,1804,80,na,1884,267.6074851925932
STAT,1888,32,15-19,1920,0.15892841022651027
SIM,1840,29,25-29,1869,38
SIM,1922,26,40-44,1948,6
STAT,1856,67,na,1923,1172.8931457846822
SIM,1878,37,25-29,1915,5
STAT,1926,16,40-44,1942,1.6242156533561731
SIM,1935,18,15-19,1953,47
STAT,1832,29,25-29,1861,33.93191735088472
STAT,1923,35,30-34,1958,1.9986252155961441
STAT,1905,19,25-29,1924,7.6944786639616005
STAT,1909,32,45-49,1941,1.4181982146535836
STAT,1847,31,15-19,1878,0.12431150650336449
SIM,1863,23,20-24,1886,51
SIM,1913,21,20-24,1934,100
SIM,1921,30,45-49,1951,1
STAT,1837,35,20-24,1872,0.6048973349523526
STAT,1900,15,25-29,1915,7.461260740522961
STAT,1845,44,45-49,1889,1.0463591446342992
STAT,1894,27,40-44,1921,3.64026995031046
STAT,1828,30,35-39,1858,11.731272146491865
STAT,1840,22,15-19,1862,2.9217306329504646
SIM,1885,20,20-24,1905,55
SIM,1916,30,na,1946,3612
SIM,1858,22,35-39,1880,4
SIM,1928,21,15-19,1949,6
SIM,1796,79,na,1875,256
STAT,1937,28,35-39,1965,13.817132691748304
SIM,1843,27,35-39,1870,11
SIM,1854,75,na,1929,710
SIM,1917,15,na,1932,3917
SIM,1869,40,40-44,1909,3
STAT,1836,20,na,1856,1781.5680374850183
STAT,1824,48,40-44,1872,0.19836177490333773
SIM,1907,63,na,1970,2789
STAT,1833,31,20-24,1864,2.14226607374336
SIM,1919,44,na,1963,3793
SIM,1821,95,na,1916,4
SIM,1833,76,na,1909,554
STAT,1869,37,na,1906,2154.3922082781883
STAT,1881,18,15-19,1899,5.398982257203492
STAT,1891,39,40-44,1930,5.067126608019591
STAT,1863,32,45-49,1895,1.4480936356267953
STAT,1886,45,45-49,1931,0.23790570506176997
STAT,1905,21,20-24,1926,94.36028909167568
SIM,1835,36,40-44,1871,4
SIM,1904,38,40-44,1942,1
SIM,1927,27,20-24,1954,26
SIM,1913,19,25-29,1932,10
STAT,1835,27,35-39,1862,7.846223276077606
SIM,1815,95,na,1910,7
SIM,1836,30,35-39,1866,12
SIM,1859,43,35-39,1902,2
SIM,1914,34,35-39,1948,15
STAT,1817,87,na,1904,78.12969655510362
STAT,1808,101,na,1909,0.22179299785364096
SIM,1935,36,45-49,1971,1
STAT,1908,47,15-19,1955,3.146452108823919E-4
STAT,1901,38,15-19,1939,0.015947245176631836
STAT,1762,102,na,1864,0.015493191937924514
STAT,1838,86,na,1924,151.32495292406662
STAT,1889,43,20-24,1932,0.18388121097010052
STAT,1938,3,na,1941,3779.343736578685
STAT,1938,25,15-19,1963,0.6612079712199572
STAT,1895,21,35-39,1916,7.215697837155845
SIM,1933,3,na,1936,5123
SIM,1851,61,na,1912,1379
STAT,1889,51,na,1940,2523.2633889882777
SIM,1901,31,na,1932,3221
STAT,1939,21,na,1960,3465.3601991308747
STAT,1920,37,20-24,1957,0.2726731825311948
STAT,1829,49,20-24,1878,0.009432911228062897
STAT,1850,45,30-34,1895,0.06882682495044082
SIM,1853,90,na,1943,51
SIM,1884,23,40-44,1907,1
STAT,1917,49,15-19,1966,3.613394012960529E-4
STAT,1857,19,35-39,1876,0.47466508059882373
STAT,1859,32,50-100,1891,0.6907800118502464
STAT,1915,43,25-29,1958,0.06780319992334648
STAT,1853,53,na,1906,1571.1675919172603
STAT,1937,35,25-29,1972,0.9315922861878816
SIM,1836,94,na,1930,16
SIM,1867,32,50-100,1899,3
STAT,1942,29,20-24,1971,18.080095232407814
STAT,1919,27,20-24,1946,18.632386507023913
SIM,1871,16,na,1887,2462
STAT,1859,50,30-34,1909,0.004552264356936198
SIM,1863,96,na,1959,14
STAT,1906,50,na,1956,3021.2369768379203
STAT,1880,31,50-100,1911,0.9144685217241842
SIM,1910,29,25-29,1939,59
STAT,1847,38,na,1885,1780.0054263497873
STAT,1904,26,25-29,1930,57.50761871073399
SIM,1881,36,25-29,1917,2
SIM,1848,91,na,1939,37
STAT,1906,34,35-39,1940,7.930628701290641
STAT,1851,43,na,1894,1682.6267426813067
SIM,1822,98,na,1920,2
STAT,1862,46,20-24,1908,0.009697509432506331
STAT,1923,20,20-24,1943,122.96427080882327
STAT,1930,18,20-24,1948,165.1587081240758
SIM,1907,44,45-49,1951,1
SIM,1826,88,na,1914,90
STAT,1921,23,20-24,1944,118.29008211312507
SIM,1871,91,na,1962,117
SIM,1793,84,na,1877,78
SIM,1931,39,40-44,1970,2
STAT,1877,30,25-29,1907,10.121709897443928
SIM,1834,26,40-44,1860,2
SIM,1838,20,40-44,1858,4
SIM,1912,26,25-29,1938,59
SIM,1850,39,50-100,1889,1
SIM,1935,33,40-44,1968,6
STAT,1932,26,30-34,1958,48.50550364178843
STAT,1869,27,45-49,1896,1.0153020270167172
STAT,1927,33,40-44,1960,4.54530508097333
STAT,1875,21,30-34,1896,17.339690515560434
STAT,1893,17,40-44,1910,0.219230534943029
SIM,1914,14,na,1928,4159
STAT,1858,49,50-100,1907,0.178341200496648
SIM,1903,39,35-39,1942,4
SIM,1918,28,na,1946,3699
STAT,1852,27,50-100,1879,0.5660881929021284
STAT,1914,42,15-19,1956,0.0014372740915595675
SIM,1884,42,na,1926,2266
SIM,1839,55,na,1894,1453
SIM,1876,43,35-39,1919,2
SIM,1893,40,30-34,1933,2
SIM,1899,25,30-34,1924,28
STAT,1859,23,na,1882,1836.7107456251078
SIM,1834,83,na,1917,235
STAT,1943,16,35-39,1959,4.20460952165813
STAT,1811,109,na,1920,3.0816819012590373E-4
STAT,1924,16,50-100,1940,0.4225530120352856
STAT,1836,48,15-19,1884,2.6098081555252055E-4
STAT,1843,48,na,1891,1602.764688208206
STAT,1838,61,na,1899,1274.454901530146
STAT,1902,29,25-29,1931,55.99100214610301
SIM,1883,33,25-29,1916,15
STAT,1875,33,25-29,1908,9.898886618369906
STAT,1934,21,35-39,1955,11.957719227333019
SIM,1841,16,30-34,1857,1
SIM,1928,0,na,1928,5008
SIM,1941,28,na,1969,3534
SIM,1785,89,na,1874,30
STAT,1892,30,20-24,1922,3.2234407026923533
SIM,1928,18,30-34,1946,13
STAT,1912,45,15-19,1957,3.359371360265237E-4
SIM,1920,36,30-34,1956,1
STAT,1810,47,40-44,1857,0.6087001225030567
STAT,1910,23,45-49,1933,0.9948254593442319
STAT,1864,93,na,1957,32.034349330403096
SIM,1800,71,na,1871,601
STAT,1892,38,50-100,1930,1.4452239789314214
SIM,1942,21,35-39,1963,8
SIM,1951,16,35-39,1967,4
STAT,1911,16,15-19,1927,8.59850142975255
SIM,1832,29,40-44,1861,3
STAT,1930,29,30-34,1959,47.022771330827055
STAT,1904,39,30-34,1943,1.542824946211627
STAT,1796,80,na,1876,275.0554332954676
SIM,1942,29,45-49,1971,2
STAT,1892,25,na,1917,2842.42720203076
STAT,1913,20,50-100,1933,0.6057940454327321
SIM,1858,34,na,1892,1909
SIM,1854,20,na,1874,1995
SIM,1942,23,30-34,1965,30
STAT,1911,16,50-100,1927,0.07098376188603787
SIM,1857,31,30-34,1888,21
STAT,1939,27,25-29,1966,62.50260538024947
STAT,1932,24,35-39,1956,11.631332000276368
STAT,1916,41,40-44,1957,0.24248665374570302
SIM,1891,43,30-34,1934,1
SIM,1935,31,45-49,1966,3
STAT,1876,17,35-39,1893,0.535131553918186
STAT,1937,19,15-19,1956,41.57908405616487
STAT,1896,15,na,1911,3167.9512965855292
STAT,1866,46,35-39,1912,0.12228467098459551
SIM,1858,10,na,1868,2259
STAT,1894,37,50-100,1931,1.4919778837318922
STAT,1914,44,40-44,1958,0.23331710896138028
SIM,1888,22,20-24,1910,76
STAT,1778,112,na,1890,6.845726860792416E-4
STAT,1849,31,30-34,1880,14.72490310232143
STAT,1866,40,20-24,1906,0.13972015254574283
STAT,1881,65,na,1946,1541.489130215157
STAT,1856,98,na,1954,2.403576098184594
STAT,1870,40,40-44,1910,2.1030950233228465
STAT,1818,43,50-100,1861,2.4376353827255777
STAT,1843,25,50-100,1868,0.5762146122375842
SIM,1877,24,40-44,1901,2
SIM,1829,37,na,1866,1554
SIM,1940,24,35-39,1964,10
STAT,1883,43,30-34,1926,1.0567507290812073
SIM,1825,47,na,1872,1334
SIM,1925,26,35-39,1951,19
SIM,1821,33,na,1854,1551
SIM,1953,7,na,1960,4370
STAT,1914,33,30-34,1947,14.916184442235535
STAT,1852,84,na,1936,252.74829441880223
SIM,1945,19,15-19,1964,38
STAT,1863,33,50-100,1896,0.7576519121877476
STAT,1940,32,15-19,1972,0.1256286923565223
STAT,1794,97,na,1891,0.965267645085648
STAT,1870,22,na,1892,2189.2533412251155
SIM,1813,45,50-100,1858,1
SIM,1922,33,30-34,1955,26
STAT,1809,64,na,1873,905.7994974279269
STAT,1866,50,50-100,1916,0.013343362451961082
STAT,1864,49,35-39,1913,0.11573550804533182
STAT,1840,20,50-100,1860,0.36639595275553144
STAT,1865,27,30-34,1892,21.61727175194461
STAT,1868,99,na,1967,8.75966532946629
SIM,1909,43,40-44,1952,3
STAT,1934,23,30-34,1957,36.47578689851461
STAT,1863,19,20-24,1882,15.107719930798021
STAT,1915,29,35-39,1944,14.361829464339374
SIM,1885,30,25-29,1915,17
SIM,1838,73,na,1911,763
SIM,1940,26,30-34,1966,44
STAT,1917,26,35-39,1943,14.924586133827663
STAT,1958,7,na,1965,4876.04415896379
SIM,1929,34,25-29,1963,13
STAT,1864,43,20-24,1907,0.1331189336769101
STAT,1881,46,30-34,1927,0.08854622454564492
SIM,1879,21,40-44,1900,3
SIM,1888,32,na,1920,2599
STAT,1930,16,25-29,1946,53.05982208326887
SIM,1906,23,20-24,1929,86
STAT,1866,17,na,1883,2257.8906201161335
SIM,1871,19,20-24,1890,13
STAT,1835,19,45-49,1854,0.10281806783486602
SIM,1923,29,35-39,1952,17
SIM,1924,41,40-44,1965,1
STAT,1818,104,na,1922,0.03215765854739399
STAT,1844,89,na,1933,73.74853674814483
SIM,1934,34,na,1968,4791
SIM,1804,61,na,1865,901
SIM,1892,77,na,1969,1357
STAT,1876,94,na,1970,87.76483490014614
SIM,1916,33,30-34,1949,23
STAT,1830,27,15-19,1857,0.4414781899159467
STAT,1890,9,na,1899,2996.8713157054876
STAT,1938,34,25-29,1972,8.767155691483195
SIM,1847,24,25-29,1871,52
STAT,1849,40,15-19,1889,0.010127967031790325
SIM,1873,16,20-24,1889,17
SIM,1859,75,na,1934,843
STAT,1896,41,45-49,1937,0.1303467900596764
SIM,1856,16,20-24,1872,15
STAT,1831,82,na,1913,284.5523162248188
STAT,1869,7,na,1876,2521.636068395507
STAT,1777,110,na,1887,0.0018475926234705442
STAT,1869,21,30-34,1890,16.337382595238378
STAT,1852,16,40-44,1868,0.16906833343004182
SIM,1863,80,na,1943,466
STAT,1910,25,40-44,1935,4.315914898592681
STAT,1894,33,35-39,1927,12.254681899026425
STAT,1865,16,20-24,1881,15.77578671507677
SIM,1905,30,20-24,1935,2
STAT,1909,39,na,1948,3329.376618478715
STAT,1908,33,30-34,1941,13.986580016914159
STAT,1861,29,50-100,1890,0.49823712014368443
SIM,1850,42,30-34,1892,3
STAT,1899,38,40-44,1937,1.2171426233074136
STAT,1894,44,45-49,1938,0.12459277568795707
SIM,1852,42,35-39,1894,3
SIM,1926,39,na,1965,4200
STAT,1877,49,15-19,1926,3.839391597970528E-4
STAT,1830,38,25-29,1868,2.2542953156119725
STAT,1879,54,20-24,1933,7.08608010637164E-4
STAT,1839,37,30-34,1876,4.246612895755383
SIM,1912,39,30-34,1951,5
SIM,1905,21,na,1926,3268
STAT,1934,29,45-49,1963,2.1933035545254156
STAT,1851,32,25-29,1883,7.817677772766336
SIM,1846,25,na,1871,1872
STAT,1945,24,15-19,1969,5.507709558956081
STAT,1867,58,na,1925,1754.129918564439
STAT,1944,24,50-100,1968,0.6706799037119126
SIM,1851,95,na,1946,9
STAT,1805,74,na,1879,466.897441766099
SIM,1881,5,na,1886,2220
STAT,1907,16,25-29,1923,7.881709146979615
STAT,1928,24,15-19,1952,6.2399944645444325
STAT,1792,90,na,1882,27.733188543950835
STAT,1848,27,30-34,1875,21.65768152580636
STAT,1904,28,20-24,1932,15.838094321826146
SIM,1877,21,30-34,1898,20
STAT,1871,63,na,1934,1671.0784595434823
STAT,1886,5,na,1891,2615.7225970377926
SIM,1851,55,na,1906,1534
STAT,1844,42,35-39,1886,1.301928983440083
STAT,1788,85,na,1873,85.31263612495223
SIM,1842,19,na,1861,2002
STAT,1912,36,30-34,1948,1.68817128907869
STAT,1784,79,na,1863,220.30060651308804
SIM,1897,15,25-29,1912,9
SIM,1856,27,30-34,1883,20
STAT,1862,27,na,1889,1930.2403488207842
SIM,1896,67,na,1963,2205
SIM,1915,16,25-29,1931,12
STAT,1889,15,25-29,1904,6.639652878148818
STAT,1848,16,20-24,1864,15.926656906878874
STAT,1780,106,na,1886,0.011031743878340099
STAT,1844,53,45-49,1897,0.010024271062111855
SIM,1901,25,40-44,1926,5
SIM,1912,28,20-24,1940,17
STAT,1798,87,na,1885,58.15254520248539
STAT,1936,34,20-24,1970,2.234875337669341
STAT,1899,31,15-19,1930,0.1851163163862123
STAT,1927,31,45-49,1958,1.8298922438554674
SIM,1861,32,35-39,1893,10
STAT,1823,42,20-24,1865,0.20575135342931752
STAT,1930,16,na,1946,4506.739388771503
SIM,1847,37,30-34,1884,4
SIM,1898,34,na,1932,2996
STAT,1899,22,30-34,1921,23.06002169227869
SIM,1821,73,na,1894,669
STAT,1885,40,30-34,1925,1.092962226286035
STAT,1889,17,20-24,1906,20.676289866921607
SIM,1916,20,25-29,1936,89
STAT,1823,48,35-39,1871,0.16461446689008022
STAT,1852,68,na,1920,1161.082237005562
STAT,1840,48,35-39,1888,0.097067689329379
STAT,1840,42,20-24,1882,0.11537197537268543
STAT,1914,47,45-49,1961,0.20359060398753348
SIM,1814,63,na,1877,897
SIM,1772,82,na,1854,116
STAT,1834,20,30-34,1854,26.584477897569993
SIM,1922,33,50-100,1955,4
STAT,1821,48,25-29,1869,0.0866772502746263
SIM,1902,25,50-100,1927,6
SIM,1854,42,50-100,1896,1
SIM,1916,31,35-39,1947,7
STAT,1829,39,50-100,1868,1.0569105000189227
STAT,1889,45,na,1934,2650.0857302954496
STAT,1839,26,20-24,1865,9.925486089644425
SIM,1876,47,na,1923,2236
STAT,1890,33,20-24,1923,3.108930582624234
STAT,1890,39,35-39,1929,8.087193832225296
STAT,1923,39,40-44,1962,1.6352636922149357
STAT,1858,30,15-19,1888,0.10783000991227198
STAT,1856,74,na,1930,821.1258952351977
SIM,1936,24,15-19,1960,7
STAT,1881,30,45-49,1911,1.6034025154790206
SIM,1850,30,na,1880,1849
STAT,1853,32,35-39,1885,7.73406532060273
SIM,1894,20,na,1914,3025
STAT,1821,37,15-19,1858,0.11746943207447806
STAT,1927,12,na,1939,4654.652391329809
STAT,1810,45,45-49,1855,0.8679015366049019
STAT,1924,16,25-29,1940,48.87530825649892
STAT,1825,42,25-29,1867,0.717283881034083
STAT,1839,24,25-29,1863,48.34189822661656
SIM,1897,17,20-24,1914,16
SIM,1807,48,50-100,1855,2
STAT,1908,20,25-29,1928,80.68140629867203
STAT,1834,32,25-29,1866,8.121181608584784
SIM,1893,19,na,1912,3144
STAT,1858,37,40-44,1895,3.24648572489944
STAT,1822,46,na,1868,1363.5139942250917
SIM,1875,22,na,1897,2292
SIM,1868,12,na,1880,2400
SIM,1880,52,na,1932,2245
SIM,1797,74,na,1871,462
SIM,1959,10,na,1969,4855
STAT,1889,28,30-34,1917,29.265566014932038
SIM,1899,28,35-39,1927,19
STAT,1901,19,na,1920,3321.666574900405
STAT,1947,24,25-29,1971,98.5595046625435
STAT,1871,39,25-29,1910,2.669354258687703
SIM,1897,28,30-34,1925,28
SIM,1809,47,50-100,1856,2
STAT,1845,21,45-49,1866,0.6141784592703683
STAT,1908,31,35-39,1939,8.180234452932574
STAT,1913,44,na,1957,3409.2927300902984
SIM,1817,68,na,1885,807
SIM,1847,26,20-24,1873,9
STAT,1919,34,15-19,1953,0.12985240906299464
STAT,1911,3,na,1914,3820.957139078351
SIM,1842,32,25-29,1874,14
SIM,1932,16,25-29,1948,66
STAT,1835,96,na,1931,5.357471270500925
SIM,1931,20,20-24,1951,141
STAT,1906,34,na,1940,3282.2103731091634
SIM,1819,94,na,1913,5
SIM,1898,32,30-34,1930,25
STAT,1908,39,45-49,1947,0.5967635734456596
STAT,1923,37,45-49,1960,0.7462773242732145
SIM,1836,23,40-44,1859,2
STAT,1900,18,35-39,1918,0.7172483292189468
STAT,1849,47,50-100,1896,0.17620092191572834
STAT,1893,50,na,1943,2617.9805115919735
STAT,1815,39,40-44,1854,14.627538790386302
STAT,1895,17,45-49,1912,0.08052957018373333
STAT,1906,20,20-24,1926,95.36226174894755
SIM,1936,24,45-49,1960,1
STAT,1921,26,25-29,1947,69.54355148759058
SIM,1932,4,na,1936,4893
STAT,1851,46,45-49,1897,0.173554036163287
STAT,1905,7,na,1912,3556.7161146266694
SIM,1837,19,15-19,1856,5
SIM,1883,30,20-24,1913,2
STAT,1846,96,na,1942,6.0542157180652865
SIM,1905,37,na,1942,3229
SIM,1867,27,na,1894,2053
STAT,1920,14,na,1934,4186.19041494548
STAT,1851,100,na,1951,0.77852175702922
STAT,1887,15,15-19,1902,6.2989628154657895
STAT,1918,24,50-100,1942,0.6662039014613838
STAT,1853,43,45-49,1896,1.1019022639098797
STAT,1874,17,30-34,1891,1.5389312056860078
STAT,1865,2,na,1867,2911.2801576968013
STAT,1875,24,35-39,1899,5.628100446413665
STAT,1850,16,30-34,1866,1.3792974417634634
STAT,1932,6,na,1938,5013.858882569412
STAT,1875,47,50-100,1922,0.23725287210086046
STAT,1845,38,15-19,1883,0.041129955854540975
STAT,1875,30,20-24,1905,2.6445087213356677
SIM,1836,26,45-49,1862,4
SIM,1910,26,20-24,1936,15
STAT,1917,23,30-34,1940,28.766780300749158
STAT,1910,20,40-44,1930,2.999848081890033
SIM,1907,41,40-44,1948,1
SIM,1836,66,na,1902,1039
SIM,1914,20,20-24,1934,110
STAT,1916,44,45-49,1960,0.16057919560846454
SIM,1859,7,na,1866,2355
SIM,1882,17,30-34,1899,1
SIM,1862,39,25-29,1901,5
STAT,1902,26,20-24,1928,15.69343415686896
STAT,1923,23,25-29,1946,101.22681572541288
STAT,1847,46,25-29,1893,0.04250175754519106
STAT,1939,15,30-34,1954,11.553034386353644
SIM,1879,12,na,1891,2554
SIM,1851,26,40-44,1877,5
STAT,1828,26,45-49,1854,2.6418668669722023
SIM,1797,58,na,1855,1072
SIM,1879,32,20-24,1911,2
STAT,1826,29,45-49,1855,2.0925171924612993
STAT,1764,99,na,1863,0.24151395447641388
SIM,1831,35,na,1866,1635
STAT,1838,21,na,1859,1905.6158873082156
STAT,1862,49,25-29,1911,0.045447122654097304
SIM,1843,16,35-39,1859,1
STAT,1864,53,na,1917,1788.7536391873698
SIM,1839,15,na,1854,2090
SIM,1888,27,20-24,1915,18
STAT,1806,99,na,1905,0.6301814416624278
SIM,1923,24,35-39,1947,14
STAT,1862,38,15-19,1900,0.04502702302684081
SIM,1917,49,50-100,1966,1
STAT,1931,33,30-34,1964,19.490988547092527
SIM,1912,31,na,1943,3367
STAT,1894,30,25-29,1924,12.547071240704767
STAT,1823,71,na,1894,702.4229351467493
SIM,1947,15,30-34,1962,15
SIM,1894,20,25-29,1914,85
SIM,1925,23,30-34,1948,38
SIM,1888,38,30-34,1926,4
STAT,1886,46,50-100,1932,0.24583528729353887
SIM,1884,82,na,1966,621
STAT,1902,18,45-49,1920,0.08685641515637971
STAT,1886,39,15-19,1925,0.05548511383279203
STAT,1930,32,na,1962,4611.17938794562
SIM,1939,2,na,1941,3786
STAT,1921,35,15-19,1956,0.020293022957371367
SIM,1904,18,15-19,1922,5
SIM,1906,26,25-29,1932,66
SIM,1902,16,15-19,1918,4
STAT,1885,71,na,1956,1285.2463281341768
SIM,1878,19,30-34,1897,4
STAT,1888,47,25-29,1935,0.06398249754101004
SIM,1838,31,20-24,1869,4
SIM,1841,42,50-100,1883,3
STAT,1883,40,20-24,1923,0.14852344737374162
STAT,1901,59,na,1960,2673.476178721695
SIM,1860,2,na,1862,2791
STAT,1841,29,40-44,1870,2.5092030222714294
STAT,1878,17,45-49,1895,0.06424158240813958
STAT,1928,44,50-100,1972,0.14102551897136756
STAT,1842,42,30-34,1884,0.8470269542642561
STAT,1937,4,na,1941,3708.8722140684376
SIM,1847,10,na,1857,2147
STAT,1897,22,20-24,1919,87.0651037352063
SIM,1821,34,50-100,1855,4
STAT,1913,16,25-29,1929,8.388845060934946
SIM,1921,16,25-29,1937,53
STAT,1814,94,na,1908,8.246174741727339
STAT,1891,17,30-34,1908,1.863722260600566
STAT,1881,49,35-39,1930,0.12503387518820425
STAT,1896,6,na,1902,3261.6122305840267
SIM,1916,34,45-49,1950,3
STAT,1843,26,40-44,1869,2.6789350823536755
STAT,1847,81,na,1928,397.88841271227346
STAT,1825,45,35-39,1870,0.15089644990763687
STAT,1908,36,50-100,1944,0.37305660995445783
SIM,1850,14,na,1864,2110
SIM,1947,24,20-24,1971,115
STAT,1833,42,50-100,1875,0.7790141521145236
STAT,1841,41,na,1882,1664.388246731129
STAT,1872,88,na,1960,210.16032065039488
STAT,1949,2,na,1951,4407.708739189962
SIM,1802,78,na,1880,306
SIM,1901,22,30-34,1923,28
STAT,1827,53,45-49,1880,0.012033246386721715
STAT,1893,10,na,1903,3104.806233194934
STAT,1928,24,45-49,1952,1.3189606126337776
STAT,1827,42,35-39,1869,1.665837377655221
SIM,1843,60,na,1903,1354
STAT,1819,48,15-19,1867,7.007290704967873E-4
STAT,1943,27,15-19,1970,0.7102354137961823
SIM,1909,11,na,1920,3651
STAT,1918,41,45-49,1959,0.16740171484902208
SIM,1857,34,35-39,1891,12
STAT,1868,40,25-29,1908,0.5850553432629587
SIM,1832,22,15-19,1854,2
STAT,1927,44,20-24,1971,0.020856430662326793
STAT,1939,24,20-24,1963,105.41124524321307
STAT,1905,43,30-34,1948,0.10820031855535334
STAT,1776,84,na,1860,85.88667364919982
SIM,1918,31,45-49,1949,1
STAT,1875,53,na,1928,2056.178239507088
SIM,1853,19,na,1872,2176
STAT,1859,17,35-39,1876,0.4802019439803094
SIM,1905,44,40-44,1949,2
SIM,1832,26,30-34,1858,26
STAT,1854,16,45-49,1870,0.05660248800877145
STAT,1900,43,50-100,1943,0.09545316354304278
STAT,1849,34,35-39,1883,7.533754790511527
STAT,1832,35,25-29,1867,2.255334219399681
STAT,1873,16,50-100,1889,0.04725706457103423
STAT,1917,34,na,1951,3709.1781376006857
SIM,1835,42,35-39,1877,3
SIM,1882,16,na,1898,2319
SIM,1938,24,na,1962,3374
STAT,1840,43,na,1883,1657.6587574369464
STAT,1920,42,15-19,1962,0.0016023438907825204
STAT,1834,71,na,1905,826.1833624129149
SIM,1863,40,45-49,1903,2
STAT,1822,102,na,1924,0.15143454009336507
SIM,1855,45,na,1900,1811
STAT,1921,29,35-39,1950,15.695604035479823
SIM,1905,33,25-29,1938,11
STAT,1902,26,15-19,1928,0.6069283976734484
SIM,1931,34,40-44,1965,9
STAT,1848,19,25-29,1867,5.001353967279797
STAT,1908,34,45-49,1942,1.3908454071773966
SIM,1796,89,na,1885,41
STAT,1862,49,30-34,1911,0.07637641519646284
STAT,1816,52,30-34,1868,0.015004141005017969
STAT,1846,50,45-49,1896,0.010379345920063935
STAT,1843,91,na,1934,41.806764580795885
STAT,1852,19,45-49,1871,0.059320863231109494
STAT,1914,45,25-29,1959,0.04992377859297607
STAT,1869,24,35-39,1893,5.302772283910058
SIM,1864,21,20-24,1885,61
SIM,1914,36,30-34,1950,4
SIM,1861,43,45-49,1904,2
SIM,1864,22,na,1886,2139
SIM,1866,37,40-44,1903,5
STAT,1909,27,15-19,1936,0.6371941853494159
STAT,1904,23,15-19,1927,4.455782954944994
SIM,1860,91,na,1951,50
SIM,1884,17,35-39,1901,2
SIM,1856,19,25-29,1875,8
STAT,1882,16,20-24,1898,16.336979342726462
SIM,1864,81,na,1945,410
SIM,1858,24,30-34,1882,16
STAT,1923,34,40-44,1957,4.233034801973962
SIM,1857,43,25-29,1900,3
SIM,1840,35,25-29,1875,1
STAT,1837,29,20-24,1866,9.369290401072012
SIM,1849,21,25-29,1870,47
SIM,1867,70,na,1937,1181
STAT,1875,49,40-44,1924,0.1626868965155981
STAT,1938,31,20-24,1969,2.3180147313627213
STAT,1905,49,na,1954,3007.8133387883718
STAT,1933,18,50-100,1951,0.4725556847103755
SIM,1877,27,45-49,1904,1
SIM,1837,19,20-24,1856,13
STAT,1845,74,na,1919,781.7143700979647
STAT,1892,36,35-39,1928,8.407586440540166
STAT,1872,35,50-100,1907,1.175204578571978
STAT,1912,22,40-44,1934,3.043420316985254
SIM,1887,47,na,1934,2340
SIM,1806,68,na,1874,716
SIM,1920,22,40-44,1942,3
STAT,1925,47,20-24,1972,0.012652249955207539
STAT,1782,102,na,1884,0.07655445799842168
STAT,1915,24,35-39,1939,9.136406852704019
STAT,1948,17,25-29,1965,46.85383300256307
STAT,1826,36,na,1862,1564.4835144989627
STAT,1871,28,15-19,1899,0.4234164521667452
STAT,1864,51,50-100,1915,0.012812424637110896
STAT,1906,36,30-34,1942,1.5900379045089432
STAT,1910,55,na,1965,3135.5311041134
STAT,1938,32,50-100,1970,0.7852729243191953
STAT,1892,47,45-49,1939,0.15675197737060986
SIM,1892,27,40-44,1919,4
SIM,1847,50,na,1897,1557
SIM,1873,27,30-34,1900,23
STAT,1912,33,20-24,1945,2.2572837593950026
STAT,1858,34,30-34,1892,12.837782374114685
SIM,1872,57,na,1929,1914
STAT,1920,42,45-49,1962,0.17365400697167235
STAT,1934,24,45-49,1958,1.4274672441493186
SIM,1931,8,na,1939,4921
SIM,1845,29,20-24,1874,13
STAT,1868,54,45-49,1922,0.012729901532968216
STAT,1878,45,na,1923,2234.670378151996
STAT,1949,21,25-29,1970,101.86448562918675
STAT,1834,48,40-44,1882,0.11095458366665548
STAT,1922,22,50-100,1944,0.7128888602752587
STAT,1886,20,25-29,1906,57.479146762226144
STAT,1901,31,25-29,1932,13.599010046945551
STAT,1840,45,30-34,1885,0.06974517876575391
STAT,1863,68,na,1931,1269.0360008916161
STAT,1845,49,25-29,1894,0.03972524518278831
STAT,1942,30,50-100,1972,0.8329167452674747
SIM,1966,1,na,1967,4550
STAT,1941,19,35-39,1960,4.08000021657664
SIM,1898,10,na,1908,3270
STAT,1889,61,na,1950,2179.337354979237
SIM,1911,30,45-49,1941,1
STAT,1919,39,20-24,1958,0.26696580364288186
SIM,1818,53,na,1871,1152
SIM,1936,27,25-29,1963,46
STAT,1868,43,35-39,1911,1.6215137570585618
SIM,1825,36,40-44,1861,2
STAT,1858,23,20-24,1881,52.978084697154316
SIM,1922,49,na,1971,3981
STAT,1902,15,35-39,1917,0.7349092850494303
STAT,1874,31,na,1905,2313.4744046979977
STAT,1892,65,na,1957,2048.0757872615964
SIM,1898,35,35-39,1933,14
SIM,1931,23,25-29,1954,127
STAT,1917,37,15-19,1954,0.018841944653279007
SIM,1869,53,na,1922,1945
STAT,1926,30,na,1956,4325.6228054854255
STAT,1925,36,40-44,1961,1.6991027384147745
STAT,1873,36,25-29,1909,2.7741744449703334
SIM,1929,28,na,1957,4521
STAT,1855,33,na,1888,1703.066965842344
STAT,1784,95,na,1879,2.0765524719076662
STAT,1839,27,50-100,1866,0.5373308106230229
SIM,1835,25,na,1860,1772
SIM,1942,24,45-49,1966,1
STAT,1860,63,na,1923,1369.9168465311793
STAT,1834,23,35-39,1857,4.796192830686487
SIM,1820,42,45-49,1862,2
STAT,1781,90,na,1871,26.507951857736742
STAT,1844,38,50-100,1882,0.90136895314995
SIM,1866,23,20-24,1889,56
STAT,1939,18,40-44,1957,1.3220743422970627
STAT,1856,21,20-24,1877,59.64598129300164
STAT,1928,27,25-29,1955,76.61267905854302
STAT,1839,33,15-19,1872,0.11564412155384199
STAT,1857,36,50-100,1893,0.9187632521715143
SIM,1903,20,45-49,1923,5
SIM,1851,71,na,1922,939
SIM,1920,33,20-24,1953,3
SIM,1938,21,15-19,1959,4
STAT,1903,30,45-49,1933,2.362594101492234
SIM,1855,85,na,1940,175
SIM,1912,23,20-24,1935,1
STAT,1859,35,50-100,1894,0.9344161812788745
STAT,1851,35,35-39,1886,5.35223911471619
STAT,1869,24,40-44,1893,1.8935826394759592
STAT,1857,53,30-34,1910,0.004361986623033341
STAT,1904,23,20-24,1927,93.07574393546226
SIM,1926,23,na,1949,4056
STAT,1876,19,na,1895,2449.901852881517
SIM,1947,18,40-44,1965,1
STAT,1812,42,45-49,1854,5.621911949366667
SIM,1839,101,na,1940,1
SIM,1852,38,50-100,1890,1
STAT,1821,45,20-24,1866,0.018868964904456914
STAT,1875,30,15-19,1905,0.13932303039135172
STAT,1884,27,40-44,1911,2.796477883820017
SIM,1933,36,40-44,1969,1
STAT,1875,93,na,1968,104.9790753848522
SIM,1927,24,na,1951,4135
STAT,1853,40,40-44,1893,1.6849121160820903
STAT,1938,31,15-19,1969,0.12212205399804271
STAT,1939,18,35-39,1957,3.966222797251605
STAT,1897,37,25-29,1934,3.6376219568796073
SIM,1844,31,45-49,1875,2
STAT,1830,32,50-100,1862,0.7665600798823247
STAT,1854,32,na,1886,1759.713406512069
SIM,1788,78,na,1866,270
SIM,1911,32,40-44,1943,5
STAT,1826,102,na,1928,0.16001993377482007
STAT,1928,34,na,1962,4462.184286056834
SIM,1874,80,na,1954,535
SIM,1919,24,45-49,1943,2
STAT,1865,94,na,1959,28.92257606849559
SIM,1870,23,40-44,1893,2
STAT,1847,23,45-49,1870,0.6244715580205576
SIM,1796,73,na,1869,459
STAT,1850,19,35-39,1869,0.46649899244487736
STAT,1889,19,40-44,1908,0.21217075343168904
STAT,1910,22,30-34,1932,25.49044559805177
STAT,1955,11,na,1966,4926.625231215433
SIM,1900,62,na,1962,2484
SIM,1894,32,50-100,1926,1
STAT,1831,52,20-24,1883,4.7727425868495667E-4
STAT,1825,30,30-34,1855,38.58628344206365
SIM,1872,17,na,1889,2374
STAT,1842,39,50-100,1881,0.9141220725661862
STAT,1862,20,50-100,1882,0.3412805995570437
SIM,1921,47,50-100,1968,1
STAT,1839,21,15-19,1860,2.8467899683325353
STAT,1888,32,20-24,1920,3.0166410085357165
SIM,1842,23,35-39,1865,8
SIM,1947,18,35-39,1965,6
SIM,1873,23,15-19,1896,4
SIM,1847,21,15-19,1868,3
SIM,1896,32,20-24,1928,3
STAT,1828,31,50-100,1859,1.0231854587218594
STAT,1834,35,35-39,1869,5.5600277232832385
STAT,1838,40,45-49,1878,1.2247452050365508
STAT,1845,55,na,1900,1456.4588661302894
STAT,1862,23,40-44,1885,1.7066482567071455
STAT,1946,21,50-100,1967,0.6919709689623618
STAT,1834,46,45-49,1880,0.1724407756027665
STAT,1936,34,15-19,1970,0.11774194657740579
SIM,1847,29,25-29,1876,39
STAT,1928,28,30-34,1956,45.585389855188566
STAT,1940,23,25-29,1963,88.85373638779059
SIM,1915,39,na,1954,3521
STAT,1811,46,na,1857,1320.6518568044937
SIM,1827,89,na,1916,49
STAT,1932,27,45-49,1959,2.1377091312658503
SIM,1837,18,30-34,1855,1
STAT,1899,35,30-34,1934,6.965270890629934
SIM,1872,20,40-44,1892,3
STAT,1876,53,35-39,1929,0.008261224156849314
STAT,1868,42,50-100,1910,0.9517221691828113
SIM,1842,35,35-39,1877,6
STAT,1880,40,na,1920,2320.5499571543583
SIM,1808,94,na,1902,7
SIM,1854,19,15-19,1873,5
SIM,1923,46,50-100,1969,2
STAT,1846,19,15-19,1865,5.194574170273795
STAT,1816,52,25-29,1868,0.008928083817764752
STAT,1874,68,na,1942,1475.5229174415695
STAT,1820,82,na,1902,248.56452109275108
STAT,1895,17,na,1912,3113.566699702895
SIM,1889,42,30-34,1931,4
STAT,1814,44,15-19,1858,0.039257844272739505
STAT,1899,24,20-24,1923,88.65654126062165
SIM,1889,57,na,1946,2327
STAT,1948,15,50-100,1963,0.405291060152051
SIM,1885,43,na,1928,2169
STAT,1864,20,40-44,1884,1.813624707932688
STAT,1832,39,40-44,1871,3.2841024951849014
STAT,1917,37,20-24,1954,0.2586484804256802
STAT,1947,16,na,1963,3918.247977304347
STAT,1931,40,25-29,1971,0.09037347525434088
SIM,1840,39,40-44,1879,3
STAT,1903,27,50-100,1930,0.8597677152849371
SIM,1855,31,20-24,1886,1
STAT,1883,43,25-29,1926,0.5902571664063392
SIM,1902,19,25-29,1921,8
SIM,1871,32,na,1903,2292
STAT,1891,30,50-100,1921,1.0799839281395638
STAT,1910,39,25-29,1949,0.8803806659182901
STAT,1827,50,40-44,1877,0.009264428716603124
SIM,1846,40,45-49,1886,1
SIM,1869,50,50-100,1919,1
STAT,1841,25,25-29,1866,36.469524402254976
STAT,1904,35,15-19,1939,0.0165770443785583
STAT,1890,36,30-34,1926,6.185434543762415
SIM,1862,29,20-24,1891,11
SIM,1883,24,35-39,1907,5
STAT,1855,73,na,1928,841.2101322360604
SIM,1873,58,na,1931,1893
STAT,1866,38,50-100,1904,1.0640465061249818
SIM,1906,62,na,1968,2803
SIM,1836,63,na,1899,1132
STAT,1919,34,20-24,1953,2.464745615200543
STAT,1823,45,30-34,1868,0.11885201499344632
STAT,1886,56,na,1942,2035.8079722312584
STAT,1892,21,30-34,1913,21.135670201804363
STAT,1931,17,na,1948,4551.398342991082
STAT,1854,29,20-24,1883,8.729280823578085
SIM,1863,37,na,1900,2017
STAT,1886,47,20-24,1933,0.011921650602852156
SIM,1904,17,30-34,1921,3
STAT,1876,35,na,1911,2319.500792262897
STAT,1899,22,25-29,1921,74.11093997462483
STAT,1894,41,40-44,1935,2.745733409113205
STAT,1954,18,30-34,1972,14.229803368178857
STAT,1825,51,na,1876,1375.8975390175842
STAT,1830,81,na,1911,323.0264750418714
SIM,1873,19,25-29,1892,10
STAT,1843,29,45-49,1872,0.9717100942577774
STAT,1905,65,na,1970,2622.8205878648055
STAT,1928,2,na,1930,4868.793622014073
STAT,1843,23,30-34,1866,16.01452753316566
STAT,1922,43,30-34,1965,0.13841625045074943
STAT,1875,47,45-49,1922,0.22797914457557053
STAT,1829,65,na,1894,1035.8602327542426
SIM,1895,42,na,1937,2901
STAT,1764,100,na,1864,0.14785001265137104
STAT,1845,20,30-34,1865,15.80194522615692
STAT,1865,23,15-19,1888,2.8458747051825357
SIM,1940,0,na,1940,3816
SIM,1923,2,na,1925,4407
STAT,1872,53,20-24,1925,6.884624794752977E-4
SIM,1927,34,20-24,1961,7
STAT,1901,2,na,1903,3524.7673604956135
SIM,1895,8,na,1903,3259
SIM,1833,30,30-34,1863,20
SIM,1848,51,na,1899,1600
STAT,1877,32,45-49,1909,1.709498501676494
STAT,1943,26,na,1969,3770.571989528676
SIM,1885,32,45-49,1917,1
STAT,1797,62,na,1859,894.7166844587539
STAT,1950,0,na,1950,4921.32370482501
SIM,1841,34,na,1875,1778
STAT,1902,15,40-44,1917,0.2449697758666013
SIM,1851,23,30-34,1874,20
STAT,1835,52,35-39,1887,0.005474141053313589
STAT,1910,39,na,1949,3363.9477584766805
SIM,1923,31,na,1954,4014
STAT,1875,36,35-39,1911,6.897578618034218
STAT,1910,20,35-39,1930,8.400748366065265
STAT,1894,21,50-100,1915,0.49705129228700495
SIM,1883,36,35-39,1919,15
SIM,1866,36,35-39,1902,10
STAT,1882,23,20-24,1905,63.15207012757892
STAT,1865,19,25-29,1884,4.953977092350833
STAT,1879,41,45-49,1920,1.4845173591259222
STAT,1912,48,25-29,1960,0.048014521843352025
SIM,1933,33,30-34,1966,27
SIM,1897,37,50-100,1934,1
STAT,1901,33,45-49,1934,2.296102718037818
STAT,1930,25,15-19,1955,0.8487873875973498
SIM,1922,30,20-24,1952,2
SIM,1937,23,na,1960,3229
SIM,1914,39,35-39,1953,5
SIM,1896,24,45-49,1920,1
STAT,1898,41,na,1939,2979.3031490157523
STAT,1894,30,30-34,1924,21.38795086000778
SIM,1837,88,na,1925,65
SIM,1848,41,30-34,1889,4
STAT,1837,33,50-100,1870,0.7177040747812805
SIM,1928,18,25-29,1946,79
SIM,1942,13,na,1955,3719
STAT,1906,37,45-49,1943,0.5918923781033391
STAT,1878,42,na,1920,2270.1961498001283
SIM,1869,29,30-34,1898,22
STAT,1877,34,40-44,1911,4.214958393069725
SIM,1907,30,25-29,1937,11
STAT,1817,56,na,1873,1100.052258144067
STAT,1890,46,50-100,1936,0.16047043334163894
STAT,1910,28,45-49,1938,1.569990623233843
STAT,1844,33,na,1877,1800.5833959984982
SIM,1823,32,20-24,1855,1
SIM,1861,33,na,1894,2061
STAT,1888,24,45-49,1912,0.773346176988819
SIM,1836,23,35-39,1859,9
STAT,1906,39,35-39,1945,2.078907252735626
SIM,1915,36,na,1951,3572
STAT,1871,22,50-100,1893,0.38191343734739763
STAT,1770,90,na,1860,20.51068205459728
SIM,1885,34,40-44,1919,6
STAT,1906,20,15-19,1926,4.565244632807814
STAT,1844,92,na,1936,29.238270870447913
STAT,1790,67,na,1857,692.0873107284959
SIM,1926,43,40-44,1969,2
STAT,1822,86,na,1908,114.60635831553833
STAT,1862,21,45-49,1883,0.5793996282205186
STAT,1864,46,30-34,1910,0.08196132662337126
STAT,1918,35,na,1953,3781.6181615892
STAT,1787,84,na,1871,104.66272169079046
STAT,1810,50,50-100,1860,0.05335909600460132
STAT,1857,43,na,1900,1708.863336430817
STAT,1866,36,na,1902,2061.9068138368007
SIM,1841,93,na,1934,12
STAT,1879,83,na,1962,593.0086919491526
STAT,1862,43,na,1905,1849.0302665976992
STAT,1915,17,40-44,1932,0.2765271027163774
SIM,1829,33,45-49,1862,1
SIM,1852,96,na,1948,4
SIM,1887,41,45-49,1928,2
STAT,1873,24,25-29,1897,54.54965213213915
STAT,1925,33,30-34,1958,17.66566570213569
STAT,1880,19,20-24,1899,17.5276283773881
STAT,1884,24,30-34,1908,16.524376663541656
SIM,1890,7,na,1897,3118
SIM,1938,24,25-29,1962,79
SIM,1883,57,na,1940,1871
SIM,1881,21,20-24,1902,67
SIM,1914,20,15-19,1934,5
STAT,1917,38,50-100,1955,0.4099100854796503
SIM,1919,24,15-19,1943,5
SIM,1940,27,45-49,1967,5
STAT,1881,25,na,1906,2191.6212845918994
SIM,1828,52,na,1880,1237
SIM,1844,33,40-44,1877,4
STAT,1845,46,20-24,1891,0.008476574915441543
SIM,1933,31,35-39,1964,16
SIM,1908,23,30-34,1931,35
STAT,1866,57,na,1923,1750.366564328615
SIM,1825,33,30-34,1858,19
STAT,1916,43,30-34,1959,0.12356773627602904
SIM,1807,53,na,1860,1095
STAT,1941,16,30-34,1957,11.862695421220105
STAT,1868,40,30-34,1908,1.047437787685194
STAT,1845,58,na,1903,1392.9827770131315
SIM,1803,79,na,1882,249
SIM,1925,38,na,1963,4156
SIM,1855,34,25-29,1889,9
SIM,1890,14,na,1904,3084
STAT,1806,49,40-44,1855,0.4897383159205368
STAT,1862,47,50-100,1909,0.19699108706854151
STAT,1847,34,25-29,1881,7.88680199211529
STAT,1836,31,45-49,1867,1.4064622849248611
STAT,1914,30,20-24,1944,2.3377043494357865
SIM,1860,27,50-100,1887,1
SIM,1786,71,na,1857,554
STAT,1867,98,na,1965,11.217662141799593
STAT,1817,39,45-49,1856,5.813958388833947
STAT,1833,30,na,1863,1729.1338842826385
STAT,1919,46,15-19,1965,3.7838910476598823E-4
STAT,1867,27,40-44,1894,2.6570666228394293
STAT,1916,49,na,1965,3538.75068823608
SIM,1834,22,25-29,1856,47
SIM,1823,39,40-44,1862,7
SIM,1869,18,20-24,1887,9
SIM,1890,23,20-24,1913,76
STAT,1868,51,40-44,1919,0.009541131369711325
SIM,1840,20,20-24,1860,62
STAT,1921,26,30-34,1947,41.39905245143022
STAT,1890,20,45-49,1910,0.8102308796240957
STAT,1914,49,40-44,1963,0.146823786542678
SIM,1803,60,na,1863,917
STAT,1842,42,25-29,1884,0.4731141565698333
STAT,1850,51,25-29,1901,0.0025055161383492446
STAT,1935,15,50-100,1950,0.4860736609685427
SIM,1874,83,na,1957,394
STAT,1925,20,25-29,1945,105.08676285793362
STAT,1851,20,30-34,1871,15.825055414197061
STAT,1829,25,na,1854,1624.8047702822164
SIM,1859,35,na,1894,1980
STAT,1846,42,50-100,1888,0.7538926480838637
SIM,1877,24,35-39,1901,5
STAT,1836,33,40-44,1869,3.4258451921580315
STAT,1901,45,45-49,1946,0.1777825911392177
STAT,1917,50,na,1967,3592.2451926492395
SIM,1888,72,na,1960,1525
STAT,1856,36,25-29,1892,2.140553939220196
SIM,1868,31,30-34,1899,19
SIM,1933,20,25-29,1953,126
SIM,1876,40,30-34,1916,1
STAT,1945,24,20-24,1969,115.04917761117072
SIM,1883,26,50-100,1909,3
SIM,1874,21,na,1895,2261
SIM,1934,16,35-39,1950,6
STAT,1892,17,50-100,1909,0.057957725012971084
STAT,1928,29,15-19,1957,0.8208935562030214
STAT,1869,68,na,1937,1397.4400645672308
STAT,1768,89,na,1857,20.672510833923003
SIM,1904,36,na,1940,3180
SIM,1864,36,25-29,1900,1
SIM,1901,47,na,1948,2996
STAT,1865,54,na,1919,1797.54657036964
SIM,1948,23,na,1971,3730
STAT,1868,43,na,1911,2069.62588280307
STAT,1849,44,30-34,1893,0.8174848250689131
SIM,1916,36,40-44,1952,2
STAT,1914,49,50-100,1963,0.21063038521347394
STAT,1915,26,30-34,1941,37.881060833891354
STAT,1892,33,25-29,1925,12.065936398528548
STAT,1928,24,20-24,1952,130.34569520404506
SIM,1922,3,na,1925,4436
STAT,1814,52,20-24,1866,0.0019148183913339258
STAT,1915,8,na,1923,3930.1966626401286
STAT,1789,105,na,1894,0.006469375599645395
SIM,1827,31,45-49,1858,2
STAT,1925,39,45-49,1964,0.7714106323444403
STAT,1847,20,40-44,1867,1.9068910736065579
STAT,1877,20,na,1897,2332.330777612346
SIM,1853,81,na,1934,404
SIM,1862,55,na,1917,1791
STAT,1920,25,50-100,1945,1.038537241681483
STAT,1874,53,30-34,1927,0.005655093970290735
SIM,1922,49,50-100,1971,1
STAT,1925,31,35-39,1956,10.258828001974383
STAT,1841,81,na,1922,369.9865202787894
SIM,1903,11,na,1914,3454
SIM,1945,18,30-34,1963,18
STAT,1864,23,45-49,1887,0.5939285482548656
STAT,1926,16,35-39,1942,4.872646677948073
SIM,1813,78,na,1891,279
STAT,1855,40,45-49,1895,1.0706711752350795
STAT,1881,43,20-24,1924,0.14381391173421268
STAT,1932,29,35-39,1961,18.55906440351012
SIM,1913,32,na,1945,3428
SIM,1840,71,na,1911,858
STAT,1875,3,na,1878,2991.725385571859
SIM,1917,46,na,1963,3571
SIM,1901,20,35-39,1921,9
STAT,1854,91,na,1945,41.72788830368222
SIM,1872,23,45-49,1895,1
SIM,1866,34,30-34,1900,20
SIM,1885,83,na,1968,619
SIM,1859,44,40-44,1903,8
STAT,1783,104,na,1887,0.02757963089418764
SIM,1840,55,na,1895,1433
SIM,1940,29,35-39,1969,18
STAT,1855,17,na,1872,1933.6278421360523
STAT,1940,20,20-24,1960,107.07165561413774
SIM,1856,23,15-19,1879,5
STAT,1929,30,50-100,1959,0.9933082282127802
SIM,1870,47,50-100,1917,1
STAT,1821,103,na,1924,0.07749792201247149
STAT,1875,23,20-24,1898,66.67552957875277
SIM,1774,86,na,1860,41
SIM,1842,20,30-34,1862,21
SIM,1853,59,na,1912,1545
STAT,1886,22,45-49,1908,0.6960135033812158
STAT,1841,22,20-24,1863,59.72883596095157
SIM,1894,57,na,1951,2566
SIM,1936,24,20-24,1960,84
STAT,1906,10,na,1916,3563.275918639707
SIM,1897,49,na,1946,2810
STAT,1922,46,35-39,1968,0.1402820656344301
STAT,1873,53,50-100,1926,0.01424962577479384
STAT,1848,23,15-19,1871,2.873090945625692
STAT,1825,33,35-39,1858,16.20432383215942
SIM,1913,19,30-34,1932,4
SIM,1833,33,35-39,1866,8
STAT,1952,17,15-19,1969,51.37999607871309
STAT,1866,43,25-29,1909,0.5552713917552936
STAT,1818,52,35-39,1870,0.017640744944030638
SIM,1783,82,na,1865,138
STAT,1929,41,20-24,1970,0.021638300079063786
SIM,1872,30,45-49,1902,3
SIM,1872,73,na,1945,1067
SIM,1883,21,30-34,1904,20
SIM,1849,37,40-44,1886,5
STAT,1831,66,na,1897,999.5750004591788
SIM,1787,96,na,1883,3
STAT,1905,31,50-100,1936,0.7211545979979639
SIM,1835,22,na,1857,1732
STAT,1918,43,40-44,1961,0.25082606120635803
SIM,1903,36,30-34,1939,2
SIM,1852,40,na,1892,1803
STAT,1818,41,na,1859,1440.3527511339419
STAT,1844,50,40-44,1894,0.007496711283409444
STAT,1899,46,50-100,1945,0.17986348563111612
SIM,1849,33,25-29,1882,10
STAT,1885,43,35-39,1928,1.6919890677085312
SIM,1850,70,na,1920,1027
SIM,1876,87,na,1963,304
STAT,1816,74,na,1890,517.1576977654702
STAT,1853,69,na,1922,1088.341669814695
SIM,1901,28,45-49,1929,2
STAT,1905,19,30-34,1924,2.164210716759681
SIM,1812,53,na,1865,1184
SIM,1859,51,50-100,1910,1
SIM,1923,26,30-34,1949,44
SIM,1916,21,na,1937,3539
SIM,1818,43,40-44,1861,5
STAT,1951,21,35-39,1972,10.631512790212065
STAT,1866,31,30-34,1897,15.269368734220276
STAT,1888,35,25-29,1923,3.243729565020764
STAT,1921,23,15-19,1944,5.662860261253185
SIM,1861,40,40-44,1901,7
STAT,1849,46,35-39,1895,0.10119722044961832
STAT,1825,53,50-100,1878,0.014964969880014233
STAT,1864,9,na,1873,2338.388934995654
STAT,1937,18,30-34,1955,11.170994624548689
SIM,1839,16,15-19,1855,5
STAT,1829,50,45-49,1879,0.011769966819515407
SIM,1863,40,na,1903,2008
STAT,1921,28,20-24,1949,19.152894044796277
STAT,1783,101,na,1884,0.11206544906297346
STAT,1821,45,na,1866,1439.1310213434388
SIM,1861,44,35-39,1905,1
SIM,1930,28,na,1958,4432
SIM,1874,43,na,1917,2203
SIM,1883,17,na,1900,2389
STAT,1833,52,30-34,1885,0.003732821434405045
STAT,1835,36,50-100,1871,0.9569249167016256
STAT,1907,35,na,1942,3325.9237704823095
SIM,1845,40,na,1885,1686
STAT,1921,39,30-34,1960,1.9185685112920652
STAT,1897,34,20-24,1931,3.385847350748096
STAT,1789,70,na,1859,581.7698734558808
SIM,1843,36,50-100,1879,2
SIM,1896,35,25-29,1931,4
SIM,1816,67,na,1883,736
STAT,1828,62,na,1890,1037.5600178453335
SIM,1837,29,na,1866,1750
SIM,1922,33,25-29,1955,13
SIM,1914,34,40-44,1948,6
SIM,1836,20,30-34,1856,20
STAT,1772,108,na,1880,0.004238871254066089
STAT,1845,23,35-39,1868,5.066162364077316
SIM,1859,91,na,1950,65
SIM,1838,92,na,1930,28
STAT,1858,21,25-29,1879,49.0634474922747
STAT,1908,47,20-24,1955,0.009439364629651201
STAT,1780,89,na,1869,30.444569121895718
SIM,1818,93,na,1911,10
STAT,1879,17,50-100,1896,0.04837615275598795
SIM,1786,74,na,1860,391
STAT,1882,26,25-29,1908,39.01902919205826
SIM,1832,29,35-39,1861,8
STAT,1912,45,20-24,1957,0.010078122945848242
STAT,1902,40,50-100,1942,0.09878952741534927
SIM,1898,31,na,1929,3022
SIM,1866,21,25-29,1887,53
STAT,1855,53,20-24,1908,5.142304073168576E-4
STAT,1927,26,50-100,1953,1.147185048742946
STAT,1841,44,na,1885,1601.6309828926596
STAT,1872,45,15-19,1917,3.830618678546003E-4
STAT,1856,33,20-24,1889,2.0035505912323246
STAT,1919,37,25-29,1956,0.9992711165356795
SIM,1864,33,20-24,1897,4
SIM,1866,44,40-44,1910,5
STAT,1847,31,20-24,1878,2.3595730166584823
STAT,1860,23,30-34,1883,13.996320727192032
STAT,1801,53,30-34,1854,0.021052543173464708
SIM,1905,8,na,1913,3547
SIM,1824,78,na,1902,420
STAT,1900,15,30-34,1915,2.0986139750843362
STAT,1830,35,20-24,1865,0.6284822536757111
SIM,1820,43,35-39,1863,3
STAT,1906,34,40-44,1940,3.3961354951775906
SIM,1942,26,40-44,1968,4
SIM,1829,30,40-44,1859,6
SIM,1857,47,50-100,1904,1
SIM,1932,7,na,1939,4851
SIM,1814,60,na,1874,1004
STAT,1848,18,40-44,1866,0.16238343192869736
SIM,1896,21,40-44,1917,6
SIM,1935,26,50-100,1961,1
STAT,1832,23,25-29,1855,54.01855036823797
STAT,1870,43,45-49,1913,1.3753863749319373
STAT,1926,27,15-19,1953,0.7995613772340305
SIM,1908,47,50-100,1955,1
SIM,1888,22,15-19,1910,3
STAT,1876,31,50-100,1907,0.8972251279435391
STAT,1881,47,15-19,1928,3.6315630054943907E-4
STAT,1883,41,50-100,1924,0.9825598824151425
STAT,1891,24,na,1915,2748.154934956252
STAT,1870,32,35-39,1902,9.374316046640722
STAT,1903,43,20-24,1946,0.014715329690860604
STAT,1843,51,50-100,1894,0.010948093015171382
SIM,1842,100,na,1942,1
STAT,1890,61,na,1951,2158.324564703863
STAT,1893,24,50-100,1917,0.4857242415428687
STAT,1934,26,40-44,1960,5.925995321379083
SIM,1868,32,45-49,1900,1
SIM,1849,23,15-19,1872,2
STAT,1860,16,50-100,1876,0.043638013089178265
STAT,1819,103,na,1922,0.07166953410624204
SIM,1848,44,35-39,1892,5
STAT,1851,48,40-44,1899,0.12396631198435698
STAT,1860,36,45-49,1896,1.5378851725387765
STAT,1888,21,40-44,1909,2.332572869304006
SIM,1877,32,na,1909,2341
SIM,1840,23,25-29,1863,44
STAT,1858,44,40-44,1902,1.6456129576909475
SIM,1886,46,na,1932,2201
SIM,1882,32,na,1914,2154
STAT,1860,25,35-39,1885,7.596121859747549
STAT,1919,42,50-100,1961,0.12026960419316804
STAT,1839,29,25-29,1868,35.024065002653
STAT,1917,24,45-49,1941,1.1225908829201703
STAT,1912,20,45-49,1932,1.0245206331266656
SIM,1873,98,na,1971,13
STAT,1934,37,20-24,1971,0.34364652429626713
SIM,1857,33,20-24,1890,2
STAT,1803,52,45-49,1855,0.041596778806173705
SIM,1870,3,na,1873,2759
SIM,1875,27,40-44,1902,3
SIM,1878,15,15-19,1893,8
SIM,1949,3,na,1952,4334
STAT,1812,43,35-39,1855,6.517373158258274
STAT,1892,24,35-39,1916,6.8601959643558565
SIM,1908,26,35-39,1934,15
SIM,1919,28,30-34,1947,45
STAT,1947,21,15-19,1968,5.685654984501971
STAT,1877,18,50-100,1895,0.04790173824236796
STAT,1884,20,15-19,1904,3.0981456281553226
SIM,1802,75,na,1877,415
STAT,1919,20,na,1939,3800.155098628968
SIM,1933,24,40-44,1957,5
STAT,1916,46,35-39,1962,0.12523339733682257
SIM,1938,28,40-44,1966,5
STAT,1831,44,15-19,1875,0.010242912440547767
STAT,1777,113,na,1890,4.5469788435423573E-4
SIM,1881,24,25-29,1905,52
STAT,1889,24,15-19,1913,3.8234729777917975
STAT,1941,16,na,1957,3582.281348027296
STAT,1819,66,na,1885,850.7283891447626
STAT,1888,20,na,1908,2655.1665347058947
SIM,1825,63,na,1888,936
STAT,1830,41,na,1871,1551.8942458627528
SIM,1891,41,50-100,1932,1
STAT,1920,17,na,1937,3901.3984060251114
SIM,1828,74,na,1902,537
STAT,1871,36,20-24,1907,0.7254081832457122
STAT,1913,18,15-19,1931,8.740835556742354
STAT,1925,24,40-44,1949,3.7787906917725382
STAT,1908,36,40-44,1944,1.3301290853994134
STAT,1912,39,35-39,1951,2.2072124990061823
STAT,1812,54,45-49,1866,0.0438777129044626
STAT,1856,58,na,1914,1463.2124898494278
SIM,1865,47,na,1912,1923
SIM,1921,18,15-19,1939,45
SIM,1920,39,35-39,1959,3
STAT,1808,63,na,1871,927.4695000744994
STAT,1923,35,25-29,1958,1.0797170645675107
SIM,1897,24,15-19,1921,4
SIM,1925,24,45-49,1949,2
SIM,1892,20,15-19,1912,3
STAT,1892,49,40-44,1941,0.11185888414742487
SIM,1920,20,45-49,1940,1
STAT,1777,85,na,1862,77.06871203906768
STAT,1903,32,40-44,1935,5.8286903250325395
STAT,1952,19,na,1971,4164.321466501526
STAT,1867,23,25-29,1890,50.61998451511843
STAT,1873,21,20-24,1894,66.28026786550801
STAT,1849,33,20-24,1882,2.0318559649006436
STAT,1945,27,25-29,1972,68.21732663305414
STAT,1854,31,50-100,1885,0.6827101574508067
STAT,1851,23,35-39,1874,5.073571576247088
SIM,1862,31,50-100,1893,5
SIM,1771,97,na,1868,1
STAT,1932,24,40-44,1956,4.153466747296233
SIM,1865,0,na,1865,3132
STAT,1901,30,40-44,1931,5.780477440324076
SIM,1862,95,na,1957,10
STAT,1840,46,15-19,1886,2.845341513191555E-4
SIM,1855,20,40-44,1875,1
STAT,1923,1,na,1924,4632.920325051366
SIM,1858,44,50-100,1902,3
STAT,1804,89,na,1893,35.60044510559891
STAT,1879,86,na,1965,431.71078399806805
SIM,1830,93,na,1923,8
SIM,1890,26,25-29,1916,46
SIM,1906,24,35-39,1930,11
STAT,1828,39,20-24,1867,0.7004278218032158
SIM,1841,96,na,1937,1
SIM,1823,35,25-29,1858,1
SIM,1875,23,25-29,1898,52
STAT,1798,84,na,1882,109.70845685446639
STAT,1859,53,35-39,1912,0.006386367793127442
STAT,1849,20,50-100,1869,0.36053075316149047
SIM,1940,24,40-44,1964,2
STAT,1914,33,25-29,1947,8.750460951645996
SIM,1849,14,na,1863,2129
STAT,1895,7,na,1902,3211.882545907612
SIM,1873,38,50-100,1911,1
STAT,1868,83,na,1951,358.0731521251349
STAT,1831,45,50-100,1876,0.1852785285665454
SIM,1905,37,40-44,1942,2
STAT,1890,45,20-24,1935,0.01399850618305805
STAT,1825,51,20-24,1876,7.608234279598877E-4
STAT,1867,37,45-49,1904,1.7682236683957655
SIM,1928,29,50-100,1957,1
STAT,1870,25,na,1895,2224.1192294949174
SIM,1869,50,na,1919,2009
STAT,1861,52,45-49,1913,0.011324043758135923
SIM,1886,68,na,1954,1493
SIM,1950,1,na,1951,4384
STAT,1838,44,25-29,1882,0.45431260275484264
STAT,1929,22,na,1951,4362.848620514004
SIM,1878,41,40-44,1919,6
STAT,1842,51,50-100,1893,0.010806315902119019
SIM,1825,43,40-44,1868,6
STAT,1874,4,na,1878,2818.313281705279
STAT,1932,25,25-29,1957,81.51544898496472
STAT,1792,93,na,1885,6.3626380060124665
STAT,1905,45,20-24,1950,0.009332862686299055
STAT,1914,9,na,1923,3876.768563258695
SIM,1890,26,30-34,1916,29
STAT,1934,22,25-29,1956,117.26559749298545
SIM,1827,40,40-44,1867,2
SIM,1892,34,40-44,1926,7
STAT,1874,15,na,1889,2459.02513935773
STAT,1920,35,45-49,1955,0.7063796455287328
STAT,1936,30,35-39,1966,8.393300501088522
STAT,1884,34,40-44,1918,4.013835488826959
STAT,1903,48,20-24,1951,0.008983445561148664
SIM,1872,31,20-24,1903,2
SIM,1919,17,15-19,1936,54
STAT,1803,70,na,1873,660.4514416696438
STAT,1898,45,35-39,1943,0.10199792257313234
STAT,1849,47,35-39,1896,0.10044026524065519
STAT,1925,32,na,1957,4243.308242657956
STAT,1921,22,15-19,1943,5.680412736609311
STAT,1930,27,50-100,1957,1.1956965384268674
SIM,1823,35,30-34,1858,6
STAT,1885,52,na,1937,2015.784042186421
STAT,1840,41,45-49,1881,1.1012746725375955
STAT,1820,39,50-100,1859,2.4481096824321114
SIM,1827,33,35-39,1860,16
SIM,1848,29,na,1877,1869
SIM,1865,60,na,1925,1622
STAT,1880,19,15-19,1899,5.867299337305113
STAT,1852,52,35-39,1904,0.006506104405358905
SIM,1922,46,na,1968,4019
SIM,1873,29,35-39,1902,14
SIM,1892,27,35-39,1919,14
STAT,1886,24,35-39,1910,5.788071002212383
STAT,1796,83,na,1879,145.79708781358818
SIM,1818,40,30-34,1858,3
SIM,1854,23,na,1877,1947
STAT,1912,48,30-34,1960,0.08069107220887775
STAT,1915,24,na,1939,3543.394737394527
SIM,1844,30,30-34,1874,19
STAT,1854,88,na,1942,98.85712077726771
STAT,1860,17,na,1877,2032.5521514244085
STAT,1896,18,na,1914,3145.0389545326843
STAT,1923,30,25-29,1953,10.09110184017826
SIM,1823,43,na,1866,1390
SIM,1830,25,20-24,1855,12
STAT,1847,39,25-29,1886,2.1528415277613284
STAT,1844,41,45-49,1885,1.0899208586509233
STAT,1892,42,20-24,1934,0.18764558731646455
SIM,1903,22,50-100,1925,1
SIM,1907,34,40-44,1941,7
SIM,1815,48,na,1863,1258
STAT,1784,98,na,1882,0.4764093987353912
SIM,1868,22,40-44,1890,2
STAT,1823,54,20-24,1877,8.137597050780075E-4
STAT,1882,26,30-34,1908,23.22790253837054
SIM,1899,20,50-100,1919,1
STAT,1855,41,20-24,1896,0.11298616502436237
SIM,1894,24,35-39,1918,8
STAT,1873,48,25-29,1921,0.05453911311575722
SIM,1842,22,20-24,1864,51
STAT,1914,30,15-19,1944,0.12315937984804114
SIM,1825,36,35-39,1861,12
SIM,1931,30,25-29,1961,13
SIM,1940,25,25-29,1965,57
STAT,1856,39,35-39,1895,5.180542130614268
SIM,1865,36,50-100,1901,3
SIM,1853,30,40-44,1883,4
STAT,1814,51,45-49,1865,0.03841973138999223
SIM,1857,65,na,1922,1360
STAT,1866,1,na,1867,3118.6935158057277
SIM,1840,25,20-24,1865,10
STAT,1824,56,na,1880,1171.464039504426
STAT,1908,15,50-100,1923,0.06895804293769321
SIM,1873,15,30-34,1888,1
SIM,1891,15,na,1906,3125
STAT,1829,51,20-24,1880,5.86727179044634E-4
STAT,1919,21,50-100,1940,0.682721034547487
STAT,1867,18,45-49,1885,0.05888429662192585
SIM,1910,22,35-39,1932,8
STAT,1863,29,25-29,1892,34.876610421948676
STAT,1834,22,20-24,1856,57.04892894937593
SIM,1840,15,na,1855,2032
STAT,1882,19,25-29,1901,5.181204971620643
STAT,1914,49,35-39,1963,0.12006618086085205
STAT,1858,78,na,1936,579.4594731848058
STAT,1907,40,25-29,1947,0.06249520387232684
STAT,1847,46,30-34,1893,0.07142656545184506
STAT,1853,36,45-49,1889,1.4938164796083642
STAT,1848,18,35-39,1866,0.48715026758067115
SIM,1887,34,45-49,1921,1
STAT,1896,42,20-24,1938,0.01375223905970319
STAT,1940,20,15-19,1960,5.125804402638172
STAT,1958,4,na,1962,4878.531793574847
STAT,1884,15,40-44,1899,0.17154058648848292
STAT,1879,34,45-49,1913,1.7071637051634998
STAT,1866,73,na,1939,1034.5195413063964
STAT,1924,19,40-44,1943,1.5652274242759978
SIM,1932,19,40-44,1951,2
SIM,1897,21,50-100,1918,1
SIM,1837,40,40-44,1877,4
SIM,1947,15,25-29,1962,48
STAT,1899,60,na,1959,2554.080326657859
STAT,1903,39,na,1942,3159.376291343598
SIM,1846,44,25-29,1890,3
STAT,1884,27,35-39,1911,9.007657952949346
STAT,1880,50,45-49,1930,0.014632614536871973
STAT,1892,48,35-39,1940,0.09225013289911449
SIM,1861,70,na,1931,1146
SIM,1919,24,20-24,1943,111
SIM,1875,37,45-49,1912,2
STAT,1833,92,na,1925,25.284944397318352
STAT,1860,48,15-19,1908,3.0324484343222536E-4
SIM,1808,54,na,1862,1146
SIM,1858,13,na,1871,2226
SIM,1870,47,na,1917,2084
STAT,1829,100,na,1929,0.6507338875953684
STAT,1846,59,na,1905,1370.283041551737
SIM,1910,19,20-24,1929,27
STAT,1832,25,20-24,1857,9.921413707394116
STAT,1902,22,35-39,1924,7.779559470151411
STAT,1929,40,45-49,1969,0.2041890264561152
SIM,1853,23,35-39,1876,7
SIM,1894,31,40-44,1925,7
STAT,1817,43,40-44,1860,5.46127200265709
STAT,1833,40,30-34,1873,0.8698110817407273
STAT,1886,2,na,1888,2950.2724386812183
SIM,1886,37,20-24,1923,1
SIM,1912,27,30-34,1939,35
STAT,1849,48,na,1897,1601.2883247390196
STAT,1879,46,na,1925,2227.872394061039
STAT,1865,15,30-34,1880,1.5678163084927794
SIM,1890,19,25-29,1909,9
STAT,1904,27,30-34,1931,34.11701977038087
SIM,1884,44,50-100,1928,1
STAT,1902,19,20-24,1921,23.508010514578167
STAT,1918,45,50-100,1963,0.22844345579481026
STAT,1816,43,35-39,1859,5.191543085543558
STAT,1818,51,45-49,1869,0.03033727962787319
STAT,1913,25,15-19,1938,0.6688691645908199
STAT,1911,34,na,1945,3448.58533567395
STAT,1844,51,30-34,1895,0.004198738095516118
STAT,1844,101,na,1945,0.4005830001664863
SIM,1853,75,na,1928,776
SIM,1811,58,na,1869,1074
SIM,1870,20,30-34,1890,18
STAT,1874,53,25-29,1927,0.003365014561460482
STAT,1819,40,40-44,1859,4.721979204052524
SIM,1898,34,20-24,1932,2
SIM,1899,24,25-29,1923,84
SIM,1766,97,na,1863,3
SIM,1795,70,na,1865,612
STAT,1878,37,20-24,1915,0.7580932844796722
STAT,1882,10,na,1892,2381.1573615745333
SIM,1820,88,na,1908,46
STAT,1886,31,40-44,1917,4.346270800194544
SIM,1896,37,20-24,1933,1
STAT,1884,28,50-100,1912,0.595076185655175
STAT,1889,16,30-34,1905,1.8634507671528415
SIM,1851,26,35-39,1877,9
STAT,1933,30,25-29,1963,11.780173234828242
SIM,1832,73,na,1905,727
SIM,1859,41,30-34,1900,4
SIM,1859,4,na,1863,2426
SIM,1845,33,50-100,1878,1
STAT,1842,54,30-34,1896,0.004122318856056403
SIM,1838,76,na,1914,606
SIM,1858,90,na,1948,39
STAT,1831,54,25-29,1885,0.0022019355849615427
STAT,1871,23,45-49,1894,0.65105396064543
STAT,1832,45,50-100,1877,0.18062532600784398
SIM,1863,33,45-49,1896,1
SIM,1867,35,50-100,1902,1
STAT,1837,36,20-24,1873,0.5986487454822946
STAT,1856,95,na,1951,9.837288907952223
SIM,1910,21,na,1931,3320
SIM,1847,25,30-34,1872,31
SIM,1877,20,25-29,1897,56
SIM,1944,5,na,1949,4005
SIM,1873,95,na,1968,46
STAT,1859,17,40-44,1876,0.16006732392781026
STAT,1862,20,30-34,1882,14.907134971931512
SIM,1863,18,na,1881,2243
SIM,1868,41,40-44,1909,6
STAT,1942,30,35-39,1972,9.206050531508154
SIM,1778,82,na,1860,124
STAT,1841,28,na,1869,1825.1456040177877
SIM,1795,88,na,1883,36
STAT,1840,30,20-24,1870,2.3409312862678586
STAT,1866,34,35-39,1900,8.745045305706832
SIM,1923,30,50-100,1953,7
STAT,1821,39,50-100,1860,2.2584424071043028
STAT,1860,26,35-39,1886,7.541581704794563
STAT,1915,22,15-19,1937,5.197704964130757
SIM,1874,34,35-39,1908,13
SIM,1864,36,30-34,1900,2
STAT,1908,32,25-29,1940,8.239888238473501
SIM,1856,30,na,1886,1921
SIM,1923,22,15-19,1945,5
STAT,1829,43,45-49,1872,1.2400023500770165
STAT,1923,27,40-44,1950,5.055867403509346
STAT,1939,19,50-100,1958,0.35400302541813394
STAT,1820,51,45-49,1871,0.023464171293209084
STAT,1841,28,35-39,1869,8.140775570771487
SIM,1896,30,na,1926,3048
STAT,1843,26,35-39,1869,8.629044069905174
STAT,1849,52,20-24,1901,5.290540261930816E-4
STAT,1867,21,na,1888,2121.674927794234
SIM,1783,85,na,1868,74
STAT,1849,43,30-34,1892,0.8226841891443054
STAT,1866,52,20-24,1918,6.392981668731253E-4
STAT,1888,37,20-24,1925,0.8602751864648778
STAT,1894,35,na,1929,2890.2217484380385
STAT,1899,26,40-44,1925,3.891405987720986
SIM,1885,44,50-100,1929,1
STAT,1899,45,40-44,1944,0.12626860932374454
STAT,1855,33,45-49,1888,1.2445343067358505
SIM,1956,15,35-39,1971,8
STAT,1948,11,na,1959,4247.734359878823
SIM,1914,32,20-24,1946,2
STAT,1887,27,50-100,1914,0.6758327845051926
STAT,1908,20,na,1928,3333.276422150502
STAT,1840,49,40-44,1889,0.11718886702039032
STAT,1839,25,30-34,1864,21.459421811508104
STAT,1862,36,50-100,1898,0.9941234181143308
STAT,1771,91,na,1862,11.97138425795745
STAT,1879,42,20-24,1921,0.15662401507265483
SIM,1916,32,25-29,1948,13
SIM,1789,76,na,1865,348
STAT,1881,42,45-49,1923,1.3634706002756614
SIM,1931,27,40-44,1958,5
SIM,1916,24,na,1940,3478
STAT,1870,48,15-19,1918,3.6561506127059614E-4
SIM,1860,69,na,1929,1194
SIM,1878,33,na,1911,2405
STAT,1854,29,15-19,1883,0.3375964986463379
STAT,1828,40,na,1868,1541.1766622136452
STAT,1873,67,na,1940,1520.0785797073133
STAT,1830,39,15-19,1869,0.04337913667439408
STAT,1878,18,20-24,1896,17.389488828430288
STAT,1948,15,35-39,1963,4.539260714719918
STAT,1828,46,na,1874,1433.571646279027
SIM,1835,62,na,1897,1150
STAT,1848,51,30-34,1899,0.0043088748959825025
SIM,1890,67,na,1957,1918
STAT,1891,19,35-39,1910,0.6381684721597681
SIM,1871,26,20-24,1897,12
STAT,1845,33,45-49,1878,1.4453861897594737
STAT,1896,34,45-49,1930,2.158577701860973
STAT,1927,3,na,1930,4764.836074081272
STAT,1939,25,35-39,1964,14.269217900188252
SIM,1832,28,35-39,1860,7
SIM,1868,34,35-39,1902,10
STAT,1924,40,25-29,1964,0.08047172726144003
STAT,1809,67,na,1876,809.9384214911073
STAT,1906,32,20-24,1938,2.135077899865168
STAT,1860,22,30-34,1882,14.097541072089639
STAT,1864,34,25-29,1898,8.573900863712069
SIM,1831,30,20-24,1861,4
STAT,1840,110,na,1950,1.9244646063694296E-4
STAT,1816,77,na,1893,402.8037979338984
STAT,1847,16,50-100,1863,0.045257610923295825
STAT,1869,29,50-100,1898,0.5807774506002173
STAT,1928,36,15-19,1964,0.022949941923920626
STAT,1851,44,25-29,1895,0.4645479837030894
STAT,1878,15,40-44,1893,0.18071220681792105
SIM,1851,33,40-44,1884,2
STAT,1923,49,45-49,1972,0.23880010852788916
STAT,1833,52,25-29,1885,0.002221182980883164
STAT,1838,46,20-24,1884,0.008528713095199831
STAT,1893,35,50-100,1928,1.4855680279869257
STAT,1860,110,na,1970,0.0029457114940579805
SIM,1798,59,na,1857,985
STAT,1881,20,40-44,1901,1.9120745417213563
STAT,1898,33,50-100,1931,1.1667748349142233
SIM,1942,22,25-29,1964,88
SIM,1897,16,30-34,1913,5
STAT,1765,97,na,1862,0.8344752839208908
SIM,1941,30,25-29,1971,11
STAT,1920,46,25-29,1966,0.055534482264559
SIM,1830,47,na,1877,1553
STAT,1853,47,na,1900,1660.720910044043
STAT,1899,38,35-39,1937,1.966590213776623
SIM,1872,54,na,1926,1973
STAT,1843,45,na,1888,1657.5244586718836
STAT,1843,33,40-44,1876,3.722500453848774
SIM,1810,70,na,1880,653
SIM,1853,33,45-49,1886,2
STAT,1914,37,40-44,1951,1.4117400384321244
SIM,1866,25,40-44,1891,2
STAT,1892,28,na,1920,2813.3352680557996
SIM,1867,73,na,1940,985
STAT,1823,49,40-44,1872,0.1984193304629804
STAT,1869,28,20-24,1897,10.689909304383665
STAT,1902,38,20-24,1940,0.22071028963143005
SIM,1906,29,40-44,1935,5
STAT,1869,20,25-29,1889,52.885251312292574
SIM,1883,23,20-24,1906,58
SIM,1925,33,35-39,1958,10
STAT,1940,30,25-29,1970,9.04600314720508
SIM,1862,36,20-24,1898,3
SIM,1931,29,na,1960,4570
STAT,1944,27,na,1971,3824.8386819669886
STAT,1957,8,na,1965,4894.3394743446515
SIM,1952,8,na,1960,4396
STAT,1890,21,20-24,1911,79.83609871092783
STAT,1895,34,50-100,1929,1.1198765894385698
SIM,1846,33,45-49,1879,1
STAT,1854,36,20-24,1890,0.5577554820949817
STAT,1890,32,45-49,1922,2.014161739569556
STAT,1875,26,50-100,1901,0.6229763650652094
SIM,1911,52,na,1963,3282
STAT,1810,46,35-39,1856,0.5062418046176459
SIM,1801,99,na,1900,1
STAT,1838,33,45-49,1871,1.4626286199329963
STAT,1858,25,40-44,1883,2.3072540447996306
STAT,1839,89,na,1928,70.04675783142169
SIM,1840,35,30-34,1875,3
STAT,1916,34,40-44,1950,3.783974879697496
SIM,1949,22,35-39,1971,11
SIM,1922,37,40-44,1959,3
SIM,1847,87,na,1934,106
STAT,1790,64,na,1854,774.0
STAT,1845,71,na,1916,940.208654149749
SIM,1858,20,15-19,1878,2
SIM,1914,30,25-29,1944,16
STAT,1917,33,35-39,1950,9.001534677747935
STAT,1863,19,15-19,1882,5.057245237611061
STAT,1895,21,50-100,1916,0.5042416968347365
STAT,1834,32,30-34,1866,13.84350418017184
STAT,1867,34,40-44,1901,3.813735974325661
STAT,1819,43,45-49,1862,2.840492736712808
STAT,1826,39,na,1865,1517.8452333093792
STAT,1827,40,30-34,1867,1.0955074250290202
STAT,1873,45,20-24,1918,0.011621619223774245
SIM,1875,34,40-44,1909,7
STAT,1919,30,35-39,1949,9.388830295578025
STAT,1924,42,50-100,1966,0.13202250592867756
SIM,1909,14,na,1923,3627
STAT,1796,67,na,1863,793.6682823456073
STAT,1921,27,30-34,1948,41.25746769204633
SIM,1831,41,45-49,1872,2
STAT,1856,48,25-29,1904,0.04208239811060562
SIM,1843,97,na,1940,3
STAT,1806,54,20-24,1860,0.002001492590152062
STAT,1932,22,20-24,1954,137.8309998102716
SIM,1842,32,30-34,1874,23
STAT,1858,28,45-49,1886,0.8368930102550727
STAT,1837,23,na,1860,1754.173222365403
SIM,1871,19,15-19,1890,7
STAT,1849,61,na,1910,1346.8953827140638
SIM,1940,22,20-24,1962,105
STAT,1887,81,na,1968,930.7740425801085
SIM,1865,44,na,1909,1951
STAT,1825,32,20-24,1857,4.74823295399676
STAT,1864,30,50-100,1894,0.7798142571110589
SIM,1924,34,40-44,1958,5
SIM,1946,22,na,1968,3795
STAT,1922,45,20-24,1967,0.012050809783559496
STAT,1931,30,15-19,1961,0.1592539769643703
SIM,1848,17,30-34,1865,2
SIM,1861,30,30-34,1891,17
STAT,1863,26,20-24,1889,9.812409608374502
STAT,1814,40,20-24,1854,0.535380519711945
STAT,1832,35,30-34,1867,4.174767620528984
SIM,1869,37,20-24,1906,4
STAT,1837,76,na,1913,598.055858115855
SIM,1844,33,35-39,1877,14
STAT,1906,30,25-29,1936,8.15540630510585
STAT,1856,18,na,1874,1996.3996722771576
STAT,1892,45,25-29,1937,0.0388205095426289
SIM,1901,21,25-29,1922,74
STAT,1869,47,20-24,1916,0.010922084122862387
SIM,1865,44,35-39,1909,1
STAT,1892,23,20-24,1915,81.27203899299947
STAT,1840,40,na,1880,1721.979095812023
SIM,1864,29,25-29,1893,43
SIM,1927,1,na,1928,4725
SIM,1863,43,na,1906,1977
SIM,1882,41,30-34,1923,3
STAT,1834,34,na,1868,1682.9343991629382
STAT,1857,44,35-39,1901,1.3304013333278173
STAT,1825,54,25-29,1879,0.0034406651388686144
STAT,1898,59,na,1957,2527.6381650402686
STAT,1920,48,20-24,1968,0.011508907571188123
STAT,1842,28,50-100,1870,0.5592899283305235
SIM,1892,24,30-34,1916,25
SIM,1949,11,na,1960,4296
STAT,1911,18,na,1929,3640.792007757901
STAT,1817,46,45-49,1863,0.5364463714154822
STAT,1881,31,20-24,1912,2.4756546688332772
STAT,1862,45,45-49,1907,0.19207371872234777
SIM,1849,25,40-44,1874,2
STAT,1816,105,na,1921,0.013663332892263007
SIM,1811,74,na,1885,425
SIM,1884,27,45-49,1911,4
SIM,1881,37,na,1918,1948
SIM,1872,34,25-29,1906,12
STAT,1920,32,40-44,1952,4.049576593436445
STAT,1874,41,30-34,1915,1.1150636018450895
STAT,1884,37,45-49,1921,1.8609990204279052
STAT,1846,51,20-24,1897,5.227760080320047E-4
STAT,1851,22,20-24,1873,60.34824590892542
STAT,1853,30,30-34,1883,13.613838478984144
STAT,1863,50,45-49,1913,0.012224488078551332
STAT,1873,36,30-34,1909,5.1351740007934845
STAT,1775,81,na,1856,173.72314023600003
STAT,1945,20,35-39,1965,9.755672827692148
STAT,1837,29,15-19,1866,0.3623482504605854
STAT,1949,5,na,1954,4333.265141730751
STAT,1865,18,35-39,1883,0.48253558574655686
STAT,1912,32,15-19,1944,0.11942648938967512
STAT,1851,53,50-100,1904,0.010897271929312707
STAT,1861,42,35-39,1903,1.4187922272798716
SIM,1886,62,na,1948,1746
SIM,1931,24,30-34,1955,36
STAT,1858,47,45-49,1905,0.1742086154950902
STAT,1912,2,na,1914,3893.2187385800116
STAT,1943,23,35-39,1966,9.460313826861531
SIM,1878,67,na,1945,1569
SIM,1938,21,20-24,1959,100
STAT,1838,24,na,1862,1864.8629329564633
STAT,1875,33,30-34,1908,16.873810349911746
STAT,1936,26,na,1962,3387.775101679055
SIM,1894,34,45-49,1928,2
STAT,1882,29,50-100,1911,0.5838344608276852
STAT,1895,37,20-24,1932,0.9503023442116767
SIM,1931,20,15-19,1951,9
STAT,1856,29,25-29,1885,31.968422900377547
STAT,1811,83,na,1894,171.95457844306392
SIM,1830,28,25-29,1858,36
STAT,1913,17,30-34,1930,2.3537329640538904
STAT,1914,40,25-29,1954,0.06730044489727188
SIM,1820,40,30-34,1860,1
SIM,1890,29,50-100,1919,3
STAT,1836,33,35-39,1869,8.000006550294104
STAT,1828,46,20-24,1874,0.010242183131185321
STAT,1864,42,45-49,1906,1.2620736771554875
STAT,1960,11,na,1971,4832.721434393912
SIM,1921,17,30-34,1938,15
STAT,1883,45,na,1928,2103.820729658744
STAT,1803,88,na,1891,45.35540440803676
STAT,1886,34,45-49,1920,1.725649143558557
SIM,1881,36,30-34,1917,4
SIM,1891,34,35-39,1925,16
STAT,1844,54,35-39,1898,0.005877442510534074
STAT,1879,31,40-44,1910,4.299712830154615
SIM,1866,48,na,1914,1948
STAT,1845,109,na,1954,5.011389865588511E-4
STAT,1901,32,30-34,1933,23.086756533864502
STAT,1850,58,na,1908,1392.2332093208631
STAT,1875,48,35-39,1923,0.13416804520174458
SIM,1872,42,45-49,1914,1
STAT,1842,52,35-39,1894,0.006097982962246197
STAT,1923,20,15-19,1943,5.886626082914844
STAT,1940,27,40-44,1967,4.489668162696384
STAT,1833,86,na,1919,134.69882176070692
STAT,1928,17,15-19,1945,54.02693676705215
STAT,1859,46,50-100,1905,0.1856895826149259
SIM,1899,35,na,1934,3051
SIM,1846,71,na,1917,904
STAT,1838,41,20-24,1879,0.12830702199633823
STAT,1862,26,45-49,1888,0.9045170665667461
STAT,1891,40,na,1931,2729.817883031029
SIM,1867,46,50-100,1913,1
STAT,1806,53,na,1859,1110.1944012879446
STAT,1941,19,40-44,1960,1.3600001509345996
STAT,1887,41,40-44,1928,2.387104535177247
SIM,1895,41,40-44,1936,1
SIM,1870,26,45-49,1896,1
STAT,1776,111,na,1887,0.0010442448606568953
SIM,1931,39,35-39,1970,6
SIM,1934,26,50-100,1960,2
STAT,1892,45,30-34,1937,0.06524002361013638
SIM,1770,96,na,1866,1
SIM,1887,31,40-44,1918,4
STAT,1885,42,45-49,1927,1.4068726191336591
SIM,1791,64,na,1855,774
SIM,1827,43,45-49,1870,1
STAT,1858,22,50-100,1880,0.34699513483106675
SIM,1931,23,na,1954,4439
SIM,1936,17,15-19,1953,30
STAT,1923,24,30-34,1947,31.39711244930445
SIM,1824,43,35-39,1867,2
SIM,1841,40,30-34,1881,1
SIM,1844,45,na,1889,1612
SIM,1819,78,na,1897,358
SIM,1876,41,30-34,1917,1
SIM,1918,25,na,1943,3753
STAT,1850,52,25-29,1902,0.002480310645997451
STAT,1862,23,35-39,1885,4.7792828712004916
STAT,1839,28,35-39,1867,8.046743603010462
SIM,1868,44,45-49,1912,2
SIM,1858,23,25-29,1881,54
STAT,1837,39,25-29,1876,2.167431853572239
STAT,1883,34,35-39,1917,9.296041069078477
STAT,1803,53,35-39,1856,0.02418648980663558
STAT,1858,44,na,1902,1690.9469400670387
SIM,1905,34,30-34,1939,8
STAT,1939,15,25-29,1954,41.07482506274082
STAT,1826,48,50-100,1874,0.2265783538211202
STAT,1854,17,20-24,1871,15.271436635303385
STAT,1844,22,50-100,1866,0.35743001151796605
STAT,1825,54,30-34,1879,0.0057822289696602665
SIM,1862,17,20-24,1879,18
SIM,1843,26,45-49,1869,1
STAT,1775,99,na,1874,0.31243218636040904
STAT,1846,40,40-44,1886,1.6467611869842511
STAT,1862,48,25-29,1910,0.045833036824156695
STAT,1854,94,na,1948,14.391859181799123
STAT,1857,53,25-29,1910,0.0025955622630703
SIM,1888,37,30-34,1925,5
SIM,1871,94,na,1965,55
SIM,1883,33,30-34,1916,23
STAT,1880,26,20-24,1906,11.701061716644547
STAT,1938,33,na,1971,3589.895731777879
STAT,1899,48,45-49,1947,0.1701781713945545
STAT,1901,42,40-44,1943,0.20627944638248835
SIM,1876,84,na,1960,451
SIM,1853,20,30-34,1873,22
SIM,1933,30,35-39,1963,14
STAT,1836,41,na,1877,1599.7725806479443
SIM,1853,41,na,1894,1868
SIM,1861,17,na,1878,2280
STAT,1886,34,na,1920,2361.4423765760293
SIM,1914,51,na,1965,3675
SIM,1870,23,35-39,1893,8
STAT,1768,86,na,1854,39.0
STAT,1879,45,25-29,1924,0.057443117575166895
STAT,1868,41,30-34,1909,1.0416664054750484
SIM,1847,28,35-39,1875,10
STAT,1867,17,30-34,1884,1.4452898871216486
STAT,1908,14,na,1922,3606.461651938425
STAT,1841,37,25-29,1878,2.32095593849691
STAT,1914,46,30-34,1960,0.08371426597511154
SIM,1908,24,45-49,1932,1
STAT,1871,20,40-44,1891,1.9632217457889751
STAT,1847,35,na,1882,1836.3273785771316
STAT,1899,29,45-49,1928,1.427139916476177
STAT,1831,51,20-24,1882,4.868221402495949E-4
SIM,1846,30,40-44,1876,4
STAT,1763,96,na,1859,0.51587791460041
STAT,1870,44,35-39,1914,1.6535893151638767
STAT,1824,101,na,1925,0.3012536975758193
STAT,1841,18,25-29,1859,4.971023960862973
STAT,1845,30,40-44,1875,3.708271436402022
SIM,1816,42,30-34,1858,4
STAT,1818,39,20-24,1857,2.13922522933253
SIM,1831,72,na,1903,738
STAT,1877,37,45-49,1914,1.9542488630842076
SIM,1874,31,30-34,1905,20
STAT,1942,24,40-44,1966,3.3279953935799043
STAT,1807,50,30-34,1857,0.02193935586919488
SIM,1874,38,50-100,1912,2
STAT,1882,18,50-100,1900,0.04491779418681331
STAT,1863,90,na,1953,65.47027780040567
STAT,1938,30,45-49,1968,1.4962419800340878
SIM,1854,40,40-44,1894,3
STAT,1922,19,30-34,1941,13.25557987086807
STAT,1853,13,na,1866,2119.9999767742756
SIM,1885,37,45-49,1922,1
SIM,1848,35,na,1883,1838
SIM,1880,35,50-100,1915,5
STAT,1927,43,15-19,1970,0.0018167821329762507
STAT,1869,62,na,1931,1671.3446026224597
SIM,1930,19,30-34,1949,21
STAT,1801,54,45-49,1855,0.05030485415429629
STAT,1850,15,30-34,1865,1.3874696379308757
STAT,1814,41,50-100,1855,3.4419303097951213
SIM,1936,28,30-34,1964,43
SIM,1841,56,na,1897,1428
STAT,1836,36,45-49,1872,1.5613107153040822
STAT,1851,41,20-24,1892,0.11698716147701639
STAT,1872,52,20-24,1924,6.959720175446036E-4
SIM,1893,56,na,1949,2529
STAT,1828,27,20-24,1855,20.768198481926103
STAT,1876,27,45-49,1903,1.082829113555284
STAT,1906,35,25-29,1941,0.862990264501893
SIM,1912,22,45-49,1934,5
SIM,1831,33,25-29,1864,15
SIM,1851,36,45-49,1887,1
SIM,1851,58,na,1909,1466
STAT,1895,30,na,1925,2965.4907143485148
SIM,1827,27,na,1854,1647
STAT,1881,46,25-29,1927,0.05268866203175158
SIM,1829,56,na,1885,1150
SIM,1852,29,20-24,1881,9
SIM,1782,81,na,1863,164
STAT,1842,33,35-39,1875,8.621811971102815
SIM,1832,25,30-34,1857,24
SIM,1866,28,45-49,1894,1
SIM,1890,11,na,1901,3099
SIM,1850,33,35-39,1883,9
STAT,1886,21,30-34,1907,17.832545956852268
STAT,1859,52,45-49,1911,0.010883019184695182
STAT,1890,24,25-29,1914,65.70630373892283
SIM,1909,17,15-19,1926,5
STAT,1843,36,45-49,1879,1.6965097721351723
STAT,1835,26,45-49,1861,0.9093951225767605
STAT,1870,31,45-49,1901,1.6207996570717056
SIM,1906,22,na,1928,3292
STAT,1895,18,20-24,1913,21.798467730316872
STAT,1881,62,na,1943,1667.1539513138573
SIM,1890,41,50-100,1931,1
STAT,1838,30,40-44,1868,3.7525084795947965
SIM,1927,30,35-39,1957,13
STAT,1814,47,50-100,1861,0.666268917508523
STAT,1790,100,na,1890,0.21371197819004156
STAT,1815,73,na,1888,532.5778948608288
SIM,1868,53,50-100,1921,1
STAT,1838,49,25-29,1887,0.039394223391158986
SIM,1928,17,25-29,1945,57
SIM,1903,57,na,1960,2793
STAT,1820,41,35-39,1861,3.3694556449402624
STAT,1878,18,45-49,1896,0.06407326946223027
SIM,1844,36,45-49,1880,1
STAT,1904,22,45-49,1926,0.9447473831101356
STAT,1927,40,35-39,1967,0.23926483790428787
STAT,1917,27,50-100,1944,0.9860673106397868
STAT,1935,36,50-100,1971,0.5550975329549576
STAT,1823,33,25-29,1856,23.445225232884678
SIM,1845,39,25-29,1884,1
SIM,1881,26,20-24,1907,7
SIM,1914,35,25-29,1949,1
STAT,1888,47,30-34,1935,0.10752614273718553
SIM,1859,42,45-49,1901,2
STAT,1821,44,45-49,1865,2.3519318420075663
STAT,1866,33,20-24,1899,2.3443992344508535
SIM,1890,38,25-29,1928,3
STAT,1937,35,50-100,1972,0.39724812768631884
SIM,1894,21,30-34,1915,31
STAT,1864,31,20-24,1895,2.2915481937270052
STAT,1887,19,na,1906,2653.984581421218
SIM,1785,86,na,1871,54
SIM,1918,46,50-100,1964,2
SIM,1836,27,20-24,1863,10
STAT,1894,31,30-34,1925,21.304110092636552
STAT,1920,43,20-24,1963,0.018397839161820185
STAT,1891,16,30-34,1907,1.8682995946073537
SIM,1892,40,na,1932,2807
SIM,1839,23,15-19,1862,3
STAT,1815,47,25-29,1862,0.14016929077368936
STAT,1890,48,25-29,1938,0.037056666529980596
STAT,1784,103,na,1887,0.04393952003658326
SIM,1838,39,25-29,1877,9
SIM,1834,86,na,1920,129
SIM,1866,37,35-39,1903,13
SIM,1827,30,30-34,1857,19
SIM,1812,59,na,1871,1035
STAT,1818,78,na,1896,376.6988740204532
SIM,1849,22,30-34,1871,16
SIM,1888,29,35-39,1917,12
STAT,1882,38,25-29,1920,2.633574565230094
SIM,1835,40,30-34,1875,4
SIM,1870,13,na,1883,2446
STAT,1780,103,na,1883,0.044825738836643925
SIM,1868,74,na,1942,908
STAT,1881,34,25-29,1915,9.262741129105455
STAT,1851,32,30-34,1883,13.326146383935702
STAT,1869,84,na,1953,304.1994628931495
STAT,1920,46,30-34,1966,0.09332878359409545
STAT,1856,45,20-24,1901,0.008967245320376073
SIM,1923,22,20-24,1945,123
STAT,1933,34,40-44,1967,4.975663488286714
SIM,1870,90,na,1960,103
STAT,1836,21,40-44,1857,1.7492196868952212
STAT,1832,38,35-39,1870,5.363899260886721
SIM,1823,99,na,1922,3
STAT,1795,82,na,1877,162.32881930402436
SIM,1917,16,35-39,1933,5
STAT,1897,26,50-100,1923,0.8109707133920052
STAT,1864,3,na,1867,2711.7564101634207
SIM,1933,30,na,1963,4829
STAT,1871,26,na,1897,2242.7529285362507
SIM,1853,26,45-49,1879,3
STAT,1846,37,na,1883,1734.6911553882774
SIM,1882,44,35-39,1926,2
SIM,1929,38,40-44,1967,2
SIM,1812,44,45-49,1856,5
STAT,1845,26,45-49,1871,0.9588112826535514
STAT,1799,72,na,1871,560.4658604672816
SIM,1921,45,na,1966,3832
SIM,1850,76,na,1926,675
SIM,1904,29,30-34,1933,43
STAT,1853,45,50-100,1898,0.18395472992225456
SIM,1906,25,25-29,1931,66
STAT,1814,43,25-29,1857,1.9101869147923818
STAT,1899,23,30-34,1922,22.988766225249545
STAT,1844,29,20-24,1873,9.937494003100497
SIM,1919,29,na,1948,3784
STAT,1873,42,50-100,1915,1.0117932934873284
STAT,1926,33,na,1959,4318.057375125318
SIM,1870,30,40-44,1900,5
STAT,1887,44,45-49,1931,1.5598519789601555
STAT,1888,66,na,1954,1829.151966395546
STAT,1900,18,40-44,1918,0.2390827902489239
STAT,1813,47,na,1860,1302.5490347045609
STAT,1910,21,25-29,1931,82.1692334069035
STAT,1857,99,na,1956,1.6624346122850584
STAT,1861,51,30-34,1912,0.004691978579162986
STAT,1947,21,20-24,1968,118.76623542796035
SIM,1844,43,45-49,1887,1
STAT,1827,43,35-39,1870,1.6368705206788319
SIM,1908,33,35-39,1941,17
SIM,1864,26,20-24,1890,12
STAT,1819,49,15-19,1868,6.903535684240092E-4
STAT,1763,101,na,1864,0.04540486495552029
SIM,1947,19,40-44,1966,2
STAT,1840,45,25-29,1885,0.04150126299782079
STAT,1867,20,15-19,1887,2.980943434187385
SIM,1868,30,25-29,1898,8
SIM,1900,40,40-44,1940,3
STAT,1903,49,35-39,1952,0.10392438727869786
SIM,1849,44,40-44,1893,3
STAT,1906,32,15-19,1938,0.11248422844322352
STAT,1881,19,na,1900,2291.362062568762
STAT,1814,107,na,1921,0.001945783426646963
STAT,1914,23,na,1937,3513.014793469757
STAT,1954,17,25-29,1971,50.60781090769036
SIM,1881,31,na,1912,1986
STAT,1842,32,20-24,1874,2.325305318378644
STAT,1851,44,30-34,1895,0.8316907416139631
STAT,1942,20,25-29,1962,91.55079631290879
STAT,1858,22,na,1880,1819.3658323229392
STAT,1828,49,25-29,1877,0.04725136035683588
STAT,1901,35,40-44,1936,1.2612222038901262
SIM,1807,50,na,1857,1154
STAT,1894,34,35-39,1928,12.201251485946669
STAT,1836,43,45-49,1879,1.110013865867371
STAT,1914,48,na,1962,3431.8318798248392
SIM,1850,32,20-24,1882,3
SIM,1868,9,na,1877,2449
STAT,1939,19,40-44,1958,1.3216116162772584
SIM,1856,89,na,1945,58
SIM,1875,20,15-19,1895,3
STAT,1834,47,35-39,1881,0.09190382440638799
SIM,1949,15,35-39,1964,4
STAT,1923,35,50-100,1958,0.460411264337057
STAT,1870,19,20-24,1889,16.372504085469238
STAT,1825,42,30-34,1867,1.2841695236939448
STAT,1906,31,50-100,1937,0.7266768188242894
STAT,1932,17,40-44,1949,1.7497111972989214
STAT,1907,44,40-44,1951,0.2137892447752032
STAT,1807,53,35-39,1860,0.029879486721438624
STAT,1888,44,20-24,1932,0.17484459019355195
SIM,1882,4,na,1886,2448
STAT,1874,44,35-39,1918,1.7247977145186648
STAT,1940,24,30-34,1964,27.637646345637812
STAT,1852,8,na,1860,2256.5335311655194
STAT,1873,39,35-39,1912,6.7140226305522965
SIM,1899,28,40-44,1927,6
SIM,1848,45,50-100,1893,1
STAT,1868,37,na,1905,2125.037297688492
SIM,1921,48,na,1969,3802
SIM,1843,47,50-100,1890,3
SIM,1887,28,50-100,1915,2
SIM,1927,21,50-100,1948,1
STAT,1889,21,50-100,1910,0.4770303993370178
STAT,1847,43,20-24,1890,0.11600871558419068
STAT,1876,24,40-44,1900,2.0195236061649933
STAT,1831,32,45-49,1863,1.430800332781036
STAT,1806,48,35-39,1854,0.40744242598143443
STAT,1870,41,na,1911,2149.1246128618964
STAT,1900,22,50-100,1922,0.5344458390639396
SIM,1884,24,40-44,1908,2
STAT,1784,109,na,1893,6.336409416523497E-4
SIM,1906,56,na,1962,2981
STAT,1868,21,50-100,1889,0.3704776125784444
SIM,1940,17,40-44,1957,2
SIM,1833,42,30-34,1875,5
STAT,1872,52,45-49,1924,0.013687449158934646
STAT,1909,16,35-39,1925,0.7790745979793223
SIM,1831,94,na,1925,12
STAT,1910,29,20-24,1939,16.52812251278633
STAT,1894,51,na,1945,2629.164367763982
SIM,1767,92,na,1859,8
SIM,1865,17,30-34,1882,1
STAT,1851,89,na,1940,77.03747427574642
STAT,1892,33,30-34,1925,20.567800231698712
SIM,1868,34,40-44,1902,2
STAT,1890,46,35-39,1936,0.09147337433243234
SIM,1943,17,15-19,1960,37
SIM,1826,42,na,1868,1518
SIM,1801,96,na,1897,1
STAT,1845,39,15-19,1884,0.04070508341056357
STAT,1853,33,35-39,1886,7.654172425840905
STAT,1949,22,25-29,1971,101.83087034892912
STAT,1898,44,20-24,1942,0.013912922635970156
STAT,1932,22,15-19,1954,6.598335867650724
STAT,1894,49,15-19,1943,2.684689812137966E-4
STAT,1923,39,35-39,1962,2.6421665895779607
STAT,1857,17,30-34,1874,1.3951758383048922
SIM,1940,22,15-19,1962,5
SIM,1881,53,na,1934,1767
STAT,1855,44,50-100,1899,0.7381185560121215
STAT,1914,45,na,1959,3457.596144483223
SIM,1861,33,35-39,1894,12
STAT,1935,17,15-19,1952,58.607436018256045
STAT,1927,9,na,1936,4676.504344078871
STAT,1820,50,30-34,1870,0.009817958707011193
STAT,1932,29,40-44,1961,5.761765535492385
STAT,1867,27,35-39,1894,8.558604176780339
SIM,1874,33,20-24,1907,2
STAT,1919,33,45-49,1952,1.5970425337510463
STAT,1857,50,20-24,1907,5.574635305195976E-4
STAT,1914,29,na,1943,3541.510332925984
SIM,1891,33,20-24,1924,3
SIM,1821,38,25-29,1859,1
STAT,1827,31,50-100,1858,1.1146431179167342
SIM,1835,87,na,1922,114
STAT,1883,50,30-34,1933,0.005590469070080606
STAT,1915,29,40-44,1944,4.458710430392116
STAT,1937,26,15-19,1963,0.650300429789457
STAT,1941,22,na,1963,3564.840897283993
STAT,1815,54,50-100,1869,0.03374694815767193
STAT,1868,44,35-39,1912,1.6112657901139518
SIM,1933,32,25-29,1965,15
SIM,1899,32,na,1931,3054
STAT,1839,38,50-100,1877,0.9681611645266144
STAT,1832,32,20-24,1864,2.139730704570261
STAT,1853,48,15-19,1901,2.9291555527700784E-4
STAT,1893,17,35-39,1910,0.6576915667495274
STAT,1901,46,20-24,1947,0.008975972173476673
SIM,1859,44,35-39,1903,2
SIM,1944,21,45-49,1965,1
STAT,1872,40,45-49,1912,1.4334370770705482
SIM,1813,84,na,1897,117
SIM,1834,23,30-34,1857,17
STAT,1831,32,50-100,1863,0.7517764413967994
STAT,1915,30,50-100,1945,0.8018050640135201
SIM,1880,40,45-49,1920,6
STAT,1750,109,na,1859,0.09664836758276837
SIM,1918,41,na,1959,3700
SIM,1919,26,na,1945,3827
SIM,1940,29,40-44,1969,4
SIM,1890,22,15-19,1912,4
SIM,1860,23,40-44,1883,5
STAT,1882,22,15-19,1904,3.032628070651582
SIM,1881,39,35-39,1920,1
SIM,1918,21,35-39,1939,12
STAT,1883,29,na,1912,2193.8109295256113
SIM,1929,31,20-24,1960,1
STAT,1857,41,30-34,1898,0.8600904849030471
STAT,1916,30,25-29,1946,9.086755412458405
STAT,1922,40,na,1962,4038.5441880386247
SIM,1782,84,na,1866,91
SIM,1893,41,na,1934,2883
SIM,1923,29,40-44,1952,9
STAT,1858,25,35-39,1883,7.4318325084424455
STAT,1874,50,20-24,1924,7.227231357041842E-4
SIM,1839,27,30-34,1866,30
STAT,1871,16,45-49,1887,0.06193728082237944
STAT,1815,44,20-24,1859,0.4063885950973467
SIM,1924,30,25-29,1954,11
STAT,1916,42,25-29,1958,0.06912904082558152
STAT,1893,24,40-44,1917,2.482050693705454
STAT,1800,99,na,1899,0.7549096085952055
STAT,1841,15,20-24,1856,15.830071940218954
STAT,1901,23,40-44,1924,2.7468790757728794
SIM,1788,75,na,1863,359
SIM,1929,24,15-19,1953,6
SIM,1900,68,na,1968,2230
STAT,1898,18,30-34,1916,2.0329428727744414
STAT,1877,41,40-44,1918,2.21498041173173
STAT,1901,41,na,1942,3080.552638805973
STAT,1841,34,20-24,1875,2.197767147665242
STAT,1876,17,40-44,1893,0.17837719496722218
SIM,1861,45,50-100,1906,1
STAT,1867,15,40-44,1882,0.16782409008924065
SIM,1818,47,na,1865,1279
STAT,1826,33,40-44,1859,5.414761423629521
STAT,1909,22,50-100,1931,0.5775751870381423
SIM,1848,29,30-34,1877,31
STAT,1834,49,na,1883,1439.454386668817
STAT,1821,61,na,1882,1067.8998204647737
STAT,1759,105,na,1864,0.00830979305302207
SIM,1885,22,40-44,1907,3
STAT,1877,44,50-100,1921,1.0216782868456238
SIM,1876,44,35-39,1920,6
SIM,1868,89,na,1957,89
STAT,1912,38,20-24,1950,0.24179550637886812
SIM,1827,33,40-44,1860,3
SIM,1845,24,na,1869,1839
SIM,1899,21,15-19,1920,4
STAT,1856,26,20-24,1882,9.05954625145689
STAT,1926,23,35-39,1949,10.774409445882677
SIM,1885,41,40-44,1926,4
SIM,1859,35,45-49,1894,2
STAT,1880,29,25-29,1909,41.74702395533804
SIM,1834,33,40-44,1867,3
STAT,1919,21,45-49,1940,1.167452924592904
SIM,1889,51,na,1940,2521
STAT,1886,24,40-44,1910,2.0668793942179176
STAT,1897,5,na,1902,3310.9549719163365
SIM,1885,34,35-39,1919,9
STAT,1916,49,45-49,1965,0.20934985930948655
STAT,1911,45,45-49,1956,0.19524645327399834
STAT,1831,51,45-49,1882,0.009574168394899637
SIM,1934,23,35-39,1957,17
STAT,1848,107,na,1955,0.0033974840730158673
STAT,1831,69,na,1900,895.0034172802187
SIM,1854,43,45-49,1897,3
STAT,1945,23,45-49,1968,1.1645836328507129
SIM,1818,43,35-39,1861,7
STAT,1882,66,na,1948,1506.6601912316225
STAT,1895,14,na,1909,3173.409796572727
SIM,1839,15,30-34,1854,5
SIM,1823,77,na,1900,450
SIM,1890,35,20-24,1925,5
SIM,1904,16,25-29,1920,9
STAT,1806,62,na,1868,897.1566953341699
SIM,1835,43,35-39,1878,1
SIM,1868,71,na,1939,1149
STAT,1887,1,na,1888,3138.1876114173087
STAT,1852,23,40-44,1875,1.8672875913917328
STAT,1812,84,na,1896,143.07788370948006
SIM,1894,24,40-44,1918,3
STAT,1812,54,20-24,1866,0.0022310702323542807
SIM,1950,20,25-29,1970,101
STAT,1847,24,20-24,1871,61.27002341345732
STAT,1917,21,35-39,1938,9.482033867325967
STAT,1762,92,na,1854,2.0
STAT,1902,1,na,1903,3628.6512701516795
STAT,1910,36,20-24,1946,0.23924712778378107
SIM,1869,37,na,1906,2154
STAT,1862,33,45-49,1895,1.3993077910586431
STAT,1882,35,20-24,1917,0.7153325815466953
STAT,1853,31,45-49,1884,1.3456620030968973
SIM,1833,32,20-24,1865,1
SIM,1849,37,35-39,1886,10
STAT,1846,43,45-49,1889,1.054418762142727
STAT,1781,84,na,1865,94.34500912567422
STAT,1925,32,25-29,1957,10.369851569880037
STAT,1841,21,15-19,1862,2.8800567499936918
STAT,1849,64,na,1913,1252.9928013637489
STAT,1883,33,20-24,1916,2.492111910678063
SIM,1925,21,35-39,1946,10
SIM,1844,21,40-44,1865,3
STAT,1842,54,25-29,1896,0.0024529500394667634
STAT,1862,45,20-24,1907,0.00976646064465761
STAT,1948,6,na,1954,4261.193884226953
STAT,1812,47,15-19,1859,0.001316207616326019
STAT,1897,27,20-24,1924,14.821695833971166
STAT,1910,48,20-24,1958,0.009710517043953665
STAT,1857,15,50-100,1872,0.043394172423910436
STAT,1906,27,40-44,1933,4.120724840644917
SIM,1858,96,na,1954,4
STAT,1852,16,35-39,1868,0.5072049709235611
SIM,1943,6,na,1949,3894
SIM,1914,39,40-44,1953,2
STAT,1940,20,50-100,1960,0.6335976505237099
SIM,1908,21,35-39,1929,10
STAT,1936,21,45-49,1957,1.0163799073646045
STAT,1908,11,na,1919,3623.5741868659834
STAT,1816,42,20-24,1858,0.4748942153908869
SIM,1819,40,50-100,1859,1
STAT,1841,103,na,1944,0.09819176848600604
SIM,1840,32,20-24,1872,1
SIM,1840,38,35-39,1878,11
SIM,1847,72,na,1919,891
STAT,1880,18,na,1898,2503.871135662628
SIM,1914,27,40-44,1941,4
STAT,1863,74,na,1937,921.5835064256511
SIM,1939,15,35-39,1954,7
STAT,1877,34,35-39,1911,9.842737445043152
STAT,1876,50,30-34,1926,0.005888679996531943
STAT,1850,24,na,1874,1780.825599552331
STAT,1915,22,20-24,1937,108.5735685928372
SIM,1871,29,25-29,1900,39
STAT,1906,39,40-44,1945,1.286656777544026
SIM,1889,18,30-34,1907,3
STAT,1821,49,15-19,1870,5.931775710740422E-4
STAT,1827,61,na,1888,1066.863733886291
STAT,1832,44,20-24,1876,0.11480108423003887
STAT,1898,42,30-34,1940,0.10196986199450464
SIM,1845,46,na,1891,1589
STAT,1835,23,40-44,1858,1.7158521948716299
STAT,1848,54,35-39,1902,0.006031613287160176
STAT,1855,44,25-29,1899,0.44866030157269754
SIM,1861,31,45-49,1892,1
STAT,1848,60,na,1908,1373.9771188892535
STAT,1801,53,25-29,1854,0.012527133007277353
SIM,1900,33,40-44,1933,7
SIM,1844,61,na,1905,1301
SIM,1853,23,40-44,1876,5
STAT,1913,36,50-100,1949,0.3932162641916814
STAT,1847,36,20-24,1883,0.5946188701122878
STAT,1902,20,na,1922,3171.772534808419
STAT,1842,19,45-49,1861,0.05903231935724498
SIM,1874,19,30-34,1893,1
STAT,1840,22,45-49,1862,0.6175722827133253
STAT,1903,46,30-34,1949,0.07359695216913727
STAT,1913,29,30-34,1942,36.610602741652
SIM,1906,22,20-24,1928,100
STAT,1842,51,20-24,1893,5.279959118877529E-4
STAT,1920,49,35-39,1969,0.13385568731933267
STAT,1894,69,na,1963,1981.2198678588154
SIM,1900,46,na,1946,2933
SIM,1923,25,25-29,1948,66
SIM,1888,35,50-100,1923,1
STAT,1845,45,45-49,1890,0.16789127944334847
STAT,1901,56,na,1957,2737.136956625439
STAT,1882,29,35-39,1911,8.806384185838672
STAT,1866,19,30-34,1885,1.4081823817130357
SIM,1828,39,30-34,1867,6
SIM,1869,8,na,1877,2478
SIM,1869,34,na,1903,2145
STAT,1856,36,30-34,1892,3.9623019943495956
STAT,1836,40,40-44,1876,1.7335880363226122
STAT,1915,25,25-29,1940,63.84651713212259
SIM,1861,19,20-24,1880,11
SIM,1890,29,35-39,1919,12
STAT,1845,23,40-44,1868,1.8090909033547338
STAT,1897,33,15-19,1930,0.17916078087606557
SIM,1875,27,35-39,1902,15
STAT,1827,41,45-49,1868,1.4012582345511326
STAT,1922,15,15-19,1937,49.851962310045394
STAT,1923,32,15-19,1955,0.13918249590137524
SIM,1877,88,na,1965,243
SIM,1870,33,45-49,1903,1
STAT,1916,46,40-44,1962,0.1531425541044359
STAT,1898,47,25-29,1945,0.041356906211297596
SIM,1890,16,20-24,1906,21
STAT,1836,24,45-49,1860,0.5728370950574126
STAT,1873,33,20-24,1906,2.581047359762819
SIM,1823,38,35-39,1861,17
SIM,1899,18,30-34,1917,2
SIM,1881,33,20-24,1914,2
SIM,1878,11,na,1889,2619
STAT,1836,75,na,1911,650.0940078547807
SIM,1839,17,20-24,1856,15
SIM,1881,29,25-29,1910,38
STAT,1861,42,na,1903,1810.8814082618912
STAT,1912,19,na,1931,3668.8873988264572
STAT,1873,29,25-29,1902,40.273272051603364
SIM,1919,27,25-29,1946,69
STAT,1852,21,50-100,1873,0.3707228098249216
STAT,1842,30,30-34,1872,15.334898280380788
SIM,1837,43,45-49,1880,1
SIM,1930,15,15-19,1945,53
STAT,1853,19,20-24,1872,15.629967832703382
STAT,1840,31,50-100,1871,0.7852997647687456
SIM,1842,44,30-34,1886,4
STAT,1918,17,15-19,1935,9.36215678256203
SIM,1829,34,20-24,1863,2
STAT,1873,26,20-24,1899,11.287991266423472
STAT,1832,28,25-29,1860,34.309456734165444
SIM,1810,73,na,1883,506
STAT,1858,37,35-39,1895,5.245488025391593
STAT,1810,44,45-49,1854,5.535125968165663
STAT,1834,31,na,1865,1736.1848833627457
STAT,1944,21,na,1965,3725.955747362121
SIM,1840,28,25-29,1868,38
SIM,1850,30,30-34,1880,22
STAT,1894,32,45-49,1926,2.1191280627228486
SIM,1868,37,45-49,1905,2
STAT,1846,19,20-24,1865,15.517968387336001
SIM,1888,26,na,1914,2586
STAT,1864,46,25-29,1910,0.048770375702542716
STAT,1923,36,30-34,1959,1.9969863429193553
STAT,1901,38,45-49,1939,0.5661271364440685
SIM,1829,53,na,1882,1236
SIM,1832,76,na,1908,557
SIM,1850,35,25-29,1885,2
SIM,1808,69,na,1877,717
STAT,1834,44,30-34,1878,0.8362035475913946
STAT,1938,24,15-19,1962,4.973020405632313
SIM,1832,57,na,1889,1252
STAT,1871,35,50-100,1906,1.1607545632276752
SIM,1947,19,50-100,1966,1
STAT,1904,30,na,1934,3259.0169140069697
STAT,1815,76,na,1891,405.4899503343429
STAT,1848,15,30-34,1863,1.4403570612380316
STAT,1816,40,30-34,1856,3.7213436026886275
SIM,1844,40,40-44,1884,3
STAT,1842,35,25-29,1877,2.455642852448083
STAT,1848,29,50-100,1877,0.5422951127339329
SIM,1878,44,45-49,1922,4
SIM,1864,39,35-39,1903,11
STAT,1847,49,35-39,1896,0.10085963930878115
STAT,1838,53,20-24,1891,4.952088411465643E-4
SIM,1901,30,50-100,1931,5
STAT,1855,52,45-49,1907,0.010223509292027136
STAT,1829,54,25-29,1883,0.002414881206395754
STAT,1861,64,na,1925,1363.7016016303403
STAT,1941,15,25-29,1956,42.186318147804585
SIM,1868,6,na,1874,2513
SIM,1928,19,15-19,1947,48
STAT,1787,101,na,1888,0.13623212828868694
STAT,1870,41,30-34,1911,1.069028119772149
STAT,1886,46,45-49,1932,0.2362260907840338
STAT,1861,54,35-39,1915,0.006567886286867336
SIM,1889,73,na,1962,1562
SIM,1834,26,35-39,1860,10
SIM,1858,17,30-34,1875,5
STAT,1896,45,25-29,1941,0.04097073413947156
SIM,1856,29,50-100,1885,2
SIM,1938,33,20-24,1971,2
STAT,1836,97,na,1933,3.3925120662734787
SIM,1833,21,na,1854,1749
STAT,1883,46,35-39,1929,0.12998941501763525
STAT,1883,52,20-24,1935,6.795781847763463E-4
SIM,1921,29,30-34,1950,58
STAT,1903,42,15-19,1945,0.0012873178624484595
SIM,1856,86,na,1942,126
SIM,1885,44,45-49,1929,3
SIM,1859,32,40-44,1891,3
STAT,1887,4,na,1891,2779.312455193366
STAT,1884,49,50-100,1933,0.22449021851670709
SIM,1877,85,na,1962,358
SIM,1812,48,50-100,1860,5
SIM,1901,29,20-24,1930,18
STAT,1883,31,30-34,1914,16.231440077226868
STAT,1783,94,na,1877,3.397488605892891
SIM,1913,19,na,1932,3598
STAT,1833,43,35-39,1876,1.3182284172875263
STAT,1856,32,15-19,1888,0.1066566198822617
STAT,1868,42,45-49,1910,1.3482730768726323
SIM,1883,63,na,1946,1642
SIM,1939,17,25-29,1956,47
SIM,1875,24,30-34,1899,23
STAT,1820,53,35-39,1873,0.013375684865803714
STAT,1829,40,40-44,1869,1.9515001302445232
STAT,1762,95,na,1857,0.4588464825044639
STAT,1867,24,30-34,1891,15.700596078359377
STAT,1873,52,na,1925,2053.6990229018493
STAT,1815,98,na,1913,1.3903796949536766
SIM,1833,39,na,1872,1572
SIM,1931,36,30-34,1967,2
STAT,1876,41,na,1917,2264.248091578648
SIM,1854,19,20-24,1873,16
SIM,1929,29,50-100,1958,1
STAT,1818,87,na,1905,84.94089959776673
STAT,1877,25,45-49,1902,1.095833396771709
SIM,1841,43,35-39,1884,4
SIM,1885,25,45-49,1910,1
STAT,1877,44,45-49,1921,1.4473775771789466
SIM,1871,78,na,1949,638
STAT,1846,34,na,1880,1768.6826958419347
STAT,1828,39,15-19,1867,0.051024549729860424
STAT,1856,12,na,1868,2088.537468927308
SIM,1892,49,50-100,1941,2
STAT,1854,39,25-29,1893,2.052426490110805
STAT,1912,44,15-19,1956,0.001388051592526042
STAT,1883,36,25-29,1919,2.6785843934473874
SIM,1891,31,30-34,1922,30
STAT,1896,31,40-44,1927,5.436657428637403
SIM,1880,19,30-34,1899,5
SIM,1866,22,30-34,1888,19
STAT,1866,43,30-34,1909,0.9941149069783516
SIM,1926,17,15-19,1943,51
SIM,1891,6,na,1897,3206
STAT,1929,41,15-19,1970,0.00188159141284932
SIM,1908,63,na,1971,2725
STAT,1842,45,35-39,1887,0.10230041087627952
STAT,1852,26,45-49,1878,0.989655305471571
SIM,1822,32,45-49,1854,1
SIM,1870,93,na,1963,53
STAT,1897,37,30-34,1934,6.733470467782153
SIM,1921,30,na,1951,3891
STAT,1811,51,35-39,1862,0.027891169534366326
STAT,1837,17,20-24,1854,19.48089954726145
SIM,1922,34,30-34,1956,18
SIM,1845,17,20-24,1862,18
SIM,1854,29,30-34,1883,23
STAT,1846,29,30-34,1875,21.17190362906479
STAT,1881,23,45-49,1904,0.6340922547884172
SIM,1934,18,na,1952,4624
STAT,1889,19,35-39,1908,0.6365122234417666
STAT,1914,34,30-34,1948,14.851149878067394
STAT,1923,46,40-44,1969,0.17468585200391512
STAT,1875,45,30-34,1920,0.09488470272731374
SIM,1882,19,na,1901,2299
STAT,1837,54,50-100,1891,0.009271864660795428
STAT,1830,34,45-49,1864,1.412438056223869
STAT,1858,22,30-34,1880,15.156745845629844
STAT,1897,40,na,1937,2959.7065621225997
STAT,1906,44,50-100,1950,0.09955548894076718
SIM,1791,80,na,1871,214
SIM,1854,38,na,1892,1834
STAT,1824,72,na,1896,666.7298113222012
STAT,1836,30,30-34,1866,14.228944809086123
STAT,1839,86,na,1925,147.9408500247864
STAT,1840,33,25-29,1873,8.59834358030031
STAT,1947,10,na,1957,4181.5566596645895
STAT,1825,35,na,1860,1647.5032326125904
STAT,1916,40,35-39,1956,0.1954775597591521
STAT,1808,54,30-34,1862,0.020799018705333353
SIM,1881,56,na,1937,1723
STAT,1847,53,30-34,1900,0.004309495971734611
SIM,1944,8,na,1952,3972
STAT,1893,27,45-49,1920,1.3308271041050548
SIM,1874,43,30-34,1917,3
STAT,1864,56,na,1920,1722.0849536786036
STAT,1930,17,30-34,1947,14.887466796329825
SIM,1792,65,na,1857,743
SIM,1819,91,na,1910,19
STAT,1855,30,40-44,1885,3.192967425583982
SIM,1856,64,na,1920,1333
SIM,1920,29,50-100,1949,4
STAT,1912,29,50-100,1941,0.9197910660459692
STAT,1948,3,na,1951,4312.223817851065
STAT,1851,47,35-39,1898,0.10218567504156631
STAT,1870,78,na,1948,723.2558480111002
STAT,1832,47,25-29,1879,0.041288711865453104
STAT,1911,42,40-44,1953,0.2254757472872545
SIM,1881,43,30-34,1924,7
STAT,1834,23,50-100,1857,0.3351637590530274
STAT,1872,19,30-34,1891,1.5032058327114404
STAT,1824,40,50-100,1864,1.4061440493637105
STAT,1937,17,25-29,1954,39.820879155987576
STAT,1837,20,na,1857,1791.587171191743
SIM,1834,36,45-49,1870,4
SIM,1885,31,30-34,1916,23
SIM,1855,39,25-29,1894,2
STAT,1885,55,na,1940,1946.0893304757506
SIM,1821,36,na,1857,1543
STAT,1927,20,50-100,1947,0.7705048090893966
SIM,1865,41,30-34,1906,3
SIM,1842,35,na,1877,1754
SIM,1863,30,40-44,1893,3
STAT,1826,36,45-49,1862,2.223527890613632
STAT,1812,87,na,1899,75.77506100217599
STAT,1816,45,25-29,1861,0.15658950344342412
SIM,1945,17,25-29,1962,52
SIM,1886,18,20-24,1904,15
SIM,1835,29,20-24,1864,10
STAT,1841,25,30-34,1866,21.710190539766714
SIM,1933,33,na,1966,4811
STAT,1877,31,30-34,1908,17.18600443435135
SIM,1860,5,na,1865,2449
SIM,1863,34,na,1897,2030
STAT,1904,8,na,1912,3521.9253225112416
SIM,1849,34,30-34,1883,22
SIM,1849,28,45-49,1877,2
SIM,1891,36,25-29,1927,3
STAT,1805,80,na,1885,264.38588222964347
STAT,1890,36,25-29,1926,3.3415565742642697
STAT,1916,55,na,1971,3447.900615228706
STAT,1810,58,na,1868,1091.7751353163674
STAT,1877,22,40-44,1899,2.0427931828030643
STAT,1883,11,na,1894,2394.6282597582385
SIM,1914,23,25-29,1937,103
STAT,1886,27,45-49,1913,1.1082203621856654
SIM,1912,34,na,1946,3334
STAT,1901,49,25-29,1950,0.04206565728519519
SIM,1894,27,45-49,1921,2
STAT,1919,38,30-34,1957,1.8478464183476278
STAT,1773,113,na,1886,3.366159068960107E-4
STAT,1906,23,25-29,1929,78.50425195646862
SIM,1832,40,50-100,1872,3
STAT,1825,57,na,1882,1221.795536275447
STAT,1827,83,na,1910,220.30766469652053
STAT,1871,35,45-49,1906,1.8847179223488857
STAT,1823,45,25-29,1868,0.0707218594797824
STAT,1862,30,40-44,1892,3.5227810388189194
STAT,1819,36,45-49,1855,5.804841832299534
SIM,1789,79,na,1868,250
STAT,1759,102,na,1861,0.033765524044904925
STAT,1827,29,20-24,1856,16.975080531820034
SIM,1828,29,20-24,1857,8
SIM,1927,38,30-34,1965,3
SIM,1857,49,na,1906,1757
STAT,1774,80,na,1854,221.0
STAT,1852,50,50-100,1902,0.011639547004559908
SIM,1892,17,30-34,1909,5
SIM,1893,49,50-100,1942,1
SIM,1791,95,na,1886,1
SIM,1824,87,na,1911,74
SIM,1857,19,30-34,1876,1
STAT,1848,53,20-24,1901,5.230788505449504E-4
STAT,1837,46,50-100,1883,0.16301676462876813
SIM,1864,1,na,1865,3055
STAT,1886,30,35-39,1916,10.18931926932923
STAT,1895,42,50-100,1937,0.09032954023774994
SIM,1892,33,35-39,1925,13
STAT,1895,36,45-49,1931,2.469398404929014
STAT,1851,27,45-49,1878,0.953319201458395
STAT,1898,46,40-44,1944,0.12384830193901979
STAT,1866,70,na,1936,1222.0622474715447
STAT,1890,44,15-19,1934,0.015735421391856682
SIM,1939,15,40-44,1954,2
STAT,1826,42,na,1868,1479.141020376095
STAT,1849,39,na,1888,1701.9587520056443
SIM,1949,19,15-19,1968,45
STAT,1787,107,na,1894,0.0017580431537425906
STAT,1904,61,na,1965,2735.047038176725
STAT,1917,15,40-44,1932,0.28565405593196375
SIM,1869,99,na,1968,9
STAT,1836,37,20-24,1873,0.59749689400759
SIM,1871,43,45-49,1914,2
STAT,1941,26,40-44,1967,4.5567199680066235
STAT,1853,44,na,1897,1690.897275656891
SIM,1890,36,35-39,1926,12
STAT,1855,103,na,1958,0.17737594277231472
SIM,1928,29,25-29,1957,84
SIM,1897,39,25-29,1936,1
STAT,1873,43,30-34,1916,1.094462759692188
STAT,1850,40,25-29,1890,0.45664169050821896
STAT,1881,87,na,1968,378.4572438011474
STAT,1815,47,30-34,1862,0.2355622825983212
STAT,1852,53,40-44,1905,0.00787019059504225
STAT,1892,41,15-19,1933,0.016411043754746505
STAT,1924,29,45-49,1953,1.886867534938495
SIM,1886,31,na,1917,2344
SIM,1943,17,na,1960,3634
STAT,1853,24,45-49,1877,0.602278895336366
SIM,1945,26,20-24,1971,19
STAT,1870,21,40-44,1891,1.9347418409988923
STAT,1908,51,na,1959,3098.0090708781768
STAT,1857,34,na,1891,1761.9912709517628
SIM,1919,18,20-24,1937,131
STAT,1850,24,20-24,1874,57.39653846126022
STAT,1806,52,30-34,1858,0.016807140849430587
STAT,1880,40,40-44,1920,2.2583364314855343
STAT,1884,17,30-34,1901,1.4879404344050684
SIM,1904,6,na,1910,3488
SIM,1795,85,na,1880,77
STAT,1863,43,45-49,1906,1.2338524045750812
SIM,1828,77,na,1905,438
STAT,1852,21,20-24,1873,62.648440992591894
STAT,1840,37,40-44,1877,3.605707829657052
SIM,1894,30,35-39,1924,14
SIM,1921,4,na,1925,4245
STAT,1833,27,25-29,1860,34.05603292391985
STAT,1884,33,35-39,1917,9.414122406211707
STAT,1909,39,20-24,1948,0.23328242488666198
STAT,1831,29,na,1860,1720.2675844406747
STAT,1854,17,15-19,1871,5.112048710800239
SIM,1879,39,50-100,1918,1
STAT,1784,73,na,1857,389.04418319560386
STAT,1828,45,45-49,1873,0.20410974891971598
SIM,1862,17,15-19,1879,6
STAT,1864,24,20-24,1888,58.27329618156664
SIM,1851,89,na,1940,60
STAT,1872,30,35-39,1902,9.679693657814843
SIM,1825,42,35-39,1867,1
STAT,1814,57,na,1871,1063.6046137922444
SIM,1951,12,na,1963,4352
SIM,1924,10,na,1934,4462
STAT,1864,36,15-19,1900,0.0476400970035741
STAT,1893,72,na,1965,1782.2751677496317
STAT,1845,100,na,1945,0.7478029621975846
SIM,1830,30,50-100,1860,3
SIM,1872,24,20-24,1896,60
SIM,1925,15,40-44,1940,1
SIM,1836,72,na,1908,778
STAT,1835,24,25-29,1859,46.79879987802344
STAT,1910,16,50-100,1926,0.07028250926505725
SIM,1876,32,40-44,1908,4
STAT,1862,27,20-24,1889,9.488497853238396
SIM,1859,69,na,1928,1209
STAT,1921,22,50-100,1943,0.7021524586596039
STAT,1857,46,25-29,1903,0.043019438719398055
SIM,1947,21,25-29,1968,85
STAT,1815,45,35-39,1860,0.3521440862167822
STAT,1950,19,45-49,1969,0.5576627483704448
SIM,1905,23,15-19,1928,3
STAT,1917,28,na,1945,3698.150766127319
SIM,1890,38,30-34,1928,12
SIM,1935,19,15-19,1954,49
STAT,1903,0,na,1903,3946.533315887191
SIM,1901,53,na,1954,2819
STAT,1941,30,50-100,1971,0.8209200040740983
STAT,1892,23,15-19,1915,3.890708263473344
STAT,1841,53,35-39,1894,0.005795671579414525
STAT,1776,78,na,1854,242.0
STAT,1929,16,15-19,1945,54.8528365378121
STAT,1901,23,35-39,1924,7.692336170916732
SIM,1955,16,35-39,1971,6
STAT,1810,67,na,1877,808.3090451065143
STAT,1909,6,na,1915,3700.0202126881773
SIM,1867,64,na,1931,1522
SIM,1887,17,20-24,1904,15
STAT,1903,20,35-39,1923,7.889874374657016
STAT,1939,21,25-29,1960,87.65362629592325
STAT,1817,42,35-39,1859,4.578409145880663
STAT,1889,39,25-29,1928,3.324131022453938
SIM,1841,27,25-29,1868,42
STAT,1831,48,25-29,1879,0.04180863399827414
STAT,1952,16,45-49,1968,0.5657058459766617
STAT,1877,22,35-39,1899,5.720620186149539
STAT,1839,45,20-24,1884,0.008363842898279997
SIM,1912,25,na,1937,3342
SIM,1840,42,30-34,1882,4
STAT,1849,37,30-34,1886,3.930881453250347
STAT,1869,46,45-49,1915,0.21641979969962225
STAT,1876,39,15-19,1915,0.05421385373986708
STAT,1882,38,30-34,1920,4.874914647505239
SIM,1851,32,35-39,1883,13
SIM,1916,15,na,1931,3807
STAT,1836,60,na,1896,1204.3630409743437
STAT,1842,54,50-100,1896,0.010459106492066765
STAT,1835,23,50-100,1858,0.33578323281925393
SIM,1938,30,na,1968,3527
STAT,1866,53,40-44,1919,0.009022241641751477
SIM,1882,41,na,1923,2111
SIM,1870,27,20-24,1897,9
STAT,1896,49,40-44,1945,0.11805462260894733
STAT,1849,19,30-34,1868,1.397529235486352
STAT,1947,16,35-39,1963,4.466887945058548
SIM,1922,37,35-39,1959,6
STAT,1870,16,na,1886,2374.130798559942
STAT,1828,27,15-19,1855,0.8031900029785685
STAT,1927,19,15-19,1946,53.02782479252858
STAT,1860,29,50-100,1889,0.4892897185391559
STAT,1897,33,45-49,1930,2.193874369259417
STAT,1849,109,na,1958,8.986839118467422E-4
STAT,1879,28,50-100,1907,0.6294293688635364
STAT,1862,80,na,1942,498.4882936469789
STAT,1939,27,50-100,1966,0.9451796207024247
STAT,1919,30,40-44,1949,4.020581599012714
STAT,1821,98,na,1919,1.7542079593522988
SIM,1869,21,40-44,1890,6
STAT,1882,36,35-39,1918,6.533076997642561
STAT,1920,18,20-24,1938,143.32589471244845
STAT,1832,42,30-34,1874,0.8528763979118259
STAT,1868,32,40-44,1900,3.91161868296722
STAT,1925,23,na,1948,4117.171077319416
STAT,1854,85,na,1939,197.402620500157
STAT,1871,4,na,1875,2760.8752516139125
SIM,1878,36,na,1914,2394
STAT,1845,49,na,1894,1551.6575896473244
STAT,1854,50,40-44,1904,0.007689840337686219
SIM,1848,38,na,1886,1785
SIM,1832,82,na,1914,275
STAT,1958,10,na,1968,4874.288993215699
SIM,1911,20,35-39,1931,11
STAT,1825,32,15-19,1857,0.25015542539817515
SIM,1920,20,na,1940,3778
STAT,1895,18,15-19,1913,7.296944715769582
SIM,1838,42,45-49,1880,3
STAT,1864,38,40-44,1902,3.677640718024522
STAT,1915,33,na,1948,3623.145593387415
STAT,1879,35,20-24,1914,0.7683897586892574
STAT,1906,9,na,1915,3569.200791954351
SIM,1882,25,20-24,1907,12
STAT,1881,38,40-44,1919,3.973107979483941
STAT,1867,32,20-24,1899,2.397614407983944
STAT,1843,16,30-34,1859,1.478207000036561
SIM,1911,18,20-24,1929,17
STAT,1837,85,na,1922,173.04947167188237
SIM,1898,56,na,1954,2583
STAT,1914,37,35-39,1951,2.2810097114445034
STAT,1848,38,25-29,1886,2.115465706405559
STAT,1820,45,45-49,1865,0.4007239708654255
SIM,1879,43,45-49,1922,2
STAT,1881,31,50-100,1912,0.8391632576362866
SIM,1929,23,30-34,1952,41
STAT,1870,49,20-24,1919,0.010876107040626845
STAT,1933,31,30-34,1964,20.069639110719912
STAT,1929,34,15-19,1963,0.15401188393056195
STAT,1878,21,40-44,1899,2.0555141605854526
SIM,1946,23,30-34,1969,37
STAT,1869,28,15-19,1897,0.41342191011419155
STAT,1809,48,15-19,1857,0.0014325961536508752
SIM,1925,33,40-44,1958,3
SIM,1856,38,25-29,1894,2
STAT,1859,27,45-49,1886,0.8515336864459936
STAT,1925,16,50-100,1941,0.4286552537419347
STAT,1823,35,15-19,1858,0.100367671954193
STAT,1843,32,35-39,1875,8.783486987623437
SIM,1897,15,na,1912,3254
SIM,1813,44,na,1857,1349
STAT,1820,57,na,1877,1151.6708137252524
STAT,1897,15,15-19,1912,7.53263852607616
STAT,1861,46,15-19,1907,3.146813091035577E-4
SIM,1867,27,45-49,1894,2
STAT,1919,23,na,1942,3765.942859562538
STAT,1876,25,25-29,1901,41.53457440944639
STAT,1935,28,50-100,1963,1.2810725684176163
STAT,1860,16,30-34,1876,1.4196903144721857
STAT,1910,47,45-49,1957,0.19150588096600946
STAT,1917,33,40-44,1950,3.8547298810240185
SIM,1868,40,35-39,1908,2
SIM,1884,25,25-29,1909,43
STAT,1854,35,15-19,1889,0.04105530042533823
SIM,1872,38,40-44,1910,4
SIM,1844,36,50-100,1880,1
SIM,1835,31,40-44,1866,3
SIM,1890,76,na,1966,1407
STAT,1866,38,45-49,1904,1.7276929885418966
SIM,1888,15,15-19,1903,4
SIM,1909,45,na,1954,3210
STAT,1841,21,45-49,1862,0.608763587367871
STAT,1872,11,na,1883,2507.018971373054
STAT,1918,31,35-39,1949,9.210985522456895
SIM,1877,43,40-44,1920,9
SIM,1844,36,na,1880,1807
SIM,1866,23,na,1889,2091
STAT,1905,18,25-29,1923,7.715696830244773
SIM,1946,24,15-19,1970,8
STAT,1890,26,15-19,1916,0.5258370525042683
STAT,1905,37,50-100,1942,0.3617627591323223
SIM,1884,36,na,1920,2331
STAT,1860,32,35-39,1892,7.775152894327388
STAT,1892,28,45-49,1920,1.3088726227119967
STAT,1906,56,na,1962,2935.1099974292024
SIM,1838,24,15-19,1862,1
STAT,1814,48,25-29,1862,0.15373980057238534
STAT,1851,54,35-39,1905,0.006139556744816869
SIM,1880,30,35-39,1910,13
STAT,1818,41,40-44,1859,5.612288168620242
STAT,1903,18,20-24,1921,23.76530356570298
STAT,1856,48,30-34,1904,0.07072180861748548
STAT,1857,111,na,1968,7.119190978206447E-4
SIM,1880,74,na,1954,1101
SIM,1904,39,40-44,1943,4
SIM,1937,16,15-19,1953,32
STAT,1824,50,25-29,1874,0.004170361675375577
STAT,1861,67,na,1928,1243.5663901472503
SIM,1841,59,na,1900,1350
SIM,1888,1,na,1889,3035
STAT,1874,43,20-24,1917,0.15223130322065664
SIM,1857,37,30-34,1894,4
STAT,1885,32,40-44,1917,4.081628058852143
STAT,1881,39,25-29,1920,2.599810404413105
STAT,1891,41,25-29,1932,0.7542760855877085
STAT,1823,93,na,1916,15.379515557925709
STAT,1807,52,20-24,1859,0.0026129285838585514
SIM,1801,59,na,1860,1010
SIM,1896,61,na,1957,2400
STAT,1850,42,20-24,1892,0.11166709248172359
SIM,1885,41,50-100,1926,2
SIM,1913,18,25-29,1931,8
STAT,1885,15,25-29,1900,5.358187643300258
STAT,1839,48,25-29,1887,0.03863268606477621
STAT,1921,33,na,1954,3959.6249724246572
STAT,1820,45,15-19,1865,6.791925992929687E-4
SIM,1866,40,30-34,1906,1
STAT,1869,43,40-44,1912,2.0419625744067904
STAT,1827,31,40-44,1858,5.275759521528305
SIM,1862,35,45-49,1897,1
SIM,1874,38,45-49,1912,5
STAT,1825,37,45-49,1862,2.5528009942955627
STAT,1899,28,30-34,1927,32.48607172405264
STAT,1891,43,20-24,1934,0.1843596825669021
STAT,1859,29,40-44,1888,2.2645394718051612
SIM,1843,24,25-29,1867,52
STAT,1864,28,50-100,1892,0.5381980201302043
SIM,1883,40,30-34,1923,2
SIM,1830,87,na,1917,83
STAT,1844,31,40-44,1875,3.678611571520996
STAT,1930,24,50-100,1954,0.7913731277764355
STAT,1850,95,na,1945,9.36008980400669
SIM,1829,90,na,1919,31
SIM,1823,31,45-49,1854,1
STAT,1776,114,na,1890,2.5699167817447397E-4
STAT,1843,14,na,1857,2181.022689844796
STAT,1805,109,na,1914,2.3821698408199433E-4
STAT,1879,47,15-19,1926,3.931311179973207E-4
SIM,1855,79,na,1934,509
STAT,1899,44,35-39,1943,0.16059586961411362
STAT,1841,15,50-100,1856,0.043745584259521485
STAT,1844,110,na,1954,1.939918739060129E-4
SIM,1932,29,45-49,1961,3
SIM,1789,85,na,1874,65
STAT,1833,42,20-24,1875,0.11710670483781645
SIM,1831,37,40-44,1868,9
SIM,1926,31,35-39,1957,20
STAT,1794,63,na,1857,814.5885530667441
STAT,1825,29,na,1854,1472.7802943064494
STAT,1910,61,na,1971,2982.0214639707256
STAT,1924,41,30-34,1965,0.1438787362649376
STAT,1899,69,na,1968,2204.3943069486395
STAT,1938,23,30-34,1961,26.860023105362966
SIM,1846,34,20-24,1880,6
STAT,1868,77,na,1945,779.6618639736388
SIM,1841,40,25-29,1881,3
STAT,1948,15,40-44,1963,1.5130869925125712
STAT,1855,49,25-29,1904,0.0399426820976083
STAT,1946,25,na,1971,3945.7077161068078
STAT,1856,46,35-39,1902,0.10387925616740268
STAT,1875,87,na,1962,304.58908318733677
STAT,1924,47,45-49,1971,0.2444582521174183
SIM,1933,27,na,1960,4704
STAT,1868,17,45-49,1885,0.0599861843521867
SIM,1851,16,30-34,1867,1
SIM,1902,28,20-24,1930,18
STAT,1824,52,20-24,1876,8.349428110742477E-4
STAT,1854,35,45-49,1889,1.457462991771514
SIM,1833,37,45-49,1870,2
SIM,1887,5,na,1892,2737
STAT,1937,26,20-24,1963,16.81491097830517
STAT,1880,37,50-100,1917,1.2203743709228614
STAT,1954,8,na,1962,4589.67345987415
STAT,1838,34,20-24,1872,2.2437670011291555
STAT,1894,22,40-44,1916,2.5322867237213327
STAT,1909,23,35-39,1932,8.239560800267324
SIM,1893,15,25-29,1908,8
STAT,1891,25,20-24,1916,13.810730035819944
SIM,1764,93,na,1857,2
STAT,1838,16,20-24,1854,16.066208930932344
SIM,1915,29,45-49,1944,1
STAT,1814,47,40-44,1861,0.46443501124088854
STAT,1880,22,40-44,1902,2.0713026990238315
SIM,1846,16,20-24,1862,10
STAT,1824,34,20-24,1858,4.855720940230534
SIM,1832,34,20-24,1866,1
STAT,1943,23,40-44,1966,3.3782114462834087
STAT,1872,49,25-29,1921,0.05347610246795204
SIM,1883,28,45-49,1911,4
STAT,1882,22,45-49,1904,0.6410129048486306
SIM,1822,80,na,1902,311
STAT,1821,36,50-100,1857,2.732782078495537
STAT,1907,41,30-34,1948,0.11127007919293143
SIM,1890,22,45-49,1912,3
STAT,1922,47,40-44,1969,0.17111949416477618
SIM,1898,38,30-34,1936,4
STAT,1875,28,45-49,1903,1.073798274926639
SIM,1867,29,40-44,1896,2
SIM,1917,23,35-39,1940,8
SIM,1918,10,na,1928,4055
STAT,1777,91,na,1868,16.379662168982232
STAT,1808,57,na,1865,1100.7358021141122
STAT,1861,46,45-49,1907,0.18566212863976567
STAT,1872,82,na,1954,442.4145362127117
STAT,1907,29,45-49,1936,1.5166248955210622
SIM,1877,30,35-39,1907,5
STAT,1831,48,50-100,1879,0.1782673712224693
SIM,1852,31,40-44,1883,3
STAT,1875,40,30-34,1915,1.1270555252930132
STAT,1885,49,na,1934,2073.291838160468
SIM,1936,18,20-24,1954,109
STAT,1897,30,40-44,1927,5.523115842677382
SIM,1836,52,50-100,1888,2
STAT,1865,53,20-24,1918,6.232921557850782E-4
SIM,1875,33,35-39,1908,11
SIM,1902,35,na,1937,3236
SIM,1928,26,20-24,1954,25
STAT,1833,24,20-24,1857,56.26742848387162
STAT,1895,4,na,1899,3243.1112907111174
SIM,1806,90,na,1896,19
SIM,1871,40,40-44,1911,3
STAT,1930,37,20-24,1967,0.3248437421931021
SIM,1899,33,20-24,1932,4
STAT,1833,40,25-29,1873,0.4858404260231747
STAT,1899,26,35-39,1925,12.534500736178764
SIM,1875,45,50-100,1920,1
STAT,1902,37,15-19,1939,0.01615838061023023
STAT,1866,42,na,1908,2010.5860764221138
SIM,1939,18,45-49,1957,1
STAT,1812,50,35-39,1862,0.028200111375261756
STAT,1937,29,25-29,1966,60.54415903531638
SIM,1846,62,na,1908,1270
SIM,1956,15,40-44,1971,1
STAT,1878,51,50-100,1929,0.014923902310177378
SIM,1938,31,25-29,1969,10
STAT,1873,44,15-19,1917,0.013063613599221984
SIM,1867,42,40-44,1909,3
STAT,1894,8,na,1902,3159.0212614133775
SIM,1842,42,35-39,1884,1
STAT,1810,53,35-39,1863,0.028639463382366344
STAT,1867,33,35-39,1900,8.944805383084462
STAT,1862,52,na,1914,1725.867135804235
SIM,1926,29,20-24,1955,18
STAT,1867,49,15-19,1916,3.4739194296150354E-4
STAT,1871,97,na,1968,24.889091014041004
STAT,1922,29,40-44,1951,4.947296555499185
STAT,1859,42,40-44,1901,1.6936964766019857
STAT,1910,29,15-19,1939,0.6392091630782515
STAT,1882,40,45-49,1922,1.3896687725757184
STAT,1848,85,na,1933,197.49289483426196
STAT,1909,26,45-49,1935,1.5779778912965754
STAT,1926,23,40-44,1949,3.8474657377301926
SIM,1930,29,40-44,1959,7
STAT,1923,28,na,1951,4049.172898126406
STAT,1895,33,40-44,1928,5.323741777783488
STAT,1804,98,na,1902,1.1008627811471376
STAT,1867,45,50-100,1912,0.22001916224311618
SIM,1841,24,20-24,1865,60
SIM,1861,21,40-44,1882,3
SIM,1831,23,20-24,1854,52
STAT,1943,26,45-49,1969,1.738874146334212
STAT,1926,39,20-24,1965,0.30373490267637293
STAT,1928,18,20-24,1946,160.97406487392314
SIM,1833,36,na,1869,1624
STAT,1873,46,35-39,1919,0.13462831865246955
SIM,1851,49,na,1900,1647
STAT,1880,46,na,1926,2242.6875614597016
SIM,1890,33,30-34,1923,31
SIM,1914,20,na,1934,3819
STAT,1863,40,40-44,1903,1.8866762815686569
SIM,1934,23,40-44,1957,4
STAT,1855,16,20-24,1871,15.022590489969966
SIM,1838,67,na,1905,994
STAT,1882,51,30-34,1933,0.005498062414921402
SIM,1810,95,na,1905,6
SIM,1890,40,45-49,1930,1
STAT,1935,16,45-49,1951,0.6466853605168417
SIM,1863,16,20-24,1879,18
SIM,1899,35,40-44,1934,7
SIM,1855,42,45-49,1897,1
STAT,1865,54,35-39,1919,0.007187171197419541
STAT,1919,15,45-49,1934,0.1051147404549635
STAT,1793,78,na,1871,304.11276391759486
STAT,1846,40,35-39,1886,1.3257501801039788
STAT,1854,57,na,1911,1447.1236802235899
STAT,1941,29,45-49,1970,1.6865133299632817
STAT,1899,43,20-24,1942,0.014174252619550657
STAT,1865,36,35-39,1901,6.100936384113638
STAT,1889,39,na,1928,2720.055735296613
SIM,1938,16,35-39,1954,7
STAT,1838,46,15-19,1884,2.842901864353267E-4
STAT,1841,19,na,1860,2001.770469306203
STAT,1928,36,20-24,1964,0.3150400722277179
SIM,1873,36,35-39,1909,9
SIM,1918,19,15-19,1937,39
SIM,1847,32,45-49,1879,2
STAT,1827,34,50-100,1861,0.979162739321432
SIM,1873,64,na,1937,1656
SIM,1823,42,30-34,1865,2
STAT,1851,9,na,1860,2172.1721409700936
STAT,1847,42,45-49,1889,1.107352629213399
STAT,1853,21,40-44,1874,1.8391233909498992
STAT,1931,23,na,1954,4460.62766139669
STAT,1824,53,35-39,1877,0.009549170017173678
STAT,1818,110,na,1928,1.3322909113995507E-4
STAT,1832,45,35-39,1877,0.1029623196982163
STAT,1843,54,na,1897,1510.6965582113373
STAT,1889,36,20-24,1925,0.9033465071265896
STAT,1882,33,30-34,1915,15.982116096707683
STAT,1933,19,45-49,1952,0.6283415421032292
SIM,1893,32,40-44,1925,6
STAT,1866,33,15-19,1899,0.1235120924940216
STAT,1868,35,45-49,1903,1.8151558014124685
SIM,1785,95,na,1880,2
STAT,1854,53,45-49,1907,0.010282514699468434
SIM,1896,21,na,1917,2988
STAT,1857,43,20-24,1900,0.11742172839990807
STAT,1894,54,na,1948,2544.688713218039
STAT,1865,35,20-24,1900,0.6680157872125151
SIM,1866,25,35-39,1891,14
SIM,1892,31,na,1923,2845
SIM,1937,17,na,1954,3263
SIM,1826,41,40-44,1867,4
SIM,1888,33,45-49,1921,2
STAT,1871,50,40-44,1921,0.010001287818558127
STAT,1828,45,15-19,1873,3.4594843580338996E-4
STAT,1850,17,50-100,1867,0.04214671417186105
STAT,1935,31,35-39,1966,11.949960139081627
STAT,1950,16,40-44,1966,1.5629404003166822
SIM,1906,20,25-29,1926,82
SIM,1839,23,20-24,1862,66
STAT,1807,50,25-29,1857,0.013054823201303724
SIM,1856,92,na,1948,19
SIM,1905,15,na,1920,3459
STAT,1852,24,25-29,1876,50.929105994934424
SIM,1834,77,na,1911,500
SIM,1868,18,na,1886,2303
SIM,1860,24,25-29,1884,50
SIM,1927,30,na,1957,4303
STAT,1942,24,35-39,1966,9.319689231487544
SIM,1929,26,50-100,1955,1
SIM,1815,79,na,1894,272
STAT,1914,51,na,1965,3397.5582613910383
STAT,1895,36,15-19,1931,0.06956052672115141
SIM,1876,35,45-49,1911,2
SIM,1830,49,50-100,1879,3
STAT,1844,18,40-44,1862,0.16225659068382922
STAT,1900,49,50-100,1949,0.17777657764174032
STAT,1952,7,na,1959,4449.992883785647
SIM,1834,32,35-39,1866,9
SIM,1897,36,20-24,1933,3
STAT,1857,45,40-44,1902,0.1287724663572093
SIM,1887,35,20-24,1922,1
STAT,1828,42,40-44,1870,1.9841567575090284
STAT,1830,75,na,1905,614.950690468942
STAT,1874,41,25-29,1915,0.6228283206960062
SIM,1885,4,na,1889,2507
STAT,1845,80,na,1925,435.727688122203
SIM,1858,32,20-24,1890,2
STAT,1871,47,15-19,1918,3.7287058156063973E-4
SIM,1906,36,40-44,1942,1
STAT,1790,73,na,1863,465.6817258365518
STAT,1835,59,na,1894,1212.5851422278142
STAT,1891,44,35-39,1935,2.088815850704951
STAT,1893,23,35-39,1916,6.9728868631687835
SIM,1809,70,na,1879,689
STAT,1897,46,20-24,1943,0.00857633900081115
STAT,1893,39,15-19,1932,0.06663033443764037
STAT,1830,38,50-100,1868,0.9612730876544526
SIM,1861,4,na,1865,2492
SIM,1910,30,na,1940,3404
STAT,1894,48,50-100,1942,0.1662398323258445
SIM,1840,18,na,1858,2000
STAT,1856,50,45-49,1906,0.010891952435459814
SIM,1836,42,40-44,1878,8
STAT,1834,42,35-39,1876,1.3512676647310797
STAT,1847,24,15-19,1871,2.933158677346305
STAT,1935,13,na,1948,5108.897440944844
STAT,1826,48,15-19,1874,3.6901981023791105E-4
STAT,1936,27,15-19,1963,0.6381307286723342
SIM,1858,34,40-44,1892,3
STAT,1936,22,50-100,1958,0.5941780939820929
SIM,1862,100,na,1962,1
STAT,1826,32,35-39,1858,13.400407455148255
STAT,1841,50,30-34,1891,0.004131210417268614
STAT,1887,72,na,1959,1453.5200870395652
SIM,1925,9,na,1934,4446
SIM,1927,30,40-44,1957,3
STAT,1886,40,50-100,1926,1.0651101286201206
STAT,1931,4,na,1935,4990.904018642088
SIM,1906,7,na,1913,3662
STAT,1849,53,35-39,1902,0.006105697664720969
STAT,1850,43,35-39,1893,1.2656081031170971
SIM,1814,57,na,1871,1092
STAT,1855,79,na,1934,495.1320603011403
STAT,1910,44,40-44,1954,0.2205063065718089
STAT,1905,15,20-24,1920,24.314647707365122
STAT,1830,46,15-19,1876,2.969803317371866E-4
STAT,1897,49,30-34,1946,0.06754621204037095
SIM,1908,33,40-44,1941,7
STAT,1860,26,na,1886,1865.301427937561
SIM,1845,20,40-44,1865,6
STAT,1774,106,na,1880,0.0119264852570675
STAT,1841,19,30-34,1860,1.3899546875411541
SIM,1862,9,na,1871,2421
STAT,1891,26,35-39,1917,11.321275681515345
STAT,1833,95,na,1928,8.071588934699419
STAT,1842,52,40-44,1894,0.00745696200520731
STAT,1816,44,40-44,1860,6.184035902340138
SIM,1885,38,20-24,1923,3
SIM,1889,35,50-100,1924,1
STAT,1877,82,na,1959,584.9514075937673
STAT,1878,67,na,1945,1558.986479210044
STAT,1901,41,35-39,1942,0.16702546666553741
STAT,1854,32,40-44,1886,3.1979813191856263
SIM,1839,21,na,1860,1889
SIM,1880,46,na,1926,2332
STAT,1920,48,15-19,1968,3.8362991491899313E-4
SIM,1832,35,35-39,1867,12
SIM,1862,0,na,1862,3182
SIM,1762,98,na,1860,1
STAT,1849,21,15-19,1870,2.8957515982741846
STAT,1824,35,35-39,1859,11.66549312578756
STAT,1900,21,25-29,1921,75.25200759358759
STAT,1855,70,na,1925,993.7087737347691
STAT,1887,26,15-19,1913,0.4809801078819829
STAT,1853,51,35-39,1904,0.006415093351194025
SIM,1857,74,na,1931,848
STAT,1906,46,40-44,1952,0.13322119020073542
SIM,1913,15,20-24,1928,20
STAT,1887,41,35-39,1928,1.9217748708504905
STAT,1865,22,45-49,1887,0.6058887385814657
STAT,1845,35,50-100,1880,1.0194547944332986
STAT,1883,35,40-44,1918,4.09147758262231
STAT,1916,43,50-100,1959,0.11354873038285533
STAT,1880,25,15-19,1905,0.4540392028839846
STAT,1855,46,20-24,1901,0.008522971615811123
SIM,1843,82,na,1925,308
SIM,1857,21,15-19,1878,3
STAT,1851,80,na,1931,453.6268275085377
STAT,1916,34,35-39,1950,8.836308159230999
SIM,1883,25,40-44,1908,7
STAT,1851,22,15-19,1873,2.8890307411162945
SIM,1840,77,na,1917,513
SIM,1899,47,50-100,1946,2
STAT,1880,25,45-49,1905,1.1111270056712914
SIM,1919,39,25-29,1958,4
STAT,1860,19,35-39,1879,0.4801604651990657
STAT,1848,35,20-24,1883,0.5842955981122369
STAT,1938,26,35-39,1964,14.056057133907721
STAT,1796,98,na,1894,0.756820671216136
SIM,1824,44,40-44,1868,9
SIM,1900,30,30-34,1930,24
STAT,1852,38,15-19,1890,0.04245306637673951
STAT,1820,42,40-44,1862,4.057556284921883
STAT,1929,13,na,1942,4769.8884867576235
STAT,1815,42,30-34,1857,3.2443494524932714
SIM,1849,45,50-100,1894,5
SIM,1952,19,20-24,1971,162
STAT,1917,36,45-49,1953,0.6721083546629854
STAT,1849,70,na,1919,1011.3230191878498
STAT,1864,16,na,1880,2216.2260682528245
STAT,1799,63,na,1862,879.4890046948325
STAT,1817,41,20-24,1858,0.41801430482641827
SIM,1831,40,50-100,1871,1
SIM,1779,95,na,1874,2
STAT,1851,40,15-19,1891,0.010229159870503405
SIM,1884,22,20-24,1906,63
SIM,1909,17,20-24,1926,23
SIM,1926,45,na,1971,4163
SIM,1898,34,50-100,1932,1
SIM,1925,36,45-49,1961,2
STAT,1833,45,25-29,1878,0.04212095908821366
STAT,1877,38,20-24,1915,0.7519280974999656
STAT,1884,15,35-39,1899,0.5146217296694628
SIM,1924,34,35-39,1958,11
STAT,1839,32,45-49,1871,1.4308758822116132
STAT,1944,19,20-24,1963,137.73520203121834
STAT,1859,25,25-29,1884,32.91350950634004
STAT,1918,47,15-19,1965,3.7031452286187045E-4
STAT,1921,16,15-19,1937,48.99413054888433
STAT,1930,8,na,1938,4871.46664939977
STAT,1841,37,30-34,1878,4.296237611865117
SIM,1863,74,na,1937,883
STAT,1883,82,na,1965,692.8743907136095
SIM,1934,12,na,1946,5016
STAT,1842,60,na,1902,1358.126647725212
STAT,1885,19,40-44,1904,0.17122140722879844
SIM,1908,51,na,1959,3024
SIM,1843,21,20-24,1864,56
STAT,1834,107,na,1941,0.0029189696912244566
STAT,1842,34,40-44,1876,3.653981501953927
STAT,1814,45,20-24,1859,0.033630384318232606
STAT,1836,19,20-24,1855,21.072130957351458
STAT,1847,44,na,1891,1677.6294084149488
SIM,1917,26,45-49,1943,1
STAT,1940,27,35-39,1967,14.46154656391282
SIM,1826,28,40-44,1854,3
STAT,1895,39,na,1934,2875.216173554636
STAT,1858,16,na,1874,2000.3742031007025
STAT,1881,36,20-24,1917,0.7065093500087773
SIM,1827,36,na,1863,1558
STAT,1787,78,na,1865,294.90464088321653
STAT,1913,25,20-24,1938,17.295045402890683
SIM,1891,35,40-44,1926,8
STAT,1823,40,50-100,1863,1.4495731656692192
SIM,1868,22,35-39,1890,4
STAT,1904,47,20-24,1951,0.009128042385097977
STAT,1918,29,20-24,1947,18.22022540781326
SIM,1854,40,35-39,1894,7
STAT,1875,43,35-39,1918,1.7447681005191575
SIM,1883,43,35-39,1926,4
STAT,1867,0,na,1867,3353.063420795485
STAT,1924,44,40-44,1968,0.2801518907487537
SIM,1844,19,20-24,1863,14
STAT,1874,46,25-29,1920,0.055772515950125195
SIM,1850,34,40-44,1884,2
SIM,1935,23,50-100,1958,4
STAT,1861,43,40-44,1904,1.7517580124059338
STAT,1837,20,40-44,1857,1.7592985555539415
SIM,1819,69,na,1888,743
SIM,1862,32,40-44,1894,3
STAT,1875,25,40-44,1900,2.9270328011296285
STAT,1830,107,na,1937,0.0028170819381932322
STAT,1818,47,na,1865,1351.5489120662749
SIM,1867,25,25-29,1892,47
STAT,1827,34,45-49,1861,1.8635678056961522
SIM,1803,54,na,1857,1058
SIM,1797,80,na,1877,233
STAT,1835,21,20-24,1856,57.56770701952005
STAT,1945,20,40-44,1965,3.4836820655070255
STAT,1913,38,na,1951,3489.2293310368977
SIM,1895,76,na,1971,1607
STAT,1879,50,40-44,1929,0.010544724244713062
STAT,1894,25,45-49,1919,1.358416694071654
SIM,1864,43,30-34,1907,3
SIM,1919,20,35-39,1939,12
STAT,1808,52,35-39,1860,0.031311839276212644
SIM,1821,34,45-49,1855,1
STAT,1863,29,30-34,1892,20.761933972325174
STAT,1917,18,45-49,1935,0.10128142210752215
STAT,1849,50,30-34,1899,0.004352199991245191
STAT,1835,19,na,1854,1891.9024033123876
STAT,1843,31,20-24,1874,2.3689091196473755
SIM,1879,40,40-44,1919,7
STAT,1872,33,45-49,1905,1.646518469131497
STAT,1884,36,na,1920,2209.984089502444
STAT,1880,43,45-49,1923,1.4769114678280526
SIM,1932,26,40-44,1958,8
SIM,1882,28,25-29,1910,53
SIM,1784,101,na,1885,1
STAT,1821,106,na,1927,0.006556496528373529
SIM,1892,71,na,1963,1775
STAT,1874,28,25-29,1902,40.699587058160624
STAT,1902,66,na,1968,2472.0428161568884
STAT,1932,36,40-44,1968,1.901885377197808
SIM,1813,42,45-49,1855,3
SIM,1948,20,30-34,1968,27
STAT,1869,46,15-19,1915,3.668129110893988E-4
SIM,1803,85,na,1888,61
SIM,1880,33,45-49,1913,2
STAT,1813,52,45-49,1865,0.04189785109308598
SIM,1845,21,na,1866,1874
SIM,1851,31,20-24,1882,1
SIM,1879,89,na,1968,272
SIM,1940,12,na,1952,3620
STAT,1924,26,40-44,1950,5.144952880041292
SIM,1835,34,45-49,1869,2
STAT,1850,25,35-39,1875,8.109887801462504
SIM,1913,29,40-44,1942,4
SIM,1904,28,25-29,1932,66
STAT,1816,40,25-29,1856,2.0785883271234082
STAT,1873,32,45-49,1905,1.672165621550525
SIM,1845,39,30-34,1884,3
SIM,1849,27,30-34,1876,31
SIM,1807,75,na,1882,364
STAT,1923,15,35-39,1938,4.676804404283513
STAT,1857,16,25-29,1873,4.989696846952329
SIM,1863,30,35-39,1893,4
STAT,1827,55,na,1882,1222.6663122701827
SIM,1953,17,15-19,1970,44
STAT,1888,37,15-19,1925,0.06266906120338896
STAT,1860,44,35-39,1904,1.3715037647394588
SIM,1886,33,40-44,1919,4
SIM,1790,70,na,1860,541
SIM,1819,42,40-44,1861,7
STAT,1773,107,na,1880,0.005557778151579422
SIM,1925,35,na,1960,4188
STAT,1831,60,na,1891,1163.1222225656447
STAT,1856,44,15-19,1900,0.010079888667766946
STAT,1884,49,15-19,1933,3.656189412634903E-4
STAT,1840,35,20-24,1875,0.6482649451040154
SIM,1842,24,40-44,1866,5
STAT,1885,49,50-100,1934,0.2263273385403721
STAT,1945,15,na,1960,3800.4038072969765
SIM,1926,45,50-100,1971,1
STAT,1900,28,45-49,1928,1.4500295096440385
STAT,1878,33,40-44,1911,4.246956681338618
SIM,1880,16,20-24,1896,22
SIM,1921,25,20-24,1946,21
SIM,1794,60,na,1854,940
STAT,1831,100,na,1931,0.647460202454626
STAT,1911,46,20-24,1957,0.009905845729095529
STAT,1868,19,50-100,1887,0.0444612211104181
STAT,1858,42,20-24,1900,0.11763544063809121
STAT,1956,9,na,1965,4911.668360548843
SIM,1864,84,na,1948,240
STAT,1823,38,25-29,1861,4.328678789860286
SIM,1836,41,na,1877,1569
STAT,1922,43,na,1965,4021.0019183122813
STAT,1947,15,20-24,1962,144.3591144723473
SIM,1873,36,na,1909,2273
SIM,1831,38,25-29,1869,1
STAT,1836,33,50-100,1869,0.7238000047016732
SIM,1873,38,25-29,1911,4
STAT,1919,27,15-19,1946,0.7205895391985129
STAT,1910,1,na,1911,3895.154201589645
SIM,1815,70,na,1885,629
SIM,1931,15,35-39,1946,6
SIM,1881,32,45-49,1913,1
STAT,1837,50,40-44,1887,0.006939470098044675
STAT,1805,100,na,1905,0.35546898389509024
SIM,1923,32,25-29,1955,9
STAT,1825,52,35-39,1877,0.008701679513926386
STAT,1870,22,50-100,1892,0.3774791405858332
SIM,1871,54,50-100,1925,2
STAT,1945,17,15-19,1962,46.8336850221538
STAT,1883,31,25-29,1914,9.522045207659598
SIM,1865,16,25-29,1881,6
SIM,1892,32,20-24,1924,4
SIM,1858,39,40-44,1897,4
SIM,1840,27,40-44,1867,3
SIM,1899,41,na,1940,3007
SIM,1909,29,20-24,1938,16
SIM,1918,40,40-44,1958,2
STAT,1812,48,20-24,1860,0.03884833311105698
STAT,1874,45,40-44,1919,0.16694695811096127
STAT,1881,24,20-24,1905,62.464613561748294
STAT,1943,17,50-100,1960,0.37530637966036984
SIM,1955,15,20-24,1970,140
STAT,1876,32,na,1908,2327.262734720853
STAT,1933,5,na,1938,5084.748642262452
STAT,1950,3,na,1953,4430.764666965005
STAT,1909,23,40-44,1932,2.9422891372563953
STAT,1893,0,na,1893,3519.5399548377413
STAT,1884,18,45-49,1902,0.060821382325654816
STAT,1931,23,15-19,1954,6.502206485758768
SIM,1824,56,na,1880,1148
SIM,1826,44,45-49,1870,3
SIM,1814,41,45-49,1855,1
SIM,1877,28,20-24,1905,12
SIM,1888,19,30-34,1907,5
STAT,1931,37,40-44,1968,1.872958309521412
SIM,1903,1,na,1904,3560
STAT,1884,32,20-24,1916,2.5234127018953987
STAT,1915,32,25-29,1947,8.891813518943932
STAT,1924,44,35-39,1968,0.22554054744076396
STAT,1834,24,40-44,1858,1.7003895937642715
STAT,1856,43,30-34,1899,0.8444878352319957
SIM,1891,31,25-29,1922,16
SIM,1885,21,na,1906,2229
SIM,1875,17,30-34,1892,4
SIM,1881,68,na,1949,1290
STAT,1802,60,na,1862,953.3319658106466
STAT,1847,42,15-19,1889,0.010217787376777877
SIM,1847,18,30-34,1865,1
SIM,1873,33,na,1906,2285
STAT,1923,27,35-39,1950,16.285315356783062
STAT,1844,39,na,1883,1711.814478150206
STAT,1886,31,na,1917,2391.568377698316
SIM,1926,2,na,1928,4597
STAT,1878,51,40-44,1929,0.010402980771043534
STAT,1892,43,35-39,1935,2.126730181147623
SIM,1949,16,40-44,1965,1
STAT,1896,47,20-24,1943,0.008411913575806696
STAT,1911,28,20-24,1939,16.754018572168853
SIM,1898,36,40-44,1934,11
STAT,1870,25,50-100,1895,0.5961610257308726
SIM,1931,27,35-39,1958,19
STAT,1807,54,40-44,1861,0.035813571658987
SIM,1884,23,35-39,1907,8
STAT,1867,9,na,1876,2427.7024437814316
SIM,1917,23,40-44,1940,5
SIM,1858,37,45-49,1895,1
STAT,1860,50,35-39,1910,0.006704672474851682
SIM,1833,92,na,1925,18
STAT,1872,16,20-24,1888,16.96545604313853
STAT,1891,41,30-34,1932,1.3503975025431725
STAT,1824,50,30-34,1874,0.007008524549775549
STAT,1931,37,50-100,1968,0.525302006553956
STAT,1783,88,na,1871,36.93366281511179
STAT,1827,52,na,1879,1297.4619268308686
STAT,1832,27,40-44,1859,2.459416079888309
STAT,1851,42,35-39,1893,1.3262646471068287
STAT,1889,23,45-49,1912,0.8107536348273714
SIM,1819,60,na,1879,1040
SIM,1820,34,50-100,1854,2
STAT,1878,18,15-19,1896,5.821057708568764
STAT,1914,22,30-34,1936,27.734664770102977
SIM,1950,21,30-34,1971,37
STAT,1839,18,30-34,1857,1.3820398997772216
SIM,1949,22,40-44,1971,5
STAT,1840,17,20-24,1857,15.985285041620534
STAT,1837,39,30-34,1876,4.012054729699892
SIM,1900,33,35-39,1933,18
STAT,1798,103,na,1901,0.03980559198346568
STAT,1882,34,15-19,1916,0.12978747993581372
STAT,1855,30,35-39,1885,7.456192234844347
STAT,1897,49,25-29,1946,0.040192786942435235
STAT,1922,18,25-29,1940,47.257891664931705
STAT,1850,43,50-100,1893,0.7383719319596881
STAT,1847,36,15-19,1883,0.04331661188193336
STAT,1905,15,15-19,1920,8.139225302395957
SIM,1929,25,20-24,1954,22
STAT,1884,50,20-24,1934,6.987765096458036E-4
STAT,1848,51,25-29,1899,0.002563958591080177
SIM,1951,9,na,1960,4352
STAT,1876,44,50-100,1920,1.0164031500877238
SIM,1805,89,na,1894,25
SIM,1897,23,45-49,1920,4
SIM,1896,39,40-44,1935,1
STAT,1903,36,15-19,1939,0.016368716890276334
SIM,1930,18,25-29,1948,62
STAT,1890,29,25-29,1919,48.510077380014174
STAT,1815,43,15-19,1858,0.03710092735949839
STAT,1843,17,45-49,1860,0.06022541237876501
SIM,1855,24,15-19,1879,3
STAT,1820,104,na,1924,0.03553340775091883
SIM,1918,50,na,1968,3643
STAT,1763,104,na,1867,0.011174268489925051
SIM,1967,0,na,1967,4517
STAT,1918,13,na,1931,4067.7686579761626
SIM,1878,27,20-24,1905,13
STAT,1840,23,20-24,1863,60.59310105537596
SIM,1913,15,15-19,1928,10
STAT,1839,40,na,1879,1665.7646638372514
STAT,1838,52,45-49,1890,0.009845338037033502
STAT,1894,24,50-100,1918,0.49245290641869627
SIM,1886,21,40-44,1907,4
STAT,1942,21,30-34,1963,28.476272610198198
STAT,1859,45,45-49,1904,0.1797000404660408
STAT,1861,16,45-49,1877,0.059248000101749264
STAT,1887,27,20-24,1914,12.394237503516786
STAT,1936,33,45-49,1969,1.442750036857903
STAT,1941,22,25-29,1963,90.16991419631468
SIM,1831,97,na,1928,2
SIM,1872,39,25-29,1911,1
STAT,1899,38,na,1937,3058.8993815619256
STAT,1842,49,45-49,1891,0.16454963541332537
SIM,1854,69,na,1923,1060
SIM,1900,1,na,1901,3488
STAT,1815,67,na,1882,791.5071229079001
STAT,1916,31,30-34,1947,15.428719099310811
SIM,1932,17,na,1949,4465
STAT,1873,48,30-34,1921,0.09165601042512607
SIM,1935,21,35-39,1956,14
STAT,1838,39,na,1877,1726.4064850471648
STAT,1910,4,na,1914,3764.671958716423
SIM,1875,68,na,1943,1413
STAT,1906,45,35-39,1951,0.10971716551984484
STAT,1872,30,40-44,1902,4.145138103414237
SIM,1890,16,15-19,1906,6
SIM,1897,71,na,1968,1998
STAT,1859,69,na,1928,1106.416979826948
STAT,1871,17,20-24,1888,16.710771782600453
SIM,1879,21,na,1900,2350
SIM,1918,22,40-44,1940,3
STAT,1915,20,25-29,1935,87.06477545462967
STAT,1945,21,50-100,1966,0.6814927971278449
STAT,1846,44,20-24,1890,0.11046324635625825
STAT,1841,32,30-34,1873,14.49381093615213
STAT,1833,47,45-49,1880,0.16821180070588082
SIM,1923,39,45-49,1962,1
STAT,1853,49,20-24,1902,0.008713483853717808
STAT,1888,43,45-49,1931,1.658200011491073
SIM,1889,29,25-29,1918,57
SIM,1890,36,na,1926,2832
STAT,1828,77,na,1905,490.69510916047795
STAT,1898,42,25-29,1940,0.056956139365101396
SIM,1905,37,35-39,1942,9
SIM,1839,26,25-29,1865,51
STAT,1869,87,na,1956,178.68067402325332
SIM,1895,27,20-24,1922,19
STAT,1836,36,50-100,1872,0.9615754781738628
STAT,1789,73,na,1862,437.7837238422688
STAT,1927,21,35-39,1948,10.993616574552922
SIM,1858,20,20-24,1878,56
SIM,1866,54,na,1920,1814
STAT,1931,19,40-44,1950,1.720289179615693
STAT,1832,31,45-49,1863,1.3956704997479852
STAT,1861,18,40-44,1879,0.163945959342223
STAT,1832,31,15-19,1863,0.11397617843766808
SIM,1822,52,na,1874,1293
STAT,1832,43,15-19,1875,0.010112880443145192
STAT,1925,42,50-100,1967,0.13438220820242502
SIM,1860,22,35-39,1882,6
SIM,1887,53,na,1940,2196
STAT,1856,15,50-100,1871,0.04337124365342713
STAT,1877,41,50-100,1918,1.040343827526078
STAT,1896,29,20-24,1925,14.542409274945467
STAT,1873,50,45-49,1923,0.01411605451684752
STAT,1909,61,na,1970,2937.0294884486902
STAT,1850,40,30-34,1890,0.8175359264358996
SIM,1871,25,45-49,1896,1
STAT,1829,44,20-24,1873,0.1295847572194103
STAT,1837,54,na,1891,1321.8264922971014
STAT,1866,50,30-34,1916,0.005259110295954625
STAT,1879,53,45-49,1932,0.014099939307807192
SIM,1889,17,25-29,1906,8
SIM,1866,2,na,1868,2811
STAT,1843,85,na,1928,197.7757614481056
STAT,1811,49,15-19,1860,0.0012867806181882833
STAT,1784,100,na,1884,0.1785412597943422
SIM,1923,20,25-29,1943,110
STAT,1829,38,20-24,1867,0.6755959073804425
STAT,1868,46,na,1914,2035.0662804586357
SIM,1905,25,35-39,1930,19
STAT,1796,58,na,1854,1072.0000000000002
STAT,1861,23,50-100,1884,0.32628814422289654
STAT,1863,25,45-49,1888,0.9353948424922789
SIM,1857,35,40-44,1892,7
STAT,1896,35,20-24,1931,0.9715699756433807
SIM,1837,38,20-24,1875,4
SIM,1902,66,na,1968,2489
STAT,1910,47,15-19,1957,3.2458596572670434E-4
STAT,1906,49,45-49,1955,0.1793025710137151
STAT,1951,15,na,1966,4143.086088718941
SIM,1853,44,na,1897,1837
SIM,1863,34,20-24,1897,1
SIM,1845,35,45-49,1880,1
SIM,1775,96,na,1871,2
STAT,1852,22,35-39,1874,5.266952580459301
SIM,1854,26,20-24,1880,13
SIM,1840,31,45-49,1871,1
SIM,1867,22,20-24,1889,55
STAT,1891,49,na,1940,2576.304727789335
STAT,1832,25,15-19,1857,0.38370108568292344
STAT,1900,43,40-44,1943,0.20322789628928253
STAT,1916,19,45-49,1935,0.09958313488484317
STAT,1849,35,40-44,1884,3.2964216984027357
STAT,1821,67,na,1888,853.8279462002102
SIM,1796,95,na,1891,5
SIM,1940,20,25-29,1960,98
SIM,1837,26,20-24,1863,10
STAT,1837,30,50-100,1867,0.7404132721886698
SIM,1901,25,na,1926,3235
STAT,1835,106,na,1941,0.007575561786584754
SIM,1848,28,25-29,1876,39
SIM,1880,30,40-44,1910,10
STAT,1885,25,50-100,1910,0.6061498813338797
STAT,1859,22,20-24,1881,53.90488773381705
STAT,1809,109,na,1918,2.9887178088790163E-4
STAT,1892,40,30-34,1932,1.37378887243332
SIM,1849,25,35-39,1874,9
SIM,1909,31,35-39,1940,11
STAT,1888,25,15-19,1913,0.5097717959674449
STAT,1896,17,20-24,1913,22.134642486491337
STAT,1905,47,40-44,1952,0.1312198831741947
STAT,1898,17,25-29,1915,7.24676496485628
SIM,1891,9,na,1900,3194
STAT,1801,54,50-100,1855,0.05235115322035736
SIM,1937,33,30-34,1970,17
STAT,1841,33,15-19,1874,0.11699550602017875
STAT,1897,44,30-34,1941,0.09950368048819977
STAT,1841,44,50-100,1885,0.7320945681918484
SIM,1837,26,na,1863,1795
STAT,1842,30,25-29,1872,8.99609609411777
SIM,1848,69,na,1917,1050
STAT,1837,35,45-49,1872,1.5643206021636324
STAT,1864,39,25-29,1903,2.4064708665822154
STAT,1932,39,45-49,1971,0.8634760972956875
STAT,1855,34,20-24,1889,1.9091962041293684
STAT,1905,29,40-44,1934,4.060182516649391
STAT,1808,88,na,1896,53.36011247426234
STAT,1846,26,20-24,1872,10.078864531470638
SIM,1924,31,30-34,1955,22
STAT,1852,22,na,1874,1929.818538855301
SIM,1948,23,35-39,1971,11
SIM,1842,41,na,1883,1633
STAT,1817,93,na,1910,12.960387006700136
STAT,1929,33,30-34,1962,18.89509699117259
STAT,1907,17,45-49,1924,0.09063282274023465
SIM,1838,36,na,1874,1637
STAT,1945,24,50-100,1969,0.6808047210161726
STAT,1915,39,45-49,1954,0.6439784444164306
SIM,1863,28,20-24,1891,18
SIM,1885,40,35-39,1925,1
STAT,1857,43,15-19,1900,0.01021058562973545
SIM,1850,30,25-29,1880,18
SIM,1943,28,50-100,1971,1
SIM,1813,75,na,1888,391
STAT,1823,41,45-49,1864,1.9952464546958706
STAT,1885,22,50-100,1907,0.3838039160503759
SIM,1848,16,25-29,1864,8
STAT,1876,22,20-24,1898,67.20728168375075
STAT,1873,28,40-44,1901,2.8623600707119516
STAT,1795,73,na,1868,481.1978240505768
STAT,1936,15,45-49,1951,0.45382604301494095
SIM,1829,62,na,1891,988
SIM,1949,20,15-19,1969,5
STAT,1877,40,35-39,1917,1.7930836138690345
SIM,1782,75,na,1857,347
SIM,1849,43,35-39,1892,3
SIM,1881,28,40-44,1909,7
STAT,1821,33,50-100,1854,2.879244437457031
STAT,1888,43,15-19,1931,0.01530057788152079
STAT,1806,93,na,1899,9.724706365110357
STAT,1874,46,na,1920,2178.4597494500363
STAT,1898,48,30-34,1946,0.06895072868528118
SIM,1830,28,30-34,1858,23
STAT,1873,21,na,1894,2274.711685090633
SIM,1897,46,na,1943,2879
STAT,1928,8,na,1936,4748.037795636637
STAT,1932,20,25-29,1952,115.17936706530585
SIM,1861,48,na,1909,1905
SIM,1865,69,na,1934,1229
SIM,1880,19,25-29,1899,6
SIM,1869,28,na,1897,2152
SIM,1825,29,35-39,1854,9
STAT,1905,46,na,1951,3080.6752280096334
STAT,1840,38,25-29,1878,2.3470692992778637
STAT,1904,21,na,1925,3213.896340241599
SIM,1891,21,na,1912,2951
SIM,1874,18,25-29,1892,5
STAT,1834,27,45-49,1861,0.9012000029321843
STAT,1827,28,15-19,1855,0.8181640491883448
STAT,1844,95,na,1939,9.333589978259193
STAT,1883,33,15-19,1916,0.1312941722100594
STAT,1819,37,20-24,1856,2.0040283494160676
STAT,1890,33,50-100,1923,1.0538223882047124
SIM,1906,25,na,1931,3345
STAT,1876,29,40-44,1905,2.900559787123026
STAT,1874,48,45-49,1922,0.2250023042414558
STAT,1817,46,50-100,1863,0.5582679178104358
SIM,1864,39,50-100,1903,1
STAT,1890,26,20-24,1916,13.596643677163698
STAT,1878,36,45-49,1914,1.9699355251348416
STAT,1869,31,40-44,1900,3.981859297999252
SIM,1901,22,na,1923,3218
STAT,1912,23,50-100,1935,0.5937409723956861
SIM,1842,27,45-49,1869,1
STAT,1934,18,50-100,1952,0.4774674579637461
STAT,1837,17,15-19,1854,6.521148585692866
STAT,1863,25,15-19,1888,0.3822298679622111
SIM,1944,15,15-19,1959,39
STAT,1775,96,na,1871,1.3618157631070846
STAT,1762,111,na,1873,2.3093568281554107E-4
SIM,1885,22,35-39,1907,7
SIM,1899,34,35-39,1933,25
STAT,1936,15,15-19,1951,41.23010435106065
STAT,1868,47,45-49,1915,0.21187418496574664
STAT,1855,28,20-24,1883,8.598195676427878
STAT,1834,54,35-39,1888,0.005251843498745718
STAT,1897,34,na,1931,2989.0896635876597
SIM,1908,18,15-19,1926,7
STAT,1829,26,20-24,1855,21.500788639777237
SIM,1871,29,30-34,1900,22
SIM,1817,38,40-44,1855,5
STAT,1940,15,35-39,1955,4.0266028670645975
SIM,1855,70,na,1925,1038
SIM,1877,31,40-44,1908,7
STAT,1856,80,na,1936,457.6956771861172
STAT,1823,37,40-44,1860,6.997158586865751
STAT,1850,22,30-34,1872,15.05103235483103
STAT,1866,18,25-29,1884,5.03621335537482
SIM,1939,17,30-34,1956,14
STAT,1838,40,50-100,1878,0.8645260246072138
SIM,1851,18,na,1869,2067
STAT,1816,42,15-19,1858,0.04129515139481183
STAT,1844,16,45-49,1860,0.05863748359468808
STAT,1890,28,40-44,1918,3.4477781775909
STAT,1832,47,30-34,1879,0.06938797477597108
SIM,1787,81,na,1868,164
STAT,1894,19,15-19,1913,7.173111019919429
STAT,1820,107,na,1927,0.002512350899211281
SIM,1919,35,na,1954,3854
STAT,1845,40,na,1885,1700.8445115274574
STAT,1940,31,na,1971,3699.5580621646504
SIM,1843,28,40-44,1871,3
STAT,1823,35,20-24,1858,1.3777742325709172
STAT,1804,67,na,1871,772.1773410215809
STAT,1862,21,na,1883,1965.1023813647
STAT,1876,72,na,1948,1231.6450735977671
STAT,1904,16,15-19,1920,8.060013581292091
STAT,1913,28,25-29,1941,61.72442596255818
STAT,1842,36,30-34,1878,4.498596139057393
STAT,1900,25,40-44,1925,3.9525896403809884
SIM,1833,67,na,1900,1007
STAT,1837,53,45-49,1890,0.009014282619657376
SIM,1825,46,50-100,1871,1
STAT,1845,27,20-24,1872,10.058051012404684
STAT,1854,39,30-34,1893,3.799172459996311
STAT,1883,47,40-44,1930,0.15776947482111936
STAT,1921,22,45-49,1943,1.200680658558552
SIM,1912,16,15-19,1928,9
SIM,1921,28,25-29,1949,70
SIM,1888,44,30-34,1932,3
SIM,1908,21,40-44,1929,3
SIM,1823,74,na,1897,597
STAT,1838,34,15-19,1872,0.11821039407710458
STAT,1946,16,15-19,1962,47.56708683797504
STAT,1873,32,15-19,1905,0.13655590434389125
STAT,1835,22,35-39,1857,4.839807315770872
SIM,1844,21,35-39,1865,5
SIM,1882,72,na,1954,1132
SIM,1949,19,45-49,1968,3
SIM,1842,44,na,1886,1564
STAT,1938,25,20-24,1963,17.096948833032428
SIM,1830,56,na,1886,1315
SIM,1864,28,na,1892,2129
STAT,1911,15,45-49,1926,0.09485179275625917
SIM,1850,36,30-34,1886,5
SIM,1945,12,na,1957,3925
STAT,1895,21,40-44,1916,2.5766748833626303
SIM,1922,23,15-19,1945,6
STAT,1800,110,na,1910,1.1015043511985224E-4
SIM,1898,39,45-49,1937,3
STAT,1867,15,35-39,1882,0.503472241117278
STAT,1939,12,na,1951,3738.2314717379936
STAT,1878,54,45-49,1932,0.013879792210507278
SIM,1845,17,15-19,1862,6
SIM,1846,40,50-100,1886,1
SIM,1889,9,na,1898,3062
SIM,1874,35,50-100,1909,2
SIM,1843,22,35-39,1865,4
STAT,1828,49,30-34,1877,0.07940853692056611
STAT,1842,32,15-19,1874,0.12250615054807307
STAT,1925,43,40-44,1968,0.28565908475213997
STAT,1866,35,50-100,1901,1.0795062356566931
SIM,1899,21,20-24,1920,93
STAT,1861,36,na,1897,1857.1046315958195
SIM,1836,30,40-44,1866,5
STAT,1897,31,na,1928,3027.2228483958424
SIM,1848,66,na,1914,1175
STAT,1914,23,15-19,1937,5.120881927076883
STAT,1845,18,na,1863,2031.5417347065004
STAT,1849,6,na,1855,2213.4420299999997
SIM,1934,29,50-100,1963,1
STAT,1858,47,na,1905,1660.7696881251272
STAT,1926,29,50-100,1955,1.119274606254571
SIM,1901,9,na,1910,3500
STAT,1788,109,na,1897,2.0866695060786964E-4
STAT,1881,20,35-39,1901,5.354556845438781
STAT,1933,34,35-39,1967,11.619129956446882
STAT,1837,35,15-19,1872,0.04406537431548193
STAT,1836,21,35-39,1857,4.898499532454956
STAT,1850,27,25-29,1877,35.04545880295351
SIM,1954,16,15-19,1970,47
SIM,1906,32,25-29,1938,12
STAT,1901,20,30-34,1921,23.69347991260967
STAT,1870,24,45-49,1894,0.6414484305663926
STAT,1879,49,40-44,1928,0.16551877112410424
SIM,1918,25,45-49,1943,2
STAT,1851,18,na,1869,2034.5128443280369
STAT,1914,25,35-39,1939,14.392575869003009
STAT,1879,47,20-24,1926,0.011793943914265406
STAT,1903,48,15-19,1951,2.994479219670271E-4
SIM,1913,10,na,1923,3703
STAT,1869,90,na,1959,113.09099082496726
STAT,1872,19,25-29,1891,5.3443895817401454
STAT,1858,27,30-34,1885,19.11817148591673
STAT,1875,42,20-24,1917,0.15394432159526686
STAT,1782,78,na,1860,264.44395697309744
SIM,1922,25,35-39,1947,22
STAT,1891,23,30-34,1914,20.76366386598513
STAT,1891,43,50-100,1934,1.2263926476102165
SIM,1888,21,45-49,1909,3
STAT,1881,18,20-24,1899,16.128605203197214
SIM,1886,36,45-49,1922,5
SIM,1866,27,30-34,1893,21
STAT,1944,21,35-39,1965,9.60712823322143
STAT,1812,93,na,1905,12.56979304088134
STAT,1808,51,20-24,1859,0.0027382201250904
SIM,1877,54,na,1931,2061
STAT,1923,45,35-39,1968,0.14316697926334554
STAT,1824,32,30-34,1856,40.441057936099845
SIM,1862,20,40-44,1882,1
STAT,1927,19,20-24,1946,158.41223588425115
SIM,1832,32,30-34,1864,16
SIM,1939,12,na,1951,3675
STAT,1866,53,35-39,1919,0.007378001359568296
STAT,1882,44,50-100,1926,0.9580348583901233
STAT,1922,15,20-24,1937,148.92484923998603
SIM,1890,44,50-100,1934,2
STAT,1846,47,25-29,1893,0.04042283710658341
STAT,1882,72,na,1954,1160.9162305029151
SIM,1842,29,50-100,1871,1
SIM,1858,28,na,1886,1960
SIM,1886,18,15-19,1904,6
STAT,1841,35,35-39,1876,5.82121329774694
STAT,1864,24,15-19,1888,2.7896973891965517
SIM,1856,22,45-49,1878,2
STAT,1827,46,45-49,1873,0.2095351695439091
STAT,1822,42,45-49,1864,2.257201290964197
STAT,1816,46,30-34,1862,0.25898183257797963
STAT,1956,15,na,1971,4603.029727462537
STAT,1927,0,na,1927,5292.382350120135
STAT,1917,49,20-24,1966,0.010840191574275062
SIM,1857,38,45-49,1895,5
STAT,1850,45,25-29,1895,0.04095480453447143
STAT,1870,47,na,1917,2072.8997362564214
SIM,1817,74,na,1891,505
STAT,1898,44,15-19,1942,0.0012098194249929735
SIM,1903,32,45-49,1935,4
SIM,1794,63,na,1857,850
SIM,1946,25,20-24,1971,23
SIM,1832,37,25-29,1869,1
STAT,1912,28,na,1940,3474.420407704978
STAT,1864,87,na,1951,148.75133207282366
STAT,1842,46,40-44,1888,0.12350628029921713
STAT,1839,20,45-49,1859,0.6060835987537753
SIM,1872,24,15-19,1896,2
STAT,1883,37,30-34,1920,4.934480787845479
STAT,1901,35,35-39,1936,2.037811507108527
STAT,1843,48,15-19,1891,2.8495587019409645E-4
SIM,1930,15,20-24,1945,152
STAT,1859,24,40-44,1883,1.6066788955310716
STAT,1924,13,na,1937,4450.964118780058
STAT,1919,19,50-100,1938,0.3890293227403818
SIM,1891,37,30-34,1928,10
STAT,1864,47,na,1911,1890.7089140572582
SIM,1923,36,40-44,1959,3
STAT,1824,37,25-29,1861,4.326973869292054
STAT,1920,36,15-19,1956,0.019881704173417728
STAT,1818,44,45-49,1862,3.3238604155530216
STAT,1828,30,40-44,1858,5.023686171791837
SIM,1905,22,30-34,1927,34
STAT,1844,34,45-49,1878,1.4338255583913548
STAT,1873,26,15-19,1899,0.4365521519254992
STAT,1945,12,na,1957,4053.6846229429752
SIM,1878,41,35-39,1919,4
STAT,1870,87,na,1957,198.95705995652705
SIM,1861,1,na,1862,2979
STAT,1933,27,na,1960,4699.062753027835
SIM,1907,10,na,1917,3653
STAT,1906,42,30-34,1948,0.10968698130557641
SIM,1876,29,45-49,1905,2
SIM,1901,44,40-44,1945,2
STAT,1901,39,20-24,1940,0.21778913688416676
STAT,1860,31,20-24,1891,2.0837804854687607
SIM,1888,35,na,1923,2590
SIM,1896,40,40-44,1936,6
SIM,1923,5,na,1928,4350
STAT,1936,30,40-44,1966,3.5942655780618864
STAT,1870,51,35-39,1921,0.008007272766498591
STAT,1891,28,25-29,1919,49.28922496163945
STAT,1835,28,40-44,1863,2.4184141899743574
STAT,1888,40,40-44,1928,2.5355436518798875
STAT,1837,32,40-44,1869,3.4324495191031157
SIM,1945,4,na,1949,3976
SIM,1845,32,40-44,1877,9
SIM,1804,64,na,1868,806
SIM,1861,36,45-49,1897,1
SIM,1828,39,25-29,1867,1
SIM,1881,45,50-100,1926,4
STAT,1860,17,45-49,1877,0.05784131358944402
STAT,1885,46,na,1931,2123.5156862587846
SIM,1858,35,25-29,1893,5
STAT,1900,46,45-49,1946,0.1749658206177146
STAT,1838,48,40-44,1886,0.11859814144247534
SIM,1934,26,45-49,1960,1
STAT,1885,35,45-49,1920,1.8940473115373617
STAT,1896,31,35-39,1927,12.695639353571233
STAT,1878,36,15-19,1914,0.05549114815234793
STAT,1901,43,50-100,1944,0.0963051132944362
STAT,1865,38,25-29,1903,2.4593726495319674
SIM,1871,69,na,1940,1324
SIM,1926,17,20-24,1943,160
STAT,1875,15,30-34,1890,1.5540980726217752
STAT,1893,13,na,1906,3090.638869363039
SIM,1870,84,na,1954,267
STAT,1764,103,na,1867,0.03638631541407927
STAT,1833,55,na,1888,1269.3216426413194
STAT,1891,46,25-29,1937,0.0381000415341843
STAT,1915,36,40-44,1951,1.435366529399204
STAT,1897,47,35-39,1944,0.09930885619563914
SIM,1861,18,15-19,1879,6
STAT,1827,28,45-49,1855,2.0022151487100386
STAT,1853,18,15-19,1871,5.2630649627154735
SIM,1854,29,25-29,1883,39
STAT,1817,37,na,1854,1370.5340943716178
SIM,1845,18,na,1863,2023
STAT,1769,96,na,1865,1.2608737837615485
STAT,1894,19,45-49,1913,0.07895552634450602
STAT,1846,29,25-29,1875,35.56529154491086
STAT,1870,49,50-100,1919,0.2225976486182726
SIM,1824,49,50-100,1873,3
SIM,1893,35,45-49,1928,2
STAT,1864,36,20-24,1900,0.6539685220422335
STAT,1929,36,35-39,1965,2.936372580183075
STAT,1834,41,20-24,1875,0.12003773443631291
STAT,1809,106,na,1915,0.005100511172985437
SIM,1822,33,20-24,1855,2
SIM,1840,29,30-34,1869,24
STAT,1906,28,na,1934,3271.367100811474
STAT,1816,52,na,1868,1285.2003089750824
STAT,1863,22,40-44,1885,1.7649086305598212
SIM,1830,42,45-49,1872,3
SIM,1894,28,20-24,1922,18
STAT,1832,29,30-34,1861,20.19956122657235
STAT,1928,39,25-29,1967,1.1731323932779534
SIM,1873,33,30-34,1906,15
STAT,1928,20,35-39,1948,11.173421153696193
SIM,1841,44,40-44,1885,5
STAT,1926,26,45-49,1952,1.9634054435817976
STAT,1949,15,25-29,1964,47.64193835712159
SIM,1935,19,20-24,1954,178
SIM,1871,22,40-44,1893,1
STAT,1918,17,20-24,1935,27.967961997821174
SIM,1805,49,na,1854,1243
STAT,1841,59,na,1900,1329.7018032075418
STAT,1854,20,40-44,1874,1.7886733898323766
STAT,1930,13,na,1943,4832.038357734151
SIM,1830,24,15-19,1854,2
STAT,1843,19,35-39,1862,0.499951682111709
SIM,1859,32,35-39,1891,9
STAT,1894,37,45-49,1931,2.422525438451461
SIM,1877,94,na,1971,75
SIM,1884,29,40-44,1913,6
SIM,1904,25,20-24,1929,18
STAT,1829,40,35-39,1869,1.57108490872475
STAT,1848,22,45-49,1870,0.6116830954310503
STAT,1849,38,45-49,1887,1.4551269730571048
STAT,1907,44,35-39,1951,0.17211428834078404
STAT,1822,52,na,1874,1246.2518047029296
SIM,1810,64,na,1874,856
STAT,1883,18,50-100,1901,0.04524112610618835
SIM,1837,41,50-100,1878,1
STAT,1851,40,na,1891,1711.9719572486038
SIM,1936,20,35-39,1956,7
STAT,1865,38,50-100,1903,1.048721844088434
STAT,1886,28,20-24,1914,11.668227626655689
STAT,1865,51,30-34,1916,0.005134384462547383
STAT,1857,47,30-34,1904,0.071755779183947
STAT,1816,49,50-100,1865,0.626327558180319
STAT,1927,27,na,1954,4302.839132852441
STAT,1910,32,40-44,1942,3.5635436570903334
STAT,1877,57,na,1934,1970.0753881773373
STAT,1948,18,45-49,1966,0.5399288797994416
SIM,1801,90,na,1891,25
SIM,1894,35,na,1929,3043
STAT,1921,47,20-24,1968,0.011770095695169984
STAT,1834,29,50-100,1863,0.5117900535395058
STAT,1811,52,40-44,1863,0.033428762029467214
SIM,1835,28,45-49,1863,4
SIM,1812,90,na,1902,26
STAT,1875,34,50-100,1909,0.8816377338783707
STAT,1885,17,45-49,1902,0.06148019338512567
SIM,1837,40,35-39,1877,7
STAT,1833,44,40-44,1877,1.6165187690787177
SIM,1841,15,25-29,1856,5
SIM,1888,34,20-24,1922,2
STAT,1838,28,20-24,1866,10.104958112426933
STAT,1826,54,45-49,1880,0.012585122238715114
STAT,1825,97,na,1922,3.0374342208713556
SIM,1902,27,45-49,1929,1
SIM,1890,73,na,1963,1618
STAT,1823,43,50-100,1866,1.3305021046640328
STAT,1898,39,50-100,1937,0.33547519066535125
SIM,1876,44,40-44,1920,7
STAT,1817,54,35-39,1871,0.017726115309569045
STAT,1855,15,45-49,1870,0.05568015756314052
STAT,1862,45,15-19,1907,3.2554840179178717E-4
STAT,1878,30,50-100,1908,0.9083270436963311
SIM,1923,17,35-39,1940,4
STAT,1826,38,40-44,1864,4.611020910285895
STAT,1835,20,50-100,1855,0.4533698008242733
SIM,1907,41,na,1948,3268
STAT,1907,39,50-100,1946,0.3639747946621795
SIM,1864,28,40-44,1892,3
STAT,1953,15,15-19,1968,51.891823385244095
STAT,1849,25,30-34,1874,21.82850006497415
SIM,1860,41,40-44,1901,5
SIM,1844,33,50-100,1877,5
STAT,1906,17,25-29,1923,7.79520299114393
SIM,1896,21,35-39,1917,9
STAT,1767,92,na,1859,7.548670900922337
STAT,1847,28,30-34,1875,22.110478819105865
STAT,1801,103,na,1904,0.054610279104459064
STAT,1921,28,15-19,1949,0.7407196651301184
STAT,1782,111,na,1893,2.716909184447366E-4
STAT,1853,18,45-49,1871,0.05793135825760517
STAT,1893,29,40-44,1922,3.5648686699107923
STAT,1902,40,35-39,1942,0.16933041599799145
STAT,1915,24,40-44,1939,3.2625465468248933
SIM,1853,41,35-39,1894,6
SIM,1844,39,na,1883,1752
SIM,1903,51,na,1954,2911
STAT,1887,41,na,1928,2452.86541438147
STAT,1890,39,na,1929,2693.829432804928
STAT,1863,37,na,1900,1956.43544339921
SIM,1838,30,45-49,1868,1
STAT,1893,45,45-49,1938,0.16115492962224803
STAT,1915,17,35-39,1932,0.829581260117364
STAT,1786,99,na,1885,0.3476564394882259
STAT,1856,28,40-44,1884,2.2802072780734686
SIM,1840,49,na,1889,1532
SIM,1897,34,30-34,1931,34
STAT,1808,54,25-29,1862,0.012376275473975457
STAT,1888,21,35-39,1909,6.53211668911843
SIM,1833,27,50-100,1860,1
STAT,1878,48,15-19,1926,3.8843783694522314E-4
STAT,1894,29,na,1923,2879.423473374764
STAT,1897,21,45-49,1918,0.8836666268504508
STAT,1906,6,na,1912,3593.5823678761662
SIM,1901,17,15-19,1918,7
STAT,1887,48,25-29,1935,0.06008956408644919
STAT,1839,18,na,1857,1990.371832675325
SIM,1876,42,50-100,1918,2
SIM,1821,38,30-34,1859,1
STAT,1924,17,45-49,1941,0.5620236762077324
SIM,1883,21,25-29,1904,57
SIM,1938,33,na,1971,3519
STAT,1911,24,40-44,1935,2.9929548264623156
SIM,1882,78,na,1960,813
STAT,1892,40,50-100,1932,1.2624005827090559
STAT,1906,24,30-34,1930,24.349346650513954
STAT,1788,100,na,1888,0.21895377333919275
STAT,1901,40,50-100,1941,0.09798468615624009
SIM,1874,15,20-24,1889,22
STAT,1843,51,40-44,1894,0.007631569729503965
STAT,1833,22,30-34,1855,15.488028499371286
STAT,1883,51,na,1934,2003.0855170998123
STAT,1930,35,30-34,1965,2.2498300619313696
STAT,1794,94,na,1888,4.116783481709087
STAT,1866,15,20-24,1881,16.037665549299582
SIM,1932,17,45-49,1949,1
SIM,1836,33,45-49,1869,5
SIM,1837,51,na,1888,1414
STAT,1864,42,15-19,1906,0.011645432671400523
STAT,1884,45,35-39,1929,0.13199853959368346
SIM,1848,25,20-24,1873,14
SIM,1852,34,na,1886,1889
STAT,1909,27,20-24,1936,16.476020946215606
STAT,1917,21,40-44,1938,3.3859675197766963
SIM,1872,18,20-24,1890,14
SIM,1917,27,20-24,1944,21
SIM,1893,16,na,1909,3154
SIM,1825,32,na,1857,1588
STAT,1852,99,na,1951,1.4389077959228511
SIM,1899,31,30-34,1930,34
STAT,1871,29,20-24,1900,10.908487647797763
SIM,1875,90,na,1965,210
SIM,1914,24,30-34,1938,31
STAT,1866,47,40-44,1913,0.14841814864153058
STAT,1915,46,50-100,1961,0.21582257768577484
SIM,1878,23,40-44,1901,1
SIM,1925,21,40-44,1946,3
SIM,1897,27,25-29,1924,56
STAT,1895,70,na,1965,1979.0006712973081
STAT,1927,25,15-19,1952,0.8163607561639991
SIM,1862,39,30-34,1901,10
STAT,1843,44,35-39,1887,1.3110799973247542
SIM,1860,28,40-44,1888,3
STAT,1864,18,20-24,1882,15.393263874645044
STAT,1837,54,20-24,1891,4.5302272123254783E-4
SIM,1880,43,na,1923,2371
STAT,1852,28,40-44,1880,2.6318553668444955
STAT,1837,82,na,1919,294.5337548701261
STAT,1845,49,30-34,1894,0.06676048213116938
STAT,1862,83,na,1945,319.9071394674936
STAT,1936,25,50-100,1961,0.9005079464399938
STAT,1851,39,45-49,1890,1.447143631679912
STAT,1868,74,na,1942,1001.0038055160303
SIM,1855,76,na,1931,705
SIM,1824,84,na,1908,163
SIM,1926,14,na,1940,4473
SIM,1841,22,30-34,1863,21
SIM,1855,20,35-39,1875,7
SIM,1808,60,na,1868,994
STAT,1948,17,30-34,1965,13.178484460597296
STAT,1823,41,15-19,1864,0.018410579882610707
STAT,1875,45,25-29,1920,0.05646031843407985
STAT,1883,15,50-100,1898,0.04557071825788713
STAT,1857,31,15-19,1888,0.1078268567175937
STAT,1913,35,na,1948,3539.924992759797
SIM,1877,34,45-49,1911,3
SIM,1857,25,30-34,1882,27
SIM,1948,4,na,1952,4056
STAT,1890,32,15-19,1922,0.1644847103044423
STAT,1913,38,35-39,1951,2.243252686701885
STAT,1856,26,15-19,1882,0.35036919485456003
STAT,1876,50,25-29,1926,0.003504007898049538
SIM,1937,22,45-49,1959,1
SIM,1921,38,35-39,1959,8
STAT,1927,43,45-49,1970,0.1968937498378043
SIM,1904,9,na,1913,3476
SIM,1847,33,20-24,1880,2
STAT,1831,36,25-29,1867,2.300510130962763
STAT,1930,28,25-29,1958,79.03077348286632
STAT,1863,54,50-100,1917,0.012196644576440202
SIM,1939,27,40-44,1966,7
STAT,1939,33,25-29,1972,8.902336538380885
STAT,1868,44,40-44,1912,2.0014102241095406
SIM,1863,71,na,1934,1085
STAT,1831,91,na,1922,35.34034805063499
STAT,1829,87,na,1916,107.9897725810506
STAT,1869,34,45-49,1903,1.5809627156815709
STAT,1921,30,na,1951,4008.368314951289
STAT,1931,7,na,1938,4942.845332409712
SIM,1907,21,20-24,1928,103
STAT,1920,17,45-49,1937,0.5294855051366819
SIM,1849,30,20-24,1879,2
STAT,1858,23,15-19,1881,2.5362015579794144
STAT,1845,41,35-39,1886,1.3156165977484702
STAT,1847,20,35-39,1867,5.340041106605597
SIM,1933,28,15-19,1961,3
STAT,1837,47,15-19,1884,2.6211958634784935E-4
STAT,1925,28,15-19,1953,0.7850218172214521
STAT,1933,22,35-39,1955,11.799086056251053
SIM,1924,13,na,1937,4440
SIM,1851,44,35-39,1895,4
STAT,1823,96,na,1919,4.518626318507325
STAT,1916,17,50-100,1933,0.07509004367439923
SIM,1816,89,na,1905,31
SIM,1855,28,30-34,1883,25
STAT,1844,64,na,1908,1220.3435648896548
STAT,1889,37,50-100,1926,1.4318820144373874
STAT,1955,7,na,1962,4928.990721423767
STAT,1860,34,25-29,1894,7.796531337658338
SIM,1898,26,30-34,1924,34
SIM,1837,57,na,1894,1275
STAT,1872,37,25-29,1909,2.7300614017120632
STAT,1844,43,40-44,1887,1.5965854360955622
SIM,1799,78,na,1877,283
STAT,1827,43,40-44,1870,2.03321476551577
STAT,1788,106,na,1894,0.0035610859942894098
STAT,1924,22,25-29,1946,102.97635528460754
STAT,1825,49,45-49,1874,0.24073794029600434
STAT,1852,24,50-100,1876,0.3627946382313853
STAT,1865,33,30-34,1898,14.924953987947301
STAT,1922,33,15-19,1955,0.13659519346407228
STAT,1858,84,na,1942,246.71287516554375
STAT,1854,54,na,1908,1507.846346731092
STAT,1840,47,50-100,1887,0.17248013227607165
STAT,1841,18,50-100,1859,0.042977143725388585
STAT,1907,22,25-29,1929,79.426399462506
SIM,1953,16,na,1969,4076
STAT,1851,20,25-29,1871,50.85900384427516
SIM,1929,28,25-29,1957,80
STAT,1854,23,45-49,1877,0.5857574530599531
STAT,1808,49,45-49,1857,0.8690451957797656
STAT,1917,45,40-44,1962,0.1562974035066647
STAT,1910,42,50-100,1952,0.10485643466840104
SIM,1843,51,na,1894,1542
STAT,1830,30,35-39,1860,8.750870292839302
STAT,1839,36,25-29,1875,2.318093085537706
SIM,1932,22,25-29,1954,120
STAT,1864,20,35-39,1884,5.0788587908164695
STAT,1894,34,40-44,1928,5.224945564563913
SIM,1842,20,25-29,1862,53
SIM,1887,29,20-24,1916,10
SIM,1924,4,na,1928,4530
SIM,1820,94,na,1914,5
SIM,1837,25,45-49,1862,4
SIM,1875,20,20-24,1895,73
SIM,1873,26,25-29,1899,41
SIM,1868,49,na,1917,1985
STAT,1904,45,30-34,1949,0.07471528716541262
SIM,1902,16,20-24,1918,28
STAT,1879,29,20-24,1908,11.501218269055816
STAT,1889,27,25-29,1916,49.33496292689553
SIM,1929,35,30-34,1964,6
SIM,1822,89,na,1911,48
STAT,1811,43,45-49,1854,5.541169143184965
STAT,1834,20,25-29,1854,85.43793548916064
STAT,1938,28,25-29,1966,61.565214283484686
STAT,1895,76,na,1971,1603.2067556668305
STAT,1910,35,45-49,1945,0.6215994801534405
SIM,1901,0,na,1901,3674
SIM,1906,22,15-19,1928,6
STAT,1914,19,40-44,1933,0.27181886170148845
SIM,1884,20,30-34,1904,19
STAT,1922,40,20-24,1962,0.019203979991331905
STAT,1896,24,na,1920,2934.3540741772817
SIM,1915,22,25-29,1937,101
STAT,1848,54,na,1902,1508.535901026464
STAT,1865,32,na,1897,2048.516395198058
STAT,1910,19,50-100,1929,0.06973432985927251
SIM,1835,43,40-44,1878,8
SIM,1879,31,45-49,1910,5
STAT,1868,8,na,1876,2478.0671015830285
STAT,1906,0,na,1906,4039.2510913180154
STAT,1878,54,50-100,1932,0.01444439390382234
STAT,1850,64,na,1914,1223.808350882716
SIM,1847,36,25-29,1883,2
STAT,1897,27,15-19,1924,0.5732147606059795
SIM,1831,66,na,1897,984
STAT,1858,52,30-34,1910,0.004391085875927477
SIM,1934,35,40-44,1969,4
STAT,1848,33,30-34,1881,13.21057370271324
STAT,1840,41,15-19,1881,0.01016170472761964
STAT,1858,30,20-24,1888,2.046735567219012
SIM,1856,33,30-34,1889,26
STAT,1807,78,na,1885,324.7317264115091
STAT,1800,54,25-29,1854,0.009930840903722463
SIM,1906,27,45-49,1933,2
SIM,1881,18,30-34,1899,2
SIM,1846,34,na,1880,1767
SIM,1918,19,na,1937,3742
STAT,1813,72,na,1885,587.2134930076106
STAT,1901,10,na,1911,3425.154281140815
STAT,1828,33,45-49,1861,1.8120209404302843
STAT,1926,35,40-44,1961,1.731526255126717
SIM,1851,86,na,1937,114
STAT,1848,26,25-29,1874,36.64442492646842
STAT,1923,32,20-24,1955,2.6418412177409842
SIM,1842,39,45-49,1881,4
STAT,1875,56,na,1931,1979.5423644505631
STAT,1922,18,na,1940,4013.941122199919
STAT,1870,5,na,1875,2582.2148241353766
STAT,1884,39,na,1923,2177.2623004616685
STAT,1859,32,na,1891,1799.0984741461498
STAT,1788,94,na,1882,4.159849435846148
STAT,1908,21,30-34,1929,25.03090193102955
STAT,1904,38,25-29,1942,0.837777939610635
STAT,1867,20,20-24,1887,62.268187335876995
STAT,1839,43,30-34,1882,0.797642771028709
STAT,1865,26,25-29,1891,36.43805437415184
SIM,1832,22,20-24,1854,54
STAT,1829,25,45-49,1854,3.185633860383921
SIM,1768,86,na,1854,44
SIM,1793,81,na,1874,166
STAT,1867,48,50-100,1915,0.21511005885361437
STAT,1826,73,na,1899,648.295757792808
STAT,1851,12,na,1863,2128.4096393114796
SIM,1916,21,30-34,1937,35
STAT,1853,33,40-44,1886,3.277748541849837
STAT,1819,63,na,1882,951.41720270083
SIM,1907,47,na,1954,3119
SIM,1833,30,25-29,1863,17
STAT,1780,74,na,1854,361.0
STAT,1873,18,30-34,1891,1.5243703413864176
STAT,1895,24,45-49,1919,0.8542762786168271
STAT,1898,19,na,1917,3212.4923177475553
STAT,1864,84,na,1948,280.8711139319908
STAT,1870,37,20-24,1907,0.7135512977664659
SIM,1862,58,na,1920,1705
SIM,1922,19,40-44,1941,1
SIM,1861,33,40-44,1894,4
SIM,1817,37,na,1854,1541
STAT,1886,42,35-39,1928,1.8051917423363633
STAT,1880,29,30-34,1909,24.851869043912014
SIM,1848,60,na,1908,1383
SIM,1823,37,na,1860,1482
SIM,1846,28,20-24,1874,9
STAT,1896,16,45-49,1912,0.08175755743811103
SIM,1856,26,25-29,1882,42
SIM,1880,37,25-29,1917,3
SIM,1901,56,na,1957,2736
STAT,1885,50,35-39,1935,0.008219107573916917
SIM,1931,32,20-24,1963,3
STAT,1852,48,50-100,1900,0.18425545159810858
STAT,1846,99,na,1945,1.3353134765871082
STAT,1889,76,na,1965,1416.956020927854
STAT,1903,46,25-29,1949,0.0437932273149345
SIM,1852,43,40-44,1895,5
STAT,1891,8,na,1899,3039.6668975716993
STAT,1819,51,35-39,1870,0.01499959701811808
SIM,1827,53,50-100,1880,1
SIM,1892,42,30-34,1934,5
STAT,1889,34,30-34,1923,20.188441626091976
STAT,1778,103,na,1881,0.04592714253413107
SIM,1806,65,na,1871,803
STAT,1947,18,25-29,1965,46.10357962459876
STAT,1841,15,15-19,1856,5.299049512263764
STAT,1820,39,15-19,1859,0.11197176677908015
STAT,1868,29,45-49,1897,0.9943102376789973
STAT,1825,30,25-29,1855,22.63633624513682
STAT,1910,17,15-19,1927,8.492698132029863
SIM,1821,42,na,1863,1456
STAT,1881,56,na,1937,1860.4398839930602
SIM,1947,16,na,1963,3751
STAT,1830,38,30-34,1868,4.1728445432943735
SIM,1800,74,na,1874,450
SIM,1876,78,na,1954,695
STAT,1834,44,25-29,1878,0.4670686501152113
STAT,1892,21,25-29,1913,67.92640555814705
SIM,1924,19,na,1943,4143
SIM,1847,28,40-44,1875,2
SIM,1940,17,35-39,1957,2
SIM,1869,33,40-44,1902,5
SIM,1887,16,na,1903,2642
STAT,1843,54,45-49,1897,0.01018213956334045
SIM,1920,29,na,1949,3787
SIM,1839,49,50-100,1888,2
SIM,1829,93,na,1922,14
SIM,1846,30,35-39,1876,9
STAT,1893,42,40-44,1935,2.692698805055359
STAT,1901,17,50-100,1918,0.06478132205582514
STAT,1828,52,50-100,1880,0.012283748946489259
SIM,1869,90,na,1959,85
STAT,1904,28,15-19,1932,0.6125229897332248
SIM,1851,80,na,1931,390
STAT,1866,25,30-34,1891,22.08196029784401
SIM,1853,39,20-24,1892,3
STAT,1830,44,na,1874,1493.3979670348483
STAT,1911,40,na,1951,3385.8841275386453
STAT,1845,39,20-24,1884,0.558769711061147
SIM,1860,44,45-49,1904,1
STAT,1817,51,30-34,1868,0.013014083696149427
STAT,1852,28,na,1880,1900.6154315292163
SIM,1790,79,na,1869,241
SIM,1892,35,25-29,1927,5
STAT,1845,51,45-49,1896,0.010271183440256685
STAT,1888,19,20-24,1907,19.67911700187299
STAT,1876,45,45-49,1921,0.23245487315691657
SIM,1794,69,na,1863,687
STAT,1884,42,30-34,1926,1.0719395998484702
STAT,1850,15,25-29,1865,4.932909463611682
SIM,1882,16,25-29,1898,7
SIM,1891,21,15-19,1912,3
STAT,1911,27,45-49,1938,1.5912566264732704
STAT,1951,2,na,1953,4483.06201741757
SIM,1879,21,35-39,1900,8
STAT,1874,16,25-29,1890,5.484842860722304
STAT,1809,54,45-49,1863,0.04832970158330938
SIM,1928,32,45-49,1960,4
SIM,1900,27,40-44,1927,6
STAT,1850,52,30-34,1902,0.004168299875808077
SIM,1815,42,na,1857,1350
STAT,1798,56,na,1854,1036.9999999999998
STAT,1826,51,40-44,1877,0.009689525707039995
SIM,1857,31,25-29,1888,12
SIM,1862,24,na,1886,2088
SIM,1917,31,na,1948,3700
SIM,1932,14,na,1946,4798
STAT,1859,109,na,1968,0.005960704698285744
STAT,1860,29,45-49,1889,0.8492517838420535
STAT,1932,17,35-39,1949,5.24913328797819
STAT,1835,87,na,1922,109.92443613333865
STAT,1883,39,50-100,1922,1.125285998143554
SIM,1855,48,na,1903,1760
SIM,1896,19,20-24,1915,18
STAT,1910,25,35-39,1935,13.901874706570366
STAT,1817,62,na,1879,943.2397445237818
STAT,1831,33,20-24,1864,2.1903840305146507
STAT,1851,36,40-44,1887,3.2783363627386986
SIM,1930,27,20-24,1957,20
STAT,1772,114,na,1886,2.567341575153365E-4
STAT,1849,31,25-29,1880,8.638247275140523
STAT,1905,34,50-100,1939,0.7120703901487464
STAT,1836,18,45-49,1854,0.10713488917230482
SIM,1777,97,na,1874,1
SIM,1872,88,na,1960,175
SIM,1784,70,na,1854,506
SIM,1939,32,20-24,1971,2
STAT,1834,39,45-49,1873,1.5033257183128967
SIM,1829,28,20-24,1857,9
STAT,1832,45,na,1877,1493.0424664037455
STAT,1857,41,25-29,1898,0.48041090344297627
STAT,1861,26,50-100,1887,0.5091251238970619
STAT,1833,21,na,1854,1721.006207643866
STAT,1896,29,50-100,1925,0.7929682605252512
SIM,1861,101,na,1962,3
STAT,1947,25,30-34,1972,41.91571805699586
STAT,1836,51,35-39,1887,0.005610772083821352
STAT,1838,30,35-39,1868,8.762828071014521
SIM,1850,39,na,1889,1720
STAT,1867,52,40-44,1919,0.009288319048122497
STAT,1953,0,na,1953,4953.854480308009
STAT,1885,48,20-24,1933,0.011152241326427658
STAT,1927,40,40-44,1967,0.2971993173253478
STAT,1860,54,na,1914,1607.6557431729984
SIM,1872,20,35-39,1892,8
STAT,1835,56,na,1891,1272.5883853877203
STAT,1867,27,na,1894,2116.847263214211
STAT,1906,27,35-39,1933,13.273153382513946
STAT,1891,16,25-29,1907,6.642417606229188
SIM,1842,75,na,1917,677
STAT,1908,24,35-39,1932,8.124506617101574
STAT,1822,49,50-100,1871,0.33295037858839344
SIM,1914,27,35-39,1941,13
STAT,1937,11,na,1948,3646.380747918836
SIM,1887,25,50-100,1912,2
STAT,1878,24,45-49,1902,0.6814895426222859
SIM,1874,31,25-29,1905,11
SIM,1846,43,50-100,1889,1
SIM,1898,32,25-29,1930,19
STAT,1906,25,na,1931,3305.195417253275
SIM,1888,63,na,1951,1934
SIM,1895,23,40-44,1918,2
SIM,1888,29,40-44,1917,3
STAT,1912,38,15-19,1950,0.017614244402689588
STAT,1857,26,35-39,1883,7.455269117720547
STAT,1838,43,50-100,1881,0.7570548108012792
STAT,1848,20,na,1868,1902.7686999372652
STAT,1887,23,40-44,1910,2.194734043813044
STAT,1913,43,15-19,1956,0.0014121913998177765
SIM,1851,41,30-34,1892,4
STAT,1893,41,na,1934,2782.823894342184
STAT,1946,22,na,1968,3839.089363727021
STAT,1768,100,na,1868,0.12367847994281882
STAT,1911,30,35-39,1941,8.472145595996693
STAT,1859,39,15-19,1898,0.041910206392178864
STAT,1922,12,na,1934,4332.287569317069
SIM,1902,32,na,1934,3203
STAT,1877,51,na,1928,2120.8861576959885
SIM,1865,26,35-39,1891,8
STAT,1883,21,15-19,1904,3.0636795235608134
SIM,1814,94,na,1908,5
SIM,1874,25,30-34,1899,26
STAT,1843,41,30-34,1884,0.8650079739235221
STAT,1887,45,20-24,1932,0.012804352569010361
STAT,1904,24,na,1928,3184.1635224368665
STAT,1811,100,na,1911,0.4598506434584819
STAT,1913,35,30-34,1948,1.7148917486886464
STAT,1871,31,35-39,1902,9.523196772348182
SIM,1921,35,30-34,1956,2
STAT,1889,20,40-44,1909,2.444788393257927
STAT,1879,25,50-100,1904,0.6359381265821044
SIM,1888,37,25-29,1925,2
SIM,1897,20,40-44,1917,4
SIM,1849,76,na,1925,634
SIM,1867,33,na,1900,2054
STAT,1863,37,15-19,1900,0.046631510868663795
SIM,1846,65,na,1911,1164
SIM,1889,26,20-24,1915,15
SIM,1900,21,35-39,1921,10
SIM,1828,32,40-44,1860,4
SIM,1941,22,35-39,1963,8
STAT,1858,45,25-29,1903,0.043143744236449545
STAT,1921,45,30-34,1966,0.09539230216485761
STAT,1816,49,35-39,1865,0.35702711079599475
STAT,1871,38,50-100,1909,1.1441312673100907
STAT,1819,97,na,1916,2.6828279005812687
STAT,1925,36,35-39,1961,2.7453141099336973
SIM,1881,90,na,1971,174
SIM,1894,40,50-100,1934,2
SIM,1853,35,50-100,1888,3
SIM,1858,50,na,1908,1762
STAT,1875,21,25-29,1896,55.72678031814493
STAT,1866,37,30-34,1903,4.6420038088457325
STAT,1856,20,45-49,1876,0.6079191224778413
SIM,1879,58,na,1937,1925
STAT,1899,66,na,1965,2349.4437291221084
STAT,1838,30,na,1868,1875.2566560296525
STAT,1848,7,na,1855,2210.46564
SIM,1866,23,15-19,1889,2
SIM,1858,59,na,1917,1589
SIM,1907,22,35-39,1929,8
STAT,1779,89,na,1868,35.14032001788332
SIM,1822,100,na,1922,1
STAT,1839,33,20-24,1872,2.195056245627864
SIM,1880,34,20-24,1914,2
STAT,1867,30,30-34,1897,15.61126266369609
STAT,1912,32,45-49,1944,1.4624110969011848
SIM,1887,2,na,1889,2921
STAT,1905,33,15-19,1938,0.1111583530716144
SIM,1882,23,30-34,1905,19
STAT,1836,69,na,1905,926.7375486476001
STAT,1890,48,30-34,1938,0.06227578740753355
STAT,1919,49,25-29,1968,0.05403436115385387
STAT,1921,25,50-100,1946,1.0551682327336933
STAT,1844,46,45-49,1890,0.16614454632771652
STAT,1931,33,25-29,1964,11.434233389296356
STAT,1823,62,na,1885,1005.16654335897
SIM,1911,46,na,1957,3336
STAT,1907,8,na,1915,3606.784729688581
STAT,1923,42,30-34,1965,0.14117365702282483
SIM,1910,61,na,1971,2928
SIM,1933,36,35-39,1969,9
STAT,1830,28,20-24,1858,10.759818349117277
STAT,1850,101,na,1951,0.40172033100344695
STAT,1888,39,40-44,1927,4.836168843414281
STAT,1928,37,na,1965,4492.119642755388
SIM,1874,37,30-34,1911,8
STAT,1939,23,15-19,1962,5.048082979251682
SIM,1839,36,35-39,1875,15
STAT,1861,34,45-49,1895,1.3562756434528649
SIM,1935,25,15-19,1960,4
STAT,1865,18,40-44,1883,0.16084520456159776
STAT,1821,44,15-19,1865,0.021701794760154658
SIM,1901,32,40-44,1933,8
SIM,1924,21,20-24,1945,120
STAT,1843,17,na,1860,2116.3297287774762
STAT,1898,27,35-39,1925,12.339309574727357
SIM,1788,69,na,1857,645
SIM,1905,46,na,1951,3063
SIM,1908,29,na,1937,3223
STAT,1946,22,45-49,1968,1.1828798326367451
SIM,1850,20,15-19,1870,2
SIM,1896,29,30-34,1925,41
STAT,1802,63,na,1865,852.4405122085282
STAT,1856,39,50-100,1895,0.8992568544668575
STAT,1871,7,na,1878,2563.7744769511146
STAT,1905,43,25-29,1948,0.060436214215129486
SIM,1875,39,40-44,1914,5
STAT,1888,29,30-34,1917,27.902396610673037
STAT,1919,39,15-19,1958,0.019447842447319896
STAT,1922,27,20-24,1949,19.514446024934642
SIM,1878,73,na,1951,1136
STAT,1867,39,40-44,1906,3.843767974248116
SIM,1832,25,25-29,1857,40
SIM,1899,72,na,1971,2042
STAT,1806,90,na,1896,26.234081649274664
STAT,1830,40,45-49,1870,1.1702841816716985
SIM,1838,20,35-39,1858,5
SIM,1827,67,na,1894,860
STAT,1916,21,20-24,1937,110.40146521494185
STAT,1811,77,na,1888,366.0224912779955
STAT,1890,0,na,1890,3391.5479789734036
STAT,1842,20,15-19,1862,3.006143077826816
STAT,1918,10,na,1928,4086.4151453198638
SIM,1925,0,na,1925,4659
SIM,1916,24,35-39,1940,11
STAT,1870,18,15-19,1888,5.513098524991976
STAT,1840,104,na,1944,0.046451022947505166
STAT,1871,66,na,1937,1535.0042192948029
STAT,1925,46,45-49,1971,0.2494461995843073
STAT,1823,31,na,1854,1498.5177183533165
SIM,1895,45,na,1940,2839
STAT,1880,44,20-24,1924,0.1557290909148828
STAT,1879,31,35-39,1910,10.040655335027692
STAT,1898,32,15-19,1930,0.18211476892071723
SIM,1843,44,45-49,1887,5
SIM,1866,33,25-29,1899,10
STAT,1842,39,35-39,1881,5.266179385711976
SIM,1947,23,15-19,1970,4
STAT,1846,22,40-44,1868,1.8128345260468992
STAT,1884,67,na,1951,1479.8638104218257
STAT,1927,23,50-100,1950,0.7635680672864336
STAT,1939,28,45-49,1967,1.639744623079784
SIM,1910,34,40-44,1944,3
SIM,1837,29,25-29,1866,31
SIM,1902,8,na,1910,3491
STAT,1865,23,20-24,1888,59.44677018839412
STAT,1819,49,20-24,1868,0.020710625270475888
SIM,1839,52,na,1891,1482
STAT,1909,49,50-100,1958,0.19513849374570683
SIM,1943,17,20-24,1960,125
STAT,1847,38,40-44,1885,3.3073235438971538
SIM,1838,39,na,1877,1577
STAT,1907,32,35-39,1939,8.068067636578176
SIM,1850,39,35-39,1889,14
SIM,1915,32,35-39,1947,9
SIM,1923,24,40-44,1947,4
STAT,1829,106,na,1935,0.007442232348725879
STAT,1831,97,na,1928,3.276342797278544
STAT,1858,33,25-29,1891,7.564162660315046
STAT,1842,69,na,1911,1045.0561146808373
STAT,1926,38,45-49,1964,0.7863673560247898
SIM,1855,38,40-44,1893,5
STAT,1826,45,na,1871,1430.5788405813885
STAT,1899,24,15-19,1923,4.244223991025721
STAT,1805,77,na,1882,351.3418450058201
SIM,1829,38,30-34,1867,4
SIM,1870,39,50-100,1909,4
STAT,1844,30,na,1874,1857.5564650181464
STAT,1949,22,30-34,1971,31.685228658467178
STAT,1822,36,15-19,1858,0.1069681429024489
STAT,1935,17,20-24,1952,175.08044154968312
STAT,1862,39,50-100,1901,0.9794040828383214
SIM,1888,38,50-100,1926,1
SIM,1946,3,na,1949,4151
SIM,1884,73,na,1957,1132
SIM,1887,31,35-39,1918,12
STAT,1839,28,40-44,1867,2.4981566396202948
STAT,1951,18,15-19,1969,51.040338663444714
STAT,1934,37,na,1971,4904.478781757058
STAT,1844,47,20-24,1891,0.008384836849792604
STAT,1921,35,20-24,1956,0.27856782554841647
SIM,1859,20,35-39,1879,9
SIM,1819,38,na,1857,1478
SIM,1920,26,50-100,1946,1
STAT,1911,40,45-49,1951,0.15172940693528025
STAT,1825,46,40-44,1871,0.18200092275097673
SIM,1856,24,na,1880,1963
STAT,1842,15,35-39,1857,0.5077283846107634
SIM,1854,22,40-44,1876,3
STAT,1813,53,20-24,1866,0.0020880749693915376
SIM,1840,17,30-34,1857,1
SIM,1772,85,na,1857,56
STAT,1930,18,15-19,1948,55.286177790983054
SIM,1866,88,na,1954,80
STAT,1839,103,na,1942,0.09569181236892854
SIM,1920,32,45-49,1952,2
STAT,1854,34,50-100,1888,0.661770770867756
STAT,1834,26,50-100,1860,0.5229742303071312
SIM,1914,29,na,1943,3779
STAT,1916,16,40-44,1932,0.28102474183935694
STAT,1858,110,na,1968,0.0021069743775280012
STAT,1886,65,na,1951,1686.7924018401395
SIM,1864,59,na,1923,1764
STAT,1922,38,50-100,1960,0.4508951556266508
SIM,1834,38,40-44,1872,6
SIM,1898,22,15-19,1920,4
STAT,1864,30,45-49,1894,1.4841626275343525
SIM,1951,15,na,1966,4065
SIM,1938,25,50-100,1963,1
SIM,1930,38,50-100,1968,2
STAT,1829,29,25-29,1858,46.305240249303594
SIM,1924,16,40-44,1940,1
STAT,1835,44,45-49,1879,1.090583261404156
SIM,1873,23,20-24,1896,61
STAT,1902,34,40-44,1936,3.291307023175463
SIM,1902,24,40-44,1926,2
STAT,1892,37,40-44,1929,5.178615536770594
SIM,1914,17,25-29,1931,9
STAT,1882,16,15-19,1898,5.468734617559828
STAT,1872,34,20-24,1906,2.541102751726203
SIM,1929,38,35-39,1967,9
STAT,1867,42,30-34,1909,1.0185007894882863
SIM,1831,43,50-100,1874,3
STAT,1844,28,15-19,1872,0.38710237059800057
STAT,1877,19,45-49,1896,0.06369334461626858
SIM,1828,46,na,1874,1362
STAT,1804,95,na,1899,4.505580345192997
SIM,1820,37,50-100,1857,1
STAT,1865,40,50-100,1905,0.9160566710606559
SIM,1925,18,15-19,1943,47
STAT,1913,37,20-24,1950,0.24570164879509818
STAT,1943,27,20-24,1970,18.364658409481724
SIM,1842,29,35-39,1871,10
SIM,1826,100,na,1926,1
STAT,1924,44,na,1968,4159.7819928123945
STAT,1829,56,na,1885,1286.905235764888
SIM,1929,25,na,1954,4523
SIM,1866,85,na,1951,188
SIM,1863,19,25-29,1882,9
STAT,1860,38,40-44,1898,3.3442002144065603
STAT,1892,15,30-34,1907,1.8943189496212312
STAT,1822,83,na,1905,205.05686112053095
SIM,1930,37,30-34,1967,1
STAT,1891,15,na,1906,2966.9292693839357
SIM,1833,24,30-34,1857,15
STAT,1886,46,15-19,1932,4.003828677229447E-4
STAT,1857,48,45-49,1905,0.17355273783407174
SIM,1941,28,40-44,1969,4
SIM,1811,80,na,1891,215
STAT,1859,100,na,1959,1.527755305689083
STAT,1922,37,30-34,1959,1.9592950908135205
STAT,1871,41,45-49,1912,1.4080107773048893
STAT,1907,26,40-44,1933,4.170509327736795
SIM,1841,25,na,1866,1895
STAT,1848,16,15-19,1864,5.331380920636641
SIM,1875,35,25-29,1910,3
STAT,1834,29,35-39,1863,7.719687919021357
STAT,1834,36,40-44,1870,3.4056103758438407
SIM,1860,94,na,1954,10
SIM,1869,36,45-49,1905,5
STAT,1855,19,25-29,1874,4.717455331971158
STAT,1804,50,45-49,1854,0.04492209764240526
STAT,1926,41,35-39,1967,0.23487935693061338
SIM,1852,65,na,1917,1279
SIM,1911,15,na,1926,3708
SIM,1865,9,na,1874,2383
SIM,1906,26,30-34,1932,36
STAT,1830,52,45-49,1882,0.00935520680082814
STAT,1854,47,15-19,1901,2.866946028191502E-4
SIM,1866,49,50-100,1915,3
STAT,1904,41,15-19,1945,0.0013051310037201563
STAT,1853,75,na,1928,763.4571395943744
STAT,1876,23,50-100,1899,0.39647090528565737
STAT,1865,17,50-100,1882,0.0433387919438529
SIM,1839,83,na,1922,262
STAT,1821,48,30-34,1869,0.1456659358932098
STAT,1867,35,25-29,1902,2.57810349945231
STAT,1893,9,na,1902,3109.9687813720116
STAT,1810,98,na,1908,1.471091574170754
STAT,1862,41,35-39,1903,1.4658248859437573
STAT,1939,25,40-44,1964,4.429958651373933
SIM,1880,12,na,1892,2652
SIM,1910,25,45-49,1935,1
SIM,1938,18,25-29,1956,43
STAT,1874,25,20-24,1899,11.403932804118321
SIM,1829,37,50-100,1866,1
STAT,1912,59,na,1971,3135.7089029048575
STAT,1885,47,45-49,1932,0.2210828018764392
SIM,1859,38,na,1897,1943
SIM,1895,26,45-49,1921,2
SIM,1939,30,30-34,1969,19
SIM,1915,26,40-44,1941,6
STAT,1839,46,35-39,1885,0.09633599355714681
STAT,1835,50,na,1885,1424.360166050594
STAT,1878,36,na,1914,2328.1435024899733
SIM,1923,34,na,1957,3983
STAT,1897,25,25-29,1922,53.806848587813306
STAT,1902,25,45-49,1927,1.4902407085518565
SIM,1870,41,35-39,1911,1
STAT,1882,53,20-24,1935,6.674410925466705E-4
SIM,1777,91,na,1868,9
SIM,1888,30,40-44,1918,3
STAT,1909,25,50-100,1934,0.9121770686639155
STAT,1880,77,na,1957,934.5467250084356
STAT,1821,40,35-39,1861,3.2096261968085544
STAT,1842,38,na,1880,1770.700277056866
STAT,1924,16,30-34,1940,13.747060786466264
SIM,1833,36,30-34,1869,6
STAT,1849,33,15-19,1882,0.10704609444650402
STAT,1884,30,na,1914,2245.6228488509723
SIM,1822,58,na,1880,1145
STAT,1900,16,45-49,1916,0.08582125290487988
STAT,1872,42,na,1914,2188.8247465165864
SIM,1784,79,na,1863,217
SIM,1864,50,na,1914,1969
STAT,1949,15,50-100,1964,0.41188987384697046
SIM,1889,11,na,1900,3053
STAT,1899,46,25-29,1945,0.0421829670165538
STAT,1868,48,20-24,1916,0.010687724334608174
STAT,1953,9,na,1962,4490.817371100881
SIM,1865,23,30-34,1888,15
SIM,1902,30,35-39,1932,20
STAT,1893,32,30-34,1925,20.92749689708051
SIM,1838,34,25-29,1872,14
SIM,1836,103,na,1939,1
SIM,1901,25,35-39,1926,16
STAT,1876,54,40-44,1930,0.009984807232172196
STAT,1903,24,15-19,1927,4.4062397493648975
STAT,1892,7,na,1899,3082.154045111695
SIM,1877,23,na,1900,2311
SIM,1911,24,15-19,1935,5
SIM,1932,16,30-34,1948,18
SIM,1879,35,25-29,1914,1
SIM,1877,26,na,1903,2339
STAT,1857,35,30-34,1892,4.00690323271885
STAT,1892,27,30-34,1919,29.79035830243731
STAT,1907,19,35-39,1926,0.7572330712267633
SIM,1878,70,na,1948,1378
STAT,1932,40,15-19,1972,0.0019717366099215195
STAT,1814,88,na,1902,56.64265346789522
STAT,1858,49,40-44,1907,0.12431601607216623
STAT,1826,76,na,1902,517.109152282133
STAT,1885,29,15-19,1914,0.42396350654168985
STAT,1917,18,15-19,1935,9.201419060429467
SIM,1882,26,35-39,1908,10
STAT,1830,35,50-100,1865,1.0009932577617773
STAT,1885,40,25-29,1925,0.6104834081710704
STAT,1849,40,20-24,1889,0.11647161457485564
SIM,1856,16,15-19,1872,6
STAT,1825,36,30-34,1861,7.106693919913459
SIM,1933,24,35-39,1957,13
STAT,1859,63,na,1922,1345.2307682013634
SIM,1902,38,30-34,1940,1
SIM,1915,19,35-39,1934,2
STAT,1898,50,na,1948,2793.1747511729013
SIM,1796,98,na,1894,2
STAT,1850,40,50-100,1890,0.7512492280493123
SIM,1860,60,na,1920,1577
STAT,1857,23,30-34,1880,15.204543307414395
STAT,1956,15,30-34,1971,15.242895341478286
SIM,1816,39,35-39,1855,13
SIM,1884,42,40-44,1926,4
STAT,1876,42,40-44,1918,2.190917701597473
STAT,1908,43,40-44,1951,0.21725227840420955
STAT,1899,34,25-29,1933,13.146684887231547
SIM,1916,31,40-44,1947,5
STAT,1809,51,40-44,1860,0.03724383758617551
STAT,1874,26,35-39,1900,9.3483158959768
STAT,1925,24,35-39,1949,10.582092447031613
SIM,1839,86,na,1925,145
STAT,1818,38,15-19,1856,0.17182648591655852
STAT,1845,45,15-19,1890,2.8456125107136337E-4
SIM,1939,23,25-29,1962,85
STAT,1860,26,40-44,1886,2.341326297761371
SIM,1864,24,25-29,1888,55
SIM,1880,15,na,1895,2602
SIM,1897,17,15-19,1914,6
STAT,1919,46,20-24,1965,0.01135168312829812
STAT,1937,17,na,1954,3382.263971902543
STAT,1805,103,na,1908,0.04805291476513021
STAT,1899,30,50-100,1929,1.1957185500242724
STAT,1888,24,50-100,1912,0.452249243541241
STAT,1914,42,20-24,1956,0.01652865116020822
STAT,1880,71,na,1951,1326.7897056282216
STAT,1870,36,45-49,1906,1.8541914026332762
STAT,1893,25,25-29,1918,51.04714741190538
STAT,1856,41,50-100,1897,0.7851992388100861
STAT,1916,18,na,1934,3860.864334927294
STAT,1936,32,na,1968,3469.7699136649708
SIM,1845,23,45-49,1868,1
SIM,1907,24,25-29,1931,74
STAT,1825,103,na,1928,0.08114254941252129
STAT,1807,52,50-100,1859,0.053477936232306955
STAT,1843,34,25-29,1877,8.701107392907991
STAT,1898,29,25-29,1927,53.70956070041965
SIM,1836,100,na,1936,2
STAT,1877,52,35-39,1929,0.008394678527369144
STAT,1921,48,35-39,1969,0.13693603466741003
STAT,1874,77,na,1951,834.5978728835232
STAT,1891,18,na,1909,2945.4708276648375
STAT,1893,20,30-34,1913,21.47747461298229
SIM,1920,36,25-29,1956,3
SIM,1848,35,30-34,1883,3
STAT,1901,17,40-44,1918,0.24185032782036492
STAT,1908,31,40-44,1939,3.5030242406831893
SIM,1854,60,na,1914,1481
STAT,1875,23,15-19,1898,3.1919346077420303
SIM,1851,34,25-29,1885,15
STAT,1898,24,30-34,1922,22.63622800131736
STAT,1835,41,40-44,1876,1.7032418717640059
STAT,1948,20,20-24,1968,120.70377338791046
STAT,1859,60,na,1919,1437.8695676619625
STAT,1911,16,20-24,1927,25.686662465795656
STAT,1930,31,15-19,1961,0.1567671045915736
STAT,1943,11,na,1954,3940.840983643486
SIM,1815,73,na,1888,482
SIM,1816,58,na,1874,1039
SIM,1924,24,25-29,1948,114
SIM,1876,40,25-29,1916,3
STAT,1859,50,25-29,1909,0.0027087853763675487
SIM,1850,37,45-49,1887,1
STAT,1909,30,na,1939,3436.0077627457877
STAT,1911,20,25-29,1931,83.23295989316085
STAT,1889,17,15-19,1906,6.921300430503266
SIM,1828,43,na,1871,1420
STAT,1934,33,40-44,1967,5.044274566782863
STAT,1826,41,30-34,1867,1.153953365498325
STAT,1905,40,20-24,1945,0.015207261160586492
STAT,1930,5,na,1935,4910.99290785275
SIM,1809,79,na,1888,302
SIM,1933,31,40-44,1964,8
STAT,1873,92,na,1965,113.15751656049513
SIM,1933,21,30-34,1954,44
STAT,1868,50,35-39,1918,0.007876762478081408
STAT,1886,62,na,1948,1824.3025932861874
STAT,1896,31,50-100,1927,1.1486370374868986
SIM,1859,29,45-49,1888,1
SIM,1847,19,na,1866,2010
STAT,1887,26,45-49,1913,1.1770569229787833
STAT,1934,15,50-100,1949,0.4809459197170417
STAT,1846,90,na,1936,55.58831227995458
STAT,1822,46,25-29,1868,0.08150935400428856
STAT,1861,31,40-44,1892,3.4159558147482882
SIM,1860,34,35-39,1894,12
SIM,1875,48,50-100,1923,7
STAT,1920,20,35-39,1940,9.948438496019675
STAT,1843,22,25-29,1865,51.84014687187029
STAT,1852,34,35-39,1886,7.8027547304275
SIM,1851,22,25-29,1873,53
STAT,1849,47,40-44,1896,0.12282409549675477
STAT,1856,18,30-34,1874,1.3862254065767177
STAT,1847,42,50-100,1889,0.7816606772048031
STAT,1789,79,na,1868,247.89991484211419
STAT,1925,31,40-44,1956,4.3931409764218365
SIM,1839,38,25-29,1877,3
SIM,1778,79,na,1857,247
STAT,1940,32,20-24,1972,2.384574694173759
STAT,1811,43,na,1854,1344.0194617745888
SIM,1910,19,15-19,1929,6
STAT,1914,33,50-100,1947,0.7827668312825274
SIM,1891,38,45-49,1929,3
STAT,1785,80,na,1865,245.69358259921978
SIM,1892,23,25-29,1915,81
STAT,1835,53,40-44,1888,0.006562821319226726
STAT,1896,55,na,1951,2581.6069871770555
STAT,1817,44,25-29,1861,1.4975017399676385
STAT,1867,24,50-100,1891,0.35944591989772423
SIM,1865,28,25-29,1893,41
STAT,1832,50,20-24,1882,4.8416696417325975E-4
STAT,1898,36,30-34,1934,6.848411506009083
SIM,1843,41,40-44,1884,4
STAT,1902,37,45-49,1939,0.5736224434454361
STAT,1951,21,40-44,1972,3.796438348295036
SIM,1843,20,na,1863,1944
STAT,1847,18,20-24,1865,16.184868559372493
SIM,1891,55,na,1946,2474
STAT,1862,39,20-24,1901,0.6149273039238705
SIM,1889,36,30-34,1925,6
STAT,1894,40,35-39,1934,2.2227418165221895
STAT,1934,21,40-44,1955,4.270017327598626
STAT,1880,47,25-29,1927,0.0569873861438618
SIM,1916,55,na,1971,3363
STAT,1912,36,25-29,1948,0.9120005764500025
STAT,1924,47,na,1971,4132.206301828175
STAT,1846,25,45-49,1871,0.9607953884099794
STAT,1863,47,25-29,1910,0.04760882758088165
STAT,1866,48,na,1914,1934.9643702879341
STAT,1902,19,15-19,1921,7.869206919715605
STAT,1857,28,25-29,1885,32.21663888899793
SIM,1891,39,50-100,1930,1
STAT,1884,35,25-29,1919,2.7133717146741896
SIM,1911,49,na,1960,3319
SIM,1825,32,25-29,1857,5
STAT,1907,5,na,1912,3636.049572429011
SIM,1855,18,20-24,1873,20
STAT,1920,28,30-34,1948,40.46425249012199
SIM,1942,21,40-44,1963,4
STAT,1836,35,na,1871,1694.9531929592365
STAT,1852,41,40-44,1893,1.716670122336156
SIM,1874,12,na,1886,2521
STAT,1841,41,50-100,1882,0.7607804842745576
SIM,1907,31,30-34,1938,13
STAT,1916,24,25-29,1940,90.86205768772321
STAT,1887,10,na,1897,2736.670417141178
SIM,1780,80,na,1860,214
SIM,1796,64,na,1860,803
STAT,1860,57,na,1917,1542.9136401310018
STAT,1884,23,25-29,1907,53.27591937629602
SIM,1875,42,30-34,1917,3
STAT,1885,18,na,1903,2370.8204942687134
SIM,1854,25,45-49,1879,4
STAT,1909,49,30-34,1958,0.07691126320594659
STAT,1851,26,30-34,1877,21.777837490534015
STAT,1866,11,na,1877,2355.9587220504113
SIM,1938,25,30-34,1963,38
STAT,1841,52,20-24,1893,5.021905033553931E-4
STAT,1856,24,25-29,1880,48.488301629123754
SIM,1860,48,50-100,1908,2
SIM,1903,36,25-29,1939,1
SIM,1834,34,25-29,1868,14
STAT,1815,106,na,1921,0.005196658465995511
STAT,1839,35,50-100,1874,0.9987951873501622
SIM,1891,15,20-24,1906,19
SIM,1839,33,30-34,1872,28
STAT,1931,26,na,1957,4571.11696838081
SIM,1875,30,30-34,1905,26
STAT,1816,47,45-49,1863,0.6213877517971851
STAT,1837,23,45-49,1860,0.5721204173542255
STAT,1816,51,50-100,1867,0.03883765548812323
STAT,1915,27,45-49,1942,1.664513686073666
SIM,1838,18,20-24,1856,15
SIM,1853,13,na,1866,2280
SIM,1923,27,45-49,1950,1
STAT,1841,50,na,1891,1494.3494058833237
STAT,1883,38,45-49,1921,1.8365490874888348
STAT,1826,34,25-29,1860,12.101076907369192
STAT,1890,30,50-100,1920,1.0667950373793746
STAT,1853,78,na,1931,579.442454015098
STAT,1791,80,na,1871,238.83488321506746
STAT,1931,30,20-24,1961,3.022820633506757
STAT,1909,41,35-39,1950,0.17890748105717638
STAT,1821,50,45-49,1871,0.022169512576902875
SIM,1897,37,35-39,1934,14
STAT,1903,45,na,1948,3054.5747813349208
STAT,1843,38,40-44,1881,3.320409603538208
SIM,1928,40,na,1968,4482
STAT,1849,43,25-29,1892,0.4595172967174724
STAT,1828,71,na,1899,757.7349421686789
SIM,1849,45,na,1894,1682
STAT,1872,15,45-49,1887,0.06288124982460173
STAT,1906,15,35-39,1921,0.7583162224361406
SIM,1846,19,25-29,1865,7
STAT,1898,49,45-49,1947,0.16668758866280212
STAT,1902,22,40-44,1924,2.778025901686893
SIM,1851,49,50-100,1900,4
SIM,1808,91,na,1899,19
SIM,1905,12,na,1917,3531
SIM,1942,18,15-19,1960,41
STAT,1861,28,15-19,1889,0.35593081621927436
STAT,1907,18,50-100,1925,0.0677965235584914
STAT,1926,27,20-24,1953,20.674372588426767
STAT,1897,19,30-34,1916,2.002919985371575
SIM,1846,31,na,1877,1826
SIM,1934,27,20-24,1961,27
SIM,1883,26,na,1909,2261
SIM,1908,26,na,1934,3281
STAT,1821,36,na,1857,1548.314601518122
STAT,1916,40,50-100,1956,0.11404410504218805
SIM,1798,90,na,1888,28
SIM,1887,84,na,1971,586
SIM,1902,2,na,1904,3554
SIM,1838,28,30-34,1866,23
SIM,1893,44,40-44,1937,1
SIM,1938,15,20-24,1953,128
SIM,1892,30,30-34,1922,27
SIM,1924,28,40-44,1952,5
STAT,1773,95,na,1868,1.703072709234063
STAT,1851,24,40-44,1875,1.7987284114750526
SIM,1861,79,na,1940,515
STAT,1890,30,na,1920,2778.408887129172
STAT,1893,44,na,1937,2742.3334826087557
STAT,1929,1,na,1930,5035.085591533541
STAT,1899,31,20-24,1930,3.513717091637845
SIM,1898,25,na,1923,3021
STAT,1930,38,35-39,1968,2.9775922956406804
SIM,1871,33,50-100,1904,3
STAT,1915,30,na,1945,3667.7468442412796
SIM,1873,16,15-19,1889,5
STAT,1838,19,25-29,1857,5.045176664863012
STAT,1833,25,35-39,1858,7.90465338729224
STAT,1939,27,30-34,1966,37.20759988724072
STAT,1882,18,40-44,1900,0.1676931390762138
STAT,1884,30,30-34,1914,16.430356093547424
SIM,1857,71,na,1928,1039
STAT,1930,25,20-24,1955,21.947216560472626
SIM,1932,19,35-39,1951,6
STAT,1860,23,na,1883,1858.3793320656118
SIM,1818,84,na,1902,118
SIM,1934,31,25-29,1965,12
SIM,1842,26,30-34,1868,26
STAT,1921,38,25-29,1959,1.0376301864494715
SIM,1855,30,45-49,1885,2
STAT,1874,16,50-100,1890,0.04741938115613353
STAT,1865,16,15-19,1881,5.280877763146061
SIM,1947,5,na,1952,4041
STAT,1912,26,15-19,1938,0.659313815747218
SIM,1865,38,35-39,1903,9
STAT,1862,89,na,1951,84.65610226253015
STAT,1814,44,50-100,1858,3.00322486740833
STAT,1895,48,15-19,1943,2.7466536860605855E-4
SIM,1851,38,40-44,1889,1
STAT,1853,37,20-24,1890,0.5716675726583456
STAT,1883,18,25-29,1901,5.232891309094374
SIM,1903,7,na,1910,3472
STAT,1839,49,na,1888,1489.773171459963
STAT,1819,94,na,1913,9.980787186007126
STAT,1859,54,40-44,1913,0.007718789626990333
SIM,1845,86,na,1931,154
STAT,1924,19,35-39,1943,4.695682000953592
STAT,1834,26,30-34,1860,20.587214838746128
STAT,1934,18,15-19,1952,57.83723644504556
SIM,1863,2,na,1865,2754
STAT,1863,49,15-19,1912,3.252297988122044E-4
SIM,1862,27,na,1889,2066
SIM,1929,16,25-29,1945,72
SIM,1947,2,na,1949,4098
STAT,1826,44,35-39,1870,1.7188261794679742
STAT,1842,17,25-29,1859,5.181917959764451
STAT,1842,37,45-49,1879,1.665282624440433
STAT,1885,15,na,1900,2388.092474328703
SIM,1911,28,30-34,1939,58
SIM,1869,18,15-19,1887,6
STAT,1925,21,30-34,1946,32.602511235474
STAT,1944,25,15-19,1969,0.7214090799941915
STAT,1870,19,na,1889,2332.426512977114
SIM,1942,26,35-39,1968,18
STAT,1893,35,35-39,1928,8.558230853233336
STAT,1913,47,30-34,1960,0.0821791753293629
STAT,1875,27,30-34,1902,24.43999117983116
STAT,1900,34,na,1934,3100.69808531598
SIM,1866,30,20-24,1896,2
STAT,1907,16,30-34,1923,2.216872662493513
SIM,1805,80,na,1885,222
SIM,1864,18,30-34,1882,5
SIM,1913,41,na,1954,3324
SIM,1896,31,45-49,1927,1
SIM,1829,40,45-49,1869,4
STAT,1825,39,35-39,1864,8.36182848570247
SIM,1878,26,45-49,1904,2
SIM,1879,52,na,1931,2104
STAT,1849,106,na,1955,0.008751618705780877
SIM,1834,44,35-39,1878,3
STAT,1903,28,30-34,1931,33.72617016300458
STAT,1832,42,50-100,1874,0.783724255820792
STAT,1871,39,30-34,1910,4.941145144269056
STAT,1829,109,na,1938,4.360882978996279E-4
STAT,1835,38,15-19,1873,0.04286830713795269
STAT,1856,18,50-100,1874,0.04260937883431014
SIM,1883,23,15-19,1906,7
SIM,1906,29,35-39,1935,16
STAT,1871,35,15-19,1906,0.05309065201374475
STAT,1934,26,35-39,1960,19.08806044725238
SIM,1906,24,40-44,1930,3
STAT,1874,23,30-34,1897,17.14517819701455
STAT,1818,53,40-44,1871,0.021145449061150443
STAT,1885,44,40-44,1929,2.088396847977606
STAT,1894,45,50-100,1939,0.1700336508422364
SIM,1915,16,30-34,1931,3
STAT,1908,28,15-19,1936,0.6280823387973221
STAT,1908,46,45-49,1954,0.18703988904138127
SIM,1883,27,30-34,1910,28
SIM,1856,36,35-39,1892,10
STAT,1821,39,na,1860,1508.3671838934806
SIM,1833,39,35-39,1872,12
STAT,1873,51,20-24,1924,7.109826270665655E-4
STAT,1883,15,20-24,1898,16.490527229220586
STAT,1832,76,na,1908,572.8556943908125
STAT,1918,44,na,1962,3717.8253979234205
SIM,1820,39,25-29,1859,1
SIM,1888,25,25-29,1913,55
SIM,1864,53,na,1917,1897
SIM,1875,32,20-24,1907,2
STAT,1911,19,25-29,1930,8.146418042168555
STAT,1792,68,na,1860,639.6314933950307
SIM,1826,106,na,1932,1
SIM,1850,17,25-29,1867,5
STAT,1865,63,na,1928,1531.7267640356558
STAT,1821,38,20-24,1859,1.5123200293355261
STAT,1847,75,na,1922,757.4665639876356
SIM,1879,39,40-44,1918,8
STAT,1923,32,50-100,1955,0.895494880746891
STAT,1941,17,45-49,1958,0.48603981374467004
STAT,1881,42,15-19,1923,0.012581044484448165
STAT,1860,22,25-29,1882,45.30707013746103
STAT,1889,24,20-24,1913,79.86757780249685
STAT,1825,100,na,1925,0.6002478669880109
STAT,1852,90,na,1942,59.900882679815254
SIM,1842,72,na,1914,843
STAT,1839,26,15-19,1865,0.38385858113033106
STAT,1904,48,35-39,1952,0.10564826297110547
SIM,1895,11,na,1906,3242
STAT,1866,21,15-19,1887,2.917825462394606
STAT,1900,31,na,1931,3140.2551098382282
STAT,1913,31,15-19,1944,0.12124734468142359
STAT,1857,38,35-39,1895,5.24143663821603
SIM,1874,21,15-19,1895,3
SIM,1914,15,35-39,1929,1
SIM,1897,24,20-24,1921,77
STAT,1888,31,45-49,1919,1.9540763664421432
SIM,1928,20,45-49,1948,2
SIM,1916,52,na,1968,3418
SIM,1948,22,20-24,1970,115
SIM,1860,31,30-34,1891,27
STAT,1841,17,40-44,1858,0.16139868048646708
STAT,1836,38,na,1874,1642.9673249298644
SIM,1929,26,35-39,1955,24
STAT,1816,83,na,1899,184.99458839639178
SIM,1833,98,na,1931,3
SIM,1924,22,35-39,1946,13
SIM,1884,47,50-100,1931,2
SIM,1891,28,35-39,1919,14
SIM,1893,40,25-29,1933,1
STAT,1870,101,na,1971,4.681916182614316
SIM,1834,31,20-24,1865,1
STAT,1876,47,50-100,1923,0.23840605816433882
STAT,1813,46,15-19,1859,0.0012306582495820672
STAT,1875,37,40-44,1912,4.248532923219491
STAT,1898,26,20-24,1924,15.053980499348105
STAT,1848,36,35-39,1884,5.305821147570254
SIM,1886,3,na,1889,2703
STAT,1873,20,45-49,1893,0.6726571137805427
STAT,1870,33,40-44,1903,3.9974255326732107
STAT,1893,22,20-24,1915,82.59961884871522
SIM,1871,38,na,1909,2259
SIM,1840,46,na,1886,1589
STAT,1894,38,20-24,1932,0.9321049015248097
STAT,1927,37,15-19,1964,0.022557557280251706
SIM,1842,22,15-19,1864,2
SIM,1939,20,20-24,1959,94
STAT,1920,30,45-49,1950,1.6414503498503406
SIM,1892,39,40-44,1931,7
SIM,1931,32,50-100,1963,1
STAT,1929,22,45-49,1951,1.344257754146932
SIM,1885,52,na,1937,2038
STAT,1925,34,45-49,1959,1.7632095249910575
STAT,1857,37,na,1894,1754.615825373026
STAT,1883,28,35-39,1911,8.902179144869997
STAT,1916,22,35-39,1938,9.320608417390245
SIM,1870,53,na,1923,1972
STAT,1852,31,30-34,1883,13.87810943904877
STAT,1808,46,40-44,1854,0.6626625380228656
STAT,1770,84,na,1854,73.0
STAT,1786,68,na,1854,663.9999999999999
STAT,1952,17,20-24,1969,153.4896083404837
SIM,1886,37,na,1923,2290
STAT,1875,22,na,1897,2295.3695974868215
STAT,1822,48,15-19,1870,5.500727750440647E-4
STAT,1862,51,45-49,1913,0.011750606735445056
SIM,1903,33,20-24,1936,5
SIM,1950,18,40-44,1968,1
SIM,1916,36,35-39,1952,6
SIM,1933,34,45-49,1967,1
SIM,1874,35,40-44,1909,4
SIM,1857,26,50-100,1883,1
SIM,1891,52,na,1943,2589
STAT,1834,22,15-19,1856,2.731083679403683
STAT,1942,18,40-44,1960,1.3803580140370368
STAT,1850,19,40-44,1869,0.15549967315153804
SIM,1938,28,35-39,1966,14
STAT,1869,22,45-49,1891,0.6376565030985815
STAT,1866,35,40-44,1901,3.8489671637028255
STAT,1859,103,na,1962,0.3604049098587147
STAT,1884,20,20-24,1904,64.71639486859084
STAT,1918,35,15-19,1953,0.01930245565077819
SIM,1837,22,40-44,1859,2
SIM,1848,97,na,1945,4
STAT,1880,37,15-19,1917,0.055817545849656085
STAT,1948,23,25-29,1971,100.16639044297064
STAT,1908,7,na,1915,3650.1844939334146
SIM,1865,38,na,1903,2008
STAT,1839,21,20-24,1860,59.46588889310758
SIM,1892,20,20-24,1912,74
STAT,1933,16,40-44,1949,1.773186994571903
STAT,1791,83,na,1874,126.59786437903122
STAT,1908,36,35-39,1944,2.1491473491397577
STAT,1917,48,45-49,1965,0.21385122649330357
SIM,1838,38,40-44,1876,6
SIM,1847,21,20-24,1868,59
STAT,1926,31,25-29,1957,10.565198906112936
SIM,1883,37,40-44,1920,5
STAT,1808,54,na,1862,1167.9111633344678
SIM,1841,25,35-39,1866,11
STAT,1899,41,30-34,1940,0.1038235424977542
STAT,1919,29,na,1948,3796.490004864642
SIM,1891,18,25-29,1909,8
STAT,1817,48,40-44,1865,0.37703258449067745
STAT,1836,49,20-24,1885,0.00772976269247276
STAT,1871,53,45-49,1924,0.013373280132222004
STAT,1831,45,20-24,1876,0.009052697193918918
SIM,1833,61,na,1894,1149
SIM,1834,46,na,1880,1470
STAT,1898,39,35-39,1937,1.932643994187935
STAT,1850,107,na,1957,0.005295220448635465
SIM,1831,32,na,1863,1663
SIM,1941,22,na,1963,3438
STAT,1922,43,25-29,1965,0.07731358164917915
SIM,1941,16,40-44,1957,2
STAT,1863,44,20-24,1907,0.13010035975290432
STAT,1892,25,40-44,1917,3.567814540808715
STAT,1838,110,na,1948,1.884692952433111E-4
STAT,1858,43,35-39,1901,1.3332519328349621
SIM,1901,20,40-44,1921,2
STAT,1801,84,na,1885,115.14363947579669
STAT,1866,31,25-29,1897,8.957653707120125
STAT,1856,32,45-49,1888,1.306040437685977
STAT,1897,29,40-44,1926,3.7575919220237153
SIM,1860,21,20-24,1881,64
SIM,1866,43,35-39,1909,3
SIM,1907,34,35-39,1941,9
SIM,1865,25,20-24,1890,11
SIM,1842,36,40-44,1878,5
SIM,1856,23,20-24,1879,66
SIM,1864,32,45-49,1896,1
STAT,1830,34,15-19,1864,0.11534548588466507
STAT,1847,30,45-49,1877,1.5381182730869818
STAT,1852,44,45-49,1896,1.1217570274311421
SIM,1822,44,50-100,1866,4
SIM,1898,31,50-100,1929,1
SIM,1924,1,na,1925,4605
STAT,1858,40,30-34,1898,0.861231333299892
STAT,1849,26,50-100,1875,0.550525074621701
SIM,1813,47,na,1860,1306
STAT,1872,32,50-100,1904,0.8687861458064075
SIM,1888,66,na,1954,1761
STAT,1827,47,20-24,1874,0.010513552723096134
STAT,1903,42,45-49,1945,0.13951306354793247
STAT,1848,23,20-24,1871,60.015283478199215
STAT,1822,43,20-24,1865,0.2332015562577619
SIM,1762,92,na,1854,8
STAT,1872,46,20-24,1918,0.011410733569287616
SIM,1783,91,na,1874,9
STAT,1904,35,20-24,1939,0.22755758056623976
SIM,1799,75,na,1874,374
SIM,1894,66,na,1960,2250
STAT,1826,31,20-24,1857,3.8046966556085984
SIM,1850,27,35-39,1877,12
SIM,1879,29,30-34,1908,25
SIM,1893,46,50-100,1939,1
STAT,1860,104,na,1964,0.242282791740632
STAT,1888,29,na,1917,2644.3484660063127
STAT,1907,41,50-100,1948,0.10224818065561762
STAT,1952,1,na,1953,4585.288729695327
STAT,1848,23,na,1871,1862.0766347173314
STAT,1889,37,35-39,1926,8.248950302702534
STAT,1867,45,35-39,1912,0.12541808960735484
SIM,1910,22,40-44,1932,5
SIM,1940,31,50-100,1971,1
STAT,1916,28,40-44,1944,4.536642022172355
STAT,1854,23,na,1877,1796.0498152231048
STAT,1884,39,40-44,1923,4.045443210992498
STAT,1877,88,na,1965,299.5547507105403
STAT,1935,29,20-24,1964,23.481873472318114
SIM,1904,67,na,1971,2455
STAT,1851,29,35-39,1880,8.166141476392395
STAT,1825,34,40-44,1859,6.364053390416544
STAT,1833,24,na,1857,1717.7862694642984
SIM,1833,34,40-44,1867,4
STAT,1856,89,na,1945,77.7284693478192
STAT,1885,46,50-100,1931,0.23180993855939933
STAT,1906,59,na,1965,2866.84473024295
SIM,1829,30,35-39,1859,7
STAT,1934,36,45-49,1970,0.889511234444971
STAT,1869,22,na,1891,2162.687464229431
STAT,1785,83,na,1868,130.23341661814686
STAT,1879,17,20-24,1896,17.505720663717742
SIM,1778,76,na,1854,325
SIM,1873,67,na,1940,1506
STAT,1857,25,20-24,1882,9.12988829605087
STAT,1932,31,50-100,1963,1.0389405258198847
