Source,YOB,Age,NPA,Date,freq
SIM,1930,26,45-49,1956,7
SIM,1896,0,na,1896,3751
STAT,1868,71,na,1939,1300.5861373136172
SIM,1875,18,na,1893,2531
SIM,1921,20,35-39,1941,13
STAT,1839,17,35-39,1856,0.4953799348681599
STAT,1876,90,na,1966,221.83637733718734
STAT,1906,62,na,1968,2995.525527383123
STAT,1890,48,20-24,1938,0.008337133330939196
SIM,1867,4,na,1871,2621
STAT,1810,57,na,1867,1048.412730244946
SIM,1905,65,na,1970,2903
SIM,1859,55,na,1914,1921
SIM,1907,17,30-34,1924,5
SIM,1931,19,15-19,1950,67
STAT,1838,30,15-19,1868,0.13274732852864732
SIM,1863,60,na,1923,1577
STAT,1871,18,50-100,1889,0.04953375536774163
SIM,1867,74,na,1941,834
SIM,1901,51,na,1952,3340
SIM,1910,27,30-34,1937,61
STAT,1784,99,na,1883,0.3057512218550576
SIM,1941,16,na,1957,3693
STAT,1917,14,na,1931,4322.920311825913
SIM,1839,40,25-29,1879,4
STAT,1898,31,25-29,1929,14.187954594935508
STAT,1927,35,35-39,1962,3.0729190349999476
SIM,1902,49,50-100,1951,1
STAT,1934,25,25-29,1959,90.37619954258619
STAT,1925,27,25-29,1952,79.31535100066085
SIM,1907,9,na,1916,3962
STAT,1925,33,na,1958,4579.263141535539
SIM,1884,2,na,1886,3306
SIM,1909,25,40-44,1934,2
SIM,1933,27,25-29,1960,95
STAT,1907,36,20-24,1943,0.25041937936612657
SIM,1886,35,50-100,1921,2
SIM,1888,68,na,1956,1705
STAT,1902,27,30-34,1929,36.227826780660614
STAT,1855,21,na,1876,1950.3431777040319
STAT,1859,35,na,1894,1937.679099969846
STAT,1829,32,15-19,1861,0.13286159821986557
SIM,1860,40,50-100,1900,2
SIM,1872,47,50-100,1919,1
STAT,1942,24,20-24,1966,118.86589703732703
SIM,1797,62,na,1859,884
SIM,1906,38,20-24,1944,1
STAT,1913,20,35-39,1933,9.363580733857857
STAT,1922,26,45-49,1948,2.0015420760774383
SIM,1833,62,na,1895,1196
SIM,1915,36,20-24,1951,1
SIM,1858,41,50-100,1899,2
SIM,1924,7,na,1931,4951
STAT,1931,24,45-49,1955,1.478986695135697
STAT,1916,34,20-24,1950,2.5478340634093017
SIM,1876,35,na,1911,2764
SIM,1869,23,20-24,1892,73
SIM,1914,26,na,1940,3782
SIM,1940,17,15-19,1957,37
STAT,1932,17,15-19,1949,61.285416950288095
SIM,1912,22,35-39,1934,10
SIM,1821,40,50-100,1861,1
STAT,1893,70,na,1963,2036.7483528254468
STAT,1815,88,na,1903,70.98597294641668
STAT,1918,42,30-34,1960,0.13871131391527963
SIM,1844,53,50-100,1897,2
STAT,1900,19,20-24,1919,24.932821825633056
STAT,1844,69,na,1913,1137.2160786323468
STAT,1923,19,15-19,1942,54.08135093872277
STAT,1909,44,30-34,1953,0.12045667406085953
SIM,1846,24,50-100,1870,4
SIM,1875,93,na,1968,135
STAT,1896,23,15-19,1919,4.43121649674205
SIM,1904,25,50-100,1929,2
STAT,1909,31,25-29,1940,9.031973876268095
STAT,1852,88,na,1940,110.59588528723067
SIM,1924,34,20-24,1958,3
SIM,1970,1,na,1971,4999
SIM,1875,20,40-44,1895,2
STAT,1907,23,15-19,1930,4.926295635717118
STAT,1940,30,50-100,1970,0.873943735126843
STAT,1941,15,15-19,1956,47.715530604758506
SIM,1832,36,50-100,1868,6
SIM,1858,38,na,1896,1935
STAT,1787,105,na,1892,0.013336884887357004
STAT,1912,41,25-29,1953,0.07066295962270464
SIM,1854,24,na,1878,2070
STAT,1849,24,40-44,1873,1.9279663695091325
STAT,1826,40,na,1866,1623.5601928716294
STAT,1904,22,35-39,1926,8.531856008120197
SIM,1860,6,na,1866,2452
STAT,1924,48,15-19,1972,4.4618833411471824E-4
STAT,1801,96,na,1897,3.063703820380412
SIM,1927,38,50-100,1965,2
STAT,1958,3,na,1961,5268.970550648907
STAT,1855,101,na,1956,0.5283648604818165
SIM,1850,10,na,1860,2296
SIM,1825,43,na,1868,1515
SIM,1829,57,na,1886,1096
SIM,1865,30,25-29,1895,14
SIM,1917,39,35-39,1956,5
SIM,1919,24,50-100,1943,1
STAT,1867,15,45-49,1882,0.06471667188369871
STAT,1829,101,na,1930,0.3795125311094382
STAT,1901,18,25-29,1919,8.062856599008263
STAT,1929,7,na,1936,5203.143995979339
SIM,1941,5,na,1946,4008
STAT,1943,23,25-29,1966,100.23178044125312
SIM,1915,23,15-19,1938,5
STAT,1867,20,40-44,1887,2.033041027142223
STAT,1920,18,35-39,1938,4.791735132836157
SIM,1836,34,50-100,1870,1
SIM,1884,54,na,1938,2171
SIM,1953,3,na,1956,4776
STAT,1841,48,25-29,1889,0.04217806454284003
STAT,1942,13,na,1955,4187.452317257821
SIM,1934,36,30-34,1970,4
SIM,1880,40,na,1920,2318
SIM,1939,28,30-34,1967,50
STAT,1838,41,na,1879,1829.8817708173212
STAT,1903,26,35-39,1929,14.040553683114364
STAT,1905,34,45-49,1939,1.462633357578736
SIM,1884,22,na,1906,2499
STAT,1899,18,45-49,1917,0.09101447570573025
STAT,1855,22,15-19,1877,2.9876751554305905
STAT,1848,15,35-39,1863,0.5350309368704909
SIM,1926,17,40-44,1943,1
STAT,1809,60,na,1869,1277.0380914317207
SIM,1863,22,15-19,1885,8
STAT,1929,43,45-49,1972,0.21948282432657748
SIM,1887,46,50-100,1933,3
SIM,1935,35,35-39,1970,5
STAT,1827,89,na,1916,67.89812187461285
STAT,1920,23,30-34,1943,32.506411566389104
STAT,1922,31,40-44,1953,4.530036366268065
STAT,1857,30,25-29,1887,8.383158815939176
SIM,1917,31,25-29,1948,2
SIM,1888,36,na,1924,2746
SIM,1912,35,40-44,1947,4
SIM,1905,36,50-100,1941,1
STAT,1904,35,40-44,1939,1.3945459285460793
SIM,1892,73,na,1965,2067
SIM,1850,42,na,1892,1733
SIM,1857,24,40-44,1881,4
SIM,1839,20,30-34,1859,27
STAT,1910,33,15-19,1943,0.12584019821579864
SIM,1911,26,35-39,1937,23
SIM,1847,22,30-34,1869,30
STAT,1878,15,20-24,1893,18.912704961251617
STAT,1765,96,na,1861,0.5111702954528634
STAT,1912,21,30-34,1933,28.183581215181714
STAT,1926,36,30-34,1962,2.2743911626092594
SIM,1822,78,na,1900,373
SIM,1916,35,25-29,1951,1
SIM,1863,92,na,1955,1
STAT,1934,30,20-24,1964,3.400066166466771
STAT,1917,46,na,1963,3925.669776222744
STAT,1938,18,20-24,1956,136.38073540839
SIM,1902,20,25-29,1922,105
SIM,1950,19,25-29,1969,56
STAT,1944,27,35-39,1971,16.55545662130613
STAT,1913,32,na,1945,3838.7291600258905
SIM,1884,30,35-39,1914,13
STAT,1942,19,25-29,1961,46.17273600287766
SIM,1902,45,25-29,1947,1
SIM,1856,90,na,1946,51
SIM,1909,29,50-100,1938,1
SIM,1929,18,20-24,1947,172
SIM,1930,32,na,1962,5408
SIM,1925,38,30-34,1963,1
STAT,1932,20,45-49,1952,1.5145704533890803
STAT,1831,94,na,1925,13.467042651815511
SIM,1863,17,na,1880,2310
STAT,1914,32,45-49,1946,1.6161001603426053
STAT,1950,15,50-100,1965,0.45218166306948016
STAT,1915,25,15-19,1940,0.7397637732415869
STAT,1822,58,na,1880,1245.7661169243959
STAT,1910,16,25-29,1926,8.779243942000699
STAT,1919,41,35-39,1960,0.22300535392505108
STAT,1839,90,na,1929,54.41141026174959
SIM,1896,30,50-100,1926,7
STAT,1954,14,na,1968,4951.38848740341
STAT,1858,17,45-49,1875,0.061731625470611916
STAT,1894,2,na,1896,3497.9275142836163
STAT,1944,18,50-100,1962,0.41122349091907945
STAT,1917,30,20-24,1947,2.627479192810489
SIM,1937,33,50-100,1970,2
STAT,1944,15,40-44,1959,1.5365404306739934
STAT,1877,4,na,1881,3060.0896348243864
SIM,1905,32,45-49,1937,2
SIM,1936,31,35-39,1967,12
STAT,1897,52,na,1949,2921.4444181082863
STAT,1903,39,40-44,1942,1.3563913156464642
STAT,1922,9,na,1931,4700.912963054198
STAT,1908,35,25-29,1943,0.9489625073303921
STAT,1934,38,30-34,1972,2.562303755918461
SIM,1887,19,na,1906,2967
SIM,1911,23,30-34,1934,41
SIM,1920,21,30-34,1941,46
STAT,1899,23,40-44,1922,2.9020227592970804
SIM,1793,80,na,1873,144
STAT,1917,38,30-34,1955,1.9222565226261659
SIM,1907,37,25-29,1944,4
SIM,1880,72,na,1952,1118
SIM,1884,86,na,1970,429
STAT,1905,13,na,1918,3799.028139652144
STAT,1772,98,na,1870,0.30855198531785466
STAT,1848,20,30-34,1868,17.10374485967295
STAT,1927,40,30-34,1967,0.16401033663006867
STAT,1839,22,30-34,1861,15.79511804504443
STAT,1871,46,45-49,1917,0.23916091262832478
STAT,1909,27,na,1936,3651.3006828118946
STAT,1813,97,na,1910,2.3102111087055603
STAT,1940,22,45-49,1962,1.1693248854394713
SIM,1894,32,na,1926,3164
SIM,1804,81,na,1885,225
STAT,1882,49,25-29,1931,0.056052024683053044
STAT,1889,33,na,1922,2994.4047295974137
STAT,1933,26,20-24,1959,24.728991659162343
STAT,1927,24,na,1951,4560.807983590757
STAT,1919,49,45-49,1968,0.23914926493689934
SIM,1898,25,40-44,1923,5
SIM,1935,15,40-44,1950,5
STAT,1885,83,na,1968,733.3248486532274
STAT,1923,22,45-49,1945,1.3357697929448016
STAT,1864,20,15-19,1884,3.0847459253292313
STAT,1865,49,25-29,1914,0.05221847100222065
STAT,1924,23,15-19,1947,6.388687626581605
SIM,1868,48,na,1916,2196
SIM,1952,15,40-44,1967,1
STAT,1913,28,45-49,1941,1.7499314717523693
SIM,1833,47,50-100,1880,1
STAT,1845,43,na,1888,1815.5512175247814
SIM,1904,33,40-44,1937,3
SIM,1941,26,20-24,1967,2
SIM,1872,53,na,1925,2205
SIM,1925,25,25-29,1950,116
STAT,1908,40,20-24,1948,0.016850278821161243
SIM,1843,40,na,1883,1838
SIM,1921,33,40-44,1954,13
STAT,1869,25,20-24,1894,11.632794175278498
STAT,1912,29,40-44,1941,4.652216546382827
SIM,1942,25,25-29,1967,108
SIM,1902,33,30-34,1935,12
STAT,1889,65,na,1954,2129.595496856696
SIM,1899,24,45-49,1923,1
STAT,1826,72,na,1898,736.5716860654549
STAT,1837,24,na,1861,1839.434330312252
SIM,1876,67,na,1943,1730
STAT,1806,105,na,1911,0.01041863004826137
STAT,1885,51,na,1936,2201.994011028299
STAT,1918,37,35-39,1955,2.601620575118466
SIM,1893,20,35-39,1913,1
SIM,1906,25,15-19,1931,1
STAT,1913,33,40-44,1946,3.9552092638274017
SIM,1922,45,na,1967,4268
SIM,1901,16,25-29,1917,13
STAT,1859,21,45-49,1880,0.6524228784849125
STAT,1927,15,40-44,1942,1.7822923866126346
STAT,1920,43,25-29,1963,0.08035642951474233
STAT,1930,40,50-100,1970,0.15808931861789555
SIM,1920,29,40-44,1949,4
SIM,1847,17,35-39,1864,1
SIM,1842,31,50-100,1873,1
SIM,1872,20,15-19,1892,3
STAT,1810,54,30-34,1864,0.017123102047669782
SIM,1922,13,na,1935,4669
STAT,1903,43,25-29,1946,0.064199621826406
STAT,1940,19,15-19,1959,46.977345616425666
SIM,1839,35,na,1874,1923
SIM,1901,29,30-34,1930,42
SIM,1925,30,20-24,1955,1
SIM,1926,37,35-39,1963,5
STAT,1930,20,35-39,1950,12.376026242306517
SIM,1931,22,45-49,1953,1
STAT,1818,53,na,1871,1297.2928450960765
STAT,1846,60,na,1906,1363.8656942106295
SIM,1835,21,na,1856,1876
STAT,1861,33,50-100,1894,0.7691065180850047
SIM,1887,23,15-19,1910,3
SIM,1901,21,20-24,1922,148
SIM,1902,28,35-39,1930,16
STAT,1800,79,na,1879,346.60610652099825
STAT,1875,17,45-49,1892,0.06839335867917846
STAT,1780,85,na,1865,77.65359459361134
STAT,1876,15,na,1891,2672.9090031253495
STAT,1822,106,na,1928,0.007059712797702132
SIM,1789,75,na,1864,439
SIM,1900,17,20-24,1917,25
STAT,1939,25,na,1964,3845.165458164455
SIM,1926,27,na,1953,4748
STAT,1930,28,45-49,1958,2.239403357063237
STAT,1810,49,35-39,1859,0.4249257059954088
STAT,1858,22,40-44,1880,1.9342376355518023
STAT,1860,45,30-34,1905,0.08092152939271859
STAT,1917,25,25-29,1942,70.91924404490497
SIM,1848,71,na,1919,925
SIM,1946,18,20-24,1964,144
STAT,1877,32,na,1909,2524.92222917319
SIM,1866,22,40-44,1888,1
STAT,1876,30,35-39,1906,10.753901007601417
STAT,1935,11,na,1946,5532.165814041073
STAT,1808,54,50-100,1862,0.03455912001821716
STAT,1908,48,30-34,1956,0.08198196277049198
STAT,1924,36,20-24,1960,0.31742677785737355
SIM,1938,28,na,1966,3714
STAT,1926,44,30-34,1970,0.16024936612386198
STAT,1907,3,na,1910,3959.87626016973
SIM,1916,27,25-29,1943,94
SIM,1934,14,na,1948,5631
SIM,1856,40,25-29,1896,4
STAT,1910,21,20-24,1931,106.82343840904542
SIM,1904,48,na,1952,3385
STAT,1835,103,na,1938,0.10692814568894539
SIM,1864,33,50-100,1897,1
STAT,1851,39,na,1890,1924.1594141477735
STAT,1835,76,na,1911,705.8781411702225
SIM,1854,32,15-19,1886,3
STAT,1875,22,40-44,1897,2.1817700563109867
SIM,1904,20,35-39,1924,8
STAT,1891,39,25-29,1930,3.5998211487595198
STAT,1855,30,15-19,1885,0.11476280735355383
STAT,1902,31,15-19,1933,0.20571140479486716
SIM,1868,16,na,1884,2563
SIM,1889,31,25-29,1920,4
SIM,1857,27,45-49,1884,2
STAT,1858,18,na,1876,2156.4813441116635
SIM,1885,71,na,1956,1430
STAT,1914,24,45-49,1938,1.1655155310216763
SIM,1881,9,na,1890,2384
STAT,1916,46,15-19,1962,3.865273195585388E-4
STAT,1931,21,40-44,1952,4.460931393710118
SIM,1834,36,na,1870,1772
SIM,1918,35,35-39,1953,1
STAT,1904,38,45-49,1942,0.6259724025888658
STAT,1864,20,50-100,1884,0.3813036193392872
STAT,1942,27,25-29,1969,70.48041448093758
SIM,1848,21,35-39,1869,12
SIM,1930,23,40-44,1953,6
STAT,1809,103,na,1912,0.07322009187480362
STAT,1848,40,25-29,1888,0.5114951427036476
STAT,1922,43,35-39,1965,0.2354611089561618
SIM,1802,58,na,1860,987
SIM,1872,16,30-34,1888,2
STAT,1846,32,15-19,1878,0.12034809650251649
SIM,1920,37,40-44,1957,1
SIM,1829,31,50-100,1860,1
SIM,1892,32,50-100,1924,1
STAT,1920,35,25-29,1955,1.1020338822795765
SIM,1948,18,30-34,1966,22
SIM,1932,23,15-19,1955,7
STAT,1930,42,30-34,1972,0.17156215970546196
STAT,1885,20,35-39,1905,5.974664685489085
SIM,1826,60,na,1886,1229
SIM,1888,23,30-34,1911,32
SIM,1851,91,na,1942,8
STAT,1861,49,40-44,1910,0.14130295136094836
STAT,1886,9,na,1895,2801.716213463337
SIM,1931,30,45-49,1961,2
STAT,1849,27,45-49,1876,1.0218148265706528
SIM,1891,56,na,1947,2586
STAT,1901,43,15-19,1944,0.0013581824333203712
STAT,1922,23,40-44,1945,3.9221978249610947
SIM,1855,20,15-19,1875,3
STAT,1879,87,na,1966,410.58272876587876
STAT,1875,73,na,1948,1243.5896886253838
STAT,1864,16,30-34,1880,1.6532738469044015
STAT,1913,45,35-39,1958,0.12898258441923013
STAT,1928,31,35-39,1959,11.662051542013517
SIM,1821,61,na,1882,1071
STAT,1935,37,35-39,1972,3.4491501958910975
STAT,1921,22,35-39,1943,10.852484358209868
SIM,1898,46,na,1944,3487
STAT,1860,0,na,1860,3212.2652083242447
STAT,1896,35,na,1931,3204.480993871188
STAT,1812,49,45-49,1861,0.5397088574950336
SIM,1858,20,40-44,1878,5
STAT,1907,19,30-34,1926,2.374632925157568
STAT,1905,31,40-44,1936,3.683831488668575
STAT,1829,45,50-100,1874,0.20395117658489587
STAT,1933,22,50-100,1955,0.8900970840083601
SIM,1898,28,45-49,1926,4
STAT,1910,29,30-34,1939,38.31438177698571
STAT,1892,21,na,1913,3032.9903083351037
STAT,1902,22,25-29,1924,82.3561416436204
SIM,1846,26,30-34,1872,6
STAT,1802,108,na,1910,5.812159746346999E-4
STAT,1904,30,35-39,1934,14.925453413814438
STAT,1948,24,15-19,1972,6.231618751172629
SIM,1875,23,45-49,1898,2
STAT,1900,5,na,1905,3705.4511479793605
SIM,1902,3,na,1905,3868
SIM,1922,24,45-49,1946,2
STAT,1829,37,na,1866,1823.3309906013287
STAT,1884,34,na,1918,2387.8419621409275
SIM,1846,22,15-19,1868,2
STAT,1867,23,45-49,1890,0.665783334618077
SIM,1915,19,30-34,1934,6
STAT,1903,23,30-34,1926,25.750926430004988
STAT,1850,27,50-100,1877,0.5662523374085914
STAT,1888,48,na,1936,2679.7581910786453
STAT,1881,69,na,1950,1447.404879644538
SIM,1910,22,25-29,1932,142
STAT,1918,45,35-39,1963,0.140669868739672
STAT,1923,30,45-49,1953,1.855374088390498
SIM,1879,25,30-34,1904,36
SIM,1900,27,50-100,1927,3
STAT,1922,34,45-49,1956,1.8052776090688796
SIM,1869,26,25-29,1895,43
STAT,1773,83,na,1856,125.09859959
SIM,1912,38,45-49,1950,1
STAT,1777,97,na,1874,1.1164032942707112
STAT,1854,25,50-100,1879,0.5721999645469452
SIM,1826,92,na,1918,14
STAT,1841,45,20-24,1886,0.009131405074923606
STAT,1824,48,25-29,1872,0.0662283584218397
STAT,1888,21,15-19,1909,3.9907016363762313
SIM,1854,38,50-100,1892,1
SIM,1924,37,25-29,1961,2
SIM,1951,20,20-24,1971,149
SIM,1917,34,na,1951,3871
STAT,1925,24,20-24,1949,134.94391128959174
SIM,1913,20,na,1933,3872
STAT,1928,39,45-49,1967,0.8769257611811709
STAT,1830,45,45-49,1875,0.20100927768558305
SIM,1912,30,35-39,1942,4
STAT,1838,26,30-34,1864,23.70620190806624
STAT,1918,17,40-44,1935,0.3116963477094414
SIM,1869,37,50-100,1906,1
STAT,1880,20,na,1900,2550.529794294741
STAT,1937,15,50-100,1952,0.3735040440163149
STAT,1852,56,na,1908,1643.1325051133063
STAT,1829,40,15-19,1869,0.01190874464619087
STAT,1943,28,30-34,1971,42.55448937206598
STAT,1933,34,20-24,1967,3.3479120844896584
SIM,1900,34,na,1934,3377
STAT,1916,37,25-29,1953,1.0289457806145863
SIM,1896,21,15-19,1917,2
STAT,1814,51,50-100,1865,0.043954552105226606
STAT,1943,20,20-24,1963,120.78257047243761
STAT,1908,27,25-29,1935,63.98720500376094
STAT,1911,42,20-24,1953,0.017193512805447266
STAT,1896,31,15-19,1927,0.1926575866413294
SIM,1903,4,na,1907,3776
SIM,1933,24,20-24,1957,140
STAT,1933,38,15-19,1971,0.026647768046330154
SIM,1930,34,45-49,1964,4
STAT,1921,51,na,1972,4172.324527909272
STAT,1934,7,na,1941,5513.840775850347
STAT,1904,27,40-44,1931,4.379711619407914
STAT,1903,40,20-24,1943,0.016154228523477563
SIM,1870,94,na,1964,38
STAT,1865,6,na,1871,2615.7318340481106
STAT,1840,49,20-24,1889,0.008487593916376246
SIM,1871,36,50-100,1907,1
SIM,1887,27,30-34,1914,3
STAT,1839,15,na,1854,2096.977209423782
STAT,1935,21,25-29,1956,128.31709709029613
SIM,1943,21,25-29,1964,106
SIM,1897,72,na,1969,1974
STAT,1820,48,40-44,1868,0.30772853171451964
STAT,1872,39,15-19,1911,0.056836241772512355
STAT,1900,42,45-49,1942,0.14677054193629435
STAT,1952,17,40-44,1969,1.7098815010384525
STAT,1909,39,35-39,1948,2.3114151975466637
SIM,1919,25,na,1944,4223
STAT,1798,59,na,1857,1212.7608403052814
SIM,1918,43,35-39,1961,1
STAT,1879,27,30-34,1906,26.852844735228057
STAT,1851,104,na,1955,0.05502869311169024
STAT,1856,70,na,1926,1123.5867341196588
SIM,1915,11,na,1926,4570
STAT,1907,44,20-24,1951,0.016296173341217742
STAT,1944,24,30-34,1968,31.639344600388863
SIM,1842,23,na,1865,1992
SIM,1854,56,na,1910,1755
SIM,1903,24,35-39,1927,11
STAT,1934,17,25-29,1951,59.77579919524539
SIM,1917,23,25-29,1940,102
STAT,1864,57,na,1921,1822.9007332267677
STAT,1913,41,40-44,1954,0.25026938669467047
STAT,1860,43,na,1903,1899.226681163857
SIM,1840,75,na,1915,631
SIM,1877,84,na,1961,459
SIM,1909,47,na,1956,3297
STAT,1860,22,50-100,1882,0.3479492654819647
SIM,1905,33,na,1938,3433
SIM,1846,37,na,1883,1968
SIM,1897,16,35-39,1913,1
STAT,1764,109,na,1873,0.005068732166637106
SIM,1888,7,na,1895,3094
STAT,1797,74,na,1871,469.99497736147345
STAT,1872,22,15-19,1894,3.373019988837403
SIM,1869,18,25-29,1887,7
SIM,1781,79,na,1860,248
STAT,1850,38,25-29,1888,2.1773153844221413
STAT,1858,30,40-44,1888,3.5820600324159226
STAT,1848,23,35-39,1871,5.48352416444425
STAT,1925,32,20-24,1957,2.9551395443866353
SIM,1847,54,na,1901,1409
SIM,1838,24,30-34,1862,23
SIM,1932,28,20-24,1960,26
SIM,1934,19,40-44,1953,1
SIM,1838,93,na,1931,14
SIM,1916,49,na,1965,3799
STAT,1821,52,40-44,1873,0.015931186202859805
STAT,1871,16,na,1887,2583.8892744619693
SIM,1912,27,40-44,1939,7
SIM,1853,39,na,1892,1911
SIM,1877,17,20-24,1894,31
SIM,1900,25,20-24,1925,1
SIM,1912,35,na,1947,3879
STAT,1869,17,20-24,1886,17.70277132933495
STAT,1897,15,30-34,1912,2.18419740735221
STAT,1929,35,45-49,1964,0.8942122923663676
SIM,1775,83,na,1858,64
SIM,1898,20,35-39,1918,13
SIM,1879,32,50-100,1911,1
SIM,1925,33,25-29,1958,5
STAT,1889,16,35-39,1905,0.6931505499690069
STAT,1808,75,na,1883,380.9386573645623
STAT,1785,84,na,1869,109.24220452143344
SIM,1829,25,na,1854,1705
STAT,1789,98,na,1887,0.4833258972647084
SIM,1844,89,na,1933,46
SIM,1848,30,25-29,1878,17
STAT,1917,33,25-29,1950,9.83514193465039
STAT,1804,61,na,1865,961.6188958047438
SIM,1913,31,40-44,1944,5
STAT,1924,28,20-24,1952,21.607783267132913
STAT,1926,19,40-44,1945,1.7400792945016064
SIM,1856,23,35-39,1879,14
SIM,1787,84,na,1871,103
SIM,1907,34,20-24,1941,1
STAT,1912,37,40-44,1949,1.4904870244203028
STAT,1934,26,na,1960,5141.588612594401
STAT,1889,41,25-29,1930,0.8128715790034334
SIM,1918,18,45-49,1936,1
SIM,1867,30,35-39,1897,3
STAT,1916,29,25-29,1945,68.95338727783395
STAT,1898,7,na,1905,3594.2254333343894
STAT,1868,16,15-19,1884,5.922008934202607
STAT,1893,30,50-100,1923,1.1952872171549933
STAT,1914,41,35-39,1955,0.20387305937599104
STAT,1930,12,na,1942,5224.605922990051
SIM,1878,21,20-24,1899,98
SIM,1818,73,na,1891,531
SIM,1904,36,45-49,1940,2
SIM,1942,17,25-29,1959,69
STAT,1919,46,40-44,1965,0.17494126514072886
SIM,1908,29,40-44,1937,6
SIM,1926,34,30-34,1960,35
STAT,1868,50,50-100,1918,0.014927095743880296
SIM,1843,42,50-100,1885,5
SIM,1924,29,25-29,1953,4
STAT,1934,33,50-100,1967,1.1504917977077744
SIM,1873,70,na,1943,1390
STAT,1950,18,20-24,1968,163.49045816609222
STAT,1882,46,20-24,1928,0.011960383987609369
STAT,1930,25,40-44,1955,6.050005675216304
STAT,1862,53,40-44,1915,0.008995423158978907
STAT,1860,48,35-39,1908,0.11442395983005199
STAT,1849,68,na,1917,1186.4322704485699
STAT,1911,25,30-34,1936,39.24144258192561
STAT,1830,77,na,1907,546.8076817540453
SIM,1869,33,na,1902,2397
STAT,1908,44,15-19,1952,0.0014310241532408288
STAT,1816,62,na,1878,969.494069263615
SIM,1839,67,na,1906,1111
STAT,1839,40,50-100,1879,0.8663615990522339
SIM,1925,21,50-100,1946,1
STAT,1936,33,35-39,1969,9.047619357226008
SIM,1849,25,45-49,1874,2
SIM,1886,15,20-24,1901,18
STAT,1915,17,15-19,1932,9.692686792817716
SIM,1836,19,25-29,1855,10
SIM,1899,21,40-44,1920,2
STAT,1875,16,50-100,1891,0.051421000460512116
STAT,1918,34,30-34,1952,16.938576321308336
STAT,1899,31,40-44,1930,6.0830194297956055
STAT,1901,35,15-19,1936,0.017455021274976067
SIM,1876,16,15-19,1892,5
SIM,1832,88,na,1920,50
STAT,1923,27,15-19,1950,0.8269693080765582
SIM,1862,43,na,1905,2103
SIM,1923,17,15-19,1940,59
STAT,1831,38,15-19,1869,0.048806957320055695
SIM,1819,90,na,1909,26
STAT,1935,29,35-39,1964,20.8500370733775
STAT,1914,21,40-44,1935,3.373416250748979
STAT,1917,22,20-24,1939,120.60102498508319
STAT,1919,30,30-34,1949,17.485359432968163
STAT,1830,42,40-44,1872,1.9403248301631053
STAT,1918,28,45-49,1946,1.8696054571068759
STAT,1856,48,20-24,1904,0.009488896875137109
STAT,1921,38,45-49,1959,0.7759660103149647
SIM,1859,37,20-24,1896,3
STAT,1887,16,25-29,1903,6.493736141523431
STAT,1940,31,35-39,1971,9.65420033797908
STAT,1836,18,na,1854,1897.9019776350522
SIM,1889,21,na,1910,3069
STAT,1840,23,na,1863,1942.5830863043466
STAT,1874,39,25-29,1913,2.9686797368959907
STAT,1844,37,na,1881,1929.2350088842406
SIM,1918,32,30-34,1950,27
STAT,1914,40,45-49,1954,0.1694349616809107
STAT,1957,11,na,1968,5282.699161637874
STAT,1944,19,35-39,1963,4.604091955237919
STAT,1937,21,35-39,1958,9.355954820252473
SIM,1829,89,na,1918,11
SIM,1899,52,na,1951,3000
SIM,1927,12,na,1939,4876
STAT,1881,20,15-19,1901,3.2731665941493646
SIM,1786,78,na,1864,242
STAT,1861,92,na,1953,35.109133117184
STAT,1873,17,35-39,1890,0.5675022023003815
SIM,1852,49,40-44,1901,1
STAT,1855,26,30-34,1881,20.494501251639942
SIM,1952,19,35-39,1971,11
STAT,1859,30,35-39,1889,8.370860666980464
STAT,1828,74,na,1902,611.123654355616
STAT,1906,48,20-24,1954,0.009924630088059626
STAT,1926,28,30-34,1954,47.74893048737701
STAT,1905,18,50-100,1923,0.07199280144057543
STAT,1921,19,40-44,1940,1.618209365743911
STAT,1910,24,25-29,1934,87.9172880923866
SIM,1927,30,30-34,1957,19
STAT,1874,30,25-29,1904,10.754059307026978
STAT,1913,42,30-34,1955,0.12718675233919613
SIM,1827,77,na,1904,454
STAT,1807,48,25-29,1855,0.247200378269571
STAT,1906,35,15-19,1941,0.01816794646983317
STAT,1857,87,na,1944,140.3665587267743
STAT,1876,47,na,1923,2358.9990942356308
STAT,1853,73,na,1926,995.9290438567075
STAT,1866,27,45-49,1893,1.0447621323812437
STAT,1881,29,15-19,1910,0.4442783640036342
SIM,1831,82,na,1913,367
STAT,1809,92,na,1901,21.249161887121225
STAT,1919,38,40-44,1957,1.6394908874153409
SIM,1934,28,30-34,1962,97
STAT,1932,38,20-24,1970,0.3608417662194161
STAT,1898,29,50-100,1927,0.8761818693691531
SIM,1925,22,20-24,1947,150
STAT,1920,32,20-24,1952,2.7264828860100963
STAT,1824,36,50-100,1860,1.762824632763376
SIM,1875,40,35-39,1915,7
SIM,1919,39,45-49,1958,2
SIM,1877,25,20-24,1902,11
SIM,1927,38,40-44,1965,1
SIM,1833,23,40-44,1856,1
STAT,1901,27,15-19,1928,0.6472425935383284
STAT,1842,49,30-34,1891,0.07432604205471643
STAT,1867,49,35-39,1916,0.13128290045239585
STAT,1886,22,50-100,1908,0.4403370182466495
SIM,1882,39,25-29,1921,2
STAT,1921,30,35-39,1951,10.460850342537318
STAT,1937,34,40-44,1971,3.9440953636584846
SIM,1825,75,na,1900,553
STAT,1910,37,30-34,1947,1.7778150129434813
STAT,1804,93,na,1897,9.861227288663295
STAT,1831,62,na,1893,1231.5639690073729
STAT,1832,23,50-100,1855,0.4289248954693662
SIM,1902,36,35-39,1938,6
STAT,1952,18,30-34,1970,14.895627217110238
SIM,1929,33,45-49,1962,3
STAT,1940,30,45-49,1970,1.6633122803476987
SIM,1896,25,30-34,1921,44
SIM,1810,45,na,1855,1660
STAT,1907,27,30-34,1934,37.719639241399406
STAT,1864,5,na,1869,2592.9061131929807
STAT,1866,20,25-29,1886,55.09455609125931
STAT,1869,24,50-100,1893,0.3991218996819912
SIM,1814,59,na,1873,1052
SIM,1871,36,na,1907,2202
SIM,1879,21,15-19,1900,7
STAT,1917,42,15-19,1959,0.0016354600843337909
STAT,1930,36,45-49,1966,0.907744180456411
SIM,1883,69,na,1952,1563
SIM,1848,37,45-49,1885,6
SIM,1841,38,25-29,1879,5
STAT,1926,20,20-24,1946,138.6335750398875
STAT,1836,53,50-100,1889,0.009325698450958871
SIM,1838,20,15-19,1858,1
SIM,1850,74,na,1924,704
SIM,1902,17,30-34,1919,7
SIM,1944,22,30-34,1966,46
STAT,1937,29,45-49,1966,1.7160838595652237
STAT,1846,40,15-19,1886,0.010254688455646888
STAT,1924,43,45-49,1967,0.2016526003189303
STAT,1930,17,40-44,1947,1.844329508328675
STAT,1909,35,40-44,1944,1.4588269317962457
STAT,1933,37,25-29,1970,1.367684937522999
STAT,1829,69,na,1898,976.0393940062451
STAT,1888,25,30-34,1913,30.5759190434457
SIM,1881,17,35-39,1898,2
SIM,1934,27,40-44,1961,4
STAT,1917,49,35-39,1966,0.13662212895193415
SIM,1895,16,25-29,1911,16
STAT,1833,38,25-29,1871,2.3588757543504966
SIM,1903,16,35-39,1919,2
STAT,1828,34,50-100,1862,0.8468355168538656
STAT,1905,43,35-39,1948,0.18392976896502503
SIM,1899,31,na,1930,3273
STAT,1863,72,na,1935,1129.5985232887358
STAT,1878,35,50-100,1913,1.3160737651512677
STAT,1915,20,45-49,1935,1.145705449307618
STAT,1937,0,na,1937,4470.519998715594
STAT,1924,38,50-100,1962,0.5046002331592719
SIM,1854,88,na,1942,92
SIM,1863,26,30-34,1889,23
STAT,1912,47,na,1959,3601.7351537915183
SIM,1917,35,40-44,1952,4
SIM,1922,21,40-44,1943,4
SIM,1879,16,40-44,1895,1
STAT,1932,25,15-19,1957,0.9438002144816829
STAT,1928,30,na,1958,4829.17207314894
STAT,1900,14,na,1914,3639.7166854893553
STAT,1950,4,na,1954,4761.066262291092
SIM,1846,69,na,1915,999
SIM,1909,21,25-29,1930,87
STAT,1900,47,15-19,1947,3.1754654134265325E-4
SIM,1940,4,na,1944,4181
SIM,1945,21,35-39,1966,19
STAT,1921,8,na,1929,4639.174575527356
STAT,1904,28,na,1932,3476.9719058772275
STAT,1867,86,na,1953,212.4978567517412
STAT,1910,35,na,1945,3704.6655197562645
STAT,1913,4,na,1917,4196.151138668465
STAT,1914,49,na,1963,3695.6505101580938
STAT,1825,55,na,1880,1348.2071413549925
STAT,1856,1,na,1857,3005.937461724273
SIM,1857,21,na,1878,2124
STAT,1926,27,40-44,1953,5.70013523819344
STAT,1850,22,na,1872,1930.3781144048273
SIM,1829,34,30-34,1863,20
SIM,1881,57,na,1938,1802
STAT,1821,41,na,1862,1464.3469787770512
STAT,1901,6,na,1907,3726.7345122634215
SIM,1812,57,na,1869,1100
STAT,1874,42,50-100,1916,1.0990052625977933
SIM,1933,35,25-29,1968,2
STAT,1823,49,20-24,1872,0.01753618831562789
STAT,1893,39,35-39,1932,9.0612714454126
SIM,1932,0,na,1932,5796
STAT,1824,92,na,1916,22.932805004675373
STAT,1856,25,35-39,1881,8.123061407404832
STAT,1947,12,na,1959,4514.620876059211
STAT,1907,47,25-29,1954,0.04844124632256282
STAT,1854,36,na,1890,1811.836702588043
SIM,1856,58,na,1914,1929
STAT,1916,38,15-19,1954,0.0199685561835979
STAT,1779,77,na,1856,261.43235682840003
STAT,1806,49,20-24,1855,0.040463000743785595
STAT,1902,19,30-34,1921,2.2807161470898025
SIM,1892,20,40-44,1912,3
STAT,1836,102,na,1938,0.18248225182013098
SIM,1937,32,40-44,1969,11
STAT,1838,73,na,1911,872.7038229140596
STAT,1836,26,20-24,1862,9.517633728998392
SIM,1910,19,30-34,1929,9
STAT,1846,49,15-19,1895,2.800759915617439E-4
STAT,1938,30,40-44,1968,4.018465454134535
STAT,1806,63,na,1869,922.9868842787487
STAT,1783,82,na,1865,169.1285224092951
STAT,1909,16,50-100,1925,0.07511510839601492
SIM,1821,93,na,1914,3
STAT,1795,62,na,1857,798.0162778113067
STAT,1901,30,45-49,1931,2.5076969084513605
SIM,1819,36,50-100,1855,4
SIM,1903,21,30-34,1924,34
STAT,1846,17,na,1863,2062.0815866714142
STAT,1787,96,na,1883,1.8886200388563628
SIM,1944,13,na,1957,4264
SIM,1909,17,40-44,1926,3
STAT,1799,76,na,1875,372.32128222077034
SIM,1918,27,35-39,1945,19
STAT,1901,25,50-100,1926,0.9187630249769089
STAT,1905,18,45-49,1923,0.09599040192076727
SIM,1874,20,25-29,1894,94
STAT,1921,31,25-29,1952,10.538722388880633
STAT,1893,30,35-39,1923,13.211253805758163
STAT,1884,20,40-44,1904,2.1157006328116084
STAT,1938,26,50-100,1964,1.006364209364334
SIM,1919,31,35-39,1950,19
STAT,1838,22,15-19,1860,3.1448460434734233
SIM,1841,81,na,1922,332
STAT,1903,47,50-100,1950,0.19996752276837185
SIM,1849,17,45-49,1866,3
STAT,1911,17,30-34,1928,2.4879617484398553
STAT,1903,17,45-49,1920,0.09472838786289742
STAT,1904,44,50-100,1948,0.10581253263721292
STAT,1920,26,35-39,1946,16.864756300571862
STAT,1865,31,50-100,1896,0.8518212627674172
STAT,1815,56,na,1871,1343.760014242475
SIM,1878,90,na,1968,152
SIM,1903,29,40-44,1932,3
STAT,1815,47,20-24,1862,0.0322816720974435
STAT,1929,33,50-100,1962,1.0704897070317547
STAT,1841,37,20-24,1878,0.6705804088496191
SIM,1900,66,na,1966,2488
SIM,1934,20,20-24,1954,136
STAT,1867,40,35-39,1907,1.75177322547991
SIM,1868,5,na,1873,2765
SIM,1813,74,na,1887,565
SIM,1879,32,na,1911,2904
SIM,1824,37,na,1861,1608
STAT,1851,43,50-100,1894,0.8652949888372395
STAT,1882,54,na,1936,2081.1923740955544
STAT,1814,82,na,1896,217.42144079644166
STAT,1821,39,45-49,1860,3.84240288942279
STAT,1846,92,na,1938,29.78440233413525
STAT,1909,40,15-19,1949,0.0014815249404442406
STAT,1888,28,35-39,1916,11.595841081790574
SIM,1933,16,20-24,1949,2
SIM,1844,26,20-24,1870,14
STAT,1925,16,20-24,1941,167.50091499072258
STAT,1882,38,20-24,1920,0.7623288470743109
SIM,1877,20,na,1897,2421
STAT,1882,86,na,1968,482.8979290103623
STAT,1880,53,50-100,1933,0.015930637335292153
STAT,1830,52,50-100,1882,0.011022022804291584
STAT,1811,63,na,1874,922.6089705337397
STAT,1815,77,na,1892,446.9559500070012
STAT,1874,35,na,1909,2477.2008938889226
STAT,1893,38,na,1931,3033.856583476662
SIM,1854,15,25-29,1869,7
SIM,1907,26,20-24,1933,22
STAT,1906,22,45-49,1928,1.035414968548976
STAT,1884,40,35-39,1924,1.8460642390561266
STAT,1886,68,na,1954,1650.1662035319903
SIM,1847,22,na,1869,1807
STAT,1862,55,na,1917,1795.6025277524468
STAT,1878,49,na,1927,2339.137802658272
STAT,1915,46,20-24,1961,0.011391721771603445
STAT,1866,69,na,1935,1380.914568885229
SIM,1871,15,25-29,1886,9
SIM,1947,18,15-19,1965,68
STAT,1862,16,20-24,1878,17.736897798151656
STAT,1853,51,50-100,1904,0.012724226304242447
STAT,1858,18,50-100,1876,0.04602601964744249
SIM,1911,29,na,1940,3762
STAT,1830,45,na,1875,1567.185982489395
STAT,1925,40,20-24,1965,0.021874713979271307
STAT,1834,59,na,1893,1306.0419980059094
SIM,1947,23,50-100,1970,1
STAT,1920,13,na,1933,4529.520860971656
STAT,1935,30,15-19,1965,0.1815105531115357
STAT,1877,38,50-100,1915,1.292614060871294
STAT,1844,40,50-100,1884,0.8602022960372765
STAT,1882,15,35-39,1897,0.5478830744709414
SIM,1914,22,45-49,1936,4
STAT,1924,27,na,1951,4450.107828543101
STAT,1901,26,25-29,1927,60.553418640022535
SIM,1908,37,40-44,1945,2
SIM,1958,9,na,1967,5141
SIM,1910,22,50-100,1932,3
STAT,1912,33,25-29,1945,9.238562448515516
SIM,1917,20,20-24,1937,141
SIM,1782,85,na,1867,50
SIM,1892,40,35-39,1932,4
STAT,1863,15,25-29,1878,5.852505979314928
SIM,1832,56,na,1888,1294
STAT,1939,18,15-19,1957,46.327200797284625
SIM,1859,24,15-19,1883,3
SIM,1861,58,na,1919,2061
STAT,1847,20,15-19,1867,3.1995643790537964
STAT,1945,20,30-34,1965,32.16048428056385
STAT,1861,17,na,1878,2224.041435498549
STAT,1922,42,45-49,1964,0.19491691190082278
SIM,1933,35,50-100,1968,4
STAT,1911,16,40-44,1927,0.286205020880713
STAT,1784,107,na,1891,0.004403227947369273
SIM,1920,33,25-29,1953,15
SIM,1938,31,45-49,1969,3
SIM,1929,24,na,1953,4840
STAT,1820,43,50-100,1863,2.040635918807337
STAT,1846,15,25-29,1861,5.151135571289589
STAT,1867,31,45-49,1898,1.676938950540191
SIM,1908,30,20-24,1938,6
STAT,1931,33,35-39,1964,12.204484553824367
STAT,1826,48,35-39,1874,0.10795860491152112
SIM,1925,10,na,1935,5034
STAT,1925,35,25-29,1960,1.2077616825816893
STAT,1929,32,40-44,1961,5.069918691212034
SIM,1861,69,na,1930,1384
SIM,1906,50,na,1956,3268
STAT,1847,27,35-39,1874,9.043896629526081
STAT,1879,23,15-19,1902,3.5070603665942066
SIM,1889,35,40-44,1924,8
STAT,1922,18,45-49,1940,0.58834980846159
STAT,1935,25,40-44,1960,6.485064661845986
STAT,1881,16,30-34,1897,1.5758582694466512
SIM,1908,38,30-34,1946,1
SIM,1910,38,35-39,1948,7
SIM,1841,92,na,1933,18
SIM,1832,45,na,1877,1594
STAT,1894,41,50-100,1935,1.3925680633582584
STAT,1908,42,50-100,1950,0.1108346193853809
STAT,1911,21,15-19,1932,5.165182017736268
STAT,1912,31,50-100,1943,0.8333235751239921
SIM,1855,27,35-39,1882,10
STAT,1845,53,40-44,1898,0.008093673568357773
STAT,1902,38,35-39,1940,2.185382917234618
SIM,1841,60,na,1901,1418
SIM,1952,16,30-34,1968,17
STAT,1845,27,50-100,1872,0.6083721803233798
SIM,1853,27,50-100,1880,1
SIM,1914,19,15-19,1933,13
STAT,1853,51,25-29,1904,0.00298418334671798
STAT,1858,25,45-49,1883,0.9328760940213353
SIM,1853,18,na,1871,2227
STAT,1909,47,35-39,1956,0.12082645889851565
STAT,1848,49,25-29,1897,0.043839531841924774
SIM,1849,88,na,1937,81
SIM,1885,27,20-24,1912,18
STAT,1905,40,30-34,1945,0.11881181362509831
STAT,1908,10,na,1918,3918.254225050911
STAT,1921,35,40-44,1956,1.708623214903561
SIM,1818,36,20-24,1854,1
SIM,1919,46,na,1965,4156
STAT,1917,37,40-44,1954,1.586735113673867
SIM,1878,21,50-100,1899,1
SIM,1915,32,na,1947,4257
STAT,1911,49,40-44,1960,0.1513575066831993
STAT,1918,25,40-44,1943,5.096298463039202
STAT,1869,16,30-34,1885,1.6009832971712237
SIM,1845,74,na,1919,939
SIM,1881,25,na,1906,2211
SIM,1935,32,30-34,1967,23
STAT,1870,44,50-100,1914,1.039338976370782
STAT,1899,26,50-100,1925,0.8966975890234576
STAT,1919,33,35-39,1952,10.018609035699276
SIM,1864,30,30-34,1894,20
STAT,1852,54,50-100,1906,0.011832220776544052
SIM,1896,20,25-29,1916,128
STAT,1841,40,na,1881,1819.3021108895289
STAT,1911,41,30-34,1952,0.12518338050148517
STAT,1843,95,na,1938,10.733129274641737
STAT,1935,28,45-49,1963,2.400439991982461
STAT,1837,88,na,1925,91.5306149170772
SIM,1851,59,na,1910,1537
SIM,1818,41,na,1859,1476
SIM,1874,24,40-44,1898,4
STAT,1863,40,na,1903,2088.1521120006482
STAT,1812,54,40-44,1866,0.022828728607306264
STAT,1918,31,na,1949,4118.011757862878
SIM,1901,24,25-29,1925,89
STAT,1895,3,na,1898,3518.7158908930933
STAT,1891,68,na,1959,2039.3367525646056
STAT,1794,77,na,1871,356.52121325035506
STAT,1833,74,na,1907,728.7933878711667
STAT,1856,30,30-34,1886,14.449981314209694
SIM,1842,55,na,1897,1536
STAT,1888,20,25-29,1908,69.45129224782791
STAT,1845,54,na,1899,1636.1069017547509
STAT,1844,15,15-19,1859,5.915277888656295
SIM,1815,43,50-100,1858,3
SIM,1931,31,35-39,1962,21
STAT,1867,54,na,1921,2005.4490173268052
SIM,1849,22,40-44,1871,3
SIM,1848,34,40-44,1882,2
STAT,1916,41,45-49,1957,0.1742974226278679
STAT,1930,21,25-29,1951,121.05214257600188
STAT,1950,17,30-34,1967,14.70318397324765
SIM,1862,38,45-49,1900,2
SIM,1926,25,40-44,1951,8
STAT,1881,50,50-100,1931,0.015109555164431266
SIM,1925,8,na,1933,5052
STAT,1906,15,50-100,1921,0.07308336817896896
SIM,1870,37,40-44,1907,10
STAT,1865,15,35-39,1880,0.5821536829337475
STAT,1890,38,50-100,1928,1.5238130161995778
STAT,1827,37,50-100,1864,1.5959445696252226
SIM,1911,18,35-39,1929,1
STAT,1945,23,35-39,1968,10.52534946638549
SIM,1852,15,15-19,1867,7
SIM,1890,3,na,1893,3477
STAT,1855,39,15-19,1894,0.04309280024093043
STAT,1849,9,na,1858,2328.2418901365495
STAT,1903,18,35-39,1921,0.7936338227297055
STAT,1901,23,20-24,1924,98.0053532751061
SIM,1876,20,35-39,1896,7
STAT,1923,31,35-39,1954,10.732654467578298
STAT,1888,16,na,1904,3053.4128762834935
STAT,1849,20,25-29,1869,54.51320409071003
STAT,1926,23,25-29,1949,114.12612185320197
STAT,1896,67,na,1963,2339.7836151234887
STAT,1952,6,na,1958,4805.725400063923
STAT,1862,87,na,1949,152.9953983024665
STAT,1897,31,30-34,1928,23.913019339141172
STAT,1892,53,na,1945,2708.830685482932
SIM,1921,17,40-44,1938,2
STAT,1922,16,50-100,1938,0.44350809551197273
SIM,1873,15,35-39,1888,1
SIM,1896,28,35-39,1924,18
STAT,1884,15,45-49,1899,0.06623518364198572
STAT,1831,30,na,1861,1928.8419269770225
STAT,1865,38,20-24,1903,0.7101910594701817
STAT,1868,20,35-39,1888,5.768438653262854
SIM,1944,17,35-39,1961,7
STAT,1866,24,40-44,1890,1.9485270231085954
STAT,1942,28,15-19,1970,0.7555725877458638
STAT,1882,24,50-100,1906,0.40275623030672997
STAT,1887,41,15-19,1928,0.015857907370225927
STAT,1852,20,45-49,1872,0.6770359698348388
SIM,1966,2,na,1968,5192
SIM,1777,85,na,1862,30
STAT,1913,17,40-44,1930,0.29174457445747637
SIM,1829,37,35-39,1866,9
STAT,1835,44,na,1879,1829.3887119246288
STAT,1788,81,na,1869,224.54242549411362
STAT,1943,27,40-44,1970,5.0645864972235835
SIM,1868,91,na,1959,69
SIM,1873,38,20-24,1911,1
STAT,1852,38,35-39,1890,5.669695257368407
SIM,1817,56,na,1873,1151
SIM,1839,23,35-39,1862,5
SIM,1813,42,na,1855,1481
SIM,1860,38,35-39,1898,11
STAT,1908,32,20-24,1940,2.347777212030547
STAT,1874,37,50-100,1911,1.2787700283691177
STAT,1923,48,20-24,1971,0.013153729932420975
SIM,1902,36,na,1938,3463
SIM,1791,78,na,1869,308
SIM,1857,20,25-29,1877,1
SIM,1934,23,25-29,1957,134
SIM,1940,31,na,1971,4022
STAT,1906,19,15-19,1925,8.76463607991947
SIM,1915,28,20-24,1943,20
STAT,1930,41,40-44,1971,0.3361379340949783
STAT,1931,17,20-24,1948,180.97879660213488
SIM,1823,63,na,1886,1003
STAT,1927,32,30-34,1959,19.76979480709877
STAT,1762,100,na,1862,0.1972573054301136
STAT,1867,28,15-19,1895,0.4329957799139454
STAT,1823,39,50-100,1862,2.1241598133033577
STAT,1897,49,20-24,1946,0.009040381727716807
SIM,1922,29,50-100,1951,1
STAT,1917,46,30-34,1963,0.09525764173696102
SIM,1949,12,na,1961,4776
STAT,1904,31,25-29,1935,15.036560595532675
STAT,1877,27,20-24,1904,12.41288395018464
SIM,1849,41,45-49,1890,4
STAT,1914,29,50-100,1943,1.0164546019025653
STAT,1936,17,35-39,1953,4.097485685033083
STAT,1841,18,na,1859,2173.031186132644
STAT,1891,30,25-29,1921,13.040372677224951
STAT,1897,20,na,1917,3245.2610613109755
STAT,1870,21,na,1891,2365.69549631411
SIM,1792,63,na,1855,769
SIM,1796,77,na,1873,344
SIM,1906,20,45-49,1926,2
STAT,1859,26,15-19,1885,0.3787379074014879
STAT,1781,109,na,1890,0.003050876788556577
STAT,1914,17,na,1931,4076.321995602896
STAT,1840,55,na,1895,1487.9224395099538
SIM,1859,87,na,1946,227
STAT,1870,39,40-44,1909,4.321583243569403
SIM,1855,73,na,1928,964
STAT,1907,28,20-24,1935,17.510533103749747
SIM,1891,21,50-100,1912,3
SIM,1899,20,na,1919,3208
STAT,1871,17,25-29,1888,5.763351668552401
STAT,1903,65,na,1968,2753.764604158882
STAT,1928,44,40-44,1972,0.32416383918188796
SIM,1837,36,30-34,1873,7
STAT,1921,42,50-100,1963,0.1350243728045635
STAT,1829,49,15-19,1878,3.154805645221004E-4
SIM,1912,31,25-29,1943,13
STAT,1925,19,25-29,1944,53.122217718131864
SIM,1933,19,25-29,1952,62
SIM,1865,40,na,1905,2280
STAT,1820,52,25-29,1872,0.0062109406015472875
STAT,1858,48,30-34,1906,0.07732795024039017
SIM,1869,54,na,1923,2092
STAT,1848,33,50-100,1881,0.748024159852648
STAT,1820,56,na,1876,1214.4420526512747
STAT,1911,45,25-29,1956,0.05146535741904806
SIM,1916,32,20-24,1948,6
STAT,1839,25,35-39,1864,8.51082052953332
STAT,1902,35,30-34,1937,1.6706522429271105
STAT,1951,5,na,1956,4776.35642479108
STAT,1770,86,na,1856,41.26288887
SIM,1939,16,15-19,1955,43
STAT,1872,76,na,1948,968.6535887696043
SIM,1889,38,45-49,1927,2
STAT,1899,26,45-49,1925,1.5563826464996489
STAT,1871,91,na,1962,124.85261189992542
STAT,1880,53,35-39,1933,0.009080982221958512
SIM,1929,30,40-44,1959,12
STAT,1848,8,na,1856,2366.3099363076
STAT,1872,30,15-19,1902,0.1467721965972899
SIM,1828,47,50-100,1875,1
SIM,1926,29,35-39,1955,36
STAT,1812,50,25-29,1862,0.008323176202562331
STAT,1840,44,na,1884,1691.0319279167027
SIM,1838,18,na,1856,2036
STAT,1940,27,15-19,1967,0.7343990737954189
STAT,1783,108,na,1891,0.003391933140892961
STAT,1880,28,45-49,1908,1.1860880480647038
STAT,1840,37,50-100,1877,1.0449420759378254
SIM,1847,25,35-39,1872,15
STAT,1917,17,25-29,1934,9.516473092645635
STAT,1918,27,50-100,1945,1.0809634327393118
SIM,1865,44,50-100,1909,3
SIM,1869,17,35-39,1886,1
STAT,1938,33,45-49,1971,1.6130252637566755
SIM,1877,49,45-49,1926,2
STAT,1906,2,na,1908,3958.0938116909847
STAT,1952,12,na,1964,4802.026175915388
STAT,1821,107,na,1928,0.0024850211411178652
SIM,1860,20,45-49,1880,1
STAT,1886,49,50-100,1935,0.2596646392411656
STAT,1896,27,30-34,1923,33.928919418843755
STAT,1918,21,25-29,1939,101.96979660446743
STAT,1851,16,45-49,1867,0.06591126989565889
STAT,1857,44,50-100,1901,0.8303338721192123
SIM,1926,21,25-29,1947,8
STAT,1909,38,45-49,1947,0.6548263350565331
SIM,1926,27,50-100,1953,1
STAT,1883,17,na,1900,2528.0444433786865
SIM,1869,65,na,1934,1605
STAT,1905,15,40-44,1920,0.27073126609633225
SIM,1838,40,30-34,1878,2
STAT,1829,36,30-34,1865,4.72460384018884
SIM,1889,53,na,1942,2781
STAT,1883,21,50-100,1904,0.40941644832099955
STAT,1849,30,50-100,1879,0.8409901521247072
STAT,1924,27,30-34,1951,46.545572588424854
STAT,1920,45,50-100,1965,0.25634695854419076
SIM,1890,39,na,1929,3022
STAT,1840,28,15-19,1868,0.4041543456281156
SIM,1803,75,na,1878,307
STAT,1847,24,30-34,1871,16.784446852667557
STAT,1918,29,35-39,1947,16.188394361661604
STAT,1909,19,40-44,1928,0.27824255014206084
SIM,1927,33,35-39,1960,5
STAT,1804,52,40-44,1856,0.030879261224604257
STAT,1931,30,30-34,1961,21.078186793560107
SIM,1941,18,20-24,1959,134
STAT,1805,78,na,1883,383.61067357488236
STAT,1905,27,20-24,1932,17.28446996544084
SIM,1772,86,na,1858,53
STAT,1933,18,20-24,1951,184.5993858288585
SIM,1889,30,35-39,1919,14
STAT,1937,23,na,1960,3626.148112997556
SIM,1909,45,35-39,1954,1
STAT,1895,15,20-24,1910,23.706503855438783
STAT,1913,36,45-49,1949,0.6896278786602397
SIM,1921,28,na,1949,5009
SIM,1906,17,15-19,1923,11
STAT,1935,34,30-34,1969,22.200072109906554
SIM,1932,27,30-34,1959,11
STAT,1914,37,15-19,1951,0.019562406449375357
SIM,1834,30,45-49,1864,3
STAT,1860,41,15-19,1901,0.011482313559805791
STAT,1801,64,na,1865,812.168721216683
SIM,1879,41,30-34,1920,3
STAT,1849,40,40-44,1889,1.7767686305420063
SIM,1833,26,45-49,1859,5
SIM,1877,16,30-34,1893,2
SIM,1898,21,25-29,1919,5
SIM,1807,89,na,1896,5
SIM,1878,37,30-34,1915,6
STAT,1925,44,15-19,1969,0.0018905724559941611
SIM,1858,16,20-24,1874,19
SIM,1866,36,na,1902,2370
STAT,1871,43,40-44,1914,2.2565293634215657
SIM,1807,78,na,1885,218
SIM,1866,25,45-49,1891,1
SIM,1870,73,na,1943,1188
SIM,1874,87,na,1961,274
SIM,1816,93,na,1909,4
SIM,1942,22,20-24,1964,195
SIM,1917,19,40-44,1936,2
SIM,1803,64,na,1867,747
STAT,1915,49,25-29,1964,0.05422494632858247
SIM,1872,21,na,1893,2446
SIM,1821,37,45-49,1858,3
SIM,1836,24,20-24,1860,82
SIM,1920,24,35-39,1944,20
STAT,1839,50,25-29,1889,0.0025053273883437694
SIM,1943,28,45-49,1971,1
STAT,1887,53,na,1940,2421.904509552156
SIM,1857,40,40-44,1897,2
SIM,1920,30,20-24,1950,2
SIM,1866,48,30-34,1914,1
STAT,1892,17,45-49,1909,0.08351886514628341
STAT,1852,17,15-19,1869,5.782297797165321
SIM,1913,27,20-24,1940,1
STAT,1840,15,30-34,1855,1.5026305648396583
SIM,1911,47,40-44,1958,1
STAT,1861,53,25-29,1914,0.002937864081821699
SIM,1908,33,25-29,1941,9
STAT,1826,30,45-49,1856,2.250667993648523
SIM,1870,30,50-100,1900,2
STAT,1912,24,35-39,1936,9.532922982598144
SIM,1935,31,na,1966,5327
STAT,1903,47,40-44,1950,0.1393910420315434
STAT,1934,22,20-24,1956,152.39136158452413
STAT,1912,30,20-24,1942,2.468101707758194
SIM,1888,26,35-39,1914,24
STAT,1870,10,na,1880,2674.169334243745
STAT,1925,39,40-44,1964,1.8291910845785904
SIM,1907,29,25-29,1936,68
STAT,1816,41,na,1857,1407.631747941015
STAT,1860,49,25-29,1909,0.046680895108120866
STAT,1893,21,45-49,1914,0.9051607813942153
STAT,1833,33,40-44,1866,3.6648527352474805
SIM,1887,6,na,1893,3062
STAT,1821,95,na,1916,7.00594101096816
STAT,1859,34,15-19,1893,0.11502833159215074
SIM,1838,42,50-100,1880,1
SIM,1882,42,na,1924,2223
STAT,1831,25,30-34,1856,27.022368322249733
SIM,1914,15,na,1929,4068
STAT,1909,32,15-19,1941,0.12506462458382764
SIM,1799,74,na,1873,591
SIM,1924,47,na,1971,4475
SIM,1851,37,30-34,1888,6
SIM,1922,34,na,1956,4269
STAT,1808,49,30-34,1857,0.23844925625129904
STAT,1895,39,45-49,1934,2.6266478124389576
SIM,1827,36,50-100,1863,1
STAT,1879,38,35-39,1917,7.5048356472862165
STAT,1901,22,45-49,1923,0.9947844317166242
STAT,1920,31,50-100,1951,0.9279623522447601
SIM,1835,36,20-24,1871,2
SIM,1837,44,30-34,1881,1
STAT,1817,52,50-100,1869,0.032349133265807316
STAT,1856,33,35-39,1889,8.124280943973211
STAT,1898,43,40-44,1941,0.2139216978725397
SIM,1824,54,50-100,1878,2
SIM,1916,3,na,1919,4383
STAT,1904,23,25-29,1927,83.43822938026157
STAT,1836,34,20-24,1870,2.0831150721932796
SIM,1823,31,na,1854,1784
STAT,1819,37,25-29,1856,8.161921838867217
SIM,1836,48,45-49,1884,2
STAT,1894,27,20-24,1921,15.394224020311373
SIM,1862,25,25-29,1887,53
SIM,1881,19,15-19,1900,5
STAT,1854,25,25-29,1879,37.838298456003436
STAT,1871,22,20-24,1893,69.63777243382256
SIM,1856,36,na,1892,2296
STAT,1946,26,50-100,1972,1.1317385542570981
SIM,1820,98,na,1918,2
STAT,1906,31,35-39,1937,8.66960634097655
STAT,1895,72,na,1967,2018.718458278393
SIM,1853,27,25-29,1880,61
STAT,1915,12,na,1927,4217.91859804488
SIM,1889,46,45-49,1935,1
SIM,1912,23,25-29,1935,96
STAT,1813,41,15-19,1854,0.052397453510215145
STAT,1850,27,20-24,1877,10.384618973318956
STAT,1841,29,20-24,1870,10.604619222012678
STAT,1857,33,na,1890,1893.1959511975567
SIM,1857,53,na,1910,1760
STAT,1835,38,35-39,1873,6.450433268544416
SIM,1903,25,25-29,1928,59
STAT,1944,20,15-19,1964,5.867977678745305
SIM,1844,21,15-19,1865,4
SIM,1838,23,40-44,1861,4
STAT,1910,20,45-49,1930,1.0841167074059972
STAT,1843,37,30-34,1880,5.022699376350818
STAT,1908,64,na,1972,3000.357654190466
STAT,1929,24,40-44,1953,4.309617448380829
SIM,1920,22,20-24,1942,135
SIM,1841,33,40-44,1874,6
STAT,1858,50,na,1908,1766.9614318397096
SIM,1865,72,na,1937,1050
STAT,1840,23,30-34,1863,16.183242314461577
STAT,1921,20,20-24,1941,128.9240957265469
STAT,1828,48,45-49,1876,0.18216071372915965
SIM,1943,22,15-19,1965,4
STAT,1849,43,45-49,1892,1.1535388347768925
STAT,1842,31,40-44,1873,4.151221004423578
SIM,1864,33,35-39,1897,16
STAT,1868,37,20-24,1905,0.7510899876533328
SIM,1881,22,30-34,1903,17
SIM,1916,28,na,1944,3909
SIM,1888,49,20-24,1937,1
STAT,1883,27,45-49,1910,1.1113750496746375
STAT,1938,22,40-44,1960,3.394591975623516
SIM,1937,24,40-44,1961,7
SIM,1844,25,na,1869,2124
SIM,1842,39,30-34,1881,1
SIM,1855,35,35-39,1890,9
STAT,1923,31,na,1954,4441.871023258096
SIM,1899,17,20-24,1916,1
SIM,1804,60,na,1864,1206
SIM,1908,0,na,1908,4296
SIM,1919,20,30-34,1939,48
SIM,1946,22,40-44,1968,7
STAT,1857,23,na,1880,1952.4575338661386
STAT,1885,40,na,1925,2376.0666848707788
STAT,1849,14,na,1863,2260.6675687745696
STAT,1914,30,30-34,1944,16.310987250976233
SIM,1833,41,na,1874,1747
SIM,1847,21,40-44,1868,3
SIM,1890,71,na,1961,1862
STAT,1912,22,20-24,1934,108.70896391196355
STAT,1895,50,na,1945,2907.153477912043
SIM,1885,22,15-19,1907,3
STAT,1864,32,30-34,1896,15.837400824817887
SIM,1882,52,na,1934,2072
STAT,1884,38,30-34,1922,5.352370104705637
SIM,1891,27,45-49,1918,2
SIM,1874,29,25-29,1903,51
SIM,1921,21,25-29,1942,164
STAT,1828,35,25-29,1863,2.6395866358270452
STAT,1874,48,15-19,1922,4.1138949079926485E-4
STAT,1878,31,20-24,1909,2.8820030327682473
STAT,1834,39,30-34,1873,4.369531364736783
STAT,1862,24,20-24,1886,60.38468547697272
STAT,1890,17,35-39,1907,0.6844251398005293
STAT,1932,21,35-39,1953,12.637425799856043
SIM,1871,23,25-29,1894,61
STAT,1847,35,35-39,1882,5.84272212645167
STAT,1845,32,20-24,1877,2.5112089466634795
STAT,1950,11,na,1961,4739.18074187667
SIM,1891,26,20-24,1917,15
STAT,1841,49,15-19,1890,2.891743270466666E-4
STAT,1880,50,30-34,1930,0.006473011425912419
STAT,1861,28,35-39,1889,8.134009058209307
STAT,1880,32,15-19,1912,0.1526652434580761
SIM,1824,36,45-49,1860,2
SIM,1827,55,na,1882,1224
SIM,1935,36,25-29,1971,1
STAT,1820,78,na,1898,430.3225166764614
SIM,1940,21,35-39,1961,12
STAT,1833,104,na,1937,0.04380163032937788
SIM,1961,7,na,1968,5328
STAT,1839,21,40-44,1860,1.8611897178968113
STAT,1845,27,25-29,1872,40.23028584007707
STAT,1857,39,25-29,1896,2.2708235920402693
STAT,1889,15,45-49,1904,0.08269818937959886
STAT,1913,21,25-29,1934,91.58687027845365
STAT,1827,36,20-24,1863,1.0278167494553587
STAT,1839,48,20-24,1887,0.008330604349743868
STAT,1893,18,15-19,1911,7.660055833039695
SIM,1870,24,20-24,1894,72
SIM,1874,33,na,1907,2397
STAT,1947,15,45-49,1962,0.5744270011561978
SIM,1829,36,na,1865,1523
SIM,1882,20,na,1902,2227
STAT,1869,49,45-49,1918,0.22758525365966528
STAT,1890,24,50-100,1914,0.5054677583376853
STAT,1896,22,25-29,1918,77.13007215119316
STAT,1863,23,25-29,1886,51.84889779331281
SIM,1835,23,15-19,1858,5
STAT,1863,36,30-34,1899,4.789994100408943
STAT,1878,92,na,1970,168.22288180866408
STAT,1931,27,50-100,1958,1.3105588833635164
STAT,1838,39,15-19,1877,0.048762859847663785
STAT,1945,15,50-100,1960,0.4177795082644557
SIM,1922,30,30-34,1952,24
STAT,1857,2,na,1859,2804.4198655074892
STAT,1844,58,na,1902,1532.4628043652392
SIM,1905,33,35-39,1938,19
STAT,1897,34,35-39,1931,13.695421281455605
SIM,1878,48,50-100,1926,1
SIM,1892,38,30-34,1930,11
SIM,1904,5,na,1909,4081
SIM,1836,35,25-29,1871,1
STAT,1861,15,15-19,1876,5.818291266987827
SIM,1841,20,35-39,1861,6
STAT,1933,33,45-49,1966,2.1612839883640618
SIM,1865,94,na,1959,8
STAT,1895,26,25-29,1921,56.49687351769283
SIM,1867,85,na,1952,152
SIM,1869,34,25-29,1903,10
SIM,1870,49,35-39,1919,1
SIM,1890,15,35-39,1905,2
STAT,1810,46,na,1856,1264.5709547736942
SIM,1854,35,na,1889,2077
SIM,1819,36,na,1855,1579
SIM,1933,1,na,1934,5484
SIM,1940,29,30-34,1969,65
STAT,1855,17,40-44,1872,0.16864046568892907
STAT,1874,34,40-44,1908,4.478286079624726
SIM,1904,29,20-24,1933,23
STAT,1888,16,40-44,1904,0.22112654331363252
SIM,1869,22,30-34,1891,22
STAT,1817,47,30-34,1864,0.21628028734474938
STAT,1932,29,30-34,1961,52.28647634972973
SIM,1829,68,na,1897,758
STAT,1846,39,35-39,1885,5.173410984475641
STAT,1927,36,25-29,1963,1.2498774188143973
STAT,1896,35,30-34,1931,7.249022162326335
SIM,1892,52,na,1944,3142
STAT,1848,47,45-49,1895,0.18259535832269755
STAT,1831,50,35-39,1881,0.006443948832075094
STAT,1851,24,45-49,1875,0.6771930592494345
STAT,1925,44,na,1969,4572.194927602841
STAT,1878,17,35-39,1895,0.5826529652318992
STAT,1932,38,50-100,1970,0.5747181769922519
SIM,1823,39,20-24,1862,2
STAT,1815,39,20-24,1854,2.9332194979035053
STAT,1940,11,na,1951,4093.476549171276
STAT,1922,39,15-19,1961,0.02224832865656141
STAT,1863,36,50-100,1899,1.103442117474994
STAT,1829,44,30-34,1873,0.938907019390926
SIM,1932,38,50-100,1970,1
SIM,1887,38,35-39,1925,5
SIM,1890,61,na,1951,2427
SIM,1863,36,50-100,1899,3
SIM,1886,31,20-24,1917,6
SIM,1879,24,40-44,1903,4
SIM,1888,43,50-100,1931,5
STAT,1819,42,20-24,1861,0.3428132484160348
STAT,1873,25,35-39,1898,10.047103742501342
STAT,1885,16,15-19,1901,6.054894424443679
STAT,1847,15,40-44,1862,0.18013222764574047
STAT,1858,72,na,1930,1021.691664417009
STAT,1864,15,40-44,1879,0.19084402853598353
STAT,1923,23,35-39,1946,11.143742279321167
STAT,1912,40,35-39,1952,0.2003659638149148
SIM,1875,72,na,1947,1151
STAT,1856,47,50-100,1903,0.19576041941886493
STAT,1935,32,na,1967,5336.051754194509
SIM,1880,26,30-34,1906,28
STAT,1872,22,na,1894,2418.0958229192415
STAT,1884,23,45-49,1907,0.70161981420926
SIM,1865,37,45-49,1902,3
SIM,1840,21,30-34,1861,18
STAT,1876,39,35-39,1915,7.375834085066271
STAT,1857,42,40-44,1899,1.7898342586846006
STAT,1939,21,45-49,1960,1.1531188973233504
SIM,1810,98,na,1908,9
SIM,1868,38,25-29,1906,5
SIM,1882,28,20-24,1910,11
STAT,1869,24,30-34,1893,17.43364268738245
STAT,1870,26,20-24,1896,11.739487811329813
STAT,1907,40,40-44,1947,0.23632220373257334
STAT,1918,43,20-24,1961,0.019131048075883155
STAT,1835,25,15-19,1860,0.44714719635058586
SIM,1822,33,30-34,1855,16
STAT,1844,49,40-44,1893,0.12989488867484922
STAT,1834,32,45-49,1866,1.5031881351136487
STAT,1932,14,na,1946,5333.3124689091665
STAT,1879,43,30-34,1922,1.2170984487756777
STAT,1940,23,35-39,1963,9.78217303348223
SIM,1842,32,45-49,1874,1
STAT,1872,51,35-39,1923,0.008844272366765013
STAT,1862,37,40-44,1899,3.8014235840748096
STAT,1927,41,20-24,1968,0.022625950329372504
SIM,1863,17,40-44,1880,1
SIM,1907,45,na,1952,3477
SIM,1857,75,na,1932,740
STAT,1838,37,35-39,1875,6.270788463614676
SIM,1844,35,na,1879,2042
STAT,1807,80,na,1887,316.5049777959554
STAT,1874,28,20-24,1902,12.176021159102016
STAT,1927,13,na,1940,5017.728680880055
SIM,1884,39,35-39,1923,16
SIM,1838,43,35-39,1881,5
SIM,1931,17,na,1948,4764
SIM,1941,30,40-44,1971,2
SIM,1834,44,50-100,1878,6
STAT,1839,54,50-100,1893,0.010136456635919739
SIM,1936,32,25-29,1968,16
STAT,1829,31,25-29,1860,9.769827691084643
SIM,1902,14,na,1916,3759
STAT,1905,35,35-39,1940,2.2706103946615257
STAT,1841,22,35-39,1863,5.458191860725995
STAT,1866,35,45-49,1901,1.8936263605886674
STAT,1908,36,15-19,1944,0.018422258527973415
STAT,1761,101,na,1862,0.06057788669699565
SIM,1921,29,20-24,1950,24
SIM,1947,21,45-49,1968,2
STAT,1864,27,35-39,1891,8.752372320116898
SIM,1872,42,na,1914,2438
SIM,1894,33,20-24,1927,7
SIM,1898,67,na,1965,2740
STAT,1848,44,40-44,1892,1.724835977922811
SIM,1872,27,35-39,1899,16
STAT,1880,15,25-29,1895,6.103125577079577
SIM,1867,53,na,1920,1853
STAT,1885,8,na,1893,2645.7630354466164
STAT,1892,25,45-49,1917,1.429222227650976
STAT,1816,41,50-100,1857,2.6267062988338195
SIM,1849,56,na,1905,1594
STAT,1955,17,45-49,1972,0.6763698878178133
STAT,1771,110,na,1881,0.0017899959592179234
SIM,1914,47,na,1961,3734
STAT,1930,21,50-100,1951,0.8623176750316962
STAT,1937,30,25-29,1967,9.33787559145771
SIM,1837,31,25-29,1868,14
SIM,1867,39,35-39,1906,3
STAT,1928,32,25-29,1960,11.788261141301538
SIM,1809,91,na,1900,3
SIM,1907,35,na,1942,3625
SIM,1913,35,35-39,1948,4
SIM,1823,38,50-100,1861,1
STAT,1889,32,35-39,1921,12.761557716835
STAT,1920,42,35-39,1962,0.22695507908196788
STAT,1827,49,40-44,1876,0.18715148010831628
STAT,1913,29,20-24,1942,18.422455093730626
SIM,1959,11,na,1970,5719
STAT,1833,47,15-19,1880,3.099327530470272E-4
SIM,1897,32,35-39,1929,23
SIM,1936,15,35-39,1951,4
SIM,1875,28,15-19,1903,4
SIM,1888,34,35-39,1922,16
STAT,1886,33,20-24,1919,2.9064782242142595
STAT,1947,20,40-44,1967,3.8798044844132247
STAT,1853,39,40-44,1892,3.6335881029049517
SIM,1856,31,35-39,1887,26
STAT,1889,45,40-44,1934,0.217887390377217
SIM,1901,20,45-49,1921,2
STAT,1909,15,25-29,1924,8.707297867370794
SIM,1894,28,25-29,1922,3
SIM,1839,56,na,1895,1521
STAT,1839,16,45-49,1855,0.059323204518189655
STAT,1922,19,20-24,1941,159.2390551539957
SIM,1826,38,35-39,1864,14
STAT,1825,34,45-49,1859,2.9777202161768743
SIM,1831,23,30-34,1854,33
SIM,1846,37,35-39,1883,10
STAT,1902,22,50-100,1924,0.5866658373445979
SIM,1871,20,20-24,1891,96
SIM,1802,79,na,1881,281
SIM,1837,27,40-44,1864,3
STAT,1936,31,20-24,1967,2.4178395331939324
SIM,1831,60,na,1891,1227
SIM,1895,49,na,1944,3003
SIM,1902,21,15-19,1923,5
STAT,1870,48,30-34,1918,0.09532206322850993
SIM,1879,44,35-39,1923,6
SIM,1893,29,35-39,1922,14
SIM,1843,38,35-39,1881,15
STAT,1871,38,na,1909,2368.9643240847636
STAT,1928,15,35-39,1943,5.418158175718447
SIM,1896,33,30-34,1929,6
STAT,1885,29,35-39,1914,9.750285986657719
SIM,1874,35,45-49,1909,5
SIM,1887,83,na,1970,849
STAT,1801,109,na,1910,2.5384755231896067E-4
STAT,1839,54,40-44,1893,0.007065803653651521
STAT,1866,18,50-100,1884,0.04703909820611605
SIM,1936,20,30-34,1956,30
SIM,1833,34,45-49,1867,4
STAT,1896,18,40-44,1914,0.24578940620626796
STAT,1861,50,20-24,1911,6.309816206457468E-4
SIM,1894,21,na,1915,3217
STAT,1803,76,na,1879,439.25640337588
STAT,1837,30,20-24,1867,2.3070427716505204
STAT,1852,40,50-100,1892,0.8596670696514652
SIM,1846,42,30-34,1888,2
STAT,1934,26,15-19,1960,0.9689199272772537
STAT,1899,49,30-34,1948,0.07468645227758107
SIM,1931,23,35-39,1954,20
STAT,1855,37,35-39,1892,5.482916542849794
STAT,1829,27,40-44,1856,4.261658700854362
SIM,1888,22,40-44,1910,1
STAT,1809,48,35-39,1857,0.612364400593772
STAT,1864,29,15-19,1893,0.40860415571455044
STAT,1885,72,na,1957,1349.195159976677
SIM,1902,22,50-100,1924,4
STAT,1886,28,25-29,1914,45.516801038601386
STAT,1818,38,35-39,1856,23.664406631499386
STAT,1884,32,50-100,1916,0.9247507063214174
STAT,1918,30,15-19,1948,0.14047023781787613
SIM,1878,32,25-29,1910,14
SIM,1893,16,15-19,1909,4
SIM,1920,31,50-100,1951,1
SIM,1861,26,20-24,1887,16
STAT,1891,28,20-24,1919,14.764643666853871
SIM,1827,37,25-29,1864,3
SIM,1830,76,na,1906,664
STAT,1869,33,20-24,1902,2.6510305887737844
SIM,1832,22,35-39,1854,4
SIM,1832,37,20-24,1869,1
SIM,1930,19,20-24,1949,193
SIM,1929,22,40-44,1951,8
STAT,1939,23,50-100,1962,0.673893572125089
SIM,1836,38,na,1874,1924
STAT,1838,42,30-34,1880,0.9878807148015155
STAT,1944,16,30-34,1960,13.38650432771398
STAT,1854,38,45-49,1892,1.5181566627734093
STAT,1881,24,30-34,1905,17.457874540406944
STAT,1875,25,45-49,1900,1.1703859753934591
STAT,1928,20,30-34,1948,36.821632051391134
SIM,1915,40,40-44,1955,1
STAT,1849,36,na,1885,1891.1762886266947
STAT,1798,80,na,1878,317.3962090759727
STAT,1853,26,20-24,1879,11.4779124546644
STAT,1919,42,25-29,1961,0.07896904900609875
SIM,1883,25,45-49,1908,1
STAT,1800,58,na,1858,1228.7029324720165
STAT,1830,29,45-49,1859,1.1221176096941363
SIM,1816,61,na,1877,1139
SIM,1942,26,15-19,1968,1
STAT,1895,43,15-19,1938,0.0012671961859893562
STAT,1860,22,45-49,1882,0.5949932213032145
STAT,1824,37,20-24,1861,1.0661186340060553
SIM,1877,33,20-24,1910,5
SIM,1834,37,30-34,1871,4
SIM,1907,13,na,1920,3946
STAT,1878,39,45-49,1917,2.0955015305800986
STAT,1898,46,45-49,1944,0.1841724787768597
STAT,1847,23,40-44,1870,1.9777655230991644
STAT,1926,32,15-19,1958,0.15851657663578256
SIM,1832,29,20-24,1861,12
SIM,1916,39,40-44,1955,3
STAT,1888,70,na,1958,1783.4054218407284
STAT,1850,50,45-49,1900,0.011073179883602088
STAT,1907,47,na,1954,3354.9196643224427
STAT,1893,28,30-34,1921,32.47435298762586
SIM,1887,35,30-34,1922,1
SIM,1859,28,50-100,1887,1
STAT,1937,13,na,1950,3925.7297975275283
SIM,1820,43,50-100,1863,2
SIM,1917,45,na,1962,3778
STAT,1830,56,na,1886,1305.930042690149
STAT,1929,27,45-49,1956,2.205269804976841
SIM,1879,54,na,1933,2602
STAT,1826,31,50-100,1857,1.0776090374982494
STAT,1899,39,15-19,1938,0.01676151535377276
STAT,1931,40,45-49,1971,0.22738210579248352
SIM,1853,15,30-34,1868,2
SIM,1886,34,25-29,1920,15
SIM,1937,27,45-49,1964,3
STAT,1881,49,45-49,1930,0.2279015852787145
STAT,1944,3,na,1947,4409.1063379516845
SIM,1865,39,25-29,1904,3
STAT,1834,24,45-49,1858,0.6186228770128331
STAT,1945,24,25-29,1969,103.21673198349151
SIM,1845,25,25-29,1870,50
SIM,1854,44,30-34,1898,3
SIM,1842,24,45-49,1866,1
SIM,1900,16,30-34,1916,5
STAT,1915,29,30-34,1944,40.491024341630954
STAT,1865,42,na,1907,2137.3487647761353
SIM,1861,37,na,1898,2526
STAT,1851,21,40-44,1872,2.0678818485894146
STAT,1879,35,30-34,1914,5.737196171920108
SIM,1838,35,35-39,1873,9
STAT,1830,26,40-44,1856,3.686551509007364
STAT,1816,94,na,1910,8.868090703773456
STAT,1825,49,30-34,1874,0.12113608474890543
STAT,1845,15,30-34,1860,1.5927398879903736
SIM,1849,26,20-24,1875,11
SIM,1874,42,50-100,1916,3
STAT,1838,45,35-39,1883,0.10857406191242265
SIM,1867,17,25-29,1884,9
STAT,1848,31,35-39,1879,9.276094993137376
STAT,1826,37,30-34,1863,4.762088551851717
STAT,1846,44,30-34,1890,0.8110552571516394
SIM,1827,34,20-24,1861,3
STAT,1843,22,45-49,1865,0.7065909604792977
STAT,1866,7,na,1873,2626.9785311517767
STAT,1908,39,40-44,1947,1.4148352442846632
SIM,1872,74,na,1946,984
SIM,1932,12,na,1944,5526
STAT,1927,33,20-24,1960,3.0588000579352377
STAT,1888,33,30-34,1921,20.967912322026248
STAT,1857,37,45-49,1894,1.5882485186009105
STAT,1877,22,15-19,1899,3.490651019394047
SIM,1892,20,na,1912,3477
STAT,1892,49,20-24,1941,0.00847388377757684
STAT,1909,20,20-24,1929,106.0277127750111
SIM,1861,34,20-24,1895,3
SIM,1886,49,50-100,1935,1
SIM,1920,25,25-29,1945,9
STAT,1929,41,30-34,1970,0.16910958906518053
STAT,1897,26,35-39,1923,13.206658203289683
STAT,1789,104,na,1893,0.013268249275386229
STAT,1866,42,50-100,1908,0.9928658389096998
SIM,1781,90,na,1871,3
STAT,1918,26,30-34,1944,42.698846490260514
SIM,1906,20,50-100,1926,1
SIM,1893,24,15-19,1917,5
STAT,1872,26,30-34,1898,25.835076948244836
SIM,1834,25,na,1859,1875
STAT,1929,28,50-100,1957,1.2699389451931409
STAT,1914,33,35-39,1947,9.34572748591571
SIM,1861,7,na,1868,3087
SIM,1876,26,50-100,1902,1
STAT,1837,25,25-29,1862,36.72532868048564
SIM,1935,33,20-24,1968,3
STAT,1836,37,25-29,1873,2.199877408539659
SIM,1918,27,50-100,1945,1
STAT,1863,20,20-24,1883,63.77988677551829
STAT,1853,34,20-24,1887,2.286064969632363
STAT,1878,5,na,1883,2888.512976447293
STAT,1941,19,30-34,1960,12.799806960149626
SIM,1878,28,40-44,1906,4
SIM,1889,43,40-44,1932,1
SIM,1922,33,35-39,1955,15
STAT,1885,24,15-19,1909,3.336657058937413
SIM,1829,42,30-34,1871,3
STAT,1878,49,50-100,1927,0.2553479561394222
STAT,1837,35,na,1872,1775.08408762356
SIM,1853,24,20-24,1877,72
STAT,1842,34,45-49,1876,1.6180362234364773
STAT,1859,17,25-29,1876,5.35910083182704
STAT,1880,2,na,1882,3440.5722452989316
STAT,1807,90,na,1897,33.31828395793711
STAT,1820,46,na,1866,1437.817170156904
STAT,1851,39,30-34,1890,4.3527405104549555
STAT,1864,68,na,1932,1386.2009637582034
STAT,1887,45,30-34,1932,0.11175849803116256
STAT,1867,33,na,1900,2275.8011811496335
STAT,1845,35,25-29,1880,2.6519667125595507
SIM,1840,39,20-24,1879,2
SIM,1891,29,25-29,1920,69
STAT,1786,106,na,1892,0.005246123905589943
STAT,1845,24,20-24,1869,65.88811296523465
SIM,1882,84,na,1966,468
STAT,1933,30,40-44,1963,5.384320530472007
STAT,1832,39,20-24,1871,0.6405935440320983
STAT,1928,17,50-100,1945,0.48152678951200506
STAT,1867,38,30-34,1905,5.0789882843277265
SIM,1926,26,30-34,1952,64
STAT,1850,4,na,1854,2450.0
STAT,1855,21,25-29,1876,52.21792131186946
STAT,1878,34,25-29,1912,10.783106530124417
STAT,1854,42,15-19,1896,0.010556404169400615
STAT,1860,49,50-100,1909,0.19904215137906808
STAT,1868,28,30-34,1896,24.450052719028417
SIM,1824,38,25-29,1862,2
STAT,1854,68,na,1922,1169.613048611158
STAT,1872,17,40-44,1889,0.18762064136534162
SIM,1846,34,30-34,1880,24
SIM,1923,29,30-34,1952,52
SIM,1898,36,45-49,1934,3
STAT,1878,26,25-29,1904,45.07238632018426
STAT,1868,24,15-19,1892,3.194338214032561
STAT,1862,27,25-29,1889,36.869976045546274
SIM,1926,22,15-19,1948,7
STAT,1882,22,na,1904,2350.5670040760533
STAT,1942,20,50-100,1962,0.7043546689407821
STAT,1907,25,na,1932,3598.994263246868
STAT,1858,38,15-19,1896,0.045204140992169066
STAT,1918,22,15-19,1940,5.858759007258922
STAT,1872,15,50-100,1887,0.05085279849212397
STAT,1856,16,45-49,1872,0.06222021650265474
SIM,1900,32,45-49,1932,5
STAT,1782,109,na,1891,0.00194360484208657
SIM,1886,39,45-49,1925,6
SIM,1917,5,na,1922,4304
STAT,1874,21,35-39,1895,6.096363490389566
STAT,1846,36,30-34,1882,4.021607968886157
STAT,1852,24,na,1876,2016.9464447920589
SIM,1819,43,25-29,1862,1
SIM,1938,20,40-44,1958,4
SIM,1847,24,45-49,1871,1
STAT,1844,23,15-19,1867,3.1689782198365073
SIM,1870,27,25-29,1897,57
STAT,1938,34,35-39,1972,9.361200242349854
STAT,1816,38,25-29,1854,8.815939873422389
SIM,1945,26,40-44,1971,1
SIM,1912,46,na,1958,3688
SIM,1848,42,40-44,1890,7
STAT,1896,39,50-100,1935,1.6375546226413458
SIM,1883,1,na,1884,3353
STAT,1837,27,50-100,1864,0.5474228910930885
STAT,1883,29,25-29,1912,42.03963215557233
SIM,1845,16,35-39,1861,1
SIM,1903,22,20-24,1925,95
STAT,1903,32,20-24,1935,3.9198802517478724
SIM,1923,6,na,1929,4623
SIM,1852,23,15-19,1875,5
SIM,1911,32,20-24,1943,2
STAT,1839,24,45-49,1863,0.6095052092874125
SIM,1857,85,na,1942,156
STAT,1864,35,35-39,1899,6.476652847712913
SIM,1952,2,na,1954,4920
SIM,1902,46,na,1948,3334
SIM,1928,30,25-29,1958,18
STAT,1937,26,40-44,1963,4.636615347608893
SIM,1824,90,na,1914,26
STAT,1859,15,50-100,1874,0.04688292893305791
SIM,1864,25,35-39,1889,11
STAT,1794,98,na,1892,0.6439145233461846
SIM,1877,73,na,1950,1144
STAT,1898,38,45-49,1936,0.5906449130562558
STAT,1925,31,45-49,1956,1.9075532646276498
SIM,1825,32,45-49,1857,1
SIM,1854,36,30-34,1890,9
STAT,1862,49,35-39,1911,0.11903759048332499
SIM,1896,24,40-44,1920,3
SIM,1868,26,30-34,1894,5
STAT,1925,12,na,1937,4883.318903417153
SIM,1927,34,25-29,1961,3
STAT,1867,53,50-100,1920,0.014232140927321533
STAT,1875,19,na,1894,2630.155493824632
SIM,1907,33,45-49,1940,5
STAT,1820,36,25-29,1856,7.405941095540217
STAT,1879,46,35-39,1925,0.14971356160101956
STAT,1797,63,na,1860,891.4607203601194
SIM,1867,36,30-34,1903,10
STAT,1887,21,na,1908,2711.7283278542004
STAT,1911,19,45-49,1930,0.10141880395490446
STAT,1926,24,15-19,1950,6.556092638135241
SIM,1857,35,45-49,1892,2
STAT,1850,19,20-24,1869,16.104353827551634
SIM,1886,26,25-29,1912,58
STAT,1819,45,25-29,1864,0.11748296320004818
SIM,1874,55,na,1929,2140
STAT,1821,73,na,1894,625.8734955200993
STAT,1936,22,30-34,1958,28.025992754411487
STAT,1890,51,na,1941,2698.6495600963394
SIM,1882,34,40-44,1916,6
SIM,1843,20,45-49,1863,4
SIM,1946,1,na,1947,4462
SIM,1829,33,40-44,1862,5
STAT,1865,20,na,1885,2248.598079643268
SIM,1853,37,40-44,1890,5
SIM,1930,15,40-44,1945,4
STAT,1857,55,na,1912,1647.386460365487
STAT,1932,25,50-100,1957,1.3306996557654727
SIM,1863,21,25-29,1884,52
STAT,1905,39,15-19,1944,0.017677897753449995
SIM,1849,24,na,1873,1946
SIM,1885,27,35-39,1912,18
STAT,1828,48,50-100,1876,0.18957064075595653
SIM,1819,58,na,1877,1175
SIM,1922,22,30-34,1944,49
STAT,1915,34,na,1949,3896.9758607817193
STAT,1810,47,20-24,1857,0.03772604855207639
STAT,1870,29,25-29,1899,41.88412049701801
SIM,1830,27,45-49,1857,1
SIM,1934,24,15-19,1958,13
STAT,1888,24,40-44,1912,2.497383015142072
SIM,1850,28,25-29,1878,51
SIM,1815,43,40-44,1858,3
SIM,1861,39,40-44,1900,14
STAT,1813,54,50-100,1867,0.034821841846070054
SIM,1818,36,35-39,1854,12
STAT,1873,26,50-100,1899,0.6638720282740382
SIM,1878,24,25-29,1902,73
STAT,1914,16,45-49,1930,0.10568929884728158
SIM,1836,48,50-100,1884,1
SIM,1915,27,30-34,1942,54
STAT,1907,43,45-49,1950,0.15455047703651698
STAT,1931,25,35-39,1956,19.785287228097168
STAT,1948,16,15-19,1964,53.00414036735388
SIM,1874,32,40-44,1906,8
STAT,1922,32,30-34,1954,18.163798724630826
STAT,1785,106,na,1891,0.009081107608398104
STAT,1934,29,40-44,1963,6.38807095142544
STAT,1891,36,na,1927,2989.916005170249
SIM,1819,35,25-29,1854,5
STAT,1842,28,25-29,1870,40.728789081903564
STAT,1857,48,15-19,1905,3.1468297156269975E-4
SIM,1876,37,20-24,1913,1
STAT,1838,34,30-34,1872,15.613175082832374
SIM,1812,79,na,1891,231
SIM,1871,68,na,1939,1458
STAT,1835,54,na,1889,1571.3548651921878
STAT,1923,0,na,1923,5397.528340990457
SIM,1903,30,20-24,1933,2
SIM,1930,32,30-34,1962,34
SIM,1878,15,35-39,1893,2
STAT,1927,44,25-29,1971,0.09105183286716927
SIM,1836,23,30-34,1859,23
STAT,1867,16,20-24,1883,17.460655682952844
SIM,1875,16,20-24,1891,16
SIM,1885,49,na,1934,2214
STAT,1843,27,15-19,1870,0.45075056712728556
STAT,1914,17,20-24,1931,28.6138054748443
SIM,1902,68,na,1970,2438
SIM,1831,26,35-39,1857,14
SIM,1875,38,30-34,1913,7
SIM,1922,17,20-24,1939,174
STAT,1919,34,25-29,1953,10.088730494946411
STAT,1874,19,50-100,1893,0.050754418898078364
SIM,1919,14,na,1933,4517
STAT,1840,48,45-49,1888,0.1690749987547853
SIM,1837,23,25-29,1860,51
STAT,1910,13,na,1923,3984.9931023222507
SIM,1879,36,35-39,1915,12
STAT,1842,26,45-49,1868,1.0845437337966082
SIM,1800,78,na,1878,396
SIM,1820,38,40-44,1858,2
SIM,1929,25,45-49,1954,1
STAT,1951,21,45-49,1972,1.3718297370775143
STAT,1887,37,30-34,1924,6.092418307139081
STAT,1892,22,40-44,1914,2.664278559092182
STAT,1926,46,50-100,1972,0.2854121115694578
SIM,1808,47,30-34,1855,1
STAT,1864,24,30-34,1888,16.182126034601918
SIM,1799,96,na,1895,5
STAT,1835,20,45-49,1855,0.9381812801980719
SIM,1878,37,45-49,1915,4
STAT,1835,42,50-100,1877,0.9435350324600577
SIM,1893,26,30-34,1919,67
STAT,1876,48,25-29,1924,0.0599151167078202
STAT,1885,43,50-100,1928,1.0674670756136966
STAT,1805,57,na,1862,1261.6492165333589
SIM,1894,25,20-24,1919,19
SIM,1888,25,45-49,1913,1
SIM,1924,25,na,1949,4483
STAT,1819,47,40-44,1866,0.33917170321107487
STAT,1890,19,15-19,1909,7.3626864625777895
STAT,1928,23,35-39,1951,11.95452812950284
SIM,1932,39,25-29,1971,3
STAT,1877,21,na,1898,2509.979773391378
SIM,1862,54,na,1916,1895
STAT,1900,18,30-34,1918,2.2477467195164227
SIM,1942,29,40-44,1971,7
STAT,1886,38,40-44,1924,4.703435181554513
STAT,1947,23,45-49,1970,1.2970060746777203
STAT,1813,44,na,1857,1353.1839619219977
STAT,1876,69,na,1945,1545.953325320431
STAT,1917,21,50-100,1938,0.7158124317818233
SIM,1888,31,30-34,1919,31
STAT,1836,21,15-19,1857,2.729811313749638
SIM,1907,31,50-100,1938,4
STAT,1903,15,30-34,1918,2.322112110451143
SIM,1826,35,30-34,1861,6
STAT,1898,15,na,1913,3500.394186362713
STAT,1912,25,25-29,1937,66.61742852963282
SIM,1874,26,20-24,1900,14
STAT,1827,44,20-24,1871,0.18119967291177716
STAT,1824,60,na,1884,1128.7300168361726
SIM,1919,36,40-44,1955,1
STAT,1821,48,35-39,1869,0.21731634946832942
SIM,1806,61,na,1867,1084
STAT,1883,71,na,1954,1336.0892798510113
SIM,1877,20,15-19,1897,4
SIM,1926,28,45-49,1954,4
STAT,1840,15,45-49,1855,0.061583207349978256
SIM,1872,24,30-34,1896,2
SIM,1895,37,30-34,1932,15
SIM,1826,38,na,1864,1670
STAT,1885,26,30-34,1911,25.717557608208878
STAT,1922,14,na,1936,4663.799424250061
SIM,1850,26,45-49,1876,1
SIM,1863,39,na,1902,2022
STAT,1841,93,na,1934,21.578647355579047
STAT,1803,98,na,1901,1.2605475560123356
SIM,1894,38,40-44,1932,10
SIM,1911,15,30-34,1926,4
SIM,1914,31,35-39,1945,18
SIM,1932,34,na,1966,5250
STAT,1825,31,40-44,1856,9.387032479552621
STAT,1922,15,40-44,1937,1.6593814106937281
STAT,1886,25,20-24,1911,12.753705332706936
STAT,1864,18,45-49,1882,0.06093476715698904
STAT,1894,35,20-24,1929,1.0211284938872747
SIM,1936,23,35-39,1959,7
STAT,1849,35,45-49,1884,1.6169026570965968
STAT,1848,72,na,1920,981.6900271260927
STAT,1800,109,na,1909,3.429006798948022E-4
SIM,1845,33,25-29,1878,16
SIM,1828,46,30-34,1874,1
SIM,1833,31,40-44,1864,7
SIM,1856,44,40-44,1900,5
STAT,1940,20,30-34,1960,29.88968899111499
SIM,1855,23,40-44,1878,7
STAT,1836,39,na,1875,1602.6802047240217
STAT,1837,33,25-29,1870,8.473869575524862
SIM,1901,19,na,1920,3713
STAT,1945,21,20-24,1966,124.3782903823259
SIM,1847,30,30-34,1877,19
STAT,1872,8,na,1880,2768.1161141248335
STAT,1869,20,15-19,1889,3.282615491054427
SIM,1868,22,15-19,1890,1
SIM,1929,20,25-29,1949,189
SIM,1941,17,30-34,1958,14
STAT,1928,36,40-44,1964,1.9315094966750457
SIM,1916,24,20-24,1940,134
SIM,1866,38,15-19,1904,1
STAT,1863,19,na,1882,2318.2178603318416
SIM,1817,37,30-34,1854,11
SIM,1870,29,40-44,1899,6
STAT,1834,91,na,1925,38.941949328914006
STAT,1933,17,30-34,1950,16.63985664676794
SIM,1845,22,20-24,1867,92
STAT,1795,94,na,1889,3.885421289400593
STAT,1847,26,45-49,1873,1.048208188142577
SIM,1863,37,35-39,1900,9
STAT,1851,61,na,1912,1541.6568248113251
STAT,1862,15,30-34,1877,1.6040695883258993
STAT,1887,28,40-44,1915,3.4122754717194317
SIM,1842,21,40-44,1863,2
STAT,1862,29,40-44,1891,2.582755468727743
STAT,1864,47,50-100,1911,0.22174080638803909
STAT,1895,29,na,1924,3153.785596784752
STAT,1955,10,na,1965,5320.080186587493
STAT,1846,20,20-24,1866,61.68839450842436
SIM,1837,36,45-49,1873,1
SIM,1844,57,na,1901,1587
STAT,1855,74,na,1929,860.3061912605866
SIM,1897,51,na,1948,2925
STAT,1844,39,25-29,1883,2.3092251345751733
SIM,1833,94,na,1927,4
SIM,1852,39,25-29,1891,5
STAT,1902,16,na,1918,3642.3757181619712
SIM,1801,84,na,1885,95
SIM,1918,20,15-19,1938,6
STAT,1924,39,25-29,1963,1.1820199029448002
STAT,1842,24,na,1866,2084.5898601725958
SIM,1954,13,na,1967,4715
SIM,1828,37,40-44,1865,9
STAT,1819,36,50-100,1855,3.7732310996377363
SIM,1869,39,45-49,1908,1
SIM,1939,24,15-19,1963,6
STAT,1830,24,25-29,1854,134.71437813449427
SIM,1880,22,15-19,1902,3
STAT,1851,15,20-24,1866,17.99430872474847
SIM,1895,28,40-44,1923,3
STAT,1829,35,40-44,1864,3.9357964667805643
STAT,1853,37,25-29,1890,2.4142030514749493
STAT,1852,103,na,1955,0.11561593579489177
STAT,1859,89,na,1948,85.58867613494972
STAT,1942,20,40-44,1962,3.59925209642815
STAT,1834,21,40-44,1855,1.8890314970369628
SIM,1895,15,35-39,1910,1
SIM,1842,18,25-29,1860,8
STAT,1884,66,na,1950,1654.2244426012903
SIM,1852,25,30-34,1877,36
SIM,1892,19,na,1911,3735
STAT,1896,27,45-49,1923,1.4959707388644894
STAT,1812,47,30-34,1859,0.22909914109755278
SIM,1827,87,na,1914,66
SIM,1934,15,25-29,1949,109
STAT,1838,28,45-49,1866,1.030281933002232
STAT,1965,5,na,1970,5006.036938417923
SIM,1906,29,30-34,1935,42
STAT,1837,42,15-19,1879,0.010864958224310597
STAT,1875,53,50-100,1928,0.015558849151839936
SIM,1861,17,30-34,1878,3
SIM,1863,25,40-44,1888,5
STAT,1857,21,35-39,1878,5.406092798372982
STAT,1894,19,35-39,1913,0.7161647772989685
STAT,1934,34,15-19,1968,0.17869564347617065
STAT,1846,49,na,1895,1575.3172903028774
SIM,1937,28,20-24,1965,2
SIM,1844,26,35-39,1870,15
STAT,1846,47,35-39,1893,0.09965029643977952
STAT,1849,48,15-19,1897,3.0664195853753187E-4
SIM,1929,14,na,1943,5386
STAT,1871,27,40-44,1898,3.0270911035572903
STAT,1889,41,50-100,1930,1.3373048473736846
STAT,1903,35,25-29,1938,0.9097628215134156
STAT,1853,17,30-34,1870,1.6076713108716685
SIM,1938,32,35-39,1970,14
STAT,1829,36,45-49,1865,1.7672009545463347
SIM,1865,21,35-39,1886,9
SIM,1895,29,45-49,1924,3
SIM,1908,25,25-29,1933,82
STAT,1899,27,20-24,1926,16.388481976089075
SIM,1835,28,35-39,1863,14
STAT,1827,28,35-39,1855,22.113518304131873
STAT,1872,48,40-44,1920,0.17284057311510864
SIM,1820,44,na,1864,1650
STAT,1819,38,na,1857,1716.0910713056314
STAT,1810,48,50-100,1858,0.7586582060365457
STAT,1855,25,40-44,1880,2.698457272424464
STAT,1859,99,na,1958,2.4828050509776514
STAT,1898,49,15-19,1947,3.047735829670491E-4
SIM,1880,48,40-44,1928,2
STAT,1864,49,45-49,1913,0.20960177758747436
SIM,1871,36,30-34,1907,6
STAT,1847,49,50-100,1896,0.18752324102728155
SIM,1909,34,30-34,1943,19
STAT,1836,26,35-39,1862,7.828099397131352
STAT,1885,19,na,1904,2556.723253122395
SIM,1930,35,35-39,1965,6
STAT,1907,15,15-19,1922,8.930587136765945
STAT,1941,28,na,1969,3951.692084223559
STAT,1924,19,30-34,1943,14.729368664437285
STAT,1844,25,30-34,1869,24.23487641721149
SIM,1900,28,25-29,1928,83
STAT,1854,16,35-39,1870,0.5053453404489523
SIM,1859,36,30-34,1895,5
STAT,1887,15,35-39,1902,0.6301620262538412
STAT,1916,30,40-44,1946,4.156118460869132
STAT,1827,57,na,1884,1368.6724020059974
STAT,1837,49,35-39,1886,0.09444470450529739
SIM,1858,31,45-49,1889,4
STAT,1909,23,25-29,1932,87.28427918342048
STAT,1931,29,15-19,1960,0.9285953565497981
STAT,1880,41,na,1921,2488.928550459647
STAT,1892,16,20-24,1908,22.722695161344227
STAT,1902,18,40-44,1920,0.2624432544591057
STAT,1944,18,45-49,1962,0.548297987892106
STAT,1863,23,50-100,1886,0.36934679590668545
STAT,1842,17,20-24,1859,17.853017064382595
STAT,1937,22,25-29,1959,91.75091096021504
SIM,1894,36,25-29,1930,4
SIM,1927,25,35-39,1952,21
STAT,1873,16,45-49,1889,0.06796005821379998
SIM,1898,33,40-44,1931,14
SIM,1837,35,40-44,1872,8
STAT,1938,31,30-34,1969,16.16953345141839
SIM,1822,57,na,1879,1178
STAT,1818,49,25-29,1867,0.12678107182788678
STAT,1896,26,40-44,1922,4.049934121808093
STAT,1890,73,na,1963,1732.214480658019
SIM,1861,37,25-29,1898,2
STAT,1919,31,20-24,1950,2.6964170113676493
SIM,1879,33,30-34,1912,26
SIM,1834,22,45-49,1856,2
SIM,1945,22,25-29,1967,120
STAT,1848,111,na,1959,1.2578799483846216E-4
STAT,1859,67,na,1926,1291.5006874284225
STAT,1804,107,na,1911,0.0015912563039823353
STAT,1817,57,na,1874,1186.8705745057243
SIM,1835,27,30-34,1862,27
SIM,1887,29,45-49,1916,2
STAT,1803,107,na,1910,0.0018299549393514677
STAT,1816,47,15-19,1863,8.225447025786983E-4
STAT,1953,17,35-39,1970,5.177898622900292
SIM,1899,32,45-49,1931,7
STAT,1908,24,20-24,1932,103.58785678170932
STAT,1879,29,45-49,1908,1.1755151801225936
SIM,1850,17,20-24,1867,23
STAT,1886,36,25-29,1922,3.123955701153386
STAT,1910,45,na,1955,3512.369523083388
STAT,1939,30,35-39,1969,9.52249581931845
SIM,1911,35,25-29,1946,2
STAT,1890,39,45-49,1929,2.461523434363167
SIM,1852,86,na,1938,126
SIM,1820,76,na,1896,583
STAT,1835,47,25-29,1882,0.04525522622433088
STAT,1852,34,na,1886,1949.522381036163
SIM,1812,47,na,1859,1354
STAT,1866,29,25-29,1895,39.51988642199329
STAT,1922,35,35-39,1957,2.813120801449172
STAT,1957,2,na,1959,5291.423789110535
STAT,1833,39,15-19,1872,0.0455189535515133
SIM,1932,19,30-34,1951,21
STAT,1837,22,20-24,1859,60.14778553660344
STAT,1839,30,30-34,1869,15.13975973035034
STAT,1884,28,15-19,1912,0.45630222755709005
STAT,1928,6,na,1934,5151.373775303026
SIM,1863,26,45-49,1889,1
SIM,1869,38,40-44,1907,7
SIM,1927,31,20-24,1958,4
STAT,1827,27,30-34,1854,84.00716520520267
SIM,1897,24,35-39,1921,14
SIM,1792,84,na,1876,101
STAT,1825,104,na,1929,0.0399975349311833
SIM,1905,24,45-49,1929,1
STAT,1845,37,40-44,1882,3.59372880036583
STAT,1802,81,na,1883,191.57085913381331
STAT,1877,27,35-39,1904,10.209395752543594
SIM,1950,20,40-44,1970,4
STAT,1867,36,15-19,1903,0.054039855339927105
STAT,1942,16,20-24,1958,144.5901189304828
STAT,1823,48,45-49,1871,0.3497982228567783
STAT,1835,46,20-24,1881,0.009549740769867386
SIM,1826,49,25-29,1875,1
STAT,1843,15,20-24,1858,18.506819139179065
SIM,1833,25,20-24,1858,15
SIM,1910,23,15-19,1933,6
STAT,1873,22,30-34,1895,18.422346393696902
STAT,1876,28,30-34,1904,26.433976854083497
STAT,1894,18,30-34,1912,2.0860247682590827
STAT,1919,38,50-100,1957,0.4598222226880585
STAT,1855,36,50-100,1891,0.9563248722048149
SIM,1865,34,40-44,1899,7
SIM,1884,28,30-34,1912,3
STAT,1863,93,na,1956,29.854121633339826
STAT,1838,21,25-29,1859,54.96491910693412
SIM,1883,19,25-29,1902,10
STAT,1889,24,35-39,1913,7.307508575656071
SIM,1850,64,na,1914,1280
SIM,1846,21,25-29,1867,70
SIM,1870,19,na,1889,2755
SIM,1904,25,40-44,1929,5
STAT,1827,67,na,1894,1024.5569278101423
STAT,1843,29,30-34,1872,24.660086545826207
SIM,1882,37,45-49,1919,5
STAT,1863,32,15-19,1895,0.12737678919588222
SIM,1858,27,25-29,1885,44
SIM,1920,2,na,1922,4522
STAT,1870,51,25-29,1921,0.0035492181231562754
SIM,1794,75,na,1869,401
SIM,1852,76,na,1928,669
STAT,1841,48,50-100,1889,0.1798425820277725
STAT,1887,48,35-39,1935,0.15802778303069684
STAT,1857,34,40-44,1891,3.42556239904488
STAT,1909,36,30-34,1945,1.7678700058990082
SIM,1838,61,na,1899,1172
SIM,1879,27,45-49,1906,2
SIM,1937,20,25-29,1957,112
STAT,1836,72,na,1908,786.0694625268779
STAT,1885,29,na,1914,2411.5925658074752
STAT,1828,26,35-39,1854,19.785109898303777
SIM,1937,11,na,1948,4609
STAT,1858,33,45-49,1891,1.4048120978539762
STAT,1893,48,na,1941,2875.573379054827
STAT,1905,66,na,1971,2781.6528404946202
SIM,1839,44,40-44,1883,2
STAT,1851,93,na,1944,24.111457744460296
STAT,1870,31,50-100,1901,0.9174716213448352
STAT,1870,15,30-34,1885,1.623719273027344
SIM,1851,29,30-34,1880,23
SIM,1871,37,35-39,1908,6
STAT,1894,38,25-29,1932,3.759395417888841
STAT,1855,26,45-49,1881,0.9036295498125184
STAT,1888,30,50-100,1918,1.113892879310045
SIM,1859,37,35-39,1896,10
STAT,1873,93,na,1966,97.80705250603862
STAT,1817,37,15-19,1854,0.19861257834667087
SIM,1815,46,45-49,1861,1
SIM,1895,21,20-24,1916,6
STAT,1898,35,40-44,1933,6.096347675575652
STAT,1842,56,na,1898,1599.4903899840567
SIM,1911,8,na,1919,4116
SIM,1874,7,na,1881,2778
SIM,1948,20,35-39,1968,20
STAT,1879,7,na,1886,2846.537621983146
SIM,1828,30,20-24,1858,5
SIM,1879,22,na,1901,3092
STAT,1877,38,25-29,1915,3.031327787846896
STAT,1856,22,30-34,1878,16.56646286102625
SIM,1876,28,30-34,1904,52
STAT,1846,38,50-100,1884,0.9073923680205569
STAT,1851,48,20-24,1899,0.009775812474264576
SIM,1837,87,na,1924,130
SIM,1866,33,45-49,1899,2
SIM,1885,38,25-29,1923,6
STAT,1873,19,15-19,1892,6.10489086297714
STAT,1861,38,na,1899,1976.1633009529764
SIM,1864,22,30-34,1886,23
STAT,1881,15,40-44,1896,0.18123128626758764
STAT,1830,24,na,1854,1568.7992872498971
STAT,1888,27,45-49,1915,1.3390479953980692
STAT,1831,47,40-44,1878,0.14001625750273325
STAT,1865,20,30-34,1885,16.935239951390148
STAT,1883,38,15-19,1921,0.05592997992698493
SIM,1950,16,20-24,1966,172
STAT,1919,25,35-39,1944,16.666399233407752
STAT,1891,49,50-100,1940,0.17132095632659797
STAT,1902,48,na,1950,3196.6480005189696
SIM,1928,37,45-49,1965,2
SIM,1887,51,na,1938,2567
STAT,1929,20,25-29,1949,119.84885741156846
STAT,1936,25,35-39,1961,14.667538553040684
SIM,1836,26,35-39,1862,16
STAT,1863,28,45-49,1891,0.9896167840428047
SIM,1849,33,45-49,1882,1
SIM,1853,35,25-29,1888,4
SIM,1805,77,na,1882,329
SIM,1924,30,40-44,1954,5
STAT,1898,18,15-19,1916,8.165573898855893
SIM,1857,32,40-44,1889,9
SIM,1929,2,na,1931,5520
STAT,1886,16,30-34,1902,1.7253065146474964
STAT,1916,29,na,1945,3924.472568744198
SIM,1960,5,na,1965,5244
STAT,1835,27,30-34,1862,24.462949943699584
SIM,1887,41,na,1928,2772
STAT,1924,48,na,1972,4449.875720399441
STAT,1925,36,15-19,1961,0.023536322921321195
STAT,1878,43,15-19,1921,0.014558192288749126
SIM,1886,17,35-39,1903,1
STAT,1927,27,35-39,1954,18.61860538803281
SIM,1829,36,45-49,1865,1
SIM,1859,34,na,1893,2284
STAT,1852,25,15-19,1877,0.4318967612628644
STAT,1861,37,25-29,1898,2.427071780266919
SIM,1889,22,35-39,1911,9
SIM,1900,56,na,1956,2829
STAT,1833,42,na,1875,1672.7035196763409
SIM,1843,27,30-34,1870,28
SIM,1855,41,na,1896,1784
STAT,1826,44,50-100,1870,0.8364353798521048
SIM,1918,51,na,1969,4081
STAT,1866,28,20-24,1894,11.000088784050151
SIM,1894,16,30-34,1910,4
STAT,1853,19,na,1872,2288.12519056244
SIM,1869,22,na,1891,2338
STAT,1852,39,25-29,1891,2.296141369241299
SIM,1902,16,40-44,1918,2
SIM,1886,23,20-24,1909,96
SIM,1830,38,35-39,1868,5
STAT,1887,29,45-49,1916,1.2601531839960123
STAT,1887,21,20-24,1908,79.01400477551115
SIM,1824,41,50-100,1865,2
SIM,1860,39,25-29,1899,3
STAT,1846,27,40-44,1873,2.5915239004625112
SIM,1913,19,20-24,1932,42
SIM,1944,25,35-39,1969,19
SIM,1935,27,35-39,1962,25
STAT,1878,23,20-24,1901,72.94939317170274
STAT,1822,38,35-39,1860,12.739138195938867
SIM,1818,95,na,1913,7
SIM,1854,27,40-44,1881,4
STAT,1826,35,15-19,1861,0.05262631931397605
SIM,1845,38,45-49,1883,2
SIM,1852,54,na,1906,1729
STAT,1857,17,15-19,1874,5.557227830928933
STAT,1861,17,30-34,1878,1.5442913490618089
STAT,1898,22,35-39,1920,8.050350669268123
SIM,1874,23,na,1897,2389
STAT,1836,39,40-44,1875,3.275927765302327
STAT,1907,48,15-19,1955,3.337262694184863E-4
SIM,1887,22,25-29,1909,84
SIM,1876,29,35-39,1905,13
STAT,1847,32,30-34,1879,15.986114412927236
STAT,1836,25,30-34,1861,20.577623603856193
STAT,1893,26,15-19,1919,0.5891725075032329
SIM,1891,18,20-24,1909,32
STAT,1843,49,25-29,1892,0.045528062955346345
STAT,1926,15,25-29,1941,54.45388824367137
STAT,1842,23,40-44,1865,2.0463236495004473
STAT,1849,32,40-44,1881,3.5478255856441976
STAT,1874,88,na,1962,266.910144439666
STAT,1881,16,45-49,1897,0.0645843421745295
SIM,1873,20,30-34,1893,19
SIM,1937,33,na,1970,4439
STAT,1905,19,20-24,1924,25.980157868468453
STAT,1831,106,na,1937,0.008181327902543951
STAT,1862,16,35-39,1878,0.5489680882550241
SIM,1889,8,na,1897,3380
SIM,1825,39,30-34,1864,10
STAT,1826,49,25-29,1875,0.043833456824003685
STAT,1879,22,25-29,1901,61.04414426893377
STAT,1817,39,30-34,1856,15.576774032933848
SIM,1909,37,35-39,1946,6
STAT,1874,56,na,1930,2124.404985820542
SIM,1855,32,30-34,1887,27
SIM,1943,26,30-34,1969,46
STAT,1873,71,na,1944,1380.5169781404409
SIM,1844,37,25-29,1881,5
STAT,1884,16,20-24,1900,17.937044268036857
SIM,1837,20,20-24,1857,82
STAT,1876,17,25-29,1893,5.969498258454106
STAT,1935,26,30-34,1961,54.4931321539494
STAT,1860,38,20-24,1898,0.6348779218840579
SIM,1801,62,na,1863,1064
SIM,1898,14,na,1912,3982
STAT,1837,38,45-49,1875,1.6015290801698097
STAT,1929,28,20-24,1957,23.289673514748586
STAT,1807,49,15-19,1856,0.0016811469737727158
SIM,1839,31,35-39,1870,12
STAT,1927,20,15-19,1947,6.730036582253991
SIM,1850,23,40-44,1873,1
SIM,1805,55,na,1860,1079
STAT,1834,31,50-100,1865,0.7980546143504756
SIM,1903,33,25-29,1936,13
STAT,1876,21,45-49,1897,0.7367967932637809
STAT,1899,34,45-49,1933,2.4152101311328726
STAT,1859,36,30-34,1895,4.362985467084436
SIM,1865,17,15-19,1882,7
STAT,1863,37,35-39,1900,6.326386791585101
STAT,1827,47,25-29,1874,0.06468948982671281
SIM,1844,25,30-34,1869,26
SIM,1838,26,45-49,1864,1
SIM,1844,39,40-44,1883,9
SIM,1855,49,45-49,1904,1
SIM,1838,32,30-34,1870,21
STAT,1846,28,45-49,1874,0.9536493312356956
STAT,1901,39,30-34,1940,1.6245382255548897
STAT,1799,97,na,1896,1.743232949286624
STAT,1901,53,na,1954,3022.4281490047165
STAT,1920,39,40-44,1959,1.6690631781431666
STAT,1946,20,25-29,1966,104.94519223934138
SIM,1953,15,35-39,1968,10
STAT,1861,36,20-24,1897,0.6529286589522081
STAT,1897,17,45-49,1914,0.08910228676797056
STAT,1916,26,20-24,1942,19.326595375344393
SIM,1939,30,35-39,1969,1
STAT,1827,102,na,1929,0.1894846626531728
STAT,1883,18,20-24,1901,17.699153586481916
STAT,1837,37,40-44,1874,3.553509765062858
STAT,1897,23,30-34,1920,24.221529396531594
SIM,1860,27,30-34,1887,39
SIM,1887,73,na,1960,1513
STAT,1852,27,30-34,1879,23.628614777974754
STAT,1866,37,na,1903,2216.904268496251
STAT,1870,53,na,1923,2112.797036439078
SIM,1854,20,20-24,1874,69
SIM,1913,23,40-44,1936,5
STAT,1905,23,40-44,1928,3.0606815991426113
STAT,1945,15,35-39,1960,4.679131359493553
SIM,1854,28,45-49,1882,1
STAT,1842,37,15-19,1879,0.051658331734333346
SIM,1899,25,20-24,1924,4
STAT,1853,48,30-34,1901,0.08014681087234843
STAT,1900,27,20-24,1927,16.587682499107434
SIM,1924,26,20-24,1950,30
STAT,1812,43,50-100,1855,2.8210594527484356
STAT,1887,33,15-19,1920,0.1621039888053741
SIM,1877,27,35-39,1904,16
SIM,1919,32,25-29,1951,17
STAT,1866,32,40-44,1898,4.0807209193139045
STAT,1822,36,35-39,1858,14.043096674800328
STAT,1849,44,50-100,1893,0.8091165642750917
SIM,1870,1,na,1871,3384
SIM,1909,26,na,1935,3507
STAT,1867,47,20-24,1914,0.011439201013217356
SIM,1862,22,20-24,1884,67
STAT,1838,38,50-100,1876,1.0772614113900436
STAT,1889,21,30-34,1910,22.513801654414692
SIM,1880,19,na,1899,2527
STAT,1851,18,25-29,1869,5.650646451114807
SIM,1910,6,na,1916,4024
STAT,1846,25,50-100,1871,0.5614444317013445
STAT,1921,23,25-29,1944,106.13307097121582
STAT,1824,104,na,1928,0.03672606390831595
STAT,1825,37,15-19,1862,0.08603295486942523
SIM,1869,36,40-44,1905,6
SIM,1847,75,na,1922,618
SIM,1842,15,20-24,1857,15
SIM,1935,20,15-19,1955,11
STAT,1796,79,na,1875,282.3731460699682
STAT,1941,17,50-100,1958,0.39370034449552493
SIM,1860,42,na,1902,2009
STAT,1871,25,25-29,1896,43.0366348466674
STAT,1896,38,35-39,1934,9.482457685177451
SIM,1863,28,45-49,1891,1
SIM,1888,30,50-100,1918,1
SIM,1897,21,30-34,1918,26
STAT,1883,24,40-44,1907,2.072763024214838
STAT,1862,18,35-39,1880,0.5425202890311946
STAT,1833,36,45-49,1869,1.6684020446236543
STAT,1916,17,30-34,1933,2.639000371881846
SIM,1770,84,na,1854,40
STAT,1839,33,35-39,1872,8.512098306498425
SIM,1913,26,45-49,1939,5
SIM,1837,47,35-39,1884,1
SIM,1892,16,20-24,1908,31
STAT,1919,1,na,1920,4709.382794303028
SIM,1852,28,35-39,1880,2
SIM,1919,23,35-39,1942,20
STAT,1878,47,30-34,1925,0.10230896337098622
STAT,1956,0,na,1956,5345.530047271418
SIM,1881,25,35-39,1906,9
STAT,1855,28,45-49,1883,0.8907000137492148
STAT,1909,59,na,1968,3237.5061481104917
STAT,1886,17,35-39,1903,0.5925027727150806
SIM,1941,29,25-29,1970,84
STAT,1892,28,15-19,1920,0.5780448697837143
STAT,1901,31,na,1932,3418.1736100844123
SIM,1849,34,na,1883,1894
SIM,1858,24,20-24,1882,58
STAT,1844,36,20-24,1880,0.7008926512789533
STAT,1900,67,na,1967,2536.1653388621917
STAT,1818,75,na,1893,524.6311695336452
STAT,1905,26,45-49,1931,1.6414729044096739
STAT,1846,23,25-29,1869,50.148650673500114
STAT,1930,33,na,1963,4974.989383997187
SIM,1934,21,45-49,1955,2
STAT,1894,16,30-34,1910,2.0966412812144557
STAT,1829,47,35-39,1876,0.11330084217424098
STAT,1898,47,na,1945,3089.877725850336
STAT,1850,39,15-19,1889,0.04202670884990948
SIM,1841,27,20-24,1868,12
SIM,1843,72,na,1915,883
SIM,1917,27,40-44,1944,5
STAT,1847,29,15-19,1876,0.4191686068006224
SIM,1908,31,45-49,1939,4
SIM,1951,15,25-29,1966,67
SIM,1860,21,50-100,1881,4
SIM,1913,30,na,1943,3952
SIM,1920,16,35-39,1936,7
STAT,1833,27,20-24,1860,10.340233950356085
STAT,1885,38,25-29,1923,2.915851118495776
STAT,1875,38,15-19,1913,0.05850280415310719
SIM,1809,58,na,1867,848
STAT,1876,26,15-19,1902,0.4795837636037654
STAT,1780,100,na,1880,0.19929694265595693
STAT,1868,15,25-29,1883,5.688256442122919
STAT,1915,6,na,1921,4266.668540224759
STAT,1942,23,45-49,1965,1.2032183199225954
STAT,1905,34,na,1939,3515.4077896539466
STAT,1824,49,15-19,1873,4.537513969722739E-4
STAT,1920,15,30-34,1935,2.8128718426983523
STAT,1808,47,15-19,1855,0.001060633707323065
STAT,1926,29,na,1955,4548.540745673271
SIM,1779,76,na,1855,230
STAT,1854,22,20-24,1876,61.97057840930918
SIM,1876,26,30-34,1902,31
SIM,1923,21,35-39,1944,16
STAT,1865,52,na,1917,1983.0109745474513
STAT,1818,47,25-29,1865,0.13080982053482224
SIM,1909,28,45-49,1937,2
STAT,1911,28,35-39,1939,14.882219283536523
STAT,1912,16,35-39,1928,0.8677106212121534
STAT,1879,26,40-44,1905,3.2052966620686147
STAT,1878,48,35-39,1926,0.14679264705262712
SIM,1904,21,25-29,1925,89
STAT,1895,23,20-24,1918,91.43985876266973
STAT,1896,29,45-49,1925,1.4852787559481027
SIM,1921,25,40-44,1946,7
STAT,1909,27,40-44,1936,4.543029313208777
STAT,1933,29,25-29,1962,89.03978175840727
STAT,1923,27,50-100,1950,1.1659753374716406
SIM,1911,39,40-44,1950,2
SIM,1946,25,45-49,1971,2
SIM,1883,37,na,1920,2459
SIM,1837,38,45-49,1875,2
STAT,1926,21,45-49,1947,1.398714915451376
STAT,1845,49,35-39,1894,0.1071046222849674
STAT,1835,49,25-29,1884,0.0441103619053092
SIM,1954,4,na,1958,4723
STAT,1840,26,35-39,1866,8.719951983362622
STAT,1863,39,35-39,1902,6.262714522504642
STAT,1924,15,15-19,1939,55.39462917982516
SIM,1895,26,40-44,1921,4
STAT,1838,25,40-44,1863,2.8404134436238975
STAT,1914,29,15-19,1943,0.7209215596698182
STAT,1885,37,20-24,1922,0.784553651266923
SIM,1946,25,na,1971,4058
STAT,1916,33,45-49,1949,1.6508800515193698
SIM,1862,27,40-44,1889,6
SIM,1852,27,30-34,1879,32
STAT,1943,19,40-44,1962,1.5122586798669162
STAT,1894,66,na,1960,2280.129426877752
STAT,1863,27,40-44,1890,2.6793872908822722
STAT,1847,111,na,1958,1.045770739771053E-4
SIM,1856,20,30-34,1876,26
STAT,1943,15,25-29,1958,46.9092784635379
STAT,1901,39,50-100,1940,0.37423509548212514
STAT,1886,15,na,1901,2739.8509381158624
STAT,1822,35,30-34,1857,11.036655563885537
SIM,1794,65,na,1859,871
STAT,1887,26,40-44,1913,3.436080505516155
SIM,1836,32,20-24,1868,5
STAT,1860,75,na,1935,852.1004369423089
SIM,1824,80,na,1904,232
SIM,1859,39,35-39,1898,16
STAT,1855,48,40-44,1903,0.13104638974175564
SIM,1871,39,35-39,1910,2
STAT,1828,32,20-24,1860,2.6672160583378623
STAT,1854,27,40-44,1881,2.403464183847208
STAT,1844,27,30-34,1871,23.888112957903353
SIM,1819,68,na,1887,844
SIM,1908,22,20-24,1930,119
SIM,1927,22,30-34,1949,44
STAT,1915,44,na,1959,3802.835943093134
STAT,1931,3,na,1934,5414.416202388676
SIM,1853,49,35-39,1902,1
SIM,1913,52,na,1965,3710
STAT,1818,46,20-24,1864,0.027682033958113635
SIM,1869,25,35-39,1894,22
STAT,1889,11,na,1900,3259.1886120582258
STAT,1938,25,45-49,1963,1.7474630555226025
STAT,1866,38,15-19,1904,0.052577683032981305
SIM,1830,36,35-39,1866,10
SIM,1833,28,25-29,1861,53
SIM,1895,70,na,1965,2058
SIM,1830,35,30-34,1865,3
SIM,1855,49,50-100,1904,1
SIM,1847,33,35-39,1880,11
STAT,1895,17,35-39,1912,0.73033787577992
SIM,1905,30,30-34,1935,23
SIM,1897,39,20-24,1936,1
SIM,1917,36,30-34,1953,1
SIM,1933,29,na,1962,5135
STAT,1938,20,25-29,1958,93.31933158702003
SIM,1884,17,25-29,1901,1
STAT,1776,80,na,1856,229.1669710173
STAT,1844,28,35-39,1872,9.087469294040629
SIM,1842,76,na,1918,692
STAT,1898,69,na,1967,2330.550191570992
STAT,1948,20,35-39,1968,11.037915683933495
SIM,1894,17,35-39,1911,1
SIM,1891,24,40-44,1915,7
SIM,1828,35,40-44,1863,6
STAT,1902,23,15-19,1925,4.731460548148733
STAT,1866,26,20-24,1892,11.076828627430768
STAT,1915,38,20-24,1953,0.2703961446153855
SIM,1891,20,25-29,1911,75
STAT,1883,20,25-29,1903,57.64276832284244
STAT,1931,16,45-49,1947,0.6684718023934387
SIM,1851,15,20-24,1866,17
STAT,1834,48,20-24,1882,0.008455222944065166
STAT,1919,22,30-34,1941,32.11634942003502
STAT,1874,37,45-49,1911,2.076339708136161
SIM,1824,33,40-44,1857,9
STAT,1889,39,20-24,1928,0.9616038037848856
STAT,1901,15,20-24,1916,25.40866003850888
STAT,1943,24,15-19,1967,5.774264773036855
STAT,1851,6,na,1857,2502.419823439255
STAT,1931,22,30-34,1953,38.017019052340736
STAT,1829,38,45-49,1867,1.7197923334346108
SIM,1932,15,15-19,1947,55
SIM,1846,25,40-44,1871,3
SIM,1918,44,25-29,1962,1
STAT,1869,37,50-100,1906,1.2092141999306154
SIM,1946,20,25-29,1966,109
STAT,1890,41,na,1931,2895.938961690768
STAT,1859,47,20-24,1906,0.00973100100998743
STAT,1895,40,na,1935,3107.326251537213
STAT,1896,26,50-100,1922,0.8648495302070605
SIM,1858,40,35-39,1898,6
SIM,1927,20,15-19,1947,13
STAT,1838,26,45-49,1864,1.045237661308612
STAT,1865,74,na,1939,1027.5563808141262
SIM,1836,37,40-44,1873,10
STAT,1861,52,50-100,1913,0.012663363799310975
SIM,1849,30,40-44,1879,2
SIM,1831,39,na,1870,1655
STAT,1859,38,30-34,1897,4.320550016334281
SIM,1814,69,na,1883,832
STAT,1843,20,na,1863,2197.9995414311197
STAT,1921,27,40-44,1948,5.3009148822114245
STAT,1935,17,40-44,1952,1.9499908954578826
SIM,1882,74,na,1956,938
STAT,1870,18,35-39,1888,0.5491661058343951
SIM,1899,28,25-29,1927,79
STAT,1895,28,40-44,1923,3.9730936496772125
STAT,1827,35,na,1862,1849.9283789748793
SIM,1905,17,20-24,1922,31
STAT,1849,89,na,1938,81.55940877604627
STAT,1941,28,20-24,1969,19.255472998276776
SIM,1938,23,45-49,1961,1
SIM,1860,36,20-24,1896,3
STAT,1841,61,na,1902,1379.7120571678608
SIM,1896,55,na,1951,2778
STAT,1905,32,30-34,1937,14.770824842352622
STAT,1878,70,na,1948,1489.8701000098495
STAT,1834,37,15-19,1871,0.04700524138332365
SIM,1951,19,40-44,1970,2
STAT,1923,20,30-34,1943,34.32429732395964
STAT,1855,34,30-34,1889,13.497912342708425
SIM,1895,24,25-29,1919,77
STAT,1881,27,35-39,1908,9.516520087105315
SIM,1943,17,40-44,1960,1
SIM,1935,24,30-34,1959,51
STAT,1887,24,25-29,1911,65.0297081299866
STAT,1786,79,na,1865,230.57222391127462
STAT,1785,94,na,1879,4.310863248711527
SIM,1924,33,45-49,1957,8
STAT,1906,27,15-19,1933,0.6736782847270667
SIM,1938,7,na,1945,3976
STAT,1892,19,25-29,1911,7.20640815347502
STAT,1919,20,15-19,1939,5.9837799155475935
STAT,1826,46,20-24,1872,0.009501802301208976
SIM,1846,26,45-49,1872,3
STAT,1869,36,25-29,1905,2.849394174962644
STAT,1939,26,15-19,1965,0.7243077851169047
STAT,1913,25,40-44,1938,4.770082926328192
SIM,1863,49,na,1912,1900
STAT,1828,37,40-44,1865,3.8377205508611065
STAT,1939,32,35-39,1971,9.511738436718783
STAT,1927,24,30-34,1951,35.89555585571204
STAT,1869,27,35-39,1896,9.503310981064278
STAT,1875,52,na,1927,2242.388242723743
STAT,1860,29,30-34,1889,20.765315563655843
SIM,1893,37,na,1930,3108
STAT,1826,94,na,1920,11.65669360791021
SIM,1883,15,na,1898,2645
STAT,1869,99,na,1968,10.608481959301542
STAT,1847,23,na,1870,2029.320217361104
STAT,1945,10,na,1955,4379.147546369636
SIM,1897,15,45-49,1912,2
STAT,1879,31,15-19,1910,0.15247771959015338
SIM,1866,89,na,1955,94
STAT,1811,95,na,1906,5.759074268192883
STAT,1926,39,35-39,1965,3.0091945109112004
SIM,1833,27,20-24,1860,10
STAT,1837,46,30-34,1883,0.06786050893669619
SIM,1828,33,25-29,1861,17
STAT,1772,110,na,1882,0.0010801290967770226
STAT,1915,21,35-39,1936,9.962114441876412
SIM,1895,9,na,1904,3615
STAT,1848,38,20-24,1886,0.611115231469762
SIM,1931,20,30-34,1951,46
STAT,1832,24,35-39,1856,5.622075013241729
SIM,1879,20,25-29,1899,109
STAT,1842,39,15-19,1881,0.046042890759918666
STAT,1910,25,15-19,1935,0.7059387883345791
STAT,1825,76,na,1901,568.1227507903702
SIM,1856,38,20-24,1894,3
STAT,1877,24,50-100,1901,0.4287761850032729
STAT,1908,31,45-49,1939,1.5208093872353787
STAT,1918,46,25-29,1964,0.05774769747293776
STAT,1877,29,35-39,1906,10.13642728990128
STAT,1881,18,45-49,1899,0.06425731412659705
STAT,1877,35,20-24,1912,0.823370471686379
SIM,1923,30,na,1953,4249
STAT,1907,15,na,1922,3800.649194128349
STAT,1813,76,na,1889,408.6681216819079
STAT,1946,22,25-29,1968,104.87279252418504
SIM,1799,64,na,1863,1009
STAT,1843,42,na,1885,1921.053557987977
STAT,1869,38,40-44,1907,4.290054690496318
STAT,1860,27,15-19,1887,0.3795598101207444
SIM,1854,23,25-29,1877,74
SIM,1877,36,25-29,1913,2
STAT,1851,17,20-24,1868,17.78296002832865
SIM,1896,33,na,1929,3290
STAT,1893,37,20-24,1930,0.997591361655564
SIM,1887,26,40-44,1913,5
STAT,1934,21,45-49,1955,1.5425484871134394
SIM,1873,23,35-39,1896,14
SIM,1896,36,35-39,1932,6
STAT,1871,39,35-39,1910,7.0754263408297335
SIM,1843,16,25-29,1859,12
STAT,1903,33,50-100,1936,0.7597239346191409
SIM,1848,39,25-29,1887,5
STAT,1846,25,40-44,1871,2.629142853210589
STAT,1788,104,na,1892,0.022087808884701854
STAT,1935,22,15-19,1957,7.39238307621774
SIM,1915,31,50-100,1946,1
STAT,1927,18,45-49,1945,0.6319290896766802
SIM,1829,45,35-39,1874,1
STAT,1830,106,na,1936,0.007680737635350888
STAT,1875,49,20-24,1924,0.012301798921925894
STAT,1889,48,45-49,1937,0.16564707792972178
SIM,1811,62,na,1873,849
STAT,1816,49,15-19,1865,7.963749889236475E-4
STAT,1830,38,35-39,1868,6.299665795518892
SIM,1864,23,na,1887,2160
STAT,1828,102,na,1930,0.16144171505315508
STAT,1859,48,25-29,1907,0.04633793477591106
STAT,1892,18,20-24,1910,22.60763695385645
STAT,1948,21,50-100,1969,0.7710652219242827
SIM,1841,36,45-49,1877,1
SIM,1878,48,na,1926,2510
STAT,1858,26,20-24,1884,9.785987619953524
STAT,1852,36,20-24,1888,0.6308837176494431
STAT,1911,20,50-100,1931,0.6403412942279568
SIM,1863,34,30-34,1897,24
STAT,1843,42,50-100,1885,0.87810044263041
SIM,1883,22,40-44,1905,2
STAT,1907,31,50-100,1938,0.7912711268238738
STAT,1926,33,50-100,1959,1.0192572886895
STAT,1917,34,15-19,1951,0.136146337963233
STAT,1821,54,50-100,1875,0.02196100980913091
SIM,1913,32,30-34,1945,25
SIM,1902,25,30-34,1927,5
STAT,1884,26,15-19,1910,0.45948552563444117
SIM,1834,57,na,1891,1326
STAT,1876,37,na,1913,2481.8555781952073
SIM,1822,36,35-39,1858,7
STAT,1860,53,na,1913,1753.5923395694438
STAT,1879,27,45-49,1906,1.1839772874364494
SIM,1854,25,40-44,1879,1
SIM,1877,38,40-44,1915,6
SIM,1844,34,20-24,1878,3
SIM,1835,25,30-34,1860,25
STAT,1837,47,35-39,1884,0.09689597372273824
SIM,1843,94,na,1937,24
SIM,1903,37,40-44,1940,1
STAT,1936,34,25-29,1970,9.144711350506629
SIM,1780,84,na,1864,118
STAT,1843,19,50-100,1862,0.049948319780152184
SIM,1814,80,na,1894,323
STAT,1904,20,20-24,1924,101.35576190753824
SIM,1889,39,20-24,1928,2
STAT,1929,25,na,1954,4800.040569518824
STAT,1836,28,35-39,1864,7.716091447099904
STAT,1951,17,25-29,1968,52.64361827077638
STAT,1844,54,50-100,1898,0.011381459716676381
STAT,1894,49,30-34,1943,0.07015536761250118
STAT,1870,17,30-34,1887,1.6046481902224738
SIM,1924,15,na,1939,4549
SIM,1925,29,40-44,1954,10
SIM,1911,33,50-100,1944,1
STAT,1917,29,40-44,1946,4.9526330854381175
STAT,1946,24,40-44,1970,3.8148998197369006
STAT,1859,39,35-39,1898,5.7044188100051345
SIM,1866,26,20-24,1892,12
STAT,1845,86,na,1931,173.36227799151288
SIM,1933,21,50-100,1954,4
SIM,1942,21,45-49,1963,3
SIM,1893,15,na,1908,3320
STAT,1856,60,na,1916,1527.2761573234395
SIM,1844,28,35-39,1872,12
STAT,1907,39,25-29,1946,0.9214922745674067
STAT,1865,23,35-39,1888,5.4295008646361
SIM,1876,24,15-19,1900,4
SIM,1912,20,20-24,1932,123
STAT,1884,88,na,1972,396.8548124915593
SIM,1907,44,50-100,1951,1
STAT,1906,30,na,1936,3602.16791981964
STAT,1888,36,35-39,1924,8.571141947081383
STAT,1828,34,35-39,1862,9.359891735072484
STAT,1826,30,na,1856,1747.7633028118726
SIM,1819,49,50-100,1868,1
SIM,1873,17,na,1890,2528
SIM,1853,33,25-29,1886,4
SIM,1894,27,35-39,1921,20
STAT,1917,31,45-49,1948,1.6884189657210347
SIM,1859,29,35-39,1888,13
SIM,1850,32,45-49,1882,1
SIM,1871,29,35-39,1900,24
STAT,1919,27,na,1946,4130.540608006284
SIM,1939,8,na,1947,4016
STAT,1908,63,na,1971,3043.8234531007447
SIM,1854,34,na,1888,2072
STAT,1864,50,25-29,1914,0.0032590679233829322
STAT,1915,26,50-100,1941,1.0395476924345568
SIM,1876,36,30-34,1912,10
SIM,1887,24,40-44,1911,3
STAT,1908,20,40-44,1928,3.1708785581133556
SIM,1853,31,30-34,1884,7
STAT,1827,42,20-24,1869,0.18820258020825884
STAT,1854,39,35-39,1893,5.358810717788605
STAT,1868,36,30-34,1904,5.217960612852158
STAT,1892,38,15-19,1930,0.07144096890551302
SIM,1832,41,40-44,1873,5
SIM,1893,35,20-24,1928,2
STAT,1834,45,15-19,1879,3.218503328737754E-4
STAT,1854,31,25-29,1885,8.111632349527644
STAT,1807,105,na,1912,0.012391012389096085
STAT,1836,48,30-34,1884,0.062256540741470995
STAT,1894,33,20-24,1927,3.5320345550793633
SIM,1916,4,na,1920,4366
STAT,1845,33,25-29,1878,9.417338210216284
SIM,1936,31,20-24,1967,3
SIM,1827,36,35-39,1863,13
SIM,1852,3,na,1855,2834
STAT,1893,60,na,1953,2468.1698297208213
SIM,1846,15,na,1861,2309
SIM,1823,43,40-44,1866,4
STAT,1871,41,50-100,1912,1.0724011574475116
SIM,1890,72,na,1962,1775
STAT,1897,36,50-100,1933,1.6827464056326327
STAT,1823,97,na,1920,2.9899368258288046
SIM,1882,53,na,1935,2046
STAT,1900,44,25-29,1944,0.06220075767096146
STAT,1886,27,35-39,1913,10.419029694099283
SIM,1815,44,45-49,1859,5
STAT,1882,34,40-44,1916,4.273260146732557
STAT,1875,28,15-19,1903,0.4733592828701871
STAT,1895,25,35-39,1920,12.929959346933046
STAT,1816,42,45-49,1858,3.5506754866600443
STAT,1861,27,30-34,1888,21.381764372016608
SIM,1844,33,30-34,1877,27
SIM,1882,35,45-49,1917,1
STAT,1884,19,25-29,1903,5.688658900037644
STAT,1845,31,30-34,1876,16.389819480876433
STAT,1874,35,45-49,1909,2.096058957941574
SIM,1928,32,25-29,1960,14
STAT,1832,36,50-100,1868,1.0540043668587935
SIM,1885,29,35-39,1914,14
SIM,1916,20,40-44,1936,5
SIM,1945,0,na,1945,4866
STAT,1885,40,15-19,1925,0.014197175298117771
SIM,1818,43,30-34,1861,2
STAT,1813,53,30-34,1866,0.014002622086695582
STAT,1824,41,40-44,1865,2.8274281479751613
STAT,1848,47,50-100,1895,0.19002296580679381
STAT,1887,52,na,1939,2448.3219028842773
SIM,1880,27,35-39,1907,15
STAT,1859,45,20-24,1904,0.009874048234681276
STAT,1871,46,30-34,1917,0.09809651001781686
SIM,1890,34,40-44,1924,3
STAT,1940,12,na,1952,4087.3772691130107
STAT,1880,44,30-34,1924,1.2158422461802207
STAT,1854,49,35-39,1903,0.10491244371519834
STAT,1815,43,40-44,1858,6.724790233739336
STAT,1926,32,50-100,1958,1.0198896202540575
STAT,1891,32,40-44,1923,5.477263998533149
SIM,1848,93,na,1941,39
STAT,1913,10,na,1923,4131.771030489739
STAT,1819,41,30-34,1860,2.555160729070238
STAT,1876,42,15-19,1918,0.014529769717362168
STAT,1883,33,45-49,1916,1.738139708213232
SIM,1841,16,15-19,1857,7
STAT,1843,43,15-19,1886,0.01133231748163126
SIM,1819,37,na,1856,1580
STAT,1927,22,15-19,1949,6.690119519167035
SIM,1818,38,35-39,1856,18
SIM,1835,35,30-34,1870,1
SIM,1855,51,na,1906,1689
SIM,1867,28,30-34,1895,29
STAT,1863,47,35-39,1910,0.12463944415140488
SIM,1823,42,na,1865,1579
STAT,1854,89,na,1943,80.4031979890506
STAT,1928,31,20-24,1959,3.1127683339656733
STAT,1828,49,35-39,1877,0.10664935633338472
STAT,1811,46,50-100,1857,0.6943476742368094
STAT,1833,34,45-49,1867,1.4578254295916284
STAT,1890,40,25-29,1930,0.8090683774250365
SIM,1778,81,na,1859,239
SIM,1852,23,na,1875,2149
SIM,1827,56,na,1883,1196
SIM,1935,22,15-19,1957,8
STAT,1842,88,na,1930,107.65842385700122
STAT,1856,101,na,1957,0.6474499898432371
STAT,1906,48,50-100,1954,0.20312408776007282
STAT,1831,26,35-39,1857,9.89106779103901
STAT,1856,44,40-44,1900,1.776914769398075
STAT,1929,30,25-29,1959,11.987848613064235
STAT,1895,71,na,1966,2079.545154033884
STAT,1857,3,na,1860,2645.6897011197652
SIM,1909,57,na,1966,3138
STAT,1896,25,50-100,1921,0.8677391014147718
SIM,1864,44,40-44,1908,4
STAT,1859,28,30-34,1887,20.720350135618144
STAT,1836,40,na,1876,1597.1660805938002
SIM,1824,42,45-49,1866,3
STAT,1880,39,35-39,1919,7.506067968288125
STAT,1886,32,30-34,1918,18.85321412708436
STAT,1879,33,50-100,1912,0.9729199064244779
SIM,1888,78,na,1966,1175
SIM,1900,38,40-44,1938,1
STAT,1825,47,15-19,1872,5.144648287679166E-4
STAT,1862,30,20-24,1892,2.3662045235979856
STAT,1815,44,50-100,1859,2.9969762815027217
SIM,1925,31,45-49,1956,2
STAT,1889,28,15-19,1917,0.569717874307048
SIM,1852,34,20-24,1886,4
SIM,1853,26,35-39,1879,16
SIM,1919,21,20-24,1940,3
STAT,1856,29,15-19,1885,0.37110254293165046
SIM,1836,34,35-39,1870,24
STAT,1830,45,30-34,1875,0.08244787329776483
STAT,1870,102,na,1972,3.1191748228136764
STAT,1854,38,50-100,1892,0.9349978864808219
STAT,1859,13,na,1872,2247.3925914299325
STAT,1835,37,30-34,1872,4.911254614734932
SIM,1872,43,35-39,1915,1
STAT,1877,36,25-29,1913,3.0611007937286523
SIM,1831,61,na,1892,1198
STAT,1813,48,35-39,1861,0.34600357443071966
STAT,1850,31,40-44,1881,3.4481014980743625
STAT,1788,105,na,1893,0.009709579907626088
STAT,1835,19,30-34,1854,3.2701911886312036
STAT,1877,19,35-39,1896,0.5774679034222676
STAT,1906,1,na,1907,4041.5518575493797
STAT,1952,13,na,1965,4801.209831465482
STAT,1853,15,30-34,1868,1.6267783231622543
SIM,1869,87,na,1956,125
SIM,1894,54,na,1948,2784
STAT,1895,32,25-29,1927,13.63301847710919
STAT,1875,46,15-19,1921,4.199929715695131E-4
STAT,1825,29,15-19,1854,1.5374033705764962
STAT,1857,22,na,1879,1966.577560752342
STAT,1919,16,30-34,1935,2.764491425975586
SIM,1914,48,na,1962,3722
SIM,1844,24,na,1868,2098
SIM,1870,23,30-34,1893,21
STAT,1881,40,30-34,1921,1.1453331768412012
STAT,1831,44,35-39,1875,1.4942014811656361
STAT,1843,25,15-19,1868,0.45729373050806865
STAT,1851,30,45-49,1881,1.5288343679450294
SIM,1885,36,25-29,1921,4
STAT,1833,29,20-24,1862,10.139558031472776
SIM,1868,27,35-39,1895,12
SIM,1841,34,45-49,1875,3
STAT,1852,51,45-49,1903,0.011747162596437261
STAT,1864,43,35-39,1907,1.6306916841233134
SIM,1843,19,30-34,1862,3
STAT,1828,41,25-29,1869,0.5336659963179696
SIM,1799,63,na,1862,1055
STAT,1897,48,45-49,1945,0.17930390612062744
SIM,1858,16,na,1874,2272
STAT,1839,19,15-19,1858,5.294841324215507
STAT,1881,42,25-29,1923,0.632565220152482
STAT,1836,18,35-39,1854,0.6376145035202251
SIM,1833,40,45-49,1873,4
SIM,1826,37,30-34,1863,4
SIM,1927,16,30-34,1943,17
STAT,1844,34,20-24,1878,2.4533462808588933
STAT,1844,59,na,1903,1506.0124963618948
STAT,1848,50,40-44,1898,0.00830109074944209
STAT,1852,78,na,1930,629.442907452985
STAT,1869,47,30-34,1916,0.09489466033972238
SIM,1872,43,na,1915,2409
STAT,1862,23,30-34,1885,15.720918416385201
STAT,1885,28,30-34,1913,25.539387356653418
STAT,1855,23,40-44,1878,1.8735974638493977
STAT,1887,47,50-100,1934,0.2794446720855774
STAT,1889,46,45-49,1935,0.2982382530446186
STAT,1850,5,na,1855,2311.33
STAT,1853,27,50-100,1880,0.6213736987611715
SIM,1880,62,na,1942,1663
STAT,1831,51,25-29,1882,0.0025992253959641054
STAT,1844,35,30-34,1879,4.896487565468153
STAT,1913,20,20-24,1933,110.57662653491556
STAT,1881,43,35-39,1924,1.7730633021822633
STAT,1892,31,45-49,1923,2.238696084966217
STAT,1848,27,15-19,1875,0.42103088982213915
SIM,1949,22,45-49,1971,2
STAT,1867,32,na,1899,2285.4457622664
SIM,1903,32,na,1935,3412
STAT,1843,18,25-29,1861,5.811587068437808
SIM,1843,37,30-34,1880,10
SIM,1907,46,na,1953,3457
STAT,1919,24,50-100,1943,0.7306616060473092
SIM,1861,91,na,1952,10
STAT,1853,40,na,1893,1957.5263359672463
SIM,1851,18,25-29,1869,10
STAT,1814,52,35-39,1866,0.02455893579262824
STAT,1860,17,15-19,1877,5.665239896586435
STAT,1933,39,40-44,1972,2.074987803756511
STAT,1826,50,50-100,1876,0.01185608696646687
SIM,1863,23,40-44,1886,4
SIM,1847,19,15-19,1866,7
STAT,1868,18,na,1886,2490.66728513136
STAT,1825,40,45-49,1865,2.1304812831601105
STAT,1872,45,35-39,1917,0.14456719734766232
STAT,1846,54,25-29,1900,0.002463315489792394
STAT,1818,37,30-34,1855,20.03872446783301
SIM,1839,57,na,1896,1505
SIM,1877,32,30-34,1909,33
STAT,1844,53,50-100,1897,0.011515383628273201
STAT,1872,23,na,1895,2410.6239068264226
SIM,1835,43,na,1878,1672
STAT,1801,108,na,1909,6.535556559279129E-4
STAT,1814,51,25-29,1865,0.01030855937866583
SIM,1865,43,45-49,1908,3
SIM,1937,30,25-29,1967,13
STAT,1885,18,30-34,1903,1.6179563407442528
STAT,1943,2,na,1945,4386.705729521941
SIM,1877,34,25-29,1911,16
SIM,1894,32,30-34,1926,27
STAT,1857,43,45-49,1900,1.183787861491031
STAT,1858,42,50-100,1900,0.8536254315396249
STAT,1928,16,25-29,1944,55.83340172894001
SIM,1831,42,35-39,1873,1
STAT,1845,21,na,1866,2088.9652065664277
SIM,1921,20,20-24,1941,147
STAT,1870,25,30-34,1895,25.283343895983936
STAT,1809,51,15-19,1860,1.0659709252945671E-4
STAT,1905,21,25-29,1926,84.59714799731185
SIM,1827,41,30-34,1868,3
SIM,1846,23,40-44,1869,2
SIM,1857,86,na,1943,113
STAT,1868,19,40-44,1887,0.17931040982548901
SIM,1893,28,30-34,1921,39
STAT,1878,22,50-100,1900,0.43301682489536314
STAT,1899,37,15-19,1936,0.016931927674495115
STAT,1827,35,30-34,1862,7.28428481554403
STAT,1838,23,40-44,1861,1.9721607151763545
SIM,1895,16,na,1911,3518
SIM,1897,46,45-49,1943,1
STAT,1873,40,na,1913,2414.518744670097
STAT,1874,17,15-19,1891,6.181201704208474
STAT,1894,26,30-34,1920,33.15754621980464
SIM,1816,60,na,1876,1179
SIM,1911,51,na,1962,3528
STAT,1830,48,35-39,1878,0.11469015233033088
STAT,1841,36,45-49,1877,1.752284218228259
STAT,1885,19,50-100,1904,0.049595490761210316
STAT,1860,35,15-19,1895,0.04692135685598478
STAT,1829,33,40-44,1862,3.9615636820076237
STAT,1834,27,15-19,1861,0.40036227326619067
STAT,1855,52,25-29,1907,0.0027311451887827346
STAT,1869,38,50-100,1907,1.2032164974989594
STAT,1889,17,50-100,1906,0.061736803840350615
SIM,1915,49,40-44,1964,1
STAT,1947,23,50-100,1970,0.7584831135072313
STAT,1871,24,35-39,1895,5.85998074409238
SIM,1868,37,35-39,1905,13
SIM,1853,16,35-39,1869,2
SIM,1868,42,30-34,1910,2
STAT,1866,41,45-49,1907,1.4146659785431386
STAT,1835,86,na,1921,165.3123749376629
STAT,1851,27,15-19,1878,0.4382679055620591
STAT,1858,36,15-19,1894,0.045648125691229086
SIM,1862,31,25-29,1893,10
STAT,1805,49,50-100,1854,0.8765663760212422
SIM,1941,26,na,1967,3913
STAT,1780,95,na,1875,2.3179547371435225
STAT,1831,72,na,1903,850.965346265242
STAT,1845,16,35-39,1861,0.5450906729739406
SIM,1863,70,na,1933,1081
SIM,1871,26,na,1897,2228
STAT,1819,36,35-39,1855,21.737262922289702
STAT,1866,48,15-19,1914,3.716584313122892E-4
STAT,1809,47,30-34,1856,0.4305582395902348
STAT,1853,32,20-24,1885,2.3340371138719758
STAT,1869,32,30-34,1901,17.19622288280328
STAT,1907,21,35-39,1928,8.767279008147746
SIM,1852,35,30-34,1887,4
STAT,1865,42,40-44,1907,2.080046830021115
STAT,1822,52,50-100,1874,0.02070042401096594
STAT,1823,42,35-39,1865,2.9292752521855268
STAT,1879,24,40-44,1903,2.208169369671302
STAT,1913,54,na,1967,3562.6195204732962
SIM,1926,24,15-19,1950,11
STAT,1892,32,50-100,1924,1.1714766427500771
STAT,1805,54,35-39,1859,0.029144990018603368
STAT,1818,44,20-24,1862,0.37536238179072495
STAT,1855,50,30-34,1905,0.004680717072630967
SIM,1814,45,50-100,1859,1
STAT,1868,26,30-34,1894,24.620623452878007
STAT,1910,22,50-100,1932,0.6302261148406015
STAT,1890,33,35-39,1923,12.57855625970396
STAT,1853,25,30-34,1878,24.815849083420524
STAT,1876,38,30-34,1914,5.586486746172718
STAT,1815,46,45-49,1861,0.6455516155722072
STAT,1833,47,50-100,1880,0.19029887022967404
SIM,1848,61,na,1909,1464
STAT,1869,34,25-29,1903,10.001657702978783
STAT,1880,26,30-34,1906,27.088384501518092
STAT,1943,21,45-49,1964,1.2217519129679264
SIM,1861,32,20-24,1893,5
SIM,1915,21,35-39,1936,14
STAT,1917,48,50-100,1965,0.2404171373021894
SIM,1877,47,30-34,1924,1
STAT,1901,21,na,1922,3384.1152688862926
SIM,1867,38,30-34,1905,1
SIM,1837,33,40-44,1870,2
SIM,1894,34,25-29,1928,15
STAT,1885,35,20-24,1920,0.7920046523600773
SIM,1867,52,na,1919,1889
SIM,1875,71,na,1946,1247
SIM,1882,32,40-44,1914,6
STAT,1896,13,na,1909,3474.1592643422427
STAT,1896,24,40-44,1920,2.790050787745722
SIM,1884,38,30-34,1922,10
SIM,1827,43,25-29,1870,1
STAT,1905,35,na,1940,3531.7824137139432
SIM,1861,25,30-34,1886,40
STAT,1882,37,45-49,1919,1.9812802416142408
STAT,1865,27,15-19,1892,0.4200844654682655
STAT,1854,24,35-39,1878,5.17255607240268
STAT,1904,31,50-100,1935,1.345085813855192
STAT,1918,24,15-19,1942,5.822082157621168
SIM,1817,47,30-34,1864,1
STAT,1830,55,na,1885,1332.0515740574153
SIM,1862,24,35-39,1886,5
STAT,1875,31,45-49,1906,1.8332617911485183
SIM,1883,31,45-49,1914,3
STAT,1886,34,25-29,1920,10.965396039884466
STAT,1840,42,35-39,1882,1.359279343972124
STAT,1844,17,30-34,1861,1.5700335462026007
STAT,1907,49,40-44,1956,0.14239360336569695
SIM,1863,45,35-39,1908,1
STAT,1872,52,25-29,1924,0.0036021801182010618
SIM,1815,41,40-44,1856,7
SIM,1852,17,30-34,1869,4
STAT,1885,41,na,1926,2362.97455743714
SIM,1856,80,na,1936,473
STAT,1855,45,35-39,1900,0.1096097342542253
STAT,1819,43,25-29,1862,1.3462066682281344
SIM,1866,29,25-29,1895,50
STAT,1895,22,30-34,1917,23.708343822308034
STAT,1909,29,50-100,1938,0.9632144841439416
STAT,1854,46,30-34,1900,0.07429667188076301
SIM,1834,25,15-19,1859,1
STAT,1881,50,25-29,1931,0.003543609003792934
STAT,1864,46,40-44,1910,0.1557333959046091
STAT,1874,32,40-44,1906,4.516958474917144
STAT,1928,21,20-24,1949,142.03882158913677
SIM,1840,37,50-100,1877,1
STAT,1899,40,45-49,1939,0.14665171813785907
STAT,1964,5,na,1969,5050.204258888641
STAT,1860,22,na,1882,2017.9898970073157
STAT,1862,38,30-34,1900,4.6052496202933755
STAT,1879,54,35-39,1933,0.008927860761728586
STAT,1827,45,25-29,1872,0.06645939909599932
SIM,1833,32,45-49,1865,4
STAT,1831,43,25-29,1874,0.537005216001962
STAT,1868,39,35-39,1907,6.822262621404176
STAT,1885,36,30-34,1921,5.45043885323318
SIM,1891,49,50-100,1940,1
SIM,1870,38,30-34,1908,12
STAT,1877,33,20-24,1910,2.8479990275830325
STAT,1883,49,50-100,1932,0.24070421955871216
STAT,1800,89,na,1889,46.95244375852281
SIM,1813,46,35-39,1859,1
SIM,1840,42,na,1882,1657
STAT,1892,23,45-49,1915,0.8888138379546332
STAT,1862,31,30-34,1893,15.22398075653061
STAT,1832,37,50-100,1869,1.042660829578242
STAT,1868,40,15-19,1908,0.013591621429784866
STAT,1830,53,30-34,1883,0.004258954561142518
STAT,1935,24,15-19,1959,7.387357109546154
SIM,1890,37,45-49,1927,4
STAT,1893,16,15-19,1909,7.6990405484792035
STAT,1841,41,40-44,1882,1.7479881414743461
SIM,1859,26,30-34,1885,29
SIM,1876,89,na,1965,281
SIM,1858,38,30-34,1896,6
SIM,1880,37,35-39,1917,11
SIM,1828,93,na,1921,31
STAT,1825,32,45-49,1857,3.457169783710776
STAT,1854,36,30-34,1890,4.0986494963449145
STAT,1828,101,na,1929,0.314223432311797
STAT,1923,47,30-34,1970,0.10640254995011357
SIM,1866,90,na,1956,74
STAT,1858,29,25-29,1887,34.531816721198844
STAT,1775,84,na,1859,95.59614375975659
STAT,1762,98,na,1860,0.5263502362667982
STAT,1842,19,20-24,1861,17.643327882017473
STAT,1894,36,25-29,1930,3.796319336950775
SIM,1830,43,30-34,1873,2
SIM,1947,20,40-44,1967,5
STAT,1856,92,na,1948,33.35299636771143
STAT,1865,44,50-100,1909,0.9649683093171114
SIM,1852,42,20-24,1894,2
STAT,1822,36,na,1858,1682.4452148266255
SIM,1849,87,na,1936,113
STAT,1891,21,50-100,1912,0.5165933919376338
SIM,1879,53,na,1932,2601
STAT,1919,41,20-24,1960,0.019558143838380563
STAT,1899,33,na,1932,3319.53642022937
STAT,1855,53,35-39,1908,0.006566573998683783
STAT,1822,50,20-24,1872,0.0010525355791753358
SIM,1850,19,20-24,1869,13
STAT,1805,53,25-29,1858,0.012234122982603903
SIM,1936,21,20-24,1957,100
SIM,1927,23,20-24,1950,136
STAT,1846,37,35-39,1883,5.281972911303987
SIM,1919,24,25-29,1943,150
STAT,1835,44,20-24,1879,0.13825037689557276
STAT,1844,42,20-24,1886,0.12604014428963434
SIM,1947,11,na,1958,4672
SIM,1862,36,30-34,1898,10
STAT,1868,29,35-39,1897,9.334405836374907
STAT,1816,40,na,1856,1425.4664144191527
SIM,1900,12,na,1912,3725
SIM,1839,29,50-100,1868,1
SIM,1883,18,20-24,1901,22
SIM,1860,10,na,1870,2387
STAT,1939,20,40-44,1959,3.4471107617127474
SIM,1893,18,30-34,1911,6
STAT,1803,77,na,1880,399.53444681859924
STAT,1828,39,40-44,1867,3.678758090469623
STAT,1897,45,40-44,1942,0.1330397117717022
STAT,1947,22,na,1969,4210.880773614443
SIM,1844,32,20-24,1876,1
STAT,1839,37,na,1876,1766.4149551121754
SIM,1881,40,25-29,1921,1
SIM,1823,62,na,1885,1037
STAT,1856,47,45-49,1903,0.18810854665605486
STAT,1898,48,na,1946,3065.3440967070846
STAT,1895,37,30-34,1932,7.093726367606038
SIM,1885,26,30-34,1911,30
STAT,1883,30,40-44,1913,4.375796122938338
STAT,1919,23,20-24,1942,123.86839321004331
SIM,1919,47,na,1966,4156
SIM,1811,61,na,1872,874
SIM,1862,39,35-39,1901,12
SIM,1815,75,na,1890,364
STAT,1831,105,na,1936,0.019756889404839294
SIM,1770,85,na,1855,40
SIM,1864,24,na,1888,2098
STAT,1818,52,20-24,1870,0.0016059866445403618
SIM,1923,29,na,1952,4160
STAT,1877,26,30-34,1903,26.736051960545222
SIM,1841,31,40-44,1872,8
STAT,1872,27,35-39,1899,9.86535054806457
SIM,1889,63,na,1952,2338
SIM,1893,69,na,1962,2086
STAT,1850,12,na,1862,2194.3063610404993
SIM,1860,15,15-19,1875,6
STAT,1827,36,na,1863,1831.2759388597713
SIM,1836,39,40-44,1875,5
STAT,1869,67,na,1936,1561.2944089930236
STAT,1828,46,30-34,1874,0.07670859718696833
STAT,1863,44,30-34,1907,1.0144423051319806
SIM,1885,33,20-24,1918,1
STAT,1818,45,30-34,1863,0.2268270786950069
STAT,1833,31,40-44,1864,3.7448888704834484
STAT,1823,45,40-44,1868,0.26477211983029364
STAT,1828,31,30-34,1859,17.83676282725478
STAT,1900,35,na,1935,3362.870430509006
STAT,1904,49,na,1953,3221.333657003023
SIM,1882,73,na,1955,975
SIM,1933,20,40-44,1953,8
STAT,1885,43,20-24,1928,0.1604689098505657
SIM,1850,32,50-100,1882,1
STAT,1813,45,30-34,1858,0.2516007198213826
SIM,1844,41,30-34,1885,5
STAT,1871,37,na,1908,2380.772957956226
SIM,1905,11,na,1916,3758
STAT,1820,108,na,1928,0.0010088300473008955
STAT,1862,88,na,1950,119.21707426524796
STAT,1792,64,na,1856,731.3739732800002
SIM,1854,47,35-39,1901,1
SIM,1893,36,30-34,1929,8
SIM,1868,39,50-100,1907,4
STAT,1880,36,30-34,1916,5.740964426235671
STAT,1881,26,50-100,1907,0.6330792789571038
STAT,1821,37,30-34,1858,11.669434727624404
STAT,1852,33,15-19,1885,0.1175558266496509
STAT,1890,36,40-44,1926,5.486500953022463
STAT,1940,32,na,1972,3993.21909505976
STAT,1894,34,na,1928,3104.5513558981816
STAT,1807,52,45-49,1859,0.059962603775154326
STAT,1925,20,40-44,1945,4.130703811720049
STAT,1893,42,15-19,1935,0.017849938858429688
SIM,1836,31,30-34,1867,26
STAT,1873,40,25-29,1913,0.6708521638087698
SIM,1891,30,40-44,1921,6
STAT,1836,41,30-34,1877,0.8623276749047216
SIM,1864,47,45-49,1911,1
SIM,1876,39,35-39,1915,17
SIM,1874,33,45-49,1907,3
STAT,1786,80,na,1866,209.721577702978
STAT,1966,6,na,1972,5007.708592756045
STAT,1877,41,20-24,1918,0.16879817132593689
SIM,1840,40,35-39,1880,2
SIM,1856,45,45-49,1901,1
STAT,1770,85,na,1855,50.9859
SIM,1906,29,na,1935,3556
STAT,1841,33,40-44,1874,3.8448813586362407
SIM,1877,35,35-39,1912,8
STAT,1855,49,50-100,1904,0.1864135260134858
STAT,1805,88,na,1893,55.177965560037606
STAT,1839,17,50-100,1856,0.04423034313268315
STAT,1854,29,40-44,1883,2.3690743425141547
STAT,1767,97,na,1864,0.6148725161640967
STAT,1845,26,35-39,1871,9.242867588510967
STAT,1861,46,50-100,1907,0.20762080480576023
SIM,1836,41,25-29,1877,4
SIM,1898,68,na,1966,2674
STAT,1945,11,na,1956,4378.622048664071
SIM,1835,75,na,1910,604
STAT,1922,47,na,1969,4306.414899663379
SIM,1869,32,25-29,1901,12
SIM,1922,15,50-100,1937,3
STAT,1887,38,35-39,1925,8.045189629374427
SIM,1863,42,30-34,1905,3
STAT,1863,51,20-24,1914,6.631912742617615E-4
SIM,1895,38,35-39,1933,17
STAT,1889,43,40-44,1932,2.8139354708710425
SIM,1865,41,na,1906,2252
STAT,1853,18,35-39,1871,0.5502007222721305
SIM,1865,40,40-44,1905,3
STAT,1837,50,50-100,1887,0.010514503199785873
SIM,1794,64,na,1858,909
STAT,1927,43,50-100,1970,0.15005755061797427
SIM,1862,29,40-44,1891,2
SIM,1848,43,45-49,1891,4
STAT,1774,99,na,1873,0.24597691018697593
STAT,1861,34,20-24,1895,2.2590842739308292
SIM,1861,18,35-39,1879,1
SIM,1853,60,na,1913,1548
SIM,1798,78,na,1876,246
STAT,1842,32,50-100,1874,0.8679947698024508
STAT,1841,62,na,1903,1349.5101602364562
STAT,1863,52,30-34,1915,0.00529592433567888
STAT,1871,23,25-29,1894,57.669349902929746
STAT,1903,64,na,1967,2797.6314655385254
SIM,1947,1,na,1948,4826
STAT,1853,28,35-39,1881,8.467840613882762
STAT,1880,54,25-29,1934,0.0036927237839230855
SIM,1935,18,30-34,1953,18
STAT,1832,40,35-39,1872,1.5270034198445448
STAT,1869,35,35-39,1904,7.032338647973473
STAT,1952,19,50-100,1971,0.4576970508261448
STAT,1851,22,45-49,1873,0.687023296081394
STAT,1887,30,25-29,1917,11.80277888277895
SIM,1818,39,50-100,1857,1
SIM,1918,22,15-19,1940,7
STAT,1811,50,45-49,1861,0.03998245284493748
STAT,1867,44,15-19,1911,0.013047584035019415
SIM,1940,25,50-100,1965,3
STAT,1868,18,30-34,1886,1.5718201008679353
STAT,1834,69,na,1903,986.2148973460638
STAT,1880,42,na,1922,2474.666989865513
SIM,1875,44,15-19,1919,2
STAT,1914,16,50-100,1930,0.0792669741354612
STAT,1852,41,15-19,1893,0.011175560347326278
STAT,1914,15,50-100,1929,0.07944015367046277
SIM,1880,44,25-29,1924,2
SIM,1909,28,30-34,1937,6
SIM,1928,28,na,1956,5034
STAT,1851,37,15-19,1888,0.04682461373869359
SIM,1868,19,35-39,1887,3
SIM,1841,42,45-49,1883,3
SIM,1924,14,na,1938,4893
STAT,1915,45,na,1960,3795.40614299555
SIM,1829,67,na,1896,804
SIM,1940,3,na,1943,4181
SIM,1877,31,20-24,1908,6
STAT,1908,18,50-100,1926,0.07391335813945091
STAT,1877,49,30-34,1926,0.10028421312741241
SIM,1861,28,35-39,1889,15
STAT,1893,34,15-19,1927,0.18271851545003762
STAT,1840,50,35-39,1890,0.006284086963771354
SIM,1845,41,na,1886,1858
SIM,1876,18,30-34,1894,1
STAT,1817,49,30-34,1866,0.20966667961196947
STAT,1837,35,40-44,1872,3.6280787231943887
STAT,1872,44,25-29,1916,0.6476980597183698
STAT,1864,99,na,1963,5.5043414518757015
STAT,1831,36,35-39,1867,6.2968573929966905
STAT,1810,79,na,1889,289.9482377653208
SIM,1830,44,na,1874,1726
SIM,1866,35,na,1901,2375
STAT,1843,39,30-34,1882,4.476714422264853
SIM,1834,58,na,1892,1326
SIM,1919,17,35-39,1936,4
STAT,1840,45,na,1885,1674.986658287722
SIM,1835,38,35-39,1873,7
SIM,1899,30,na,1929,3291
STAT,1836,33,30-34,1869,13.595794183715133
SIM,1862,21,30-34,1883,18
STAT,1853,35,25-29,1888,2.4648641212815967
STAT,1869,42,25-29,1911,0.6316872079175062
SIM,1851,46,20-24,1897,1
SIM,1870,72,na,1942,1286
SIM,1895,30,25-29,1925,22
STAT,1859,46,30-34,1905,0.07908831920308983
STAT,1894,29,35-39,1923,12.57100550464881
STAT,1873,41,35-39,1914,1.8813075238723411
STAT,1927,18,30-34,1945,15.419072922966498
STAT,1879,65,na,1944,1802.099979881541
SIM,1854,37,35-39,1891,14
STAT,1822,51,30-34,1873,0.008322974340200164
STAT,1871,16,35-39,1887,0.5613716457313364
STAT,1875,51,na,1926,2265.1759124025134
STAT,1851,17,na,1868,2302.489571805671
STAT,1833,49,15-19,1882,2.748988092920283E-4
STAT,1826,43,15-19,1869,0.0111225250978145
SIM,1888,14,na,1902,3052
SIM,1889,44,45-49,1933,8
SIM,1901,41,na,1942,3516
STAT,1917,21,45-49,1938,1.2240392117075198
SIM,1877,42,na,1919,2364
STAT,1833,42,45-49,1875,1.1999345100841574
SIM,1961,6,na,1967,5329
STAT,1865,50,40-44,1915,0.00988765728953351
STAT,1862,33,na,1895,2063.5276040491667
STAT,1948,22,35-39,1970,11.030300833415957
SIM,1831,29,na,1860,1790
SIM,1885,34,30-34,1919,18
STAT,1863,25,40-44,1888,2.71828168188963
STAT,1906,20,na,1926,3532.685349298732
SIM,1910,20,45-49,1930,1
STAT,1805,105,na,1910,0.011784765917158579
STAT,1880,47,35-39,1927,0.14938444598875666
STAT,1854,21,30-34,1875,16.133799483984546
STAT,1877,34,30-34,1911,18.31571591216857
STAT,1903,20,50-100,1923,0.5948916476938901
STAT,1868,93,na,1961,59.165654086429974
STAT,1827,38,35-39,1865,8.955270538413163
SIM,1925,21,45-49,1946,1
STAT,1851,19,15-19,1870,5.882853402972345
STAT,1797,96,na,1893,2.1622533075392676
SIM,1851,39,30-34,1890,8
STAT,1933,30,na,1963,5203.700712870331
SIM,1856,42,40-44,1898,7
SIM,1875,26,15-19,1901,3
STAT,1863,18,na,1881,2331.9530638780825
STAT,1843,46,20-24,1889,0.009766440710529862
STAT,1859,53,20-24,1912,5.91541151347223E-4
STAT,1911,33,50-100,1944,0.8177667469964258
SIM,1861,35,25-29,1896,2
STAT,1880,29,35-39,1909,10.270006966837421
SIM,1853,17,na,1870,2248
STAT,1947,22,40-44,1969,3.877127880239753
STAT,1880,21,25-29,1901,61.55426921038285
STAT,1836,40,20-24,1876,0.12065629613548548
SIM,1847,76,na,1923,565
SIM,1831,92,na,1923,26
STAT,1902,20,45-49,1922,1.0091841974693008
STAT,1821,41,50-100,1862,1.8933909211818767
STAT,1900,36,25-29,1936,0.8829274623386686
STAT,1872,37,35-39,1909,7.2315646350577065
SIM,1821,38,35-39,1859,5
SIM,1843,62,na,1905,1386
SIM,1871,25,40-44,1896,5
STAT,1806,50,35-39,1856,0.029202196376792902
SIM,1876,27,50-100,1903,1
SIM,1858,48,na,1906,1851
STAT,1808,53,na,1861,1020.3688484909912
SIM,1885,16,30-34,1901,5
STAT,1811,96,na,1907,3.7193829346270117
STAT,1937,32,25-29,1969,9.327326770821676
STAT,1848,42,40-44,1890,1.7462839774364032
STAT,1895,47,30-34,1942,0.07233871230404551
SIM,1912,13,na,1925,4197
STAT,1835,19,50-100,1854,0.10051815134532269
STAT,1920,48,45-49,1968,0.24449137855613576
SIM,1842,17,20-24,1859,25
SIM,1939,24,na,1963,3679
STAT,1870,30,50-100,1900,0.9210822638190054
STAT,1852,6,na,1858,2430.756665370609
STAT,1869,39,30-34,1908,5.196315775985236
STAT,1915,47,25-29,1962,0.0545446549033707
STAT,1884,47,20-24,1931,0.012054927890617744
STAT,1933,36,50-100,1969,0.583737275886578
SIM,1840,32,35-39,1872,16
SIM,1849,29,25-29,1878,5
STAT,1885,39,35-39,1924,7.1262180797368355
STAT,1836,92,na,1928,25.924035493020767
STAT,1881,46,40-44,1927,0.16933008973497868
SIM,1845,36,30-34,1881,6
SIM,1948,16,15-19,1964,55
SIM,1859,34,50-100,1893,1
SIM,1819,45,40-44,1864,1
SIM,1923,26,50-100,1949,1
SIM,1929,13,na,1942,5403
STAT,1837,101,na,1938,0.380449900431481
STAT,1829,37,35-39,1866,6.184296220904249
STAT,1904,18,na,1922,3682.9278037381127
SIM,1877,24,30-34,1901,27
SIM,1886,36,40-44,1922,9
STAT,1878,36,40-44,1914,4.670673040966675
SIM,1846,59,na,1905,1535
STAT,1891,14,na,1905,3251.144324458588
SIM,1848,28,50-100,1876,2
STAT,1867,48,30-34,1915,0.09154354491988882
SIM,1822,41,30-34,1863,1
STAT,1769,105,na,1874,0.009921871239953924
STAT,1844,45,25-29,1889,0.04533878491332312
SIM,1890,17,na,1907,3276
STAT,1828,73,na,1901,654.055882481716
STAT,1835,33,15-19,1868,0.1337437010601943
SIM,1863,27,35-39,1890,11
SIM,1886,22,30-34,1908,23
SIM,1929,32,40-44,1961,6
STAT,1823,41,25-29,1864,1.0649165869312782
STAT,1895,15,50-100,1910,0.06551169608218621
SIM,1826,48,35-39,1874,1
STAT,1878,22,30-34,1900,18.91417286013493
STAT,1925,23,45-49,1948,1.3698458070984418
SIM,1877,39,30-34,1916,7
STAT,1884,21,45-49,1905,0.7059193565991714
SIM,1911,48,45-49,1959,1
SIM,1893,39,35-39,1932,9
STAT,1789,77,na,1866,270.14888687253335
SIM,1806,94,na,1900,7
STAT,1880,19,40-44,1899,0.19502597134840197
SIM,1901,30,45-49,1931,7
STAT,1870,21,15-19,1891,3.2999263804760353
SIM,1854,33,40-44,1887,1
SIM,1872,35,35-39,1907,12
SIM,1822,56,na,1878,1198
STAT,1818,48,35-39,1866,0.31300478582209135
SIM,1899,53,na,1952,2943
STAT,1863,94,na,1957,23.428320492979754
STAT,1876,52,45-49,1928,0.015206418560873023
STAT,1895,40,25-29,1935,0.8633424545181363
SIM,1820,42,50-100,1862,4
STAT,1900,15,na,1915,3587.67188890239
SIM,1873,27,15-19,1900,2
STAT,1858,28,15-19,1886,0.37304838587593797
STAT,1904,29,na,1933,3464.3157281398367
SIM,1828,43,40-44,1871,6
SIM,1918,26,30-34,1944,51
STAT,1814,41,30-34,1855,4.145418614840007
STAT,1878,37,30-34,1915,5.65927201600436
SIM,1880,34,30-34,1914,30
STAT,1957,12,na,1969,5281.906756763628
STAT,1872,34,30-34,1906,17.69849679568838
STAT,1930,3,na,1933,5348.281392847359
SIM,1857,22,na,1879,2106
STAT,1869,31,20-24,1900,2.6731450488936397
STAT,1881,32,30-34,1913,17.22012473469647
STAT,1945,3,na,1948,4469.281686950952
STAT,1900,29,35-39,1929,13.545590068750254
SIM,1909,20,20-24,1929,141
STAT,1893,38,30-34,1931,6.863043860457988
STAT,1867,26,15-19,1893,0.43601648538163623
STAT,1821,42,na,1863,1445.9997320104223
SIM,1898,29,20-24,1927,23
STAT,1892,20,40-44,1912,2.680175162287362
STAT,1904,30,20-24,1934,3.9838169630126634
STAT,1880,73,na,1953,1273.306022191048
STAT,1876,36,na,1912,2493.8008844316364
STAT,1873,33,35-39,1906,10.429713878163023
STAT,1853,41,30-34,1894,0.9683571536711961
SIM,1857,44,50-100,1901,2
STAT,1843,20,45-49,1863,0.7168479416901388
STAT,1872,41,20-24,1913,0.16310986197079738
STAT,1897,38,15-19,1935,0.07621695633976125
SIM,1845,35,40-44,1880,7
SIM,1939,18,15-19,1957,45
STAT,1809,93,na,1902,14.910536896192953
STAT,1850,46,50-100,1896,0.18526602160798333
SIM,1867,21,na,1888,2188
STAT,1869,50,25-29,1919,0.003538690408899983
STAT,1823,34,35-39,1857,21.1811830557271
STAT,1869,98,na,1967,15.438603427688019
STAT,1873,47,45-49,1920,0.24294497448185198
STAT,1860,39,30-34,1899,4.366969057593072
SIM,1845,21,30-34,1866,20
SIM,1857,28,20-24,1885,13
STAT,1922,21,25-29,1943,108.40943075095352
SIM,1831,41,25-29,1872,4
STAT,1806,74,na,1880,486.61616813165654
STAT,1852,44,20-24,1896,0.1262130883667566
SIM,1930,21,25-29,1951,149
STAT,1803,108,na,1911,7.107727979935036E-4
STAT,1826,104,na,1930,0.03890217741922823
STAT,1855,27,35-39,1882,7.796478154183253
STAT,1847,39,15-19,1886,0.04450031252437437
STAT,1890,25,35-39,1915,12.117116648495648
STAT,1890,32,25-29,1922,12.775977922731201
STAT,1890,72,na,1962,1790.7912628663778
SIM,1874,30,40-44,1904,8
STAT,1825,45,na,1870,1585.7520800226005
SIM,1819,39,40-44,1858,5
STAT,1837,36,30-34,1873,4.3715301576416286
STAT,1944,18,30-34,1962,13.378473624548143
STAT,1859,49,35-39,1908,0.11167860722267642
STAT,1879,53,25-29,1932,0.003716398678678069
STAT,1849,28,20-24,1877,10.71896611649765
STAT,1872,53,35-39,1925,0.008660829310688269
SIM,1956,15,na,1971,5501
STAT,1880,15,50-100,1895,0.05276476379218851
SIM,1856,69,na,1925,1444
SIM,1886,12,na,1898,2900
STAT,1840,45,40-44,1885,0.12745689334846994
STAT,1914,28,na,1942,3839.5574198580175
STAT,1899,29,15-19,1928,0.6292787508597933
STAT,1779,78,na,1857,237.79102880040782
STAT,1840,22,na,1862,1956.6317019241608
STAT,1886,67,na,1953,1711.737397728276
STAT,1948,8,na,1956,4588.777114168079
SIM,1933,23,45-49,1956,5
STAT,1840,31,30-34,1871,15.462564785291711
STAT,1867,19,25-29,1886,5.483066539439635
STAT,1942,29,40-44,1971,4.986111940865415
STAT,1805,50,20-24,1855,0.0027069186039784515
STAT,1847,50,25-29,1897,0.0028018003940658573
STAT,1931,28,na,1959,4930.120014195617
STAT,1882,53,na,1935,2105.6237433728993
SIM,1790,82,na,1872,114
SIM,1828,34,50-100,1862,2
STAT,1857,40,40-44,1897,1.8101228902278348
SIM,1944,23,20-24,1967,133
STAT,1885,46,25-29,1931,0.05879050264167654
STAT,1932,39,25-29,1971,1.346270332726086
STAT,1936,23,20-24,1959,108.39170352855332
SIM,1820,45,na,1865,1652
STAT,1819,37,na,1856,1728.438735540489
STAT,1837,54,30-34,1891,0.0038596855734843232
STAT,1841,44,45-49,1885,1.1192342319828865
SIM,1888,44,50-100,1932,4
SIM,1870,31,30-34,1901,29
STAT,1925,41,45-49,1966,0.20587122567192756
STAT,1823,74,na,1897,617.6560085021528
SIM,1831,34,35-39,1865,15
SIM,1873,69,na,1942,1489
SIM,1878,35,30-34,1913,13
SIM,1890,30,25-29,1920,21
STAT,1831,33,30-34,1864,15.78400596270494
SIM,1925,31,na,1956,4716
STAT,1848,18,na,1866,2198.9046921059307
STAT,1936,19,35-39,1955,4.075511709288815
STAT,1860,43,15-19,1903,0.011348020783689456
SIM,1924,39,40-44,1963,3
STAT,1831,52,35-39,1883,0.006193653615786177
STAT,1827,51,30-34,1878,0.0065789837481621
STAT,1863,73,na,1936,1062.3874111530558
SIM,1895,71,na,1966,2058
STAT,1868,32,15-19,1900,0.13875738781368066
SIM,1851,37,na,1888,1868
STAT,1864,42,25-29,1906,0.581772147051211
SIM,1897,2,na,1899,3591
STAT,1847,54,40-44,1901,0.0079838395493754
STAT,1899,47,15-19,1946,3.1373314323104043E-4
STAT,1815,55,na,1870,1370.6382299314312
STAT,1881,17,35-39,1898,0.5411794287717604
SIM,1834,29,30-34,1863,34
SIM,1842,77,na,1919,692
STAT,1898,41,40-44,1939,0.21645325286582226
STAT,1859,68,na,1927,1245.0454077016223
SIM,1896,26,35-39,1922,20
STAT,1843,17,15-19,1860,6.122316182327142
STAT,1911,47,40-44,1958,0.15224990577294598
SIM,1942,12,na,1954,4666
STAT,1866,47,na,1913,2107.163368947017
STAT,1871,20,20-24,1891,70.05327104300473
STAT,1920,35,na,1955,4210.888030114695
STAT,1855,54,na,1909,1623.2318608338253
STAT,1843,74,na,1917,895.9023636269219
STAT,1835,51,45-49,1886,0.011244491927225037
SIM,1864,88,na,1952,251
STAT,1906,21,40-44,1927,3.1034761450376305
STAT,1826,29,30-34,1855,42.42875991183235
STAT,1868,46,25-29,1914,0.05628290408433372
SIM,1881,33,35-39,1914,16
STAT,1925,22,50-100,1947,0.8035624578740642
SIM,1891,4,na,1895,3395
STAT,1894,42,30-34,1936,0.10463238322393227
STAT,1861,23,15-19,1884,2.8364880058014084
STAT,1893,49,na,1942,2851.3610512031823
STAT,1896,43,30-34,1939,0.1067893588793091
SIM,1944,19,35-39,1963,4
SIM,1895,45,30-34,1940,1
STAT,1882,30,25-29,1912,10.261714467372235
SIM,1843,18,na,1861,2320
SIM,1849,36,15-19,1885,3
STAT,1851,92,na,1943,34.36149030135428
SIM,1905,49,50-100,1954,1
SIM,1907,45,50-100,1952,1
STAT,1916,39,40-44,1955,1.5486539728674529
SIM,1918,5,na,1923,4643
STAT,1852,15,15-19,1867,5.851019826557241
STAT,1877,44,25-29,1921,0.6702859455021322
STAT,1877,42,30-34,1919,1.2149501740452895
SIM,1928,22,25-29,1950,155
SIM,1829,35,35-39,1864,11
SIM,1885,44,25-29,1929,1
STAT,1871,28,30-34,1899,25.357356736771738
SIM,1867,49,35-39,1916,1
STAT,1831,26,50-100,1857,0.6557454352352214
SIM,1886,37,30-34,1923,2
STAT,1832,28,15-19,1860,0.4080378209536726
STAT,1859,57,na,1916,1637.2764454344979
SIM,1848,40,40-44,1888,2
SIM,1903,15,30-34,1918,5
SIM,1886,22,50-100,1908,4
STAT,1877,16,30-34,1893,1.6905928401810448
STAT,1914,48,20-24,1962,0.011151336157601766
STAT,1829,52,30-34,1881,0.004237431852497122
STAT,1819,92,na,1911,24.554704648748288
STAT,1867,87,na,1954,168.7339231537201
STAT,1826,47,30-34,1873,0.07564003887368717
STAT,1807,59,na,1866,1209.3554738731898
STAT,1872,26,45-49,1898,1.1391025653891524
STAT,1888,44,35-39,1932,2.1543997476872865
STAT,1868,27,50-100,1895,0.6232953775431757
SIM,1828,41,na,1869,1744
STAT,1857,36,20-24,1893,0.617105807897997
SIM,1892,21,45-49,1913,1
STAT,1828,96,na,1924,4.728386696729762
SIM,1819,46,30-34,1865,1
STAT,1846,33,40-44,1879,3.6270811385765143
SIM,1897,17,50-100,1914,4
SIM,1918,33,20-24,1951,3
STAT,1883,48,15-19,1931,3.953549757974639E-4
STAT,1913,5,na,1918,4180.121841318752
STAT,1921,30,20-24,1951,2.792150555611599
STAT,1784,108,na,1892,0.0017102577670376996
SIM,1877,38,50-100,1915,3
STAT,1843,35,15-19,1878,0.05403169742333712
STAT,1795,84,na,1879,98.4610187473461
SIM,1820,34,25-29,1854,11
STAT,1836,43,25-29,1879,0.4694754830932096
STAT,1776,81,na,1857,185.4648296443009
STAT,1799,98,na,1897,1.0541155321041284
STAT,1814,60,na,1874,1131.946387587324
STAT,1899,9,na,1908,3624.6238122671907
STAT,1876,45,20-24,1921,0.0127671799621748
STAT,1906,49,25-29,1955,0.04723710836956727
STAT,1846,39,na,1885,1723.2537103839961
STAT,1884,18,15-19,1902,5.973946061653425
SIM,1844,43,25-29,1887,3
SIM,1869,37,30-34,1906,9
STAT,1837,24,35-39,1861,5.020411319449559
STAT,1843,73,na,1916,958.8406648689177
STAT,1847,87,na,1934,137.38806791899052
SIM,1889,41,40-44,1930,7
STAT,1833,50,45-49,1883,0.010292767997841968
STAT,1822,43,30-34,1865,1.7378165801534513
SIM,1841,82,na,1923,283
SIM,1813,49,50-100,1862,1
SIM,1895,34,40-44,1929,9
STAT,1893,45,20-24,1938,0.00884741111317114
STAT,1856,37,15-19,1893,0.04496876960736861
SIM,1782,86,na,1868,34
SIM,1898,13,na,1911,3992
SIM,1885,42,30-34,1927,7
STAT,1887,34,40-44,1921,4.915001755392967
SIM,1876,8,na,1884,3127
STAT,1826,54,20-24,1880,5.351107112544058E-4
SIM,1937,12,na,1949,4598
SIM,1864,55,na,1919,1934
SIM,1914,21,40-44,1935,5
STAT,1863,29,35-39,1892,8.568816862459792
STAT,1831,40,20-24,1871,0.13824142429410316
STAT,1815,78,na,1893,404.0079527708284
SIM,1878,16,na,1894,2826
STAT,1875,18,20-24,1893,18.513328939103292
SIM,1864,19,15-19,1883,7
SIM,1860,41,na,1901,2024
STAT,1896,25,30-34,1921,34.15910434882252
STAT,1907,20,45-49,1927,1.0507410253210085
SIM,1894,9,na,1903,3521
STAT,1832,46,45-49,1878,0.189778412817673
STAT,1868,52,30-34,1920,0.0057690936591881
STAT,1877,37,35-39,1914,7.4837589307849575
SIM,1830,25,30-34,1855,35
STAT,1863,21,25-29,1884,52.60154423264468
SIM,1904,31,25-29,1935,10
SIM,1858,26,15-19,1884,1
SIM,1885,37,35-39,1922,9
STAT,1856,19,15-19,1875,5.553411623926644
STAT,1832,32,35-39,1864,8.8823503144287
STAT,1930,20,20-24,1950,146.15127168535793
SIM,1912,31,50-100,1943,2
SIM,1871,21,25-29,1892,56
SIM,1872,42,25-29,1914,2
STAT,1814,44,35-39,1858,5.655690655725191
STAT,1782,108,na,1890,0.0050040030948908885
STAT,1856,91,na,1947,46.404814491626226
STAT,1824,44,45-49,1868,1.7727279214281508
SIM,1887,72,na,1959,1589
STAT,1777,96,na,1873,1.8236520210897305
SIM,1932,13,na,1945,5519
STAT,1859,108,na,1967,0.014522541446811052
SIM,1944,26,25-29,1970,87
SIM,1851,43,50-100,1894,3
STAT,1868,50,45-49,1918,0.01434362622695992
SIM,1904,39,50-100,1943,1
STAT,1884,24,na,1908,2372.0593880513493
STAT,1843,43,50-100,1886,0.8669222239957244
SIM,1853,30,20-24,1883,4
STAT,1908,23,45-49,1931,1.0515434888664228
STAT,1855,42,30-34,1897,0.8901235955916131
SIM,1833,33,50-100,1866,2
STAT,1838,49,15-19,1887,2.9471445455124225E-4
SIM,1845,39,35-39,1884,10
SIM,1851,92,na,1943,1
SIM,1835,39,25-29,1874,4
SIM,1891,57,na,1948,2586
STAT,1934,31,45-49,1965,2.192275635445179
STAT,1806,53,40-44,1859,0.03350537546760802
STAT,1895,36,40-44,1931,5.854547442051501
STAT,1898,37,20-24,1935,1.0634264504082984
STAT,1817,45,15-19,1862,9.21913894949921E-4
STAT,1900,41,20-24,1941,0.015664022527103152
SIM,1802,57,na,1859,1014
SIM,1823,32,35-39,1855,12
STAT,1871,49,35-39,1920,0.13851959078891526
STAT,1938,32,40-44,1970,4.013925870061842
STAT,1834,30,45-49,1864,1.5347319271733053
SIM,1903,46,45-49,1949,1
STAT,1814,93,na,1907,13.618659402909216
SIM,1928,15,35-39,1943,7
SIM,1890,23,35-39,1913,12
STAT,1882,23,35-39,1905,5.781827191586278
STAT,1877,86,na,1963,421.58877925227387
STAT,1901,28,40-44,1929,4.258366668548067
STAT,1937,12,na,1949,3931.8241249211565
STAT,1888,19,45-49,1907,0.07835777819879008
STAT,1825,33,50-100,1858,1.6807840131896223
STAT,1809,54,20-24,1863,0.0030111509280610254
SIM,1840,43,40-44,1883,8
STAT,1891,35,45-49,1926,2.541681162864108
STAT,1881,35,35-39,1916,7.042113231495225
STAT,1850,105,na,1955,0.022055150387799767
SIM,1918,21,25-29,1939,174
SIM,1861,36,na,1897,2549
STAT,1894,18,50-100,1912,0.06411960074228097
SIM,1859,105,na,1964,2
SIM,1862,38,50-100,1900,4
STAT,1936,26,25-29,1962,64.27626993585152
STAT,1852,19,30-34,1871,1.5347379593260646
STAT,1859,53,50-100,1912,0.012106875084896962
STAT,1884,36,15-19,1920,0.05694860668935927
STAT,1907,46,na,1953,3380.2035871543562
STAT,1835,102,na,1937,0.21843468231930355
SIM,1855,25,35-39,1880,13
STAT,1923,49,25-29,1972,0.06294280461715598
STAT,1816,39,15-19,1855,0.1545827687675243
SIM,1851,81,na,1932,259
SIM,1921,31,25-29,1952,15
STAT,1882,50,40-44,1932,0.010613547271940086
SIM,1892,18,15-19,1910,10
STAT,1860,21,na,1881,2032.5838490434467
STAT,1875,20,na,1895,2491.005694969419
SIM,1822,44,35-39,1866,2
SIM,1877,17,35-39,1894,1
SIM,1832,44,45-49,1876,2
STAT,1872,50,30-34,1922,0.006173522391707912
SIM,1842,30,45-49,1872,8
STAT,1827,31,15-19,1858,0.231439481407201
STAT,1837,31,25-29,1868,8.651690284448167
STAT,1848,73,na,1921,923.2794705120901
SIM,1832,23,na,1855,1920
SIM,1834,89,na,1923,27
STAT,1880,21,na,1901,2543.0567419974577
STAT,1949,21,40-44,1970,4.004163778584083
SIM,1844,36,35-39,1880,10
STAT,1874,51,45-49,1925,0.01518789915691858
SIM,1854,36,45-49,1890,4
STAT,1839,37,15-19,1876,0.046312447456342096
STAT,1864,51,35-39,1915,0.007846489009925258
SIM,1830,75,na,1905,736
STAT,1864,35,na,1899,2157.361184754507
STAT,1847,25,35-39,1872,9.17517920033468
STAT,1894,22,15-19,1916,4.32903940654991
SIM,1909,24,15-19,1933,5
STAT,1845,30,20-24,1875,2.563905645753587
STAT,1837,39,35-39,1876,5.623552149160249
SIM,1853,38,30-34,1891,4
STAT,1827,39,25-29,1866,3.5485584074216723
STAT,1913,31,25-29,1944,9.419473230630638
STAT,1869,17,35-39,1886,0.5479118526856253
SIM,1863,24,30-34,1887,26
SIM,1902,47,na,1949,3302
SIM,1934,24,na,1958,5073
STAT,1850,34,45-49,1884,1.343978824549381
SIM,1878,34,40-44,1912,10
STAT,1840,34,35-39,1874,8.693590510498682
SIM,1831,31,30-34,1862,29
SIM,1853,4,na,1857,2503
SIM,1868,34,30-34,1902,19
SIM,1911,17,30-34,1928,3
SIM,1881,44,40-44,1925,5
STAT,1858,28,na,1886,1962.2738782382007
STAT,1855,24,30-34,1879,15.900417257752036
STAT,1860,20,45-49,1880,0.6633299290833385
STAT,1842,25,20-24,1867,11.542150502800688
STAT,1890,22,30-34,1912,22.217917313536553
SIM,1874,54,na,1928,2184
SIM,1845,31,25-29,1876,15
SIM,1868,44,25-29,1912,3
SIM,1878,68,na,1946,1746
STAT,1908,41,45-49,1949,0.15792059626248903
STAT,1903,17,30-34,1920,2.3113731337805365
STAT,1932,13,na,1945,5342.341025241825
STAT,1936,27,na,1963,3656.628853667886
STAT,1854,69,na,1923,1123.1911067117812
STAT,1847,43,35-39,1890,1.401895483796513
STAT,1846,36,45-49,1882,1.5042508709349696
STAT,1948,18,15-19,1966,52.97234263230443
STAT,1888,26,35-39,1914,11.676737067809654
STAT,1836,36,35-39,1872,5.460538863402921
SIM,1878,30,25-29,1908,11
SIM,1850,25,20-24,1875,14
STAT,1798,58,na,1856,1237.0187785526998
STAT,1865,21,na,1886,2232.4531454314297
STAT,1837,25,na,1862,1878.061507564029
SIM,1844,18,35-39,1862,1
SIM,1918,29,35-39,1947,3
SIM,1855,43,35-39,1898,1
SIM,1938,27,na,1965,3638
STAT,1852,47,25-29,1899,0.046186322419983585
SIM,1916,23,45-49,1939,1
STAT,1873,44,40-44,1917,2.2949117463395474
STAT,1840,41,25-29,1881,0.4882477267510647
STAT,1828,45,40-44,1873,0.13746302499089152
SIM,1858,17,na,1875,2282
STAT,1902,7,na,1909,3748.1839501233344
STAT,1823,31,30-34,1854,50.83901735880219
STAT,1831,41,na,1872,1748.9697134101482
STAT,1835,55,na,1890,1540.58283527954
STAT,1849,38,15-19,1887,0.04414960173352203
STAT,1863,54,25-29,1917,0.003081037231061437
SIM,1927,24,50-100,1951,1
STAT,1870,28,35-39,1898,9.588645149717465
SIM,1773,82,na,1855,85
STAT,1842,47,15-19,1889,3.137339922436744E-4
STAT,1924,25,50-100,1949,1.1904126044840666
STAT,1847,36,50-100,1883,1.0037237136640758
STAT,1878,25,35-39,1903,10.315334044223459
STAT,1871,8,na,1879,2744.5261512432235
STAT,1886,46,na,1932,2436.3028264788486
STAT,1862,33,25-29,1895,8.857142389434147
STAT,1858,4,na,1862,2518.890617906431
SIM,1855,40,na,1895,1803
STAT,1873,29,15-19,1902,0.4658879044584069
STAT,1883,39,na,1922,2334.516961451612
STAT,1854,58,na,1912,1513.5633637009973
STAT,1929,20,50-100,1949,0.853746045952575
SIM,1886,25,35-39,1911,17
SIM,1881,36,na,1917,2159
STAT,1936,17,50-100,1953,0.3658468683809404
STAT,1775,85,na,1860,77.36595914477101
SIM,1937,7,na,1944,4646
SIM,1844,88,na,1932,71
STAT,1850,16,15-19,1866,5.487254018615329
STAT,1902,47,na,1949,3222.2325267816173
STAT,1921,36,45-49,1957,0.7774580151423763
STAT,1879,50,20-24,1929,7.981918822411745E-4
STAT,1899,19,20-24,1918,24.633405005455977
STAT,1921,15,25-29,1936,50.6401014226883
STAT,1896,46,35-39,1942,0.10670483437280404
SIM,1914,39,30-34,1953,2
SIM,1929,3,na,1932,5520
STAT,1878,32,25-29,1910,10.87622442183538
STAT,1872,23,40-44,1895,2.1239645516272185
STAT,1900,36,na,1936,3373.6791058827384
STAT,1891,17,15-19,1908,7.495325394319429
STAT,1901,24,25-29,1925,81.15415764677553
SIM,1886,32,25-29,1918,19
SIM,1847,55,na,1902,1382
SIM,1903,18,35-39,1921,2
SIM,1878,38,35-39,1916,10
SIM,1860,37,30-34,1897,7
STAT,1861,41,45-49,1902,1.267328670738939
SIM,1853,23,30-34,1876,25
STAT,1847,18,45-49,1865,0.0632028424418675
STAT,1936,16,30-34,1952,11.93145259669855
STAT,1845,23,30-34,1868,17.153714395532113
STAT,1842,29,15-19,1871,0.4336988501448666
SIM,1868,49,30-34,1917,1
STAT,1834,49,30-34,1883,0.06733720701952287
STAT,1914,6,na,1920,4216.338165717446
STAT,1932,36,20-24,1968,0.36153558224998245
STAT,1829,31,50-100,1860,0.8739536244074202
STAT,1852,37,30-34,1889,4.316813435258566
SIM,1795,81,na,1876,201
SIM,1939,22,35-39,1961,15
STAT,1840,16,35-39,1856,0.51425214625165
STAT,1849,41,45-49,1890,1.1671898436561539
SIM,1886,35,na,1921,2640
STAT,1883,26,20-24,1909,11.783075385772204
SIM,1867,28,50-100,1895,1
SIM,1944,16,30-34,1960,14
STAT,1858,46,15-19,1904,3.2452156400677366E-4
SIM,1891,33,45-49,1924,2
STAT,1837,21,30-34,1858,15.659242436689782
STAT,1963,4,na,1967,5095.059041080183
SIM,1787,85,na,1872,81
SIM,1830,28,35-39,1858,12
STAT,1820,45,na,1865,1456.353310286598
STAT,1868,43,20-24,1911,0.15362440965480795
STAT,1906,39,30-34,1945,1.6908901487500172
STAT,1839,52,40-44,1891,0.007226924408774104
SIM,1807,56,na,1863,1122
STAT,1805,89,na,1894,42.223834585507575
SIM,1870,26,35-39,1896,10
SIM,1870,95,na,1965,19
SIM,1952,18,30-34,1970,18
STAT,1928,42,25-29,1970,0.0928561133692929
SIM,1845,29,40-44,1874,1
STAT,1845,38,30-34,1883,4.330141385507852
STAT,1850,49,15-19,1899,2.9459949918672043E-4
STAT,1837,29,40-44,1866,2.526803056233122
STAT,1872,87,na,1959,260.22843906294366
SIM,1817,89,na,1906,56
STAT,1831,25,45-49,1856,1.1914518056373133
SIM,1918,36,25-29,1954,1
STAT,1898,44,45-49,1942,0.14144124392526686
SIM,1951,16,na,1967,4911
STAT,1836,47,40-44,1883,0.11152633934103677
STAT,1862,26,35-39,1888,8.470839803009026
STAT,1873,0,na,1873,3824.4140352086697
STAT,1830,27,30-34,1857,28.485569490242494
STAT,1930,42,45-49,1972,0.22333992877549094
SIM,1939,23,na,1962,3556
SIM,1938,33,45-49,1971,4
SIM,1903,5,na,1908,3761
SIM,1882,21,35-39,1903,6
SIM,1861,29,25-29,1890,59
SIM,1877,83,na,1960,522
STAT,1832,26,na,1858,1922.7621676597828
STAT,1906,46,20-24,1952,0.010079456679022637
STAT,1893,48,25-29,1941,0.041520027991946346
STAT,1894,40,45-49,1934,1.9837351427138785
STAT,1886,8,na,1894,2807.021484068226
STAT,1928,23,50-100,1951,0.8353968922921391
STAT,1886,31,20-24,1917,2.930723586395593
SIM,1846,37,50-100,1883,4
SIM,1884,21,na,1905,2535
SIM,1916,50,na,1966,3783
SIM,1828,46,45-49,1874,1
STAT,1903,48,45-49,1951,0.19062552242411104
STAT,1823,50,35-39,1873,0.012965998885506822
SIM,1893,68,na,1961,2161
SIM,1936,24,25-29,1960,99
SIM,1931,9,na,1940,5190
STAT,1936,9,na,1945,3887.275558329094
SIM,1837,22,na,1859,1753
SIM,1855,95,na,1950,7
STAT,1863,19,40-44,1882,0.16788410964161773
SIM,1871,19,40-44,1890,1
STAT,1832,43,40-44,1875,1.824333429944542
SIM,1926,20,20-24,1946,188
STAT,1873,15,35-39,1888,0.5742469090578898
STAT,1896,28,35-39,1924,12.954755177184337
SIM,1915,10,na,1925,4585
SIM,1919,24,na,1943,3998
STAT,1872,54,na,1926,2140.9237269191785
STAT,1884,35,na,1919,2400.429493463156
STAT,1837,66,na,1903,1092.7715839711266
STAT,1928,17,35-39,1945,5.393101041747686
STAT,1822,53,25-29,1875,0.00475905854123931
SIM,1862,35,40-44,1897,7
STAT,1890,41,35-39,1931,2.268914833836317
SIM,1827,33,30-34,1860,13
SIM,1884,34,15-19,1918,1
STAT,1794,99,na,1893,0.37539572796559223
STAT,1853,29,25-29,1882,36.85692184622092
STAT,1921,19,50-100,1940,0.43344883184889227
SIM,1920,32,na,1952,4060
STAT,1819,40,20-24,1859,0.36314762637618936
STAT,1790,85,na,1875,93.16798939269364
SIM,1872,32,30-34,1904,26
STAT,1849,58,na,1907,1535.3286458251112
SIM,1926,28,30-34,1954,73
STAT,1886,24,30-34,1910,19.113511196053956
SIM,1871,26,30-34,1897,32
SIM,1894,39,30-34,1933,15
STAT,1945,16,50-100,1961,0.4176750633873894
STAT,1854,35,40-44,1889,3.401605958391152
STAT,1822,46,35-39,1868,0.20256879146934553
STAT,1921,33,25-29,1954,10.45153738704933
SIM,1837,37,35-39,1874,9
SIM,1895,37,45-49,1932,4
STAT,1819,48,30-34,1867,0.18900906674007514
STAT,1928,24,25-29,1952,116.90007533868928
STAT,1853,21,15-19,1874,3.2920509623633203
STAT,1876,34,15-19,1910,0.1487320474116674
STAT,1918,20,20-24,1938,123.11236406149055
SIM,1839,40,50-100,1879,3
STAT,1896,20,25-29,1916,77.59027408736783
STAT,1887,37,45-49,1924,2.278821211693678
STAT,1844,38,35-39,1882,5.731961946036434
SIM,1835,74,na,1909,661
SIM,1839,88,na,1927,106
STAT,1880,52,30-34,1932,0.006347338342770094
SIM,1852,38,35-39,1890,9
SIM,1875,7,na,1882,2750
STAT,1842,32,45-49,1874,1.6519900559507381
STAT,1865,45,45-49,1910,0.22069154933590418
STAT,1918,28,30-34,1946,42.403030521411694
STAT,1886,39,30-34,1925,5.697021646222455
SIM,1861,21,15-19,1882,5
STAT,1820,40,45-49,1860,3.145448447158294
STAT,1835,53,30-34,1888,0.004433032725071521
STAT,1948,21,45-49,1969,1.318521479251081
STAT,1838,37,50-100,1875,1.088505675012928
STAT,1863,26,30-34,1889,22.68688543864181
SIM,1878,27,30-34,1905,33
STAT,1905,47,15-19,1952,3.3088550234561373E-4
STAT,1851,24,50-100,1875,0.39601934798387667
SIM,1865,36,20-24,1901,5
STAT,1859,34,na,1893,1927.5181698405825
SIM,1818,39,25-29,1857,1
STAT,1909,30,20-24,1939,2.3929495385037822
SIM,1903,43,40-44,1946,1
STAT,1930,31,25-29,1961,12.172546085311128
STAT,1802,53,20-24,1855,0.0019164829535052853
SIM,1886,56,na,1942,2320
STAT,1840,18,50-100,1858,0.0453760716335791
SIM,1880,41,na,1921,2299
STAT,1820,44,25-29,1864,1.2047374629223033
STAT,1927,21,25-29,1948,116.43935614757592
STAT,1944,15,na,1959,4043.4500439701674
STAT,1862,30,50-100,1892,0.8020633577267017
STAT,1902,46,35-39,1948,0.11393478844982219
SIM,1890,20,30-34,1910,1
SIM,1852,22,na,1874,2356
STAT,1877,48,40-44,1925,0.1788682322469296
STAT,1907,42,20-24,1949,0.016498813083413263
SIM,1896,18,35-39,1914,1
STAT,1912,40,20-24,1952,0.017572611023163643
SIM,1932,20,45-49,1952,1
STAT,1860,46,20-24,1906,0.009960771863915313
SIM,1880,26,45-49,1906,1
SIM,1825,44,na,1869,1514
STAT,1836,61,na,1897,1163.1034013356334
STAT,1897,16,35-39,1913,0.7502975765852853
STAT,1880,29,50-100,1909,0.6808678628649989
SIM,1905,31,40-44,1936,3
SIM,1795,60,na,1855,1005
SIM,1923,22,45-49,1945,1
STAT,1899,27,50-100,1926,0.8936308832689975
SIM,1896,1,na,1897,3677
SIM,1901,48,35-39,1949,1
SIM,1846,91,na,1937,21
STAT,1876,91,na,1967,184.49909666756534
SIM,1930,32,45-49,1962,3
STAT,1837,46,45-49,1883,0.16544504229330015
STAT,1865,31,35-39,1896,9.414998117646988
SIM,1859,54,na,1913,1948
SIM,1811,45,35-39,1856,1
STAT,1834,32,50-100,1866,0.789810710184235
SIM,1818,72,na,1890,569
STAT,1854,43,40-44,1897,1.7090579641721115
STAT,1913,34,45-49,1947,1.5834814146424827
STAT,1845,45,40-44,1890,0.13510019214676705
STAT,1863,18,30-34,1881,1.4716581062294793
SIM,1892,46,50-100,1938,1
STAT,1904,50,na,1954,3193.3995538297495
SIM,1903,63,na,1966,2750
SIM,1887,25,30-34,1912,43
SIM,1943,28,na,1971,3688
SIM,1928,26,40-44,1954,6
STAT,1879,25,30-34,1904,27.035023251107233
STAT,1924,20,45-49,1944,1.3626580058532782
STAT,1876,16,na,1892,2667.0820614985364
SIM,1838,72,na,1910,731
STAT,1864,39,15-19,1903,0.05042415338873094
SIM,1915,42,20-24,1957,1
STAT,1811,51,20-24,1862,0.00199253832327888
STAT,1911,44,35-39,1955,0.19363559910610215
STAT,1922,32,45-49,1954,1.8141436421693538
SIM,1878,37,na,1915,2642
STAT,1828,42,na,1870,1457.5615206465127
STAT,1882,20,30-34,1902,17.808842902624207
STAT,1873,37,15-19,1910,0.0580778320759558
SIM,1867,16,15-19,1883,9
SIM,1921,34,45-49,1955,7
STAT,1840,76,na,1916,681.7497259835253
STAT,1870,11,na,1881,2653.123621583247
STAT,1915,22,45-49,1937,1.1868582136327608
STAT,1875,50,35-39,1925,0.009143308460406582
SIM,1895,33,50-100,1928,3
SIM,1837,55,na,1892,1296
STAT,1833,21,50-100,1854,0.5349585498761062
SIM,1886,66,na,1952,1841
SIM,1932,34,20-24,1966,6
STAT,1899,64,na,1963,2620.978663039236
STAT,1929,42,40-44,1971,0.3303791158108016
STAT,1874,43,50-100,1917,1.092411231022207
SIM,1860,45,30-34,1905,1
SIM,1907,18,20-24,1925,24
STAT,1901,40,45-49,1941,0.14976007484751538
STAT,1944,25,na,1969,4134.477607496899
STAT,1822,32,40-44,1854,13.661966434461512
SIM,1850,11,na,1861,2281
SIM,1855,40,30-34,1895,3
STAT,1855,102,na,1957,0.32673554607335054
STAT,1821,36,40-44,1857,10.15132123215028
STAT,1845,50,50-100,1895,0.011970065121143191
STAT,1889,64,na,1953,2190.5812796830733
STAT,1929,34,50-100,1963,1.0697724789280436
SIM,1878,47,na,1925,2541
SIM,1838,62,na,1900,1140
SIM,1888,47,na,1935,2616
STAT,1807,104,na,1911,0.02818765756522233
STAT,1894,3,na,1897,3469.034633015633
STAT,1886,46,40-44,1932,0.18538869428161747
SIM,1830,32,40-44,1862,1
STAT,1811,46,25-29,1857,0.16284375306960652
STAT,1954,18,40-44,1972,1.7631538129923698
STAT,1925,36,50-100,1961,0.5145895406492803
STAT,1827,54,35-39,1881,0.008158174030945077
STAT,1870,36,35-39,1906,7.087509916592534
STAT,1891,35,50-100,1926,1.5653631628798221
STAT,1765,95,na,1860,0.8349999925722231
SIM,1906,37,30-34,1943,2
STAT,1823,38,15-19,1861,0.10129523833051086
STAT,1923,43,15-19,1966,0.0018284530765368132
SIM,1837,26,30-34,1863,24
STAT,1882,53,45-49,1935,0.014191966418650512
SIM,1867,5,na,1872,2589
STAT,1810,56,na,1866,1069.3833374931862
SIM,1859,0,na,1859,3362
STAT,1865,7,na,1872,2595.146024514152
SIM,1941,27,na,1968,3693
SIM,1860,7,na,1867,2424
STAT,1765,108,na,1873,0.0017076284969869346
SIM,1870,41,25-29,1911,3
SIM,1912,36,na,1948,3863
STAT,1862,41,25-29,1903,0.5601724193262727
SIM,1935,21,25-29,1956,141
SIM,1838,25,35-39,1863,2
SIM,1899,19,15-19,1918,12
SIM,1848,17,na,1865,2284
STAT,1842,46,50-100,1888,0.19511666824378257
STAT,1847,40,30-34,1887,0.924925080518168
STAT,1863,36,45-49,1899,1.791659667739603
SIM,1896,66,na,1962,2384
STAT,1904,41,40-44,1945,0.22939969472265476
STAT,1780,109,na,1889,0.002970645153026399
STAT,1894,45,35-39,1939,0.1046611764885208
STAT,1870,45,50-100,1915,0.24736954238243847
SIM,1829,26,na,1855,1596
SIM,1846,36,na,1882,1988
STAT,1864,17,35-39,1881,0.5148848104864895
STAT,1822,57,na,1879,1270.6842347681993
STAT,1868,17,na,1885,2505.424233868848
STAT,1873,49,na,1922,2278.313050315136
SIM,1895,39,na,1934,3213
STAT,1885,47,35-39,1932,0.14182474024137243
SIM,1828,72,na,1900,807
STAT,1844,53,25-29,1897,0.0027006762716177304
SIM,1916,16,20-24,1932,27
STAT,1899,39,50-100,1938,0.36646763028010026
STAT,1792,97,na,1889,0.8802174903651817
STAT,1870,40,20-24,1910,0.15997640691158455
SIM,1835,20,na,1855,1933
SIM,1840,21,na,1861,1871
SIM,1906,19,15-19,1925,9
SIM,1896,56,na,1952,2735
STAT,1881,68,na,1949,1507.2267076720414
STAT,1946,16,40-44,1962,1.583261963068999
STAT,1878,44,40-44,1922,2.3561796386518696
SIM,1849,18,20-24,1867,1
STAT,1852,52,20-24,1904,5.91304402476631E-4
SIM,1872,17,35-39,1889,1
STAT,1866,91,na,1957,69.53119513090927
STAT,1810,48,30-34,1858,0.299015124324294
STAT,1839,41,35-39,1880,1.4660851744286238
STAT,1929,6,na,1935,5217.12589337358
STAT,1898,16,50-100,1914,0.06775285948746271
STAT,1934,8,na,1942,5501.544910920201
STAT,1840,86,na,1926,159.6616465961077
SIM,1954,16,40-44,1970,2
STAT,1830,34,40-44,1864,4.00606097093675
SIM,1886,44,40-44,1930,7
STAT,1808,104,na,1912,0.022205087362890365
STAT,1895,44,40-44,1939,0.2050901507814862
SIM,1848,72,na,1920,845
STAT,1828,53,40-44,1881,0.007094248582062364
STAT,1839,48,50-100,1887,0.170499695607562
SIM,1945,18,40-44,1963,5
SIM,1877,46,40-44,1923,2
SIM,1868,37,na,1905,2351
STAT,1840,38,15-19,1878,0.047299906465724136
STAT,1913,33,na,1946,3822.529722970582
STAT,1845,44,na,1889,1792.4392505256917
SIM,1906,30,45-49,1936,3
STAT,1858,18,20-24,1876,16.6552856585145
STAT,1826,61,na,1887,1133.8802926300127
SIM,1879,26,35-39,1905,14
STAT,1838,42,na,1880,1806.5873758748166
STAT,1890,29,15-19,1919,0.56187516603071
STAT,1829,29,35-39,1858,9.913663100589325
SIM,1919,28,40-44,1947,9
STAT,1853,44,35-39,1897,1.4978698997314364
STAT,1838,17,40-44,1855,0.17751203651687125
STAT,1820,37,35-39,1857,17.206298260455103
STAT,1943,22,20-24,1965,120.69924484778105
STAT,1880,40,50-100,1920,1.143975522934134
STAT,1861,45,25-29,1906,0.049039042482130916
STAT,1859,16,15-19,1875,5.645636787170621
SIM,1926,26,na,1952,4808
STAT,1923,21,40-44,1944,4.003737451734514
SIM,1888,37,na,1925,2709
STAT,1855,22,50-100,1877,0.3693047588851794
STAT,1869,35,15-19,1904,0.05583235961735235
SIM,1931,21,40-44,1952,9
STAT,1889,47,20-24,1936,0.008490144845808352
SIM,1836,91,na,1927,4
SIM,1850,41,na,1891,1748
SIM,1862,22,na,1884,2215
SIM,1837,29,35-39,1866,9
SIM,1855,5,na,1860,2310
SIM,1877,28,25-29,1905,43
STAT,1895,25,15-19,1920,0.6079799876743567
STAT,1937,18,40-44,1955,1.3843302679875509
STAT,1869,46,40-44,1915,0.1690950564359601
SIM,1924,6,na,1930,4964
STAT,1792,87,na,1879,51.53560912241148
STAT,1904,41,25-29,1945,0.06549246866962974
STAT,1818,42,na,1860,1503.480414627916
SIM,1879,64,na,1943,2088
STAT,1922,8,na,1930,4709.814512482791
SIM,1910,11,na,1921,3986
STAT,1854,80,na,1934,473.44552723474476
STAT,1933,32,20-24,1965,3.352235075218239
SIM,1856,91,na,1947,29
STAT,1903,42,35-39,1945,0.18212880262319403
STAT,1863,37,50-100,1900,1.0981566297322882
STAT,1914,31,40-44,1945,4.035508725830118
STAT,1855,19,35-39,1874,0.49997916553684046
STAT,1900,6,na,1906,3693.7419223517454
SIM,1903,53,na,1956,2978
STAT,1914,45,15-19,1959,3.7450147461252394E-4
STAT,1838,24,30-34,1862,16.73688125421765
STAT,1890,47,45-49,1937,0.16527590665148473
STAT,1938,17,45-49,1955,0.5026689896230476
STAT,1911,47,50-100,1958,0.21841458429046323
STAT,1869,34,na,1903,2330.1755632796394
STAT,1908,32,na,1940,3640.3558278288124
SIM,1875,19,na,1894,2563
STAT,1811,47,35-39,1858,0.38891463972229284
STAT,1772,97,na,1869,0.5040216689827415
SIM,1821,34,40-44,1855,2
STAT,1908,16,20-24,1924,26.88290970063372
STAT,1930,34,45-49,1964,2.068525345992464
SIM,1903,28,50-100,1931,1
STAT,1892,20,na,1912,3041.9030843723144
SIM,1846,24,30-34,1870,22
STAT,1828,34,15-19,1862,0.131619603180028
STAT,1835,75,na,1910,767.0170719775533
SIM,1846,19,35-39,1865,1
STAT,1884,48,30-34,1932,0.09647097131921147
STAT,1848,46,20-24,1894,0.009354481620089955
STAT,1918,28,50-100,1946,1.07715844145607
SIM,1894,20,15-19,1914,1
STAT,1905,14,na,1919,3792.6077820961323
STAT,1916,51,na,1967,3796.324835938994
STAT,1784,78,na,1862,253.91497134221692
STAT,1886,20,15-19,1906,3.583580933579407
STAT,1928,28,40-44,1956,5.854497658214458
SIM,1936,28,40-44,1964,12
SIM,1836,34,15-19,1870,1
SIM,1845,43,40-44,1888,12
SIM,1894,31,na,1925,3259
STAT,1877,53,na,1930,2241.6569820612303
STAT,1880,25,40-44,1905,3.233119946994128
STAT,1889,34,na,1923,2981.3491249763697
SIM,1848,92,na,1940,61
STAT,1910,48,35-39,1958,0.12234625465244703
STAT,1837,43,40-44,1880,1.7471025583912638
STAT,1838,19,35-39,1857,0.5262812785050138
STAT,1927,23,na,1950,4575.357620824979
STAT,1860,47,30-34,1907,0.07974920372420984
STAT,1862,77,na,1939,750.6381679870871
STAT,1869,23,50-100,1892,0.4003951562789583
SIM,1828,62,na,1890,1106
STAT,1832,22,50-100,1854,0.6722996781889437
STAT,1858,50,35-39,1908,0.007064881944759895
STAT,1904,19,40-44,1923,0.26598221282569817
STAT,1794,78,na,1872,324.28099993612545
SIM,1862,24,15-19,1886,2
STAT,1824,38,na,1862,1565.1900233082865
STAT,1870,35,25-29,1905,2.898585179455361
STAT,1907,45,50-100,1952,0.2095843824367153
SIM,1895,27,30-34,1922,64
STAT,1854,90,na,1944,60.34099202682269
SIM,1875,40,na,1915,2334
SIM,1917,29,50-100,1946,3
SIM,1811,44,25-29,1855,1
SIM,1828,36,30-34,1864,4
STAT,1824,30,35-39,1854,28.630375855759507
STAT,1883,49,na,1932,2204.992543279713
STAT,1826,71,na,1897,778.5100208908442
SIM,1925,32,20-24,1957,5
STAT,1877,52,25-29,1929,0.0037278029016286443
STAT,1887,0,na,1887,3599.248804086479
STAT,1835,48,35-39,1883,0.10859510191579005
SIM,1873,44,50-100,1917,4
STAT,1801,65,na,1866,782.4433460201521
STAT,1823,46,15-19,1869,6.099191758342365E-4
STAT,1845,48,45-49,1893,0.18208091288660713
SIM,1832,77,na,1909,402
STAT,1860,76,na,1936,784.1795111136375
STAT,1909,33,25-29,1942,8.957253940597948
STAT,1903,33,na,1936,3475.252513055889
STAT,1956,1,na,1957,5313.937964692044
SIM,1915,45,50-100,1960,1
STAT,1775,95,na,1870,2.3093688377437727
SIM,1921,31,40-44,1952,7
STAT,1921,41,40-44,1962,0.28789292917762704
STAT,1874,36,20-24,1910,0.8067511337512676
STAT,1880,18,30-34,1898,1.7041985141994966
STAT,1852,45,30-34,1897,0.07875968814263591
STAT,1910,30,45-49,1940,1.5599179923063744
STAT,1856,33,50-100,1889,0.7350437213366213
STAT,1905,32,45-49,1937,1.4752639788401858
STAT,1912,43,25-29,1955,0.06983651249888212
SIM,1836,27,25-29,1863,50
STAT,1885,82,na,1967,799.4906988936673
SIM,1846,27,35-39,1873,14
SIM,1936,26,na,1962,3221
STAT,1843,54,20-24,1897,5.79320981434012E-4
STAT,1923,35,15-19,1958,0.022741792554076472
STAT,1895,18,25-29,1913,7.522716300684414
STAT,1933,35,25-29,1968,1.3700541087968414
SIM,1940,22,45-49,1962,1
STAT,1856,16,na,1872,2186.4274351065774
STAT,1824,105,na,1929,0.016144410433456612
STAT,1913,49,15-19,1962,3.6464507780696484E-4
STAT,1911,43,25-29,1954,0.06910446480233616
SIM,1821,42,40-44,1863,2
SIM,1853,93,na,1946,13
SIM,1949,13,na,1962,4776
STAT,1860,11,na,1871,2289.297561046139
SIM,1832,30,35-39,1862,14
STAT,1916,18,20-24,1934,29.276565188807773
STAT,1817,51,50-100,1868,0.03300191803666632
STAT,1932,33,15-19,1965,0.17410641829689136
STAT,1880,33,40-44,1913,4.629469355598538
STAT,1845,85,na,1930,214.19409910363976
SIM,1885,45,35-39,1930,1
STAT,1870,33,30-34,1903,17.33844654891151
STAT,1939,24,na,1963,3738.7202660759463
STAT,1880,52,50-100,1932,0.016104403852864563
STAT,1838,27,35-39,1865,9.018267047611431
STAT,1813,42,40-44,1855,8.18670800901148
STAT,1828,27,25-29,1855,62.08629076284465
SIM,1880,23,40-44,1903,1
SIM,1931,27,na,1958,4970
SIM,1933,28,na,1961,4939
STAT,1869,54,40-44,1923,0.010083636400155003
STAT,1859,54,30-34,1913,0.004716269482694093
STAT,1931,22,45-49,1953,1.4883037351851451
STAT,1822,35,45-49,1857,4.128174320477643
STAT,1811,43,20-24,1854,0.4905198989087238
STAT,1852,48,35-39,1900,0.11136709179734443
STAT,1903,45,40-44,1948,0.14144011197710515
STAT,1913,31,40-44,1944,3.988202967446285
SIM,1882,0,na,1882,3346
STAT,1788,82,na,1870,181.72218495238616
STAT,1850,20,35-39,1870,5.344957849995538
STAT,1900,46,na,1946,3190.786828507058
STAT,1873,30,30-34,1903,18.202855834863723
STAT,1876,16,15-19,1892,6.266984279400364
SIM,1810,49,35-39,1859,1
STAT,1846,61,na,1907,1336.301968530633
STAT,1893,46,30-34,1939,0.07086524772906677
SIM,1921,27,na,1948,4762
SIM,1891,67,na,1958,2104
SIM,1851,47,30-34,1898,1
STAT,1886,36,na,1922,2556.257128355283
SIM,1876,66,na,1942,1824
SIM,1813,63,na,1876,947
STAT,1863,33,40-44,1896,3.862614232549972
SIM,1911,45,40-44,1956,2
STAT,1778,82,na,1860,103.10777799850898
STAT,1891,21,35-39,1912,7.392450573390579
SIM,1923,37,30-34,1960,1
STAT,1843,47,30-34,1890,0.07777971607838617
STAT,1909,58,na,1967,3266.018489524036
SIM,1928,29,45-49,1957,2
STAT,1813,53,50-100,1866,0.03552731379760872
STAT,1830,41,15-19,1871,0.012084043119889228
SIM,1883,38,na,1921,2428
STAT,1854,24,15-19,1878,2.92424728903494
SIM,1823,73,na,1896,684
SIM,1830,35,45-49,1865,2
STAT,1875,10,na,1885,2761.181325209581
STAT,1917,32,20-24,1949,2.606527553913967
SIM,1959,0,na,1959,5726
STAT,1906,43,15-19,1949,0.0014136554379459562
STAT,1894,65,na,1959,2320.3173229105632
STAT,1940,21,40-44,1961,3.4954517198556996
SIM,1884,49,35-39,1933,1
SIM,1888,42,35-39,1930,4
STAT,1836,51,25-29,1887,0.0022755047196853333
STAT,1846,18,30-34,1864,1.4233989827341629
SIM,1854,18,30-34,1872,3
STAT,1833,43,na,1876,1651.4106325696628
STAT,1876,49,35-39,1925,0.14440084172659182
STAT,1906,32,45-49,1938,1.4867801429785603
SIM,1887,17,30-34,1904,1
STAT,1886,49,45-49,1935,0.24951488176530426
STAT,1915,44,20-24,1959,0.018083146292611513
SIM,1894,49,45-49,1943,1
SIM,1937,16,40-44,1953,4
STAT,1888,44,50-100,1932,1.2569043292275337
SIM,1869,44,40-44,1913,5
STAT,1863,40,15-19,1903,0.012476864295086206
STAT,1887,27,30-34,1914,28.786270364385405
SIM,1910,55,na,1965,3347
SIM,1914,32,45-49,1946,8
SIM,1881,30,30-34,1911,6
STAT,1833,35,20-24,1868,0.6520479556152358
STAT,1911,36,35-39,1947,2.394470192692511
STAT,1854,28,30-34,1882,20.059406263193267
SIM,1872,33,50-100,1905,3
SIM,1908,17,25-29,1925,12
SIM,1807,79,na,1886,170
SIM,1931,39,30-34,1970,3
STAT,1853,94,na,1947,16.75829992120925
SIM,1837,45,na,1882,1546
STAT,1878,47,45-49,1925,0.24943094352101663
STAT,1854,17,25-29,1871,5.188154644464386
STAT,1871,42,15-19,1913,0.013937991852685606
STAT,1902,21,20-24,1923,99.43996363610276
STAT,1946,19,45-49,1965,0.5649135549484459
SIM,1838,17,na,1855,2029
SIM,1843,93,na,1936,41
STAT,1841,52,45-49,1893,0.010658236670147661
STAT,1904,15,25-29,1919,8.323623950805889
SIM,1873,31,35-39,1904,2
STAT,1785,95,na,1880,2.639024263596222
STAT,1841,26,15-19,1867,0.4190858482656708
STAT,1864,47,15-19,1911,3.6114107510868597E-4
STAT,1915,37,30-34,1952,1.8788128014961467
STAT,1846,26,30-34,1872,21.942929281393855
SIM,1908,62,na,1970,3276
SIM,1916,19,25-29,1935,53
SIM,1862,28,30-34,1890,22
STAT,1872,77,na,1949,883.7801613216117
STAT,1901,21,20-24,1922,98.60593233845461
SIM,1845,19,na,1864,2197
STAT,1900,48,40-44,1948,0.1348309082942013
SIM,1862,17,25-29,1879,11
STAT,1888,41,30-34,1929,1.3927968029229092
STAT,1860,54,20-24,1914,5.939901724959966E-4
SIM,1862,43,40-44,1905,4
STAT,1828,52,na,1880,1270.5204337135963
STAT,1901,47,30-34,1948,0.07753272096827163
STAT,1885,44,30-34,1929,1.1543136877314164
SIM,1828,28,30-34,1856,29
SIM,1870,41,na,1911,2604
SIM,1909,31,25-29,1940,11
SIM,1939,13,na,1952,3983
SIM,1912,15,25-29,1927,9
STAT,1818,53,30-34,1871,0.01269862381741733
STAT,1836,71,na,1907,830.8260625145359
STAT,1919,48,na,1967,4054.995638089314
STAT,1923,39,30-34,1962,2.1500831678080967
STAT,1921,33,40-44,1954,4.425178712314812
SIM,1845,10,na,1855,2381
STAT,1888,17,na,1905,3045.932014736598
STAT,1882,45,45-49,1927,0.236893343165702
SIM,1855,74,na,1929,900
SIM,1886,47,45-49,1933,2
SIM,1815,44,na,1859,1473
SIM,1870,34,35-39,1904,13
SIM,1870,19,25-29,1889,10
SIM,1939,29,20-24,1968,25
STAT,1850,76,na,1926,712.6416058045414
SIM,1776,79,na,1855,245
SIM,1910,21,20-24,1931,103
SIM,1822,46,na,1868,1366
STAT,1862,19,25-29,1881,5.0685300006494565
STAT,1854,35,na,1889,1830.7483328665533
STAT,1803,52,25-29,1855,0.014307038833908405
STAT,1877,45,35-39,1922,0.14960884799455101
STAT,1910,36,50-100,1946,0.4115157068971088
SIM,1924,18,20-24,1942,171
SIM,1822,77,na,1899,420
STAT,1898,30,35-39,1928,14.08311787783028
SIM,1870,33,25-29,1903,10
STAT,1823,105,na,1928,0.016318503414984493
STAT,1830,37,45-49,1867,1.8010831807845122
SIM,1893,14,na,1907,3398
STAT,1887,19,30-34,1906,1.8122343366617277
STAT,1922,33,40-44,1955,4.492560169978306
SIM,1858,18,15-19,1876,3
STAT,1861,38,35-39,1899,5.9326754189838065
STAT,1939,31,45-49,1970,1.6388168569689092
STAT,1866,16,na,1882,2453.7574515155934
STAT,1870,43,25-29,1913,0.6357731543753126
SIM,1854,26,30-34,1880,35
STAT,1770,96,na,1866,0.931692531180984
STAT,1879,18,40-44,1897,0.19452858727811903
SIM,1838,17,35-39,1855,1
STAT,1906,31,na,1937,3588.0474215739446
STAT,1844,80,na,1924,479.3573085742744
STAT,1908,19,25-29,1927,8.52580287154277
STAT,1895,29,30-34,1924,33.27782918089366
SIM,1887,28,35-39,1915,1
STAT,1917,17,50-100,1934,0.08227496690448934
SIM,1836,38,30-34,1874,11
STAT,1838,16,30-34,1854,1.5560557104005839
STAT,1923,46,20-24,1969,0.013223192760360302
SIM,1913,53,na,1966,3683
STAT,1859,16,50-100,1875,0.04660678848164221
STAT,1953,16,50-100,1969,0.46244177508621553
SIM,1872,22,na,1894,2625
STAT,1867,53,na,1920,2029.0468319827653
STAT,1872,16,30-34,1888,1.6446668976039387
SIM,1842,56,na,1898,1536
STAT,1941,27,30-34,1968,41.35227919235195
STAT,1811,44,30-34,1855,3.390530633162315
SIM,1852,43,30-34,1895,2
STAT,1815,54,45-49,1869,0.035832345898348
STAT,1913,42,45-49,1955,0.16557194347162163
STAT,1882,3,na,1885,2972.573633866616
SIM,1844,29,25-29,1873,48
STAT,1853,63,na,1916,1496.136767764447
STAT,1932,22,45-49,1954,1.5055872623471485
SIM,1884,1,na,1885,3537
STAT,1828,38,30-34,1866,4.573282641655302
STAT,1821,40,25-29,1861,1.1885307426439893
STAT,1951,4,na,1955,4777.359670321847
STAT,1935,20,20-24,1955,154.52425819738676
SIM,1880,16,30-34,1896,1
STAT,1873,32,50-100,1905,0.9476265807976185
SIM,1839,98,na,1937,4
STAT,1879,34,na,1913,2522.8684067325976
STAT,1906,51,na,1957,3248.8905221158566
STAT,1879,28,35-39,1907,10.252965178803148
SIM,1913,32,45-49,1945,2
STAT,1924,37,50-100,1961,0.5051103946578763
STAT,1917,40,50-100,1957,0.1254599711482533
STAT,1833,33,50-100,1866,0.7742966416214828
STAT,1836,29,25-29,1865,33.58487628567361
STAT,1856,15,35-39,1871,0.5257465627112562
SIM,1881,32,50-100,1913,1
SIM,1858,92,na,1950,21
STAT,1907,45,25-29,1952,0.04915334015957319
SIM,1943,20,20-24,1963,137
STAT,1894,48,40-44,1942,0.12513002990349506
STAT,1890,37,15-19,1927,0.07004365476780632
STAT,1949,17,20-24,1966,160.86921258410513
STAT,1931,37,15-19,1968,0.02593736562079442
STAT,1913,19,50-100,1932,0.07772676898601201
STAT,1821,33,35-39,1854,31.91414164739024
STAT,1882,27,15-19,1909,0.45092444063314346
SIM,1815,45,20-24,1860,1
STAT,1782,97,na,1879,0.9169991256993317
STAT,1918,32,na,1950,4101.251450008376
STAT,1871,38,45-49,1909,2.0044756583090937
STAT,1878,17,na,1895,2681.843229960138
SIM,1939,18,50-100,1957,1
SIM,1869,64,na,1933,1688
SIM,1841,33,50-100,1874,3
SIM,1885,40,na,1925,2387
STAT,1846,19,40-44,1865,0.162378795638453
STAT,1864,90,na,1954,71.51488383361529
STAT,1844,50,20-24,1894,5.800394583428828E-4
STAT,1855,75,na,1930,798.0372291371453
STAT,1902,36,50-100,1938,0.3830723625730865
SIM,1828,39,35-39,1867,8
SIM,1843,45,30-34,1888,1
STAT,1911,40,20-24,1951,0.017388409536555745
STAT,1913,42,50-100,1955,0.11687431270387333
STAT,1804,83,na,1887,141.23835967512005
SIM,1911,20,25-29,1931,88
STAT,1810,44,15-19,1854,0.046098376346937205
STAT,1830,30,25-29,1860,10.138403546052851
SIM,1927,26,25-29,1953,103
STAT,1847,56,na,1903,1590.5331487212445
STAT,1912,46,45-49,1958,0.21360571563141395
STAT,1829,68,na,1897,1016.3794962108541
STAT,1870,32,20-24,1902,2.695659654667582
SIM,1886,18,25-29,1904,11
STAT,1818,50,50-100,1868,0.03420958531719946
SIM,1801,85,na,1886,95
SIM,1844,58,na,1902,1568
SIM,1850,75,na,1925,605
STAT,1922,40,30-34,1962,0.1501441737877533
STAT,1844,31,15-19,1875,0.13334156352557083
SIM,1824,68,na,1892,779
STAT,1813,45,45-49,1858,0.6134067130369506
STAT,1853,47,40-44,1900,0.1428817329838758
STAT,1915,33,15-19,1948,0.13298918820536001
STAT,1859,88,na,1947,111.84699519745666
STAT,1852,102,na,1954,0.23618225158296247
SIM,1812,47,45-49,1859,1
STAT,1857,51,45-49,1908,0.011617635708700752
STAT,1837,24,15-19,1861,2.838233937968958
STAT,1827,46,35-39,1873,0.1593677758263808
SIM,1887,33,50-100,1920,1
STAT,1847,22,50-100,1869,0.3898373229748716
STAT,1903,20,25-29,1923,83.51088077983148
STAT,1869,28,25-29,1897,41.51637223742964
SIM,1920,32,35-39,1952,6
STAT,1827,56,na,1883,1396.0489213537428
STAT,1836,19,na,1855,1893.1406196044165
STAT,1878,48,na,1926,2359.0005876059154
STAT,1884,46,50-100,1930,0.24858358628493177
STAT,1923,32,45-49,1955,1.8405792508046137
SIM,1900,34,25-29,1934,17
STAT,1880,52,na,1932,2295.971476497707
STAT,1891,36,20-24,1927,0.9782664519077029
STAT,1834,90,na,1924,52.98224398491701
STAT,1844,43,30-34,1887,0.9008059094395693
STAT,1903,34,35-39,1937,8.360454851510811
STAT,1835,45,30-34,1880,0.08574485981388057
STAT,1950,5,na,1955,4742.87898916914
SIM,1801,95,na,1896,5
STAT,1897,42,35-39,1939,0.1713118228458214
STAT,1824,45,20-24,1869,0.01436812992308212
STAT,1908,42,20-24,1950,0.01666141368926942
SIM,1824,58,na,1882,1136
STAT,1823,53,40-44,1876,0.014937073510268982
SIM,1937,34,50-100,1971,1
SIM,1827,51,25-29,1878,1
STAT,1912,32,35-39,1944,9.173060208007069
STAT,1921,44,45-49,1965,0.19064808010913972
SIM,1930,33,40-44,1963,9
STAT,1834,28,na,1862,1892.44626195087
STAT,1885,50,45-49,1935,0.014982684516843033
STAT,1900,40,45-49,1940,0.14843425656925416
STAT,1931,31,40-44,1962,5.232607309311482
SIM,1911,34,35-39,1945,16
STAT,1890,44,40-44,1934,2.7677342686098427
SIM,1863,38,na,1901,2037
STAT,1886,42,25-29,1928,0.6925552357267067
STAT,1855,85,na,1940,212.50853822248814
STAT,1823,43,na,1866,1513.7119778075767
SIM,1841,21,50-100,1862,3
STAT,1853,43,25-29,1896,0.5345582023259683
STAT,1935,31,25-29,1966,13.047880068264657
STAT,1835,52,20-24,1887,5.605417555370635E-4
SIM,1950,21,na,1971,4349
STAT,1890,30,30-34,1920,21.953204937434112
SIM,1855,20,na,1875,1978
STAT,1891,37,na,1928,2975.5943075054815
SIM,1871,57,na,1928,1851
STAT,1883,35,50-100,1918,1.2405993504387571
STAT,1880,40,15-19,1920,0.014953929497104099
STAT,1836,44,35-39,1880,1.3070175071092496
SIM,1931,32,45-49,1963,2
STAT,1887,33,50-100,1920,1.042970893600921
SIM,1873,38,na,1911,2322
STAT,1783,83,na,1866,136.87571318584253
SIM,1868,16,15-19,1884,8
SIM,1816,39,na,1855,1724
STAT,1800,80,na,1880,315.26251630830444
STAT,1813,43,na,1856,1367.37567344126
STAT,1846,16,na,1862,2074.2992090124976
STAT,1862,45,40-44,1907,0.1501522623757253
STAT,1876,46,30-34,1922,0.1022614818332783
SIM,1894,17,20-24,1911,24
STAT,1884,55,na,1939,2086.9073518025343
STAT,1903,41,25-29,1944,0.06495936183790463
SIM,1881,67,na,1948,1517
STAT,1934,32,20-24,1966,3.3962251763197697
STAT,1880,36,45-49,1916,2.14736264822041
STAT,1831,48,15-19,1879,3.2295739379833803E-4
STAT,1812,46,40-44,1858,0.4121799825019878
SIM,1844,44,35-39,1888,2
SIM,1823,44,50-100,1867,7
SIM,1859,23,na,1882,2287
SIM,1911,41,25-29,1952,2
SIM,1859,33,na,1892,2232
STAT,1821,62,na,1883,1003.9336355570692
SIM,1861,36,35-39,1897,1
SIM,1873,48,na,1921,2232
SIM,1930,40,30-34,1970,2
SIM,1871,67,na,1938,1458
STAT,1874,43,45-49,1917,1.5475825817162558
SIM,1882,43,45-49,1925,4
STAT,1893,1,na,1894,3522.493882120726
STAT,1853,36,35-39,1889,5.992538282156385
STAT,1841,21,50-100,1862,0.38418348983795164
STAT,1868,51,20-24,1919,7.224447202533439E-4
STAT,1885,32,15-19,1917,0.14493951062988913
STAT,1929,16,40-44,1945,1.8251178327230633
STAT,1841,30,35-39,1871,9.262630397228715
STAT,1891,40,40-44,1931,2.8694957569298998
STAT,1906,47,30-34,1953,0.08069943324741102
STAT,1808,76,na,1884,346.4903745790851
SIM,1902,67,na,1969,2498
STAT,1883,18,na,1901,2521.4209669370334
SIM,1853,48,45-49,1901,1
STAT,1919,26,25-29,1945,72.82307888373641
SIM,1771,91,na,1862,3
SIM,1869,23,na,1892,2318
SIM,1906,34,50-100,1940,2
STAT,1818,41,15-19,1859,0.03684894453097905
STAT,1864,40,30-34,1904,1.0533663884006628
SIM,1887,52,na,1939,2530
SIM,1917,12,na,1929,4248
SIM,1862,46,45-49,1908,1
STAT,1868,47,35-39,1915,0.13577547211055918
SIM,1850,40,45-49,1890,1
STAT,1852,23,na,1875,2031.5328506597953
STAT,1871,92,na,1963,102.00832950059603
SIM,1905,42,45-49,1947,1
STAT,1837,17,25-29,1854,6.905018792119545
STAT,1827,53,25-29,1880,0.0037624057747002175
STAT,1901,52,na,1953,3055.3958704468378
STAT,1871,54,30-34,1925,0.005849783902573445
STAT,1919,19,35-39,1938,4.706628779842756
SIM,1909,1,na,1910,3927
STAT,1864,54,40-44,1918,0.009286841216781486
SIM,1863,22,50-100,1885,1
SIM,1869,23,50-100,1892,5
SIM,1833,73,na,1906,743
STAT,1900,33,20-24,1933,3.805860412205927
SIM,1966,3,na,1969,5192
STAT,1795,61,na,1856,828.3332757019997
STAT,1850,35,20-24,1885,0.6013785952510323
STAT,1856,41,35-39,1897,1.4566673992063288
SIM,1805,54,na,1859,1116
STAT,1873,18,na,1891,2605.2633655469626
SIM,1889,7,na,1896,3387
STAT,1821,72,na,1893,665.4688947582131
STAT,1834,38,na,1872,1771.7884281958213
STAT,1868,18,15-19,1886,5.852453115883849
SIM,1845,17,25-29,1862,7
SIM,1836,60,na,1896,1524
STAT,1838,53,35-39,1891,0.00622396168933592
SIM,1927,19,35-39,1946,3
STAT,1926,40,15-19,1966,0.0019367044429908797
SIM,1796,76,na,1872,375
SIM,1923,7,na,1930,4607
STAT,1873,52,40-44,1925,0.010830253530636751
SIM,1872,40,30-34,1912,1
SIM,1932,1,na,1933,5661
STAT,1842,40,45-49,1882,1.2458075147047445
STAT,1911,33,30-34,1944,15.583132986025804
STAT,1877,30,15-19,1907,0.15189074460469498
STAT,1845,41,25-29,1886,0.5175268278267892
STAT,1945,16,25-29,1961,48.31109208235084
SIM,1880,19,35-39,1899,2
STAT,1856,52,40-44,1908,0.008385698267312261
STAT,1886,17,20-24,1903,19.143482744459295
SIM,1953,16,25-29,1969,93
SIM,1859,18,15-19,1877,9
STAT,1822,54,35-39,1876,0.011338988060379111
STAT,1872,19,35-39,1891,0.5580078817198582
SIM,1889,40,50-100,1929,1
STAT,1874,89,na,1963,229.37990903000457
SIM,1911,7,na,1918,4127
SIM,1878,34,50-100,1912,3
STAT,1921,41,25-29,1962,0.08219199536062691
STAT,1870,52,na,1922,2135.842780035663
STAT,1837,56,na,1893,1359.8781563406249
STAT,1892,46,15-19,1938,2.8930497491191443E-4
SIM,1882,43,50-100,1925,1
STAT,1928,7,na,1935,5137.568093585214
STAT,1815,51,40-44,1866,0.027604777566785334
STAT,1915,30,45-49,1945,1.6485370366948064
SIM,1913,41,40-44,1954,1
STAT,1845,16,20-24,1861,17.611620354830364
STAT,1883,41,45-49,1924,1.50486356984719
STAT,1920,45,40-44,1965,0.17869136536977342
SIM,1944,23,40-44,1967,2
STAT,1941,23,15-19,1964,5.610405868069981
STAT,1847,51,35-39,1898,0.0067455777286231505
STAT,1859,42,15-19,1901,0.011237222899112847
STAT,1910,41,15-19,1951,0.0014887812753826932
SIM,1925,41,na,1966,4747
STAT,1894,37,35-39,1931,9.281216352046531
SIM,1871,36,45-49,1907,3
STAT,1832,51,40-44,1883,0.007500102900498356
STAT,1878,25,15-19,1903,0.48503761665356177
SIM,1870,30,20-24,1900,5
STAT,1920,31,30-34,1951,17.6829894272023
STAT,1821,44,40-44,1865,3.6583783265972567
SIM,1821,92,na,1913,8
SIM,1837,86,na,1923,167
SIM,1854,29,35-39,1883,13
STAT,1825,47,50-100,1872,0.3158816702169652
STAT,1811,54,25-29,1865,0.009004342164287894
STAT,1861,37,na,1898,1986.0139300460041
STAT,1900,26,30-34,1926,35.728130785800666
SIM,1786,79,na,1865,201
SIM,1926,28,50-100,1954,2
STAT,1920,12,na,1932,4536.552517373585
STAT,1870,42,na,1912,2302.0754732368837
STAT,1848,53,45-49,1901,0.011099851740022247
SIM,1868,92,na,1960,49
STAT,1816,95,na,1911,5.899408659778256
SIM,1891,41,45-49,1932,5
SIM,1918,52,na,1970,4064
STAT,1905,41,40-44,1946,0.23116933989594313
SIM,1923,30,45-49,1953,2
STAT,1936,23,40-44,1959,3.2775999966649545
SIM,1847,48,50-100,1895,1
SIM,1945,9,na,1954,4698
SIM,1810,47,50-100,1857,1
STAT,1861,35,30-34,1896,4.5353321914979325
STAT,1846,29,35-39,1875,8.228046746892215
STAT,1882,42,40-44,1924,2.232750864216066
SIM,1869,15,20-24,1884,21
STAT,1842,57,na,1899,1575.9618863473913
STAT,1926,33,25-29,1959,11.394160748667279
STAT,1816,50,45-49,1866,0.029719132650951382
SIM,1896,15,30-34,1911,1
SIM,1903,32,35-39,1935,14
SIM,1879,33,na,1912,2915
SIM,1934,33,25-29,1967,16
SIM,1837,76,na,1913,586
SIM,1853,16,20-24,1869,17
STAT,1839,68,na,1907,1054.6776461213658
STAT,1851,45,15-19,1896,3.332966994233366E-4
STAT,1846,52,30-34,1898,0.00423413658144988
STAT,1854,46,45-49,1900,0.18113651391902938
STAT,1894,44,25-29,1938,0.05772550794069071
STAT,1888,15,30-34,1903,1.9311697506860863
SIM,1928,18,40-44,1946,3
STAT,1832,47,20-24,1879,0.009526740042317457
STAT,1862,34,35-39,1896,8.719050785033492
STAT,1924,42,20-24,1966,0.021431831763424447
SIM,1890,42,40-44,1932,3
STAT,1862,26,50-100,1888,0.5615889660026777
STAT,1894,30,15-19,1924,0.18837203009714718
STAT,1870,47,40-44,1917,0.16993541523917396
STAT,1916,44,20-24,1960,0.01840714605076152
SIM,1855,19,na,1874,2115
STAT,1922,47,15-19,1969,4.318035403278913E-4
STAT,1858,17,50-100,1875,0.046298719102958935
STAT,1944,21,25-29,1965,101.78617632998116
STAT,1845,34,35-39,1879,9.21492527832573
STAT,1926,30,20-24,1956,3.0122267964904466
STAT,1913,43,40-44,1956,0.2484421832667979
SIM,1826,91,na,1917,14
STAT,1936,30,30-34,1966,15.62601107876206
STAT,1889,40,35-39,1929,2.3049104970186183
STAT,1927,5,na,1932,5099.717374115894
STAT,1846,71,na,1917,954.5449712981729
STAT,1881,39,15-19,1920,0.05482656027968522
SIM,1918,33,40-44,1951,5
SIM,1798,57,na,1855,1058
STAT,1878,40,25-29,1918,0.6887620891883759
STAT,1912,43,40-44,1955,0.24461552561947417
STAT,1902,43,30-34,1945,0.11402504004736304
SIM,1862,12,na,1874,2508
STAT,1831,41,30-34,1872,0.9874599312138915
STAT,1931,34,45-49,1965,2.100133616888947
SIM,1911,31,30-34,1942,29
STAT,1868,54,25-29,1922,0.0033563153902500882
STAT,1941,20,45-49,1961,1.1870935852777218
STAT,1840,53,40-44,1893,0.00745403939026839
STAT,1873,48,20-24,1921,0.012255050874462256
STAT,1832,57,na,1889,1347.918592466893
STAT,1882,23,na,1905,2343.30375203346
STAT,1877,63,na,1940,1887.9472796014516
STAT,1893,69,na,1962,2088.4800024870506
STAT,1809,104,na,1913,0.03402976989973372
SIM,1845,20,na,1865,2235
STAT,1871,35,40-44,1906,4.465585633813674
STAT,1905,45,na,1950,3348.460163525603
SIM,1861,33,30-34,1894,19
SIM,1847,86,na,1933,85
SIM,1853,34,35-39,1887,12
SIM,1875,28,50-100,1903,1
SIM,1900,31,20-24,1931,7
STAT,1844,46,35-39,1890,0.10879561056648339
STAT,1847,47,15-19,1894,3.1047073284148734E-4
STAT,1899,10,na,1909,3618.6069367388272
SIM,1962,8,na,1970,5403
STAT,1851,49,30-34,1900,0.07819423151414659
STAT,1860,1,na,1861,3030.4509975330925
STAT,1853,40,20-24,1893,0.13450819668101568
STAT,1865,53,45-49,1918,0.013221338409937097
STAT,1852,57,na,1909,1618.9620259630894
STAT,1862,23,na,1885,2087.3649893818315
STAT,1911,52,na,1963,3487.9700428142646
SIM,1907,12,na,1919,3946
SIM,1900,35,na,1935,3435
SIM,1874,41,45-49,1915,2
SIM,1812,44,40-44,1856,2
SIM,1864,41,35-39,1905,5
SIM,1826,39,50-100,1865,5
SIM,1832,46,na,1878,1570
STAT,1918,31,25-29,1949,10.06365039964904
SIM,1819,57,na,1876,1199
STAT,1952,20,20-24,1972,136.47502095738645
STAT,1862,48,45-49,1910,0.20236729919422003
SIM,1847,15,35-39,1862,1
STAT,1867,22,na,1889,2274.4132276716414
STAT,1911,22,25-29,1933,89.3579411275325
SIM,1820,42,25-29,1862,1
SIM,1842,87,na,1929,127
STAT,1903,31,30-34,1934,25.422936414976668
SIM,1826,39,na,1865,1655
SIM,1868,27,20-24,1895,12
STAT,1818,39,50-100,1857,3.6803013648398313
STAT,1809,51,50-100,1860,0.06545066979431398
STAT,1764,108,na,1872,0.00808835937038171
SIM,1936,16,25-29,1952,46
STAT,1854,102,na,1956,0.27006909424070447
STAT,1934,25,na,1959,5143.748987169016
STAT,1832,105,na,1937,0.01959289186139397
SIM,1876,18,15-19,1894,9
STAT,1877,22,na,1899,2502.424734273467
STAT,1840,41,50-100,1881,0.8032462550897269
STAT,1864,89,na,1953,95.29219144229732
STAT,1861,42,20-24,1903,0.13370952088070961
STAT,1853,33,30-34,1886,14.920380171316223
STAT,1904,44,45-49,1948,0.14990108833227916
SIM,1815,54,na,1869,1252
STAT,1811,62,na,1873,957.6593009484528
STAT,1906,34,50-100,1940,0.7745013286499978
STAT,1886,35,35-39,1921,7.709959753836459
STAT,1812,42,25-29,1854,1.8528925103713938
SIM,1901,31,20-24,1932,7
SIM,1820,35,35-39,1855,3
SIM,1948,19,20-24,1967,188
STAT,1814,48,15-19,1862,0.001173523689041808
STAT,1786,105,na,1891,0.012668736792054922
STAT,1899,15,40-44,1914,0.2566971670901539
STAT,1896,36,na,1932,3189.612202059624
SIM,1849,28,15-19,1877,1
STAT,1894,55,na,1949,2713.291395073517
STAT,1904,59,na,1963,3012.9024328800024
STAT,1879,88,na,1967,357.5436518639026
STAT,1880,51,20-24,1931,7.948564097399673E-4
SIM,1957,9,na,1966,5607
SIM,1866,3,na,1869,3060
STAT,1819,44,35-39,1863,3.6874974856534926
SIM,1813,73,na,1886,565
SIM,1864,78,na,1942,723
SIM,1775,84,na,1859,49
SIM,1894,35,35-39,1929,12
STAT,1814,83,na,1897,184.99085868724455
SIM,1921,43,40-44,1964,1
STAT,1881,37,na,1918,2323.647043941766
SIM,1800,55,na,1855,1054
SIM,1884,85,na,1969,489
STAT,1878,6,na,1884,2865.7803793226526
SIM,1873,6,na,1879,2703
SIM,1914,34,50-100,1948,1
STAT,1922,37,na,1959,4368.054462086531
STAT,1838,50,30-34,1888,0.004526140056329183
STAT,1867,18,15-19,1885,5.776230590349115
STAT,1824,52,45-49,1876,0.016317080079910125
STAT,1899,54,na,1953,2925.274646515788
STAT,1874,40,40-44,1914,2.3663992061500854
STAT,1888,48,15-19,1936,2.686989296411906E-4
SIM,1845,28,30-34,1873,40
STAT,1829,26,30-34,1855,48.82158334085989
STAT,1892,46,50-100,1938,0.17763340381520726
SIM,1932,33,na,1965,5240
STAT,1847,17,35-39,1864,0.534049526587153
SIM,1823,40,35-39,1863,4
STAT,1881,54,40-44,1935,0.010097652128226449
STAT,1875,41,na,1916,2430.842096977477
STAT,1869,88,na,1957,167.59001513990236
STAT,1872,52,50-100,1924,0.015359295890127748
STAT,1929,19,45-49,1948,0.6467436074389784
SIM,1859,18,30-34,1877,2
SIM,1924,37,50-100,1961,1
STAT,1868,44,30-34,1912,1.105078603695506
STAT,1845,75,na,1920,804.367046971231
STAT,1853,102,na,1955,0.24582684326819795
SIM,1890,31,35-39,1921,17
STAT,1854,54,30-34,1908,0.004430529435796754
SIM,1853,19,25-29,1872,12
STAT,1927,43,35-39,1970,0.2572064887298299
SIM,1827,44,35-39,1871,6
SIM,1944,14,na,1958,4265
STAT,1882,31,35-39,1913,10.106188418630726
STAT,1891,43,45-49,1934,1.8765986906149106
STAT,1827,50,20-24,1877,8.319263337739127E-4
STAT,1878,18,25-29,1896,6.001513962987911
SIM,1855,17,35-39,1872,1
STAT,1894,41,20-24,1935,0.2093403010967263
STAT,1932,37,30-34,1969,2.4973488597748403
STAT,1844,90,na,1934,61.09445304852963
STAT,1820,34,30-34,1854,52.35642945836116
STAT,1857,56,na,1913,1625.0149522337238
SIM,1905,35,50-100,1940,3
SIM,1876,44,30-34,1920,2
SIM,1937,19,45-49,1956,1
SIM,1882,40,40-44,1922,4
SIM,1926,31,25-29,1957,13
STAT,1895,51,na,1946,2879.680877545773
STAT,1835,41,15-19,1876,0.012492825848310334
STAT,1901,33,20-24,1934,3.839854447111605
STAT,1839,15,35-39,1854,0.5012674757106372
SIM,1814,58,na,1872,1093
SIM,1840,65,na,1905,1133
SIM,1842,19,15-19,1861,4
SIM,1863,93,na,1956,1
STAT,1876,53,20-24,1929,7.648648411252019E-4
STAT,1837,28,30-34,1865,21.394925495781795
STAT,1864,33,50-100,1897,0.82760284982459
STAT,1893,49,35-39,1942,0.10006701680623047
STAT,1832,54,45-49,1886,0.009742507244887502
SIM,1810,99,na,1909,5
STAT,1896,17,30-34,1913,2.1475054902249586
STAT,1806,95,na,1901,4.7243562470830796
SIM,1827,29,25-29,1856,41
STAT,1931,41,35-39,1972,0.2747480880789699
SIM,1883,2,na,1885,3153
STAT,1819,51,25-29,1870,0.006884203763670888
STAT,1844,16,50-100,1860,0.04854514897042849
SIM,1864,34,na,1898,2147
STAT,1871,31,25-29,1902,10.39270225124786
SIM,1832,87,na,1919,76
STAT,1830,76,na,1906,599.3201097722933
STAT,1805,51,30-34,1856,0.021402019225282218
STAT,1883,70,na,1953,1404.428784505026
STAT,1920,41,25-29,1961,0.08059965709884101
STAT,1832,36,15-19,1868,0.04820810603256857
STAT,1853,15,50-100,1868,0.05000342189820352
STAT,1855,49,15-19,1904,3.036048361865373E-4
STAT,1910,45,30-34,1955,0.08522877795381675
SIM,1837,19,40-44,1856,2
SIM,1905,34,na,1939,3441
STAT,1876,27,50-100,1903,0.6738707589947587
SIM,1868,45,35-39,1913,1
SIM,1908,52,na,1960,3525
STAT,1860,42,na,1902,1910.6908261205801
SIM,1819,38,30-34,1857,10
STAT,1865,46,20-24,1911,0.011142380100700155
STAT,1930,31,40-44,1961,5.153853430035628
SIM,1898,28,50-100,1926,1
STAT,1914,49,30-34,1963,0.089676150147399
STAT,1845,19,25-29,1864,5.530473083388457
STAT,1872,29,50-100,1901,0.6493659165137173
SIM,1862,53,na,1915,1921
SIM,1903,22,40-44,1925,3
SIM,1934,30,20-24,1964,6
STAT,1888,18,35-39,1906,0.6600205152365393
STAT,1924,45,25-29,1969,0.06473353532773303
SIM,1884,27,50-100,1911,1
STAT,1867,16,50-100,1883,0.048251618014727805
STAT,1881,51,50-100,1932,0.014966769868127387
STAT,1815,40,35-39,1855,6.360632042249639
STAT,1894,34,30-34,1928,22.71480463169164
STAT,1821,47,45-49,1868,0.371848684795095
SIM,1875,18,15-19,1893,6
STAT,1876,50,50-100,1926,0.016138308899650504
STAT,1920,34,35-39,1954,10.127369793268384
STAT,1844,38,na,1882,1909.3060112424682
SIM,1862,8,na,1870,2564
STAT,1925,11,na,1936,4890.605906217416
STAT,1879,51,30-34,1930,0.006377901446853469
STAT,1872,42,30-34,1914,1.1740077136693083
STAT,1820,41,20-24,1861,0.3249195352390427
SIM,1829,27,35-39,1856,6
SIM,1871,33,40-44,1904,7
SIM,1849,39,50-100,1888,3
SIM,1877,52,na,1929,2203
SIM,1853,38,na,1891,1930
SIM,1865,19,na,1884,2491
STAT,1905,44,45-49,1949,0.15105746187392047
STAT,1900,22,15-19,1922,4.664654165564229
STAT,1884,44,15-19,1928,0.013749883799331545
STAT,1871,21,30-34,1892,18.054093649741702
STAT,1895,29,50-100,1924,0.8453521876798952
STAT,1860,35,50-100,1895,1.0258713543265237
SIM,1886,29,30-34,1915,34
STAT,1916,37,50-100,1953,0.4387614527300272
SIM,1835,43,30-34,1878,2
STAT,1878,29,30-34,1907,26.54856949329454
STAT,1850,42,45-49,1892,1.1243939525453444
STAT,1873,9,na,1882,2768.972170859033
STAT,1895,47,45-49,1942,0.17636297611251525
SIM,1863,16,30-34,1879,2
SIM,1880,42,30-34,1922,4
STAT,1827,43,30-34,1870,1.3368774038909181
SIM,1918,18,30-34,1936,22
STAT,1909,40,50-100,1949,0.11333664966207534
STAT,1861,31,15-19,1892,0.12053572675936156
STAT,1855,16,30-34,1871,1.478288260272035
SIM,1812,80,na,1892,231
STAT,1927,22,30-34,1949,36.12168387471645
SIM,1910,21,50-100,1931,1
SIM,1907,19,25-29,1926,14
SIM,1947,22,50-100,1969,1
STAT,1929,30,40-44,1959,5.075652559471068
STAT,1839,15,40-44,1854,0.1670891682444759
STAT,1948,22,50-100,1970,0.7708107704010481
STAT,1908,28,35-39,1936,14.42164931059732
STAT,1907,41,15-19,1948,0.001442947565596825
STAT,1800,108,na,1908,8.828317496841027E-4
STAT,1776,108,na,1884,0.004856797941154765
STAT,1903,19,45-49,1922,0.09422037893810821
STAT,1893,20,40-44,1913,2.7128442081796855
SIM,1933,25,30-34,1958,76
SIM,1852,21,na,1873,2101
SIM,1912,37,35-39,1949,3
STAT,1850,85,na,1935,206.20524270826198
STAT,1865,25,35-39,1890,8.994581135502056
STAT,1923,28,50-100,1951,1.1618711042837404
STAT,1916,47,25-29,1963,0.055521943629077065
STAT,1887,54,na,1941,2393.7377601060643
SIM,1823,32,na,1855,1754
SIM,1816,70,na,1886,884
SIM,1869,43,50-100,1912,2
STAT,1900,15,50-100,1915,0.06959390219610703
SIM,1841,69,na,1910,1005
STAT,1914,39,15-19,1953,0.019365519529820786
STAT,1882,25,50-100,1907,0.6400887507221719
SIM,1924,16,20-24,1940,162
STAT,1906,45,45-49,1951,0.1996387567875068
SIM,1897,20,20-24,1917,83
STAT,1836,62,na,1898,1137.6430678803963
STAT,1937,16,50-100,1953,0.3726898052003593
STAT,1869,30,45-49,1899,1.731310731498877
STAT,1936,28,40-44,1964,4.547474905396643
SIM,1836,82,na,1918,249
STAT,1900,24,15-19,1924,4.635452619770903
STAT,1921,34,30-34,1955,17.738191056334863
SIM,1944,15,35-39,1959,5
SIM,1959,9,na,1968,5721
SIM,1873,25,35-39,1898,14
STAT,1923,42,40-44,1965,0.2982805573951321
STAT,1851,54,20-24,1905,5.920548216708652E-4
SIM,1847,15,40-44,1862,4
SIM,1895,18,na,1913,3502
STAT,1902,21,15-19,1923,4.760455047421654
SIM,1894,76,na,1970,1616
SIM,1937,30,40-44,1967,7
SIM,1835,41,na,1876,1728
SIM,1944,26,45-49,1970,3
STAT,1859,28,15-19,1887,0.37331875589930014
STAT,1867,22,35-39,1889,5.6118479020246355
SIM,1799,97,na,1896,4
SIM,1918,36,45-49,1954,1
SIM,1916,2,na,1918,4403
SIM,1892,31,50-100,1923,4
STAT,1847,21,25-29,1868,55.121127377242175
SIM,1935,22,30-34,1957,43
SIM,1918,25,35-39,1943,27
STAT,1904,37,35-39,1941,2.2320305762784165
SIM,1827,46,na,1873,1466
STAT,1878,18,na,1896,2674.816800697645
SIM,1855,21,25-29,1876,83
STAT,1920,36,35-39,1956,2.704992765185627
STAT,1921,45,40-44,1966,0.18222161733821704
SIM,1848,16,na,1864,2297
STAT,1870,37,40-44,1907,4.365520263235457
STAT,1911,27,25-29,1938,65.47492089421792
STAT,1849,37,na,1886,1871.640437565181
SIM,1919,34,40-44,1953,10
STAT,1911,30,25-29,1941,9.254256424323032
SIM,1900,30,45-49,1930,7
STAT,1850,33,50-100,1883,0.7135291168592613
STAT,1920,16,40-44,1936,1.6053740784387824
STAT,1782,96,na,1878,1.4979240185882123
STAT,1904,48,45-49,1952,0.19218994309312953
SIM,1942,18,35-39,1960,7
STAT,1925,45,25-29,1970,0.06588834315962544
SIM,1848,31,35-39,1879,14
STAT,1914,19,20-24,1933,28.46035550191283
STAT,1917,15,25-29,1932,9.560688014518167
STAT,1897,19,50-100,1916,0.06646833710250202
STAT,1900,37,20-24,1937,0.23525431525484164
STAT,1940,29,15-19,1969,0.7336721984932546
SIM,1857,44,na,1901,1925
SIM,1846,92,na,1938,12
STAT,1904,51,na,1955,3163.2219280460577
STAT,1950,19,30-34,1969,14.693334486742183
SIM,1900,18,30-34,1918,2
STAT,1886,13,na,1899,2784.302235482354
SIM,1888,33,30-34,1921,27
STAT,1934,18,35-39,1952,5.772924024923175
SIM,1843,22,45-49,1865,3
SIM,1902,26,40-44,1928,7
STAT,1782,88,na,1870,43.45061037058093
STAT,1921,15,45-49,1936,0.5837474490153968
STAT,1942,26,15-19,1968,0.7562757608478876
SIM,1820,99,na,1919,2
SIM,1889,32,35-39,1921,16
SIM,1912,17,40-44,1929,1
STAT,1841,49,na,1890,1626.4918487591515
STAT,1951,15,30-34,1966,14.814816668368639
STAT,1786,78,na,1864,253.49585398735073
SIM,1920,10,na,1930,4398
STAT,1904,17,40-44,1921,0.2674163116849205
SIM,1873,15,na,1888,2552
SIM,1903,30,na,1933,3387
SIM,1887,7,na,1894,3062
SIM,1922,19,20-24,1941,153
STAT,1879,20,50-100,1899,0.4374439009334252
SIM,1799,73,na,1872,591
STAT,1835,22,45-49,1857,0.6909129643958912
STAT,1952,16,30-34,1968,14.904568622834592
SIM,1833,42,na,1875,1721
SIM,1837,56,na,1893,1274
STAT,1930,27,35-39,1957,19.470556337488
STAT,1932,35,45-49,1967,0.9357318421074283
STAT,1790,83,na,1873,142.24848265549224
STAT,1857,32,na,1889,1912.956794888757
STAT,1916,16,20-24,1932,29.425563915162865
STAT,1831,39,na,1870,1777.1927565601752
STAT,1871,47,na,1918,2262.920252387741
SIM,1806,84,na,1890,199
SIM,1907,35,30-34,1942,3
STAT,1811,52,25-29,1863,0.009373804896910328
STAT,1902,34,20-24,1936,2.2137991954649783
STAT,1932,15,20-24,1947,183.9311044803398
SIM,1831,51,na,1882,1419
STAT,1863,22,20-24,1885,62.867295607656814
SIM,1802,70,na,1872,659
STAT,1905,16,45-49,1921,0.09647893080167494
STAT,1893,31,50-100,1924,1.1906016912637452
STAT,1915,18,25-29,1933,9.231013500459545
SIM,1923,18,25-29,1941,59
SIM,1912,15,na,1927,4124
SIM,1808,75,na,1883,494
STAT,1911,21,50-100,1932,0.6384650942358693
SIM,1940,15,20-24,1955,142
STAT,1866,48,30-34,1914,0.08994141616436664
SIM,1875,9,na,1884,2690
STAT,1840,75,na,1915,740.7987981870118
STAT,1934,34,50-100,1968,1.14972096820331
SIM,1920,23,25-29,1943,140
STAT,1908,22,20-24,1930,104.24041992744009
STAT,1810,77,na,1887,350.46787721835693
STAT,1844,17,15-19,1861,5.845801128539966
STAT,1934,32,15-19,1966,0.1789263841857503
SIM,1897,26,35-39,1923,18
SIM,1926,19,35-39,1945,9
STAT,1913,40,30-34,1953,0.1286284753048113
STAT,1917,32,15-19,1949,0.13732203440283405
SIM,1877,18,30-34,1895,3
SIM,1852,13,na,1865,2475
STAT,1912,23,25-29,1935,90.02549993082623
STAT,1896,16,25-29,1912,7.653838009719043
SIM,1847,35,35-39,1882,11
STAT,1803,75,na,1878,482.92754089941405
SIM,1827,54,na,1881,1264
STAT,1894,24,na,1918,3084.0316512585005
SIM,1941,19,30-34,1960,17
STAT,1898,38,na,1936,3259.592262968497
SIM,1943,19,35-39,1962,5
STAT,1932,15,na,1947,4993.573822491817
SIM,1852,17,15-19,1869,6
STAT,1854,67,na,1921,1213.2537873418441
SIM,1878,46,na,1924,2541
STAT,1935,19,35-39,1954,5.818600145210999
STAT,1830,52,35-39,1882,0.0062829120410679146
SIM,1945,24,40-44,1969,5
STAT,1870,54,30-34,1924,0.0057730124523793095
STAT,1890,18,na,1908,3142.027882806115
STAT,1829,25,25-29,1854,132.39579919905594
SIM,1860,34,50-100,1894,3
STAT,1889,26,35-39,1915,12.200762314234124
SIM,1882,51,na,1933,2072
STAT,1860,47,25-29,1907,0.04745407118019085
STAT,1937,24,40-44,1961,3.337572360363165
STAT,1868,16,na,1884,2520.268616017189
SIM,1837,25,25-29,1862,4
STAT,1872,21,na,1893,2425.3962656789367
STAT,1924,29,30-34,1953,46.2129026678042
STAT,1792,98,na,1890,0.5388515432517569
SIM,1849,40,40-44,1889,3
STAT,1819,49,50-100,1868,0.47264184994428626
STAT,1899,31,na,1930,3347.227445784654
SIM,1805,49,50-100,1854,3
STAT,1836,52,50-100,1888,0.009512233346891405
STAT,1885,48,40-44,1933,0.17205435095193816
STAT,1903,30,20-24,1933,3.9513888062724187
SIM,1816,62,na,1878,1139
STAT,1908,41,na,1949,3524.0422479518097
SIM,1837,46,50-100,1883,1
STAT,1825,78,na,1903,468.53617622578753
STAT,1852,53,25-29,1905,0.002807636163306331
STAT,1918,19,35-39,1937,4.6357874663951835
SIM,1903,25,45-49,1928,2
SIM,1861,89,na,1950,35
SIM,1921,40,30-34,1961,3
STAT,1869,18,30-34,1887,1.5821792554031904
STAT,1877,52,na,1929,2266.108290515895
STAT,1931,2,na,1933,5459.511769605619
STAT,1933,31,15-19,1964,0.17671130670000576
SIM,1850,44,50-100,1894,1
STAT,1858,40,40-44,1898,1.8380426484674315
SIM,1906,27,na,1933,3570
STAT,1907,41,45-49,1948,0.15637943144248428
SIM,1831,39,20-24,1870,4
STAT,1761,102,na,1863,0.03796234425640627
SIM,1898,66,na,1964,2810
SIM,1933,0,na,1933,5597
STAT,1924,41,45-49,1965,0.20226297431263532
STAT,1909,29,35-39,1938,14.528838857354616
STAT,1913,43,50-100,1956,0.11668965128980123
STAT,1866,60,na,1926,1794.5992065773155
SIM,1886,33,na,1919,2621
STAT,1943,22,15-19,1965,5.7781932770839495
SIM,1911,30,20-24,1941,5
STAT,1854,103,na,1957,0.16047505579782662
STAT,1938,23,45-49,1961,1.135584522727604
STAT,1853,42,na,1895,1935.5855435597102
STAT,1903,36,35-39,1939,2.224517348989928
SIM,1911,36,35-39,1947,6
SIM,1840,44,na,1884,1602
SIM,1936,34,40-44,1970,2
STAT,1866,92,na,1958,56.80907235780679
SIM,1853,62,na,1915,1490
SIM,1857,76,na,1933,656
STAT,1823,39,20-24,1862,1.3336720665005537
STAT,1915,11,na,1926,4224.212674930526
STAT,1919,25,na,1944,4158.5635517638275
SIM,1932,29,30-34,1961,82
STAT,1890,39,50-100,1929,1.5159958554264743
SIM,1911,41,na,1952,3693
SIM,1915,55,na,1970,3964
STAT,1952,5,na,1957,4806.494439174191
STAT,1849,8,na,1857,2346.7105017856024
SIM,1828,35,25-29,1863,1
STAT,1840,39,20-24,1879,0.6425913794447691
STAT,1910,34,25-29,1944,9.01153416305522
SIM,1916,28,35-39,1944,18
SIM,1856,25,35-39,1881,13
STAT,1786,107,na,1893,0.0020376469861701895
SIM,1932,23,50-100,1955,1
STAT,1918,44,25-29,1962,0.07722060305610023
SIM,1930,30,30-34,1960,34
SIM,1844,26,na,1870,2101
STAT,1857,43,50-100,1900,0.8356149586579303
SIM,1946,23,45-49,1969,1
STAT,1889,20,20-24,1909,87.35777492367912
SIM,1915,29,30-34,1944,71
STAT,1878,20,15-19,1898,3.524007233806814
STAT,1839,35,35-39,1874,5.955671224744718
STAT,1928,34,40-44,1962,4.984710759619616
SIM,1853,94,na,1947,13
SIM,1939,27,20-24,1966,19
STAT,1905,24,50-100,1929,0.5970545701811011
SIM,1878,26,25-29,1904,45
STAT,1907,29,30-34,1936,37.13483291777542
SIM,1910,32,na,1942,3666
SIM,1916,22,20-24,1938,104
STAT,1871,53,35-39,1924,0.008559983880415803
STAT,1871,39,na,1910,2356.811537102209
SIM,1836,90,na,1926,18
STAT,1857,24,na,1881,1951.191607311693
STAT,1923,30,na,1953,4459.351681850953
STAT,1917,45,20-24,1962,0.011834954248358205
SIM,1917,29,35-39,1946,33
STAT,1922,30,30-34,1952,18.30980192006841
STAT,1800,100,na,1900,0.5116786980108281
STAT,1933,31,45-49,1964,2.1638798660721488
STAT,1919,28,40-44,1947,5.121219887898873
STAT,1863,5,na,1868,2566.4845135393157
SIM,1819,67,na,1886,883
STAT,1893,23,45-49,1916,0.8996477194376222
STAT,1891,67,na,1958,2083.1240194535185
SIM,1870,74,na,1944,1083
SIM,1829,80,na,1909,252
SIM,1905,37,50-100,1942,1
STAT,1856,15,40-44,1871,0.1752488643837855
SIM,1924,19,25-29,1943,65
STAT,1835,21,na,1856,2132.7421867088733
SIM,1871,99,na,1970,8
SIM,1878,78,na,1956,859
STAT,1918,41,20-24,1959,0.019188955061458207
STAT,1898,40,50-100,1938,0.10222819700732488
SIM,1815,77,na,1892,334
STAT,1857,101,na,1958,0.7592232620730102
SIM,1935,34,25-29,1969,21
STAT,1805,107,na,1912,0.0018954685970647834
SIM,1881,26,na,1907,2192
SIM,1908,36,30-34,1944,1
STAT,1847,110,na,1957,2.6526246443056334E-4
STAT,1867,30,40-44,1897,4.1867966129380205
SIM,1941,16,20-24,1957,133
SIM,1919,45,na,1964,4156
STAT,1905,29,20-24,1934,17.16093462294507
STAT,1924,28,na,1952,4434.44344898663
SIM,1897,40,50-100,1937,2
SIM,1858,18,20-24,1876,23
STAT,1911,24,20-24,1935,106.89603987278785
SIM,1895,26,25-29,1921,55
STAT,1841,21,30-34,1862,16.78113301616128
STAT,1839,59,na,1898,1341.2717474330664
STAT,1847,23,50-100,1870,0.3870382909959119
STAT,1916,19,25-29,1935,9.332195068108527
STAT,1883,48,30-34,1931,0.09567598476186386
STAT,1921,37,35-39,1958,2.7559228120439063
SIM,1918,20,na,1938,4147
SIM,1927,28,40-44,1955,11
SIM,1834,21,35-39,1855,6
SIM,1910,37,30-34,1947,3
STAT,1856,90,na,1946,63.13580202942343
STAT,1878,34,50-100,1912,0.9645958283351579
STAT,1907,26,20-24,1933,17.632691714854897
STAT,1940,32,45-49,1972,1.6614332680675226
SIM,1857,48,30-34,1905,1
SIM,1886,34,50-100,1920,1
STAT,1878,33,20-24,1911,2.8581607271814886
SIM,1866,13,na,1879,2684
STAT,1910,47,30-34,1957,0.08482952210709956
SIM,1878,23,20-24,1901,77
STAT,1889,40,50-100,1929,1.3447142227409867
STAT,1887,26,25-29,1913,48.5221121704294
SIM,1911,33,25-29,1944,12
STAT,1941,25,15-19,1966,0.7456930403439543
SIM,1930,16,45-49,1946,1
STAT,1920,8,na,1928,4566.480681318702
STAT,1895,20,45-49,1915,0.9336804738569943
SIM,1830,77,na,1907,583
SIM,1887,74,na,1961,1454
SIM,1888,16,na,1904,3038
STAT,1923,45,45-49,1968,0.26063211138404163
STAT,1924,41,15-19,1965,0.0018663251535233603
STAT,1907,25,50-100,1932,0.964687541532577
STAT,1826,32,45-49,1858,1.9010166962719417
STAT,1875,29,na,1904,2480.8564744263813
STAT,1854,59,na,1913,1487.4392600435183
STAT,1894,56,na,1950,2676.444897928418
STAT,1807,57,na,1864,1258.21897117505
STAT,1931,19,20-24,1950,180.00824441661095
SIM,1879,43,30-34,1922,3
STAT,1869,30,15-19,1899,0.14138593665195115
STAT,1922,16,45-49,1938,0.591344127349297
SIM,1940,30,na,1970,4003
SIM,1834,32,45-49,1866,1
SIM,1907,16,20-24,1923,26
STAT,1844,41,50-100,1885,0.849251920808722
STAT,1865,11,na,1876,2514.410189469489
SIM,1866,4,na,1870,2886
STAT,1900,24,45-49,1924,0.9798052645635236
SIM,1864,54,na,1918,1966
STAT,1915,43,na,1958,3809.502572595176
STAT,1859,90,na,1949,64.23258966575708
STAT,1901,25,15-19,1926,0.6516336998165364
STAT,1903,33,25-29,1936,8.492867043207887
STAT,1949,23,na,1972,4345.982471858051
STAT,1945,18,40-44,1963,1.5583851631796566
SIM,1923,35,45-49,1958,1
SIM,1858,18,na,1876,2230
STAT,1800,54,15-19,1854,1.0014897557915975E-4
STAT,1875,38,30-34,1913,5.552447306653356
SIM,1846,60,na,1906,1506
STAT,1875,21,na,1896,2483.7070482831564
STAT,1878,20,45-49,1898,0.7448767409070194
SIM,1928,30,na,1958,4983
SIM,1888,30,20-24,1918,4
STAT,1841,60,na,1901,1408.1711970604526
SIM,1902,27,25-29,1929,90
SIM,1913,29,20-24,1942,17
STAT,1933,16,20-24,1949,185.53887696099952
STAT,1913,23,40-44,1936,3.453067423674532
STAT,1850,106,na,1956,0.011453460147888294
STAT,1852,22,45-49,1874,0.667348636137142
SIM,1883,38,30-34,1921,8
SIM,1921,27,35-39,1948,34
STAT,1838,19,40-44,1857,0.17542710299202458
SIM,1887,82,na,1969,925
STAT,1897,33,30-34,1930,23.715191124492044
SIM,1856,22,25-29,1878,76
SIM,1905,19,20-24,1924,1
STAT,1913,27,35-39,1940,15.261245541259722
STAT,1914,42,45-49,1956,0.16825873306198838
STAT,1914,18,na,1932,4065.6420319744157
STAT,1903,16,40-44,1919,0.26589098342512935
SIM,1877,21,na,1898,2457
SIM,1879,87,na,1966,602
SIM,1921,38,45-49,1959,2
SIM,1856,59,na,1915,1929
STAT,1907,56,na,1963,3213.191341795516
SIM,1953,18,40-44,1971,2
STAT,1902,37,25-29,1939,0.8940454066516352
STAT,1899,41,40-44,1940,0.2191860420298659
SIM,1851,28,na,1879,2013
STAT,1817,67,na,1884,861.4825302486972
STAT,1921,48,45-49,1969,0.2493215849213354
STAT,1925,42,20-24,1967,0.021814162916000933
SIM,1891,36,na,1927,3008
STAT,1904,43,50-100,1947,0.10648552113075932
STAT,1930,24,30-34,1954,37.31757104344789
STAT,1870,97,na,1967,24.26918882825242
STAT,1863,40,50-100,1903,0.9544800488268687
SIM,1902,30,25-29,1932,25
STAT,1899,30,30-34,1929,24.586752032465746
SIM,1838,42,30-34,1880,3
SIM,1874,64,na,1938,1744
STAT,1860,44,20-24,1904,0.12967745785787804
STAT,1873,62,na,1935,1890.3301679287265
STAT,1911,26,40-44,1937,4.652500711921969
SIM,1879,31,na,1910,2936
SIM,1901,19,30-34,1920,2
STAT,1879,67,na,1946,1690.4049635267925
STAT,1932,23,na,1955,4871.351616923031
SIM,1861,52,50-100,1913,1
STAT,1813,53,na,1866,1203.4980125444847
STAT,1911,15,30-34,1926,2.4995211815678835
SIM,1854,25,25-29,1879,11
SIM,1871,40,50-100,1911,3
STAT,1901,20,45-49,1921,1.0007198821678445
SIM,1871,22,20-24,1893,46
STAT,1860,23,50-100,1883,0.3454509897558043
STAT,1901,36,25-29,1937,0.8908137912428139
STAT,1930,35,40-44,1965,1.9949537463285358
SIM,1837,22,20-24,1859,58
SIM,1910,37,25-29,1947,1
STAT,1846,25,25-29,1871,37.12705922657179
SIM,1938,6,na,1944,3987
STAT,1902,40,25-29,1942,0.06480041770728778
SIM,1823,64,na,1887,964
SIM,1914,25,20-24,1939,21
SIM,1834,56,na,1890,1348
SIM,1877,30,45-49,1907,6
SIM,1830,66,na,1896,1105
SIM,1926,16,30-34,1942,29
STAT,1879,45,50-100,1924,0.2645077865268946
SIM,1874,21,35-39,1895,9
STAT,1909,38,25-29,1947,0.9457670974508634
STAT,1911,43,30-34,1954,0.12371928325282441
STAT,1937,27,45-49,1964,1.717784045256494
SIM,1909,32,30-34,1941,16
SIM,1917,38,25-29,1955,1
SIM,1903,23,25-29,1926,101
SIM,1921,23,40-44,1944,5
SIM,1930,33,35-39,1963,18
STAT,1834,30,50-100,1864,0.8063845669268297
SIM,1887,45,50-100,1932,2
STAT,1909,41,25-29,1950,0.06851131624233253
STAT,1926,37,40-44,1963,1.8663943027624672
SIM,1844,34,na,1878,2026
SIM,1848,48,na,1896,1778
STAT,1849,19,50-100,1868,0.04626860983787245
STAT,1848,22,25-29,1870,54.18197781609675
SIM,1897,23,30-34,1920,36
SIM,1925,15,25-29,1940,70
STAT,1901,20,15-19,1921,4.73439954572832
SIM,1836,28,50-100,1864,4
STAT,1808,47,30-34,1855,0.2566735734514857
SIM,1853,5,na,1858,2475
STAT,1924,38,20-24,1962,0.3168176101908391
STAT,1926,20,50-100,1946,0.8203656413563197
STAT,1906,25,20-24,1931,17.53757440710178
STAT,1915,35,45-49,1950,0.7094293212875054
SIM,1929,4,na,1933,5491
STAT,1855,37,50-100,1892,0.9517440760669535
STAT,1903,66,na,1969,2706.06940121485
STAT,1889,23,30-34,1912,22.376676862940577
STAT,1943,0,na,1943,4832.140798982924
STAT,1927,38,40-44,1965,1.8966543906545812
STAT,1869,89,na,1958,144.0251831110807
SIM,1842,30,50-100,1872,2
STAT,1836,30,na,1866,1740.8613655352153
SIM,1849,43,45-49,1892,6
STAT,1813,77,na,1890,371.71226343821326
STAT,1871,45,35-39,1916,0.1428838780376031
SIM,1932,38,20-24,1970,1
STAT,1816,42,na,1858,1390.4182357507118
STAT,1936,26,45-49,1962,1.6870861954174012
STAT,1775,86,na,1861,62.61227073586318
STAT,1872,49,15-19,1921,4.0043250325635997E-4
SIM,1833,46,50-100,1879,1
STAT,1781,108,na,1889,0.004868394511555647
SIM,1839,87,na,1926,156
SIM,1849,32,35-39,1881,2
STAT,1882,31,na,1913,2381.391519195514
STAT,1825,46,50-100,1871,0.32023960065418866
STAT,1940,10,na,1950,4099.74916539433
STAT,1856,32,30-34,1888,14.152986641869179
STAT,1837,87,na,1924,117.46440660798902
SIM,1915,26,20-24,1941,27
STAT,1884,30,40-44,1914,4.412155289808564
SIM,1936,17,na,1953,3403
SIM,1904,4,na,1908,4081
STAT,1833,73,na,1906,779.9920671595177
STAT,1917,48,25-29,1965,0.05638447480013738
STAT,1823,50,50-100,1873,0.02274606654722237
SIM,1854,87,na,1941,124
SIM,1897,0,na,1897,3730
SIM,1910,21,15-19,1931,5
STAT,1888,22,25-29,1910,69.03936408365753
SIM,1934,37,40-44,1971,4
STAT,1767,99,na,1866,0.23043230032879614
STAT,1837,32,20-24,1869,2.259625449984637
SIM,1872,48,50-100,1920,2
STAT,1822,81,na,1903,314.42428019226054
STAT,1936,15,35-39,1951,4.116523201103777
SIM,1896,22,25-29,1918,109
STAT,1964,3,na,1967,5052.679774880762
STAT,1910,31,20-24,1941,2.408514532919129
SIM,1911,33,30-34,1944,21
STAT,1826,95,na,1921,7.75449885572619
SIM,1810,104,na,1914,3
SIM,1915,25,50-100,1940,1
STAT,1872,15,25-29,1887,5.881974879404323
STAT,1923,45,15-19,1968,4.417489695159515E-4
SIM,1886,33,20-24,1919,6
SIM,1839,21,40-44,1860,2
SIM,1857,52,na,1909,1760
SIM,1845,32,20-24,1877,3
SIM,1875,22,35-39,1897,8
SIM,1946,20,40-44,1966,4
STAT,1828,103,na,1931,0.07902894835282048
SIM,1906,15,20-24,1921,34
STAT,1922,33,35-39,1955,10.490990915084794
SIM,1919,37,45-49,1956,1
SIM,1880,15,25-29,1895,11
STAT,1918,27,40-44,1945,5.061956488118363
STAT,1820,55,na,1875,1238.733618918263
SIM,1791,77,na,1868,347
SIM,1862,7,na,1869,2583
SIM,1905,22,45-49,1927,1
SIM,1828,95,na,1923,19
SIM,1902,37,na,1939,3457
SIM,1829,31,25-29,1860,8
STAT,1904,45,40-44,1949,0.14260087907582017
STAT,1922,45,na,1967,4326.683330798827
SIM,1936,30,25-29,1966,9
STAT,1824,69,na,1893,808.0518598249242
STAT,1903,33,30-34,1936,14.477085488398552
SIM,1799,65,na,1864,1009
STAT,1895,41,na,1936,3100.8770603337366
SIM,1854,37,50-100,1891,4
STAT,1866,21,35-39,1887,5.575882273644059
STAT,1916,36,15-19,1952,0.020164682759908112
SIM,1892,30,40-44,1922,8
STAT,1828,28,50-100,1856,0.8079858280550473
STAT,1918,16,30-34,1934,2.7228819826157444
SIM,1926,27,40-44,1953,9
STAT,1915,35,15-19,1950,0.019983926919887356
SIM,1868,24,15-19,1892,4
STAT,1904,34,30-34,1938,14.532257558758038
STAT,1920,20,25-29,1940,105.4190833980154
STAT,1827,34,na,1861,1835.2249164063526
SIM,1938,29,25-29,1967,75
STAT,1928,30,25-29,1958,11.801593176883198
SIM,1912,45,40-44,1957,1
STAT,1846,37,50-100,1883,0.9168635686850739
SIM,1864,32,30-34,1896,19
STAT,1926,26,30-34,1952,48.082041021221656
STAT,1921,32,35-39,1953,10.377435044891152
SIM,1925,7,na,1932,5052
SIM,1897,23,25-29,1920,91
STAT,1889,23,25-29,1912,71.91478732980735
STAT,1912,44,30-34,1956,0.12481108247035236
SIM,1820,39,45-49,1859,3
STAT,1898,46,na,1944,3113.164194021618
STAT,1911,53,na,1964,3472.2044182207446
STAT,1938,28,15-19,1966,0.7131012902933895
SIM,1884,20,40-44,1904,2
STAT,1938,20,40-44,1958,3.396935457533282
SIM,1878,38,na,1916,2608
STAT,1925,25,30-34,1950,47.536503284764855
SIM,1938,18,15-19,1956,39
STAT,1842,47,30-34,1889,0.07592369009808997
SIM,1912,34,30-34,1946,23
STAT,1920,17,25-29,1937,49.61606905973934
SIM,1806,92,na,1898,15
SIM,1856,22,30-34,1878,27
SIM,1924,47,25-29,1971,1
SIM,1908,1,na,1909,4296
STAT,1834,37,30-34,1871,4.461224204473698
SIM,1934,26,30-34,1960,5
SIM,1875,18,20-24,1893,19
STAT,1872,32,na,1904,2439.8351774333196
STAT,1875,20,50-100,1895,0.42950839504270255
STAT,1928,38,35-39,1966,3.114834692529042
STAT,1849,69,na,1918,1139.342773634466
SIM,1952,12,na,1964,4885
STAT,1880,75,na,1955,1103.613831460369
STAT,1919,44,40-44,1963,0.2756836267801949
SIM,1861,37,40-44,1898,2
STAT,1831,49,20-24,1880,0.00956484217053605
STAT,1830,44,35-39,1874,1.5180353527556714
SIM,1920,26,35-39,1946,25
STAT,1914,23,35-39,1937,9.784639089327314
SIM,1931,28,50-100,1959,6
SIM,1896,43,30-34,1939,1
SIM,1941,19,25-29,1960,53
STAT,1849,50,50-100,1899,0.011893674487026626
SIM,1911,34,50-100,1945,1
STAT,1802,82,na,1884,155.03829629699516
STAT,1843,32,45-49,1875,1.6923745059040303
SIM,1855,10,na,1865,2220
STAT,1829,29,40-44,1858,3.0777522584950407
SIM,1923,39,30-34,1962,6
STAT,1888,43,30-34,1931,1.376507180778708
STAT,1903,21,30-34,1924,25.908728700583772
SIM,1868,20,20-24,1888,76
SIM,1922,34,45-49,1956,5
SIM,1918,34,25-29,1952,13
STAT,1830,105,na,1935,0.01854802616602485
STAT,1902,17,na,1919,3633.4518976524746
SIM,1851,32,45-49,1883,3
SIM,1833,93,na,1926,13
STAT,1849,20,45-49,1869,0.6640375066294555
STAT,1924,25,15-19,1949,0.8443014669508357
STAT,1870,46,30-34,1916,0.09680911009698584
SIM,1847,32,25-29,1879,9
STAT,1813,45,na,1858,1359.3240624214275
STAT,1843,21,35-39,1864,5.955812939400143
STAT,1926,45,40-44,1971,0.19939242246690952
SIM,1837,29,40-44,1866,6
STAT,1893,19,50-100,1912,0.06306265107626002
SIM,1765,93,na,1858,4
STAT,1912,26,35-39,1938,15.144794376615584
STAT,1839,32,25-29,1871,8.699073102573175
STAT,1882,87,na,1969,425.2737191415557
SIM,1897,22,40-44,1919,7
STAT,1823,52,na,1875,1341.9312136746441
SIM,1934,29,35-39,1963,4
STAT,1855,31,25-29,1886,8.1689939193624
SIM,1810,46,na,1856,1630
SIM,1851,21,35-39,1872,11
SIM,1893,39,50-100,1932,2
STAT,1917,48,30-34,1965,0.09475724328570974
SIM,1929,40,35-39,1969,2
STAT,1853,37,40-44,1890,3.670530358309432
STAT,1866,43,50-100,1909,0.9869086438762414
SIM,1809,89,na,1898,10
SIM,1862,32,20-24,1894,4
STAT,1856,18,45-49,1874,0.06148942090222639
SIM,1908,53,na,1961,3509
SIM,1856,20,50-100,1876,4
STAT,1921,9,na,1930,4630.406535579609
STAT,1869,97,na,1966,21.790240684941665
STAT,1890,82,na,1972,1061.16668721704
STAT,1832,31,30-34,1863,15.483522569383567
STAT,1889,22,40-44,1911,2.6258984320988574
SIM,1902,22,25-29,1924,100
SIM,1922,22,45-49,1944,3
STAT,1910,19,30-34,1929,2.4500606391886195
STAT,1855,20,15-19,1875,3.0310446996893528
STAT,1831,38,50-100,1869,1.0670974319894593
STAT,1901,44,25-29,1945,0.06275633630454587
STAT,1933,19,25-29,1952,58.84288224721523
STAT,1884,31,50-100,1915,0.9285298226998057
STAT,1914,34,45-49,1948,1.6022637559169364
SIM,1820,67,na,1887,1041
STAT,1919,45,30-34,1964,0.09913447560815478
STAT,1938,31,na,1969,3881.527936476877
STAT,1854,50,30-34,1904,0.004621280163208892
SIM,1896,31,50-100,1927,4
STAT,1854,32,20-24,1886,2.118574555409024
SIM,1780,85,na,1865,91
STAT,1844,14,na,1858,2330.233376878102
STAT,1812,44,50-100,1856,2.6533943838627225
STAT,1894,38,40-44,1932,5.715747481066236
SIM,1913,29,na,1942,3866
STAT,1797,73,na,1870,516.7221625179737
STAT,1901,62,na,1963,2792.0875171420976
STAT,1785,85,na,1870,88.40971611919609
STAT,1884,48,25-29,1932,0.05740421378545079
STAT,1838,29,na,1867,1992.9475110415194
STAT,1844,15,50-100,1859,0.048832774009343514
STAT,1881,4,na,1885,2799.657059694264
STAT,1956,16,20-24,1972,183.0177699976627
STAT,1899,44,45-49,1943,0.1432269833107009
STAT,1914,22,45-49,1936,1.1728578248479145
SIM,1861,23,15-19,1884,2
STAT,1847,54,na,1901,1632.894919118066
STAT,1907,29,25-29,1936,62.380368923423724
STAT,1865,48,15-19,1913,3.65707223607212E-4
STAT,1825,105,na,1930,0.01758251638039888
SIM,1915,29,25-29,1944,100
STAT,1911,29,45-49,1940,1.7062649074316394
STAT,1819,47,na,1866,1589.366136750289
STAT,1835,27,15-19,1862,0.4407492141221165
STAT,1857,15,35-39,1872,0.5199285478759802
STAT,1899,33,35-39,1932,14.087503148864052
STAT,1911,18,35-39,1929,0.8542673462635673
STAT,1848,28,na,1876,1993.0770443301014
STAT,1881,39,50-100,1920,1.1987078255178685
STAT,1884,8,na,1892,2623.6768201166365
STAT,1853,23,15-19,1876,3.244946823671815
SIM,1814,90,na,1904,63
SIM,1902,24,20-24,1926,90
STAT,1880,72,na,1952,1353.8607359819757
STAT,1852,34,50-100,1886,0.7485366214395902
STAT,1884,86,na,1970,517.4758111216568
STAT,1867,18,20-24,1885,17.255574905820684
STAT,1940,24,45-49,1964,1.1685298795743968
STAT,1944,17,50-100,1961,0.4113551245589383
SIM,1843,92,na,1935,41
SIM,1930,29,20-24,1959,27
STAT,1847,65,na,1912,1317.8547617128118
STAT,1838,18,na,1856,2214.663062535871
STAT,1845,17,30-34,1862,1.5740326676013154
STAT,1901,51,na,1952,3086.445512300582
STAT,1922,29,20-24,1951,20.925312029437
STAT,1768,92,na,1860,14.469014273960006
STAT,1910,17,35-39,1927,0.8480111937156001
STAT,1834,54,20-24,1888,4.894037748722304E-4
STAT,1827,47,40-44,1874,0.1922715407039922
STAT,1865,22,25-29,1887,53.648180727950944
STAT,1851,70,na,1921,1157.5606053961299
STAT,1910,23,20-24,1933,106.17280898886855
STAT,1884,65,na,1949,1705.6497835761104
SIM,1784,75,na,1859,443
SIM,1873,22,25-29,1895,66
SIM,1859,19,20-24,1878,1
STAT,1841,50,45-49,1891,0.010869262676776676
STAT,1930,23,40-44,1953,4.379604680419367
STAT,1950,15,15-19,1965,54.7742832037136
STAT,1888,79,na,1967,1233.7385675865805
STAT,1920,33,25-29,1953,10.28776623751341
SIM,1846,15,25-29,1861,4
SIM,1901,26,25-29,1927,76
STAT,1859,98,na,1957,3.613244827804599
SIM,1881,58,na,1939,1769
STAT,1894,24,15-19,1918,4.30193886747786
STAT,1925,22,20-24,1947,135.79400536416952
SIM,1892,22,35-39,1914,13
SIM,1876,39,50-100,1915,4
SIM,1901,15,15-19,1916,8
SIM,1937,34,35-39,1971,15
STAT,1861,17,15-19,1878,5.749953644605174
STAT,1860,48,50-100,1908,0.2007323174923538
STAT,1906,28,25-29,1934,62.589989666814155
SIM,1928,24,40-44,1952,4
STAT,1802,90,na,1892,25.01654561328225
STAT,1936,24,25-29,1960,90.00947840089559
STAT,1918,44,30-34,1962,0.13824978877672472
SIM,1934,35,20-24,1969,1
STAT,1853,101,na,1954,0.47846713236832483
STAT,1768,105,na,1873,0.027584591980595992
STAT,1783,81,na,1864,208.98124602656011
STAT,1871,54,50-100,1925,0.0148420136648829
STAT,1913,38,45-49,1951,0.6829203912982947
SIM,1892,33,45-49,1925,1
STAT,1851,37,50-100,1888,1.0237561982567223
STAT,1826,92,na,1918,24.29163253757882
STAT,1829,46,50-100,1875,0.20133985885431666
SIM,1958,8,na,1966,5142
STAT,1951,16,15-19,1967,55.14711522596315
STAT,1813,42,na,1855,1383.9587634081327
STAT,1942,22,20-24,1964,118.94676710060388
STAT,1873,32,30-34,1905,18.05770543238628
SIM,1868,79,na,1947,651
SIM,1926,32,30-34,1958,30
STAT,1868,48,40-44,1916,0.16471569550853687
STAT,1924,23,50-100,1947,0.7897018988958358
SIM,1820,75,na,1895,640
SIM,1949,16,25-29,1965,64
STAT,1900,29,15-19,1929,0.6369275774246028
SIM,1809,60,na,1869,789
SIM,1944,24,25-29,1968,110
SIM,1872,84,na,1956,177
STAT,1858,43,45-49,1901,1.2020468819576684
STAT,1860,21,50-100,1881,0.3504656085513635
STAT,1941,29,30-34,1970,41.31135055898944
STAT,1823,44,na,1867,1494.6053203298516
SIM,1841,29,na,1870,1935
SIM,1907,38,35-39,1945,3
STAT,1879,20,30-34,1899,19.10754752050546
STAT,1941,25,45-49,1966,1.8248637338018843
SIM,1887,16,25-29,1903,10
SIM,1933,22,20-24,1955,4
STAT,1935,32,30-34,1967,22.228737948041775
STAT,1843,18,50-100,1861,0.05024425846249629
SIM,1881,32,30-34,1913,16
SIM,1858,40,50-100,1898,3
STAT,1913,17,50-100,1930,0.07814584915513186
SIM,1946,16,na,1962,4045
STAT,1879,17,30-34,1896,1.6996306538732036
SIM,1933,20,na,1953,4667
STAT,1891,48,50-100,1939,0.17277572795598736
STAT,1926,35,20-24,1961,0.3292288398901212
SIM,1814,41,30-34,1855,1
SIM,1844,66,na,1910,1269
SIM,1914,17,15-19,1931,7
STAT,1847,102,na,1949,0.22862167178441767
STAT,1855,19,40-44,1874,0.1666597314950131
STAT,1906,17,15-19,1923,8.811892452705377
SIM,1914,28,25-29,1942,68
SIM,1870,18,na,1888,2752
SIM,1876,90,na,1966,226
STAT,1929,34,35-39,1963,11.82396626575889
SIM,1850,20,35-39,1870,7
SIM,1868,68,na,1936,1526
STAT,1882,22,30-34,1904,17.70321543731083
SIM,1858,37,50-100,1895,2
SIM,1869,21,20-24,1890,103
SIM,1927,23,40-44,1950,5
STAT,1892,45,50-100,1937,0.17889641248736807
STAT,1926,29,35-39,1955,18.229322469933024
STAT,1842,44,50-100,1886,0.835462634564057
STAT,1902,37,30-34,1939,1.654935123524798
STAT,1925,42,15-19,1967,0.0018968838342785066
SIM,1917,33,25-29,1950,14
SIM,1880,19,40-44,1899,1
SIM,1849,28,20-24,1877,12
SIM,1895,61,na,1956,2555
SIM,1937,33,45-49,1970,1
STAT,1892,34,15-19,1926,0.18051815335455998
STAT,1916,28,na,1944,3938.8098365492365
SIM,1855,29,na,1884,1906
STAT,1911,34,40-44,1945,3.8537269080563354
SIM,1929,23,na,1952,5211
STAT,1912,46,na,1958,3610.6896641586304
STAT,1872,19,40-44,1891,0.18600263800928357
SIM,1891,21,35-39,1912,9
STAT,1879,5,na,1884,2891.876646524778
STAT,1884,33,45-49,1917,1.7525821799187586
SIM,1840,31,30-34,1871,16
STAT,1871,19,50-100,1890,0.04924200154862565
SIM,1899,19,20-24,1918,40
STAT,1909,22,15-19,1931,5.0457224339335545
STAT,1925,34,20-24,1959,2.951328641939344
STAT,1795,63,na,1858,768.808882043413
SIM,1824,30,35-39,1854,14
SIM,1902,4,na,1906,3857
SIM,1933,34,20-24,1967,8
SIM,1944,12,na,1956,4264
STAT,1817,42,45-49,1859,3.762981476108461
STAT,1956,2,na,1958,5310.802741292876
STAT,1874,36,na,1910,2465.7066817412797
STAT,1824,93,na,1917,16.091949271780713
STAT,1828,49,50-100,1877,0.18709344168532793
STAT,1885,28,na,1913,2420.40283211638
SIM,1890,22,30-34,1912,32
SIM,1874,5,na,1879,2805
STAT,1919,23,40-44,1942,3.745591516284107
STAT,1847,45,35-39,1892,0.11026223823481768
STAT,1884,22,35-39,1906,5.889648574773382
SIM,1907,19,30-34,1926,3
SIM,1938,26,20-24,1964,23
STAT,1922,0,na,1922,5320.005492268905
SIM,1851,36,na,1887,1886
STAT,1905,49,15-19,1954,3.254943368113218E-4
STAT,1862,54,na,1916,1818.392327082214
SIM,1875,33,45-49,1908,4
SIM,1825,42,45-49,1867,3
STAT,1909,35,20-24,1944,0.2568896390075602
SIM,1839,25,35-39,1864,2
STAT,1824,106,na,1930,0.006685400360494381
SIM,1933,28,35-39,1961,23
STAT,1867,33,45-49,1900,1.663065928737464
STAT,1851,62,na,1913,1507.9099569162051
SIM,1868,28,30-34,1896,39
SIM,1883,36,na,1919,2456
SIM,1898,1,na,1899,4122
STAT,1837,55,na,1892,1378.5995380675831
STAT,1912,40,15-19,1952,0.0015280532149804895
SIM,1918,31,na,1949,4248
STAT,1863,95,na,1958,17.97280178298449
STAT,1897,49,50-100,1946,0.1850264720349218
STAT,1940,26,50-100,1966,1.0359232247936805
STAT,1792,66,na,1858,678.8171177555514
STAT,1827,33,15-19,1860,0.20926851072770142
STAT,1898,16,35-39,1914,0.7588321668531175
STAT,1965,4,na,1969,5007.0884269875905
STAT,1846,91,na,1937,41.43974501785799
STAT,1916,32,20-24,1948,2.5698359731327427
STAT,1944,22,30-34,1966,31.66087033538641
SIM,1823,31,30-34,1854,17
STAT,1870,49,35-39,1919,0.1367016860522146
SIM,1924,32,20-24,1956,1
STAT,1915,39,30-34,1954,1.8599033863450227
STAT,1887,34,50-100,1921,1.0384235405048206
STAT,1883,21,35-39,1904,5.858748689746101
SIM,1825,31,35-39,1856,15
STAT,1915,39,50-100,1954,0.42845475128085236
SIM,1893,46,na,1939,3021
STAT,1813,74,na,1887,493.9676481448232
SIM,1906,39,30-34,1945,8
STAT,1848,25,35-39,1873,9.08407686933476
SIM,1905,34,45-49,1939,2
STAT,1888,46,35-39,1934,0.16932220463436123
SIM,1872,21,25-29,1893,69
SIM,1892,21,na,1913,3454
SIM,1929,28,15-19,1957,2
SIM,1866,69,na,1935,1618
STAT,1803,67,na,1870,867.5238211779746
STAT,1814,49,20-24,1863,0.03464116275427245
SIM,1788,70,na,1858,719
STAT,1813,44,35-39,1857,5.529733702570711
SIM,1920,42,35-39,1962,1
SIM,1903,27,40-44,1930,4
STAT,1876,28,50-100,1904,0.6714987339230973
SIM,1821,44,35-39,1865,3
STAT,1858,17,na,1875,2169.2582753534957
STAT,1833,35,50-100,1868,1.0385267101670366
STAT,1867,40,50-100,1907,1.0220068737448513
STAT,1816,93,na,1909,12.967699095974991
STAT,1928,35,30-34,1963,2.353528634346073
SIM,1875,40,50-100,1915,2
SIM,1830,29,50-100,1859,1
STAT,1901,41,20-24,1942,0.015803933945515117
STAT,1920,19,45-49,1939,0.5688758304604579
STAT,1929,33,45-49,1962,2.0373836485403727
SIM,1886,20,15-19,1906,4
STAT,1907,4,na,1911,3940.472866494898
SIM,1920,23,30-34,1943,57
STAT,1915,15,20-24,1930,29.0898989661942
STAT,1925,28,35-39,1953,18.028100378304433
SIM,1929,39,25-29,1968,2
STAT,1838,31,25-29,1869,9.449159920089235
STAT,1950,15,45-49,1965,0.6029088840926402
SIM,1855,18,na,1873,2113
SIM,1821,38,na,1859,1579
SIM,1938,9,na,1947,3963
SIM,1800,79,na,1879,326
STAT,1880,3,na,1883,3245.835856215012
STAT,1900,69,na,1969,2425.9232750002457
SIM,1868,47,na,1915,2220
STAT,1869,57,na,1926,1979.3025161471514
STAT,1885,18,15-19,1903,6.024234976079061
SIM,1898,23,40-44,1921,5
SIM,1820,36,40-44,1856,8
SIM,1943,23,25-29,1966,137
SIM,1933,26,15-19,1959,2
STAT,1874,87,na,1961,306.5043802848649
STAT,1912,23,30-34,1935,28.011923502439632
STAT,1908,25,30-34,1933,38.34980167734313
STAT,1931,39,15-19,1970,0.02588214837237013
STAT,1792,63,na,1855,759.1592000000002
STAT,1841,19,20-24,1860,16.68425358156209
SIM,1839,22,30-34,1861,24
SIM,1841,35,50-100,1876,3
STAT,1796,77,na,1873,341.31166945290954
STAT,1890,23,50-100,1913,0.5070802736077579
STAT,1855,15,25-29,1870,5.286939515902133
STAT,1944,19,50-100,1963,0.4110795626972577
SIM,1952,19,50-100,1971,1
STAT,1882,48,15-19,1930,3.92555161631035E-4
STAT,1925,26,15-19,1951,0.853613625106714
SIM,1936,35,30-34,1971,2
SIM,1857,84,na,1941,196
SIM,1893,18,15-19,1911,12
STAT,1879,47,50-100,1926,0.26067581164959075
SIM,1900,33,na,1933,3381
STAT,1935,12,na,1947,5523.922886978152
STAT,1935,23,25-29,1958,128.2324217799484
SIM,1893,35,na,1928,3153
SIM,1916,25,30-34,1941,42
SIM,1919,25,50-100,1944,1
SIM,1821,60,na,1881,1118
STAT,1925,37,25-29,1962,1.2056731561025908
STAT,1917,19,40-44,1936,1.522772985703795
STAT,1832,34,35-39,1866,8.687946241921052
STAT,1838,30,50-100,1868,0.8540912588208214
STAT,1922,13,na,1935,4671.694588103956
SIM,1940,18,25-29,1958,66
STAT,1901,54,na,1955,2987.2773096317924
STAT,1902,37,50-100,1939,0.3812374459563614
SIM,1863,15,25-29,1878,6
SIM,1839,36,na,1875,1918
SIM,1954,17,45-49,1971,1
STAT,1880,22,20-24,1902,73.87623414748968
SIM,1917,35,na,1952,3903
STAT,1883,16,na,1899,2534.2533641207824
STAT,1842,20,35-39,1862,5.8557359626375876
SIM,1865,28,na,1893,2261
SIM,1868,17,na,1885,2537
STAT,1868,34,15-19,1902,0.13756940245116905
STAT,1903,10,na,1913,3756.3992166743137
SIM,1923,15,20-24,1938,163
STAT,1932,18,25-29,1950,58.36632538963349
SIM,1867,43,na,1910,2062
SIM,1901,17,35-39,1918,1
STAT,1911,61,na,1972,3268.089377529764
STAT,1822,59,na,1881,1221.336643371509
STAT,1806,54,45-49,1860,0.045217438617124066
STAT,1827,104,na,1931,0.04310952584112636
STAT,1844,47,40-44,1891,0.13204633884680866
STAT,1908,42,15-19,1950,0.0014488186599275522
STAT,1910,44,20-24,1954,0.01681380412514205
STAT,1918,32,30-34,1950,17.084849986621673
SIM,1854,6,na,1860,2588
SIM,1876,19,20-24,1895,35
STAT,1920,30,20-24,1950,2.7483987429130687
SIM,1931,24,45-49,1955,2
STAT,1846,40,na,1886,1716.244470575912
SIM,1780,82,na,1862,192
SIM,1834,59,na,1893,1326
SIM,1925,19,40-44,1944,2
SIM,1896,46,35-39,1942,1
STAT,1864,21,25-29,1885,53.143069784639096
SIM,1892,10,na,1902,3802
STAT,1873,45,45-49,1918,0.246516303301701
SIM,1912,15,45-49,1927,2
STAT,1835,77,na,1912,644.0290984408877
STAT,1925,13,na,1938,4875.749759116856
SIM,1788,81,na,1869,259
SIM,1902,29,45-49,1931,2
STAT,1796,88,na,1884,47.264584397661814
SIM,1862,45,35-39,1907,1
STAT,1923,24,45-49,1947,1.3274076418841771
STAT,1898,32,35-39,1930,13.970818453682284
STAT,1924,25,45-49,1949,2.0661787680405856
STAT,1820,45,35-39,1865,0.2629378173872733
SIM,1867,54,na,1921,1823
STAT,1875,54,50-100,1929,0.01537789973620404
STAT,1839,18,45-49,1857,0.05862643521550887
SIM,1882,15,35-39,1897,2
STAT,1870,23,15-19,1893,3.2798275218404047
STAT,1874,15,35-39,1889,0.576312643110771
SIM,1932,25,45-49,1957,3
SIM,1839,41,35-39,1880,4
SIM,1923,39,na,1962,4238
STAT,1821,54,40-44,1875,0.015308326067056113
SIM,1834,67,na,1901,1147
STAT,1848,95,na,1943,10.33506220241898
STAT,1904,15,45-49,1919,0.0959495362635562
STAT,1951,18,35-39,1969,5.09584876209255
STAT,1946,17,45-49,1963,0.5652922374347965
STAT,1872,28,50-100,1900,0.651738243720861
STAT,1861,69,na,1930,1237.09246672605
SIM,1953,16,45-49,1969,1
SIM,1845,11,na,1856,2367
STAT,1832,44,45-49,1876,1.1982378256688795
SIM,1857,22,40-44,1879,1
SIM,1819,59,na,1878,1152
SIM,1866,32,35-39,1898,16
STAT,1860,44,na,1904,1887.2235685389012
STAT,1868,39,50-100,1907,1.1842325128515658
SIM,1856,45,50-100,1901,2
SIM,1911,9,na,1920,4118
STAT,1884,57,na,1941,2028.2856271890694
STAT,1883,72,na,1955,1264.114150345437
STAT,1926,38,25-29,1964,1.2263361062864555
SIM,1888,8,na,1896,3089
STAT,1913,35,40-44,1948,1.521415077194127
STAT,1871,36,na,1907,2392.2317480292877
STAT,1847,42,30-34,1889,0.901526374759756
STAT,1850,77,na,1927,650.1999483039474
STAT,1952,19,35-39,1971,5.126207919017113
STAT,1895,49,na,1944,2932.583657826468
SIM,1908,21,na,1929,4083
STAT,1894,64,na,1958,2357.279464920516
STAT,1910,15,15-19,1925,9.21425783194788
STAT,1945,16,45-49,1961,0.5569000845165195
STAT,1926,41,25-29,1967,0.08993697510612136
SIM,1902,18,35-39,1920,2
SIM,1845,51,na,1896,1706
STAT,1919,39,50-100,1958,0.4593072217986479
SIM,1928,27,45-49,1955,4
STAT,1869,43,20-24,1912,0.15528637776266002
STAT,1926,38,na,1964,4685.848696573057
STAT,1882,51,45-49,1933,0.014492563231979113
SIM,1946,2,na,1948,4420
STAT,1930,38,45-49,1968,0.9060021459376109
SIM,1970,0,na,1970,5001
SIM,1846,81,na,1927,283
STAT,1884,45,20-24,1929,0.012232137201033746
STAT,1921,17,40-44,1938,1.6269342807701535
STAT,1934,15,30-34,1949,16.891135945895854
STAT,1947,18,15-19,1965,52.14235742001811
SIM,1840,34,35-39,1874,8
STAT,1915,48,20-24,1963,0.011331879854171393
STAT,1879,21,15-19,1900,3.5285517133389424
SIM,1854,25,na,1879,2274
STAT,1839,34,50-100,1873,0.7621760106378606
SIM,1901,23,20-24,1924,111
STAT,1825,47,30-34,1872,0.12450059346901944
STAT,1868,19,20-24,1887,17.380301134735287
STAT,1965,7,na,1972,5004.535239471625
SIM,1908,15,25-29,1923,15
STAT,1904,33,40-44,1937,3.625388664867591
SIM,1818,74,na,1892,488
SIM,1840,44,45-49,1884,2
SIM,1888,33,25-29,1921,19
STAT,1873,94,na,1967,76.75506252463884
STAT,1910,26,25-29,1936,65.04759578505735
SIM,1960,7,na,1967,5242
STAT,1849,80,na,1929,480.2537492872833
STAT,1859,28,50-100,1887,0.5263562482223133
STAT,1851,37,30-34,1888,4.44408100093924
STAT,1902,25,na,1927,3456.653970603073
STAT,1918,47,35-39,1965,0.14001089803869957
STAT,1935,27,40-44,1962,6.479423881267403
SIM,1806,49,na,1855,1467
SIM,1887,21,15-19,1908,4
STAT,1913,24,30-34,1937,29.42276719104496
SIM,1908,61,na,1969,3321
STAT,1849,22,40-44,1871,1.9559530208155331
STAT,1861,46,35-39,1907,0.11835062199131091
SIM,1848,19,15-19,1867,9
SIM,1921,24,30-34,1945,47
STAT,1924,45,30-34,1969,0.10878830347425954
SIM,1943,16,30-34,1959,13
STAT,1926,27,na,1953,4581.284040325841
SIM,1811,49,45-49,1860,1
STAT,1879,32,25-29,1911,10.922252352730709
STAT,1919,40,25-29,1959,0.07918824879392385
SIM,1921,35,40-44,1956,6
SIM,1943,27,40-44,1970,9
SIM,1855,42,30-34,1897,2
STAT,1935,16,30-34,1951,17.034511679477678
SIM,1847,34,50-100,1881,1
SIM,1887,32,25-29,1919,2
STAT,1817,54,20-24,1871,0.001518666874333598
SIM,1824,89,na,1913,36
STAT,1856,39,na,1895,1867.686220479183
SIM,1906,35,45-49,1941,1
STAT,1892,38,30-34,1930,6.780396617331272
SIM,1880,17,na,1897,2525
STAT,1949,15,na,1964,4369.778651997417
SIM,1847,77,na,1924,565
STAT,1919,15,35-39,1934,0.9537894067843715
SIM,1917,26,30-34,1943,4
STAT,1895,48,50-100,1943,0.18207977869496358
STAT,1852,50,20-24,1902,6.030118368880189E-4
STAT,1857,54,20-24,1911,5.717470593450828E-4
SIM,1932,35,na,1967,5300
STAT,1919,48,35-39,1967,0.14230793974500427
SIM,1806,60,na,1866,1130
SIM,1846,31,25-29,1877,17
SIM,1858,69,na,1927,1124
STAT,1841,47,15-19,1888,2.9667971477673167E-4
STAT,1919,26,45-49,1945,1.9114178718702675
STAT,1802,109,na,1911,2.2575009670786387E-4
STAT,1838,20,15-19,1858,3.1904971041054675
SIM,1932,25,15-19,1957,1
SIM,1921,43,35-39,1964,2
STAT,1848,21,40-44,1869,1.9865523432341947
SIM,1904,22,35-39,1926,12
STAT,1902,33,15-19,1935,0.20400959042477965
SIM,1865,31,35-39,1896,16
SIM,1907,47,25-29,1954,1
STAT,1871,50,30-34,1921,0.006101638799553503
SIM,1856,21,40-44,1877,4
SIM,1869,24,25-29,1893,60
STAT,1911,21,na,1932,3702.884982312428
STAT,1915,35,na,1950,3915.12781313245
STAT,1912,42,35-39,1954,0.19812017639595453
STAT,1853,104,na,1957,0.08319434521425756
STAT,1914,50,na,1964,3683.9342901821915
STAT,1864,80,na,1944,561.117753362206
SIM,1814,44,35-39,1858,4
SIM,1823,37,50-100,1860,3
SIM,1882,43,na,1925,2190
STAT,1841,49,50-100,1890,0.17755318595855893
SIM,1927,15,35-39,1942,8
STAT,1824,37,na,1861,1580.7180811933865
STAT,1873,35,35-39,1908,7.3846390961169845
STAT,1909,26,30-34,1935,38.646858830234606
STAT,1895,33,20-24,1928,3.5826180568677146
STAT,1857,31,35-39,1888,8.202974169645215
STAT,1913,43,35-39,1956,0.20001216437130723
SIM,1866,80,na,1946,787
SIM,1888,13,na,1901,3063
SIM,1867,3,na,1870,2855
STAT,1935,35,35-39,1970,3.4551249838989806
SIM,1892,50,na,1942,3189
SIM,1927,26,45-49,1953,6
SIM,1943,27,na,1970,3636
SIM,1911,21,30-34,1932,38
SIM,1886,20,45-49,1906,1
SIM,1846,20,15-19,1866,3
SIM,1905,23,35-39,1928,10
SIM,1955,4,na,1959,5095
SIM,1868,23,25-29,1891,60
STAT,1868,44,25-29,1912,0.6172511144995463
STAT,1909,37,40-44,1946,1.4451026171332624
SIM,1947,12,na,1959,4672
STAT,1875,72,na,1947,1322.2644217175796
STAT,1813,41,50-100,1854,4.008404900623161
STAT,1828,42,20-24,1870,0.12985339090161582
STAT,1858,32,35-39,1890,8.192874075045156
STAT,1880,35,35-39,1915,7.654392056696163
SIM,1881,35,35-39,1916,11
STAT,1860,84,na,1944,275.3500666649839
SIM,1918,38,40-44,1956,4
SIM,1876,44,25-29,1920,1
STAT,1836,70,na,1906,873.3219064840499
STAT,1804,60,na,1864,998.1512308540002
STAT,1897,22,50-100,1919,0.5562410380912108
SIM,1895,31,15-19,1926,1
STAT,1879,36,40-44,1915,4.690439221547926
SIM,1837,53,na,1890,1327
SIM,1905,20,30-34,1925,34
SIM,1890,22,25-29,1912,116
STAT,1820,42,30-34,1862,2.286075814881628
STAT,1863,29,40-44,1892,2.6602372083330366
SIM,1884,55,na,1939,2143
STAT,1892,39,20-24,1931,0.9756586033366835
STAT,1902,44,40-44,1946,0.221675128719649
SIM,1901,35,30-34,1936,1
STAT,1822,50,40-44,1872,0.01501617367933833
STAT,1903,34,50-100,1937,0.7564115382642015
SIM,1818,37,30-34,1855,5
SIM,1919,20,15-19,1939,4
STAT,1936,27,35-39,1963,14.654780566664321
STAT,1879,20,25-29,1899,61.40836839839682
STAT,1942,14,na,1956,4186.61482679437
SIM,1833,63,na,1896,1161
SIM,1797,61,na,1858,918
SIM,1827,37,40-44,1864,8
SIM,1924,8,na,1932,4940
STAT,1805,53,45-49,1858,0.05012592098966641
SIM,1928,20,25-29,1948,185
STAT,1837,26,35-39,1863,8.316878156071777
STAT,1855,20,na,1875,1964.4479137245733
STAT,1877,28,30-34,1905,26.55082561922695
SIM,1793,71,na,1864,528
SIM,1829,58,na,1887,1062
STAT,1856,20,30-34,1876,16.80694414057783
STAT,1931,18,45-49,1949,0.6650869412758037
STAT,1869,2,na,1871,3286.2438875826747
SIM,1936,6,na,1942,3498
STAT,1851,30,na,1881,2092.1137281627925
STAT,1868,72,na,1940,1230.5235620965327
SIM,1789,66,na,1855,831
SIM,1888,45,na,1933,2665
STAT,1888,43,50-100,1931,1.2648984876696059
STAT,1900,25,20-24,1925,16.700218783786344
STAT,1930,20,15-19,1950,6.996649370546001
STAT,1875,15,15-19,1890,6.242406896585132
STAT,1854,45,35-39,1899,0.10821788259014166
STAT,1894,47,30-34,1941,0.07131735157702512
SIM,1823,31,25-29,1854,11
SIM,1808,64,na,1872,1023
STAT,1871,24,15-19,1895,3.3128752138880766
SIM,1885,28,30-34,1913,34
SIM,1924,35,25-29,1959,3
SIM,1918,17,40-44,1935,2
STAT,1843,37,15-19,1880,0.052921168217568176
STAT,1916,28,20-24,1944,19.192701464725285
SIM,1905,64,na,1969,2903
STAT,1872,44,45-49,1916,1.5095543436966703
STAT,1916,35,25-29,1951,1.038717803373992
SIM,1871,35,35-39,1906,2
STAT,1848,48,15-19,1896,3.0702609950928044E-4
STAT,1914,27,15-19,1941,0.7261112124330964
STAT,1848,20,50-100,1868,0.39156929291716
SIM,1861,60,na,1921,1960
STAT,1814,48,45-49,1862,0.6923795592988053
SIM,1887,36,40-44,1923,10
SIM,1924,15,15-19,1939,59
STAT,1856,45,45-49,1901,0.19087377147852944
STAT,1887,31,15-19,1918,0.16345623355535419
STAT,1787,106,na,1893,0.005522804031854536
SIM,1916,29,40-44,1945,7
STAT,1847,42,25-29,1889,0.503555274448626
STAT,1867,21,45-49,1888,0.6754479461622672
SIM,1859,56,na,1915,1891
STAT,1909,38,30-34,1947,1.7506752751042414
SIM,1924,28,20-24,1952,19
STAT,1831,45,40-44,1876,0.14366691921236427
STAT,1825,48,20-24,1873,0.015223968902588541
STAT,1917,13,na,1930,4330.238414746835
STAT,1843,17,20-24,1860,18.2894508501398
STAT,1917,15,na,1932,4261.106295040596
SIM,1885,40,45-49,1925,4
SIM,1949,16,30-34,1965,16
STAT,1848,32,50-100,1880,0.8305845188335974
SIM,1831,62,na,1893,1157
SIM,1917,38,30-34,1955,6
SIM,1950,18,20-24,1968,169
SIM,1875,21,45-49,1896,2
STAT,1908,29,40-44,1937,4.46098453096343
SIM,1892,72,na,1964,2145
SIM,1869,22,50-100,1891,1
STAT,1845,34,15-19,1879,0.12958107238806083
STAT,1885,42,na,1927,2349.434713223026
STAT,1840,78,na,1918,562.2454114201859
STAT,1786,89,na,1875,31.234098799167548
STAT,1927,34,30-34,1961,19.74429998417037
SIM,1871,100,na,1971,4
SIM,1910,28,35-39,1938,16
STAT,1942,18,20-24,1960,144.50337781439916
STAT,1920,37,40-44,1957,1.6726239751379695
STAT,1946,26,na,1972,4259.470112721962
SIM,1889,42,50-100,1931,1
SIM,1912,36,45-49,1948,1
SIM,1951,17,25-29,1968,62
SIM,1880,44,45-49,1924,5
STAT,1934,19,40-44,1953,1.9190162723936324
STAT,1844,16,25-29,1860,5.615056697523251
SIM,1919,33,35-39,1952,16
STAT,1848,9,na,1857,2347.687077108859
STAT,1905,28,45-49,1933,1.6301008431604833
STAT,1941,29,25-29,1970,69.39622683373115
STAT,1872,24,na,1896,2402.9581228027128
SIM,1905,42,na,1947,3361
STAT,1792,95,na,1887,2.3487225632007087
STAT,1880,25,25-29,1905,45.656034099508446
STAT,1910,47,25-29,1957,0.05047707051938669
STAT,1852,17,30-34,1869,1.5529781660482787
STAT,1874,25,na,1899,2502.5754522228995
SIM,1892,18,20-24,1910,28
STAT,1919,41,15-19,1960,0.0017007082517159048
STAT,1863,16,35-39,1879,0.5633601248586669
STAT,1889,49,15-19,1938,2.783935445511048E-4
STAT,1894,34,25-29,1928,13.325459451351193
SIM,1930,31,na,1961,5432
STAT,1929,31,30-34,1960,20.423451385827715
STAT,1899,49,15-19,1948,3.0862144357432454E-4
SIM,1889,33,40-44,1922,9
STAT,1875,34,15-19,1909,0.14782579706820612
STAT,1902,28,35-39,1930,13.83252501358012
STAT,1826,47,25-29,1873,0.04500894831749517
STAT,1943,17,25-29,1960,46.884419829601725
STAT,1866,49,20-24,1915,0.011055881744740918
SIM,1879,43,25-29,1922,2
SIM,1835,43,25-29,1878,1
STAT,1821,38,35-39,1859,14.552809879997351
STAT,1843,44,20-24,1887,0.1286626494718546
STAT,1831,43,45-49,1874,1.2515686039819394
STAT,1851,31,35-39,1882,8.786831194503028
STAT,1920,17,30-34,1937,13.955413104919899
SIM,1896,9,na,1905,3558
STAT,1837,39,40-44,1876,3.4804734444348284
SIM,1865,19,15-19,1884,6
STAT,1885,50,na,1935,2222.9404528939126
STAT,1876,54,30-34,1930,0.006098153442696057
SIM,1888,67,na,1955,1745
STAT,1827,43,25-29,1870,0.7467243187420376
SIM,1860,17,30-34,1877,3
STAT,1924,22,40-44,1946,4.047884372479737
STAT,1869,17,40-44,1886,0.18263729480302326
STAT,1890,15,40-44,1905,0.22920170620941366
STAT,1820,39,30-34,1859,11.56270497100852
SIM,1806,63,na,1869,1053
STAT,1868,70,na,1938,1367.1096950760157
STAT,1882,22,25-29,1904,56.895086836440406
SIM,1942,19,40-44,1961,2
SIM,1913,28,45-49,1941,2
SIM,1831,24,40-44,1855,3
STAT,1844,68,na,1912,1184.2176782834158
SIM,1937,31,30-34,1968,25
STAT,1842,87,na,1929,138.1617821116004
SIM,1890,35,45-49,1925,6
STAT,1877,37,50-100,1914,1.2990573855033904
STAT,1817,80,na,1897,301.89511408882225
STAT,1857,19,15-19,1876,5.491956478984225
STAT,1872,46,40-44,1918,0.17553692718352887
STAT,1884,18,20-24,1902,17.846218591485066
STAT,1886,28,40-44,1914,3.2232601947099386
SIM,1781,78,na,1859,248
STAT,1922,25,40-44,1947,5.418141780336096
SIM,1804,82,na,1886,225
SIM,1823,44,45-49,1867,2
SIM,1930,25,40-44,1955,9
SIM,1889,20,35-39,1909,12
STAT,1895,46,35-39,1941,0.10541057572580785
STAT,1942,25,25-29,1967,70.54177249060945
STAT,1878,15,na,1893,2694.303464727021
SIM,1844,80,na,1924,364
STAT,1909,15,50-100,1924,0.0752792170892695
SIM,1895,15,na,1910,3519
STAT,1819,37,40-44,1856,12.40930495610458
SIM,1875,94,na,1969,95
STAT,1877,55,na,1932,2187.8187017185505
SIM,1821,34,25-29,1855,11
SIM,1861,33,25-29,1894,14
SIM,1842,22,na,1864,1986
SIM,1884,38,25-29,1922,7
SIM,1849,38,30-34,1887,12
SIM,1942,24,20-24,1966,5
SIM,1891,25,na,1916,3214
STAT,1849,38,20-24,1887,0.6060535475454334
SIM,1884,23,na,1907,2554
SIM,1826,83,na,1909,192
STAT,1888,40,20-24,1928,0.19346434896876535
STAT,1869,46,25-29,1915,0.05689179424583634
SIM,1839,34,na,1873,1961
STAT,1846,54,45-49,1900,0.010092751052897664
SIM,1870,17,30-34,1887,1
STAT,1908,30,na,1938,3669.617525310196
STAT,1835,43,50-100,1878,0.9315238314968409
SIM,1851,41,50-100,1892,3
SIM,1923,19,15-19,1942,49
STAT,1864,28,45-49,1892,1.0035912032251217
SIM,1833,21,40-44,1854,1
STAT,1915,19,15-19,1934,9.640706900548626
SIM,1842,31,35-39,1873,9
STAT,1886,35,15-19,1921,0.06121224633224378
STAT,1899,29,20-24,1928,16.271350427482123
STAT,1819,61,na,1880,1210.169807077802
STAT,1897,53,na,1950,2889.922032836899
STAT,1951,6,na,1957,4775.592207763113
STAT,1819,44,15-19,1863,0.028122003762027455
STAT,1917,47,na,1964,3915.934115177713
SIM,1886,24,30-34,1910,37
SIM,1795,80,na,1875,238
SIM,1925,24,20-24,1949,166
STAT,1938,17,na,1955,3703.806763071576
STAT,1894,1,na,1895,3571.6827633467265
STAT,1850,6,na,1856,2293.1398329
STAT,1915,39,25-29,1954,1.0047753871075977
SIM,1904,17,na,1921,3948
SIM,1932,22,40-44,1954,9
STAT,1859,20,40-44,1879,1.9637375263961525
STAT,1878,21,20-24,1899,73.39642873413698
SIM,1888,24,35-39,1912,7
STAT,1838,35,40-44,1873,3.962496914592635
SIM,1906,39,25-29,1945,1
SIM,1855,72,na,1927,1025
STAT,1917,24,20-24,1941,119.84604160821834
STAT,1928,40,50-100,1968,0.1531873178106964
STAT,1934,24,20-24,1958,152.28775305984885
STAT,1904,16,35-39,1920,0.8042192257084908
SIM,1901,23,50-100,1924,2
STAT,1859,27,25-29,1886,35.05847632351903
STAT,1878,24,30-34,1902,18.795766850747228
STAT,1860,23,15-19,1883,2.794698185390058
STAT,1871,29,35-39,1900,9.680791343838402
SIM,1912,16,35-39,1928,1
STAT,1904,40,na,1944,3425.0698109027617
STAT,1908,49,35-39,1957,0.1182025764045414
SIM,1923,39,25-29,1962,3
STAT,1904,36,45-49,1940,0.6321205598745326
STAT,1770,112,na,1882,4.800163359282576E-4
SIM,1851,18,50-100,1869,2
SIM,1852,16,25-29,1868,7
STAT,1827,88,na,1915,88.72903816449023
SIM,1902,27,30-34,1929,52
STAT,1855,46,40-44,1901,0.13309074460452647
STAT,1925,21,45-49,1946,1.3782402537716725
SIM,1935,34,30-34,1969,31
STAT,1858,38,30-34,1896,4.290283423759898
STAT,1826,63,na,1889,1052.3991558942926
STAT,1834,31,35-39,1865,8.820726859386664
STAT,1841,38,na,1879,1843.9623941156833
STAT,1917,44,15-19,1961,0.0016300185243000927
SIM,1867,27,25-29,1894,42
STAT,1767,96,na,1863,1.0043982426150753
STAT,1867,48,25-29,1915,0.05447219149345112
SIM,1862,20,na,1882,2239
STAT,1853,33,25-29,1886,8.752922342736086
SIM,1847,23,35-39,1870,7
SIM,1867,20,40-44,1887,1
SIM,1867,51,na,1918,1919
SIM,1833,41,35-39,1874,8
STAT,1868,27,na,1895,2325.3503248548245
SIM,1897,25,45-49,1922,1
SIM,1916,21,45-49,1937,1
SIM,1846,35,40-44,1881,3
STAT,1877,25,50-100,1902,0.6814415071596664
SIM,1845,39,50-100,1884,1
STAT,1813,49,40-44,1862,0.41607624720956193
STAT,1943,3,na,1946,4350.471540196089
STAT,1826,49,na,1875,1452.5049071081476
STAT,1830,49,40-44,1879,0.13844156985313794
SIM,1816,41,35-39,1857,3
STAT,1858,94,na,1952,16.16889016937662
STAT,1892,32,35-39,1924,12.948080622602268
STAT,1881,39,45-49,1920,1.9463426584610837
STAT,1918,23,25-29,1941,101.34872925606143
SIM,1905,10,na,1915,3761
SIM,1876,26,na,1902,2798
SIM,1884,77,na,1961,908
SIM,1921,20,15-19,1941,6
STAT,1895,36,25-29,1931,3.850687753503679
STAT,1897,75,na,1972,1885.4972688484836
STAT,1935,31,50-100,1966,1.167189682055411
SIM,1883,32,35-39,1915,19
STAT,1875,32,35-39,1907,10.603146015903032
STAT,1909,18,na,1927,3852.690799187851
SIM,1916,34,20-24,1950,1
STAT,1837,26,50-100,1863,0.5513818125068879
STAT,1840,38,45-49,1878,1.679146479841625
STAT,1831,93,na,1924,19.69268951512811
STAT,1937,23,35-39,1960,9.349780908934584
STAT,1908,21,45-49,1929,1.0579873715984294
SIM,1813,43,na,1856,1460
SIM,1868,38,40-44,1906,7
STAT,1829,102,na,1931,0.19498594823340717
STAT,1889,24,na,1913,2961.643732325653
STAT,1809,102,na,1911,0.1495752816530553
STAT,1839,99,na,1938,1.3070425494609688
STAT,1850,103,na,1953,0.10795269183876892
STAT,1899,16,15-19,1915,8.31074894151481
SIM,1821,52,na,1873,1281
STAT,1825,41,35-39,1866,2.524712846483747
SIM,1926,23,25-29,1949,141
STAT,1867,28,30-34,1895,24.03261027014159
STAT,1889,25,45-49,1914,1.4086336407662703
SIM,1906,32,40-44,1938,6
STAT,1839,23,35-39,1862,5.137482950027239
STAT,1853,46,30-34,1899,0.08139712019308097
SIM,1854,33,na,1887,2129
STAT,1776,79,na,1855,251.95089000000002
STAT,1834,33,15-19,1867,0.12148843486458821
STAT,1896,34,na,1930,3187.677123983863
SIM,1925,39,35-39,1964,1
STAT,1914,20,30-34,1934,28.920513341358628
SIM,1857,25,15-19,1882,3
SIM,1880,20,15-19,1900,4
STAT,1834,50,na,1884,1543.574871229787
STAT,1861,43,30-34,1904,0.9621330018260693
STAT,1826,41,na,1867,1602.928820814206
STAT,1839,81,na,1920,373.20583109982846
STAT,1862,39,35-39,1901,6.080307474616213
STAT,1858,2,na,1860,2830.20285661153
STAT,1893,71,na,1964,1982.3060693544223
STAT,1908,34,20-24,1942,2.3276764807738055
SIM,1848,19,na,1867,2233
SIM,1895,34,50-100,1929,2
STAT,1848,50,na,1898,1697.780726187361
SIM,1804,80,na,1884,290
STAT,1917,39,35-39,1956,2.5481834574551234
SIM,1870,39,35-39,1909,15
SIM,1914,25,na,1939,3827
SIM,1845,23,30-34,1868,16
STAT,1891,23,50-100,1914,0.5134469770302934
STAT,1904,30,15-19,1934,0.2098830105317488
STAT,1849,25,15-19,1874,0.4236047436893093
STAT,1860,17,20-24,1877,16.924007770452008
STAT,1864,66,na,1930,1486.7171116913119
SIM,1944,24,30-34,1968,42
STAT,1837,23,30-34,1860,15.435182986828709
SIM,1858,37,25-29,1895,2
STAT,1805,50,40-44,1855,0.038618703915947364
SIM,1895,47,na,1942,3081
STAT,1934,36,30-34,1970,2.5672304788964087
STAT,1911,23,15-19,1934,5.133722448269503
STAT,1829,34,30-34,1863,15.635351656925002
STAT,1894,28,30-34,1922,32.92783201284361
STAT,1846,29,40-44,1875,2.5544432165285964
SIM,1892,24,15-19,1916,5
STAT,1903,24,35-39,1927,8.409430804714292
SIM,1907,35,25-29,1942,1
SIM,1842,54,na,1896,1565
STAT,1786,104,na,1890,0.028819438094713073
STAT,1877,87,na,1964,371.2805902240999
SIM,1852,41,50-100,1893,2
STAT,1852,34,20-24,1886,2.208292802141242
STAT,1835,37,25-29,1872,2.6532065014418174
STAT,1839,20,30-34,1859,16.024402366628657
STAT,1919,47,45-49,1966,0.24055928146676966
SIM,1901,38,35-39,1939,5
STAT,1809,69,na,1878,912.9849728383984
STAT,1837,45,35-39,1882,0.09941086451438849
STAT,1853,29,50-100,1882,0.5573593484453069
SIM,1925,19,na,1944,4627
STAT,1866,42,35-39,1908,1.7018239678981644
STAT,1919,27,35-39,1946,16.554090845536553
SIM,1864,32,25-29,1896,14
SIM,1939,19,50-100,1958,1
STAT,1898,39,15-19,1937,0.016552534493917186
SIM,1927,27,35-39,1954,26
STAT,1897,46,45-49,1943,0.18210108972189923
STAT,1872,41,40-44,1913,2.31013203082065
SIM,1853,49,na,1902,1848
SIM,1868,90,na,1958,81
STAT,1853,52,50-100,1905,0.012596220587621769
STAT,1840,24,50-100,1864,0.36783535661995287
STAT,1828,45,25-29,1873,0.046249241692963725
STAT,1864,35,50-100,1899,1.1242403440540203
SIM,1874,42,35-39,1916,2
SIM,1817,55,na,1872,1173
SIM,1909,23,25-29,1932,8
SIM,1858,21,45-49,1879,1
STAT,1856,23,35-39,1879,5.3883687509055544
STAT,1856,32,25-29,1888,8.302737032948789
STAT,1858,31,45-49,1889,1.4254908488524016
SIM,1837,34,30-34,1871,23
STAT,1871,9,na,1880,2722.926730432939
SIM,1911,24,35-39,1935,8
SIM,1936,28,na,1964,3114
SIM,1859,44,25-29,1903,2
SIM,1856,24,45-49,1880,1
SIM,1918,31,20-24,1949,5
STAT,1884,24,15-19,1908,3.308803420762462
STAT,1898,20,35-39,1918,8.098383646050777
STAT,1843,19,na,1862,2340.254938417362
SIM,1900,18,25-29,1918,13
SIM,1941,15,15-19,1956,68
STAT,1891,36,50-100,1927,1.55809987780406
STAT,1932,39,50-100,1971,0.5740744926340206
STAT,1900,28,25-29,1928,59.60154448082889
SIM,1843,41,na,1884,1812
SIM,1846,38,45-49,1884,3
STAT,1770,110,na,1880,0.0012223011160904602
SIM,1953,17,35-39,1970,6
SIM,1929,35,45-49,1964,2
STAT,1924,17,na,1941,4471.937693950054
SIM,1853,91,na,1944,37
STAT,1839,67,na,1906,1094.0299016849744
SIM,1860,34,20-24,1894,1
SIM,1885,34,25-29,1919,11
STAT,1873,20,30-34,1893,18.532264603842506
SIM,1843,37,25-29,1880,2
SIM,1877,53,na,1930,2169
STAT,1897,21,na,1918,3235.7524464013354
STAT,1877,34,25-29,1911,10.744769046771852
SIM,1933,21,45-49,1954,1
STAT,1841,71,na,1912,985.5535926937081
STAT,1858,48,15-19,1906,3.1953671521490145E-4
STAT,1901,29,30-34,1930,35.66721831413836
STAT,1943,29,35-39,1972,16.2972539169306
SIM,1861,27,30-34,1888,38
SIM,1877,75,na,1952,910
SIM,1847,85,na,1932,120
STAT,1848,24,45-49,1872,0.6505591504618919
STAT,1849,44,15-19,1893,0.010576687887582942
STAT,1794,76,na,1870,391.9667680886079
STAT,1826,44,20-24,1870,0.12573865427010533
STAT,1924,29,25-29,1953,77.63002256730212
STAT,1908,46,30-34,1954,0.08283007695833218
STAT,1762,101,na,1863,0.12361523559388929
SIM,1934,17,25-29,1951,68
STAT,1817,53,50-100,1870,0.031709261558108714
STAT,1838,38,45-49,1876,1.7491500386231373
STAT,1842,27,15-19,1869,0.4399944882239071
STAT,1862,34,15-19,1896,0.12260804258370311
STAT,1920,32,50-100,1952,0.924185545471124
STAT,1867,23,na,1890,2258.0829406969597
SIM,1866,28,20-24,1894,11
STAT,1864,39,45-49,1903,1.790057232418366
STAT,1939,16,na,1955,3759.5674672641403
SIM,1898,43,35-39,1941,1
STAT,1858,28,20-24,1886,9.645965328879178
SIM,1851,39,na,1890,1844
SIM,1842,27,20-24,1869,12
SIM,1872,39,45-49,1911,2
STAT,1853,27,30-34,1880,24.460772807160883
STAT,1833,53,20-24,1886,4.931707557923129E-4
STAT,1834,36,na,1870,1808.968688235918
SIM,1893,17,25-29,1910,15
STAT,1905,44,na,1949,3370.8894856706634
STAT,1933,15,15-19,1948,62.244044979371516
STAT,1941,26,20-24,1967,19.273393090798297
STAT,1834,27,20-24,1861,10.35222441145006
STAT,1826,43,50-100,1869,0.8508731078065085
SIM,1854,29,40-44,1883,3
STAT,1876,38,25-29,1914,3.0179870761931524
SIM,1822,79,na,1901,316
STAT,1885,17,25-29,1902,5.767476047554151
SIM,1872,52,na,1924,2230
SIM,1931,17,15-19,1948,54
STAT,1864,25,40-44,1889,2.7462660121927693
STAT,1928,20,15-19,1948,6.81975735596939
SIM,1834,43,50-100,1877,3
SIM,1862,35,25-29,1897,7
STAT,1805,79,na,1884,348.9207603635058
STAT,1931,27,15-19,1958,0.9295153492001489
SIM,1772,87,na,1859,53
SIM,1921,40,na,1961,4920
STAT,1923,17,15-19,1940,54.37294187956981
STAT,1886,16,50-100,1902,0.05303195175845302
SIM,1918,34,30-34,1952,21
STAT,1822,53,45-49,1875,0.019498920581603126
STAT,1860,21,35-39,1881,5.015162271378765
STAT,1809,47,25-29,1856,0.2561999417497647
STAT,1844,60,na,1904,1477.8952430548186
STAT,1854,39,40-44,1893,3.3166222882455387
SIM,1864,57,na,1921,1893
STAT,1878,41,15-19,1919,0.014730474318801595
STAT,1941,22,40-44,1963,3.5449492152597437
SIM,1871,88,na,1959,292
STAT,1819,93,na,1912,17.230036252026668
STAT,1831,40,40-44,1871,1.9579192722586676
STAT,1854,35,25-29,1889,2.237324496192327
STAT,1922,16,na,1938,4357.190165682267
SIM,1936,20,15-19,1956,5
SIM,1932,29,25-29,1961,113
STAT,1893,35,20-24,1928,1.0070656076987925
SIM,1872,25,40-44,1897,5
SIM,1800,76,na,1876,396
SIM,1951,17,na,1968,4992
STAT,1926,17,25-29,1943,54.2020575793203
STAT,1829,30,15-19,1859,0.13902503840922148
SIM,1947,20,35-39,1967,24
STAT,1880,0,na,1880,3865.7960483876395
SIM,1819,81,na,1900,279
SIM,1926,35,35-39,1961,6
SIM,1875,28,30-34,1903,31
SIM,1908,27,25-29,1935,106
STAT,1850,37,15-19,1887,0.04290862225379159
STAT,1806,94,na,1900,7.1017320772699755
SIM,1940,19,15-19,1959,67
STAT,1875,28,20-24,1903,12.239718501790867
SIM,1886,27,35-39,1913,1
STAT,1934,27,25-29,1961,90.29758933008584
SIM,1888,21,30-34,1909,1
STAT,1801,107,na,1908,0.0016826437422515202
STAT,1815,44,45-49,1859,4.245716410962166
STAT,1884,38,15-19,1922,0.056394710781915165
STAT,1936,21,20-24,1957,108.46327748003928
STAT,1775,109,na,1884,0.0029596416334030312
SIM,1855,30,30-34,1885,19
STAT,1932,19,15-19,1951,60.95675582269418
SIM,1859,22,15-19,1881,7
STAT,1854,20,20-24,1874,62.870152694745926
SIM,1942,27,25-29,1969,90
STAT,1859,24,20-24,1883,57.41785846246343
SIM,1849,19,30-34,1868,3
STAT,1863,30,15-19,1893,0.1284006619291756
STAT,1838,52,25-29,1890,0.0025886471433056416
SIM,1904,35,40-44,1939,1
STAT,1935,28,30-34,1963,54.442465311562785
SIM,1862,76,na,1938,747
STAT,1882,35,45-49,1917,2.0000967001474104
SIM,1890,25,35-39,1915,20
SIM,1904,15,na,1919,4019
STAT,1925,25,25-29,1950,79.85345238523337
SIM,1944,21,20-24,1965,121
STAT,1831,95,na,1926,8.95881545369375
STAT,1896,21,15-19,1917,4.458371093548995
STAT,1947,20,25-29,1967,106.58452764265326
STAT,1866,22,40-44,1888,1.9768121359711837
STAT,1878,27,35-39,1905,10.245823016638246
STAT,1878,46,35-39,1924,0.14908264727630685
SIM,1872,27,50-100,1899,1
STAT,1914,58,na,1972,3526.4626865715804
SIM,1874,22,40-44,1896,3
STAT,1862,51,25-29,1913,0.0030906010429081142
SIM,1853,17,30-34,1870,3
SIM,1837,21,na,1858,1767
SIM,1859,88,na,1947,177
STAT,1897,19,45-49,1916,0.0886244494700027
SIM,1886,36,na,1922,2610
STAT,1810,49,50-100,1859,0.74544109339704
SIM,1833,31,na,1864,1922
STAT,1880,51,40-44,1931,0.01133995100492689
STAT,1774,90,na,1864,20.369581602043443
STAT,1901,17,20-24,1918,25.291153650183862
SIM,1828,39,40-44,1867,5
SIM,1911,46,50-100,1957,1
STAT,1930,26,45-49,1956,2.2414874562362477
STAT,1939,20,35-39,1959,9.653258867982201
STAT,1918,35,35-39,1953,2.6263284809677043
SIM,1810,54,na,1864,1495
STAT,1890,18,45-49,1908,0.08126569279271469
SIM,1863,20,15-19,1883,5
SIM,1876,38,30-34,1914,7
SIM,1933,25,25-29,1958,118
STAT,1913,31,na,1944,3854.416635733329
STAT,1845,27,40-44,1872,2.8488970228850645
SIM,1871,37,na,1908,2191
SIM,1887,20,25-29,1907,76
SIM,1862,24,50-100,1886,3
STAT,1828,49,40-44,1877,0.13041692687263967
STAT,1823,107,na,1930,0.002624677570316589
SIM,1819,36,35-39,1855,15
STAT,1818,97,na,1915,2.73778492261328
SIM,1914,24,45-49,1938,1
STAT,1945,17,35-39,1962,4.6766517474122145
STAT,1803,51,50-100,1854,0.06224731832673443
SIM,1851,47,25-29,1898,1
STAT,1877,40,45-49,1917,1.5995527986289666
SIM,1853,27,40-44,1880,3
STAT,1882,25,35-39,1907,9.654907050025345
STAT,1774,110,na,1884,0.0014065738046050939
STAT,1915,36,20-24,1951,0.27305191349538405
SIM,1930,28,50-100,1958,2
SIM,1883,28,20-24,1911,11
STAT,1862,43,50-100,1905,0.9107955953826719
STAT,1899,32,45-49,1931,2.4360667622736085
STAT,1849,42,35-39,1891,1.4041135371523905
SIM,1937,8,na,1945,4631
STAT,1868,38,30-34,1906,5.167209467272277
SIM,1897,28,na,1925,3179
STAT,1928,16,45-49,1944,0.6436125701461982
STAT,1841,21,25-29,1862,53.931672669820045
STAT,1903,46,50-100,1949,0.201474552420477
SIM,1875,6,na,1881,2772
SIM,1783,79,na,1862,214
STAT,1859,23,45-49,1882,0.5852098225962655
STAT,1906,24,45-49,1930,1.0289330908907375
STAT,1854,24,50-100,1878,0.3614644778347882
STAT,1843,47,25-29,1890,0.046282144658433624
STAT,1881,38,na,1919,2312.1217546038115
STAT,1790,86,na,1876,75.40085381550698
STAT,1859,36,na,1895,1928.6882689459853
STAT,1871,90,na,1961,150.11916928173406
STAT,1824,49,50-100,1873,0.27860359177933725
SIM,1925,15,30-34,1940,21
SIM,1866,31,45-49,1897,3
STAT,1927,37,35-39,1964,3.0676051780815814
STAT,1855,48,50-100,1903,0.18799645617447494
STAT,1871,17,40-44,1888,0.18602173301642952
SIM,1870,43,50-100,1913,2
SIM,1827,27,30-34,1854,27
SIM,1828,35,50-100,1863,1
SIM,1830,34,35-39,1864,7
SIM,1851,82,na,1933,211
STAT,1861,27,25-29,1888,35.91782283532665
STAT,1925,10,na,1935,4898.099999216217
SIM,1888,42,50-100,1930,1
SIM,1878,36,50-100,1914,2
SIM,1894,18,30-34,1912,2
SIM,1912,44,na,1956,3702
SIM,1943,28,30-34,1971,51
STAT,1836,49,35-39,1885,0.08889423657847162
SIM,1880,41,40-44,1921,2
STAT,1841,34,45-49,1875,1.5300813336627943
SIM,1862,74,na,1936,939
SIM,1944,15,na,1959,4023
SIM,1915,25,15-19,1940,1
STAT,1801,63,na,1864,843.0233768078499
STAT,1828,30,20-24,1858,2.862617203620605
STAT,1933,37,50-100,1970,0.5832060749655213
SIM,1775,92,na,1867,2
STAT,1837,40,15-19,1877,0.01114695325816175
STAT,1822,34,35-39,1856,23.176781918117843
STAT,1864,88,na,1952,124.52751648824187
SIM,1847,20,30-34,1867,23
SIM,1916,5,na,1921,4346
SIM,1823,34,35-39,1857,17
STAT,1908,37,25-29,1945,0.9400348821473697
SIM,1845,26,35-39,1871,14
SIM,1844,49,35-39,1893,2
STAT,1847,30,30-34,1877,16.321576526487043
STAT,1886,18,30-34,1904,1.7165702853607523
SIM,1867,24,20-24,1891,65
STAT,1867,45,20-24,1912,0.011607359043000354
SIM,1907,15,15-19,1922,12
STAT,1817,47,15-19,1864,8.937194425694056E-4
STAT,1917,15,30-34,1932,2.6891157106624366
SIM,1912,8,na,1920,4244
STAT,1906,28,50-100,1934,0.9465010671657853
STAT,1851,48,na,1899,1832.8350560903766
STAT,1919,28,na,1947,4116.001105066101
SIM,1939,20,40-44,1959,5
SIM,1921,29,na,1950,4822
STAT,1876,28,15-19,1904,0.47626122570553514
STAT,1891,38,15-19,1929,0.0705713172003084
SIM,1949,19,35-39,1968,6
STAT,1810,48,na,1858,1232.6084718871653
STAT,1950,19,25-29,1969,52.239621509666115
SIM,1848,32,40-44,1880,1
SIM,1916,37,25-29,1953,2
SIM,1901,52,na,1953,3297
STAT,1893,18,30-34,1911,2.0572962300995945
STAT,1827,37,30-34,1864,6.927925762501761
STAT,1851,38,20-24,1889,0.6361343051728794
SIM,1888,19,50-100,1907,1
SIM,1929,30,25-29,1959,15
STAT,1824,47,15-19,1871,4.661712463123227E-4
STAT,1874,54,20-24,1928,7.474530014824324E-4
STAT,1862,22,na,1884,2102.460656898362
SIM,1903,23,30-34,1926,32
STAT,1924,46,15-19,1970,4.4854458619229457E-4
STAT,1883,28,15-19,1911,0.4525419861908519
STAT,1907,25,15-19,1932,0.6842057143860254
SIM,1879,29,45-49,1908,2
STAT,1864,48,50-100,1912,0.21998018438531802
SIM,1834,27,30-34,1861,29
STAT,1812,45,30-34,1857,0.23707760848821274
SIM,1941,21,50-100,1962,1
SIM,1927,43,na,1970,4642
STAT,1879,39,45-49,1918,2.104369644725201
STAT,1897,33,25-29,1930,13.912328229737799
SIM,1835,37,30-34,1872,9
SIM,1865,50,na,1915,2064
STAT,1848,22,30-34,1870,16.859016822584543
SIM,1843,39,na,1882,1830
SIM,1882,19,15-19,1901,6
SIM,1881,66,na,1947,1517
STAT,1922,15,50-100,1937,0.4444770554929474
STAT,1908,19,na,1927,3799.867983458822
SIM,1847,19,20-24,1866,16
STAT,1902,21,50-100,1923,0.5884370328133662
SIM,1871,59,na,1930,1770
STAT,1853,74,na,1927,930.5562614179532
STAT,1928,16,50-100,1944,0.4827094276096485
STAT,1939,22,50-100,1961,0.674116030415126
STAT,1921,7,na,1928,4649.543056543448
STAT,1878,24,25-29,1902,60.406358998317344
STAT,1933,21,50-100,1954,0.8927843649468502
STAT,1853,49,35-39,1902,0.11493880647225756
SIM,1920,27,40-44,1947,6
STAT,1835,34,20-24,1869,2.5123829315850763
STAT,1881,2,na,1883,3145.669506866089
STAT,1846,34,30-34,1880,14.45186361059547
SIM,1826,69,na,1895,862
SIM,1900,27,20-24,1927,19
STAT,1860,27,30-34,1887,21.066748023857617
STAT,1881,51,35-39,1932,0.008531546367671837
SIM,1858,30,40-44,1888,4
SIM,1927,11,na,1938,4884
STAT,1865,29,15-19,1894,0.41708204315375186
STAT,1916,31,45-49,1947,1.66465142074332
STAT,1808,84,na,1892,110.7467871929683
STAT,1895,21,20-24,1916,92.00020432434785
SIM,1879,46,35-39,1925,1
SIM,1885,37,50-100,1922,1
STAT,1917,36,30-34,1953,1.941136485058419
SIM,1902,23,15-19,1925,4
STAT,1850,24,45-49,1874,0.6205586945015598
STAT,1912,27,40-44,1939,4.685706165511935
SIM,1906,41,na,1947,3443
SIM,1850,51,na,1901,1578
SIM,1843,34,20-24,1877,4
SIM,1873,30,50-100,1903,1
STAT,1804,94,na,1898,6.743698893625281
STAT,1831,61,na,1892,1259.126242454705
STAT,1835,30,50-100,1865,0.8877294088019583
SIM,1831,35,40-44,1866,6
STAT,1789,75,na,1864,326.53589359542866
SIM,1900,15,20-24,1915,18
STAT,1877,45,15-19,1922,4.274534910364323E-4
STAT,1957,10,na,1967,5283.333161617268
SIM,1875,49,na,1924,2204
STAT,1847,57,na,1904,1567.136406103555
STAT,1919,24,30-34,1943,31.91529549084409
STAT,1944,25,35-39,1969,16.56986927587085
STAT,1950,16,20-24,1966,163.58859666655383
SIM,1899,51,na,1950,3042
STAT,1931,20,30-34,1951,38.24385023877062
SIM,1929,20,40-44,1949,8
STAT,1893,47,15-19,1940,2.9064097690061465E-4
STAT,1886,66,na,1952,1769.8229882010341
SIM,1900,28,50-100,1928,1
STAT,1912,38,na,1950,3727.2837801908786
STAT,1824,34,45-49,1858,2.7763789746478893
SIM,1845,26,50-100,1871,3
STAT,1858,34,15-19,1892,0.11422252778623516
STAT,1883,19,na,1902,2514.487059277958
STAT,1873,15,40-44,1888,0.1914156474353676
SIM,1891,22,40-44,1913,2
SIM,1897,41,na,1938,3158
STAT,1930,1,na,1931,5506.536107353659
STAT,1908,3,na,1911,3998.901993461193
SIM,1927,24,30-34,1951,65
SIM,1845,35,25-29,1880,5
STAT,1857,64,na,1921,1384.9829879285314
STAT,1950,16,50-100,1966,0.45206861765371265
SIM,1861,49,35-39,1910,1
STAT,1783,109,na,1892,0.0013174607512542352
STAT,1875,41,50-100,1916,1.111121297188693
STAT,1895,27,50-100,1922,0.851437571391745
STAT,1903,63,na,1966,2838.16039599331
STAT,1872,24,30-34,1896,18.09779736593123
SIM,1872,36,40-44,1908,8
STAT,1951,15,25-29,1966,52.67153049493155
STAT,1857,86,na,1943,176.7729472032923
SIM,1835,97,na,1932,6
SIM,1925,33,na,1958,4765
SIM,1932,26,20-24,1958,37
STAT,1946,26,40-44,1972,5.299727210066495
SIM,1806,95,na,1901,7
STAT,1883,22,40-44,1905,2.0858206238356733
STAT,1939,19,25-29,1958,44.221002282999855
SIM,1838,45,35-39,1883,1
STAT,1900,21,40-44,1921,2.955296405836055
STAT,1942,21,45-49,1963,1.204012837278201
STAT,1837,35,25-29,1872,2.3862815096185175
STAT,1840,21,na,1861,1970.7819160816262
STAT,1853,96,na,1949,7.199901060427336
SIM,1825,32,50-100,1857,1
STAT,1795,60,na,1855,859.8020299999998
STAT,1853,24,20-24,1877,67.29620745616529
SIM,1950,21,45-49,1971,3
STAT,1857,35,45-49,1892,1.6033323072356154
SIM,1861,24,20-24,1885,78
STAT,1834,39,na,1873,1753.4858537325597
STAT,1855,52,na,1907,1660.246241076534
STAT,1875,33,50-100,1908,0.9552705309682006
STAT,1787,97,na,1884,1.1561754153870885
SIM,1873,37,na,1910,2353
STAT,1899,35,15-19,1934,0.07919123449835405
STAT,1783,84,na,1867,110.77351468130236
STAT,1847,25,40-44,1872,2.848485793737339
STAT,1849,48,30-34,1897,0.07420741649503021
SIM,1862,20,20-24,1882,71
STAT,1906,29,na,1935,3518.291964814863
STAT,1873,23,35-39,1896,6.016693616426896
SIM,1845,23,25-29,1868,58
STAT,1837,23,25-29,1860,49.60602097860284
STAT,1839,19,20-24,1858,15.817500644293586
SIM,1880,49,45-49,1929,2
STAT,1836,33,25-29,1869,7.975864509582627
STAT,1821,33,15-19,1854,0.4487794066806237
STAT,1912,20,20-24,1932,109.35758350062102
STAT,1930,34,50-100,1964,1.086852293727611
STAT,1913,26,45-49,1939,1.7621395065878531
SIM,1879,34,35-39,1913,17
SIM,1860,19,na,1879,2273
STAT,1924,26,20-24,1950,21.758525496243507
STAT,1854,46,25-29,1900,0.04420958945337665
STAT,1887,36,35-39,1923,8.124207635647299
STAT,1864,37,na,1901,2137.065217429019
STAT,1841,24,35-39,1865,5.380093608496051
STAT,1842,34,na,1876,2010.9235914835435
SIM,1866,38,30-34,1904,13
SIM,1899,31,40-44,1930,8
STAT,1868,17,25-29,1885,5.621446118796027
STAT,1789,78,na,1867,245.71932303265018
STAT,1804,62,na,1866,926.4236442182904
STAT,1864,36,40-44,1900,3.9898668338979237
STAT,1832,27,na,1859,1909.571268031363
SIM,1895,36,35-39,1931,20
SIM,1828,45,35-39,1873,1
SIM,1921,26,45-49,1947,3
STAT,1871,43,20-24,1914,0.159325176262758
STAT,1944,17,40-44,1961,1.535726171803566
STAT,1827,34,20-24,1861,3.785025777773234
STAT,1856,37,na,1893,1886.6747627735645
STAT,1877,24,15-19,1901,3.4687989373374917
STAT,1853,44,15-19,1897,0.011423222149752906
SIM,1920,20,20-24,1940,179
STAT,1778,80,na,1858,157.42450884549677
STAT,1922,48,na,1970,4294.443066242316
STAT,1926,45,50-100,1971,0.28604426940484257
SIM,1939,23,45-49,1962,2
SIM,1828,42,na,1870,1734
STAT,1900,44,30-34,1944,0.11135942053593356
STAT,1836,44,15-19,1880,0.009967722390310511
STAT,1911,27,30-34,1938,38.977009749590614
SIM,1904,26,45-49,1930,1
SIM,1855,25,40-44,1880,4
SIM,1844,33,25-29,1877,17
SIM,1830,24,25-29,1854,4
SIM,1895,35,30-34,1930,12
SIM,1903,20,20-24,1923,1
SIM,1908,24,20-24,1932,114
SIM,1838,25,40-44,1863,1
SIM,1840,29,20-24,1869,3
SIM,1828,44,30-34,1872,3
STAT,1865,35,45-49,1900,1.8633045305473532
STAT,1915,32,40-44,1947,4.067059961832558
STAT,1894,25,20-24,1919,15.498663490795215
STAT,1905,2,na,1907,3927.4355746774045
SIM,1885,24,15-19,1909,9
SIM,1928,23,35-39,1951,15
STAT,1843,23,15-19,1866,3.318875584396246
SIM,1864,35,35-39,1899,9
SIM,1919,24,30-34,1943,54
STAT,1888,47,na,1935,2700.703631680937
STAT,1872,49,45-49,1921,0.23625537577339753
STAT,1920,44,50-100,1964,0.13196793768393655
STAT,1863,54,45-49,1917,0.012623694320386453
STAT,1897,24,35-39,1921,7.909978539923389
SIM,1824,35,na,1859,1670
STAT,1812,48,35-39,1860,0.32570852023863284
SIM,1815,42,50-100,1857,3
STAT,1928,39,na,1967,4839.490467382823
STAT,1836,46,30-34,1882,0.06387238085345269
STAT,1921,30,15-19,1951,0.147101377877183
STAT,1871,93,na,1964,81.74743509518765
STAT,1876,20,40-44,1896,2.208242948984431
STAT,1932,32,40-44,1964,5.305322233614543
STAT,1902,25,30-34,1927,36.473608253033646
SIM,1925,30,na,1955,4726
SIM,1890,44,35-39,1934,7
SIM,1924,19,30-34,1943,19
STAT,1882,85,na,1967,542.4112964577014
STAT,1847,46,40-44,1893,0.13388303044688638
STAT,1947,25,45-49,1972,1.9958621775187513
SIM,1843,43,50-100,1886,3
STAT,1893,2,na,1895,3449.754383454933
STAT,1900,13,na,1913,3645.8782196806155
STAT,1879,11,na,1890,2757.980912755239
SIM,1913,30,30-34,1943,21
STAT,1897,36,35-39,1933,9.694158689163336
STAT,1843,64,na,1907,1403.3298304240207
SIM,1911,19,na,1930,3999
SIM,1838,33,35-39,1871,12
STAT,1872,25,35-39,1897,9.932280325493943
SIM,1817,87,na,1904,101
STAT,1880,54,45-49,1934,0.015129910079602115
SIM,1841,91,na,1932,18
SIM,1904,38,45-49,1942,1
STAT,1897,16,40-44,1913,0.2500992066755408
STAT,1853,71,na,1924,1119.2285617683485
STAT,1842,24,45-49,1866,0.6798609018634729
STAT,1819,90,na,1909,46.48101041665753
SIM,1869,20,15-19,1889,4
SIM,1835,34,20-24,1869,1
SIM,1885,38,40-44,1923,7
SIM,1903,3,na,1906,3798
SIM,1910,25,30-34,1935,52
STAT,1916,19,30-34,1935,2.6248479538825205
STAT,1909,34,15-19,1943,0.12399387119393901
STAT,1887,35,30-34,1922,6.150278742041318
STAT,1882,44,35-39,1926,1.7754329338338801
SIM,1802,59,na,1861,960
STAT,1846,35,35-39,1881,5.39281296604292
SIM,1869,36,25-29,1905,1
STAT,1815,57,na,1872,1317.4088803631803
SIM,1824,31,40-44,1855,5
SIM,1864,23,35-39,1887,5
STAT,1798,57,na,1855,1261.76193
SIM,1856,32,50-100,1888,1
STAT,1863,35,35-39,1898,6.3864692535348935
STAT,1837,39,50-100,1876,0.9761561027947017
SIM,1915,3,na,1918,4675
STAT,1867,77,na,1944,827.8557679426656
SIM,1934,22,15-19,1956,6
SIM,1880,22,30-34,1902,20
SIM,1854,79,na,1933,627
SIM,1899,22,na,1921,3503
SIM,1869,27,35-39,1896,14
STAT,1811,49,30-34,1860,0.2596380776137732
SIM,1908,18,35-39,1926,1
SIM,1879,26,40-44,1905,3
STAT,1906,29,15-19,1935,0.6688633799135476
SIM,1829,35,40-44,1864,6
SIM,1881,32,25-29,1913,14
STAT,1811,52,30-34,1863,0.015753200048023597
SIM,1886,36,25-29,1922,4
STAT,1912,47,35-39,1959,0.12640100137931087
STAT,1917,18,35-39,1935,0.9190655229823973
SIM,1919,48,na,1967,4140
SIM,1925,18,35-39,1943,8
STAT,1939,16,20-24,1955,138.47825649590274
STAT,1877,84,na,1961,526.2209987062081
STAT,1862,36,30-34,1898,4.650481325218743
SIM,1814,41,25-29,1855,1
SIM,1851,23,15-19,1874,7
SIM,1864,86,na,1950,319
STAT,1897,30,20-24,1927,3.716708227504136
STAT,1924,26,na,1950,4465.379426180638
STAT,1898,15,45-49,1913,0.09053451121773826
STAT,1905,30,30-34,1935,25.930954292955818
STAT,1910,18,40-44,1928,0.2819298177860885
STAT,1920,33,na,1953,4209.719201861627
STAT,1894,45,15-19,1939,2.9903168071735835E-4
SIM,1914,29,15-19,1943,1
STAT,1828,75,na,1903,566.8905242533568
STAT,1927,34,25-29,1961,11.582836528882014
SIM,1870,23,25-29,1893,66
STAT,1856,35,35-39,1891,5.717812154430119
SIM,1947,16,20-24,1963,236
STAT,1896,76,na,1972,1768.1774153254266
SIM,1820,48,35-39,1868,1
SIM,1854,35,35-39,1889,9
SIM,1928,36,40-44,1964,3
STAT,1852,46,15-19,1898,3.231552844962138E-4
SIM,1923,32,40-44,1955,1
STAT,1852,53,30-34,1905,0.004718388597698287
STAT,1858,49,na,1907,1782.1353403527085
STAT,1831,48,45-49,1879,0.19054502271953533
SIM,1854,34,30-34,1888,25
SIM,1859,48,40-44,1907,1
SIM,1865,43,50-100,1908,2
STAT,1888,25,na,1913,2897.7218605064686
SIM,1825,84,na,1909,210
STAT,1841,28,50-100,1869,0.5824303574195583
STAT,1868,35,20-24,1903,0.7582231802782411
STAT,1832,29,20-24,1861,10.430462898758648
STAT,1854,27,na,1881,1914.8057997783246
SIM,1875,27,na,1902,2315
STAT,1926,34,15-19,1960,0.1583121560997084
STAT,1862,23,25-29,1885,50.52432546031869
STAT,1916,30,na,1946,4016.6993170635624
STAT,1886,69,na,1955,1584.6711069138057
SIM,1943,24,15-19,1967,4
SIM,1835,21,15-19,1856,3
SIM,1924,31,45-49,1955,4
SIM,1834,23,15-19,1857,3
STAT,1838,82,na,1920,342.8224452864768
STAT,1936,24,30-34,1960,28.006938316340644
SIM,1839,24,45-49,1863,2
SIM,1883,78,na,1961,1079
SIM,1899,54,na,1953,2883
SIM,1869,43,30-34,1912,4
SIM,1896,26,40-44,1922,9
STAT,1888,26,40-44,1914,3.625108450595575
STAT,1873,46,50-100,1919,0.2547328834715418
SIM,1824,57,na,1881,1160
SIM,1905,27,15-19,1932,1
STAT,1861,24,20-24,1885,58.82527377423726
STAT,1806,72,na,1878,588.1854526160892
SIM,1938,25,45-49,1963,2
STAT,1878,36,25-29,1914,3.072022843351985
SIM,1886,24,25-29,1910,86
SIM,1937,5,na,1942,4678
STAT,1864,34,na,1898,2146.0482711444997
STAT,1926,22,15-19,1948,6.597393467871099
SIM,1855,33,35-39,1888,15
SIM,1849,15,15-19,1864,5
STAT,1906,42,40-44,1948,0.23163894711359492
STAT,1919,18,50-100,1937,0.42139346665978705
SIM,1882,11,na,1893,2527
STAT,1906,49,50-100,1955,0.201413782941133
SIM,1907,39,40-44,1946,3
SIM,1952,10,na,1962,4886
STAT,1847,33,35-39,1880,9.176556721173274
STAT,1898,36,45-49,1934,2.7633558902519524
STAT,1820,87,na,1907,97.03236246384155
SIM,1856,29,15-19,1885,1
STAT,1900,40,15-19,1940,0.0013696356815733489
SIM,1830,28,40-44,1858,2
STAT,1928,37,50-100,1965,0.5412306828385592
STAT,1877,47,30-34,1924,0.10194522142249524
STAT,1908,43,50-100,1951,0.11016961166906858
SIM,1844,37,40-44,1881,10
SIM,1853,2,na,1855,2918
STAT,1891,15,35-39,1906,0.6962383817403591
STAT,1931,23,35-39,1954,12.416266145449265
SIM,1823,72,na,1895,684
SIM,1886,21,20-24,1907,74
STAT,1811,73,na,1884,534.7767899634343
STAT,1927,17,40-44,1944,1.774049892086255
STAT,1866,19,50-100,1885,0.04676203791768203
SIM,1896,11,na,1907,3543
SIM,1832,24,35-39,1856,7
SIM,1826,61,na,1887,1168
STAT,1865,22,30-34,1887,16.692922957952256
SIM,1945,20,25-29,1965,127
STAT,1841,43,35-39,1884,1.37164408543335
STAT,1916,30,50-100,1946,0.8780894619534292
SIM,1836,33,25-29,1869,16
SIM,1907,31,45-49,1938,1
STAT,1925,29,40-44,1954,5.576551972538641
SIM,1873,22,30-34,1895,20
SIM,1934,1,na,1935,5840
SIM,1866,15,15-19,1881,7
STAT,1887,33,30-34,1920,19.874559824341148
STAT,1842,48,20-24,1890,0.009292212929412283
SIM,1813,65,na,1878,840
STAT,1814,45,40-44,1859,0.527263930044494
SIM,1903,26,35-39,1929,21
SIM,1838,21,25-29,1859,4
SIM,1837,24,na,1861,1860
STAT,1848,41,na,1889,1817.5284208066455
STAT,1888,47,40-44,1935,0.205508081539509
SIM,1924,30,50-100,1954,4
SIM,1891,25,45-49,1916,1
STAT,1848,45,45-49,1893,0.1852795384212541
STAT,1947,24,40-44,1971,3.8744918810894604
SIM,1880,24,30-34,1904,26
STAT,1873,18,45-49,1891,0.0673827668644269
STAT,1931,15,40-44,1946,1.8758107693346362
STAT,1933,36,15-19,1969,0.026699005598022314
STAT,1775,94,na,1869,3.772368972759275
STAT,1833,76,na,1909,622.1559092240002
STAT,1874,38,15-19,1912,0.058198346729200406
STAT,1836,37,40-44,1873,3.3446717779892947
STAT,1848,29,15-19,1877,0.4150065913971378
STAT,1898,33,40-44,1931,5.957480644052372
SIM,1935,17,40-44,1952,5
STAT,1836,23,15-19,1859,2.690751951608964
STAT,1892,44,na,1936,2925.2429686028468
SIM,1910,16,25-29,1926,11
SIM,1828,42,30-34,1870,6
SIM,1904,49,na,1953,3360
SIM,1851,27,30-34,1878,32
SIM,1896,47,40-44,1943,1
STAT,1828,33,25-29,1861,9.77481857411805
STAT,1859,107,na,1966,0.030986049003181387
SIM,1859,38,30-34,1897,5
STAT,1866,78,na,1944,735.2107787219946
SIM,1875,41,na,1916,2322
STAT,1843,27,30-34,1870,25.01805609045027
SIM,1879,31,30-34,1910,23
STAT,1881,36,40-44,1917,4.338212141911913
STAT,1820,109,na,1929,3.918396786721409E-4
SIM,1853,23,25-29,1876,73
STAT,1858,15,15-19,1873,5.674973621388965
SIM,1869,24,30-34,1893,29
STAT,1845,23,25-29,1868,55.129085083853475
STAT,1826,37,15-19,1863,0.05017526840370029
STAT,1863,34,30-34,1897,15.483168858970004
SIM,1854,32,30-34,1886,25
STAT,1902,16,25-29,1918,8.172435856278351
STAT,1895,24,25-29,1919,75.71754465691512
STAT,1951,19,40-44,1970,1.6980218366553783
SIM,1839,42,40-44,1881,7
SIM,1913,21,25-29,1934,101
STAT,1850,53,20-24,1903,5.461543384773354E-4
STAT,1893,28,15-19,1921,0.585090742995475
SIM,1959,1,na,1960,5726
STAT,1842,106,na,1948,0.00952156912282448
STAT,1873,32,25-29,1905,10.593409251162353
STAT,1846,16,35-39,1862,0.4958464611334434
STAT,1923,29,15-19,1952,0.8210588036230805
SIM,1839,41,50-100,1880,1
STAT,1840,53,na,1893,1524.537532599511
STAT,1872,20,15-19,1892,3.393145347032013
STAT,1918,40,na,1958,4040.7586956646473
STAT,1934,15,25-29,1949,60.05352627601951
STAT,1908,33,na,1941,3624.993526235376
SIM,1862,23,na,1885,2377
STAT,1903,37,40-44,1940,1.370181583830954
SIM,1936,25,na,1961,3202
SIM,1815,43,na,1858,1502
SIM,1919,30,25-29,1949,13
SIM,1862,23,25-29,1885,2
STAT,1829,38,na,1867,1804.5582013859832
SIM,1868,40,45-49,1908,7
STAT,1876,23,45-49,1899,0.7323091856981665
STAT,1763,109,na,1872,0.0010799748084828226
SIM,1888,36,35-39,1924,11
SIM,1913,25,40-44,1938,5
STAT,1883,25,45-49,1908,1.1189149829342695
STAT,1877,38,40-44,1915,4.608800682478328
SIM,1906,18,25-29,1924,15
STAT,1832,31,25-29,1863,9.083285351023344
STAT,1905,25,40-44,1930,4.443440400764076
SIM,1933,29,40-44,1962,2
STAT,1830,46,na,1876,1547.235837342772
STAT,1862,17,30-34,1879,1.585229297117986
SIM,1824,34,45-49,1858,5
STAT,1933,19,30-34,1952,16.550620506741936
SIM,1926,18,na,1944,5186
SIM,1911,37,40-44,1948,1
SIM,1930,28,45-49,1958,6
STAT,1852,27,15-19,1879,0.4257169890857253
STAT,1953,15,35-39,1968,5.180644001576048
SIM,1885,70,na,1955,1463
STAT,1832,35,40-44,1867,3.798769078889735
STAT,1922,28,45-49,1950,1.9876754694335894
SIM,1918,22,30-34,1940,44
SIM,1941,28,20-24,1969,23
SIM,1870,71,na,1941,1383
STAT,1824,91,na,1915,31.906955233708132
STAT,1842,21,40-44,1863,2.076028392977478
STAT,1874,19,15-19,1893,6.148053186615155
SIM,1873,35,45-49,1908,1
STAT,1854,23,25-29,1877,51.10934318201234
SIM,1847,31,na,1878,1793
SIM,1871,29,40-44,1900,6
SIM,1895,33,30-34,1928,26
SIM,1840,35,40-44,1875,6
SIM,1898,22,35-39,1920,8
STAT,1862,56,na,1918,1771.2182454255683
STAT,1930,11,na,1941,5232.402202271435
STAT,1883,49,20-24,1932,0.011760792952222578
SIM,1840,31,25-29,1871,9
STAT,1875,74,na,1949,1161.9604614640136
STAT,1933,28,20-24,1961,24.70599903838152
SIM,1860,64,na,1924,1696
STAT,1921,16,35-39,1937,4.892789894960452
STAT,1899,39,30-34,1938,1.5908199979255426
SIM,1804,69,na,1873,891
STAT,1845,45,na,1890,1775.4317827224766
STAT,1847,28,45-49,1875,1.0332099562086479
STAT,1831,23,30-34,1854,40.984128845117915
STAT,1855,49,45-49,1904,0.17912700411822002
SIM,1827,33,25-29,1860,11
STAT,1863,25,25-29,1888,38.385820258789046
SIM,1840,76,na,1916,546
STAT,1846,30,15-19,1876,0.12287355239334806
STAT,1833,37,15-19,1870,0.046499258058949736
STAT,1832,24,na,1856,1888.270553818141
STAT,1837,20,20-24,1857,63.544620011096875
SIM,1854,22,20-24,1876,2
SIM,1850,21,40-44,1871,1
SIM,1851,68,na,1919,1180
SIM,1894,24,25-29,1918,3
SIM,1838,30,30-34,1868,3
SIM,1855,28,45-49,1883,1
SIM,1894,30,45-49,1924,2
SIM,1909,35,35-39,1944,5
SIM,1854,4,na,1858,2627
SIM,1892,28,30-34,1920,42
STAT,1886,24,25-29,1910,61.427534624972864
STAT,1908,25,25-29,1933,64.42131521285728
STAT,1839,45,45-49,1884,0.17025482477910148
STAT,1887,62,na,1949,2089.3404892920403
STAT,1928,24,30-34,1952,36.374093677157326
STAT,1867,38,15-19,1905,0.05351425065086193
STAT,1907,46,15-19,1953,3.389324786323727E-4
STAT,1815,54,na,1869,1397.90837228687
STAT,1850,39,50-100,1889,0.9188565637194263
SIM,1857,21,35-39,1878,8
SIM,1864,89,na,1953,183
STAT,1846,22,20-24,1868,60.80572934807243
SIM,1811,84,na,1895,45
STAT,1871,46,25-29,1917,0.058371476472819275
SIM,1841,18,15-19,1859,10
STAT,1824,37,50-100,1861,1.6980233862974057
STAT,1872,22,30-34,1894,18.211806439454175
STAT,1900,27,50-100,1927,0.9044928862044902
SIM,1938,20,25-29,1958,115
STAT,1884,28,30-34,1912,25.326190482633432
SIM,1832,37,50-100,1869,4
STAT,1893,38,25-29,1931,3.7076213755271272
STAT,1940,17,15-19,1957,47.00883627173807
STAT,1937,28,50-100,1965,0.9892126820851974
SIM,1817,44,20-24,1861,3
STAT,1865,30,50-100,1895,0.8551735430561975
STAT,1899,65,na,1964,2579.88171760278
STAT,1917,34,50-100,1951,0.8759603561420729
SIM,1845,20,20-24,1865,4
SIM,1871,25,25-29,1896,43
SIM,1862,43,20-24,1905,1
SIM,1900,39,30-34,1939,3
STAT,1876,35,20-24,1911,0.81974686222685
SIM,1847,32,30-34,1879,20
SIM,1845,39,40-44,1884,10
STAT,1873,36,40-44,1909,4.549221226255406
STAT,1831,24,35-39,1855,7.311055891235985
SIM,1884,35,20-24,1919,1
STAT,1820,42,50-100,1862,2.1007183117678943
SIM,1918,37,35-39,1955,4
SIM,1904,23,40-44,1927,3
STAT,1888,43,25-29,1931,0.7688598698870465
STAT,1907,38,20-24,1945,0.24798373998108963
SIM,1879,22,25-29,1901,5
STAT,1917,27,25-29,1944,70.44134681850458
STAT,1781,100,na,1881,0.20467958475616257
SIM,1814,45,40-44,1859,1
STAT,1858,19,30-34,1877,1.4885605745835426
SIM,1825,37,30-34,1862,5
STAT,1846,32,30-34,1878,14.755130094649163
SIM,1832,34,45-49,1866,1
SIM,1906,32,50-100,1938,2
SIM,1912,12,na,1924,4210
STAT,1897,21,30-34,1918,24.369959486845158
SIM,1873,60,na,1933,1892
SIM,1925,27,25-29,1952,96
STAT,1836,27,30-34,1863,20.283189754787884
STAT,1783,106,na,1889,0.013935353046509462
STAT,1896,47,40-44,1943,0.12950874252021127
STAT,1943,26,30-34,1969,42.59409267793242
SIM,1861,27,na,1888,2528
SIM,1878,49,50-100,1927,2
SIM,1844,27,30-34,1871,35
STAT,1879,33,na,1912,2533.916281720901
STAT,1927,31,20-24,1958,3.0624739253800706
STAT,1891,25,45-49,1916,1.4118242896549655
STAT,1942,1,na,1943,4420.267032739535
STAT,1830,45,25-29,1875,0.04905989107625104
SIM,1938,22,40-44,1960,3
STAT,1821,35,30-34,1856,13.008908691477414
STAT,1823,98,na,1921,1.8079848992104202
SIM,1846,38,na,1884,1951
STAT,1929,38,15-19,1967,0.02512012636006462
STAT,1870,24,20-24,1894,68.29363626167606
SIM,1870,36,30-34,1906,14
STAT,1857,32,40-44,1889,3.476475244107595
SIM,1866,67,na,1933,1697
STAT,1826,39,30-34,1865,4.519588311519072
SIM,1908,15,30-34,1923,3
STAT,1866,54,50-100,1920,0.013820437323433155
STAT,1916,15,15-19,1931,9.871602943159816
SIM,1935,25,35-39,1960,39
STAT,1807,47,15-19,1854,0.0017531997286268596
STAT,1839,32,30-34,1871,14.828587841428389
SIM,1888,6,na,1894,3101
STAT,1809,83,na,1892,202.53924724230532
STAT,1888,29,45-49,1917,1.3294775687051743
SIM,1855,75,na,1930,822
SIM,1949,21,na,1970,4449
STAT,1811,45,15-19,1856,0.00115089038144293
SIM,1851,50,na,1901,1773
SIM,1968,3,na,1971,5237
SIM,1901,20,na,1921,3489
SIM,1795,83,na,1878,125
SIM,1865,32,40-44,1897,6
STAT,1817,37,30-34,1854,18.850137043386148
SIM,1834,39,30-34,1873,4
SIM,1829,38,45-49,1867,5
STAT,1778,83,na,1861,83.44512473419331
STAT,1828,72,na,1900,695.4342184813568
STAT,1872,100,na,1972,9.538437621008198
SIM,1814,47,50-100,1861,1
SIM,1916,25,25-29,1941,68
SIM,1940,22,na,1962,3780
SIM,1849,31,45-49,1880,8
SIM,1897,73,na,1970,1906
STAT,1928,37,45-49,1965,0.8787966038526591
SIM,1939,14,na,1953,3983
STAT,1937,20,25-29,1957,91.81425188648356
SIM,1796,68,na,1864,596
SIM,1913,33,35-39,1946,12
STAT,1863,51,40-44,1914,0.009461528478437656
SIM,1935,31,20-24,1966,4
STAT,1849,21,35-39,1870,5.517046146364242
SIM,1828,26,35-39,1854,11
STAT,1926,38,30-34,1964,2.270026421969967
SIM,1895,23,20-24,1918,129
SIM,1868,34,25-29,1902,13
SIM,1776,91,na,1867,18
SIM,1944,27,35-39,1971,23
SIM,1828,32,20-24,1860,2
SIM,1880,25,35-39,1905,2
STAT,1840,24,na,1864,1928.635339744681
SIM,1858,71,na,1929,1068
STAT,1887,17,35-39,1904,0.6272477417676682
STAT,1851,16,na,1867,2316.1315868522292
SIM,1860,37,25-29,1897,7
STAT,1957,13,na,1970,5281.008832614979
STAT,1778,107,na,1885,0.005323919174725532
SIM,1864,20,30-34,1884,18
STAT,1887,23,20-24,1910,78.5327542477375
SIM,1890,25,50-100,1915,2
STAT,1788,90,na,1878,33.44138633374526
STAT,1862,27,40-44,1889,2.6109375759235016
SIM,1888,46,45-49,1934,1
SIM,1870,27,40-44,1897,2
STAT,1840,35,40-44,1875,3.803911956437418
STAT,1927,25,35-39,1952,18.74492012044856
STAT,1856,3,na,1859,2675.2950420719667
STAT,1949,23,20-24,1972,132.33211157739663
SIM,1819,49,40-44,1868,1
STAT,1852,37,25-29,1889,2.3320716131426966
STAT,1866,15,na,1881,2468.295713266734
STAT,1868,22,15-19,1890,3.2144613004467315
STAT,1893,43,50-100,1936,0.09425557852700119
STAT,1886,30,45-49,1916,1.898136129307157
SIM,1865,35,45-49,1900,2
STAT,1858,54,45-49,1912,0.0114177940174152
STAT,1905,33,35-39,1938,8.531287511972794
SIM,1876,22,15-19,1898,3
STAT,1918,48,40-44,1966,0.17073735330237735
STAT,1834,61,na,1895,1255.755881804357
STAT,1923,39,25-29,1962,1.1615391762328628
STAT,1891,34,35-39,1925,12.680956651390806
STAT,1845,20,20-24,1865,67.81488043781671
SIM,1939,20,35-39,1959,12
STAT,1812,58,na,1870,1149.0761252138373
STAT,1854,42,35-39,1896,1.3842083999991759
STAT,1902,47,40-44,1949,0.13828381130221334
SIM,1914,23,40-44,1937,4
STAT,1875,18,15-19,1893,6.197258424068601
STAT,1896,43,25-29,1939,0.05964811060906943
SIM,1838,71,na,1909,778
STAT,1894,46,25-29,1940,0.04275659007106106
SIM,1860,29,30-34,1889,26
STAT,1898,9,na,1907,3579.432373130986
SIM,1876,38,25-29,1914,6
STAT,1854,26,30-34,1880,22.363287705645305
STAT,1857,38,20-24,1895,0.6111036877176177
STAT,1833,52,45-49,1885,0.009893032414091842
SIM,1814,81,na,1895,273
SIM,1933,2,na,1935,5409
STAT,1852,29,30-34,1881,21.194378461098953
STAT,1801,94,na,1895,7.130996254084942
SIM,1896,35,45-49,1931,5
STAT,1938,16,40-44,1954,1.4109302924233285
STAT,1822,33,30-34,1855,46.55932402498248
STAT,1873,54,40-44,1927,0.010588798310085853
STAT,1837,29,35-39,1866,8.139015787217241
STAT,1901,29,na,1930,3380.231288076045
STAT,1858,19,25-29,1877,5.29232088744866
STAT,1824,43,35-39,1867,2.187363607332055
STAT,1838,51,na,1889,1605.0985444494922
SIM,1903,52,na,1955,2992
STAT,1827,53,30-34,1880,0.006322931987866259
STAT,1894,44,30-34,1938,0.10334727992258529
STAT,1819,49,40-44,1868,0.32946370020177457
SIM,1825,45,na,1870,1499
STAT,1877,47,35-39,1924,0.1474414360084422
STAT,1829,52,25-29,1881,0.002521447028424216
SIM,1829,35,na,1864,1532
SIM,1897,19,na,1916,3413
STAT,1875,16,20-24,1891,18.607549774598496
STAT,1868,38,25-29,1906,2.79148096124893
SIM,1832,43,35-39,1875,6
STAT,1852,86,na,1938,178.74381720312414
SIM,1883,16,20-24,1899,23
STAT,1888,35,45-49,1923,2.427018077693795
SIM,1869,46,40-44,1915,1
SIM,1931,39,25-29,1970,2
SIM,1871,32,35-39,1903,13
STAT,1848,45,15-19,1893,3.140328516518766E-4
STAT,1859,33,na,1892,1935.95895086636
STAT,1877,6,na,1883,2864.1687485143734
SIM,1886,67,na,1953,1774
STAT,1863,35,40-44,1898,3.95265057583701
STAT,1879,42,40-44,1921,2.395573562680572
SIM,1862,26,30-34,1888,36
SIM,1878,33,30-34,1911,5
SIM,1901,31,50-100,1932,3
STAT,1865,45,50-100,1910,0.22966883232152763
SIM,1884,32,na,1916,2578
SIM,1848,39,30-34,1887,6
STAT,1863,17,40-44,1880,0.18668065538300374
SIM,1834,81,na,1915,299
SIM,1853,39,40-44,1892,6
SIM,1914,16,na,1930,4038
STAT,1885,37,15-19,1922,0.05715292218369293
SIM,1834,26,25-29,1860,41
SIM,1830,33,30-34,1863,17
SIM,1876,37,na,1913,2732
STAT,1811,45,20-24,1856,0.03452674181415972
SIM,1851,23,20-24,1874,62
STAT,1893,17,25-29,1910,7.3335765811609175
SIM,1864,39,45-49,1903,4
STAT,1843,23,20-24,1866,69.32716812521133
SIM,1846,43,35-39,1889,3
SIM,1896,65,na,1961,2436
SIM,1929,19,45-49,1948,4
STAT,1813,99,na,1912,0.8144146171378525
SIM,1869,63,na,1932,1762
STAT,1944,26,na,1970,4132.741126901749
SIM,1870,32,na,1902,2608
SIM,1887,42,40-44,1929,5
SIM,1881,36,40-44,1917,6
STAT,1882,29,15-19,1911,0.44770159924288283
SIM,1926,22,20-24,1948,157
SIM,1938,32,50-100,1970,1
STAT,1834,20,45-49,1854,1.131951655810384
STAT,1845,39,40-44,1884,3.519865846197458
STAT,1876,51,50-100,1927,0.015985801880548794
SIM,1850,20,na,1870,1989
STAT,1845,51,25-29,1896,0.0027807825745647077
STAT,1918,22,20-24,1940,122.38216238383768
SIM,1837,32,30-34,1869,27
STAT,1917,24,na,1941,3935.9214475033978
STAT,1879,25,na,1904,2562.1463009082368
STAT,1906,52,na,1958,3235.440115354296
STAT,1906,60,na,1966,3064.4523742900524
SIM,1858,24,15-19,1882,1
STAT,1864,16,45-49,1880,0.06775711109741352
STAT,1828,41,na,1869,1476.330996072857
STAT,1847,49,45-49,1896,0.18019334265114303
STAT,1914,46,20-24,1960,0.0112102246514958
SIM,1859,65,na,1924,1449
STAT,1865,44,35-39,1909,1.6540061433288844
STAT,1882,47,45-49,1929,0.2334614240092533
SIM,1845,27,40-44,1872,2
STAT,1883,30,na,1913,2407.8149098316144
STAT,1896,23,30-34,1919,23.925282802073728
STAT,1889,46,15-19,1935,5.054881390212481E-4
SIM,1872,30,30-34,1902,30
STAT,1831,25,50-100,1856,0.6864455626997801
SIM,1887,44,35-39,1931,5
STAT,1849,26,20-24,1875,10.874564249230602
STAT,1875,43,na,1918,2402.4118915312256
STAT,1865,32,40-44,1897,4.015378078330743
STAT,1878,45,30-34,1923,0.10381292100663994
STAT,1880,16,30-34,1896,1.7128717791960695
STAT,1780,87,na,1867,50.8605022868606
STAT,1779,90,na,1869,23.71172367543393
SIM,1825,33,20-24,1858,2
STAT,1846,38,45-49,1884,1.4733335648972135
STAT,1868,26,50-100,1894,0.6254343630648578
STAT,1844,52,20-24,1896,5.687780311217993E-4
STAT,1829,32,30-34,1861,16.28933255521937
SIM,1866,19,25-29,1885,12
STAT,1843,38,20-24,1881,0.6542525591922328
SIM,1856,37,na,1893,2316
STAT,1861,21,15-19,1882,2.877662894538375
STAT,1879,26,35-39,1905,10.324492868938625
STAT,1834,50,40-44,1884,0.007557781309311151
SIM,1835,37,25-29,1872,5
STAT,1902,70,na,1972,2440.971175642703
SIM,1804,51,na,1855,1346
SIM,1851,44,50-100,1895,2
SIM,1854,38,45-49,1892,1
STAT,1907,22,45-49,1929,1.0445088904309263
STAT,1821,35,35-39,1856,17.26421741407559
STAT,1808,103,na,1911,0.0477775354223478
STAT,1882,37,50-100,1919,1.220225082075089
STAT,1841,28,15-19,1869,0.4130893803658601
SIM,1880,49,50-100,1929,1
STAT,1858,37,25-29,1895,2.329292599452157
STAT,1895,43,35-39,1938,0.1661610882783185
STAT,1859,47,15-19,1906,3.243664150091638E-4
SIM,1855,34,45-49,1889,2
SIM,1910,47,40-44,1957,1
STAT,1894,28,25-29,1922,55.313304178796756
SIM,1873,44,35-39,1917,2
STAT,1879,44,35-39,1923,1.904905857061741
STAT,1881,15,35-39,1896,0.5436938273235368
STAT,1906,23,40-44,1929,3.084573805674178
SIM,1818,71,na,1889,619
SIM,1853,20,20-24,1873,84
STAT,1821,94,na,1915,10.53144881692045
STAT,1837,27,40-44,1864,2.5634825114213085
SIM,1892,24,20-24,1916,100
STAT,1855,42,25-29,1897,0.4971861545268474
SIM,1802,88,na,1890,87
SIM,1870,35,25-29,1905,5
SIM,1871,19,35-39,1890,3
SIM,1938,21,30-34,1959,53
STAT,1817,89,na,1906,51.269536269111974
STAT,1820,36,30-34,1856,13.708869762742284
SIM,1922,11,na,1933,4686
SIM,1885,47,35-39,1932,1
SIM,1887,26,35-39,1913,21
STAT,1887,20,na,1907,2719.697040181934
STAT,1880,31,25-29,1911,11.025247909357708
STAT,1771,111,na,1882,0.001121736767763096
SIM,1874,28,20-24,1902,2
STAT,1896,41,30-34,1937,0.10805310695811056
SIM,1919,27,35-39,1946,23
STAT,1903,46,45-49,1949,0.19359932593372262
SIM,1910,34,na,1944,3659
SIM,1865,73,na,1938,1050
STAT,1884,24,20-24,1908,69.11677319962057
STAT,1912,49,20-24,1961,0.010770867248978692
STAT,1920,43,40-44,1963,0.2814635144183004
STAT,1877,30,na,1907,2545.217912872373
SIM,1890,40,na,1930,3048
STAT,1829,50,30-34,1879,0.0048447025070787785
STAT,1923,32,na,1955,4423.7926081934365
STAT,1863,19,35-39,1882,0.503652299763984
STAT,1828,52,35-39,1880,0.006502784736412443
STAT,1832,53,40-44,1885,0.007208818151325755
STAT,1870,12,na,1882,2641.078440341259
STAT,1943,24,50-100,1967,0.713753453373088
STAT,1912,60,na,1972,3353.9876742380384
SIM,1894,21,20-24,1915,91
SIM,1821,63,na,1884,979
STAT,1919,21,25-29,1940,103.52803765322277
STAT,1928,27,35-39,1955,18.866817364371943
STAT,1885,73,na,1958,1305.0629862938397
SIM,1842,18,30-34,1860,3
STAT,1876,50,45-49,1926,0.015507495547933963
SIM,1863,25,35-39,1888,13
STAT,1845,53,20-24,1898,5.67313589922658E-4
STAT,1838,43,na,1881,1784.2444221116662
STAT,1840,17,45-49,1857,0.06085989361818321
STAT,1861,36,15-19,1897,0.04756434537821366
STAT,1960,0,na,1960,5260.900505203733
STAT,1835,31,15-19,1866,0.13655025826815995
STAT,1864,33,35-39,1897,9.147317182413776
SIM,1911,43,40-44,1954,1
STAT,1787,103,na,1890,0.06527965572750807
STAT,1897,40,35-39,1937,0.17325372469279626
STAT,1839,42,40-44,1881,1.6360836372633234
STAT,1859,50,45-49,1909,0.011993389260044689
STAT,1890,21,40-44,1911,2.6070588204286986
SIM,1878,51,30-34,1929,1
STAT,1874,9,na,1883,2778.9329734590974
STAT,1878,71,na,1949,1417.3730209433704
STAT,1814,41,25-29,1855,2.315459055600539
STAT,1853,45,25-29,1898,0.048779029513807824
STAT,1844,37,25-29,1881,2.3576832854628953
STAT,1855,25,35-39,1880,8.691926459094653
SIM,1838,63,na,1901,1099
SIM,1927,21,25-29,1948,4
STAT,1858,41,50-100,1899,0.8585448937809899
STAT,1864,34,45-49,1898,1.5682476091182278
SIM,1875,27,25-29,1902,71
STAT,1887,39,45-49,1926,2.2558858898176566
SIM,1941,3,na,1944,4051
STAT,1849,46,15-19,1895,3.114256460568994E-4
SIM,1819,36,30-34,1855,12
SIM,1845,44,30-34,1889,2
STAT,1890,20,30-34,1910,22.350482061374674
SIM,1846,25,35-39,1871,12
STAT,1927,14,na,1941,5009.248719409368
STAT,1947,21,30-34,1968,33.152415789019656
STAT,1844,36,15-19,1880,0.05105841148400897
STAT,1869,35,na,1904,2342.459105638859
STAT,1873,48,na,1921,2297.6593419745636
STAT,1903,43,40-44,1946,0.22487125538935163
SIM,1852,21,15-19,1873,6
SIM,1931,28,na,1959,4767
STAT,1878,27,30-34,1905,26.73968301346039
SIM,1845,65,na,1910,1358
SIM,1878,39,45-49,1917,2
STAT,1849,31,45-49,1880,1.5840600325958492
STAT,1886,21,20-24,1907,74.63720280742528
STAT,1821,40,50-100,1861,1.9553247578652744
STAT,1895,27,30-34,1922,33.517384200227
STAT,1849,44,20-24,1893,0.121631904137759
SIM,1895,39,45-49,1934,6
SIM,1797,64,na,1861,795
SIM,1906,31,35-39,1937,15
STAT,1899,17,20-24,1916,24.766221172528912
SIM,1847,42,40-44,1889,2
STAT,1948,23,45-49,1971,1.3176513986617642
SIM,1936,27,35-39,1963,26
STAT,1766,107,na,1873,0.011026407380371861
STAT,1828,54,30-34,1882,0.003932495461986785
STAT,1830,28,40-44,1858,3.180679757825769
STAT,1849,35,na,1884,1910.9160514380496
STAT,1909,29,na,1938,3625.204153308351
SIM,1828,48,45-49,1876,1
SIM,1836,36,30-34,1872,4
SIM,1888,40,35-39,1928,3
STAT,1845,104,na,1949,0.05211587315516374
STAT,1916,50,na,1966,3810.6528908084347
SIM,1857,31,45-49,1888,1
STAT,1858,71,na,1929,1079.8639345724255
STAT,1862,25,na,1887,2110.2919074847937
SIM,1872,16,45-49,1888,1
SIM,1846,36,50-100,1882,2
STAT,1784,77,na,1861,279.15935149819904
STAT,1851,5,na,1856,2522.27008904
STAT,1853,27,25-29,1880,41.090047052086106
SIM,1827,30,20-24,1857,4
STAT,1829,35,35-39,1864,6.359237337325877
SIM,1857,26,20-24,1883,13
STAT,1850,33,35-39,1883,7.886484625062151
STAT,1869,52,25-29,1921,0.0034699869717034473
SIM,1766,92,na,1858,6
SIM,1861,27,25-29,1888,46
STAT,1939,15,45-49,1954,0.5113514028491596
STAT,1844,21,15-19,1865,3.2149795867891497
STAT,1825,34,50-100,1859,1.5645648496891582
STAT,1889,35,na,1924,2997.065334879766
SIM,1870,36,35-39,1906,16
STAT,1838,41,40-44,1879,1.957666702281265
STAT,1855,43,35-39,1898,1.3935994216251317
SIM,1840,38,50-100,1878,3
STAT,1838,43,35-39,1881,1.397922639279423
STAT,1836,40,50-100,1876,0.8026266502967264
STAT,1873,24,45-49,1897,0.7166896797443992
STAT,1870,27,25-29,1897,42.18562908523999
SIM,1822,88,na,1910,110
STAT,1818,46,15-19,1864,9.227336536024932E-4
SIM,1921,29,15-19,1950,1
STAT,1954,17,35-39,1971,5.291154302100273
STAT,1861,39,25-29,1900,2.4026443823600596
STAT,1913,34,na,1947,3805.863493378432
STAT,1938,34,40-44,1972,4.008749573074269
STAT,1924,21,35-39,1945,11.369883389060668
SIM,1867,6,na,1873,2572
STAT,1853,6,na,1859,2516.363616734149
STAT,1871,29,40-44,1900,3.0054559167687116
SIM,1898,27,20-24,1925,20
STAT,1789,103,na,1892,0.02854860417287682
STAT,1840,31,25-29,1871,9.070990633695393
STAT,1880,10,na,1890,2776.906182656823
STAT,1908,15,15-19,1923,9.018600672754735
STAT,1835,46,15-19,1881,3.1832441231991366E-4
SIM,1945,17,35-39,1962,5
STAT,1868,53,20-24,1921,7.074601673320885E-4
STAT,1828,36,30-34,1864,4.77653488209102
STAT,1881,30,30-34,1911,17.358542544495815
STAT,1937,17,35-39,1954,4.163899981460867
STAT,1939,33,45-49,1972,1.6368508660590875
STAT,1828,51,25-29,1879,0.0027290057331520517
STAT,1820,38,25-29,1858,6.618760568404067
SIM,1804,91,na,1895,39
STAT,1834,103,na,1937,0.09644461125934177
STAT,1885,40,45-49,1925,1.5386187649103193
SIM,1896,57,na,1953,2696
SIM,1883,19,30-34,1902,1
STAT,1831,27,45-49,1858,1.0986860538125967
STAT,1913,29,15-19,1942,0.7124706446966584
SIM,1893,22,15-19,1915,4
STAT,1934,9,na,1943,5491.146991038562
STAT,1899,19,15-19,1918,8.245927957403318
STAT,1895,42,25-29,1937,0.05928030051616617
STAT,1837,44,30-34,1881,0.8022792948710517
STAT,1871,40,15-19,1911,0.014095985689142604
STAT,1942,11,na,1953,4200.211259097575
STAT,1891,20,50-100,1911,0.5181114585110715
SIM,1922,17,50-100,1939,5
SIM,1845,26,30-34,1871,31
SIM,1846,41,40-44,1887,5
SIM,1891,34,na,1925,2993
STAT,1853,43,30-34,1896,0.957031616377576
SIM,1879,85,na,1964,602
STAT,1847,35,50-100,1882,1.014200403835698
SIM,1929,34,40-44,1963,12
STAT,1850,21,40-44,1871,1.8949427239647114
STAT,1869,50,30-34,1919,0.005946965883384027
SIM,1887,29,na,1916,2801
STAT,1818,43,na,1861,1484.9314225352216
STAT,1874,50,40-44,1924,0.01112277263056668
STAT,1854,44,30-34,1898,0.8680268400842485
SIM,1797,84,na,1881,81
STAT,1848,53,50-100,1901,0.011551371113865502
SIM,1898,32,45-49,1930,1
SIM,1880,42,na,1922,2251
STAT,1822,56,na,1878,1296.1007708852599
SIM,1857,28,15-19,1885,2
STAT,1838,25,35-39,1863,9.149177575534056
STAT,1885,22,15-19,1907,3.3576766986350797
STAT,1896,24,50-100,1920,0.5459982369339536
STAT,1875,51,40-44,1926,0.011075299962044963
SIM,1909,22,20-24,1931,100
STAT,1880,17,40-44,1897,0.19607749475689681
STAT,1885,7,na,1892,2651.676273536603
SIM,1869,49,45-49,1918,1
STAT,1889,55,na,1944,2605.6160775501276
SIM,1932,21,35-39,1953,1
STAT,1842,31,50-100,1873,0.8770547453216231
SIM,1900,36,na,1936,3424
STAT,1859,18,30-34,1877,1.4984653827559806
STAT,1899,35,20-24,1934,1.0870795367965613
SIM,1876,57,na,1933,2293
SIM,1850,40,na,1890,1762
SIM,1892,75,na,1967,1882
STAT,1881,35,na,1916,2345.715001482405
SIM,1843,31,15-19,1874,2
STAT,1909,49,na,1958,3422.711076160503
STAT,1849,28,15-19,1877,0.4145456542381074
SIM,1808,73,na,1881,632
STAT,1913,47,15-19,1960,3.6679501369482696E-4
STAT,1938,19,45-49,1957,0.5023322576989269
SIM,1872,75,na,1947,907
STAT,1856,54,40-44,1910,0.008198743214147576
SIM,1815,43,35-39,1858,1
STAT,1837,89,na,1926,70.04197245299498
SIM,1866,27,na,1893,2378
STAT,1880,32,35-39,1912,10.856514652468608
STAT,1877,44,30-34,1921,1.2000280588116508
STAT,1930,34,na,1964,4971.65614110991
SIM,1848,41,45-49,1889,9
STAT,1852,58,na,1910,1593.1557712692381
STAT,1874,34,35-39,1908,10.45765817238249
STAT,1862,20,20-24,1882,62.150516103819164
STAT,1869,39,50-100,1908,1.1970439968667896
STAT,1889,18,50-100,1907,0.061575053414288886
STAT,1802,106,na,1908,0.0038526249856719536
SIM,1825,73,na,1898,632
SIM,1843,30,na,1873,2025
STAT,1830,25,35-39,1855,13.341502898673541
SIM,1858,40,na,1898,1914
STAT,1858,18,15-19,1876,5.575286308152064
STAT,1896,40,20-24,1936,0.015008954606898448
SIM,1929,31,30-34,1960,29
SIM,1888,43,40-44,1931,6
STAT,1832,22,35-39,1854,9.620607268855956
STAT,1934,24,na,1958,5001.355283971743
SIM,1896,34,35-39,1930,1
SIM,1821,41,35-39,1862,5
STAT,1814,92,na,1906,19.40809377641332
SIM,1843,29,30-34,1872,37
STAT,1846,52,25-29,1898,0.0025194862060017803
SIM,1798,58,na,1856,1038
STAT,1829,53,35-39,1882,0.006008311384039341
SIM,1906,35,50-100,1941,3
STAT,1861,37,30-34,1898,4.4926648094112664
SIM,1845,73,na,1918,1018
STAT,1857,31,50-100,1888,0.742163485145976
STAT,1883,28,20-24,1911,11.701442691969676
STAT,1835,29,30-34,1864,24.112923106288743
SIM,1791,79,na,1870,277
STAT,1839,21,50-100,1860,0.3642250202163259
STAT,1820,39,35-39,1859,15.34494992997239
SIM,1898,12,na,1910,4004
SIM,1891,28,20-24,1919,19
STAT,1858,51,40-44,1909,0.008557699554103418
STAT,1860,25,15-19,1885,0.38506955770958723
STAT,1824,31,40-44,1855,10.210854928692596
SIM,1832,28,15-19,1860,1
STAT,1923,36,20-24,1959,0.3119267595648297
SIM,1842,17,15-19,1859,8
STAT,1894,43,20-24,1937,0.014367000514211394
STAT,1864,15,35-39,1879,0.5725320524590258
SIM,1897,59,na,1956,2610
SIM,1933,23,50-100,1956,1
SIM,1840,73,na,1913,717
SIM,1872,31,40-44,1903,7
STAT,1844,53,30-34,1897,0.004538636555766967
STAT,1856,48,na,1904,1779.0421903204597
SIM,1874,22,na,1896,2367
SIM,1837,35,35-39,1872,9
STAT,1794,67,na,1861,774.1276070505706
STAT,1854,29,35-39,1883,7.63096016812601
STAT,1927,4,na,1931,5119.272996964298
STAT,1867,27,25-29,1894,40.51341211405297
STAT,1875,54,45-49,1929,0.014776809217037818
SIM,1847,21,35-39,1868,5
STAT,1764,107,na,1871,0.012906887788440024
STAT,1830,42,20-24,1872,0.1369991459379863
STAT,1871,42,50-100,1913,1.0662562988153381
STAT,1896,26,35-39,1922,13.04513134621789
STAT,1834,35,15-19,1869,0.04799162726894494
STAT,1881,91,na,1972,215.40928382533193
STAT,1894,47,35-39,1941,0.10314493001351466
SIM,1880,70,na,1950,1296
SIM,1952,15,25-29,1967,63
STAT,1875,19,25-29,1894,5.901306929469289
STAT,1921,29,na,1950,4229.9746099929625
SIM,1863,42,25-29,1905,3
STAT,1932,24,50-100,1956,0.8774325892556741
STAT,1944,15,25-29,1959,47.605313160592104
SIM,1865,31,50-100,1896,1
STAT,1822,34,40-44,1856,9.925000236526081
SIM,1870,20,20-24,1890,81
SIM,1894,37,35-39,1931,19
STAT,1876,32,15-19,1908,0.15001642818321395
SIM,1862,29,35-39,1891,16
SIM,1962,6,na,1968,5404
SIM,1882,34,35-39,1916,17
SIM,1909,49,na,1958,3280
SIM,1877,39,50-100,1916,6
STAT,1856,109,na,1965,0.003934669345832199
STAT,1890,20,na,1910,2967.6137560827992
STAT,1865,47,45-49,1912,0.21749434866445058
SIM,1904,26,na,1930,3727
STAT,1834,53,45-49,1887,0.00981746094977644
STAT,1819,37,50-100,1856,3.4803939629854095
SIM,1888,22,35-39,1910,7
SIM,1926,25,25-29,1951,105
SIM,1848,29,50-100,1877,3
STAT,1880,19,35-39,1899,0.5850778801698926
SIM,1867,29,na,1896,2257
STAT,1855,41,40-44,1896,1.751524292066659
STAT,1847,16,45-49,1863,0.06395400188544927
SIM,1937,13,na,1950,4598
STAT,1839,21,35-39,1860,5.212059429258878
STAT,1835,23,na,1858,2102.2259568860395
SIM,1832,31,40-44,1863,7
SIM,1890,44,40-44,1934,6
SIM,1967,4,na,1971,5236
STAT,1873,39,45-49,1912,2.041012068057902
STAT,1890,26,50-100,1916,0.8006501189234487
STAT,1810,46,15-19,1856,0.0012798846482217935
STAT,1888,34,35-39,1922,12.108879542033387
SIM,1902,20,50-100,1922,4
STAT,1891,22,40-44,1913,2.6318462667037763
STAT,1874,52,35-39,1926,0.008919132405637466
SIM,1885,73,na,1958,1359
STAT,1868,37,15-19,1905,0.05471517154751865
STAT,1870,42,20-24,1912,0.15818332292101028
STAT,1832,58,na,1890,1321.4859088686173
STAT,1881,32,25-29,1913,10.102049197432104
SIM,1883,21,45-49,1904,2
STAT,1876,47,15-19,1923,4.1940694390796106E-4
STAT,1832,38,15-19,1870,0.047174951461846866
STAT,1896,44,35-39,1940,0.1671382256757416
SIM,1881,39,45-49,1920,1
STAT,1846,19,35-39,1865,0.4871363587107433
STAT,1886,33,15-19,1919,0.15312460522326482
SIM,1878,36,35-39,1914,13
STAT,1836,48,na,1884,1446.840943974073
STAT,1897,30,na,1927,3281.17986268613
SIM,1840,22,35-39,1862,10
STAT,1882,44,40-44,1926,2.205328039481695
STAT,1803,51,20-24,1854,0.003041400038661339
SIM,1881,24,45-49,1905,1
SIM,1839,65,na,1904,1214
STAT,1819,42,15-19,1861,0.029809849298406615
SIM,1946,19,45-49,1965,1
STAT,1806,103,na,1909,0.05099576013792488
SIM,1841,48,50-100,1889,2
SIM,1870,32,20-24,1902,4
STAT,1918,25,25-29,1943,71.96663910539807
STAT,1956,15,45-49,1971,0.6745154719025364
STAT,1865,53,na,1918,1961.6142861320839
STAT,1806,48,45-49,1854,0.8287596026574174
STAT,1849,29,25-29,1878,38.373077318394934
SIM,1829,43,35-39,1872,5
SIM,1862,42,35-39,1904,1
STAT,1891,19,15-19,1910,7.4551295007714025
SIM,1928,20,30-34,1948,77
SIM,1849,19,25-29,1868,7
SIM,1954,5,na,1959,4723
STAT,1895,40,30-34,1935,1.5456614848293717
STAT,1854,81,na,1935,413.87661099806917
STAT,1873,51,35-39,1924,0.008946517726422189
STAT,1836,30,20-24,1866,2.1714590247698977
STAT,1861,16,50-100,1877,0.04774920496143048
SIM,1822,41,25-29,1863,3
STAT,1836,49,40-44,1885,0.10870495190813062
STAT,1839,54,35-39,1893,0.005778110477759641
STAT,1854,50,50-100,1904,0.011725066168927161
STAT,1907,14,na,1921,3855.783559904295
STAT,1818,51,na,1869,1349.709367550053
STAT,1850,50,50-100,1900,0.0115236143006196
SIM,1885,44,30-34,1929,3
STAT,1870,26,15-19,1896,0.4540133444099474
STAT,1804,52,20-24,1856,0.002164434282101183
STAT,1924,22,45-49,1946,1.3545758349882606
SIM,1938,24,35-39,1962,1
SIM,1837,78,na,1915,465
STAT,1915,27,50-100,1942,1.0359924393264304
SIM,1911,46,45-49,1957,1
STAT,1861,19,30-34,1880,1.526153171679772
SIM,1862,45,na,1907,2067
STAT,1807,99,na,1906,0.8003544587165478
SIM,1932,22,45-49,1954,2
SIM,1832,47,na,1879,1569
STAT,1866,31,45-49,1897,1.6475903807828496
SIM,1848,30,na,1878,2030
STAT,1833,48,50-100,1881,0.17096591304507613
SIM,1832,86,na,1918,76
SIM,1844,49,40-44,1893,1
STAT,1847,49,15-19,1896,3.054121881109509E-4
STAT,1812,44,25-29,1856,1.6128475767998454
STAT,1896,37,na,1933,3174.3339596117585
SIM,1836,39,35-39,1875,10
STAT,1853,42,20-24,1895,0.13300057128345924
SIM,1831,30,40-44,1861,6
SIM,1894,19,35-39,1913,2
STAT,1884,39,20-24,1923,0.7701741115777837
SIM,1843,19,na,1862,2310
STAT,1902,49,50-100,1951,0.19514689264887494
SIM,1849,37,25-29,1886,5
STAT,1801,74,na,1875,444.4578923656228
STAT,1833,34,15-19,1867,0.1190520049854951
SIM,1890,26,40-44,1916,3
STAT,1761,100,na,1861,0.09666632629134257
SIM,1863,22,30-34,1885,32
STAT,1875,19,30-34,1894,1.659848867924463
STAT,1850,18,15-19,1868,5.42280453064118
SIM,1869,43,35-39,1912,4
STAT,1827,37,25-29,1864,3.7426725178181357
STAT,1847,34,45-49,1881,1.4230825909347313
SIM,1819,37,40-44,1856,8
STAT,1838,100,na,1938,0.7800459781033844
SIM,1818,38,50-100,1856,7
SIM,1827,28,35-39,1855,17
STAT,1845,76,na,1921,740.2509496571543
STAT,1837,45,40-44,1882,0.12156528546868013
STAT,1889,63,na,1952,2248.4796301596843
SIM,1820,41,50-100,1861,3
STAT,1864,27,50-100,1891,0.5802536508338769
STAT,1878,28,40-44,1906,3.1696764920706895
SIM,1886,28,40-44,1914,9
STAT,1815,53,40-44,1868,0.02651995015168915
STAT,1900,47,35-39,1947,0.11114138317068811
SIM,1856,44,35-39,1900,7
SIM,1869,55,na,1924,2094
STAT,1851,47,15-19,1898,3.2846816641246166E-4
SIM,1828,73,na,1901,731
SIM,1944,20,15-19,1964,6
STAT,1844,91,na,1935,44.90442299066929
SIM,1857,29,25-29,1886,60
STAT,1888,61,na,1949,2253.6122494246515
STAT,1820,35,15-19,1855,0.1527070440925013
STAT,1840,32,35-39,1872,8.876021973939046
SIM,1850,12,na,1862,2273
SIM,1853,36,35-39,1889,12
SIM,1931,1,na,1932,5354
STAT,1870,20,na,1890,2372.647353058573
SIM,1914,20,30-34,1934,41
STAT,1901,49,45-49,1950,0.18594622611344044
STAT,1845,36,35-39,1881,5.867151422171864
STAT,1819,46,35-39,1865,0.2814223150213731
SIM,1857,42,50-100,1899,2
STAT,1824,46,45-49,1870,0.27878126719585267
STAT,1848,81,na,1929,420.3541558656755
STAT,1859,32,15-19,1891,0.11602166275279241
STAT,1954,16,na,1970,4642.57476301788
STAT,1849,47,25-29,1896,0.04450988731643088
SIM,1829,26,45-49,1855,2
STAT,1876,48,30-34,1924,0.10069068321552901
STAT,1906,20,30-34,1926,26.60629954492616
SIM,1878,60,na,1938,2148
STAT,1817,48,20-24,1865,0.026398452825236823
STAT,1824,51,na,1875,1348.8958873801432
STAT,1869,53,35-39,1922,0.008342993377922525
STAT,1891,37,45-49,1928,2.517769599887154
STAT,1898,39,20-24,1937,0.22722112673758837
STAT,1888,17,45-49,1905,0.0787802605863613
STAT,1871,22,15-19,1893,3.3337450372259982
SIM,1825,53,na,1878,1333
SIM,1873,32,40-44,1905,7
STAT,1876,47,20-24,1923,0.012582219384977977
STAT,1812,43,15-19,1855,0.036876596848277224
SIM,1840,38,45-49,1878,1
STAT,1822,53,50-100,1875,0.0202920969787148
STAT,1903,24,na,1927,3408.2393167732002
STAT,1949,16,15-19,1965,53.86536963644809
STAT,1832,38,45-49,1870,1.6747105777315185
SIM,1817,39,30-34,1856,3
STAT,1927,42,50-100,1969,0.15029501674443047
STAT,1890,40,na,1930,2911.983993494923
STAT,1894,10,na,1904,3399.072952997428
SIM,1883,41,50-100,1924,3
STAT,1936,1,na,1937,4077.8964348971845
STAT,1901,48,35-39,1949,0.11124375586580246
SIM,1849,35,na,1884,1923
STAT,1835,47,30-34,1882,0.07605392258221946
SIM,1875,24,15-19,1899,3
SIM,1904,46,na,1950,3461
SIM,1864,36,40-44,1900,10
STAT,1837,47,50-100,1884,0.1699832219574622
SIM,1904,16,35-39,1920,1
STAT,1849,29,30-34,1878,22.84336946626162
SIM,1965,3,na,1968,4973
STAT,1929,22,25-29,1951,119.13801218157188
STAT,1881,33,35-39,1914,9.945946598898987
STAT,1891,45,na,1936,2870.406823429863
STAT,1886,37,35-39,1923,7.637426191839286
SIM,1833,24,15-19,1857,2
SIM,1874,43,45-49,1917,4
STAT,1852,16,25-29,1868,5.554059958443402
STAT,1855,40,30-34,1895,0.900213574354322
SIM,1906,32,45-49,1938,4
STAT,1803,52,30-34,1855,0.024043773827604257
STAT,1949,0,na,1949,5243.090178300198
SIM,1860,16,25-29,1876,10
STAT,1874,23,50-100,1897,0.42342649084263156
STAT,1912,45,50-100,1957,0.22278712086302188
SIM,1870,33,30-34,1903,21
STAT,1853,46,35-39,1899,0.11772310777061512
SIM,1845,47,50-100,1892,1
STAT,1894,4,na,1898,3452.0363633138563
STAT,1895,48,35-39,1943,0.10379140510870095
STAT,1846,15,na,1861,2086.5892195154424
STAT,1878,23,50-100,1901,0.43167880290643645
STAT,1874,35,15-19,1909,0.05904392132997872
SIM,1893,60,na,1953,2461
STAT,1832,23,45-49,1855,0.7334615433056315
STAT,1809,105,na,1914,0.014959146550223948
STAT,1793,82,na,1875,181.48474938479814
STAT,1825,39,15-19,1864,0.08051906476032496
STAT,1831,54,35-39,1885,0.005953080348781983
SIM,1883,18,15-19,1901,7
STAT,1828,39,35-39,1867,5.943929265996873
STAT,1874,53,45-49,1927,0.014872880066461773
STAT,1855,22,30-34,1877,16.13123011862797
STAT,1886,36,50-100,1922,1.3321123109942807
STAT,1777,95,na,1872,2.978947402871264
SIM,1894,36,50-100,1930,3
SIM,1828,29,35-39,1857,2
STAT,1814,42,35-39,1856,6.207156872718322
STAT,1936,20,15-19,1956,5.19429498195938
SIM,1937,22,25-29,1959,3
STAT,1919,26,50-100,1945,1.101248334512835
STAT,1875,36,15-19,1911,0.05907740526986299
STAT,1867,24,15-19,1891,3.139800402520983
STAT,1948,16,na,1964,4298.837240277508
STAT,1886,19,35-39,1905,0.5893253018080782
SIM,1842,45,na,1887,1685
SIM,1871,34,30-34,1905,28
SIM,1944,0,na,1944,4573
SIM,1862,85,na,1947,168
STAT,1845,32,15-19,1877,0.13230027852520032
SIM,1921,18,na,1939,4675
STAT,1872,86,na,1958,295.4891605969815
SIM,1829,44,45-49,1873,2
SIM,1880,22,35-39,1902,8
STAT,1813,41,35-39,1854,6.870615611482808
SIM,1850,27,20-24,1877,12
STAT,1929,40,25-29,1969,0.09458340462129657
STAT,1842,27,20-24,1869,11.377000247140055
STAT,1850,36,45-49,1886,1.5391553839736696
STAT,1857,39,30-34,1896,4.203439438127465
STAT,1839,39,15-19,1878,0.04536057424221846
STAT,1861,83,na,1944,334.64742895079513
SIM,1857,29,30-34,1886,36
STAT,1878,46,40-44,1924,0.18230677967746342
SIM,1866,34,20-24,1900,4
SIM,1881,38,50-100,1919,1
STAT,1939,30,40-44,1969,4.0778212261285915
SIM,1822,42,35-39,1864,5
SIM,1858,9,na,1867,2397
STAT,1873,1,na,1874,3607.9522008158588
STAT,1856,68,na,1924,1223.785943978503
STAT,1892,48,15-19,1940,2.8486107436839856E-4
SIM,1878,36,40-44,1914,8
STAT,1858,49,20-24,1907,0.009505394843445581
STAT,1820,35,20-24,1855,2.096250977891985
SIM,1833,40,na,1873,1773
SIM,1784,89,na,1873,34
STAT,1841,25,40-44,1866,2.787018530682326
STAT,1851,50,40-44,1901,0.00881030801028968
SIM,1874,31,45-49,1905,5
STAT,1823,41,na,1864,1552.6587689635628
STAT,1941,23,50-100,1964,0.6934989510454214
STAT,1910,0,na,1910,4538.0075240775395
SIM,1831,93,na,1924,19
STAT,1842,48,na,1890,1742.1665616559737
SIM,1929,34,35-39,1963,26
STAT,1860,26,25-29,1886,35.64457559712568
STAT,1921,44,50-100,1965,0.13457511498551517
SIM,1827,88,na,1915,66
STAT,1883,42,35-39,1925,1.810330445791976
STAT,1797,95,na,1892,3.3480224014667437
STAT,1819,36,na,1855,1741.5267347074653
SIM,1852,37,30-34,1889,2
SIM,1887,20,na,1907,2803
STAT,1916,6,na,1922,4325.330350694422
STAT,1867,24,20-24,1891,65.58651110893528
STAT,1848,44,35-39,1892,1.388605479929166
STAT,1882,76,na,1958,1046.4168743817515
SIM,1826,29,30-34,1855,30
STAT,1924,19,15-19,1943,54.84275171668053
STAT,1862,39,40-44,1901,3.7631639465743096
SIM,1866,98,na,1964,10
SIM,1930,19,15-19,1949,63
STAT,1866,43,45-49,1909,1.3981205828311698
SIM,1880,42,25-29,1922,2
STAT,1872,42,25-29,1914,0.6557520589667638
STAT,1822,37,45-49,1859,3.7790296643500394
STAT,1830,25,30-34,1855,34.81882888806192
STAT,1846,51,40-44,1897,0.007564572548192808
STAT,1910,38,35-39,1948,2.3476488619172793
STAT,1890,71,na,1961,1844.7502064036855
STAT,1812,89,na,1901,47.91556366035708
STAT,1870,43,na,1913,2288.263020397461
STAT,1881,27,50-100,1908,0.6309141478230706
SIM,1932,19,15-19,1951,52
STAT,1895,23,15-19,1918,4.377468788858605
SIM,1891,42,35-39,1933,3
SIM,1837,19,35-39,1856,1
SIM,1889,32,na,1921,3086
STAT,1909,17,25-29,1926,8.667029583922776
STAT,1841,31,40-44,1872,3.925564631233852
STAT,1861,52,20-24,1913,6.187311547566787E-4
STAT,1922,19,15-19,1941,53.304599039961936
STAT,1851,84,na,1935,274.4529154941477
STAT,1900,20,35-39,1920,8.300306138570583
STAT,1833,37,20-24,1870,0.6383079166818324
STAT,1898,60,na,1958,2700.2484881298783
STAT,1880,50,na,1930,2341.4301866966
STAT,1857,41,45-49,1898,1.1977968381472024
STAT,1891,19,45-49,1910,0.08205974674939187
STAT,1816,51,35-39,1867,0.017280599858256192
STAT,1893,17,na,1910,3268.50424234055
SIM,1867,20,na,1887,2358
STAT,1916,39,na,1955,3892.0473156917797
SIM,1879,47,40-44,1926,2
STAT,1876,18,30-34,1894,1.6746298517223122
STAT,1821,63,na,1884,967.1896644956801
STAT,1923,26,45-49,1949,2.030708445134586
SIM,1879,32,40-44,1911,8
STAT,1834,92,na,1926,27.989136660663654
SIM,1931,26,45-49,1957,3
STAT,1844,37,30-34,1881,4.364222275771091
STAT,1845,18,35-39,1863,0.5386884151864434
SIM,1853,18,35-39,1871,1
STAT,1872,16,50-100,1888,0.05055327550900538
SIM,1849,16,20-24,1865,14
SIM,1822,40,40-44,1862,4
SIM,1918,15,20-24,1933,32
STAT,1922,37,15-19,1959,0.022295793475662982
STAT,1940,23,40-44,1963,3.4931451023752866
SIM,1841,37,20-24,1878,2
STAT,1825,56,na,1881,1321.7687993130212
STAT,1828,32,15-19,1860,0.14051934144063635
SIM,1943,25,25-29,1968,4
SIM,1897,30,35-39,1927,18
STAT,1861,45,50-100,1906,0.20909702983640527
STAT,1856,24,45-49,1880,0.6392700190316019
SIM,1917,17,25-29,1934,9
STAT,1874,38,20-24,1912,0.7989044773133291
STAT,1872,51,50-100,1923,0.01551538061915646
STAT,1892,15,15-19,1907,7.622943950299731
STAT,1820,51,20-24,1871,0.0013199809047878847
STAT,1860,43,45-49,1903,1.2298416660877431
SIM,1878,91,na,1969,117
STAT,1851,35,15-19,1886,0.04780720922660667
STAT,1898,46,50-100,1944,0.19166424031063317
STAT,1895,41,15-19,1936,0.0012821922189491424
STAT,1763,100,na,1863,0.07245418634292417
STAT,1865,84,na,1949,308.0137910445434
STAT,1834,81,na,1915,363.4032329763959
STAT,1888,31,30-34,1919,21.142823189824487
STAT,1869,33,15-19,1902,0.13966662779678213
SIM,1894,37,30-34,1931,12
STAT,1814,40,40-44,1854,8.515924858698178
STAT,1914,33,40-44,1947,4.0021236699695555
SIM,1877,37,35-39,1914,8
SIM,1801,86,na,1887,70
STAT,1869,37,35-39,1906,6.96617999246894
SIM,1833,42,45-49,1875,3
STAT,1861,91,na,1952,48.84816918104463
SIM,1909,22,15-19,1931,3
STAT,1886,37,30-34,1923,5.754942583527196
STAT,1895,35,50-100,1930,1.6496586739719128
STAT,1873,17,na,1890,2612.1070861125763
STAT,1853,30,20-24,1883,2.3830159340606634
STAT,1881,31,40-44,1912,4.2946848543342195
STAT,1865,45,15-19,1910,3.740531586162169E-4
SIM,1897,50,na,1947,2925
STAT,1872,52,30-34,1924,0.006053663868098901
SIM,1922,33,40-44,1955,5
SIM,1833,71,na,1904,843
SIM,1870,39,40-44,1909,9
SIM,1927,34,na,1961,4655
SIM,1923,21,na,1944,4167
STAT,1841,63,na,1904,1317.4457988292384
STAT,1836,27,25-29,1863,34.07239942748809
SIM,1844,27,25-29,1871,58
STAT,1805,51,25-29,1856,0.012735085697263721
STAT,1892,21,45-49,1913,0.8942605096358376
STAT,1910,14,na,1924,3978.2584639793263
STAT,1889,30,35-39,1919,12.864136931330071
STAT,1851,17,15-19,1868,5.952770525654195
STAT,1851,29,15-19,1880,0.43199697220056277
STAT,1870,27,30-34,1897,25.112969266576336
SIM,1852,55,na,1907,1686
STAT,1849,66,na,1915,1272.4627990132751
SIM,1875,24,20-24,1899,67
SIM,1882,38,20-24,1920,2
STAT,1815,41,40-44,1856,7.515867007976945
STAT,1904,39,20-24,1943,0.2408116136764735
STAT,1821,50,25-29,1871,0.005578112525234954
STAT,1912,33,40-44,1945,3.9116053806801467
SIM,1902,21,20-24,1923,98
STAT,1807,47,20-24,1854,0.05259603812403226
STAT,1935,25,25-29,1960,91.57789942622733
STAT,1914,15,40-44,1929,0.29657664582308385
SIM,1816,42,50-100,1858,2
SIM,1823,35,40-44,1858,8
SIM,1838,40,na,1878,1673
STAT,1799,99,na,1898,0.6145388140613858
STAT,1871,26,35-39,1897,9.783940926575102
STAT,1856,39,45-49,1895,1.5803241645507697
SIM,1920,33,40-44,1953,9
STAT,1848,10,na,1858,2329.210779812012
STAT,1898,71,na,1969,2212.0699188810813
STAT,1825,42,45-49,1867,2.043567218983581
STAT,1850,43,na,1893,1725.9669918298925
SIM,1896,31,30-34,1927,27
STAT,1902,43,25-29,1945,0.06368966226902292
SIM,1922,15,40-44,1937,2
SIM,1833,30,45-49,1863,4
STAT,1882,26,40-44,1908,2.987438584142047
SIM,1912,39,20-24,1951,1
SIM,1821,83,na,1904,168
STAT,1892,33,45-49,1925,2.2201757449225843
SIM,1880,21,25-29,1901,102
STAT,1857,52,35-39,1909,0.006822486115807663
STAT,1856,42,40-44,1898,1.7990103585425232
SIM,1833,24,45-49,1857,1
STAT,1915,31,35-39,1946,9.536178446471295
SIM,1891,5,na,1896,3383
SIM,1881,20,30-34,1901,29
STAT,1897,22,40-44,1919,2.8423914978513216
STAT,1852,49,25-29,1901,0.045433801962540786
SIM,1883,47,na,1930,2345
STAT,1825,30,45-49,1855,4.234776924665398
STAT,1930,29,20-24,1959,23.649445313018553
STAT,1932,31,35-39,1963,12.396136205701284
STAT,1906,23,35-39,1929,8.638013542905455
SIM,1873,29,45-49,1902,2
SIM,1891,65,na,1956,2149
SIM,1868,29,35-39,1897,17
STAT,1863,38,45-49,1901,1.7742335529461917
STAT,1851,32,45-49,1883,1.497411790136971
STAT,1811,47,50-100,1858,0.6822673944697393
STAT,1877,25,20-24,1902,12.497097030702642
SIM,1917,13,na,1930,4241
STAT,1812,45,35-39,1857,0.34288083887800697
STAT,1847,88,na,1935,107.0555302838358
SIM,1844,30,20-24,1874,3
STAT,1832,35,50-100,1867,1.0654273559809257
STAT,1846,18,na,1864,2049.9359261259197
STAT,1892,15,45-49,1907,0.08390690597415898
SIM,1849,34,20-24,1883,3
STAT,1821,52,20-24,1873,0.0011166719735034405
SIM,1832,55,na,1887,1326
STAT,1836,42,20-24,1878,0.117603939538568
SIM,1838,31,40-44,1869,7
STAT,1819,46,30-34,1865,0.194583429155169
STAT,1845,54,30-34,1899,0.0045231067444356675
STAT,1889,45,35-39,1934,0.17817894113993366
SIM,1923,31,35-39,1954,18
STAT,1865,73,na,1938,1099.7435472560112
SIM,1851,14,na,1865,2315
STAT,1880,37,35-39,1917,7.5823812630576155
SIM,1869,42,25-29,1911,1
SIM,1919,30,30-34,1949,22
SIM,1919,37,50-100,1956,1
SIM,1841,32,50-100,1873,1
SIM,1863,47,na,1910,1949
SIM,1890,41,35-39,1931,3
STAT,1842,41,35-39,1883,1.4881382426144003
SIM,1821,46,35-39,1867,1
STAT,1840,30,40-44,1870,3.880743591133164
SIM,1844,42,20-24,1886,1
STAT,1841,43,40-44,1884,1.7037676299398996
STAT,1842,23,35-39,1865,5.730506874251693
STAT,1850,52,45-49,1902,0.010858194838065011
STAT,1916,36,50-100,1952,0.44087323552820723
STAT,1860,36,50-100,1896,1.0211113112424484
STAT,1842,30,45-49,1872,1.6866563958401168
STAT,1878,40,30-34,1918,1.2331063159210374
STAT,1894,31,20-24,1925,3.561498205042897
SIM,1886,40,30-34,1926,1
SIM,1928,17,35-39,1945,9
SIM,1914,23,35-39,1937,11
STAT,1882,41,35-39,1923,1.8078691870836294
SIM,1822,48,na,1870,1349
STAT,1813,46,35-39,1859,0.35781973437934594
STAT,1831,41,25-29,1872,0.551554198069846
SIM,1889,42,45-49,1931,1
STAT,1827,40,20-24,1867,0.19540164719948103
SIM,1865,38,20-24,1903,1
SIM,1850,23,35-39,1873,7
SIM,1827,37,50-100,1864,2
STAT,1897,37,40-44,1934,5.971074000684976
STAT,1852,17,50-100,1869,0.047734974907128275
STAT,1851,20,45-49,1871,0.696996230117427
STAT,1941,21,35-39,1962,9.930521890939897
SIM,1889,36,45-49,1925,4
STAT,1818,74,na,1892,565.5669018926343
SIM,1858,28,30-34,1886,28
STAT,1863,32,35-39,1895,9.058171637274164
STAT,1866,25,15-19,1891,0.4298169313411156
STAT,1902,39,na,1941,3381.778797894159
SIM,1885,31,20-24,1916,3
SIM,1859,38,25-29,1897,4
STAT,1847,52,40-44,1899,0.00816589417755746
SIM,1866,37,25-29,1903,1
SIM,1891,24,35-39,1915,10
SIM,1841,33,35-39,1874,12
SIM,1911,6,na,1917,4140
SIM,1934,16,na,1950,5235
STAT,1821,71,na,1892,703.3588352110318
SIM,1909,3,na,1912,3867
STAT,1833,51,na,1884,1486.1931984791752
SIM,1850,31,50-100,1881,2
SIM,1860,73,na,1933,1171
STAT,1842,25,na,1867,2128.36354409939
STAT,1872,25,40-44,1897,3.083532080283988
STAT,1878,49,45-49,1927,0.24536692894085582
SIM,1824,33,35-39,1857,13
SIM,1885,25,20-24,1910,21
STAT,1854,47,35-39,1901,0.10665010943379909
SIM,1820,53,na,1873,1482
SIM,1845,96,na,1941,3
STAT,1866,28,15-19,1894,0.4254178016891893
SIM,1848,17,15-19,1865,5
SIM,1850,41,35-39,1891,1
SIM,1874,25,15-19,1899,1
SIM,1911,28,na,1939,3911
STAT,1787,74,na,1861,525.7237544597
STAT,1791,70,na,1861,592.3424177332229
STAT,1824,82,na,1906,256.90743063494295
STAT,1877,31,20-24,1908,2.8717565659470092
STAT,1832,50,35-39,1882,0.006255947192580098
STAT,1862,35,25-29,1897,2.5240405260345553
STAT,1929,26,40-44,1955,5.95242914940878
STAT,1811,48,25-29,1859,0.15722807125462832
STAT,1833,33,35-39,1866,8.558135071297365
STAT,1811,64,na,1875,888.8414822122044
SIM,1874,29,30-34,1903,32
SIM,1895,72,na,1967,1980
STAT,1773,85,na,1858,81.93539067737774
STAT,1896,42,40-44,1938,0.21018987014914123
STAT,1880,30,15-19,1910,0.15389238838051525
SIM,1853,36,30-34,1889,7
STAT,1905,37,15-19,1942,0.01785762682436482
STAT,1857,38,15-19,1895,0.04451749278572927
SIM,1869,40,30-34,1909,2
STAT,1909,32,20-24,1941,2.3738680497652553
SIM,1859,25,na,1884,2378
SIM,1937,26,40-44,1963,8
STAT,1831,51,30-34,1882,0.004368142721428096
STAT,1898,42,45-49,1940,0.14320003825106958
SIM,1870,17,25-29,1887,12
STAT,1862,17,25-29,1879,5.636009890212381
STAT,1883,24,35-39,1907,5.80454746826463
STAT,1878,47,50-100,1925,0.25957728655996565
SIM,1801,94,na,1895,5
STAT,1914,17,50-100,1931,0.0790727700488293
STAT,1845,36,30-34,1881,4.4210076425403075
STAT,1833,51,35-39,1884,0.005986139608176556
SIM,1816,48,na,1864,1503
STAT,1897,43,40-44,1940,0.2115157191588112
SIM,1920,0,na,1920,4749
SIM,1940,31,35-39,1971,15
STAT,1877,43,20-24,1920,0.1668239720574138
STAT,1870,46,35-39,1916,0.14001317582355408
STAT,1821,38,40-44,1859,9.006881591167092
STAT,1832,38,50-100,1870,1.031415853872095
SIM,1931,23,40-44,1954,8
SIM,1828,41,25-29,1869,1
STAT,1858,16,20-24,1874,16.853232058147594
SIM,1879,35,45-49,1914,2
SIM,1929,33,50-100,1962,3
STAT,1851,30,50-100,1881,0.8032858493853381
STAT,1896,45,na,1941,3062.1210137860626
STAT,1909,41,50-100,1950,0.11271216472243728
STAT,1773,82,na,1855,154.5763
STAT,1955,16,40-44,1971,1.8943665690628007
SIM,1850,29,na,1879,1944
SIM,1883,39,na,1922,2424
SIM,1945,8,na,1953,4704
STAT,1856,17,na,1873,2173.5493775138016
STAT,1940,26,45-49,1966,1.79803419782883
SIM,1834,23,20-24,1857,59
STAT,1887,32,25-29,1919,11.708662985760956
SIM,1842,85,na,1927,239
STAT,1830,28,35-39,1858,10.245200036135254
STAT,1843,26,25-29,1869,42.33012093747403
STAT,1874,98,na,1972,24.58809892338156
STAT,1925,36,20-24,1961,0.32308948308838276
SIM,1922,18,45-49,1940,2
STAT,1879,41,30-34,1920,1.23150162379699
STAT,1877,46,25-29,1923,0.061118787303220304
STAT,1886,38,na,1924,2531.394353933177
STAT,1854,100,na,1954,0.8125349326115017
STAT,1863,10,na,1873,2467.0704878687525
STAT,1851,53,45-49,1904,0.011780754559841247
SIM,1817,78,na,1895,312
STAT,1805,56,na,1861,1286.8850320110973
STAT,1854,26,35-39,1880,8.568923116510495
STAT,1914,18,45-49,1932,0.10515413252173515
STAT,1832,103,na,1935,0.09590074790482493
STAT,1900,7,na,1907,3683.8426939998426
SIM,1832,78,na,1910,334
STAT,1885,50,50-100,1935,0.015592149624124039
SIM,1860,28,20-24,1888,6
STAT,1829,51,40-44,1880,0.00840025285861333
SIM,1876,65,na,1941,1887
STAT,1835,35,30-34,1870,5.014315296695089
SIM,1851,26,25-29,1877,46
SIM,1848,35,45-49,1883,2
SIM,1895,32,25-29,1927,18
STAT,1850,33,40-44,1883,3.377231664242094
STAT,1871,26,30-34,1897,25.534257089371433
STAT,1903,32,na,1935,3460.543943427381
SIM,1918,18,25-29,1936,72
STAT,1841,22,50-100,1863,0.3814250523809152
SIM,1832,25,40-44,1857,4
STAT,1830,40,25-29,1870,0.5699420720750324
SIM,1843,17,30-34,1860,3
STAT,1852,28,20-24,1880,10.928788732349975
SIM,1907,14,na,1921,3933
SIM,1907,28,20-24,1935,1
STAT,1866,46,15-19,1912,3.774563912777666E-4
SIM,1883,33,45-49,1916,6
SIM,1917,21,na,1938,3890
STAT,1912,36,45-49,1948,0.6820251321478867
SIM,1866,58,na,1924,2050
STAT,1900,49,30-34,1949,0.07559425938124008
STAT,1862,53,20-24,1915,6.305203393851723E-4
STAT,1804,50,25-29,1854,0.010822668826645954
SIM,1887,41,30-34,1928,2
SIM,1845,42,35-39,1887,1
STAT,1806,97,na,1903,1.9089401070553258
SIM,1839,25,na,1864,2130
SIM,1927,25,40-44,1952,10
SIM,1862,26,35-39,1888,13
STAT,1834,29,15-19,1863,0.3946337106581445
SIM,1828,27,40-44,1855,3
SIM,1811,53,na,1864,1063
STAT,1911,50,na,1961,3515.68926135364
STAT,1867,17,50-100,1884,0.04796741598462105
SIM,1861,5,na,1866,3120
SIM,1944,23,na,1967,3936
STAT,1815,50,35-39,1865,0.023031083634353446
STAT,1837,58,na,1895,1318.5167515432004
STAT,1951,19,na,1970,4468.392977511718
STAT,1891,16,40-44,1907,0.23157354076388675
SIM,1833,28,30-34,1861,29
SIM,1836,37,na,1873,1953
STAT,1852,46,20-24,1898,0.00969466706263838
STAT,1910,35,30-34,1945,1.794699137545383
STAT,1879,32,50-100,1911,0.9770430280026494
STAT,1919,25,40-44,1944,5.174177028322799
SIM,1816,42,45-49,1858,4
STAT,1837,42,35-39,1879,1.4246675476224007
SIM,1849,32,na,1881,1937
STAT,1869,43,na,1912,2259.915615464259
STAT,1872,28,45-49,1900,1.131210906557675
SIM,1917,4,na,1921,4327
STAT,1892,19,30-34,1911,2.0269320945865212
SIM,1778,89,na,1867,55
SIM,1920,36,45-49,1956,1
STAT,1848,48,20-24,1896,0.009210791087396962
SIM,1880,28,45-49,1908,1
STAT,1861,25,30-34,1886,21.69214529632061
STAT,1879,23,30-34,1902,18.935525072268927
STAT,1880,16,35-39,1896,0.5896771592529008
SIM,1895,46,50-100,1941,1
SIM,1838,43,50-100,1881,3
STAT,1887,46,50-100,1933,0.28155067110544624
STAT,1893,29,20-24,1922,15.0737060644339
SIM,1864,21,40-44,1885,2
SIM,1827,49,35-39,1876,1
STAT,1862,32,20-24,1894,2.3473363008278896
STAT,1875,33,45-49,1908,1.8180955379044648
STAT,1914,36,45-49,1950,0.6978078459459931
SIM,1844,24,20-24,1868,64
SIM,1877,37,30-34,1914,9
STAT,1860,19,15-19,1879,5.5986999096736625
STAT,1895,45,30-34,1940,0.07340210259887744
SIM,1953,15,40-44,1968,2
STAT,1871,41,25-29,1912,0.651851688036155
STAT,1925,18,20-24,1943,166.65276054009286
STAT,1870,32,50-100,1902,0.9137375118459615
SIM,1854,31,25-29,1885,11
STAT,1779,99,na,1878,0.28633560761530263
STAT,1901,42,25-29,1943,0.06353669912614915
STAT,1860,40,40-44,1900,1.88054348550036
SIM,1872,98,na,1970,19
SIM,1849,66,na,1915,1316
SIM,1933,20,50-100,1953,2
STAT,1863,17,50-100,1880,0.05000373481792962
STAT,1830,46,35-39,1876,0.11770551336224576
STAT,1944,2,na,1946,4445.828884537968
SIM,1943,22,20-24,1965,112
SIM,1770,86,na,1856,26
STAT,1846,17,40-44,1863,0.16430865133906405
STAT,1858,34,20-24,1892,2.168072787788391
STAT,1887,18,40-44,1905,0.20853479630199484
STAT,1945,15,40-44,1960,1.559710543469897
STAT,1816,96,na,1912,3.810015094744589
SIM,1846,40,30-34,1886,3
SIM,1870,40,na,1910,2611
STAT,1886,35,na,1921,2568.173453178031
STAT,1909,57,na,1966,3291.7268764289465
SIM,1881,80,na,1961,788
STAT,1832,55,na,1887,1402.380674070734
SIM,1890,32,40-44,1922,11
STAT,1846,35,40-44,1881,3.3376666244517743
STAT,1923,23,40-44,1946,3.9793518916405968
STAT,1891,34,40-44,1925,5.430369850701499
SIM,1880,28,50-100,1908,4
STAT,1884,27,25-29,1911,42.694088605793766
SIM,1909,0,na,1909,4060
SIM,1934,13,na,1947,5632
STAT,1856,36,40-44,1892,3.5223918301372565
SIM,1887,23,30-34,1910,25
STAT,1803,78,na,1881,363.4045467927932
SIM,1902,24,25-29,1926,88
STAT,1845,84,na,1929,259.92536842419213
STAT,1859,48,30-34,1907,0.07787347447116164
STAT,1935,22,20-24,1957,154.4176548167124
STAT,1811,110,na,1921,1.1969816671323384E-4
STAT,1860,37,15-19,1897,0.046479931316141795
STAT,1833,96,na,1929,5.638821104884579
STAT,1925,20,50-100,1945,0.808356969128067
STAT,1843,41,50-100,1884,0.8894227948083196
SIM,1812,78,na,1890,263
SIM,1877,50,na,1927,2217
STAT,1905,41,50-100,1946,0.10857684998035562
STAT,1773,111,na,1884,0.0012309447259278622
STAT,1824,43,40-44,1867,2.717001697932091
SIM,1899,29,30-34,1928,64
STAT,1836,24,20-24,1860,55.802887192974275
STAT,1914,49,25-29,1963,0.0533610144494558
SIM,1865,17,na,1882,2526
STAT,1897,42,50-100,1939,0.09994550547729995
SIM,1861,8,na,1869,3063
SIM,1933,18,20-24,1951,183
STAT,1856,21,40-44,1877,1.9520797660980505
SIM,1825,36,25-29,1861,2
STAT,1863,50,30-34,1913,0.005400780119853568
STAT,1901,46,40-44,1947,0.13815740296480622
SIM,1832,43,40-44,1875,2
STAT,1837,48,45-49,1885,0.16125962236540695
SIM,1922,36,45-49,1958,1
STAT,1836,45,25-29,1881,0.038496769471453536
STAT,1846,31,25-29,1877,8.746329281222787
SIM,1849,55,na,1904,1622
STAT,1870,51,na,1921,2157.547709998247
SIM,1854,35,40-44,1889,9
STAT,1826,38,20-24,1864,0.6706744510158282
SIM,1874,25,45-49,1899,1
STAT,1869,37,30-34,1906,5.24914609662761
STAT,1882,32,40-44,1914,4.310162033446239
STAT,1850,34,15-19,1884,0.10975482418733323
STAT,1933,31,na,1964,5200.838677478251
STAT,1866,25,45-49,1891,1.0518501417374473
STAT,1923,8,na,1931,4778.445689365665
STAT,1925,47,50-100,1972,0.279624504763872
STAT,1887,36,40-44,1923,5.028154480112267
STAT,1812,42,30-34,1854,3.31727528725359
STAT,1894,40,15-19,1934,0.01830436246355487
STAT,1858,109,na,1967,0.005489493069455369
STAT,1825,45,15-19,1870,5.287596676742552E-4
STAT,1949,22,15-19,1971,6.3371807594246095
SIM,1823,38,45-49,1861,1
SIM,1831,32,35-39,1863,11
SIM,1836,36,35-39,1872,10
SIM,1861,30,20-24,1891,2
STAT,1934,16,na,1950,5089.643619379888
STAT,1781,89,na,1870,34.21161818378502
SIM,1853,39,35-39,1892,12
SIM,1892,27,25-29,1919,7
STAT,1867,39,20-24,1906,0.7308360993491513
SIM,1917,35,25-29,1952,3
STAT,1831,104,na,1935,0.04494390091867262
STAT,1893,47,20-24,1940,0.008719236976749622
SIM,1805,53,na,1858,1143
STAT,1856,51,35-39,1907,0.006927150688089761
SIM,1828,70,na,1898,858
SIM,1823,41,40-44,1864,6
STAT,1927,44,40-44,1971,0.3189261771308476
SIM,1890,29,45-49,1919,7
STAT,1878,43,35-39,1921,1.9089428304859952
SIM,1828,45,40-44,1873,1
STAT,1854,22,15-19,1876,2.9666961047955307
SIM,1875,39,20-24,1914,1
STAT,1882,29,45-49,1911,1.0956175903782064
STAT,1845,39,35-39,1884,5.687200164043693
STAT,1892,36,15-19,1928,0.07214264570732568
STAT,1841,46,45-49,1887,0.1772981849417738
STAT,1838,22,30-34,1860,16.97983635293013
STAT,1883,61,na,1944,1870.4396214768474
STAT,1844,19,30-34,1863,1.5515930187891223
STAT,1883,21,30-34,1904,17.88330852316682
STAT,1911,39,na,1950,3669.292716944232
SIM,1945,20,30-34,1965,39
SIM,1838,34,45-49,1872,4
SIM,1915,22,45-49,1937,1
STAT,1823,32,35-39,1855,25.80172404803729
STAT,1851,18,30-34,1869,1.5893460935047115
SIM,1895,36,40-44,1931,10
SIM,1826,47,30-34,1873,1
STAT,1872,21,25-29,1893,58.70631677773541
STAT,1900,4,na,1904,3719.6602501348757
STAT,1834,47,15-19,1881,2.854746086538137E-4
STAT,1877,28,25-29,1905,44.60098961576496
STAT,1897,25,45-49,1922,1.5247689077224231
STAT,1838,40,30-34,1878,1.0135207080587405
STAT,1909,35,25-29,1944,0.9595083234615848
STAT,1876,36,30-34,1912,5.6413559369672575
STAT,1832,66,na,1898,1095.2323875595212
STAT,1890,23,35-39,1913,7.256317866023475
STAT,1927,30,15-19,1957,0.16143185450859945
SIM,1846,22,30-34,1868,23
STAT,1852,55,na,1907,1665.7534367848443
STAT,1929,29,45-49,1958,2.203087127719961
STAT,1810,52,45-49,1862,0.043459406255636185
SIM,1864,32,na,1896,2163
STAT,1892,18,15-19,1910,7.567810685016523
SIM,1858,91,na,1949,25
SIM,1937,29,45-49,1966,2
SIM,1884,36,30-34,1920,10
SIM,1862,44,30-34,1906,3
STAT,1809,45,30-34,1854,0.4452144395701973
STAT,1819,49,35-39,1868,0.26942125078631873
STAT,1865,44,40-44,1909,2.05449952845105
STAT,1868,54,30-34,1922,0.005640474529643478
SIM,1812,50,25-29,1862,1
STAT,1947,24,35-39,1971,10.85009322168354
SIM,1869,24,na,1893,2314
SIM,1824,30,30-34,1854,21
SIM,1885,28,25-29,1913,53
STAT,1892,75,na,1967,1683.7197015429113
SIM,1891,21,30-34,1912,31
STAT,1849,91,na,1940,44.98839824721169
STAT,1937,20,30-34,1957,28.568503393528413
SIM,1869,32,na,1901,2336
STAT,1866,29,30-34,1895,23.5260612358949
SIM,1830,31,35-39,1861,13
STAT,1813,43,30-34,1856,3.9925063550109985
STAT,1938,30,25-29,1968,9.490948199577572
STAT,1902,29,45-49,1931,1.5859161568699502
STAT,1831,24,40-44,1855,2.610726572945502
STAT,1875,48,15-19,1923,4.135416238344841E-4
SIM,1905,33,40-44,1938,7
SIM,1901,29,na,1930,3530
STAT,1842,20,30-34,1862,17.874112442018653
SIM,1871,1,na,1872,3216
SIM,1873,44,40-44,1917,5
STAT,1838,40,na,1878,1853.4765270061082
STAT,1899,38,25-29,1937,0.863839999104243
STAT,1856,39,15-19,1895,0.044516178943379184
STAT,1925,46,30-34,1971,0.11048431107136468
STAT,1948,20,40-44,1968,3.9415619596782188
STAT,1949,22,45-49,1971,1.3395030819842089
STAT,1821,34,25-29,1855,27.734679758964248
STAT,1875,83,na,1958,512.5164862316504
SIM,1833,27,15-19,1860,1
SIM,1841,19,20-24,1860,18
SIM,1885,17,na,1902,2535
STAT,1885,38,30-34,1923,5.397426568120607
STAT,1880,34,30-34,1914,18.55708373777704
SIM,1910,29,45-49,1939,1
STAT,1869,36,50-100,1905,1.215034213814788
STAT,1876,68,na,1944,1609.848200394072
STAT,1910,25,20-24,1935,18.253559952008217
STAT,1870,44,15-19,1914,0.013586131402862085
SIM,1872,33,35-39,1905,13
STAT,1818,47,30-34,1865,0.21983317273974107
SIM,1853,40,na,1893,1927
SIM,1862,22,15-19,1884,3
SIM,1866,41,50-100,1907,4
SIM,1850,20,30-34,1870,26
STAT,1839,36,na,1875,1784.8524812434212
STAT,1934,27,na,1961,5139.274897718738
STAT,1855,43,na,1898,1778.7264651314297
SIM,1913,54,na,1967,3657
STAT,1891,35,15-19,1926,0.07159666098963824
SIM,1924,46,na,1970,4494
STAT,1864,30,30-34,1894,15.964704103328334
STAT,1939,33,40-44,1972,4.070689195922878
SIM,1843,35,30-34,1878,9
SIM,1864,42,40-44,1906,4
SIM,1821,43,30-34,1864,2
STAT,1889,49,20-24,1938,0.008351813683066568
STAT,1945,19,na,1964,4099.4997544082835
SIM,1856,14,na,1870,2778
SIM,1908,39,na,1947,3850
STAT,1907,19,15-19,1926,8.841614796912726
SIM,1818,63,na,1881,987
SIM,1915,19,15-19,1934,8
STAT,1895,27,35-39,1922,12.842829375476263
SIM,1829,66,na,1895,839
SIM,1859,35,20-24,1894,4
STAT,1865,76,na,1941,877.2037247096274
SIM,1841,15,na,1856,2165
SIM,1863,41,40-44,1904,3
STAT,1809,52,50-100,1861,0.06415087933458634
SIM,1829,44,50-100,1873,3
STAT,1828,36,35-39,1864,6.338974209601436
STAT,1919,21,20-24,1940,124.62746157811247
STAT,1854,40,15-19,1894,0.010676066084226086
STAT,1929,35,50-100,1964,0.5507248520059447
STAT,1824,44,15-19,1868,0.016357352211189464
STAT,1841,28,45-49,1869,1.0109143954201874
SIM,1927,21,20-24,1948,6
STAT,1914,40,50-100,1954,0.11960114907908688
SIM,1842,14,na,1856,2251
SIM,1881,0,na,1881,3206
STAT,1891,31,35-39,1922,12.842733418887182
SIM,1935,16,30-34,1951,19
STAT,1854,23,30-34,1877,15.902949859479047
STAT,1933,15,45-49,1948,0.6851296905220052
SIM,1920,33,na,1953,3993
STAT,1897,61,na,1958,2619.5093029866644
STAT,1936,25,40-44,1961,4.553619529949573
SIM,1935,30,50-100,1965,6
STAT,1885,41,20-24,1926,0.16236790314595761
SIM,1935,18,25-29,1953,87
SIM,1835,52,na,1887,1484
STAT,1850,38,30-34,1888,4.03034977626716
SIM,1839,41,30-34,1880,3
STAT,1866,47,25-29,1913,0.05394719945309346
SIM,1924,23,na,1947,4417
SIM,1871,90,na,1961,202
SIM,1827,57,na,1884,1196
STAT,1896,45,50-100,1941,0.18852172942679563
SIM,1853,16,15-19,1869,5
SIM,1873,91,na,1964,78
STAT,1889,66,na,1955,2065.388192626466
STAT,1865,26,40-44,1891,2.7831193602557245
STAT,1898,32,30-34,1930,24.086595444524402
SIM,1944,25,40-44,1969,6
STAT,1927,16,30-34,1943,15.497546002451132
SIM,1918,29,na,1947,4325
SIM,1832,40,35-39,1872,6
STAT,1920,24,35-39,1944,10.615556668228978
SIM,1872,42,30-34,1914,3
STAT,1807,50,45-49,1857,0.06244771064215058
STAT,1846,69,na,1915,1049.472216545909
STAT,1845,16,15-19,1861,5.895415295892052
SIM,1941,15,45-49,1956,1
SIM,1944,9,na,1953,4286
STAT,1906,42,45-49,1948,0.1541296753834998
STAT,1885,39,50-100,1924,1.236994178033864
STAT,1850,74,na,1924,834.7883264181094
STAT,1864,42,30-34,1906,1.0415598073946633
STAT,1894,17,50-100,1911,0.0642880353950159
SIM,1881,42,40-44,1923,4
STAT,1841,47,20-24,1888,0.00890039927238952
STAT,1852,35,30-34,1887,4.407400010672048
SIM,1869,86,na,1955,143
STAT,1780,84,na,1864,95.95155639887723
STAT,1816,53,20-24,1869,0.0014230672114564212
STAT,1911,24,25-29,1935,88.79854488566394
SIM,1860,35,30-34,1895,5
SIM,1910,15,15-19,1925,11
STAT,1876,14,na,1890,2711.68373216159
STAT,1902,15,15-19,1917,8.577382242968378
STAT,1927,45,na,1972,4726.262575990167
STAT,1948,24,20-24,1972,130.1707370068093
SIM,1878,30,30-34,1908,28
STAT,1883,44,20-24,1927,0.1568206084579171
SIM,1823,31,50-100,1854,1
SIM,1924,24,50-100,1948,1
STAT,1839,42,50-100,1881,0.7684444992507068
SIM,1919,31,40-44,1950,7
STAT,1862,54,30-34,1916,0.005027044742513118
STAT,1873,42,40-44,1915,2.323448527024344
SIM,1848,39,na,1887,1874
STAT,1907,17,na,1924,3783.072487626881
STAT,1918,25,20-24,1943,19.958505035647036
STAT,1790,94,na,1884,4.542876949042739
STAT,1858,74,na,1932,897.8274680625781
SIM,1820,44,50-100,1864,4
STAT,1865,41,35-39,1906,1.684223991110836
STAT,1894,29,50-100,1923,0.8334165380464312
SIM,1865,31,30-34,1896,24
STAT,1868,19,na,1887,2475.997254821937
STAT,1949,9,na,1958,4662.777522284026
STAT,1886,15,20-24,1901,19.23242615717892
SIM,1856,29,45-49,1885,3
STAT,1888,31,50-100,1919,1.10952641922315
STAT,1931,36,45-49,1967,0.9216150397215199
SIM,1812,89,na,1901,64
STAT,1887,31,na,1918,2739.0196466446046
SIM,1910,26,40-44,1936,9
STAT,1882,40,25-29,1922,0.644664915569939
SIM,1838,94,na,1932,4
SIM,1876,34,na,1910,2754
SIM,1848,34,35-39,1882,5
STAT,1909,45,35-39,1954,0.12198808940639284
SIM,1879,3,na,1882,3342
SIM,1852,44,na,1896,1925
STAT,1896,20,30-34,1916,24.142635408175558
STAT,1907,25,45-49,1932,1.6743916425278071
STAT,1772,89,na,1861,19.327946217490066
STAT,1951,18,30-34,1969,14.802227623498748
STAT,1871,45,40-44,1916,0.17472657045447226
SIM,1889,35,35-39,1924,13
STAT,1825,87,na,1912,105.64906626334998
STAT,1870,49,40-44,1919,0.16716663284405983
STAT,1854,48,45-49,1902,0.17835414678932335
STAT,1873,31,na,1904,2478.1271866110214
STAT,1906,21,50-100,1927,0.6073339277548521
STAT,1944,15,20-24,1959,148.93466261552007
SIM,1778,80,na,1858,239
SIM,1870,43,na,1913,2564
STAT,1879,23,35-39,1902,6.203465234807946
STAT,1880,52,25-29,1932,0.003776928564255091
STAT,1801,97,na,1898,1.9168062952210043
STAT,1911,48,50-100,1959,0.21780739174613578
STAT,1932,32,45-49,1964,2.1333049208257533
SIM,1873,41,35-39,1914,4
STAT,1927,18,25-29,1945,54.81985959364789
STAT,1865,24,50-100,1889,0.37669585460181904
STAT,1848,29,45-49,1877,1.0156062038342901
STAT,1844,40,20-24,1884,0.1293114587320619
STAT,1859,44,15-19,1903,0.011099206428488115
SIM,1851,19,15-19,1870,6
SIM,1952,15,20-24,1967,197
STAT,1921,20,na,1941,4234.058185492039
STAT,1934,31,50-100,1965,1.151873631852239
STAT,1892,37,25-29,1929,3.6812317747201693
SIM,1887,23,35-39,1910,5
STAT,1883,41,na,1924,2323.939025791116
SIM,1863,61,na,1924,1544
STAT,1902,31,20-24,1933,3.904635167137498
SIM,1840,41,40-44,1881,2
SIM,1808,50,na,1858,1475
STAT,1842,43,20-24,1885,0.12721183119460092
STAT,1887,51,na,1938,2473.2023182054236
STAT,1934,37,40-44,1971,2.1067019686242046
STAT,1843,19,15-19,1862,6.05040769370456
STAT,1782,99,na,1881,0.3436585834940762
SIM,1898,27,50-100,1925,5
SIM,1909,26,30-34,1935,52
STAT,1900,43,20-24,1943,0.01548082207195471
STAT,1889,32,na,1921,3007.094669101022
STAT,1856,34,50-100,1890,0.7274507196952139
SIM,1920,20,25-29,1940,158
STAT,1825,46,25-29,1871,0.0751050523923185
SIM,1911,50,na,1961,3528
SIM,1936,30,30-34,1966,17
STAT,1859,29,20-24,1888,9.583648098726977
SIM,1861,80,na,1941,469
STAT,1833,40,45-49,1873,1.2313057590303502
STAT,1914,5,na,1919,4229.7040304536795
STAT,1840,41,30-34,1881,0.8741209265746384
SIM,1863,22,35-39,1885,6
SIM,1913,51,na,1964,3710
STAT,1919,24,25-29,1943,102.5702655425662
SIM,1909,46,na,1955,3310
STAT,1942,22,na,1964,3906.3879412297088
STAT,1856,50,25-29,1906,0.0028772173872207325
SIM,1922,14,na,1936,4652
STAT,1861,33,15-19,1894,0.11953855583384788
SIM,1847,36,40-44,1883,4
STAT,1877,40,15-19,1917,0.014759427090474841
SIM,1846,22,35-39,1868,8
SIM,1897,27,40-44,1924,1
STAT,1924,47,25-29,1971,0.06443028983860641
SIM,1883,16,na,1899,2603
STAT,1838,109,na,1947,5.227465932834209E-4
STAT,1844,33,15-19,1877,0.1306009555547007
SIM,1868,28,25-29,1896,64
STAT,1905,46,45-49,1951,0.196693880928822
STAT,1840,48,15-19,1888,2.86567553300381E-4
STAT,1832,41,40-44,1873,1.87229833889485
STAT,1848,64,na,1912,1351.283555505898
SIM,1848,31,50-100,1879,3
SIM,1849,38,50-100,1887,2
SIM,1945,21,40-44,1966,4
STAT,1844,18,20-24,1862,17.36054641976502
STAT,1805,52,50-100,1857,0.053222249901821304
SIM,1833,23,35-39,1856,1
STAT,1830,47,45-49,1877,0.1958598581265817
SIM,1876,68,na,1944,1646
SIM,1919,15,35-39,1934,1
STAT,1881,60,na,1941,1881.0082152316754
STAT,1855,22,35-39,1877,5.284750481102172
SIM,1882,39,30-34,1921,2
STAT,1806,106,na,1912,0.004314354702985034
SIM,1831,39,50-100,1870,1
STAT,1849,25,45-49,1874,1.0366476450799422
STAT,1889,27,40-44,1916,3.774840765618116
STAT,1804,54,40-44,1858,0.029642767172920765
STAT,1926,42,30-34,1968,0.16078433338535342
STAT,1857,31,30-34,1888,14.14245850528901
STAT,1850,30,35-39,1880,8.940686292112815
STAT,1852,89,na,1941,84.63128929834753
STAT,1928,33,35-39,1961,11.64806127383683
STAT,1900,45,15-19,1945,3.222145247704194E-4
SIM,1868,39,na,1907,2321
STAT,1841,34,50-100,1875,0.8039410347584244
STAT,1865,49,30-34,1914,0.08775604239117867
SIM,1894,15,20-24,1909,31
STAT,1898,49,na,1947,3039.533899412811
SIM,1872,44,na,1916,2410
STAT,1937,21,40-44,1958,3.34094557993884
SIM,1915,22,40-44,1937,4
STAT,1937,9,na,1946,3950.2826536730436
STAT,1896,14,na,1910,3468.2879351855045
STAT,1813,47,45-49,1860,0.5931350518110681
SIM,1857,25,45-49,1882,1
SIM,1823,41,na,1864,1619
SIM,1836,33,30-34,1869,23
SIM,1863,16,na,1879,2334
SIM,1901,17,30-34,1918,5
STAT,1859,51,20-24,1910,6.04070449951962E-4
STAT,1865,48,20-24,1913,0.010971226358872389
SIM,1894,53,na,1947,2836
STAT,1908,21,15-19,1929,5.005331682459556
SIM,1932,9,na,1941,5549
SIM,1916,21,15-19,1937,8
STAT,1890,29,na,1919,2955.5226691142434
STAT,1907,48,35-39,1955,0.11680429277149935
STAT,1924,40,40-44,1964,0.3043825169719043
SIM,1848,70,na,1918,998
SIM,1890,40,25-29,1930,2
SIM,1903,21,na,1924,3365
STAT,1856,46,50-100,1902,0.19723574277482062
STAT,1902,26,40-44,1928,4.324343785510115
STAT,1829,32,35-39,1861,9.448213982120127
STAT,1839,36,40-44,1875,3.647948666365302
STAT,1880,38,45-49,1918,2.126476880301003
SIM,1936,31,40-44,1967,5
STAT,1818,43,15-19,1861,0.03395905622256625
STAT,1896,23,35-39,1919,7.83815920230136
STAT,1905,36,na,1941,3515.394943314309
STAT,1807,48,30-34,1855,0.41543397304025514
STAT,1807,82,na,1889,207.3001543745449
STAT,1821,97,na,1918,2.830845322420003
STAT,1835,43,15-19,1878,0.012176783000870267
STAT,1907,22,40-44,1929,3.121310084885828
STAT,1903,39,35-39,1942,2.191580375480953
STAT,1875,30,40-44,1905,4.577086276955285
STAT,1814,51,30-34,1865,0.017324106900558422
STAT,1824,48,30-34,1872,0.11130043675384484
STAT,1923,49,30-34,1972,0.10577888100109098
SIM,1900,34,30-34,1934,31
STAT,1886,17,15-19,1903,6.408199740541021
STAT,1828,33,30-34,1861,16.662321853285754
STAT,1926,5,na,1931,5029.034533028788
SIM,1926,25,20-24,1951,29
STAT,1959,2,na,1961,5249.429883029975
STAT,1867,52,50-100,1919,0.014387380765784347
SIM,1852,24,na,1876,2146
STAT,1865,22,na,1887,2216.4241318472323
STAT,1860,98,na,1958,4.254756711834307
STAT,1865,40,25-29,1905,0.6005744911122866
STAT,1871,47,35-39,1918,0.14081389197707492
SIM,1852,18,20-24,1870,2
SIM,1873,40,25-29,1913,2
STAT,1923,41,35-39,1964,0.24048160019820825
STAT,1763,92,na,1855,3.67308
SIM,1859,2,na,1861,3171
SIM,1863,44,45-49,1907,1
SIM,1883,30,40-44,1913,4
STAT,1871,101,na,1972,5.581488128728467
STAT,1808,106,na,1914,0.004042085735930518
STAT,1895,24,30-34,1919,23.55992546947023
STAT,1917,26,15-19,1943,0.7581091510852922
STAT,1848,51,45-49,1899,0.011334955175518387
STAT,1885,34,15-19,1919,0.14369859639972868
STAT,1925,35,50-100,1960,0.5150118503665811
STAT,1908,47,40-44,1955,0.14539709649335122
SIM,1888,37,40-44,1925,10
STAT,1881,46,na,1927,2225.267176231206
SIM,1774,90,na,1864,26
SIM,1858,15,na,1873,2282
STAT,1891,39,30-34,1930,6.663498758750233
STAT,1924,48,35-39,1972,0.1561660486001771
STAT,1878,94,na,1972,105.79385111497864
STAT,1928,31,40-44,1959,4.994043811681303
SIM,1927,24,25-29,1951,169
SIM,1865,96,na,1961,8
SIM,1785,82,na,1867,90
SIM,1911,39,35-39,1950,4
STAT,1867,31,na,1898,2294.7855394118037
STAT,1818,50,20-24,1868,0.0016714781761390774
STAT,1837,20,50-100,1857,0.37602595861174587
STAT,1874,39,30-34,1913,5.495215713355677
STAT,1838,22,35-39,1860,5.562762273880197
STAT,1874,19,45-49,1893,0.06767255853077114
STAT,1869,19,35-39,1888,0.5414764592737733
STAT,1824,40,35-39,1864,2.322530014857266
STAT,1933,38,35-39,1971,3.3564071158511197
STAT,1936,28,na,1964,3654.8736718181235
STAT,1917,42,20-24,1959,0.018807789954013512
SIM,1831,41,30-34,1872,3
STAT,1854,98,na,1952,2.486285996953159
STAT,1845,22,na,1867,2073.9664363832812
SIM,1939,24,20-24,1963,117
STAT,1960,9,na,1969,5219.305420264728
STAT,1881,49,15-19,1930,3.8627354823358165E-4
SIM,1832,24,na,1856,1894
SIM,1880,73,na,1953,997
STAT,1918,41,25-29,1959,0.07759012164845856
SIM,1840,35,50-100,1875,1
SIM,1909,25,20-24,1934,1
STAT,1850,15,40-44,1865,0.17011935998441802
STAT,1890,32,30-34,1922,21.778149080196865
STAT,1890,43,na,1933,2862.069160051638
SIM,1894,17,15-19,1911,7
STAT,1832,89,na,1921,70.19969941046597
SIM,1817,47,na,1864,1374
STAT,1782,107,na,1889,0.007985068847863926
SIM,1898,26,45-49,1924,1
STAT,1823,41,30-34,1864,1.9065442042860279
STAT,1883,47,25-29,1930,0.05738681525079531
STAT,1918,40,15-19,1958,0.0016708270780895409
STAT,1887,30,30-34,1917,20.119217458291434
SIM,1903,24,40-44,1927,8
STAT,1812,48,40-44,1860,0.3982949895447282
STAT,1863,41,na,1904,2076.6463938635256
STAT,1818,53,25-29,1871,0.007556205835059067
STAT,1920,21,30-34,1941,32.70561160556003
SIM,1891,31,45-49,1922,3
SIM,1954,2,na,1956,4725
STAT,1900,44,na,1944,3234.9990852877345
SIM,1869,18,30-34,1887,1
SIM,1882,82,na,1964,613
STAT,1901,35,20-24,1936,0.23960980735525067
STAT,1845,17,25-29,1862,5.596202201313542
SIM,1913,31,na,1944,3935
STAT,1874,44,50-100,1918,1.0855071920421464
STAT,1908,28,30-34,1936,37.63780913162709
STAT,1868,41,20-24,1909,0.1554424049550483
STAT,1841,40,35-39,1881,1.4253896926808758
STAT,1767,106,na,1873,0.00854389534485609
STAT,1918,29,50-100,1947,1.0732375847291697
STAT,1932,39,30-34,1971,2.4920323317045505
SIM,1886,23,15-19,1909,3
SIM,1891,34,50-100,1925,1
STAT,1807,68,na,1875,879.8446210259542
STAT,1878,23,15-19,1901,3.492281113470743
SIM,1914,41,35-39,1955,1
STAT,1869,18,25-29,1887,5.625165991918678
SIM,1882,44,50-100,1926,6
STAT,1871,23,30-34,1894,17.94413159779791
SIM,1876,41,20-24,1917,4
SIM,1935,15,20-24,1950,182
STAT,1883,31,45-49,1914,1.7526389831076032
SIM,1913,19,15-19,1932,15
SIM,1876,88,na,1964,281
SIM,1783,81,na,1864,147
STAT,1881,42,30-34,1923,1.1324957927361654
SIM,1870,63,na,1933,1908
STAT,1925,43,25-29,1968,0.08806572835694446
SIM,1898,35,na,1933,3678
SIM,1858,0,na,1858,3284
STAT,1881,15,50-100,1896,0.048544082731251256
STAT,1864,45,35-39,1909,0.128257574862435
STAT,1850,40,45-49,1890,1.1371394983979517
SIM,1951,16,15-19,1967,65
STAT,1824,50,45-49,1874,0.0169778557501876
STAT,1836,26,15-19,1862,0.36808528528826795
STAT,1947,8,na,1955,4516.878894116265
SIM,1893,44,25-29,1937,1
SIM,1889,32,30-34,1921,27
STAT,1905,19,15-19,1924,8.696747772299709
STAT,1895,49,45-49,1944,0.1734894685348099
SIM,1896,34,na,1930,3277
SIM,1869,27,30-34,1896,33
SIM,1824,40,45-49,1864,4
STAT,1857,19,45-49,1876,0.06045080206554366
STAT,1800,78,na,1878,381.0658954461977
SIM,1905,22,50-100,1927,1
SIM,1930,23,na,1953,5177
SIM,1919,18,40-44,1937,2
SIM,1920,30,50-100,1950,1
STAT,1853,17,na,1870,2315.3193289679893
STAT,1875,15,45-49,1890,0.06871112419810135
STAT,1943,16,15-19,1959,49.11403485502377
STAT,1935,8,na,1943,5560.364847949295
SIM,1853,17,25-29,1870,15
STAT,1896,68,na,1964,2290.601363533592
STAT,1770,94,na,1864,2.4860756505105215
STAT,1885,44,25-29,1929,0.6447517921816727
STAT,1918,54,na,1972,3885.4332355869133
STAT,1879,53,30-34,1932,0.006245614506306085
SIM,1916,28,30-34,1944,52
STAT,1865,29,45-49,1894,1.0206852597420049
STAT,1814,43,45-49,1857,4.892506737638279
SIM,1843,95,na,1938,13
STAT,1903,35,na,1938,3476.2174166822483
STAT,1891,41,45-49,1932,1.898806408826106
STAT,1891,38,20-24,1929,0.9687515960472738
STAT,1892,30,40-44,1922,5.58933000090126
SIM,1848,31,30-34,1879,24
STAT,1878,40,na,1918,2478.979818029665
SIM,1816,46,25-29,1862,1
STAT,1867,46,30-34,1913,0.09297164600364285
SIM,1877,34,30-34,1911,28
SIM,1883,37,25-29,1920,1
STAT,1884,42,15-19,1926,0.013920860926904663
STAT,1871,48,45-49,1919,0.23548725540919013
STAT,1906,41,35-39,1947,0.18755917721352966
SIM,1818,40,na,1858,1509
STAT,1927,15,20-24,1942,172.75504762730327
STAT,1927,19,50-100,1946,0.47264346351005176
SIM,1874,53,na,1927,2226
STAT,1820,54,25-29,1874,0.005968351778256764
SIM,1850,30,45-49,1880,3
STAT,1816,40,45-49,1856,3.8242041226543004
STAT,1932,12,na,1944,5350.634508730358
STAT,1824,47,20-24,1871,0.013985149691173033
STAT,1850,54,na,1904,1575.0845713530114
STAT,1912,30,50-100,1942,0.8366030591157257
SIM,1936,33,35-39,1969,10
STAT,1907,45,na,1952,3404.2375039321173
STAT,1912,48,45-49,1960,0.21248362225043854
SIM,1839,29,45-49,1868,1
SIM,1909,29,35-39,1938,19
STAT,1925,23,50-100,1948,0.801079449879233
SIM,1891,11,na,1902,3341
STAT,1875,37,25-29,1912,3.014550122402244
SIM,1845,76,na,1921,724
SIM,1861,35,na,1896,2551
SIM,1895,30,30-34,1925,36
STAT,1810,88,na,1898,58.52857069011804
SIM,1866,44,na,1910,2291
SIM,1898,25,35-39,1923,26
STAT,1935,25,20-24,1960,25.397295046327077
SIM,1870,2,na,1872,3384
SIM,1839,44,35-39,1883,1
STAT,1822,51,25-29,1873,0.004952513609246997
STAT,1947,11,na,1958,4515.2981707848285
SIM,1910,7,na,1917,4015
SIM,1827,27,25-29,1854,33
STAT,1862,16,15-19,1878,5.937351389261453
STAT,1898,35,35-39,1933,9.850133787927394
SIM,1822,43,45-49,1865,6
STAT,1892,34,20-24,1926,3.4264387557792917
STAT,1915,7,na,1922,4255.233868536957
STAT,1838,74,na,1912,815.4195439779808
SIM,1835,66,na,1901,1040
SIM,1858,94,na,1952,4
STAT,1838,52,30-34,1890,0.004350365379983508
SIM,1877,18,25-29,1895,5
STAT,1853,49,40-44,1902,0.14055374016194186
STAT,1912,20,25-29,1932,90.8433492823871
STAT,1909,42,30-34,1951,0.12195452934665751
STAT,1780,101,na,1881,0.12489341505420855
STAT,1844,43,25-29,1887,0.5031528523762446
SIM,1894,18,25-29,1912,17
SIM,1887,20,30-34,1907,29
SIM,1926,29,50-100,1955,1
STAT,1881,34,45-49,1915,1.7051673909513454
SIM,1830,74,na,1904,736
SIM,1853,71,na,1924,1046
STAT,1869,34,30-34,1903,17.04899568721289
SIM,1875,46,30-34,1921,1
STAT,1841,91,na,1932,42.78592503307374
STAT,1920,38,50-100,1958,0.4686411367676743
STAT,1855,52,30-34,1907,0.0045898412642738804
SIM,1791,68,na,1859,711
STAT,1879,16,25-29,1895,6.057585305514466
SIM,1852,43,25-29,1895,1
STAT,1886,18,25-29,1904,6.102970165342474
SIM,1889,52,na,1941,2827
SIM,1890,49,na,1939,2895
STAT,1837,22,15-19,1859,2.879434170921233
STAT,1865,51,45-49,1916,0.013501376572142945
SIM,1857,24,35-39,1881,6
SIM,1874,25,na,1899,2410
STAT,1929,26,na,1955,4784.056434422324
STAT,1840,33,45-49,1873,1.512611276930635
STAT,1870,29,na,1899,2362.980365421539
STAT,1804,53,30-34,1857,0.017106625430986164
STAT,1863,27,na,1890,2134.629822617676
STAT,1833,65,na,1898,1109.7911220491274
STAT,1928,30,30-34,1958,20.117196283871817
SIM,1879,62,na,1941,2208
STAT,1900,28,30-34,1928,35.480607667676885
STAT,1919,50,na,1969,4029.6499828532988
STAT,1902,41,30-34,1943,0.11537441536722018
SIM,1910,31,20-24,1941,1
STAT,1907,45,30-34,1952,0.08260491967541703
STAT,1823,44,35-39,1867,2.786076511642366
STAT,1839,39,45-49,1878,1.6103001940946808
SIM,1847,39,45-49,1886,1
SIM,1934,35,25-29,1969,4
STAT,1825,43,20-24,1868,0.2123650641599834
STAT,1834,45,50-100,1879,0.19761627039021146
STAT,1926,35,25-29,1961,1.2297024255963713
STAT,1830,51,50-100,1881,0.011242595875533291
STAT,1910,32,25-29,1942,9.089353579936686
SIM,1861,49,40-44,1910,1
STAT,1856,79,na,1935,559.8459320237266
STAT,1902,40,20-24,1942,0.016025909960325074
STAT,1922,43,40-44,1965,0.29247457107104896
STAT,1890,35,35-39,1925,8.90610225872056
STAT,1829,110,na,1939,1.8378799662026533E-4
SIM,1904,20,40-44,1924,6
STAT,1863,31,25-29,1894,9.19895483066028
STAT,1923,25,50-100,1948,1.1738856970118214
STAT,1859,54,25-29,1913,0.0028063752023242522
SIM,1792,64,na,1856,769
SIM,1868,25,20-24,1893,14
STAT,1830,44,40-44,1874,1.8856054005528582
STAT,1879,56,na,1935,2174.9739338393847
SIM,1904,57,na,1961,3146
STAT,1842,46,25-29,1888,0.045760260633375974
STAT,1863,53,35-39,1916,0.007576749834978709
STAT,1867,29,50-100,1896,0.6082749342182041
SIM,1902,31,30-34,1933,40
SIM,1921,49,na,1970,4809
STAT,1910,31,15-19,1941,0.12688993640316726
STAT,1860,13,na,1873,2268.557925277449
STAT,1942,27,50-100,1969,1.065821992871561
SIM,1842,36,25-29,1878,1
STAT,1802,59,na,1861,904.4682713934728
SIM,1814,50,na,1864,1252
STAT,1834,36,25-29,1870,2.4352426828827753
STAT,1849,42,50-100,1891,0.8191777711951319
SIM,1915,25,45-49,1940,1
SIM,1798,80,na,1878,173
SIM,1881,35,na,1916,2163
STAT,1916,46,20-24,1962,0.01159582978683417
STAT,1926,45,35-39,1971,0.16305455145877562
SIM,1885,62,na,1947,1866
STAT,1806,51,40-44,1857,0.03495918162966804
STAT,1830,28,50-100,1858,0.6792232445170302
STAT,1829,25,50-100,1854,2.002121519707098
STAT,1830,43,30-34,1873,0.9776803007860114
STAT,1842,45,15-19,1887,3.2187681487920493E-4
SIM,1909,28,25-29,1937,8
STAT,1816,73,na,1889,541.3855697280911
STAT,1850,18,45-49,1868,0.05968963602977325
STAT,1863,52,25-29,1915,0.0031512937892057996
STAT,1914,27,na,1941,3853.1204036789645
STAT,1913,22,35-39,1935,9.30804364452631
STAT,1903,55,na,1958,3059.922672520463
SIM,1850,43,na,1893,1719
STAT,1933,35,30-34,1968,2.5360576195665545
SIM,1807,57,na,1864,1092
STAT,1817,58,na,1875,1163.5960425396665
STAT,1896,45,45-49,1941,0.18115280218971122
STAT,1838,24,50-100,1862,0.3831703999399924
STAT,1855,21,50-100,1876,0.3719755432859727
SIM,1928,39,na,1967,5010
SIM,1946,24,na,1970,3961
SIM,1926,17,35-39,1943,5
SIM,1900,37,35-39,1937,5
SIM,1942,18,30-34,1960,18
STAT,1856,100,na,1956,1.008473372444724
SIM,1865,34,35-39,1899,18
SIM,1825,29,15-19,1854,1
STAT,1883,47,na,1930,2241.5138539702607
SIM,1825,42,na,1867,1537
STAT,1862,79,na,1941,607.1030228074187
STAT,1861,94,na,1955,16.847628785477195
STAT,1934,18,30-34,1952,16.76897008909414
SIM,1890,18,na,1908,3271
STAT,1857,34,35-39,1891,7.999346174056795
STAT,1872,55,na,1927,2114.0916613686636
SIM,1835,19,30-34,1854,1
STAT,1785,93,na,1878,7.041823072807879
STAT,1948,23,40-44,1971,3.9375429320760404
STAT,1869,12,na,1881,2619.525996896067
SIM,1879,16,35-39,1895,3
STAT,1928,34,45-49,1962,2.0043849410339516
STAT,1871,44,30-34,1915,1.1460863785488842
STAT,1826,45,30-34,1871,0.0776693412730893
STAT,1883,46,15-19,1929,4.0152260749555914E-4
STAT,1924,28,15-19,1952,0.8356601330535427
STAT,1843,41,na,1884,1945.8238961864306
STAT,1829,91,na,1920,38.540156639996255
STAT,1850,37,20-24,1887,0.5890182859215289
STAT,1849,24,35-39,1873,5.399060181166981
SIM,1931,25,50-100,1956,4
STAT,1887,85,na,1972,698.9992715127398
SIM,1936,34,45-49,1970,4
STAT,1858,40,na,1898,1888.6777584078932
STAT,1886,0,na,1886,3586.195852593782
SIM,1845,22,15-19,1867,5
SIM,1921,22,35-39,1943,17
STAT,1829,54,45-49,1883,0.009929638232337787
SIM,1878,69,na,1947,1667
STAT,1883,34,50-100,1917,0.9092780281438004
SIM,1852,78,na,1930,607
STAT,1927,19,35-39,1946,5.293607772092078
SIM,1935,19,35-39,1954,6
STAT,1846,103,na,1949,0.10263071489248977
STAT,1866,44,20-24,1910,0.14742119084082628
SIM,1865,41,45-49,1906,2
STAT,1854,13,na,1867,2175.7045961732656
STAT,1893,36,30-34,1929,6.930451102275705
STAT,1888,39,na,1927,2812.7590756781306
SIM,1918,35,40-44,1953,1
STAT,1957,4,na,1961,5287.932012417213
SIM,1794,73,na,1867,506
STAT,1820,49,45-49,1869,0.4180468763280052
STAT,1822,52,35-39,1874,0.01179991600299257
STAT,1841,107,na,1948,0.003482037035638732
SIM,1952,4,na,1956,4887
SIM,1910,57,na,1967,3291
SIM,1931,25,na,1956,4770
STAT,1887,8,na,1895,2971.6280970414937
STAT,1910,23,50-100,1933,0.6282787161457442
STAT,1936,18,50-100,1954,0.3648883495857822
STAT,1910,36,40-44,1946,1.4672545566458834
SIM,1883,67,na,1950,1631
STAT,1927,30,50-100,1957,1.0386464071197854
SIM,1920,29,35-39,1949,25
STAT,1930,17,50-100,1947,0.49401671245549966
STAT,1872,40,30-34,1912,1.18731565534937
STAT,1874,33,na,1907,2475.001791417909
STAT,1916,24,50-100,1940,0.6992070817341981
STAT,1809,91,na,1900,29.56446265286643
SIM,1920,24,40-44,1944,6
STAT,1846,53,35-39,1899,0.006057675980875823
STAT,1816,38,30-34,1854,16.31886751485139
SIM,1948,17,20-24,1965,145
STAT,1941,26,na,1967,3955.369723706746
STAT,1947,24,50-100,1971,0.7582176444175039
STAT,1764,91,na,1855,28.160279999999993
STAT,1896,2,na,1898,3591.5861071042655
STAT,1893,32,15-19,1925,0.1842963875491152
STAT,1912,49,na,1961,3580.623908064079
STAT,1936,7,na,1943,3903.3408713081126
STAT,1883,29,30-34,1912,25.026057764075084
STAT,1887,17,30-34,1904,1.8220053779928005
STAT,1846,38,na,1884,1741.2407270948868
SIM,1856,41,35-39,1897,1
STAT,1883,40,40-44,1923,2.274165290554566
SIM,1877,15,20-24,1892,21
SIM,1835,83,na,1918,216
SIM,1843,28,20-24,1871,19
STAT,1912,24,40-44,1936,3.4041396644697794
STAT,1835,53,25-29,1888,0.002637837629164914
STAT,1872,49,50-100,1921,0.2458657635366572
SIM,1862,39,50-100,1901,2
STAT,1876,45,na,1921,2393.6767469395395
STAT,1909,40,na,1949,3582.9469515116957
SIM,1891,2,na,1893,3436
SIM,1807,88,na,1895,10
STAT,1898,17,40-44,1915,0.25232435729072183
SIM,1911,17,25-29,1928,12
STAT,1847,15,35-39,1862,0.5403966516488983
SIM,1852,75,na,1927,763
STAT,1929,17,45-49,1946,0.6502306611775884
SIM,1880,40,30-34,1920,2
STAT,1901,24,30-34,1925,25.25155714384422
SIM,1863,43,35-39,1906,2
STAT,1910,34,na,1944,3687.489346921129
STAT,1881,52,40-44,1933,0.01032790779560892
STAT,1837,41,25-29,1878,0.5117349090805547
SIM,1858,20,35-39,1878,7
STAT,1864,4,na,1868,2748.469486106615
STAT,1835,28,20-24,1863,11.314688322480691
SIM,1872,34,45-49,1906,6
STAT,1895,20,15-19,1915,4.417236521480993
SIM,1828,26,30-34,1854,27
STAT,1826,103,na,1929,0.08370379856103846
SIM,1908,30,na,1938,3916
STAT,1893,44,15-19,1937,0.0012243122890819454
STAT,1933,16,25-29,1949,59.30544432087445
SIM,1788,79,na,1867,331
SIM,1868,44,30-34,1912,3
STAT,1861,40,20-24,1901,0.13522518256268265
STAT,1912,29,35-39,1941,14.985126689299738
STAT,1832,80,na,1912,413.3633304440795
STAT,1866,38,na,1904,2205.9084233245103
SIM,1935,32,na,1967,5369
STAT,1903,17,25-29,1920,8.217689305668136
SIM,1790,83,na,1873,89
STAT,1848,41,35-39,1889,1.4240000391719716
STAT,1821,40,na,1861,1482.9238403694262
STAT,1942,28,35-39,1970,16.06882305547815
SIM,1839,26,40-44,1865,4
SIM,1941,16,25-29,1957,56
SIM,1864,34,50-100,1898,1
STAT,1851,33,20-24,1884,2.297126636264636
STAT,1811,49,35-39,1860,0.37550961655372816
SIM,1893,41,50-100,1934,3
SIM,1894,34,30-34,1928,30
STAT,1884,46,30-34,1930,0.09797594142728773
STAT,1912,45,40-44,1957,0.1552978628648382
SIM,1937,17,45-49,1954,1
STAT,1840,51,40-44,1891,0.007611921703475948
STAT,1957,1,na,1958,5294.5475721781195
SIM,1850,28,30-34,1878,39
SIM,1879,28,35-39,1907,14
SIM,1932,23,20-24,1955,155
SIM,1827,43,30-34,1870,1
STAT,1867,42,15-19,1909,0.013209828201779933
SIM,1899,21,35-39,1920,12
STAT,1928,18,40-44,1946,1.7929904761514466
SIM,1833,34,50-100,1867,3
SIM,1929,15,na,1944,4972
STAT,1843,44,50-100,1887,0.8558863040842591
STAT,1870,33,25-29,1903,10.171461748545708
SIM,1916,18,20-24,1934,29
STAT,1873,21,40-44,1894,2.1616850932026184
SIM,1899,62,na,1961,2718
STAT,1842,28,30-34,1870,24.24571709982111
STAT,1907,46,50-100,1953,0.2081047166967121
SIM,1898,22,30-34,1920,35
STAT,1908,18,20-24,1926,26.746785909848885
SIM,1901,39,45-49,1940,2
SIM,1884,29,20-24,1913,15
STAT,1886,34,30-34,1920,18.69180043393135
SIM,1900,17,15-19,1917,8
STAT,1853,26,15-19,1879,0.44389717031415127
STAT,1857,16,40-44,1873,0.17228873288497568
STAT,1889,42,35-39,1931,2.279076074357814
SIM,1915,26,25-29,1941,78
STAT,1876,29,20-24,1905,12.269928745442092
SIM,1881,89,na,1970,264
SIM,1828,42,35-39,1870,3
STAT,1861,15,na,1876,2250.473944902356
SIM,1879,46,50-100,1925,1
SIM,1920,45,40-44,1965,1
STAT,1890,45,45-49,1935,0.2973062565510029
STAT,1852,7,na,1859,2411.6266104141423
STAT,1924,23,20-24,1947,133.45170975068416
SIM,1882,8,na,1890,2534
STAT,1836,93,na,1929,18.19089570545268
STAT,1887,33,35-39,1920,11.52773407899119
SIM,1895,33,35-39,1928,18
STAT,1813,44,40-44,1857,6.8686778040173175
STAT,1855,44,45-49,1899,1.1445324630385734
SIM,1937,10,na,1947,4620
STAT,1907,26,25-29,1933,63.58019094282166
STAT,1934,33,25-29,1967,12.861216327390895
STAT,1870,45,25-29,1915,0.05801500627325329
STAT,1858,15,45-49,1873,0.06246529964804394
SIM,1900,33,20-24,1933,4
STAT,1919,43,35-39,1962,0.22233238513797873
SIM,1943,28,25-29,1971,83
SIM,1821,44,40-44,1865,7
STAT,1921,41,50-100,1962,0.13521908829170354
SIM,1906,52,na,1958,3223
STAT,1935,28,25-29,1963,91.45432480484774
STAT,1823,54,45-49,1877,0.020185292192819847
STAT,1922,46,45-49,1968,0.25539768949419706
STAT,1869,15,20-24,1884,17.913166991109655
SIM,1823,95,na,1918,4
STAT,1803,54,25-29,1857,0.013741050343365601
SIM,1831,54,45-49,1885,1
STAT,1892,33,50-100,1925,1.166533011317672
SIM,1841,38,na,1879,1825
SIM,1798,89,na,1887,32
STAT,1861,60,na,1921,1607.6918943954308
STAT,1950,18,15-19,1968,54.72773818568177
SIM,1825,76,na,1901,553
SIM,1939,22,na,1961,3681
STAT,1911,46,35-39,1957,0.1248129640560415
STAT,1873,39,15-19,1912,0.05749330452913104
STAT,1896,65,na,1961,2427.386005006745
SIM,1867,23,na,1890,2146
SIM,1871,35,40-44,1906,4
STAT,1936,21,25-29,1957,90.10044923291234
SIM,1939,26,45-49,1965,2
STAT,1873,50,25-29,1923,0.003715968876178555
STAT,1890,39,15-19,1929,0.06933869653798598
SIM,1878,15,na,1893,2768
SIM,1829,25,35-39,1854,3
STAT,1872,52,na,1924,2189.742978691456
STAT,1861,18,20-24,1879,17.075903706562904
STAT,1891,59,na,1950,2454.5912134190226
STAT,1942,21,15-19,1963,5.696177253431358
STAT,1920,46,45-49,1966,0.24578249998317947
SIM,1860,50,na,1910,1911
SIM,1900,67,na,1967,2488
SIM,1934,32,20-24,1966,2
STAT,1888,16,35-39,1904,0.6633795915320082
SIM,1851,48,35-39,1899,1
STAT,1925,21,15-19,1946,6.52044607850279
STAT,1890,74,na,1964,1669.1618735620677
SIM,1868,70,na,1938,1467
STAT,1900,46,25-29,1946,0.04607135376927588
SIM,1908,26,15-19,1934,3
STAT,1847,31,40-44,1878,4.01214235261285
SIM,1874,21,30-34,1895,24
SIM,1904,23,45-49,1927,2
STAT,1838,36,50-100,1874,1.099867304265995
STAT,1843,75,na,1918,831.0569505476054
STAT,1877,27,15-19,1904,0.4800562892153557
STAT,1819,43,30-34,1862,2.410144186482824
STAT,1905,67,na,1972,2728.5232712411735
STAT,1808,46,25-29,1854,0.1588988436455457
SIM,1909,9,na,1918,3808
SIM,1924,38,35-39,1962,4
STAT,1833,30,35-39,1863,8.839930438528274
SIM,1933,21,15-19,1954,7
SIM,1898,15,na,1913,3914
STAT,1926,32,20-24,1958,3.00882394111076
STAT,1854,39,50-100,1893,0.9302013473231754
SIM,1855,35,50-100,1890,3
SIM,1911,31,50-100,1942,2
STAT,1927,38,45-49,1965,0.8637242454160466
STAT,1925,47,40-44,1972,0.19491740737188984
STAT,1912,15,na,1927,4002.6363491310926
SIM,1838,27,35-39,1865,10
STAT,1778,91,na,1869,11.615740147049042
STAT,1892,52,na,1944,2738.3777817479927
STAT,1809,94,na,1903,10.196719761830517
STAT,1941,29,na,1970,3949.676721260607
STAT,1836,43,30-34,1879,0.8405125550021159
SIM,1944,21,25-29,1965,104
STAT,1779,106,na,1885,0.010616660344405747
SIM,1818,94,na,1912,7
STAT,1814,103,na,1917,0.06687616278574594
STAT,1941,22,45-49,1963,1.1862746317305979
SIM,1865,39,30-34,1904,3
STAT,1857,50,40-44,1907,0.008508110249979299
STAT,1969,1,na,1970,5017.066232340969
STAT,1823,48,15-19,1871,5.928778448093962E-4
SIM,1811,70,na,1881,547
SIM,1844,43,30-34,1887,5
STAT,1843,48,35-39,1891,0.11159814383757082
STAT,1852,31,15-19,1883,0.12002268789251014
STAT,1872,22,35-39,1894,5.96636785507782
SIM,1855,31,40-44,1886,10
STAT,1880,19,na,1899,2693.004662404062
STAT,1849,21,30-34,1870,16.84029194572878
STAT,1947,14,na,1961,4512.950619832179
STAT,1850,23,na,1873,1916.5179995434007
STAT,1916,31,15-19,1947,0.13594226388063496
SIM,1857,21,30-34,1878,23
STAT,1823,75,na,1898,572.9500666067669
STAT,1899,16,45-49,1915,0.09147768034987394
SIM,1896,16,35-39,1912,1
SIM,1902,45,na,1947,3333
STAT,1943,21,na,1964,3965.250437766741
SIM,1911,59,na,1970,3316
SIM,1855,15,35-39,1870,1
STAT,1812,54,35-39,1866,0.01866835287612891
SIM,1856,68,na,1924,1533
SIM,1805,76,na,1881,374
SIM,1844,40,50-100,1884,4
STAT,1840,54,50-100,1894,0.01056904726346349
STAT,1829,46,na,1875,1654.4567806232208
STAT,1838,71,na,1909,980.7476251394235
STAT,1846,16,30-34,1862,1.4403159368861684
STAT,1827,52,20-24,1879,7.995480459653136E-4
STAT,1927,31,25-29,1958,11.604523487576154
STAT,1948,7,na,1955,4589.373732753336
STAT,1901,45,30-34,1946,0.07867246399636203
SIM,1862,45,40-44,1907,1
STAT,1846,32,35-39,1878,8.558338777582174
STAT,1878,42,25-29,1920,0.6810421491092068
SIM,1841,30,35-39,1871,17
SIM,1843,16,na,1859,2328
SIM,1854,32,35-39,1886,14
STAT,1884,49,35-39,1933,0.13834933894387966
STAT,1911,34,35-39,1945,8.999192543220198
STAT,1916,38,35-39,1954,2.5151301208932204
STAT,1862,33,30-34,1895,15.098035434018051
STAT,1882,45,na,1927,2258.3572145966023
STAT,1769,103,na,1872,0.02526479493005021
STAT,1804,106,na,1910,0.004096846898850017
SIM,1854,16,30-34,1870,3
SIM,1891,40,40-44,1931,5
SIM,1860,31,15-19,1891,2
SIM,1857,30,na,1887,2112
SIM,1844,26,15-19,1870,4
STAT,1826,41,15-19,1867,0.011518751742281045
STAT,1876,51,20-24,1927,7.810652693877133E-4
SIM,1801,63,na,1864,1009
STAT,1852,43,15-19,1895,0.011044855240216886
STAT,1864,49,15-19,1913,3.5525695113425586E-4
SIM,1938,29,na,1967,3690
STAT,1897,18,35-39,1915,0.7464983840321423
SIM,1812,55,na,1867,1184
SIM,1918,31,25-29,1949,17
STAT,1922,49,15-19,1971,4.292725628249387E-4
SIM,1829,41,40-44,1870,3
SIM,1886,42,25-29,1928,1
STAT,1825,53,na,1878,1402.6091454721798
STAT,1902,44,35-39,1946,0.17846293934267826
STAT,1843,41,15-19,1884,0.011626442611785396
SIM,1810,44,30-34,1854,5
SIM,1869,20,45-49,1889,1
STAT,1888,32,40-44,1920,5.230167707487586
SIM,1853,33,30-34,1886,7
STAT,1913,6,na,1919,4166.912656300185
STAT,1910,35,50-100,1945,0.4134340408466373
STAT,1795,83,na,1878,121.6619532279082
SIM,1863,30,na,1893,2107
SIM,1847,23,na,1870,1824
STAT,1920,44,na,1964,4171.943686634012
STAT,1806,48,15-19,1854,0.001404676110346623
STAT,1866,21,30-34,1887,17.01988398358062
SIM,1809,69,na,1878,517
SIM,1891,29,30-34,1920,42
STAT,1815,46,na,1861,1590.261195950239
SIM,1874,40,40-44,1914,7
STAT,1930,40,30-34,1970,0.17203837652052506
STAT,1857,35,15-19,1892,0.04516429571580388
SIM,1896,32,40-44,1928,10
STAT,1926,16,15-19,1942,56.90318148257909
STAT,1870,74,na,1944,1106.7507468244285
SIM,1824,38,30-34,1862,3
STAT,1819,39,na,1858,1702.2298887996824
STAT,1779,76,na,1855,287.42412
STAT,1874,67,na,1941,1651.102423206008
SIM,1950,21,15-19,1971,5
STAT,1845,33,30-34,1878,16.052954750009533
STAT,1827,36,15-19,1863,0.0748740772614577
STAT,1867,88,na,1955,131.48084759984178
STAT,1910,37,na,1947,3669.812862318939
SIM,1934,16,15-19,1950,66
STAT,1866,40,40-44,1906,2.1378577637160174
STAT,1894,27,15-19,1921,0.5953567348408703
STAT,1762,99,na,1861,0.32222108763780855
STAT,1816,52,45-49,1868,0.02855284940691195
STAT,1846,50,30-34,1896,0.00431796967335408
STAT,1901,20,na,1921,3394.05986428866
STAT,1833,38,30-34,1871,4.366429611809189
STAT,1837,26,30-34,1863,21.705497468948167
STAT,1892,55,na,1947,2643.6997576840536
SIM,1893,19,20-24,1912,20
SIM,1815,40,35-39,1855,5
STAT,1841,94,na,1935,14.75677378058629
STAT,1916,15,45-49,1931,0.10865823825628067
SIM,1847,20,na,1867,1851
STAT,1912,27,45-49,1939,1.7367528645163821
STAT,1835,46,na,1881,1789.6233947629717
STAT,1845,53,na,1898,1655.3587237115148
STAT,1854,27,50-100,1881,0.5132515265067444
STAT,1874,31,35-39,1905,10.591071303680007
STAT,1861,43,25-29,1904,0.537407624840389
SIM,1846,44,45-49,1890,2
SIM,1952,18,25-29,1970,67
SIM,1838,49,na,1887,1491
SIM,1843,61,na,1904,1432
SIM,1871,31,25-29,1902,13
STAT,1860,23,20-24,1883,58.37775657173523
STAT,1834,33,50-100,1867,0.7816519655480318
STAT,1894,40,50-100,1934,1.4002836261382807
STAT,1898,36,15-19,1934,0.07784102025021263
STAT,1899,8,na,1907,3631.487323308243
SIM,1888,45,50-100,1933,1
STAT,1805,52,35-39,1857,0.030338416159933802
SIM,1777,87,na,1864,10
STAT,1942,25,30-34,1967,41.99329020285527
STAT,1885,18,50-100,1903,0.049732254460978016
STAT,1809,53,15-19,1862,1.0240528890505608E-4
SIM,1935,31,25-29,1966,23
STAT,1876,30,50-100,1906,0.9729584033374427
STAT,1902,56,na,1958,2998.186786012326
STAT,1853,52,30-34,1905,0.004964634185796339
STAT,1909,16,15-19,1925,9.098945304928852
STAT,1901,27,35-39,1928,13.764960346912869
STAT,1910,39,45-49,1949,0.6582850356328362
STAT,1911,21,20-24,1932,107.89420483987865
SIM,1894,22,na,1916,3182
STAT,1872,43,35-39,1915,1.8380553878763024
SIM,1836,68,na,1904,1178
STAT,1907,23,20-24,1930,102.90416651276318
STAT,1820,46,40-44,1866,0.31686464523526064
SIM,1917,16,15-19,1933,9
STAT,1907,48,na,1955,3328.281602187721
STAT,1921,39,20-24,1960,0.2997173761314671
SIM,1909,17,35-39,1926,2
STAT,1883,43,45-49,1926,1.4872632573824138
SIM,1849,89,na,1938,63
SIM,1917,44,na,1961,3788
SIM,1941,18,15-19,1959,52
STAT,1814,61,na,1875,1090.517149801628
STAT,1829,60,na,1889,1290.0138324536197
STAT,1884,26,na,1910,2416.9423552494964
SIM,1900,15,25-29,1915,10
SIM,1864,17,35-39,1881,1
SIM,1880,43,35-39,1923,6
STAT,1840,54,45-49,1894,0.010155924911538479
STAT,1933,18,15-19,1951,61.79386228532027
SIM,1858,49,na,1907,1854
STAT,1906,49,30-34,1955,0.0793845856639533
STAT,1835,50,20-24,1885,5.831902084948559E-4
STAT,1830,54,na,1884,1358.6542030328064
STAT,1945,17,50-100,1962,0.4175581143696412
SIM,1818,43,na,1861,1433
SIM,1842,33,50-100,1875,1
STAT,1874,16,40-44,1890,0.19097273160470943
STAT,1859,59,na,1918,1583.3693221457568
SIM,1841,38,30-34,1879,11
STAT,1894,33,na,1927,3118.146474527121
STAT,1811,46,30-34,1857,0.2736679765462166
STAT,1917,55,na,1972,3793.0370144832787
SIM,1891,43,45-49,1934,4
STAT,1777,98,na,1875,0.6834397686866439
SIM,1907,37,na,1944,3594
STAT,1820,47,na,1867,1419.5169427339713
SIM,1837,32,35-39,1869,14
SIM,1920,27,45-49,1947,1
SIM,1859,96,na,1955,26
SIM,1882,31,35-39,1913,20
SIM,1915,23,20-24,1938,122
STAT,1944,18,25-29,1962,47.564860049572275
STAT,1838,44,45-49,1882,1.1406770080965154
STAT,1856,17,35-39,1873,0.5195715074548457
STAT,1883,22,50-100,1905,0.4081841048115532
STAT,1900,21,45-49,1921,0.988954408823894
STAT,1834,33,20-24,1867,2.3059879234493508
STAT,1856,93,na,1949,23.40379755122311
STAT,1869,66,na,1935,1614.274911591455
SIM,1926,28,25-29,1954,111
SIM,1840,20,40-44,1860,2
SIM,1851,90,na,1941,13
STAT,1836,100,na,1936,0.6608045861704768
STAT,1838,20,na,1858,2067.7904817921785
STAT,1931,33,40-44,1964,5.226330062185897
SIM,1869,23,15-19,1892,3
SIM,1810,77,na,1887,528
SIM,1932,26,25-29,1958,141
SIM,1856,26,40-44,1882,3
SIM,1942,11,na,1953,4666
STAT,1921,18,50-100,1939,0.43464410313250673
STAT,1918,31,50-100,1949,0.9002373449808538
STAT,1864,26,na,1890,2172.201948527856
STAT,1924,26,25-29,1950,78.4571764797511
STAT,1842,24,15-19,1866,3.2164177031920045
STAT,1863,16,30-34,1879,1.6364270588627823
STAT,1913,44,45-49,1957,0.16502104670628479
SIM,1849,86,na,1935,176
SIM,1926,31,50-100,1957,1
STAT,1843,72,na,1915,1019.5009727473871
STAT,1890,42,40-44,1932,2.8021505052878286
SIM,1850,24,15-19,1874,3
SIM,1841,83,na,1924,214
STAT,1791,79,na,1870,252.40501719546992
STAT,1919,40,30-34,1959,0.1417725093574473
SIM,1861,38,na,1899,2495
STAT,1886,30,15-19,1916,0.15500958300111797
STAT,1918,28,25-29,1946,71.23006836340751
STAT,1949,19,20-24,1968,160.76144822902563
STAT,1811,87,na,1898,76.31418839407212
STAT,1823,51,40-44,1874,0.015543290766919671
STAT,1842,42,45-49,1884,1.214291142100961
SIM,1830,30,25-29,1860,12
STAT,1876,44,15-19,1920,0.01435131392331195
SIM,1865,42,na,1907,2248
SIM,1878,33,35-39,1911,4
STAT,1901,23,na,1924,3363.5036410637954
STAT,1870,30,20-24,1900,2.71732775005668
STAT,1808,98,na,1906,1.0814707122422116
SIM,1884,30,50-100,1914,2
STAT,1902,34,25-29,1936,8.388670527982454
SIM,1842,33,20-24,1875,1
SIM,1844,29,50-100,1873,1
SIM,1888,15,30-34,1903,2
STAT,1882,48,20-24,1930,0.011776665208077913
SIM,1901,32,25-29,1933,17
STAT,1885,19,20-24,1904,17.946958531924107
SIM,1809,80,na,1889,158
STAT,1827,41,50-100,1868,1.275737839032814
SIM,1909,15,na,1924,3696
SIM,1826,28,20-24,1854,13
STAT,1854,41,25-29,1895,0.4937016716715762
STAT,1848,26,40-44,1874,2.7999535101937
SIM,1835,41,50-100,1876,4
STAT,1909,26,na,1935,3662.615913953505
STAT,1937,21,na,1958,3628.5425559361884
STAT,1836,29,50-100,1865,0.5078786785912401
STAT,1854,45,40-44,1899,0.13233501040505063
STAT,1864,31,40-44,1895,3.9498346558036443
SIM,1924,15,45-49,1939,1
STAT,1861,47,40-44,1908,0.14364335337449402
STAT,1863,38,50-100,1901,1.0927097728488167
STAT,1881,15,na,1896,2502.5215642700996
STAT,1839,51,35-39,1890,0.005969925556009525
SIM,1863,40,30-34,1903,5
STAT,1911,30,na,1941,3786.8104765413304
SIM,1901,36,40-44,1937,1
SIM,1874,24,35-39,1898,8
SIM,1945,24,45-49,1969,1
SIM,1884,63,na,1947,1766
STAT,1810,53,20-24,1863,0.0021658116087692222
SIM,1910,34,25-29,1944,4
STAT,1874,0,na,1874,3838.1715708265915
STAT,1905,43,40-44,1948,0.22846567114086924
SIM,1851,45,30-34,1896,1
SIM,1957,10,na,1967,5607
STAT,1847,34,na,1881,1947.3990690082915
STAT,1890,24,45-49,1914,0.8643498338232388
STAT,1883,25,15-19,1908,0.45722159964917236
SIM,1939,23,40-44,1962,7
STAT,1924,44,20-24,1968,0.021360523022667072
STAT,1823,33,45-49,1856,3.9572582745703646
STAT,1855,12,na,1867,2201.0830516441074
SIM,1831,33,45-49,1864,2
SIM,1892,41,na,1933,3393
STAT,1821,53,30-34,1874,0.008829975593554742
SIM,1930,31,40-44,1961,5
SIM,1935,35,40-44,1970,4
STAT,1878,26,na,1904,2542.8530582341477
SIM,1881,21,40-44,1902,1
STAT,1858,100,na,1958,1.4069816551750691
STAT,1904,32,35-39,1936,8.501856722181484
STAT,1880,35,40-44,1915,4.737380854661785
SIM,1874,56,na,1930,2116
STAT,1932,35,15-19,1967,0.0263586465743332
SIM,1869,4,na,1873,2852
STAT,1820,42,25-29,1862,1.2769072171403228
STAT,1893,48,30-34,1941,0.06977671438118549
SIM,1937,26,50-100,1963,1
STAT,1915,32,45-49,1947,1.6353915271909127
STAT,1848,49,30-34,1897,0.07367476949996815
SIM,1892,4,na,1896,3861
SIM,1905,56,na,1961,3090
STAT,1805,87,na,1892,70.81179328050821
STAT,1862,36,35-39,1898,6.171687616754008
STAT,1937,24,45-49,1961,1.1168784606619344
STAT,1831,42,35-39,1873,1.5346707483113302
SIM,1816,43,20-24,1859,3
SIM,1898,69,na,1967,2594
STAT,1861,30,45-49,1891,1.4818026883569306
STAT,1840,44,35-39,1884,1.3248923670341954
SIM,1810,47,35-39,1857,1
STAT,1927,35,40-44,1962,1.901860748248366
SIM,1883,34,20-24,1917,1
SIM,1834,87,na,1921,57
SIM,1812,58,na,1870,1071
STAT,1875,34,20-24,1909,2.8059008513321433
STAT,1906,30,45-49,1936,1.4987310930567328
STAT,1912,19,50-100,1931,0.07686987653703953
STAT,1849,12,na,1861,2281.3350692373315
STAT,1848,19,na,1867,2185.953143469427
STAT,1906,45,15-19,1951,3.383704894151681E-4
SIM,1819,39,35-39,1858,12
STAT,1845,51,50-100,1896,0.011856948005748384
SIM,1889,55,na,1944,2723
STAT,1846,40,20-24,1886,0.11792891087049628
STAT,1930,22,35-39,1952,12.30262179431546
SIM,1924,35,30-34,1959,2
SIM,1893,77,na,1970,1442
STAT,1850,51,35-39,1901,0.006506760037538338
STAT,1916,35,30-34,1951,1.922732965736222
SIM,1890,63,na,1953,2280
STAT,1852,47,30-34,1899,0.0776186814816612
STAT,1911,31,30-34,1942,15.713124912343517
STAT,1917,45,25-29,1962,0.05680777774219433
STAT,1857,78,na,1935,622.5025267320327
STAT,1940,27,20-24,1967,18.989461613023742
SIM,1915,28,15-19,1943,1
STAT,1867,85,na,1952,262.5472364329555
STAT,1845,28,50-100,1873,0.6040040680686581
STAT,1779,79,na,1858,216.28758606598691
SIM,1941,18,na,1959,3665
SIM,1925,18,30-34,1943,24
STAT,1879,45,45-49,1924,0.25416872036998356
STAT,1874,41,45-49,1915,1.5658967146500515
STAT,1897,30,25-29,1927,14.083590252017093
SIM,1858,60,na,1918,1502
STAT,1812,80,na,1892,282.1456094696266
STAT,1895,46,40-44,1941,0.12890207516172492
SIM,1919,34,45-49,1953,4
SIM,1900,64,na,1964,2539
STAT,1851,36,25-29,1887,2.4258847445557588
SIM,1845,29,35-39,1874,3
SIM,1856,34,na,1890,2301
SIM,1914,30,45-49,1944,5
SIM,1839,22,25-29,1861,64
SIM,1820,36,na,1856,1786
STAT,1914,8,na,1922,4195.661143847186
STAT,1902,5,na,1907,3770.1698130172426
SIM,1912,32,35-39,1944,17
STAT,1832,35,na,1867,1833.2150789370437
STAT,1920,33,30-34,1953,17.53670115726741
SIM,1859,16,15-19,1875,8
SIM,1882,41,45-49,1923,3
STAT,1960,10,na,1970,5218.7312966684985
SIM,1887,45,45-49,1932,1
SIM,1830,43,na,1873,1735
STAT,1908,43,25-29,1951,0.06696584280802116
SIM,1870,49,na,1919,2431
STAT,1843,45,30-34,1888,0.0797984531241836
STAT,1950,16,25-29,1966,52.289280662066346
STAT,1910,43,15-19,1953,0.0014713690553227023
STAT,1907,28,15-19,1935,0.6772029431439026
STAT,1849,110,na,1959,4.0527867809225505E-4
STAT,1857,53,45-49,1910,0.011376669068324673
STAT,1864,52,40-44,1916,0.009498608050802996
STAT,1814,54,35-39,1868,0.02359508907581249
SIM,1946,25,50-100,1971,1
STAT,1864,7,na,1871,2552.254367537965
STAT,1866,24,35-39,1890,5.456638055917925
STAT,1797,64,na,1861,858.8332579949389
STAT,1781,80,na,1861,229.71415270885012
STAT,1836,46,35-39,1882,0.09237741036710471
STAT,1901,24,50-100,1925,0.5781034771622178
STAT,1818,42,50-100,1860,2.7050075113969747
STAT,1892,21,50-100,1913,0.5229593822863876
STAT,1812,51,30-34,1863,0.013709442117689305
STAT,1842,79,na,1921,548.2415581584215
STAT,1895,18,na,1913,3352.801988306104
SIM,1935,18,na,1953,5102
SIM,1845,42,na,1887,1848
SIM,1885,48,na,1933,2240
STAT,1901,41,15-19,1942,0.00137425519992168
STAT,1938,25,50-100,1963,1.0067870599295041
STAT,1881,45,35-39,1926,0.13945542338234018
STAT,1876,54,25-29,1930,0.0036286532532433984
STAT,1917,18,30-34,1935,2.6696665672842594
STAT,1850,20,na,1870,1958.3997749647617
SIM,1867,26,20-24,1893,14
STAT,1902,16,20-24,1918,25.56771284952633
STAT,1904,24,30-34,1928,25.87969849342256
SIM,1859,79,na,1938,535
STAT,1840,44,45-49,1884,1.0950254354905087
STAT,1917,38,na,1955,3967.972854346825
STAT,1822,53,40-44,1875,0.014144979663245441
STAT,1843,12,na,1855,2462.76804
SIM,1847,28,45-49,1875,2
STAT,1841,37,15-19,1878,0.048850234605373105
STAT,1883,47,20-24,1930,0.011955587068277259
STAT,1884,10,na,1894,2614.370998928878
STAT,1934,36,35-39,1970,3.406990254973914
STAT,1886,1,na,1887,3383.217167336974
STAT,1913,24,na,1937,3738.390123937756
STAT,1929,32,35-39,1961,11.839233959548922
SIM,1855,65,na,1920,1314
SIM,1901,32,30-34,1933,35
STAT,1839,108,na,1947,0.0012641545853453288
STAT,1907,24,50-100,1931,0.6070000718074942
STAT,1836,33,15-19,1869,0.11089213988316288
STAT,1898,18,na,1916,3475.077437016162
STAT,1827,97,na,1924,3.4721840358017717
STAT,1869,3,na,1872,3100.2424835454954
STAT,1839,20,35-39,1859,5.249752653309643
SIM,1851,51,na,1902,1748
SIM,1924,18,15-19,1942,57
STAT,1835,40,45-49,1875,1.3713674134284028
SIM,1846,41,25-29,1887,1
STAT,1909,19,na,1928,3842.095899490085
STAT,1825,54,20-24,1879,8.7943465898595E-4
STAT,1839,28,45-49,1867,0.9583970312316105
SIM,1910,38,40-44,1948,3
STAT,1916,45,30-34,1961,0.09374687073627817
STAT,1865,23,40-44,1888,1.9388365232070024
STAT,1848,26,45-49,1874,1.0378003032143446
STAT,1906,32,40-44,1938,3.697477876715141
STAT,1859,36,50-100,1895,1.0050747081089844
STAT,1902,38,40-44,1940,1.3525556458994368
SIM,1864,25,40-44,1889,3
SIM,1905,34,40-44,1939,6
STAT,1822,66,na,1888,957.3574295170998
SIM,1842,15,na,1857,2204
STAT,1854,17,30-34,1871,1.4592619425076583
STAT,1871,67,na,1938,1601.9016638475996
STAT,1856,25,40-44,1881,2.5218499296236834
STAT,1788,89,na,1877,41.32137196805295
STAT,1805,70,na,1875,818.8449226861998
STAT,1872,25,na,1897,2456.6062397814567
SIM,1881,1,na,1882,2988
STAT,1846,36,50-100,1882,0.9264336280629646
STAT,1845,31,15-19,1876,0.13368120537674205
SIM,1914,32,40-44,1946,3
STAT,1898,42,35-39,1940,0.17326048463236035
SIM,1921,17,35-39,1938,11
SIM,1846,29,na,1875,2144
STAT,1792,94,na,1886,3.836653538502906
STAT,1846,18,35-39,1864,0.49002259177630564
STAT,1925,38,35-39,1963,2.958817377825634
STAT,1943,4,na,1947,4329.154229649129
SIM,1899,29,20-24,1928,23
STAT,1806,49,15-19,1855,0.001348765505039426
SIM,1923,25,45-49,1948,3
STAT,1872,47,45-49,1919,0.24016847561912263
STAT,1926,6,na,1932,5013.142783904417
SIM,1889,30,40-44,1919,10
SIM,1871,15,30-34,1886,1
SIM,1940,22,40-44,1962,3
STAT,1777,114,na,1891,2.2869395393252518E-4
STAT,1784,75,na,1859,337.42707346410606
STAT,1892,45,20-24,1937,0.008740867405717187
STAT,1809,84,na,1893,169.7218130116346
STAT,1955,2,na,1957,5328.227086604453
SIM,1930,40,na,1970,5459
STAT,1915,25,45-49,1940,1.8103536017264328
STAT,1863,48,na,1911,1987.088407656055
STAT,1972,0,na,1972,5173.199483106053
STAT,1913,17,35-39,1930,0.8752336726974406
SIM,1843,40,45-49,1883,3
SIM,1806,64,na,1870,1005
SIM,1862,17,30-34,1879,3
STAT,1838,41,25-29,1879,0.5589040792741357
STAT,1839,82,na,1921,322.0094551895541
STAT,1863,15,30-34,1878,1.6461227216935572
STAT,1932,28,25-29,1960,87.87743792343716
STAT,1857,42,50-100,1899,0.8406589121307144
STAT,1798,83,na,1881,168.2404248915163
SIM,1940,28,25-29,1968,68
STAT,1927,37,30-34,1964,2.311497515701518
STAT,1831,51,40-44,1882,0.0077254755425910536
SIM,1896,63,na,1959,2516
STAT,1814,54,45-49,1868,0.0397745786723488
STAT,1844,42,50-100,1886,0.8384409438568269
STAT,1932,22,40-44,1954,4.49915242339488
STAT,1810,46,50-100,1856,0.7858498341540386
SIM,1858,14,na,1872,2337
SIM,1917,28,25-29,1945,69
SIM,1910,25,35-39,1935,20
SIM,1814,83,na,1897,224
STAT,1877,24,na,1901,2486.7591205154986
STAT,1905,25,50-100,1930,0.9488814453574906
STAT,1920,34,40-44,1954,4.336846588481791
STAT,1888,20,30-34,1908,21.61014698153955
STAT,1897,48,50-100,1945,0.1865976240292481
SIM,1856,26,45-49,1882,1
STAT,1928,38,50-100,1966,0.5406840398488922
SIM,1907,48,35-39,1955,1
STAT,1892,29,na,1921,3029.509316932847
STAT,1903,37,45-49,1940,0.6239719056927995
STAT,1894,48,35-39,1942,0.10232595926920733
SIM,1884,78,na,1962,861
SIM,1955,16,na,1971,4713
STAT,1875,48,25-29,1923,0.05955004343652517
SIM,1934,25,20-24,1959,30
SIM,1924,45,30-34,1969,1
STAT,1830,54,50-100,1884,0.010593774300526531
STAT,1881,61,na,1942,1842.9930392018432
STAT,1831,46,45-49,1877,0.19551309289702326
STAT,1885,75,na,1960,1208.0360322390618
STAT,1837,25,30-34,1862,21.86247000357382
SIM,1809,48,50-100,1857,1
STAT,1874,35,50-100,1909,1.290914662281514
STAT,1879,42,25-29,1921,0.6839243037761399
SIM,1829,33,na,1862,1550
STAT,1888,23,50-100,1911,0.49028379853337956
STAT,1912,30,15-19,1942,0.13002922110435167
STAT,1826,28,50-100,1854,1.8381256757871804
STAT,1871,21,15-19,1892,3.3438099050401693
SIM,1910,16,20-24,1926,25
SIM,1912,24,30-34,1936,65
STAT,1902,25,35-39,1927,13.975563388341675
STAT,1859,26,20-24,1885,9.793080098574547
STAT,1909,28,25-29,1937,63.92790797716132
SIM,1867,50,na,1917,1945
STAT,1929,26,50-100,1955,1.2711208129871239
SIM,1873,23,40-44,1896,3
SIM,1937,32,35-39,1969,16
STAT,1822,50,na,1872,1459.55507912369
SIM,1922,37,20-24,1959,2
STAT,1873,47,50-100,1920,0.2528274815031747
STAT,1877,34,15-19,1911,0.14938950263201678
STAT,1929,23,na,1952,4695.531920150268
STAT,1900,17,25-29,1917,8.012469211509185
SIM,1764,91,na,1855,6
STAT,1844,54,30-34,1898,0.004485852212623394
STAT,1818,45,na,1863,1465.6763308694283
STAT,1816,40,35-39,1856,4.626978230707321
SIM,1846,9,na,1855,2406
STAT,1842,46,20-24,1888,0.009533388076659382
STAT,1875,46,50-100,1921,0.25787590116993786
SIM,1887,11,na,1898,3058
SIM,1899,16,15-19,1915,7
SIM,1837,52,na,1889,1361
SIM,1838,22,35-39,1860,3
STAT,1914,37,20-24,1951,0.2685384547459607
STAT,1882,15,40-44,1897,0.18262770206424003
SIM,1916,25,na,1941,3986
STAT,1824,34,50-100,1858,1.4587753844540838
SIM,1912,11,na,1923,4218
STAT,1899,21,45-49,1920,0.9770781123316242
STAT,1945,20,25-29,1965,103.35826010388331
STAT,1803,53,30-34,1856,0.023563385560446567
STAT,1865,18,45-49,1883,0.06195880032706157
SIM,1875,5,na,1880,2804
STAT,1825,49,25-29,1874,0.07208097535422937
STAT,1840,79,na,1919,503.0747043223256
STAT,1857,41,35-39,1898,1.4492374667151533
STAT,1886,32,15-19,1918,0.15377352951783008
STAT,1843,44,na,1887,1872.4548467017316
STAT,1827,81,na,1908,349.50655294115955
STAT,1871,35,35-39,1906,7.215240710555077
STAT,1869,23,25-29,1892,56.20746616708217
SIM,1828,28,35-39,1856,9
STAT,1860,37,25-29,1897,2.383152549466846
SIM,1925,27,20-24,1952,27
SIM,1920,32,40-44,1952,2
SIM,1812,44,35-39,1856,3
SIM,1942,27,20-24,1969,22
SIM,1847,33,40-44,1880,5
SIM,1808,71,na,1879,773
STAT,1842,86,na,1928,173.99632530898597
SIM,1897,24,40-44,1921,6
STAT,1919,38,35-39,1957,2.6489966525086706
STAT,1844,15,20-24,1859,17.670956707821514
SIM,1901,27,35-39,1928,18
SIM,1941,24,na,1965,3669
STAT,1864,50,50-100,1914,0.013896303604679609
SIM,1785,69,na,1854,626
SIM,1793,88,na,1881,7
SIM,1937,19,na,1956,4261
SIM,1826,84,na,1910,147
SIM,1927,38,35-39,1965,1
STAT,1944,0,na,1944,4897.2674400509295
STAT,1910,27,35-39,1937,14.786573520582946
SIM,1874,31,35-39,1905,13
STAT,1912,32,40-44,1944,3.9281823100284687
SIM,1900,26,na,1926,3410
STAT,1926,25,20-24,1951,22.47474432512205
STAT,1889,24,40-44,1913,2.609459851532771
STAT,1882,49,50-100,1931,0.23899960693184358
STAT,1883,42,50-100,1925,1.0561699039795023
STAT,1917,27,20-24,1944,19.53549578904023
STAT,1919,41,50-100,1960,0.1301041717490957
SIM,1859,3,na,1862,2960
SIM,1852,15,20-24,1867,19
SIM,1843,17,20-24,1860,27
STAT,1887,19,35-39,1906,0.623883940714355
STAT,1819,41,15-19,1860,0.030692623545679344
STAT,1858,20,45-49,1878,0.656665228188937
STAT,1855,38,50-100,1893,0.9470234254496616
STAT,1882,38,15-19,1920,0.055533896509008994
STAT,1914,21,35-39,1935,9.446885403171006
SIM,1928,4,na,1932,5323
SIM,1888,29,45-49,1917,2
STAT,1919,30,25-29,1949,10.25764702335308
STAT,1868,19,25-29,1887,5.555420503287508
STAT,1856,48,15-19,1904,3.162962842795816E-4
SIM,1880,32,na,1912,2337
SIM,1884,46,na,1930,2391
STAT,1918,48,45-49,1966,0.23536223958008243
SIM,1916,24,15-19,1940,6
SIM,1879,23,35-39,1902,9
STAT,1943,25,20-24,1968,19.85157938647959
SIM,1876,27,na,1903,2796
STAT,1821,44,35-39,1865,2.9452332030346713
SIM,1916,46,35-39,1962,1
STAT,1934,27,20-24,1961,25.04222670051193
STAT,1903,42,40-44,1945,0.22622862715226522
SIM,1931,24,40-44,1955,6
STAT,1902,40,na,1942,3370.204799084061
SIM,1886,18,30-34,1904,6
SIM,1945,2,na,1947,4762
STAT,1908,35,50-100,1943,0.4046551102565545
STAT,1923,24,40-44,1947,3.96669755262518
STAT,1855,52,40-44,1907,0.008117570485409965
STAT,1881,45,45-49,1926,0.23508199908821895
STAT,1834,67,na,1901,1065.294189197225
SIM,1893,39,na,1932,3086
SIM,1936,20,25-29,1956,84
STAT,1839,33,40-44,1872,3.6451383977207006
SIM,1817,48,na,1865,1344
STAT,1903,31,50-100,1934,1.3341368535977924
STAT,1908,24,15-19,1932,4.959025703917748
STAT,1869,32,15-19,1901,0.1402585187458897
STAT,1828,27,50-100,1855,0.9388840096670499
STAT,1906,54,na,1960,3204.9373035175527
STAT,1843,31,50-100,1874,0.8984951730900299
SIM,1800,75,na,1875,432
SIM,1825,67,na,1892,940
STAT,1906,35,20-24,1941,0.24939632470789994
SIM,1821,53,na,1874,1262
SIM,1927,30,25-29,1957,11
STAT,1885,41,50-100,1926,1.0800995090335395
SIM,1876,19,25-29,1895,15
STAT,1838,45,50-100,1883,0.1904699251765878
STAT,1917,49,40-44,1966,0.16706934587594124
SIM,1836,27,30-34,1863,32
STAT,1895,18,30-34,1913,2.1158994583138653
STAT,1923,35,20-24,1958,0.3121827494193534
SIM,1853,31,15-19,1884,1
STAT,1811,105,na,1916,0.01270049528077176
STAT,1815,47,15-19,1862,0.001076054790046993
STAT,1888,46,50-100,1934,0.2970395237994837
STAT,1901,39,na,1940,3353.414855913165
STAT,1834,51,na,1885,1513.3053680049707
SIM,1863,47,45-49,1910,1
STAT,1914,27,50-100,1941,1.0237716898197677
STAT,1801,88,na,1889,46.31521795244304
SIM,1922,21,35-39,1943,15
STAT,1851,47,25-29,1898,0.04729945536318415
STAT,1864,31,25-29,1895,9.328853648986385
STAT,1860,99,na,1959,2.9236135269698247
STAT,1832,25,50-100,1857,0.601022560805845
SIM,1884,18,20-24,1902,1
STAT,1908,46,35-39,1954,0.11979556590311596
STAT,1895,22,15-19,1917,4.39103709347745
SIM,1873,94,na,1967,30
STAT,1819,62,na,1881,1165.8775921387553
STAT,1899,19,50-100,1918,0.06807313942315461
STAT,1903,32,15-19,1935,0.20651457529279504
STAT,1855,47,45-49,1902,0.1820938862468726
STAT,1881,45,na,1926,2241.08926645236
STAT,1938,16,na,1954,3712.903376343619
STAT,1879,21,50-100,1900,0.43616219030369047
STAT,1885,59,na,1944,1978.0165983930613
SIM,1911,32,15-19,1943,1
SIM,1869,57,na,1926,2027
SIM,1917,42,na,1959,3812
STAT,1828,27,30-34,1855,36.95976913494854
STAT,1835,40,50-100,1875,0.968024053763699
SIM,1888,34,40-44,1922,6
SIM,1865,43,na,1908,2229
STAT,1868,38,50-100,1906,1.1903389516736513
SIM,1842,31,na,1873,1982
STAT,1928,16,40-44,1944,1.802115634638806
SIM,1925,36,35-39,1961,2
STAT,1875,20,45-49,1895,0.7344593275380187
STAT,1942,21,na,1963,3907.677474796391
SIM,1905,41,na,1946,3359
STAT,1938,33,50-100,1971,0.8475217435217803
SIM,1846,45,na,1891,1845
STAT,1865,38,15-19,1903,0.05173577905336173
STAT,1928,39,15-19,1967,0.024702137055467328
STAT,1914,34,40-44,1948,3.9846744107684877
STAT,1874,16,45-49,1890,0.06820453041604195
STAT,1938,30,35-39,1968,9.383888690824387
STAT,1915,20,50-100,1935,0.6700032122586406
STAT,1920,32,15-19,1952,0.14364174900403695
STAT,1876,41,45-49,1917,1.5837385041943275
STAT,1908,37,20-24,1945,0.25167600491276015
STAT,1834,47,25-29,1881,0.04110837788885725
STAT,1927,41,15-19,1968,0.0019674740479495426
SIM,1847,20,35-39,1867,6
STAT,1890,35,45-49,1925,2.510164509962195
SIM,1922,34,40-44,1956,7
STAT,1952,15,20-24,1967,165.82423946751254
STAT,1798,67,na,1865,915.8419488835654
STAT,1930,17,35-39,1947,5.532988204632588
SIM,1902,17,25-29,1919,9
STAT,1862,45,35-39,1907,0.12278806531004151
STAT,1809,50,45-49,1859,0.06416662673404416
SIM,1796,69,na,1865,553
SIM,1860,12,na,1872,2358
SIM,1900,10,na,1910,3742
STAT,1915,28,25-29,1943,68.26670546124873
STAT,1890,5,na,1895,3268.819019280176
STAT,1853,33,15-19,1886,0.12169593498623059
SIM,1830,46,na,1876,1698
SIM,1855,22,35-39,1877,11
STAT,1917,54,na,1971,3813.7456533811387
STAT,1891,28,15-19,1919,0.5710083231859622
SIM,1893,16,20-24,1909,24
STAT,1879,63,na,1942,1902.7017582708045
STAT,1913,40,na,1953,3736.666354318438
SIM,1945,22,na,1967,4363
STAT,1838,65,na,1903,1241.7035962627087
SIM,1905,4,na,1909,3813
SIM,1889,42,35-39,1931,4
SIM,1864,26,na,1890,2186
STAT,1837,50,20-24,1887,5.137379616978453E-4
SIM,1934,0,na,1934,5938
SIM,1832,22,40-44,1854,4
STAT,1886,24,15-19,1910,3.5400252871943945
SIM,1918,46,45-49,1964,1
STAT,1931,37,20-24,1968,0.35604924690702067
STAT,1898,30,40-44,1928,6.0308177710912
SIM,1926,19,na,1945,4810
SIM,1907,1,na,1908,4063
STAT,1920,46,35-39,1966,0.14580317815938645
STAT,1892,44,50-100,1936,0.09253199726250756
STAT,1855,41,25-29,1896,0.5000514493315169
STAT,1824,37,15-19,1861,0.07766428112282492
SIM,1920,26,30-34,1946,58
STAT,1947,20,35-39,1967,10.864970589627967
SIM,1786,70,na,1856,597
STAT,1813,73,na,1886,543.0782107422443
STAT,1912,26,30-34,1938,39.525082589959844
STAT,1902,19,25-29,1921,8.108693666673064
SIM,1842,44,20-24,1886,1
STAT,1843,71,na,1914,1077.548511036948
STAT,1903,40,15-19,1943,0.0014047155996505633
SIM,1910,19,25-29,1929,19
STAT,1849,30,45-49,1879,1.6005941703758313
STAT,1842,54,20-24,1896,5.62766469112816E-4
STAT,1868,15,50-100,1883,0.04917799966056589
STAT,1892,21,35-39,1913,7.483547884618914
STAT,1931,21,na,1952,4844.939557945513
STAT,1847,22,35-39,1869,5.578571438835885
STAT,1897,44,na,1941,3120.8019577124132
STAT,1893,30,na,1923,3113.0596885541354
STAT,1782,106,na,1888,0.012742063363275612
STAT,1910,32,30-34,1942,15.49386657551186
STAT,1954,18,35-39,1972,5.289461132723601
STAT,1886,46,35-39,1932,0.15160290455187092
STAT,1825,30,35-39,1855,24.59302653888839
STAT,1914,49,15-19,1963,3.7056229166994157E-4
STAT,1921,25,45-49,1946,1.9781091424922355
SIM,1872,77,na,1949,725
SIM,1821,37,na,1858,1571
SIM,1780,81,na,1861,192
STAT,1879,44,50-100,1923,1.1113464068504528
STAT,1869,20,45-49,1889,0.6938532660122115
STAT,1930,36,na,1966,5009.568087296099
SIM,1930,18,15-19,1948,60
SIM,1861,47,35-39,1908,1
SIM,1869,15,15-19,1884,7
SIM,1936,28,35-39,1964,29
STAT,1937,8,na,1945,3957.762825413074
SIM,1849,20,45-49,1869,1
STAT,1871,99,na,1970,13.07432337103371
STAT,1827,43,15-19,1870,0.016058588572343834
STAT,1848,51,35-39,1899,0.006724125960952753
SIM,1833,30,35-39,1863,12
STAT,1903,34,40-44,1937,3.580200075742394
STAT,1778,108,na,1886,0.0033363404292252492
STAT,1925,35,30-34,1960,2.2356439779021935
SIM,1880,48,na,1928,2122
STAT,1888,23,35-39,1911,7.015960335841367
STAT,1814,90,na,1904,36.73869516630164
SIM,1847,46,na,1893,1533
SIM,1912,27,35-39,1939,31
STAT,1922,18,15-19,1940,53.45159091497815
SIM,1876,16,20-24,1892,18
STAT,1928,20,25-29,1948,118.33838663049038
SIM,1932,22,50-100,1954,1
STAT,1894,34,15-19,1928,0.18527003708642215
STAT,1814,51,40-44,1865,0.030639329502892512
STAT,1901,55,na,1956,2971.056393840491
STAT,1928,28,35-39,1956,18.85776129203705
STAT,1832,47,15-19,1879,3.1755772207598965E-4
STAT,1923,27,45-49,1950,2.0237634222522267
SIM,1911,34,40-44,1945,11
STAT,1841,27,50-100,1868,0.5866424502120811
STAT,1877,50,50-100,1927,0.01620964668877081
STAT,1856,94,na,1950,16.004920993379436
STAT,1925,33,50-100,1958,1.0010713749501399
STAT,1881,42,40-44,1923,2.215678708450321
SIM,1877,20,45-49,1897,2
STAT,1943,17,20-24,1960,146.67932601746764
STAT,1875,45,20-24,1920,0.01268938730466013
SIM,1879,36,40-44,1915,3
SIM,1933,35,30-34,1968,6
STAT,1853,47,35-39,1900,0.1168425389244909
STAT,1877,53,30-34,1930,0.006197182961209901
STAT,1916,48,35-39,1964,0.13457401121233697
SIM,1896,23,35-39,1919,10
SIM,1896,32,25-29,1928,15
STAT,1885,16,20-24,1901,18.08803901672302
STAT,1945,25,30-34,1970,43.89635937596936
STAT,1904,27,35-39,1931,14.10736856831278
SIM,1918,32,25-29,1950,12
SIM,1887,27,na,1914,2950
STAT,1896,42,25-29,1938,0.060008159566468246
SIM,1904,17,35-39,1921,1
STAT,1856,33,40-44,1889,3.4790632528455285
SIM,1856,23,40-44,1879,2
STAT,1908,38,35-39,1946,2.2977984761908083
SIM,1916,38,35-39,1954,7
STAT,1888,32,25-29,1920,12.352787737865212
STAT,1943,22,na,1965,3963.9419051222817
STAT,1848,23,40-44,1871,1.9581278631263712
STAT,1868,47,na,1915,2181.951377826507
SIM,1951,17,20-24,1968,168
STAT,1808,54,20-24,1862,0.0016885564195359846
STAT,1870,44,30-34,1914,1.1310453591207585
SIM,1863,7,na,1870,2479
STAT,1924,22,50-100,1946,0.7921496412874136
STAT,1872,36,50-100,1908,1.2613223402937128
SIM,1932,8,na,1940,5549
STAT,1829,51,25-29,1880,0.002826253276222902
STAT,1830,34,35-39,1864,9.354921839939689
STAT,1852,40,45-49,1892,1.2178616854961815
SIM,1857,29,na,1886,2017
STAT,1941,18,25-29,1959,45.523443539148026
SIM,1853,15,na,1868,2277
STAT,1872,84,na,1956,368.8252838986443
STAT,1842,38,50-100,1880,1.117771734249636
STAT,1941,15,45-49,1956,0.5252121183185605
SIM,1919,19,45-49,1938,3
SIM,1922,30,25-29,1952,13
STAT,1879,30,30-34,1909,18.767913167042344
SIM,1877,20,20-24,1897,92
STAT,1901,46,25-29,1947,0.04648286418704153
SIM,1892,3,na,1895,3861
STAT,1860,34,20-24,1894,2.2182048716691174
SIM,1845,25,30-34,1870,30
SIM,1905,57,na,1962,3064
STAT,1843,28,na,1871,2133.764124622022
SIM,1836,22,25-29,1858,66
SIM,1888,12,na,1900,3063
STAT,1932,2,na,1934,5522.9125511332695
STAT,1845,45,35-39,1890,0.11047912934675995
SIM,1880,36,50-100,1916,1
STAT,1804,54,50-100,1858,0.0425249042777598
STAT,1804,109,na,1913,2.4006063062257654E-4
STAT,1858,53,50-100,1911,0.012022063231276883
STAT,1789,101,na,1890,0.11351081569329893
STAT,1934,28,35-39,1962,20.586938881777105
SIM,1908,22,na,1930,3781
STAT,1876,18,20-24,1894,18.626825440001124
SIM,1841,40,35-39,1881,2
SIM,1943,18,25-29,1961,66
STAT,1816,97,na,1913,2.3837359440269537
SIM,1923,17,45-49,1940,3
STAT,1855,13,na,1868,2191.090134589643
STAT,1859,27,na,1886,1977.897356110639
SIM,1839,59,na,1898,1453
STAT,1840,30,25-29,1870,9.165672025721094
STAT,1917,22,15-19,1939,5.773491231507504
SIM,1820,46,35-39,1866,1
STAT,1851,39,25-29,1890,2.351480492739953
STAT,1821,41,30-34,1862,2.060454830513505
STAT,1869,20,20-24,1889,68.56974003746896
STAT,1937,17,45-49,1954,0.49570228690349133
SIM,1805,79,na,1884,224
SIM,1878,46,50-100,1924,1
SIM,1835,45,na,1880,1644
SIM,1848,41,35-39,1889,5
STAT,1870,77,na,1947,862.0260437256969
SIM,1831,31,na,1862,1760
STAT,1868,16,20-24,1884,17.691064641326264
SIM,1901,26,20-24,1927,16
STAT,1880,44,na,1924,2444.2729319226246
SIM,1898,31,45-49,1929,5
STAT,1848,40,50-100,1888,0.8414920036745351
STAT,1833,40,35-39,1873,1.4897805555482901
STAT,1877,56,na,1933,2158.1081237492126
STAT,1783,100,na,1883,0.23008300888276853
SIM,1897,27,45-49,1924,6
STAT,1867,62,na,1929,1750.47606818319
STAT,1889,27,45-49,1916,1.3991414060561789
SIM,1860,28,na,1888,2122
SIM,1838,35,40-44,1873,2
SIM,1904,28,15-19,1932,1
STAT,1860,83,na,1943,328.591795249214
SIM,1840,20,25-29,1860,64
STAT,1878,51,20-24,1929,7.873170613098381E-4
SIM,1869,29,35-39,1898,11
STAT,1843,106,na,1949,0.009801658541814572
STAT,1850,27,15-19,1877,0.4016151016358064
STAT,1925,43,30-34,1968,0.15766606141331074
STAT,1897,26,40-44,1923,4.100081039664393
STAT,1862,42,30-34,1904,0.9971427714258758
STAT,1830,31,50-100,1861,0.8914929837978424
STAT,1896,59,na,1955,2618.533119944236
STAT,1903,45,45-49,1948,0.19497585547336457
STAT,1823,51,na,1874,1368.7728417056799
STAT,1834,44,20-24,1878,0.12558215284414204
STAT,1827,65,na,1892,1092.2554410524167
STAT,1812,46,35-39,1858,0.3370630705803333
STAT,1892,45,na,1937,2905.778902167485
STAT,1869,28,30-34,1897,24.714562818339022
SIM,1881,21,25-29,1902,1
STAT,1821,49,40-44,1870,0.26180632692692796
SIM,1776,92,na,1868,12
STAT,1886,76,na,1962,1251.9580726745091
SIM,1847,30,na,1877,1818
SIM,1853,23,15-19,1876,4
SIM,1819,35,30-34,1854,7
SIM,1925,22,15-19,1947,7
SIM,1818,49,na,1867,1371
SIM,1914,18,na,1932,4025
STAT,1762,96,na,1858,1.4044831982979136
STAT,1881,29,na,1910,2336.9510802297395
STAT,1943,28,25-29,1971,71.4844941474538
SIM,1942,28,35-39,1970,1
STAT,1878,17,40-44,1895,0.19421766632227103
STAT,1882,62,na,1944,1816.5396250468968
SIM,1857,13,na,1870,2376
SIM,1888,30,25-29,1918,12
STAT,1916,18,15-19,1934,9.8002061563824
SIM,1869,21,25-29,1890,92
STAT,1851,20,35-39,1871,5.832757465278992
SIM,1850,34,na,1884,1842
SIM,1896,8,na,1904,3565
STAT,1889,41,na,1930,2925.6724065256917
SIM,1923,28,25-29,1951,81
STAT,1914,30,25-29,1944,9.568710924378456
SIM,1884,62,na,1946,1813
SIM,1887,30,30-34,1917,21
STAT,1936,29,50-100,1965,0.9706023969156837
STAT,1869,49,50-100,1918,0.23684295850430342
STAT,1863,54,40-44,1917,0.009157527396945416
SIM,1931,38,25-29,1969,4
STAT,1919,35,30-34,1954,2.0092290159026027
STAT,1814,40,25-29,1854,2.4312540723975613
STAT,1935,18,25-29,1953,60.25660697297653
SIM,1859,31,na,1890,2267
STAT,1923,38,25-29,1961,1.1628415587786953
STAT,1899,20,30-34,1919,25.031687255470104
STAT,1840,41,40-44,1881,1.7101795327141638
SIM,1878,93,na,1971,83
STAT,1771,113,na,1884,4.405231788218365E-4
SIM,1858,28,20-24,1886,14
SIM,1886,26,30-34,1912,40
STAT,1832,39,15-19,1871,0.046665760734553495
SIM,1806,48,na,1854,1491
STAT,1831,86,na,1917,149.50487391601777
STAT,1769,86,na,1855,32.372
STAT,1902,24,na,1926,3381.1665059996917
STAT,1922,40,25-29,1962,0.08386431362998362
STAT,1936,22,25-29,1958,90.07071608466543
STAT,1878,26,30-34,1904,26.831446560697977
STAT,1839,48,15-19,1887,2.7768656739556274E-4
SIM,1944,22,25-29,1966,134
SIM,1927,35,30-34,1962,2
STAT,1828,82,na,1910,256.93142518577827
STAT,1845,23,15-19,1868,3.177050103804631
SIM,1817,64,na,1881,862
STAT,1848,59,na,1907,1510.7190354372913
STAT,1867,15,15-19,1882,5.879510830387507
STAT,1861,40,50-100,1901,0.8995414146823675
STAT,1918,45,40-44,1963,0.1720191533763887
STAT,1927,45,30-34,1972,0.11468428392661949
STAT,1910,24,30-34,1934,27.355941932876718
SIM,1820,68,na,1888,1009
STAT,1869,36,30-34,1905,5.274410523032936
SIM,1915,24,50-100,1939,4
STAT,1840,47,na,1887,1632.6129344131546
STAT,1920,43,30-34,1963,0.14386392967164593
SIM,1945,18,35-39,1963,9
SIM,1948,19,15-19,1967,61
SIM,1856,66,na,1922,1619
SIM,1822,48,50-100,1870,1
STAT,1838,81,na,1919,397.32788447935457
SIM,1888,15,25-29,1903,14
SIM,1883,20,45-49,1903,1
STAT,1860,29,25-29,1889,34.88229093531527
SIM,1938,20,35-39,1958,16
STAT,1810,47,15-19,1857,0.0012575338455662625
SIM,1926,30,50-100,1956,1
STAT,1881,31,25-29,1912,10.143332560955193
SIM,1922,37,45-49,1959,2
STAT,1890,32,40-44,1922,5.409346341977282
STAT,1926,39,40-44,1965,1.8624209941628191
SIM,1919,27,45-49,1946,2
SIM,1936,24,40-44,1960,4
STAT,1859,2,na,1861,2832.2540704525036
STAT,1917,38,25-29,1955,1.0384604145688232
STAT,1910,35,35-39,1945,2.381758288743787
STAT,1866,30,45-49,1896,1.6540743522436447
SIM,1837,84,na,1921,275
SIM,1882,41,35-39,1923,7
SIM,1934,16,30-34,1950,21
STAT,1830,31,30-34,1861,16.988039405680848
STAT,1839,50,na,1889,1522.9729991094678
STAT,1874,32,na,1906,2485.490561587811
SIM,1879,20,30-34,1899,33
STAT,1940,20,25-29,1960,96.06031495722485
SIM,1925,33,30-34,1958,8
STAT,1863,40,20-24,1903,0.14348393164379952
SIM,1822,40,25-29,1862,1
STAT,1771,89,na,1860,32.030380194850544
SIM,1801,60,na,1861,1156
SIM,1875,38,25-29,1913,4
STAT,1917,33,30-34,1950,16.765150078775584
STAT,1891,16,45-49,1907,0.08270481587535475
STAT,1902,17,35-39,1919,0.7893979403957
STAT,1903,62,na,1965,2875.6007173329854
STAT,1878,15,15-19,1893,6.33094785538433
SIM,1832,25,45-49,1857,1
SIM,1807,86,na,1893,21
SIM,1879,32,25-29,1911,18
STAT,1926,17,20-24,1943,169.57277712701966
SIM,1877,36,30-34,1913,1
SIM,1887,43,na,1930,2734
STAT,1823,41,40-44,1864,3.7300707227793053
STAT,1921,27,35-39,1948,17.074631046762963
SIM,1843,25,20-24,1868,14
STAT,1916,5,na,1921,4339.041722537641
STAT,1936,31,15-19,1967,0.12738121377586187
STAT,1823,67,na,1890,882.2575235158001
STAT,1867,38,25-29,1905,2.7438212419887815
SIM,1911,5,na,1916,4149
STAT,1953,5,na,1958,4851.708995315794
STAT,1822,82,na,1904,271.2915574354863
STAT,1826,96,na,1922,5.008087995993644
STAT,1837,21,15-19,1858,2.9002580235301805
SIM,1845,21,15-19,1866,2
STAT,1908,45,20-24,1953,0.010341200614830893
STAT,1783,74,na,1857,456.0169729526808
STAT,1914,37,45-49,1951,0.6944653463639117
STAT,1866,31,35-39,1897,9.568209773649736
STAT,1965,3,na,1968,5008.490804412826
STAT,1835,25,20-24,1860,11.561948841504115
STAT,1787,88,na,1875,54.783615475878456
STAT,1901,30,15-19,1931,0.20478881681374694
STAT,1840,108,na,1948,0.0013181045448853305
STAT,1862,27,30-34,1889,21.94857811460658
SIM,1831,41,40-44,1872,4
SIM,1932,18,25-29,1950,69
STAT,1874,28,15-19,1902,0.47089584970777243
STAT,1914,25,na,1939,3879.2612376787674
STAT,1918,39,na,1957,4038.031803115598
SIM,1918,43,40-44,1961,1
SIM,1828,48,na,1876,1631
SIM,1838,31,25-29,1869,11
STAT,1851,63,na,1914,1472.0820163398762
STAT,1920,30,25-29,1950,10.414409572940691
STAT,1927,33,15-19,1960,0.16114951332720023
STAT,1855,77,na,1932,670.0753033806016
SIM,1847,14,na,1861,2111
STAT,1789,74,na,1863,359.0002898022457
SIM,1945,17,45-49,1962,3
STAT,1864,42,40-44,1906,2.037766412576515
SIM,1934,17,20-24,1951,186
STAT,1904,15,40-44,1919,0.2686587668690503
SIM,1838,35,50-100,1873,3
SIM,1905,48,25-29,1953,1
STAT,1843,50,45-49,1893,0.011883836556689524
STAT,1846,51,25-29,1897,0.0025450898094852023
SIM,1913,18,15-19,1931,10
SIM,1854,2,na,1856,3001
STAT,1847,58,na,1905,1542.1562517902646
SIM,1832,34,50-100,1866,1
SIM,1883,21,35-39,1904,8
STAT,1929,41,25-29,1970,0.09445760869315022
SIM,1878,19,35-39,1897,1
STAT,1881,0,na,1881,3534.4459822903277
STAT,1819,52,30-34,1871,0.01134118777961861
STAT,1924,18,25-29,1942,52.51214321952051
SIM,1929,22,35-39,1951,19
SIM,1902,28,40-44,1930,9
STAT,1920,40,15-19,1960,0.0017356344687230018
STAT,1876,26,20-24,1902,12.400665788040058
STAT,1907,16,20-24,1923,26.62055636819624
STAT,1874,41,35-39,1915,1.8946085977212537
SIM,1884,26,20-24,1910,1
STAT,1870,53,20-24,1923,7.240838220447825E-4
SIM,1820,52,na,1872,1506
SIM,1935,33,15-19,1968,1
STAT,1832,24,40-44,1856,2.007603395531114
STAT,1807,50,35-39,1857,0.037045252127496535
SIM,1912,20,15-19,1932,6
SIM,1913,25,50-100,1938,1
STAT,1853,44,30-34,1897,0.9509831765620697
STAT,1886,43,30-34,1929,1.232457888161767
STAT,1928,24,40-44,1952,4.255302777603041
STAT,1922,18,50-100,1940,0.4412623563461924
SIM,1872,42,40-44,1914,3
STAT,1830,39,40-44,1869,3.8429519223983752
STAT,1934,35,20-24,1969,0.37161871106110705
STAT,1873,20,35-39,1893,6.0713531181960185
STAT,1922,47,20-24,1969,0.01295411760470994
STAT,1940,27,45-49,1967,1.7972250824398073
SIM,1808,47,25-29,1855,1
STAT,1899,26,15-19,1925,0.6359837647652499
SIM,1883,46,50-100,1929,1
STAT,1857,79,na,1936,556.9903608187536
STAT,1937,18,35-39,1955,4.152990563509439
SIM,1872,13,na,1885,2739
SIM,1896,36,40-44,1932,3
STAT,1926,16,30-34,1942,15.282747710512199
SIM,1831,90,na,1921,60
SIM,1888,41,50-100,1929,4
SIM,1848,40,45-49,1888,4
STAT,1869,80,na,1949,609.260702374456
STAT,1915,17,45-49,1932,0.10668888091850004
STAT,1856,36,45-49,1892,1.6040746487792918
SIM,1927,20,na,1947,4345
STAT,1833,27,15-19,1860,0.3998985537726501
STAT,1910,26,20-24,1936,18.03964703883775
STAT,1880,18,50-100,1898,0.05238314040118273
STAT,1774,111,na,1885,8.814576061318743E-4
STAT,1905,18,15-19,1923,8.720729779192485
STAT,1880,76,na,1956,1056.853713421393
SIM,1859,16,20-24,1875,21
STAT,1873,10,na,1883,2747.1803598743727
STAT,1826,37,25-29,1863,2.572622536878296
SIM,1903,32,40-44,1935,5
SIM,1870,70,na,1940,1457
STAT,1861,15,20-24,1876,17.381224521946017
STAT,1849,65,na,1914,1312.0202082933188
SIM,1866,65,na,1931,1777
SIM,1911,10,na,1921,4105
STAT,1892,49,15-19,1941,2.824625441222168E-4
SIM,1874,84,na,1958,366
STAT,1863,29,50-100,1892,0.568084524505554
SIM,1920,22,15-19,1942,8
STAT,1772,90,na,1862,15.64210687381471
STAT,1918,47,30-34,1965,0.09680753517145856
STAT,1925,24,15-19,1949,6.46012327566991
SIM,1882,2,na,1884,2968
SIM,1864,21,25-29,1885,67
SIM,1908,27,20-24,1935,31
STAT,1901,43,20-24,1944,0.015619097139583262
STAT,1921,20,15-19,1941,6.171938723566553
SIM,1898,0,na,1898,4122
SIM,1853,42,30-34,1895,1
STAT,1832,71,na,1903,891.9510767529805
STAT,1916,41,15-19,1957,0.0016082808292034517
SIM,1794,89,na,1883,16
SIM,1919,49,na,1968,4128
STAT,1884,9,na,1893,2618.7180709266163
STAT,1877,83,na,1960,579.1048539708238
SIM,1790,75,na,1865,276
SIM,1861,44,50-100,1905,4
STAT,1836,37,30-34,1873,4.072113523267142
SIM,1935,23,na,1958,5435
SIM,1862,51,na,1913,1957
STAT,1810,49,40-44,1859,0.5196234335617888
SIM,1919,20,25-29,1939,128
SIM,1915,35,na,1950,4275
STAT,1911,28,40-44,1939,4.6202683656458
SIM,1933,24,15-19,1957,6
SIM,1829,48,45-49,1877,1
STAT,1894,45,30-34,1939,0.0723657277106971
STAT,1905,47,20-24,1952,0.00992657380211327
STAT,1949,20,45-49,1969,1.34042781793576
STAT,1848,18,45-49,1866,0.06257528780270959
STAT,1867,51,45-49,1918,0.013965500534322859
STAT,1857,95,na,1952,10.592806573580017
STAT,1808,49,25-29,1857,0.1418871593770866
STAT,1841,85,na,1926,202.40788751600235
STAT,1936,30,25-29,1966,9.166875101619636
SIM,1844,37,30-34,1881,6
STAT,1890,48,15-19,1938,2.7790419991063675E-4
STAT,1856,14,na,1870,2239.9914556764616
STAT,1900,26,15-19,1926,0.6437140901704502
SIM,1851,31,50-100,1882,2
STAT,1871,25,30-34,1896,25.619570258331688
STAT,1886,60,na,1946,2059.395689806696
STAT,1893,41,45-49,1934,1.9456354792622188
STAT,1828,38,35-39,1866,6.069236681880981
STAT,1902,22,30-34,1924,25.62556099604883
STAT,1785,104,na,1889,0.03499408858312758
SIM,1840,25,50-100,1865,4
SIM,1903,34,30-34,1937,17
STAT,1937,29,15-19,1966,0.7012423815658481
SIM,1899,24,15-19,1923,5
STAT,1888,39,45-49,1927,2.379988184103638
STAT,1853,41,15-19,1894,0.011631918586276371
STAT,1929,40,35-39,1969,0.2667150299516054
SIM,1833,31,50-100,1864,4
STAT,1869,64,na,1933,1712.1238584682005
SIM,1953,16,40-44,1969,3
STAT,1914,45,20-24,1959,0.011235054121103438
STAT,1873,21,25-29,1894,59.38499877939381
STAT,1955,17,50-100,1972,0.50727741586336
STAT,1945,16,40-44,1961,1.5593206158340291
STAT,1836,52,30-34,1888,0.0037491212962447247
STAT,1920,37,45-49,1957,0.7617022309964628
STAT,1820,86,na,1906,122.19931045128341
STAT,1827,54,30-34,1881,0.005640794613125757
STAT,1900,16,50-100,1916,0.0694421874893195
SIM,1910,22,30-34,1932,54
STAT,1888,24,na,1912,2834.440525945444
SIM,1836,30,na,1866,2129
SIM,1887,44,50-100,1931,4
SIM,1949,7,na,1956,4779
SIM,1910,17,35-39,1927,1
STAT,1896,75,na,1971,1846.4097984873354
STAT,1901,37,35-39,1938,2.177855652299299
SIM,1854,59,na,1913,1693
STAT,1847,38,45-49,1885,1.5962501710096142
STAT,1892,61,na,1953,2389.1662219799155
SIM,1869,25,40-44,1894,8
SIM,1938,33,40-44,1971,7
STAT,1826,50,45-49,1876,0.01139265687573899
STAT,1852,48,na,1900,1789.7015978989107
STAT,1878,22,15-19,1900,3.5031057101149994
STAT,1897,22,25-29,1919,78.0851087705764
STAT,1775,110,na,1885,0.0018547186224046781
STAT,1931,30,50-100,1961,1.106134450768662
SIM,1870,27,30-34,1897,43
STAT,1892,48,25-29,1940,0.04102002887816396
SIM,1922,27,50-100,1949,1
SIM,1886,22,15-19,1908,4
SIM,1908,26,30-34,1934,57
SIM,1849,41,50-100,1890,3
STAT,1912,44,35-39,1956,0.19658682529073807
SIM,1875,58,na,1933,1907
SIM,1919,28,35-39,1947,31
STAT,1920,18,40-44,1938,1.5972451367573073
STAT,1852,25,20-24,1877,11.167616165969083
STAT,1853,100,na,1953,0.8901879706940127
SIM,1920,44,35-39,1964,1
STAT,1894,42,15-19,1936,0.0012568455332154296
SIM,1816,90,na,1906,17
SIM,1927,26,40-44,1953,7
STAT,1925,37,20-24,1962,0.3227954716587724
SIM,1954,15,na,1969,4389
SIM,1855,31,25-29,1886,14
SIM,1929,21,50-100,1950,1
SIM,1917,17,20-24,1934,27
STAT,1804,53,na,1857,1146.4100884442298
SIM,1966,5,na,1971,5192
STAT,1871,83,na,1954,401.16513647876377
STAT,1856,21,25-29,1877,53.62680017155777
SIM,1862,99,na,1961,8
STAT,1921,22,40-44,1943,3.875345739104184
STAT,1777,89,na,1866,42.81122054185312
STAT,1912,22,15-19,1934,5.204186697497945
STAT,1875,97,na,1972,37.20447346882165
STAT,1852,32,na,1884,1990.432315838438
SIM,1874,30,50-100,1904,1
STAT,1919,26,40-44,1945,5.156947018818481
SIM,1835,29,na,1864,1819
STAT,1847,30,35-39,1877,9.466916279414233
STAT,1847,31,25-29,1878,9.476014083635068
STAT,1837,17,30-34,1854,1.9421609080969289
SIM,1855,38,45-49,1893,1
SIM,1928,29,15-19,1957,1
SIM,1849,80,na,1929,600
STAT,1817,37,20-24,1854,2.726408687006355
SIM,1865,4,na,1869,2772
SIM,1910,27,25-29,1937,89
STAT,1936,26,40-44,1962,4.551707009746994
STAT,1845,42,30-34,1887,0.9147451084387686
SIM,1849,10,na,1859,2326
SIM,1938,28,45-49,1966,2
STAT,1851,48,15-19,1899,3.258601291711468E-4
STAT,1791,88,na,1879,42.2484163372693
SIM,1850,66,na,1916,1185
STAT,1893,28,25-29,1921,54.55153452293878
SIM,1845,17,30-34,1862,4
STAT,1889,19,45-49,1908,0.08187429602319946
STAT,1925,46,35-39,1971,0.15979135905992453
STAT,1888,56,na,1944,2459.839827212057
SIM,1855,30,35-39,1885,11
STAT,1853,70,na,1923,1176.4758779914112
STAT,1902,27,25-29,1929,60.8567488340508
SIM,1881,25,40-44,1906,4
SIM,1890,6,na,1896,3429
STAT,1884,51,45-49,1935,0.014717208107727368
SIM,1944,26,40-44,1970,9
STAT,1871,16,50-100,1887,0.05012245908236919
SIM,1906,58,na,1964,3089
STAT,1873,48,15-19,1921,4.0850133648371445E-4
STAT,1805,53,40-44,1858,0.03636253248137421
SIM,1897,20,25-29,1917,94
SIM,1859,95,na,1954,46
SIM,1925,35,20-24,1960,3
STAT,1842,70,na,1912,1100.2972543056492
STAT,1854,28,na,1882,1901.0574941359168
SIM,1861,48,25-29,1909,1
SIM,1936,27,45-49,1963,2
SIM,1855,81,na,1936,347
STAT,1851,8,na,1859,2463.1867275446834
SIM,1924,30,35-39,1954,12
STAT,1869,27,40-44,1896,2.9503561436753434
STAT,1877,30,20-24,1907,2.883058153910339
STAT,1779,85,na,1864,68.29916958000932
SIM,1901,35,35-39,1936,1
STAT,1934,38,25-29,1972,1.3842330559436018
SIM,1862,21,15-19,1883,2
STAT,1829,38,50-100,1867,1.0591806737584906
STAT,1823,44,45-49,1867,2.302696219995896
SIM,1924,16,25-29,1940,61
STAT,1934,33,30-34,1967,21.923447913308838
SIM,1907,33,50-100,1940,1
STAT,1939,29,25-29,1968,67.43437913278561
SIM,1886,17,40-44,1903,3
SIM,1878,40,30-34,1918,3
STAT,1922,31,35-39,1953,10.578505031742623
SIM,1831,44,45-49,1875,3
STAT,1880,15,30-34,1895,1.7166139977110793
STAT,1927,40,25-29,1967,0.09160937759161439
STAT,1858,80,na,1938,500.44914351835683
SIM,1940,25,45-49,1965,2
SIM,1951,16,30-34,1967,27
STAT,1848,38,15-19,1886,0.044518333721421714
SIM,1919,24,40-44,1943,8
STAT,1892,20,45-49,1912,0.8968883926262324
SIM,1823,39,15-19,1862,2
STAT,1909,35,na,1944,3666.2957274074083
STAT,1875,21,35-39,1896,6.128255858949791
STAT,1853,48,25-29,1901,0.04769066386110052
STAT,1921,24,30-34,1945,32.91886581627117
SIM,1837,38,50-100,1875,1
STAT,1868,79,na,1947,681.1853310266968
STAT,1848,43,na,1891,1783.624936305718
SIM,1946,23,na,1969,4032
STAT,1828,31,15-19,1859,0.14548299067897835
STAT,1766,89,na,1855,48.558
STAT,1887,82,na,1969,931.9412096646744
SIM,1896,31,35-39,1927,25
STAT,1873,25,40-44,1898,3.11917965348038
STAT,1865,26,45-49,1891,1.0315607403621816
STAT,1917,26,30-34,1943,42.07741187196251
STAT,1916,30,35-39,1946,9.705334901547868
STAT,1818,77,na,1895,440.5087598084521
SIM,1820,90,na,1910,45
STAT,1932,27,50-100,1959,1.3295421985671918
STAT,1865,51,35-39,1916,0.008009291198030148
STAT,1872,44,40-44,1916,2.2686843264582937
SIM,1810,103,na,1913,3
SIM,1911,30,25-29,1941,16
SIM,1864,58,na,1922,1856
SIM,1930,31,35-39,1961,19
STAT,1880,40,20-24,1920,0.1719701799284383
STAT,1780,102,na,1882,0.07826695641202087
STAT,1923,20,25-29,1943,110.312382728543
SIM,1948,20,40-44,1968,6
STAT,1898,45,na,1943,3135.299407840975
SIM,1901,11,na,1912,3832
STAT,1894,31,na,1925,3144.157538356715
STAT,1805,50,25-29,1855,0.012993208692999463
STAT,1922,17,na,1939,4346.51504977635
SIM,1873,62,na,1935,1836
SIM,1869,44,50-100,1913,2
STAT,1930,33,50-100,1963,1.0875809729795074
STAT,1858,58,na,1916,1599.8915301809607
STAT,1915,37,15-19,1952,0.019795922643798963
STAT,1908,43,30-34,1951,0.11989046002060345
STAT,1824,50,35-39,1874,0.010071609357372375
SIM,1835,39,50-100,1874,3
STAT,1831,43,40-44,1874,1.8809618131320918
SIM,1859,19,25-29,1878,2
STAT,1827,39,50-100,1866,1.5131707338434401
STAT,1921,38,15-19,1959,0.02185820007313521
STAT,1888,31,35-39,1919,12.26335806003214
STAT,1845,51,na,1896,1690.4205003945153
SIM,1807,49,na,1856,1264
STAT,1915,22,40-44,1937,3.5466931353864783
STAT,1941,20,na,1961,3852.765286250182
SIM,1868,13,na,1881,2665
SIM,1898,30,30-34,1928,29
STAT,1802,89,na,1891,33.33406035241745
SIM,1883,61,na,1944,1927
STAT,1812,43,30-34,1855,3.069976470021821
SIM,1820,43,30-34,1863,1
SIM,1860,27,25-29,1887,64
STAT,1939,27,20-24,1966,18.720101883767914
STAT,1852,27,25-29,1879,39.692159387473176
STAT,1893,46,na,1939,2920.4330080175905
STAT,1838,52,40-44,1890,0.007694034624722522
STAT,1882,46,na,1928,2242.413212661548
STAT,1943,16,30-34,1959,13.190780975303223
STAT,1932,38,na,1970,5149.887052165051
STAT,1938,22,35-39,1960,9.506185718148267
SIM,1829,40,35-39,1869,2
SIM,1843,96,na,1939,13
STAT,1850,102,na,1952,0.22052764307641962
STAT,1902,20,50-100,1922,0.5901662198374901
SIM,1946,22,35-39,1968,24
STAT,1903,30,25-29,1933,14.972857019588513
STAT,1908,48,25-29,1956,0.04878265506269454
STAT,1851,101,na,1952,0.47077438115605147
STAT,1864,45,45-49,1909,0.21620562589526568
STAT,1879,42,na,1921,2461.5677499307653
STAT,1916,16,25-29,1932,9.405555164311178
STAT,1949,6,na,1955,4664.5964788924
STAT,1830,85,na,1915,173.4152871358363
STAT,1870,42,50-100,1912,1.0522629541547468
SIM,1895,46,na,1941,3116
STAT,1917,35,20-24,1952,0.2820670350462113
SIM,1885,30,20-24,1915,4
SIM,1891,32,na,1923,3030
STAT,1876,39,na,1915,2456.8768057300354
STAT,1839,36,45-49,1875,1.6612524267457187
STAT,1854,21,15-19,1875,2.9881510291850804
STAT,1797,66,na,1863,797.1171221887892
STAT,1866,13,na,1879,2522.1939466400877
STAT,1940,24,40-44,1964,3.491922501589457
SIM,1837,18,35-39,1855,1
STAT,1873,27,45-49,1900,1.1483305407020414
STAT,1916,53,na,1969,3763.5197027271533
SIM,1914,35,45-49,1949,2
SIM,1930,24,na,1954,5082
SIM,1816,63,na,1879,1111
SIM,1862,25,30-34,1887,35
STAT,1891,41,35-39,1932,2.2974024492887004
STAT,1854,25,30-34,1879,22.525017330075244
STAT,1877,38,30-34,1915,5.6111812551141425
SIM,1840,27,45-49,1867,1
SIM,1841,30,na,1871,1936
STAT,1832,27,45-49,1859,1.0112949487183889
SIM,1885,38,30-34,1923,9
STAT,1918,43,15-19,1961,0.001663569487753712
STAT,1839,66,na,1905,1131.1543887228584
SIM,1845,44,na,1889,1779
SIM,1923,22,40-44,1945,7
STAT,1927,43,40-44,1970,0.3194852763644855
STAT,1873,7,na,1880,2813.075749972177
STAT,1876,17,30-34,1893,1.6790289074598566
STAT,1928,27,45-49,1955,2.171006485286999
STAT,1849,31,35-39,1880,9.1992638842246
SIM,1881,27,45-49,1908,1
STAT,1906,35,45-49,1941,0.6449620229773201
SIM,1924,17,na,1941,4844
SIM,1874,30,45-49,1904,9
SIM,1857,31,35-39,1888,16
STAT,1812,47,25-29,1859,0.13632345454583497
STAT,1924,24,na,1948,4368.814583005634
STAT,1928,38,na,1966,4844.916774169889
SIM,1877,38,35-39,1915,14
SIM,1896,31,na,1927,3246
STAT,1851,47,na,1898,1847.504239754024
SIM,1903,37,35-39,1940,5
STAT,1902,24,20-24,1926,98.52001165001002
STAT,1904,20,15-19,1924,4.852169396639152
STAT,1844,29,na,1873,2022.7639659441727
STAT,1884,15,15-19,1899,6.017467651544252
SIM,1905,30,25-29,1935,11
STAT,1812,110,na,1922,1.2603951744126436E-4
STAT,1944,23,na,1967,4021.430927375587
STAT,1912,35,45-49,1947,0.6852044809394455
SIM,1881,20,35-39,1901,10
SIM,1785,85,na,1870,71
SIM,1922,7,na,1929,4723
STAT,1941,27,15-19,1968,0.7450444283348397
SIM,1907,21,na,1928,3513
STAT,1850,40,35-39,1890,1.3758469829567712
STAT,1871,28,35-39,1899,9.71615815953912
SIM,1877,28,na,1905,2476
SIM,1858,27,30-34,1885,32
STAT,1888,36,40-44,1924,5.304766657094636
STAT,1920,10,na,1930,4550.284001776511
STAT,1865,28,na,1893,2201.9105167590656
SIM,1860,40,45-49,1900,1
STAT,1869,38,35-39,1907,6.931627739706295
SIM,1847,51,na,1898,1444
STAT,1870,47,35-39,1917,0.13896587726839385
SIM,1910,24,20-24,1934,109
SIM,1938,5,na,1943,4006
STAT,1889,39,15-19,1928,0.07005061703621157
STAT,1828,35,30-34,1863,4.88604337399047
SIM,1932,16,20-24,1948,176
STAT,1863,32,na,1895,2134.440030492195
SIM,1826,52,na,1878,1416
STAT,1897,20,20-24,1917,94.56001560418584
SIM,1939,27,25-29,1966,77
STAT,1889,40,40-44,1929,2.863010846934335
SIM,1925,28,35-39,1953,25
STAT,1924,16,20-24,1940,165.12193722470934
STAT,1834,39,25-29,1873,2.360551413968848
SIM,1861,44,30-34,1905,4
STAT,1859,43,na,1902,1869.3992331560055
STAT,1882,83,na,1965,663.3206300185248
STAT,1901,34,30-34,1935,24.694419666659414
STAT,1918,18,25-29,1936,48.00756477530654
SIM,1868,30,45-49,1898,2
STAT,1936,35,30-34,1971,1.828100894156877
STAT,1861,84,na,1945,280.42450603789786
STAT,1865,98,na,1963,9.252369958069949
STAT,1872,41,25-29,1913,0.6595311725856802
SIM,1844,81,na,1925,298
STAT,1846,54,40-44,1900,0.007321521096102605
SIM,1848,95,na,1943,23
STAT,1896,30,30-34,1926,23.71350297456774
STAT,1840,53,35-39,1893,0.006095592973388764
STAT,1859,18,20-24,1877,16.667356719918573
STAT,1917,28,35-39,1945,16.011070432208953
STAT,1841,29,15-19,1870,0.410123398614833
STAT,1943,18,35-39,1961,4.538364204398367
SIM,1927,22,25-29,1949,141
SIM,1911,36,30-34,1947,1
SIM,1908,22,15-19,1930,5
STAT,1870,98,na,1968,17.19496297670512
STAT,1936,29,45-49,1965,1.6846579557057513
SIM,1879,30,20-24,1909,4
SIM,1916,6,na,1922,4346
SIM,1924,31,50-100,1955,2
STAT,1927,7,na,1934,5069.978213137555
SIM,1836,35,30-34,1871,6
STAT,1916,31,50-100,1947,0.8746473512625715
SIM,1810,53,na,1863,1494
SIM,1840,26,45-49,1866,3
STAT,1858,25,15-19,1883,0.3812006331923104
SIM,1814,67,na,1881,867
STAT,1810,46,25-29,1856,0.1843035428662308
STAT,1862,47,na,1909,1944.6532635996682
STAT,1850,15,45-49,1865,0.06075689950558728
STAT,1853,44,50-100,1897,0.8738764305988621
STAT,1873,28,45-49,1901,1.1442884171987704
SIM,1831,52,na,1883,1419
SIM,1950,20,35-39,1970,16
SIM,1889,41,45-49,1930,3
STAT,1895,26,30-34,1921,33.632407032277385
STAT,1849,48,20-24,1897,0.009199266848107401
SIM,1881,28,45-49,1909,2
STAT,1799,73,na,1872,494.7769719290675
SIM,1890,10,na,1900,3410
SIM,1931,20,25-29,1951,137
SIM,1874,9,na,1883,2724
SIM,1810,47,40-44,1857,2
SIM,1855,35,40-44,1890,5
STAT,1812,67,na,1879,850.7325322600853
STAT,1932,25,45-49,1957,2.3096726000924463
SIM,1898,32,35-39,1930,20
SIM,1857,51,na,1908,1780
SIM,1870,23,15-19,1893,3
SIM,1951,18,35-39,1969,9
STAT,1850,52,40-44,1902,0.007876792180429446
STAT,1931,41,40-44,1972,0.34127431731602154
STAT,1919,22,25-29,1941,103.21641825988657
STAT,1862,23,15-19,1885,2.911681070059659
STAT,1815,39,15-19,1854,0.21367826845322319
SIM,1944,16,na,1960,3982
STAT,1867,94,na,1961,40.837520777562546
SIM,1880,44,40-44,1924,6
STAT,1907,0,na,1907,4398.300151810122
SIM,1894,24,na,1918,3392
STAT,1832,26,45-49,1858,1.025914856712882
SIM,1871,29,50-100,1900,1
STAT,1927,16,na,1943,4679.9288031510205
STAT,1954,17,45-49,1971,0.6298992049732554
SIM,1888,37,45-49,1925,2
STAT,1914,48,25-29,1962,0.05352641105963007
SIM,1876,43,na,1919,2652
STAT,1903,36,30-34,1939,1.6762151669860026
STAT,1897,60,na,1957,2648.001802380276
SIM,1797,70,na,1867,565
STAT,1896,38,na,1934,3158.589263172082
STAT,1889,20,25-29,1909,72.56810735836048
SIM,1906,28,25-29,1934,98
STAT,1879,53,40-44,1932,0.01104596282539616
STAT,1912,41,30-34,1953,0.12650949171013243
SIM,1941,24,50-100,1965,1
SIM,1907,18,15-19,1925,10
STAT,1833,66,na,1899,1076.330919719346
STAT,1881,54,35-39,1935,0.008257425824835225
STAT,1923,39,15-19,1962,0.022654135650858574
STAT,1892,2,na,1894,3408.211200130757
STAT,1892,24,na,1916,3004.9311120529774
STAT,1831,40,25-29,1871,0.5589761867429441
STAT,1846,95,na,1941,9.507928850036878
STAT,1765,93,na,1858,2.228066749745175
STAT,1878,18,30-34,1896,1.6880339010250733
STAT,1834,20,35-39,1854,9.4726473192697
STAT,1847,35,40-44,1882,3.616119965627681
STAT,1786,103,na,1889,0.045988220426561144
STAT,1871,32,30-34,1903,17.643474471687448
STAT,1829,29,na,1858,1900.7866907525854
STAT,1912,39,na,1951,3708.1628143985004
STAT,1918,30,50-100,1948,0.903780163220679
STAT,1911,36,50-100,1947,0.4156406181644166
SIM,1866,37,20-24,1903,3
STAT,1852,28,25-29,1880,39.407169683071096
STAT,1942,20,35-39,1962,10.079314132826196
STAT,1851,44,20-24,1895,0.12925494013504835
STAT,1933,24,50-100,1957,0.8894919207974475
SIM,1860,28,25-29,1888,36
STAT,1862,43,20-24,1905,0.13691698753680878
SIM,1866,21,35-39,1887,8
SIM,1839,27,20-24,1866,10
STAT,1864,51,30-34,1915,0.005425286684404
STAT,1899,62,na,1961,2694.0246477744245
STAT,1782,73,na,1855,458.42328
SIM,1949,16,15-19,1965,53
STAT,1898,18,20-24,1916,24.39335997010569
SIM,1910,26,25-29,1936,93
STAT,1854,50,na,1904,1671.6183802802846
SIM,1818,70,na,1888,680
STAT,1890,47,15-19,1937,2.801284195619586E-4
SIM,1907,16,25-29,1923,10
STAT,1925,28,30-34,1953,47.04997233193242
SIM,1799,98,na,1897,1
STAT,1845,34,30-34,1879,15.887127727441932
SIM,1838,96,na,1934,2
STAT,1837,80,na,1917,412.4345723298918
SIM,1922,10,na,1932,4689
SIM,1871,25,35-39,1896,14
STAT,1945,27,45-49,1972,1.933764818684528
SIM,1811,48,na,1859,1199
STAT,1841,48,na,1889,1647.464066323449
STAT,1847,42,40-44,1889,1.7637970988267915
SIM,1803,52,50-100,1855,1
SIM,1863,53,30-34,1916,1
SIM,1933,28,30-34,1961,66
STAT,1897,21,50-100,1918,0.5579203784302861
SIM,1836,83,na,1919,212
STAT,1839,18,40-44,1857,0.16415405852158635
STAT,1922,42,50-100,1964,0.13758840800630348
SIM,1783,89,na,1872,36
STAT,1852,85,na,1937,220.84314615456978
STAT,1927,36,40-44,1963,1.9003012224348024
SIM,1853,34,30-34,1887,26
STAT,1894,30,20-24,1924,3.5755142207883885
STAT,1902,26,25-29,1928,61.0655931626671
STAT,1842,65,na,1907,1325.2763882658314
STAT,1882,51,35-39,1933,0.00859728328519335
SIM,1910,15,30-34,1925,5
STAT,1906,4,na,1910,3906.1654970180653
STAT,1887,77,na,1964,1286.0562390530458
STAT,1853,40,50-100,1893,0.8947718999952419
STAT,1851,51,20-24,1902,6.117091779494684E-4
SIM,1945,17,na,1962,4408
SIM,1852,20,na,1872,2204
STAT,1867,41,50-100,1908,1.0163756158705173
SIM,1935,36,40-44,1971,3
SIM,1901,4,na,1905,3867
SIM,1886,42,na,1928,2563
SIM,1846,40,35-39,1886,7
STAT,1910,34,20-24,1944,2.3781750652298994
STAT,1871,30,na,1901,2430.8094789635957
SIM,1928,15,30-34,1943,16
STAT,1879,45,40-44,1924,0.1843800207104055
STAT,1828,44,na,1872,1420.7337445559858
STAT,1852,24,20-24,1876,65.00678349520068
STAT,1912,48,15-19,1960,3.6014142950267005E-4
STAT,1858,21,35-39,1879,5.455794786382126
STAT,1902,61,na,1963,2868.8149693657065
STAT,1894,41,15-19,1935,0.018203505426380683
SIM,1827,31,na,1858,1725
SIM,1926,29,40-44,1955,11
SIM,1865,17,20-24,1882,23
STAT,1902,15,30-34,1917,2.303666779616618
STAT,1904,23,40-44,1927,3.037251500577927
STAT,1819,44,30-34,1863,2.3411566472496426
STAT,1882,45,50-100,1927,0.24652968214382948
STAT,1841,50,35-39,1891,0.006447867698602204
STAT,1843,46,15-19,1889,3.2554773732144677E-4
STAT,1883,30,45-49,1913,1.7595363656609948
SIM,1942,26,30-34,1968,59
STAT,1769,91,na,1860,8.501329131167548
STAT,1920,39,35-39,1959,2.696777887370257
SIM,1948,0,na,1948,4760
STAT,1867,18,50-100,1885,0.04768488790447164
STAT,1929,19,15-19,1948,58.75666862558748
STAT,1812,104,na,1916,0.03042230289702068
STAT,1853,40,15-19,1893,0.011696365560514807
STAT,1919,37,45-49,1956,0.7473684775070855
STAT,1936,34,40-44,1970,3.871868845694305
STAT,1849,28,na,1877,1976.5689857582809
STAT,1921,18,45-49,1939,0.5795254708433423
SIM,1845,50,na,1895,1724
STAT,1803,52,50-100,1855,0.06100362434716038
STAT,1899,22,35-39,1921,8.151988832633423
STAT,1895,74,na,1969,1881.6084006468116
STAT,1896,33,50-100,1929,1.2292969862801677
STAT,1837,19,45-49,1856,0.06192689111591837
STAT,1837,96,na,1933,5.7249525751069825
SIM,1817,40,50-100,1857,1
SIM,1868,47,50-100,1915,1
SIM,1912,23,40-44,1935,3
STAT,1918,29,40-44,1947,5.025777737499525
STAT,1900,18,15-19,1918,8.369171691523537
STAT,1897,36,45-49,1933,2.732276408756979
SIM,1824,88,na,1912,55
SIM,1874,57,na,1931,2082
STAT,1829,83,na,1912,264.02963605728024
STAT,1864,46,35-39,1910,0.12735207638390628
STAT,1910,21,15-19,1931,5.113921586075982
STAT,1932,16,na,1948,4982.687831558787
STAT,1776,109,na,1885,0.0030436095657834566
SIM,1869,36,35-39,1905,8
STAT,1934,26,30-34,1960,53.77806453415325
STAT,1887,55,na,1942,2363.6724138391323
SIM,1907,38,30-34,1945,4
STAT,1847,54,35-39,1901,0.006528840768050161
STAT,1887,45,na,1932,2597.508528127844
SIM,1909,15,20-24,1924,46
SIM,1820,44,20-24,1864,1
SIM,1766,93,na,1859,3
STAT,1902,34,50-100,1936,0.7504031026647567
STAT,1828,66,na,1894,902.5483709123695
STAT,1895,22,50-100,1917,0.5427734980206894
STAT,1908,40,na,1948,3543.5673037957235
SIM,1855,42,40-44,1897,4
STAT,1849,38,na,1887,1852.306391845134
SIM,1837,31,na,1868,1705
SIM,1840,35,na,1875,1755
STAT,1779,91,na,1870,14.515842999627143
SIM,1887,41,35-39,1928,3
SIM,1795,74,na,1869,455
STAT,1823,33,40-44,1856,9.841317152217883
STAT,1863,25,35-39,1888,8.755782318858321
STAT,1903,25,na,1928,3484.3312052762512
SIM,1939,16,45-49,1955,1
STAT,1879,41,35-39,1920,1.9397075145161637
STAT,1853,33,na,1886,2039.2465285283188
SIM,1838,45,45-49,1883,1
SIM,1869,19,30-34,1888,2
SIM,1870,33,na,1903,2647
STAT,1782,95,na,1877,2.4468685984321805
STAT,1907,44,15-19,1951,0.001417058627946801
STAT,1881,43,30-34,1924,1.125700817979749
SIM,1947,18,45-49,1965,1
SIM,1879,46,45-49,1925,1
STAT,1864,34,40-44,1898,3.900079556019252
SIM,1920,37,35-39,1957,5
STAT,1862,85,na,1947,238.05834808141998
STAT,1890,24,40-44,1914,2.582940057186883
STAT,1913,16,45-49,1929,0.10445036894408886
SIM,1828,36,50-100,1864,2
SIM,1926,16,35-39,1942,9
STAT,1895,33,30-34,1928,23.14100607722338
SIM,1911,31,25-29,1942,17
SIM,1920,25,na,1945,4200
SIM,1839,42,50-100,1881,2
SIM,1886,64,na,1950,1907
SIM,1927,15,25-29,1942,83
STAT,1924,27,15-19,1951,0.8386120474606039
STAT,1810,53,25-29,1863,0.010395895237152621
SIM,1912,18,50-100,1930,2
SIM,1922,45,45-49,1967,1
STAT,1812,44,20-24,1856,0.39887628753071885
SIM,1853,85,na,1938,239
STAT,1803,90,na,1893,30.5928964407083
STAT,1908,36,30-34,1944,1.748439604337924
SIM,1827,53,na,1880,1294
SIM,1877,35,30-34,1912,5
SIM,1903,55,na,1958,2930
STAT,1886,20,45-49,1906,0.7574689577744197
SIM,1873,19,20-24,1892,33
STAT,1910,25,50-100,1935,0.9953298253319596
STAT,1865,19,20-24,1884,16.716577777420433
STAT,1910,17,30-34,1927,2.4632706547395027
SIM,1847,21,25-29,1868,60
SIM,1840,45,na,1885,1593
STAT,1782,89,na,1871,35.164578972911144
STAT,1913,40,50-100,1953,0.11819913920990985
STAT,1881,46,35-39,1927,0.13847086809326087
SIM,1886,33,30-34,1919,32
STAT,1847,80,na,1927,482.38943754682145
STAT,1930,16,45-49,1946,0.6603067013589956
STAT,1878,33,30-34,1911,18.461559035186376
STAT,1830,35,25-29,1865,2.6736930823138345
SIM,1864,35,50-100,1899,2
STAT,1870,51,30-34,1921,0.005964658292235256
STAT,1879,26,na,1905,2553.6143537262114
STAT,1866,5,na,1871,2668.820466833362
SIM,1932,10,na,1942,5537
SIM,1827,44,30-34,1871,3
STAT,1866,54,45-49,1920,0.013280224811428749
STAT,1857,17,20-24,1874,16.601338815234143
STAT,1939,18,45-49,1957,0.5099305605140783
SIM,1925,37,25-29,1962,3
STAT,1841,24,45-49,1865,0.6429043184330737
SIM,1874,79,na,1953,659
SIM,1881,33,50-100,1914,1
STAT,1849,47,20-24,1896,0.009272893623477815
SIM,1861,50,na,1911,2357
STAT,1919,34,na,1953,4128.27444816127
SIM,1849,29,30-34,1878,3
STAT,1838,44,na,1882,1761.5309906181853
STAT,1825,31,50-100,1856,1.9832577865420162
STAT,1886,35,30-34,1921,5.809597970589198
SIM,1860,33,na,1893,2044
STAT,1878,19,30-34,1897,1.6833918077972543
STAT,1933,38,50-100,1971,0.5826170368298065
STAT,1860,44,25-29,1904,0.5243479750736882
SIM,1866,29,30-34,1895,32
SIM,1894,35,30-34,1929,10
STAT,1864,30,35-39,1894,9.259921486540366
STAT,1881,30,25-29,1911,10.183250904500834
SIM,1936,24,50-100,1960,1
STAT,1811,43,50-100,1854,3.263023613147429
STAT,1878,37,50-100,1915,1.3036924400749663
STAT,1848,19,20-24,1867,16.882907028165704
SIM,1856,19,20-24,1875,32
SIM,1893,12,na,1905,3408
SIM,1831,68,na,1899,940
SIM,1840,19,na,1859,2037
STAT,1891,15,45-49,1906,0.08288550627904309
STAT,1921,31,50-100,1952,0.9427346028621025
SIM,1937,19,15-19,1956,52
STAT,1850,31,45-49,1881,1.3865042629723752
SIM,1836,42,30-34,1878,5
STAT,1853,11,na,1864,2418.89104837429
STAT,1919,15,25-29,1934,9.850146715247783
STAT,1918,16,35-39,1934,0.9373855836677695
STAT,1828,42,30-34,1870,0.9400256182790144
STAT,1903,44,30-34,1947,0.11421162379121025
STAT,1801,101,na,1902,0.2035974618346064
SIM,1934,15,30-34,1949,34
STAT,1869,24,15-19,1893,3.228895796706723
SIM,1823,34,45-49,1857,2
STAT,1871,36,25-29,1907,2.923503244192247
STAT,1867,57,na,1924,1924.6873321982546
SIM,1862,32,30-34,1894,18
SIM,1925,26,30-34,1951,93
SIM,1892,29,50-100,1921,2
STAT,1890,41,30-34,1931,1.4405121809426376
STAT,1917,37,25-29,1954,1.0436368533614961
STAT,1840,45,35-39,1885,0.10422876816551419
STAT,1839,29,20-24,1868,10.053705462858881
SIM,1833,65,na,1898,1082
SIM,1903,28,45-49,1931,1
STAT,1871,27,35-39,1898,9.750479848606222
SIM,1806,85,na,1891,155
STAT,1823,45,35-39,1868,0.21651925736988553
SIM,1845,32,30-34,1877,26
STAT,1871,62,na,1933,1846.9673340165734
STAT,1808,46,na,1854,1137.275743194865
STAT,1855,53,30-34,1908,0.004540316877032367
STAT,1821,45,25-29,1866,0.09351101258436222
STAT,1869,35,30-34,1904,5.298997873164419
STAT,1890,36,35-39,1926,8.864777944240098
STAT,1838,44,40-44,1882,1.7143046625818614
STAT,1838,40,35-39,1878,1.5963712069480473
STAT,1894,25,na,1919,3152.885323414836
STAT,1899,40,na,1939,3272.5740826961023
STAT,1915,10,na,1925,4230.685623935147
SIM,1786,91,na,1877,6
SIM,1881,27,na,1908,2201
STAT,1933,34,15-19,1967,0.1763810621351778
STAT,1854,32,30-34,1886,13.684391102699482
SIM,1863,40,25-29,1903,1
STAT,1903,18,40-44,1921,0.26454462289338654
STAT,1948,19,25-29,1967,50.56403245102356
STAT,1858,29,30-34,1887,20.556679391606608
SIM,1825,46,na,1871,1472
STAT,1770,88,na,1858,27.02580949044396
STAT,1839,21,25-29,1860,51.12990299700539
STAT,1837,32,30-34,1869,14.595473321557563
STAT,1907,15,20-24,1922,26.678715969008675
STAT,1910,37,25-29,1947,0.9604287948237624
SIM,1936,34,na,1970,3313
SIM,1929,20,30-34,1949,67
STAT,1871,50,20-24,1921,7.564015320708209E-4
STAT,1886,15,50-100,1901,0.05314781399295768
SIM,1892,28,20-24,1920,19
SIM,1907,22,45-49,1929,1
STAT,1903,31,25-29,1934,14.914163420071729
STAT,1823,50,30-34,1873,0.008965062082487684
SIM,1890,25,45-49,1915,2
STAT,1850,84,na,1934,250.23086026292012
SIM,1781,76,na,1857,290
STAT,1842,34,50-100,1876,0.8501546206254235
STAT,1921,22,na,1943,4208.945221299571
STAT,1854,50,20-24,1904,5.728859918478771E-4
STAT,1874,53,40-44,1927,0.010789140106169614
SIM,1877,39,35-39,1916,16
STAT,1814,68,na,1882,839.9994344512869
STAT,1839,52,45-49,1891,0.009962349077255801
SIM,1932,26,50-100,1958,2
STAT,1922,44,40-44,1966,0.2919627405716747
STAT,1899,30,na,1929,3360.400214625988
SIM,1856,28,na,1884,2376
SIM,1846,44,40-44,1890,6
STAT,1845,39,50-100,1884,0.9872043506834528
SIM,1847,29,20-24,1876,9
STAT,1884,16,50-100,1900,0.04956809320623465
STAT,1882,25,45-49,1907,1.1109910810940822
SIM,1825,37,20-24,1862,1
STAT,1869,39,35-39,1908,6.896068489401601
STAT,1855,40,35-39,1895,1.4179039646417737
STAT,1794,74,na,1868,473.7802933754707
STAT,1942,28,30-34,1970,41.93662473040163
STAT,1943,27,25-29,1970,71.51882318258141
SIM,1843,28,25-29,1871,61
SIM,1836,67,na,1903,1231
SIM,1913,55,na,1968,3618
SIM,1909,27,50-100,1936,1
SIM,1814,41,40-44,1855,6
SIM,1879,78,na,1957,1082
STAT,1878,24,50-100,1902,0.4303060643131938
STAT,1884,28,20-24,1912,11.798671789374245
SIM,1896,35,40-44,1931,12
STAT,1808,99,na,1907,0.6304866105300866
STAT,1916,47,20-24,1963,0.011567072128962819
SIM,1871,22,30-34,1893,19
STAT,1860,26,20-24,1886,9.885308670686165
SIM,1895,39,50-100,1934,1
STAT,1873,32,40-44,1905,4.485247229481224
STAT,1845,37,35-39,1882,5.806543747980827
STAT,1849,20,40-44,1869,1.9843459305835618
STAT,1915,47,50-100,1962,0.23257234963146736
SIM,1846,47,45-49,1893,1
STAT,1830,52,25-29,1882,0.002584969499382933
STAT,1925,32,15-19,1957,0.15568827330065171
SIM,1908,15,15-19,1923,9
SIM,1948,17,25-29,1965,63
STAT,1931,37,45-49,1968,0.9207763700353732
SIM,1865,27,na,1892,2281
STAT,1812,52,20-24,1864,0.001665725820838372
STAT,1863,11,na,1874,2447.6546431292254
STAT,1847,33,50-100,1880,0.8302482949449844
SIM,1876,64,na,1940,1944
STAT,1809,51,20-24,1860,0.003197915588876739
STAT,1900,8,na,1908,3675.627724792223
SIM,1910,41,na,1951,3588
SIM,1918,36,40-44,1954,3
SIM,1901,34,20-24,1935,2
STAT,1891,32,45-49,1923,2.202443833985872
SIM,1885,30,45-49,1915,4
STAT,1829,54,40-44,1883,0.00720319518570268
SIM,1881,32,40-44,1913,3
SIM,1883,32,50-100,1915,6
SIM,1923,47,50-100,1970,1
SIM,1928,18,35-39,1946,8
SIM,1829,44,40-44,1873,3
SIM,1911,42,na,1953,3662
STAT,1823,37,50-100,1860,2.3003431746810894
STAT,1824,41,45-49,1865,1.8813355355300914
STAT,1835,28,25-29,1863,40.798651484150696
SIM,1897,10,na,1907,3507
STAT,1883,46,45-49,1929,0.23689853781586362
SIM,1925,40,na,1965,4759
STAT,1863,22,30-34,1885,16.249739424596807
STAT,1950,17,15-19,1967,54.74525666781545
STAT,1880,22,30-34,1902,19.09529498547412
STAT,1832,23,40-44,1855,2.1918060563862563
STAT,1946,15,50-100,1961,0.42419397118724855
SIM,1900,16,15-19,1916,16
STAT,1872,53,30-34,1925,0.005988344834962115
SIM,1900,47,35-39,1947,1
SIM,1902,12,na,1914,3778
STAT,1877,30,45-49,1907,1.8599450721666564
STAT,1887,39,na,1926,2666.0903413974884
SIM,1832,41,45-49,1873,4
STAT,1875,32,50-100,1907,0.9593188565428116
STAT,1909,17,20-24,1926,27.11506429137027
STAT,1864,54,35-39,1918,0.0075943795172179985
SIM,1917,39,40-44,1956,5
STAT,1909,39,40-44,1948,1.4305583020734602
STAT,1887,39,50-100,1926,1.3893484057621468
STAT,1921,23,40-44,1944,3.8633709207703504
SIM,1800,54,na,1854,1076
SIM,1888,39,na,1927,2669
SIM,1853,37,35-39,1890,14
SIM,1834,66,na,1900,1191
SIM,1864,79,na,1943,628
STAT,1856,44,35-39,1900,1.4305323043671219
STAT,1838,47,45-49,1885,0.17839469407204636
SIM,1848,44,50-100,1892,4
SIM,1836,38,35-39,1874,12
SIM,1864,44,35-39,1908,8
STAT,1946,19,15-19,1965,51.32240685245615
STAT,1857,40,45-49,1897,1.204433265439775
STAT,1842,45,45-49,1887,0.18990748062063836
SIM,1817,38,25-29,1855,4
STAT,1876,29,25-29,1905,44.243069924077325
SIM,1895,25,na,1920,3243
STAT,1907,49,na,1956,3317.997212036963
STAT,1836,40,15-19,1876,0.010491852404542337
SIM,1840,23,40-44,1863,2
STAT,1809,47,na,1856,1613.4664854220268
STAT,1824,36,na,1860,1596.3082789785328
STAT,1922,38,na,1960,4363.642727079828
STAT,1834,36,20-24,1870,0.6519887304829665
STAT,1934,29,35-39,1963,20.576439542947394
STAT,1895,29,35-39,1924,12.751039269752082
STAT,1862,63,na,1925,1549.489866254843
SIM,1879,56,na,1935,2523
STAT,1918,46,40-44,1964,0.17163899104742694
STAT,1792,67,na,1859,653.9724112456983
STAT,1840,51,45-49,1891,0.010493069647539096
STAT,1937,15,na,1952,3669.4440617860414
STAT,1849,102,na,1951,0.22760949244900544
STAT,1918,42,25-29,1960,0.07747839187328476
STAT,1919,17,50-100,1936,0.4225004177543033
STAT,1768,104,na,1872,0.04401773178961174
STAT,1843,27,20-24,1870,11.655121713697431
STAT,1881,52,45-49,1933,0.014237069170482808
STAT,1900,37,30-34,1937,1.626526537909099
STAT,1920,44,30-34,1964,0.1436121677947206
SIM,1903,33,40-44,1936,5
SIM,1851,27,20-24,1878,14
SIM,1923,26,20-24,1949,31
STAT,1935,29,40-44,1964,6.473010837787916
STAT,1904,20,na,1924,3478.488295040846
STAT,1833,32,50-100,1865,0.7827072709241364
STAT,1901,44,20-24,1945,0.015520384445661107
SIM,1908,28,35-39,1936,20
SIM,1865,42,50-100,1907,6
STAT,1834,54,25-29,1888,0.0023491380098059427
STAT,1912,37,35-39,1949,2.4082446377737923
STAT,1901,49,40-44,1950,0.13488980458299865
SIM,1854,80,na,1934,627
STAT,1853,5,na,1858,2536.324490474181
STAT,1911,47,45-49,1958,0.20987720674757665
SIM,1888,22,25-29,1910,80
STAT,1928,17,na,1945,4730.700099966102
STAT,1835,30,na,1865,2098.81171180582
SIM,1869,33,30-34,1902,1
STAT,1863,51,25-29,1914,0.0031833179679635125
STAT,1848,41,30-34,1889,0.9040839133753058
STAT,1869,43,30-34,1912,1.1241383244065646
STAT,1870,21,45-49,1891,0.6975123047255462
STAT,1819,47,35-39,1866,0.2773600383122318
SIM,1870,11,na,1881,2892
SIM,1885,25,na,1910,2356
SIM,1830,24,35-39,1854,1
STAT,1911,16,25-29,1927,8.867244476725995
SIM,1815,68,na,1883,741
STAT,1898,32,50-100,1930,1.2640087728540308
STAT,1799,68,na,1867,708.4151023984103
STAT,1867,35,20-24,1902,0.745277828183692
STAT,1829,61,na,1890,1242.7993261858164
STAT,1886,38,35-39,1924,7.599544557927765
SIM,1848,17,20-24,1865,17
SIM,1884,29,25-29,1913,55
SIM,1942,29,35-39,1971,15
SIM,1816,85,na,1901,85
STAT,1851,54,25-29,1905,0.0028418630114551368
STAT,1853,53,20-24,1906,6.088098303331026E-4
STAT,1832,65,na,1897,1129.2801851415377
SIM,1856,41,30-34,1897,1
STAT,1869,42,na,1911,2273.5569572075046
STAT,1921,15,40-44,1936,1.6344932547109914
STAT,1810,50,20-24,1860,0.0023004771324102555
SIM,1823,43,35-39,1866,4
SIM,1912,26,35-39,1938,21
STAT,1893,25,20-24,1918,15.2852173456241
SIM,1929,23,35-39,1952,2
STAT,1908,39,35-39,1947,2.286010770007951
STAT,1849,81,na,1930,419.8282225519573
SIM,1931,28,20-24,1959,23
STAT,1823,36,45-49,1859,3.8593012112871614
SIM,1922,42,40-44,1964,2
SIM,1894,38,35-39,1932,16
SIM,1866,81,na,1947,660
STAT,1808,46,20-24,1854,0.03310392730369486
STAT,1846,63,na,1909,1275.9948028733747
STAT,1923,28,20-24,1951,21.307794982910224
SIM,1899,20,35-39,1919,15
STAT,1847,9,na,1856,2371.2315459920997
STAT,1876,53,50-100,1929,0.015654233128570415
STAT,1848,15,40-44,1863,0.178343655949382
STAT,1917,18,50-100,1935,0.08205940649119962
STAT,1911,49,50-100,1960,0.21713436690564022
SIM,1935,19,40-44,1954,1
STAT,1792,73,na,1865,440.0355221046082
STAT,1864,27,na,1891,2164.7730178638913
STAT,1926,40,50-100,1966,0.14815787906238312
STAT,1911,44,na,1955,3571.3395549886923
STAT,1826,34,20-24,1860,2.6077956493285304
SIM,1862,28,35-39,1890,10
SIM,1890,34,35-39,1924,4
SIM,1909,18,25-29,1927,10
SIM,1881,24,40-44,1905,4
SIM,1852,31,45-49,1883,2
STAT,1854,28,35-39,1882,7.686146701442366
STAT,1882,34,35-39,1916,9.97888323828096
STAT,1818,41,45-49,1859,3.9935040831693165
STAT,1829,50,25-29,1879,0.002882798158246354
STAT,1831,52,30-34,1883,0.0042824690695457334
SIM,1831,36,45-49,1867,6
STAT,1909,56,na,1965,3314.5975998680356
STAT,1815,43,35-39,1858,5.413894822155938
SIM,1839,19,45-49,1858,1
STAT,1901,36,20-24,1937,0.23849801784912236
STAT,1915,26,20-24,1941,19.064480581095165
STAT,1878,78,na,1956,870.9432735306364
SIM,1880,16,na,1896,2547
SIM,1839,50,45-49,1889,1
SIM,1916,39,35-39,1955,2
SIM,1924,38,30-34,1962,3
STAT,1875,37,20-24,1912,0.8070869983913308
STAT,1888,43,40-44,1931,2.6930763646473745
SIM,1785,90,na,1875,15
SIM,1891,30,45-49,1921,2
STAT,1830,32,20-24,1862,2.5850280000143857
STAT,1898,41,45-49,1939,0.1440253032386269
SIM,1854,96,na,1950,11
SIM,1815,46,na,1861,1457
STAT,1780,88,na,1868,41.161404500756284
STAT,1850,78,na,1928,587.7222352714211
STAT,1899,39,20-24,1938,0.23008986363467343
STAT,1855,40,25-29,1895,0.5028219985434916
SIM,1886,36,35-39,1922,14
SIM,1915,40,na,1955,4189
SIM,1955,3,na,1958,5097
SIM,1865,70,na,1935,1200
SIM,1902,46,30-34,1948,1
STAT,1890,20,35-39,1910,7.322238909128006
STAT,1889,42,30-34,1931,1.4469634547085881
SIM,1852,30,na,1882,2160
STAT,1906,39,15-19,1945,0.01781589446120544
STAT,1814,84,na,1898,155.01678985415023
STAT,1890,27,45-49,1917,1.3849220102959297
STAT,1835,52,na,1887,1634.844795055138
STAT,1844,31,45-49,1875,1.6328051102773826
SIM,1840,51,na,1891,1523
STAT,1868,40,20-24,1908,0.15630363800043068
SIM,1845,82,na,1927,445
STAT,1878,36,35-39,1914,7.546609344068159
STAT,1870,54,35-39,1924,0.008349398178712499
SIM,1923,38,na,1961,4263
STAT,1830,26,35-39,1856,11.874649612356743
STAT,1876,12,na,1888,2736.474517663809
SIM,1935,17,na,1952,5172
SIM,1885,47,na,1932,2267
STAT,1916,38,30-34,1954,1.895197291897428
STAT,1866,51,40-44,1917,0.0099536017004522
STAT,1805,51,50-100,1856,0.05430099078668268
STAT,1861,18,25-29,1879,5.458123241260372
STAT,1871,53,25-29,1924,0.0035218219038322565
STAT,1856,35,45-49,1891,1.6115522512249767
SIM,1896,30,20-24,1926,2
SIM,1877,12,na,1889,2722
STAT,1869,58,na,1927,1947.752434039766
SIM,1826,41,45-49,1867,3
SIM,1840,31,40-44,1871,3
STAT,1948,16,20-24,1964,158.34148241166892
STAT,1899,24,na,1923,3283.2182423519043
SIM,1918,22,20-24,1940,119
STAT,1879,48,45-49,1927,0.24849766647652807
STAT,1926,18,35-39,1944,5.234632821518449
SIM,1860,24,20-24,1884,57
SIM,1841,30,30-34,1871,29
STAT,1819,67,na,1886,967.5784012034385
STAT,1885,32,45-49,1917,1.774825248634513
SIM,1893,32,45-49,1925,3
SIM,1872,30,35-39,1902,17
STAT,1878,25,na,1903,2551.3490505725536
STAT,1908,31,50-100,1939,0.7990693341232453
SIM,1856,40,50-100,1896,3
STAT,1823,53,35-39,1876,0.012214896590304808
STAT,1871,33,20-24,1904,2.719980476844571
SIM,1915,18,25-29,1933,17
STAT,1810,106,na,1916,0.005176407117257238
STAT,1907,18,25-29,1925,8.465879773973803
STAT,1870,9,na,1879,2695.381990509052
SIM,1786,75,na,1861,372
SIM,1903,25,40-44,1928,5
SIM,1934,18,35-39,1952,8
STAT,1837,35,35-39,1872,5.862044410586053
STAT,1890,44,35-39,1934,2.2282066362088386
STAT,1932,29,15-19,1961,0.9420459680208472
STAT,1871,39,50-100,1910,1.2281775680708662
STAT,1896,41,25-29,1937,0.060353987917234016
STAT,1857,57,na,1914,1601.1109822863652
STAT,1870,41,15-19,1911,0.013834343087161525
STAT,1844,50,na,1894,1692.4914095495112
STAT,1920,36,30-34,1956,2.038262323128362
SIM,1864,35,45-49,1899,4
SIM,1887,48,45-49,1935,1
SIM,1940,29,15-19,1969,1
STAT,1822,50,25-29,1872,0.005052170544371885
STAT,1842,53,45-49,1895,0.011197972560068449
STAT,1877,41,15-19,1918,0.014678102647206327
STAT,1815,102,na,1917,0.1515935866668964
STAT,1903,35,40-44,1938,1.383194364362225
STAT,1888,30,20-24,1918,3.286147340401397
STAT,1880,18,35-39,1898,0.5866912811931738
STAT,1884,47,15-19,1931,4.0183057622339186E-4
SIM,1877,49,50-100,1926,1
STAT,1865,42,45-49,1907,1.3840372989452956
SIM,1863,63,na,1926,1449
STAT,1840,49,15-19,1889,2.8291954834686706E-4
SIM,1845,35,35-39,1880,13
SIM,1823,33,na,1856,1712
STAT,1887,40,30-34,1927,1.327485138109744
STAT,1904,26,35-39,1930,14.155781340497285
STAT,1833,30,30-34,1863,15.240612347549861
STAT,1941,16,20-24,1957,142.50696192229188
SIM,1907,11,na,1918,3955
SIM,1846,67,na,1913,1138
STAT,1871,24,30-34,1895,17.887069259316913
STAT,1927,39,45-49,1966,0.8627568742611811
STAT,1832,31,40-44,1863,3.8458610905450095
STAT,1858,38,20-24,1896,0.6205294937291945
SIM,1841,36,na,1877,1857
STAT,1905,47,45-49,1952,0.19522261069947439
STAT,1859,42,45-49,1901,1.2178339461897898
SIM,1911,35,40-44,1946,2
STAT,1928,3,na,1931,5213.0640595212
STAT,1910,39,40-44,1949,1.4455298780385846
STAT,1910,38,50-100,1948,0.40751320570963273
STAT,1841,41,45-49,1882,1.1630895761563227
STAT,1844,42,25-29,1886,0.5096405769204418
SIM,1877,46,35-39,1923,1
STAT,1890,20,25-29,1910,71.83060174696602
STAT,1812,50,30-34,1862,0.013987560141894003
STAT,1924,26,50-100,1950,1.186448530511134
STAT,1926,27,25-29,1953,80.493632489176
SIM,1871,34,na,1905,2177
SIM,1810,47,na,1857,1626
STAT,1846,50,35-39,1896,0.006244997464292596
STAT,1785,87,na,1872,57.90540144848629
STAT,1898,61,na,1959,2671.1938143976004
SIM,1880,11,na,1891,2613
SIM,1815,40,30-34,1855,4
STAT,1873,35,45-49,1908,2.081343604583215
SIM,1893,19,25-29,1912,11
STAT,1915,48,30-34,1963,0.09141049410727145
STAT,1882,18,45-49,1900,0.06475242692055666
STAT,1826,51,20-24,1877,5.679127406076265E-4
STAT,1879,40,20-24,1919,0.17105988425725097
SIM,1887,40,20-24,1927,3
STAT,1866,20,40-44,1886,2.005507839808472
STAT,1874,31,30-34,1905,18.259692562865897
STAT,1883,43,40-44,1926,2.235183420477631
SIM,1860,71,na,1931,1370
SIM,1882,31,30-34,1913,21
STAT,1834,43,45-49,1877,1.1987351677324385
STAT,1859,64,na,1923,1416.2666102163462
STAT,1879,54,30-34,1933,0.006172978009597748
STAT,1910,25,30-34,1935,39.18179474634301
SIM,1826,28,25-29,1854,45
SIM,1839,97,na,1936,7
SIM,1913,31,35-39,1944,22
STAT,1875,52,20-24,1927,7.684964628861126E-4
SIM,1842,43,45-49,1885,5
STAT,1880,41,50-100,1921,1.1376722178027674
STAT,1816,52,40-44,1868,0.02071291446612345
STAT,1848,27,na,1875,2007.490828478579
STAT,1870,43,30-34,1913,1.1382390297890244
STAT,1911,42,15-19,1953,0.0014950881507898982
STAT,1821,33,30-34,1854,55.02204622931949
STAT,1889,16,40-44,1905,0.23105019670053306
SIM,1911,26,na,1937,3748
SIM,1914,36,20-24,1950,1
STAT,1885,11,na,1896,2632.345217805172
SIM,1875,28,20-24,1903,8
STAT,1901,27,30-34,1928,35.92397367898997
STAT,1930,16,35-39,1946,5.546577319064295
SIM,1830,51,na,1881,1566
SIM,1911,45,45-49,1956,1
STAT,1864,52,45-49,1916,0.013093875595992772
STAT,1872,31,na,1903,2449.8058873950176
SIM,1863,40,35-39,1903,2
SIM,1881,35,45-49,1916,5
SIM,1809,50,na,1859,1053
STAT,1894,30,45-49,1924,2.3066687178672787
STAT,1949,16,na,1965,4368.6862073344155
STAT,1931,34,40-44,1965,5.222828421044232
STAT,1858,45,20-24,1903,0.00980487792214026
STAT,1912,21,25-29,1933,90.5771782689897
STAT,1909,15,30-34,1924,2.4490843605615114
STAT,1912,23,na,1935,3719.318862649449
SIM,1852,42,25-29,1894,4
STAT,1842,49,na,1891,1727.497519206829
SIM,1871,0,na,1871,3532
STAT,1823,42,30-34,1865,1.8597686520354786
STAT,1923,35,45-49,1958,0.8073335396580127
SIM,1854,64,na,1918,1469
SIM,1892,35,20-24,1927,1
STAT,1933,30,35-39,1963,12.573422643632426
STAT,1905,31,35-39,1936,8.60245410592062
STAT,1928,33,na,1961,4820.725944889661
STAT,1857,42,35-39,1899,1.440933336030875
STAT,1864,37,45-49,1901,1.8082565300811275
SIM,1822,54,na,1876,1222
STAT,1825,107,na,1932,0.0028279821500653743
STAT,1940,32,40-44,1972,4.131823243220961
SIM,1868,38,30-34,1906,8
SIM,1872,37,45-49,1909,6
STAT,1885,19,25-29,1904,5.736546255843706
STAT,1855,54,45-49,1909,0.010940630837366789
STAT,1886,31,15-19,1917,0.1544019454357536
SIM,1822,43,40-44,1865,4
SIM,1841,14,na,1855,2204
STAT,1884,35,20-24,1919,0.7853931814686869
STAT,1829,45,na,1874,1675.7895225627285
STAT,1873,26,na,1899,2476.731084857329
STAT,1898,17,50-100,1915,0.06758686498171843
STAT,1872,51,40-44,1923,0.010815281612131364
SIM,1839,23,40-44,1862,4
STAT,1901,47,25-29,1948,0.04613517236292244
STAT,1909,42,50-100,1951,0.11206632401857777
SIM,1875,41,50-100,1916,2
STAT,1860,48,40-44,1908,0.1399241562694967
SIM,1939,16,20-24,1955,125
SIM,1920,28,45-49,1948,5
STAT,1890,33,30-34,1923,21.686245291078443
STAT,1892,41,40-44,1933,2.888850848664177
STAT,1819,40,15-19,1859,0.03157805617305288
STAT,1817,45,50-100,1862,0.5660556070090093
STAT,1839,51,30-34,1890,0.004127777096855976
SIM,1942,22,15-19,1964,9
SIM,1821,34,35-39,1855,7
SIM,1842,79,na,1921,533
SIM,1852,42,50-100,1894,3
STAT,1808,53,45-49,1861,0.03391323472150674
STAT,1817,44,20-24,1861,0.3690100459246367
SIM,1826,47,na,1873,1551
STAT,1919,37,35-39,1956,2.651674844101212
STAT,1823,51,45-49,1874,0.021426498973940063
STAT,1920,47,35-39,1967,0.14544158627755116
STAT,1814,43,40-44,1857,7.352867685167558
STAT,1852,41,20-24,1893,0.12851893705283277
STAT,1900,38,na,1938,3340.865887818051
STAT,1920,24,50-100,1944,0.741827946241019
SIM,1887,41,25-29,1928,2
STAT,1899,49,25-29,1948,0.04444152489387598
SIM,1805,84,na,1889,49
SIM,1810,69,na,1879,1079
SIM,1855,12,na,1867,2201
SIM,1867,17,30-34,1884,4
SIM,1905,19,na,1924,3688
SIM,1879,39,45-49,1918,7
SIM,1825,44,20-24,1869,1
STAT,1927,19,40-44,1946,1.7645360261952239
STAT,1837,52,35-39,1889,0.005760844831013017
STAT,1797,72,na,1869,568.094992708614
STAT,1912,28,45-49,1940,1.7306394944332844
SIM,1850,42,40-44,1892,7
SIM,1930,18,na,1948,5303
STAT,1917,15,15-19,1932,10.012547626250834
STAT,1914,42,40-44,1956,0.252873274871757
SIM,1926,7,na,1933,5319
STAT,1836,47,35-39,1883,0.09120144593313143
STAT,1875,44,45-49,1919,1.5458466792667993
STAT,1933,17,15-19,1950,61.956187496561256
STAT,1934,22,15-19,1956,7.295379039892598
SIM,1901,28,35-39,1929,1
SIM,1831,42,30-34,1873,1
SIM,1931,35,45-49,1966,2
STAT,1881,34,40-44,1915,4.2405857610580115
STAT,1861,31,45-49,1892,1.4759940218185708
SIM,1941,17,15-19,1958,48
STAT,1841,64,na,1905,1283.5215695093857
STAT,1897,39,na,1936,3206.3979686456055
STAT,1859,17,30-34,1876,1.507343636776595
STAT,1880,25,35-39,1905,10.414113686319848
SIM,1919,17,40-44,1936,2
SIM,1870,34,30-34,1904,24
SIM,1963,6,na,1969,5151
STAT,1870,48,25-29,1918,0.05672056600253134
STAT,1880,66,na,1946,1757.067410877642
STAT,1885,43,25-29,1928,0.6488525402359641
STAT,1866,30,50-100,1896,0.8690899085258618
STAT,1844,18,50-100,1862,0.04797497124871943
SIM,1822,32,na,1854,1582
SIM,1858,39,25-29,1897,3
STAT,1811,66,na,1877,824.9689422101833
STAT,1869,46,35-39,1915,0.13827866796511554
STAT,1872,78,na,1950,798.8577256202179
SIM,1882,40,45-49,1922,2
SIM,1883,44,45-49,1927,3
SIM,1877,24,15-19,1901,3
STAT,1890,42,45-49,1932,1.8645161063692939
STAT,1906,36,20-24,1942,0.2482391257612553
STAT,1825,50,40-44,1875,0.013584039234257909
STAT,1764,92,na,1856,17.239160210399994
STAT,1912,34,30-34,1946,15.67954835053356
STAT,1834,51,20-24,1885,5.193626289104197E-4
STAT,1940,28,20-24,1968,18.9803466714495
STAT,1907,40,35-39,1947,0.19025479021326042
STAT,1842,42,40-44,1884,1.8249381304785595
SIM,1935,33,na,1968,5413
STAT,1847,79,na,1926,545.1713728434763
STAT,1858,21,45-49,1879,0.6519503718505402
SIM,1925,15,15-19,1940,50
STAT,1935,32,50-100,1967,1.166512712039819
SIM,1903,36,45-49,1939,1
STAT,1820,54,20-24,1874,0.0012434066784716244
STAT,1952,17,25-29,1969,52.975790743581996
STAT,1874,40,45-49,1914,1.5745726097296613
STAT,1893,14,na,1907,3331.3252559428925
SIM,1866,21,45-49,1887,4
SIM,1867,42,45-49,1909,1
STAT,1818,52,25-29,1870,0.00770873553420263
STAT,1831,64,na,1895,1171.3427323693352
STAT,1862,30,15-19,1892,0.12466088014521293
STAT,1892,51,na,1943,2766.2058122189137
STAT,1924,40,na,1964,4519.565831387391
STAT,1864,43,30-34,1907,1.0353104485502957
SIM,1869,26,30-34,1895,31
STAT,1789,68,na,1857,565.115220129728
STAT,1843,37,25-29,1880,2.7134122918693335
STAT,1894,15,50-100,1909,0.06458672698323949
STAT,1847,20,30-34,1867,17.275274784832895
SIM,1890,31,30-34,1921,24
STAT,1922,1,na,1923,4931.432291113584
SIM,1848,30,40-44,1878,3
SIM,1847,24,na,1871,1766
STAT,1942,24,15-19,1966,5.690426050318932
SIM,1839,19,20-24,1858,19
SIM,1845,28,35-39,1873,11
SIM,1827,37,30-34,1864,7
STAT,1840,33,40-44,1873,3.7617173991282664
STAT,1928,24,50-100,1952,0.8327403301746505
STAT,1850,34,50-100,1884,0.7061583610821052
STAT,1831,50,40-44,1881,0.007880028839336722
SIM,1823,40,30-34,1863,1
SIM,1916,35,50-100,1951,1
STAT,1842,27,na,1869,2097.9099658548935
STAT,1911,60,na,1971,3303.63650633796
STAT,1888,46,45-49,1934,0.28542885884286623
STAT,1911,44,40-44,1955,0.24052162602864008
SIM,1902,6,na,1908,3820
STAT,1845,30,15-19,1875,0.13507654609793374
SIM,1851,37,25-29,1888,2
SIM,1864,64,na,1928,1628
SIM,1920,34,30-34,1954,8
STAT,1945,27,35-39,1972,16.805103028029777
SIM,1944,15,25-29,1959,55
STAT,1806,50,30-34,1856,0.020191232914232346
STAT,1880,82,na,1962,730.3830100064116
STAT,1842,53,20-24,1895,5.693884568661697E-4
STAT,1876,6,na,1882,2859.7277160492526
SIM,1872,43,30-34,1915,5
STAT,1849,54,45-49,1903,0.01095703420911626
SIM,1830,41,35-39,1871,6
SIM,1894,28,30-34,1922,1
SIM,1888,9,na,1897,3084
STAT,1863,26,na,1889,2150.0673058738503
STAT,1851,79,na,1930,576.7739831048323
STAT,1912,55,na,1967,3488.6988271192768
SIM,1834,28,50-100,1862,4
STAT,1898,43,35-39,1941,0.17222092172456618
STAT,1859,53,25-29,1912,0.002839397394016667
STAT,1877,17,50-100,1894,0.05183761920645054
STAT,1819,37,30-34,1856,15.108238380412212
STAT,1907,27,15-19,1934,0.6795951179591189
STAT,1867,52,20-24,1919,7.029665147598566E-4
SIM,1933,36,30-34,1969,2
STAT,1779,75,na,1854,316.0
STAT,1856,32,40-44,1888,3.5153770982706645
STAT,1832,49,na,1881,1567.647673235798
STAT,1860,46,15-19,1906,3.320254367362901E-4
STAT,1860,33,50-100,1893,0.7551891024765137
STAT,1886,28,30-34,1914,27.09600521271364
STAT,1893,18,20-24,1911,22.883204737468102
SIM,1815,84,na,1899,95
SIM,1967,1,na,1968,5239
SIM,1816,47,na,1863,1542
STAT,1925,36,30-34,1961,2.233810749840315
STAT,1841,17,45-49,1858,0.062205382710398154
STAT,1903,41,na,1944,3378.471324065595
STAT,1910,38,na,1948,3651.6105905218374
SIM,1855,20,30-34,1875,21
SIM,1909,29,40-44,1938,6
STAT,1822,41,35-39,1863,2.9037718423325414
STAT,1851,36,20-24,1887,0.6494833250165403
STAT,1939,30,50-100,1969,0.8615471094259255
STAT,1896,46,50-100,1942,0.18719076601704243
SIM,1915,27,15-19,1942,1
STAT,1857,53,40-44,1910,0.008252905689495126
SIM,1765,92,na,1857,8
SIM,1834,27,20-24,1861,12
STAT,1878,29,35-39,1907,10.172594201520265
STAT,1914,19,na,1933,4054.4615163864864
STAT,1860,46,na,1906,1867.5124861451568
STAT,1823,35,na,1858,1624.4777973246685
SIM,1913,44,40-44,1957,3
STAT,1778,90,na,1868,18.97438685852044
SIM,1796,75,na,1871,375
SIM,1940,29,25-29,1969,104
SIM,1828,32,na,1860,1867
SIM,1876,40,45-49,1916,3
SIM,1840,34,45-49,1874,3
STAT,1941,29,50-100,1970,1.0494266432229744
STAT,1884,29,50-100,1913,0.6410159644190326
SIM,1920,21,25-29,1941,126
SIM,1831,36,na,1867,1718
SIM,1885,45,30-34,1930,1
STAT,1817,47,25-29,1864,0.12869570693173155
STAT,1932,29,25-29,1961,87.83262043009624
SIM,1876,38,50-100,1914,2
STAT,1779,107,na,1886,0.006653142538028748
STAT,1947,9,na,1956,4516.336868648971
SIM,1895,41,na,1936,3232
STAT,1873,41,30-34,1914,1.1944240320624775
STAT,1900,15,20-24,1915,25.18371847154264
STAT,1901,42,30-34,1943,0.11375118667979009
STAT,1899,22,45-49,1921,0.9741371072135061
STAT,1931,37,na,1968,5081.488835925448
SIM,1891,43,40-44,1934,7
SIM,1838,38,45-49,1876,2
SIM,1870,41,30-34,1911,1
STAT,1896,45,40-44,1941,0.13141254112963419
STAT,1921,26,45-49,1947,1.9715220390477353
SIM,1819,38,35-39,1857,9
STAT,1832,34,45-49,1866,1.4960140920371539
STAT,1893,42,20-24,1935,0.2052742857848988
STAT,1905,44,40-44,1949,0.22702176809925895
STAT,1920,42,40-44,1962,0.2819089305285355
STAT,1844,34,na,1878,1967.0386661205187
STAT,1877,45,30-34,1922,0.10344383199506846
SIM,1886,29,35-39,1915,14
STAT,1832,40,30-34,1872,0.9694797679593375
SIM,1816,69,na,1885,884
SIM,1918,47,45-49,1965,1
SIM,1939,19,25-29,1958,99
STAT,1781,94,na,1875,3.8886576019776657
STAT,1853,51,30-34,1904,0.005015085950457945
STAT,1888,21,30-34,1909,21.54682925088364
SIM,1872,30,25-29,1902,17
SIM,1934,27,25-29,1961,85
SIM,1830,26,50-100,1856,1
STAT,1878,41,na,1919,2465.3206392323223
SIM,1910,9,na,1919,3999
STAT,1863,64,na,1927,1554.8776769306592
STAT,1851,40,40-44,1891,1.874416260581696
STAT,1846,41,20-24,1887,0.11642767583511489
STAT,1863,6,na,1869,2546.286280417761
STAT,1829,67,na,1896,1054.3027667301374
STAT,1912,45,na,1957,3618.686962345416
SIM,1896,26,na,1922,3204
STAT,1901,4,na,1905,3752.884343161204
STAT,1853,110,na,1963,0.0010114896612245334
SIM,1874,20,40-44,1894,3
STAT,1904,26,na,1930,3501.2282809605585
SIM,1903,21,25-29,1924,95
STAT,1911,49,35-39,1960,0.12377366229272552
STAT,1815,40,30-34,1855,4.038304037997952
STAT,1871,20,15-19,1891,3.353636058692137
STAT,1845,27,30-34,1872,23.948959723844055
STAT,1869,26,na,1895,2358.5731817060405
STAT,1897,29,45-49,1926,1.503669709856999
STAT,1909,41,na,1950,3563.2049138088664
STAT,1862,37,35-39,1899,6.142125233069753
STAT,1868,40,45-49,1908,1.472991869037268
SIM,1918,25,25-29,1943,97
STAT,1878,53,35-39,1931,0.008994847558866913
STAT,1931,21,35-39,1952,12.492353310514494
SIM,1853,27,30-34,1880,34
STAT,1882,31,30-34,1913,17.423723079125473
STAT,1884,63,na,1947,1800.8672540009745
SIM,1780,91,na,1871,20
STAT,1833,52,40-44,1885,0.007176640456558647
STAT,1836,53,20-24,1889,4.5565303681698727E-4
STAT,1829,50,35-39,1879,0.007006801149776853
STAT,1852,27,na,1879,2029.8343227931234
STAT,1864,30,25-29,1894,9.365566670334099
SIM,1832,40,30-34,1872,2
SIM,1877,22,na,1899,2638
STAT,1870,32,25-29,1902,10.214567222223494
STAT,1885,81,na,1966,863.9686816015945
STAT,1862,34,30-34,1896,15.032207999525736
STAT,1898,45,50-100,1943,0.1930270110083521
SIM,1842,40,40-44,1882,2
SIM,1896,21,30-34,1917,29
STAT,1941,19,15-19,1960,47.658297590974406
SIM,1892,38,25-29,1930,7
STAT,1903,38,45-49,1941,0.6208770050405633
SIM,1794,68,na,1862,823
STAT,1862,53,na,1915,1839.7890740129867
STAT,1929,18,na,1947,4778.530103835959
STAT,1834,43,50-100,1877,0.8461659983275119
STAT,1906,39,25-29,1945,0.9134693856896684
STAT,1872,54,45-49,1926,0.014429889353668917
STAT,1846,15,30-34,1861,1.4488496613917656
STAT,1876,42,45-49,1918,1.574663682565293
STAT,1851,43,45-49,1894,1.2258345710322094
SIM,1855,49,na,1904,1711
SIM,1847,25,40-44,1872,7
STAT,1831,30,20-24,1861,2.5401083542299014
STAT,1909,27,25-29,1936,64.15372910360604
STAT,1867,19,30-34,1886,1.5422112249060485
STAT,1897,33,40-44,1930,5.890476820879745
STAT,1809,51,45-49,1860,0.06289233752779388
SIM,1898,11,na,1909,4010
SIM,1917,27,25-29,1944,72
STAT,1859,29,25-29,1888,34.55684395210813
SIM,1867,29,25-29,1896,6
STAT,1911,40,25-29,1951,0.07030965505383027
SIM,1871,42,35-39,1913,1
SIM,1917,2,na,1919,4389
STAT,1862,46,25-29,1908,0.05016185705361277
STAT,1819,83,na,1902,234.04647309072666
SIM,1914,56,na,1970,3562
SIM,1884,42,45-49,1926,3
SIM,1886,7,na,1893,2941
SIM,1829,30,30-34,1859,7
STAT,1864,12,na,1876,2461.6261536691673
STAT,1863,18,35-39,1881,0.5066363880898331
STAT,1824,40,30-34,1864,1.4745519431198428
STAT,1834,40,40-44,1874,1.87215043829771
STAT,1823,49,15-19,1872,5.845390963404236E-4
SIM,1872,34,40-44,1906,8
STAT,1884,38,25-29,1922,2.8915102705776263
STAT,1852,33,50-100,1885,0.7563497139850553
SIM,1868,45,na,1913,2266
SIM,1971,0,na,1971,5183
SIM,1838,42,40-44,1880,4
SIM,1938,23,50-100,1961,2
STAT,1913,16,35-39,1929,0.8773832616885773
STAT,1910,9,na,1919,4009.916611434827
STAT,1948,21,na,1969,4279.32039009826
STAT,1850,68,na,1918,1149.5175770423875
STAT,1919,34,40-44,1953,4.271566351170287
STAT,1936,36,na,1972,3770.5199471747696
SIM,1849,8,na,1857,2365
SIM,1889,31,40-44,1920,3
STAT,1896,41,35-39,1937,0.17019175572602932
STAT,1873,96,na,1969,44.07603027479913
STAT,1910,28,35-39,1938,14.734524781790496
SIM,1878,77,na,1955,909
STAT,1846,104,na,1950,0.047698651053433544
STAT,1899,46,20-24,1945,0.009482934929313347
SIM,1864,28,45-49,1892,1
STAT,1857,16,45-49,1873,0.061531675353094555
STAT,1909,18,35-39,1927,0.8370294330372999
STAT,1854,35,35-39,1889,5.496122525656313
SIM,1910,31,na,1941,3689
STAT,1847,45,45-49,1892,0.18587062990814343
STAT,1856,28,45-49,1884,0.9147317712027642
SIM,1912,26,45-49,1938,1
STAT,1891,31,30-34,1922,22.14170381557547
STAT,1816,41,35-39,1857,4.502311954748435
STAT,1836,27,50-100,1863,0.5152511222751552
STAT,1855,44,40-44,1899,1.720098962227274
SIM,1876,11,na,1887,3069
SIM,1795,90,na,1885,40
STAT,1807,98,na,1905,1.3728442318333904
STAT,1825,53,45-49,1878,0.017642495970171333
STAT,1843,51,20-24,1894,5.985526143031456E-4
SIM,1860,33,50-100,1893,1
SIM,1864,32,40-44,1896,7
STAT,1904,26,45-49,1930,1.628907117771706
STAT,1928,17,40-44,1945,1.7977004513339412
SIM,1801,55,na,1856,1304
STAT,1890,44,na,1934,2843.980882960113
STAT,1883,32,35-39,1915,10.136843052519723
STAT,1810,87,na,1897,75.11174083072567
SIM,1879,88,na,1967,523
STAT,1803,54,20-24,1857,0.002862718955072382
STAT,1887,42,20-24,1929,0.18132096815813414
STAT,1891,24,50-100,1915,0.511814215643337
SIM,1929,30,35-39,1959,18
STAT,1839,45,na,1884,1623.0773170811162
STAT,1865,41,30-34,1906,1.0692975948016614
STAT,1836,44,30-34,1880,0.8298128301769392
STAT,1875,41,40-44,1916,2.3656716589393256
SIM,1858,30,na,1888,2017
STAT,1814,46,45-49,1860,0.7151559260773259
STAT,1916,34,15-19,1950,0.13422983247686499
STAT,1842,31,35-39,1873,9.693898400057986
SIM,1839,26,45-49,1865,4
STAT,1852,17,20-24,1869,17.273699726159577
STAT,1885,40,20-24,1925,0.1632675071101345
STAT,1863,42,35-39,1905,1.6176914068024968
STAT,1870,82,na,1952,465.3052531682153
SIM,1905,25,50-100,1930,3
STAT,1861,53,30-34,1914,0.004937243851757021
STAT,1870,45,20-24,1915,0.012086460204060876
SIM,1873,41,30-34,1914,2
STAT,1842,49,25-29,1891,0.044227065920354025
STAT,1925,45,20-24,1970,0.013726738798569511
STAT,1924,40,35-39,1964,0.24504778220757512
SIM,1883,41,40-44,1924,3
STAT,1903,47,35-39,1950,0.11398800192417832
SIM,1861,34,na,1895,2522
SIM,1888,26,40-44,1914,5
SIM,1901,21,15-19,1922,6
SIM,1847,33,50-100,1880,1
STAT,1892,37,20-24,1929,0.9855780075980601
STAT,1933,22,na,1955,4939.9330853726615
STAT,1855,51,40-44,1906,0.0082000631204012
STAT,1936,15,25-29,1951,42.51290400078916
STAT,1805,54,na,1859,1338.6813102864983
SIM,1877,28,30-34,1905,29
STAT,1808,50,40-44,1858,0.026202801357027777
SIM,1875,63,na,1938,1743
SIM,1854,15,30-34,1869,2
SIM,1954,1,na,1955,4726
SIM,1901,25,30-34,1926,8
SIM,1846,61,na,1907,1462
STAT,1871,17,30-34,1888,1.621046465949124
STAT,1959,1,na,1960,5252.528875066264
STAT,1835,20,na,1855,2094.992595166989
SIM,1844,44,30-34,1888,5
STAT,1945,24,40-44,1969,3.7572126881178867
STAT,1812,53,35-39,1865,0.01904706826743207
SIM,1850,31,35-39,1881,18
STAT,1923,32,40-44,1955,4.577341910524242
SIM,1885,63,na,1948,1815
STAT,1847,20,50-100,1867,0.39549626049414793
STAT,1860,41,20-24,1901,0.1320465988058151
STAT,1814,52,30-34,1866,0.01698074988320768
SIM,1914,39,25-29,1953,1
STAT,1858,48,25-29,1906,0.046013325319406995
STAT,1881,37,45-49,1918,1.9661308913474747
STAT,1898,17,45-49,1915,0.09011581997562457
SIM,1931,32,40-44,1963,5
STAT,1832,87,na,1919,117.72892376558114
STAT,1837,28,35-39,1865,8.197876540780046
SIM,1849,21,35-39,1870,9
STAT,1914,45,45-49,1959,0.22095605599635618
SIM,1842,43,50-100,1885,3
STAT,1842,42,15-19,1884,0.011204532663010778
STAT,1840,36,45-49,1876,1.7143826862488984
STAT,1909,17,30-34,1926,2.4377581805316813
SIM,1890,42,45-49,1932,4
SIM,1840,43,35-39,1883,3
STAT,1828,45,35-39,1873,0.11241135247141121
STAT,1804,91,na,1895,19.55274232690785
SIM,1831,33,40-44,1864,9
SIM,1871,12,na,1883,2572
STAT,1824,46,na,1870,1447.1632938753262
SIM,1880,31,20-24,1911,3
SIM,1904,56,na,1960,3173
STAT,1817,98,na,1915,1.5853937813957881
STAT,1927,32,25-29,1959,11.597792863953362
STAT,1898,40,30-34,1938,0.11124833228150634
STAT,1908,55,na,1963,3281.6554020135964
SIM,1895,16,30-34,1911,2
STAT,1822,87,na,1909,102.43926066644588
SIM,1874,34,50-100,1908,1
STAT,1847,64,na,1911,1355.5945129534355
SIM,1868,31,20-24,1899,1
STAT,1848,50,45-49,1898,0.011443092398685968
STAT,1849,51,40-44,1900,0.008212357537947365
STAT,1875,11,na,1886,2739.4508281801814
STAT,1911,46,30-34,1957,0.08629924939392566
SIM,1865,42,35-39,1907,4
SIM,1860,17,20-24,1877,22
STAT,1907,48,30-34,1955,0.08076182525112306
STAT,1889,62,na,1951,2303.2037512903426
STAT,1890,59,na,1949,2424.1544692594057
SIM,1870,37,35-39,1907,12
STAT,1825,46,20-24,1871,0.015646886644950127
STAT,1838,97,na,1935,3.947266584441877
STAT,1865,15,40-44,1880,0.19405123887991776
STAT,1865,47,50-100,1912,0.22634157603500482
STAT,1850,30,30-34,1880,15.414321961772144
SIM,1850,13,na,1863,2266
STAT,1925,39,35-39,1964,2.9555035023624674
SIM,1915,19,na,1934,4461
STAT,1901,23,15-19,1924,4.691776440910073
STAT,1791,72,na,1863,490.05529847287687
STAT,1853,54,35-39,1907,0.0070201757501096185
SIM,1836,45,35-39,1881,2
STAT,1882,42,45-49,1924,1.485644664690559
SIM,1936,18,na,1954,3163
STAT,1773,91,na,1864,17.413993090979634
STAT,1880,51,25-29,1931,0.003815310588778199
STAT,1837,86,na,1923,147.93074316225557
STAT,1931,30,25-29,1961,12.365350615154012
STAT,1839,33,50-100,1872,0.7701314687096309
STAT,1912,25,40-44,1937,4.717495534701524
SIM,1873,15,40-44,1888,1
STAT,1944,19,40-44,1963,1.5346974072697892
SIM,1916,41,na,1957,3849
STAT,1860,50,45-49,1910,0.012184751376946782
STAT,1918,49,45-49,1967,0.23463497025978003
STAT,1932,26,20-24,1958,24.39372710853638
SIM,1902,16,25-29,1918,14
STAT,1822,72,na,1894,734.3026727435928
STAT,1875,21,45-49,1896,0.7323073617083321
STAT,1905,40,25-29,1945,0.06636335562968834
STAT,1835,52,25-29,1887,0.002690600301068874
SIM,1852,79,na,1931,542
SIM,1917,18,35-39,1935,7
STAT,1879,41,25-29,1920,0.68786577466497
SIM,1862,35,35-39,1897,11
STAT,1918,33,na,1951,4083.9441688893403
SIM,1830,73,na,1903,826
SIM,1858,15,15-19,1873,4
STAT,1868,63,na,1931,1738.567801205187
SIM,1935,32,25-29,1967,13
STAT,1854,12,na,1866,2185.6273443164623
SIM,1823,31,40-44,1854,3
STAT,1877,48,35-39,1925,0.1462707510065353
STAT,1877,77,na,1954,914.6011975164213
STAT,1832,43,35-39,1875,1.4687074194090872
STAT,1837,34,50-100,1871,0.750194135042093
STAT,1887,16,30-34,1903,1.8264802546166115
STAT,1847,51,30-34,1898,0.004664085170248642
STAT,1877,54,20-24,1931,7.593111508335692E-4
SIM,1952,19,40-44,1971,5
STAT,1831,53,45-49,1884,0.010235953292483347
SIM,1940,26,20-24,1966,1
SIM,1885,41,na,1926,2378
STAT,1892,44,45-49,1936,0.13108699649753228
STAT,1794,90,na,1884,32.33621344955311
STAT,1802,99,na,1901,0.60093442533095
STAT,1896,48,45-49,1944,0.17711089135712388
SIM,1836,23,15-19,1859,3
SIM,1859,35,50-100,1894,2
STAT,1921,37,na,1958,4286.6533792032
STAT,1873,44,35-39,1917,1.8475536617450585
SIM,1894,77,na,1971,1616
STAT,1901,45,35-39,1946,0.11378248930250032
STAT,1876,92,na,1968,150.7412969503009
SIM,1890,22,40-44,1912,6
STAT,1815,51,45-49,1866,0.038053314904806776
STAT,1838,40,25-29,1878,0.5661106680787786
STAT,1854,34,na,1888,1831.8762484292051
STAT,1897,49,15-19,1946,3.0134579251653364E-4
STAT,1881,30,35-39,1911,10.06838210357378
SIM,1841,36,50-100,1877,7
SIM,1910,37,40-44,1947,2
STAT,1867,28,20-24,1895,11.196033648004896
SIM,1909,25,25-29,1934,9
SIM,1891,32,35-39,1923,24
SIM,1806,69,na,1875,900
STAT,1922,47,45-49,1969,0.2547643032242515
SIM,1860,41,20-24,1901,2
SIM,1879,4,na,1883,3342
STAT,1840,42,30-34,1882,0.862993367179343
STAT,1841,21,40-44,1862,1.9631774902433214
STAT,1913,16,50-100,1929,0.07833777670806663
SIM,1824,41,35-39,1865,5
STAT,1933,38,30-34,1971,2.5291151434372856
SIM,1868,41,15-19,1909,1
SIM,1884,0,na,1884,3537
SIM,1919,26,50-100,1945,1
SIM,1921,16,35-39,1937,7
STAT,1882,22,40-44,1904,2.071049315799231
STAT,1856,52,45-49,1908,0.011559724257538602
SIM,1927,34,40-44,1961,2
STAT,1951,3,na,1954,4800.884001931311
STAT,1856,78,na,1934,625.6939648886031
STAT,1879,48,50-100,1927,0.258606045705093
STAT,1878,50,30-34,1928,0.006411613810023371
SIM,1873,78,na,1951,626
STAT,1914,38,20-24,1952,0.2672065040104207
STAT,1855,24,50-100,1879,0.3640205810942402
STAT,1835,41,45-49,1876,1.3539099062554603
SIM,1917,17,30-34,1934,6
STAT,1821,42,20-24,1863,0.27556277474002455
SIM,1881,44,35-39,1925,3
STAT,1919,18,na,1937,4139.927742904567
SIM,1891,59,na,1950,2462
STAT,1835,79,na,1914,520.8794717805048
SIM,1854,86,na,1940,159
STAT,1859,50,20-24,1909,6.098333753490101E-4
STAT,1844,18,25-29,1862,5.549106127734883
STAT,1806,53,35-39,1859,0.027399255702584908
STAT,1895,36,35-39,1931,9.45944664590181
STAT,1883,43,15-19,1926,0.013723306683276081
STAT,1843,34,20-24,1877,2.5693931945142827
STAT,1866,47,20-24,1913,0.011239000410329268
SIM,1921,16,50-100,1937,1
STAT,1836,31,na,1867,1722.878267629237
SIM,1851,34,20-24,1885,3
STAT,1849,51,50-100,1900,0.011781279263124231
SIM,1879,43,40-44,1922,4
STAT,1821,36,35-39,1857,16.401930726739003
SIM,1907,49,35-39,1956,1
STAT,1820,52,30-34,1872,0.010437830833754169
STAT,1920,45,45-49,1965,0.2463268823932686
SIM,1800,70,na,1870,606
SIM,1869,22,15-19,1891,1
SIM,1861,40,50-100,1901,2
STAT,1859,96,na,1955,6.995678372244729
STAT,1833,36,50-100,1869,1.02753057294735
STAT,1902,37,40-44,1939,1.3592977628029397
STAT,1839,25,40-44,1864,2.642231921806981
STAT,1915,29,15-19,1944,0.7295271910642834
STAT,1868,41,na,1909,2262.1863123122107
SIM,1846,40,25-29,1886,1
SIM,1886,26,na,1912,2645
STAT,1872,31,20-24,1903,2.7749815854395665
STAT,1881,38,50-100,1919,1.2048889056036152
STAT,1908,32,15-19,1940,0.12369005752366968
STAT,1863,16,50-100,1879,0.05030000182870066
SIM,1939,20,50-100,1959,1
SIM,1838,39,45-49,1877,5
SIM,1858,24,na,1882,2012
STAT,1859,37,15-19,1896,0.045749961719310374
STAT,1879,39,40-44,1918,4.62099095563275
STAT,1856,36,35-39,1892,5.691281506033561
STAT,1906,5,na,1911,3891.243944819456
STAT,1824,30,30-34,1854,49.360621423049004
SIM,1855,36,40-44,1891,1
SIM,1935,15,25-29,1950,66
STAT,1788,101,na,1889,0.1549225183506389
SIM,1937,21,40-44,1958,5
STAT,1886,16,25-29,1902,6.1340303247482915
STAT,1829,98,na,1927,2.160552254457162
SIM,1890,23,30-34,1913,27
STAT,1874,22,50-100,1896,0.4247389341491523
STAT,1892,39,na,1931,2981.9455302895612
STAT,1834,43,20-24,1877,0.12720142700997902
SIM,1844,22,20-24,1866,75
STAT,1845,13,na,1858,2346.823424684136
STAT,1915,37,na,1952,3878.2951739193327
STAT,1945,17,40-44,1962,1.5588840060615963
SIM,1894,62,na,1956,2453
SIM,1823,32,30-34,1855,17
SIM,1924,9,na,1933,4927
STAT,1763,91,na,1854,6.0
STAT,1820,41,25-29,1861,1.3138050604847342
STAT,1890,27,50-100,1917,0.7979118955167304
SIM,1894,16,25-29,1910,7
SIM,1919,32,30-34,1951,27
SIM,1888,42,30-34,1930,4
STAT,1945,18,50-100,1963,0.4174244957730429
STAT,1873,32,na,1905,2468.0412089615133
STAT,1833,41,35-39,1874,1.4706800945590284
STAT,1877,46,na,1923,2387.283697122947
STAT,1770,89,na,1859,21.871987620616295
STAT,1899,61,na,1960,2726.359268701221
SIM,1800,85,na,1885,45
SIM,1827,32,na,1859,1716
STAT,1817,46,25-29,1863,0.13071001793869616
STAT,1788,99,na,1887,0.4038280728318161
STAT,1891,21,30-34,1912,22.564796912621006
STAT,1790,93,na,1883,7.420818956912575
STAT,1887,45,25-29,1932,0.06650092380736873
SIM,1846,39,na,1885,1950
STAT,1927,22,na,1949,4589.539297253496
SIM,1835,51,na,1886,1482
SIM,1887,39,40-44,1926,8
STAT,1854,20,15-19,1874,3.0097611139834806
STAT,1929,21,40-44,1950,4.349859436425067
STAT,1836,22,20-24,1858,56.61293034022989
SIM,1900,21,45-49,1921,1
SIM,1903,22,25-29,1925,84
STAT,1820,54,30-34,1874,0.01003014683512839
SIM,1864,42,45-49,1906,1
SIM,1949,22,15-19,1971,9
STAT,1865,34,35-39,1899,9.29639969223566
STAT,1780,108,na,1888,0.004740365986925173
STAT,1910,40,20-24,1950,0.017215843037317387
SIM,1833,22,45-49,1855,3
SIM,1910,49,35-39,1959,1
STAT,1852,18,20-24,1870,17.1719576347725
SIM,1825,39,35-39,1864,11
STAT,1879,31,30-34,1910,18.694342947427536
STAT,1881,51,na,1932,2133.781357352977
STAT,1889,31,na,1920,3019.3835601909996
SIM,1860,18,20-24,1878,27
STAT,1882,23,30-34,1905,17.648512501609545
STAT,1902,49,35-39,1951,0.11124008572393886
STAT,1807,49,50-100,1856,1.0322251090075678
SIM,1872,32,25-29,1904,12
SIM,1935,33,25-29,1968,1
STAT,1882,41,30-34,1923,1.147798739162683
STAT,1843,41,20-24,1884,0.13370408281405832
SIM,1812,70,na,1882,581
STAT,1847,43,30-34,1890,0.8900499440090642
STAT,1850,20,30-34,1870,16.315007749365503
SIM,1825,45,50-100,1870,1
SIM,1945,16,na,1961,4414
SIM,1823,66,na,1889,944
SIM,1870,48,na,1918,2462
STAT,1832,50,na,1882,1548.3157328406344
STAT,1840,40,40-44,1880,1.903550193710723
STAT,1887,76,na,1963,1348.5055301545005
STAT,1901,42,20-24,1943,0.01571337740400731
STAT,1958,14,na,1972,5259.546696000443
STAT,1879,57,na,1936,2142.980067272607
STAT,1894,17,15-19,1911,7.787425596680808
STAT,1817,39,35-39,1856,20.672050199773963
SIM,1849,39,20-24,1888,1
STAT,1895,75,na,1970,1807.5106618293403
STAT,1888,37,40-44,1925,5.279356824807152
STAT,1891,81,na,1972,1175.670548633383
STAT,1850,39,20-24,1889,0.5769120216277609
SIM,1841,41,35-39,1882,2
SIM,1861,0,na,1861,3311
SIM,1842,36,30-34,1878,1
SIM,1865,32,50-100,1897,1
SIM,1815,47,na,1862,1438
STAT,1826,44,25-29,1870,0.5084215085961831
STAT,1834,36,30-34,1870,4.507789671783216
STAT,1917,19,30-34,1936,13.269878346418347
STAT,1933,30,45-49,1963,2.165070654932361
STAT,1870,48,35-39,1918,0.13786248820288288
SIM,1855,43,30-34,1898,1
SIM,1916,19,na,1935,3974
STAT,1847,52,45-49,1899,0.011256723292413352
SIM,1841,67,na,1908,1117
STAT,1927,15,25-29,1942,55.21923505209438
STAT,1890,18,40-44,1908,0.22754399515260984
STAT,1909,42,20-24,1951,0.016846571905632546
STAT,1841,18,45-49,1859,0.06183899300623394
SIM,1885,10,na,1895,2636
STAT,1847,36,40-44,1883,3.5787654463827474
STAT,1809,53,50-100,1862,0.06287690020686075
STAT,1944,25,25-29,1969,72.64319744053947
SIM,1872,20,30-34,1892,27
STAT,1876,53,25-29,1929,0.003671351066142639
SIM,1808,65,na,1873,1023
SIM,1894,37,50-100,1931,4
STAT,1862,84,na,1946,288.8847269390821
SIM,1890,41,30-34,1931,2
STAT,1862,53,25-29,1915,0.0030264974878711245
SIM,1920,24,na,1944,3791
STAT,1897,37,35-39,1934,9.647723669042245
SIM,1807,48,30-34,1855,1
SIM,1891,26,na,1917,3091
STAT,1952,3,na,1955,4808.850493155428
SIM,1882,45,na,1927,2198
STAT,1820,53,na,1873,1288.6826960790627
STAT,1950,22,45-49,1972,1.3617650650061692
STAT,1882,50,45-49,1932,0.014630824523728343
STAT,1831,33,25-29,1864,9.259561543508038
SIM,1890,32,45-49,1922,2
SIM,1836,23,25-29,1859,66
SIM,1876,29,40-44,1905,7
SIM,1869,25,30-34,1894,38
STAT,1861,18,15-19,1879,5.716086417638452
SIM,1841,23,35-39,1864,9
STAT,1870,18,40-44,1888,0.18305537921015314
STAT,1871,39,40-44,1910,4.3790531027599515
STAT,1866,39,30-34,1905,4.964500303059427
STAT,1919,27,40-44,1946,5.139310260014125
SIM,1837,62,na,1899,1135
STAT,1837,81,na,1918,360.5420544393447
SIM,1882,77,na,1959,782
STAT,1815,50,30-34,1865,0.015924349248536425
SIM,1840,14,na,1854,2142
STAT,1830,79,na,1909,442.2484902112103
SIM,1936,24,30-34,1960,33
SIM,1851,36,25-29,1887,4
SIM,1853,15,25-29,1868,8
SIM,1900,38,50-100,1938,5
SIM,1901,5,na,1906,3867
SIM,1845,48,50-100,1893,2
STAT,1828,30,15-19,1858,0.15081383564407486
SIM,1927,27,40-44,1954,9
STAT,1927,33,25-29,1960,11.59060223237771
SIM,1908,3,na,1911,4266
STAT,1854,47,40-44,1901,0.13041784780685867
SIM,1930,1,na,1931,5957
STAT,1843,36,25-29,1879,2.7417344083071464
STAT,1860,33,20-24,1893,2.2279185967509516
STAT,1935,1,na,1936,5822.004813326545
STAT,1874,45,15-19,1919,4.2077795712413526E-4
STAT,1833,23,35-39,1856,5.510134353067507
STAT,1782,74,na,1856,416.9680627895999
STAT,1890,28,na,1918,2966.3200741842775
STAT,1828,45,na,1873,1408.5813903079045
STAT,1845,15,25-29,1860,5.662712503212957
SIM,1874,39,30-34,1913,9
STAT,1861,47,na,1908,1887.7025332492476
SIM,1787,86,na,1873,59
SIM,1873,31,30-34,1904,4
STAT,1818,38,40-44,1856,14.646141206593082
STAT,1949,16,50-100,1965,0.4446782504387024
STAT,1814,50,40-44,1864,0.03125886940404444
STAT,1949,17,25-29,1966,51.42005969915929
STAT,1885,19,15-19,1904,6.007668329894842
STAT,1835,28,15-19,1863,0.43758463476471976
STAT,1933,28,30-34,1961,53.032141996975895
SIM,1837,17,35-39,1854,2
STAT,1843,29,35-39,1872,9.448985696514434
SIM,1941,28,30-34,1969,44
STAT,1864,20,30-34,1884,16.655340286422188
STAT,1860,29,35-39,1889,7.956629405171414
STAT,1920,21,20-24,1941,126.53208147594468
STAT,1881,67,na,1948,1563.464526697345
SIM,1826,28,15-19,1854,1
STAT,1848,65,na,1913,1313.6638213206134
SIM,1925,19,30-34,1944,25
STAT,1828,50,50-100,1878,0.011869186623266277
STAT,1858,44,20-24,1902,0.12674670908989843
STAT,1806,107,na,1913,0.001675738510186417
STAT,1824,49,20-24,1873,0.013612553883223893
SIM,1806,54,na,1860,1316
STAT,1852,20,50-100,1872,0.3959274828256418
STAT,1872,34,25-29,1906,10.382682361783136
SIM,1880,34,25-29,1914,18
STAT,1828,105,na,1933,0.016145918283486063
STAT,1893,40,na,1933,3021.2638685919746
STAT,1929,5,na,1934,5233.6642724746
SIM,1817,44,25-29,1861,3
STAT,1839,44,35-39,1883,1.2838327624086214
STAT,1894,25,50-100,1919,0.8451108751241074
STAT,1867,29,20-24,1896,11.155280085526158
STAT,1875,44,20-24,1919,0.16403448304043042
SIM,1851,29,35-39,1880,13
STAT,1861,31,na,1892,2019.8050360965447
SIM,1846,35,na,1881,2017
STAT,1918,40,20-24,1958,0.019214510360237316
STAT,1841,25,35-39,1866,8.977188690877403
STAT,1883,19,50-100,1902,0.04877619021351034
SIM,1914,24,na,1938,3779
STAT,1775,92,na,1867,10.065975988913923
STAT,1808,53,20-24,1861,0.0017244018309418763
SIM,1831,31,25-29,1862,15
SIM,1911,21,20-24,1932,114
SIM,1897,35,35-39,1932,16
STAT,1777,108,na,1885,0.006092138349005072
SIM,1826,38,40-44,1864,6
SIM,1847,44,35-39,1891,3
STAT,1858,79,na,1937,565.5815102372821
STAT,1878,18,40-44,1896,0.19370881603650664
STAT,1931,40,50-100,1971,0.16050501539357
STAT,1890,22,25-29,1912,71.40456146821505
STAT,1809,78,na,1887,412.0588947721388
SIM,1859,33,20-24,1892,4
STAT,1854,65,na,1919,1293.4206139565013
STAT,1864,41,40-44,1905,2.049510105480921
SIM,1883,8,na,1891,2675
SIM,1886,63,na,1949,1990
STAT,1861,42,25-29,1903,0.5406515340446569
SIM,1893,29,40-44,1922,7
STAT,1855,38,40-44,1893,3.3766012158287615
STAT,1833,44,15-19,1877,0.010789965766423574
STAT,1853,16,15-19,1869,6.021406182962591
STAT,1960,8,na,1968,5219.931812082178
STAT,1798,89,na,1887,47.27021731068829
STAT,1879,16,35-39,1895,0.586555800854082
STAT,1935,17,25-29,1952,60.414893995244036
SIM,1887,31,30-34,1918,26
STAT,1867,45,25-29,1912,0.05571532080743673
STAT,1899,48,25-29,1947,0.04481890003214667
SIM,1856,29,na,1885,2356
STAT,1903,21,20-24,1924,100.23617385351375
SIM,1829,27,na,1856,1624
STAT,1889,35,35-39,1924,8.99754379243619
STAT,1856,84,na,1940,266.3978486760613
STAT,1807,49,20-24,1856,0.05043445357700619
SIM,1894,30,na,1924,3288
SIM,1888,37,35-39,1925,15
SIM,1872,41,40-44,1913,4
STAT,1885,29,40-44,1914,3.0270309180291193
SIM,1862,20,15-19,1882,3
STAT,1856,51,30-34,1907,0.004789629902165804
SIM,1854,26,50-100,1880,1
SIM,1932,32,45-49,1964,6
SIM,1855,71,na,1926,1111
STAT,1820,49,35-39,1869,0.24799391003183122
STAT,1879,41,na,1920,2475.753819315443
SIM,1879,47,35-39,1926,1
STAT,1880,37,40-44,1917,4.692812644334247
STAT,1809,101,na,1910,0.2911271004185746
STAT,1833,39,20-24,1872,0.6248510110455686
STAT,1842,64,na,1906,1363.2286745657418
STAT,1907,38,30-34,1945,1.7145366010066874
STAT,1823,31,25-29,1854,29.824305132524767
SIM,1846,38,40-44,1884,5
SIM,1860,34,na,1894,2047
SIM,1900,37,30-34,1937,4
SIM,1926,17,25-29,1943,71
SIM,1915,32,45-49,1947,4
SIM,1906,36,50-100,1942,2
STAT,1894,19,40-44,1913,0.23872160625468572
STAT,1844,28,40-44,1872,2.8212557618661886
STAT,1870,45,30-34,1915,0.09749744203777251
SIM,1814,89,na,1903,63
STAT,1827,28,40-44,1855,6.865265665500307
STAT,1848,34,35-39,1882,8.182345085581353
SIM,1835,28,40-44,1863,1
STAT,1813,46,40-44,1859,0.4375624170319599
STAT,1838,30,30-34,1868,16.275322660515585
STAT,1891,16,35-39,1907,0.694720582068165
STAT,1831,92,na,1923,28.06425753901682
STAT,1769,92,na,1861,5.204343667518149
STAT,1803,54,30-34,1857,0.023092598716274764
STAT,1809,90,na,1899,40.22375871138291
STAT,1838,54,45-49,1892,0.010369801239213477
STAT,1890,31,40-44,1921,5.431452353054216
STAT,1838,38,40-44,1876,3.8409632683984514
STAT,1951,7,na,1958,4774.9236248540265
SIM,1878,44,na,1922,2588
SIM,1832,30,30-34,1862,22
STAT,1918,17,25-29,1935,9.657020373497105
SIM,1835,40,50-100,1875,4
SIM,1924,5,na,1929,4981
STAT,1924,32,45-49,1956,1.8730330856805495
SIM,1799,71,na,1870,720
STAT,1924,38,30-34,1962,2.190447601754393
STAT,1823,40,40-44,1863,3.8221218678117164
STAT,1894,0,na,1894,3853.1142264463692
SIM,1932,38,30-34,1970,4
STAT,1833,28,na,1861,1857.3974301319154
STAT,1882,19,45-49,1901,0.06457435774652512
SIM,1893,19,15-19,1912,6
STAT,1907,32,45-49,1939,1.4998383494818242
SIM,1953,5,na,1958,4775
STAT,1881,41,40-44,1922,2.228447713850685
STAT,1920,34,50-100,1954,0.9162730377656703
SIM,1887,43,25-29,1930,3
STAT,1937,22,30-34,1959,28.54879452012508
SIM,1831,40,40-44,1871,1
SIM,1915,38,30-34,1953,7
STAT,1870,16,15-19,1886,6.010083322844481
STAT,1850,44,15-19,1894,0.010247604466347785
STAT,1866,31,50-100,1897,0.8656830760844404
SIM,1926,35,25-29,1961,2
STAT,1884,34,20-24,1918,2.7047928605179776
STAT,1929,24,45-49,1953,1.442161661857019
STAT,1827,87,na,1914,113.86904618014199
STAT,1875,37,30-34,1912,5.580124725290798
STAT,1772,113,na,1885,2.6582289239248736E-4
STAT,1830,46,40-44,1876,0.14393702743675374
SIM,1883,37,30-34,1920,2
STAT,1829,48,40-44,1877,0.13677688970642585
SIM,1856,34,35-39,1890,16
SIM,1846,30,30-34,1876,5
SIM,1902,31,20-24,1933,8
SIM,1945,22,30-34,1967,34
STAT,1879,43,25-29,1922,0.6798207579534831
SIM,1882,21,30-34,1903,20
STAT,1900,26,50-100,1926,0.9075968674913106
SIM,1837,22,30-34,1859,21
STAT,1817,44,50-100,1861,2.4547189543573724
STAT,1808,46,30-34,1854,0.26703833703355223
SIM,1852,28,40-44,1880,1
STAT,1902,62,na,1964,2834.7908238290293
SIM,1820,40,50-100,1860,3
STAT,1817,43,20-24,1860,0.3837301022546842
SIM,1892,34,20-24,1926,7
STAT,1918,35,25-29,1953,1.0691080881270858
STAT,1873,26,40-44,1899,3.1087927852342907
SIM,1832,25,35-39,1857,10
STAT,1870,52,20-24,1922,7.319819068193636E-4
STAT,1834,45,na,1879,1644.96292303063
STAT,1838,59,na,1897,1427.9644676209666
SIM,1823,35,35-39,1858,12
SIM,1891,39,30-34,1930,12
STAT,1935,35,25-29,1970,1.4064889797849276
SIM,1866,6,na,1872,2838
SIM,1831,37,50-100,1868,2
SIM,1936,32,30-34,1968,32
SIM,1926,32,20-24,1958,3
STAT,1832,33,45-49,1865,1.5126745777205386
SIM,1870,49,40-44,1919,1
STAT,1942,20,45-49,1962,1.20444643799588
SIM,1776,86,na,1862,98
STAT,1916,54,na,1970,3744.965550592708
SIM,1863,30,30-34,1893,22
STAT,1849,47,30-34,1896,0.07480133912770423
SIM,1918,15,25-29,1933,13
STAT,1841,30,30-34,1871,15.969374440722094
STAT,1856,33,30-34,1889,14.006786289858674
SIM,1867,39,40-44,1906,3
STAT,1902,46,30-34,1948,0.07877776797817689
SIM,1838,36,40-44,1874,10
STAT,1851,50,45-49,1901,0.012145050772924488
STAT,1928,32,30-34,1960,20.094470269456654
STAT,1918,32,20-24,1950,2.6450229457046643
SIM,1864,33,30-34,1897,25
STAT,1910,43,25-29,1953,0.06841865650298543
STAT,1882,26,35-39,1908,9.62275620954876
SIM,1881,42,45-49,1923,3
STAT,1900,43,15-19,1943,0.0013461585137467275
SIM,1944,23,25-29,1967,116
STAT,1808,49,35-39,1857,0.3448646269660142
STAT,1839,36,35-39,1875,5.894149140993106
STAT,1953,19,40-44,1972,1.7248101034469792
STAT,1893,27,25-29,1920,54.74423422741929
SIM,1893,45,na,1938,3020
SIM,1859,9,na,1868,2660
STAT,1866,23,45-49,1889,0.6567667250017446
SIM,1924,18,na,1942,4495
STAT,1846,30,na,1876,1869.9696208022256
STAT,1827,28,na,1855,1795.8461448978733
STAT,1883,39,30-34,1922,5.281031538104279
SIM,1843,86,na,1929,100
SIM,1871,37,40-44,1908,2
SIM,1807,48,na,1855,1288
SIM,1890,26,35-39,1916,18
STAT,1860,36,25-29,1896,2.3946227926436094
STAT,1929,17,na,1946,4791.0827406163735
STAT,1933,22,45-49,1955,1.5220659556592258
STAT,1865,50,45-49,1915,0.013630181790059002
SIM,1927,34,30-34,1961,6
STAT,1834,46,25-29,1880,0.045756495766151796
STAT,1870,83,na,1953,395.9003216056443
SIM,1866,37,30-34,1903,2
SIM,1788,71,na,1859,639
STAT,1936,23,25-29,1959,90.04099274835752
SIM,1841,20,30-34,1861,23
STAT,1862,50,20-24,1912,6.500179166195694E-4
STAT,1871,61,na,1932,1888.3022707226937
SIM,1888,5,na,1893,3105
STAT,1957,9,na,1966,5283.9143922004105
STAT,1861,28,40-44,1889,2.525248689158561
STAT,1871,47,40-44,1918,0.17219527322057812
SIM,1943,17,25-29,1960,52
STAT,1866,43,15-19,1909,0.012900767529322085
SIM,1919,35,35-39,1954,5
STAT,1861,47,30-34,1908,0.08121890556317485
STAT,1909,25,na,1934,3674.853175026341
SIM,1834,36,25-29,1870,3
STAT,1815,53,35-39,1868,0.021686875174057298
STAT,1820,49,na,1869,1383.612254925908
STAT,1841,15,40-44,1856,0.17624516770472562
STAT,1862,49,40-44,1911,0.14556596745534556
STAT,1863,37,40-44,1900,3.915464930937505
SIM,1950,20,45-49,1970,1
STAT,1844,18,15-19,1862,5.811369359892867
STAT,1847,39,45-49,1886,1.5797609067430842
STAT,1853,18,40-44,1871,0.18340025137603258
STAT,1927,29,40-44,1956,5.75696633548496
SIM,1944,19,50-100,1963,3
STAT,1855,30,30-34,1885,14.07035259999678
STAT,1844,19,50-100,1863,0.04769239866806448
STAT,1876,29,15-19,1905,0.47452763484396704
SIM,1810,45,50-100,1855,1
STAT,1895,36,50-100,1931,1.6420042577246834
STAT,1888,8,na,1896,3135.10527745745
STAT,1846,94,na,1940,14.292479180501589
SIM,1812,54,na,1866,1208
STAT,1806,51,45-49,1857,0.048191395281110876
STAT,1843,50,na,1893,1763.1727470299136
STAT,1834,39,35-39,1873,5.798836879211808
STAT,1832,34,na,1866,1832.2405518589735
STAT,1888,45,45-49,1933,0.2874583145435438
SIM,1928,31,40-44,1959,10
STAT,1848,52,35-39,1900,0.006656481253785572
STAT,1892,3,na,1895,3380.059375617677
SIM,1823,70,na,1893,801
SIM,1896,25,na,1921,3251
SIM,1866,59,na,1925,2000
STAT,1835,101,na,1936,0.4251521708110543
STAT,1816,48,30-34,1864,0.19586164270424947
STAT,1916,30,45-49,1946,1.671202534679263
STAT,1932,37,na,1969,5155.093696798816
STAT,1832,51,45-49,1883,0.010338926904976137
STAT,1886,39,na,1925,2518.4083008975026
STAT,1802,68,na,1870,658.0294716205465
STAT,1840,43,45-49,1883,1.1091448494236718
SIM,1868,14,na,1882,2642
STAT,1847,46,35-39,1893,0.10948378683287992
STAT,1858,39,20-24,1897,0.617346177426364
STAT,1826,36,25-29,1862,2.639536034346943
STAT,1850,15,35-39,1865,0.5103580504041302
SIM,1946,22,45-49,1968,2
STAT,1838,42,25-29,1880,0.5517892303449757
STAT,1857,49,30-34,1906,0.07551213213633043
SIM,1811,85,na,1896,45
SIM,1829,49,45-49,1878,1
SIM,1846,46,40-44,1892,1
STAT,1861,99,na,1960,3.433578757952695
STAT,1897,42,30-34,1939,0.10876422678749867
STAT,1919,34,30-34,1953,17.197421448103267
STAT,1851,102,na,1953,0.24187446155035613
STAT,1911,32,50-100,1943,0.8212323475028879
SIM,1911,24,25-29,1935,101
SIM,1800,69,na,1869,606
SIM,1824,51,na,1875,1329
SIM,1842,39,35-39,1881,2
SIM,1799,67,na,1866,972
STAT,1938,22,45-49,1960,1.1359593893260815
STAT,1811,72,na,1883,587.9446221439077
SIM,1873,32,45-49,1905,4
SIM,1864,36,35-39,1900,13
SIM,1869,28,35-39,1897,1
SIM,1908,19,30-34,1927,2
SIM,1840,33,45-49,1873,3
STAT,1838,46,40-44,1884,0.13108039751665865
STAT,1873,42,45-49,1915,1.5459937618560997
STAT,1901,45,25-29,1946,0.04681336655491923
STAT,1903,24,25-29,1927,82.49587080518192
STAT,1824,108,na,1932,0.0010085750626647617
SIM,1847,36,35-39,1883,2
SIM,1836,20,20-24,1856,66
SIM,1870,42,50-100,1912,2
SIM,1829,82,na,1911,165
SIM,1925,5,na,1930,5072
SIM,1834,29,35-39,1863,15
STAT,1895,48,40-44,1943,0.12692206081165747
STAT,1895,21,15-19,1916,4.404294018473054
STAT,1897,27,40-44,1924,4.086058762508745
STAT,1812,47,35-39,1859,0.33134173314248433
STAT,1936,30,15-19,1966,0.12745131199746046
SIM,1841,51,na,1892,1660
STAT,1846,44,25-29,1890,0.4530218571994972
STAT,1821,48,40-44,1869,0.26574684959414296
SIM,1872,83,na,1955,199
STAT,1889,32,30-34,1921,22.00175165015736
SIM,1806,70,na,1876,825
SIM,1847,52,na,1899,1425
SIM,1887,80,na,1967,1055
SIM,1922,8,na,1930,4712
STAT,1875,47,25-29,1922,0.060026655077843265
SIM,1900,21,50-100,1921,1
STAT,1879,47,40-44,1926,0.18170887209691391
STAT,1910,32,20-24,1942,2.3987118787701487
STAT,1848,17,50-100,1865,0.0472095299836358
STAT,1933,9,na,1942,5434.591623592778
STAT,1829,82,na,1911,310.3164355898644
STAT,1874,42,35-39,1916,1.8837524904563112
STAT,1822,88,na,1910,79.822720696508
STAT,1817,51,20-24,1868,0.0016124716291513984
STAT,1923,15,50-100,1938,0.45095395247797004
SIM,1929,21,na,1950,4882
STAT,1864,8,na,1872,2532.1681256654415
STAT,1892,23,na,1915,3014.5172769938176
STAT,1881,25,50-100,1906,0.6351944765640622
SIM,1902,39,na,1941,3426
SIM,1854,49,50-100,1903,1
SIM,1899,61,na,1960,2718
STAT,1892,33,15-19,1925,0.18130865910827204
SIM,1864,48,na,1912,2057
SIM,1869,95,na,1964,43
STAT,1891,40,45-49,1931,1.9093267994913026
STAT,1814,53,45-49,1867,0.040578831742367844
SIM,1900,27,30-34,1927,52
STAT,1849,18,15-19,1867,5.637879180874544
SIM,1881,34,45-49,1915,7
STAT,1877,40,50-100,1917,1.1290960899142888
SIM,1857,18,15-19,1875,9
SIM,1885,40,50-100,1925,4
SIM,1897,32,30-34,1929,37
STAT,1871,43,25-29,1914,0.6442278783965256
STAT,1922,23,na,1945,4259.830452231498
STAT,1926,37,na,1963,4690.586188623566
STAT,1825,42,15-19,1867,0.018856446251055547
STAT,1901,38,35-39,1939,2.167053488263894
SIM,1924,30,45-49,1954,3
STAT,1840,69,na,1909,1056.0412093911766
SIM,1824,83,na,1907,166
STAT,1804,52,25-29,1856,0.010389284069454429
STAT,1859,29,15-19,1888,0.3706383272319432
STAT,1944,22,20-24,1966,122.49016692277311
SIM,1916,51,na,1967,3783
STAT,1876,50,20-24,1926,7.885167527007354E-4
STAT,1893,35,25-29,1928,3.7614900958713
STAT,1856,54,35-39,1910,0.006704579746656978
STAT,1884,42,20-24,1926,0.16008989201280943
STAT,1804,90,na,1894,26.6023705127998
STAT,1864,32,25-29,1896,9.290885214635013
STAT,1925,43,50-100,1968,0.14488232638619358
SIM,1838,43,30-34,1881,2
SIM,1876,33,na,1909,2834
STAT,1830,41,50-100,1871,0.9244292311202188
STAT,1927,8,na,1935,5058.672161722258
STAT,1860,26,30-34,1886,21.21910117026008
STAT,1817,38,20-24,1855,2.5252059245644807
SIM,1816,38,30-34,1854,9
SIM,1840,41,45-49,1881,4
STAT,1886,7,na,1893,2813.295132213061
STAT,1840,14,na,1854,2204.0
STAT,1844,28,na,1872,2037.3924436898653
STAT,1944,22,na,1966,4022.7584376600153
STAT,1814,53,na,1867,1300.1056183480173
SIM,1895,56,na,1951,2813
STAT,1839,29,45-49,1868,0.9515157405473674
SIM,1880,26,50-100,1906,4
SIM,1883,62,na,1945,1886
STAT,1812,54,25-29,1866,0.007680693677244057
SIM,1883,29,30-34,1912,36
SIM,1884,32,20-24,1916,4
STAT,1837,24,30-34,1861,15.324358372983278
STAT,1875,29,30-34,1904,26.17727662350976
STAT,1884,29,20-24,1913,11.755724624060921
SIM,1875,95,na,1970,95
STAT,1937,25,35-39,1962,14.941149380011117
STAT,1897,34,30-34,1931,23.611792891189264
STAT,1898,24,na,1922,3242.283412958584
SIM,1877,24,25-29,1901,70
SIM,1887,76,na,1963,1401
STAT,1838,53,30-34,1891,0.004303424937533486
STAT,1775,88,na,1863,41.008939194798025
SIM,1860,47,50-100,1907,1
STAT,1945,24,30-34,1969,32.1164470368395
SIM,1848,33,45-49,1881,2
STAT,1875,27,na,1902,2498.715260150169
STAT,1913,21,30-34,1934,28.49775237059725
STAT,1918,43,25-29,1961,0.07735597601412499
STAT,1924,48,30-34,1972,0.1079776678403324
SIM,1921,21,30-34,1942,62
STAT,1832,41,45-49,1873,1.245804035939656
STAT,1823,73,na,1896,661.0471429664719
SIM,1884,19,20-24,1903,32
SIM,1918,33,25-29,1951,7
SIM,1873,68,na,1941,1569
SIM,1910,33,50-100,1943,1
SIM,1847,29,45-49,1876,1
STAT,1901,37,50-100,1938,0.3780398989125327
SIM,1903,6,na,1909,3753
STAT,1823,35,40-44,1858,8.712589876818225
SIM,1874,23,45-49,1897,1
SIM,1882,24,35-39,1906,8
STAT,1910,48,30-34,1958,0.08459369603564183
STAT,1828,51,50-100,1879,0.011636177305389744
STAT,1848,30,50-100,1878,0.8480139973785943
STAT,1877,23,20-24,1900,72.69003413277586
STAT,1900,18,25-29,1918,7.991476542175032
SIM,1858,42,20-24,1900,2
STAT,1941,24,50-100,1965,0.6932562264125551
SIM,1872,28,40-44,1900,7
SIM,1873,26,35-39,1899,1
SIM,1885,23,20-24,1908,64
STAT,1834,28,30-34,1862,22.06180003353482
STAT,1905,11,na,1916,3810.6035739279314
STAT,1800,102,na,1902,0.141300897384087
STAT,1897,9,na,1906,3539.174474177159
STAT,1921,45,50-100,1966,0.26141138542980147
STAT,1891,22,45-49,1913,0.8807157088079218
STAT,1853,48,35-39,1901,0.11591480916543044
STAT,1863,32,30-34,1895,15.616874302491718
STAT,1916,49,35-39,1965,0.1341581775176908
SIM,1945,25,35-39,1970,26
SIM,1953,17,40-44,1970,2
STAT,1865,4,na,1869,2794.658616746176
STAT,1868,73,na,1941,1157.3074101517886
SIM,1901,21,na,1922,3413
SIM,1856,31,30-34,1887,31
SIM,1879,37,40-44,1916,7
SIM,1830,83,na,1913,212
STAT,1926,42,20-24,1968,0.022210448830286018
SIM,1856,30,50-100,1886,1
STAT,1951,20,50-100,1971,0.8025285531728003
SIM,1816,43,50-100,1859,2
STAT,1865,19,45-49,1884,0.061593862993135184
STAT,1873,34,45-49,1907,1.7881061219416772
STAT,1869,31,15-19,1900,0.1408317037802754
STAT,1890,26,40-44,1916,3.7492998758771945
SIM,1867,2,na,1869,3017
STAT,1881,44,45-49,1925,1.4561777774014084
STAT,1907,1,na,1908,4077.0483087219104
STAT,1868,29,40-44,1897,2.8979185950856374
SIM,1890,16,40-44,1906,3
SIM,1922,43,45-49,1965,1
STAT,1811,88,na,1899,59.46554188042887
STAT,1837,17,40-44,1854,0.22287093276467002
SIM,1843,18,20-24,1861,27
STAT,1946,21,40-44,1967,3.818755464907026
SIM,1814,43,45-49,1857,2
SIM,1821,49,45-49,1870,1
SIM,1887,9,na,1896,3060
SIM,1816,49,35-39,1865,1
STAT,1809,62,na,1871,1185.2695722846763
STAT,1841,40,30-34,1881,0.9049661910073316
STAT,1807,51,35-39,1858,0.03630065041612241
STAT,1867,84,na,1951,318.6020877520514
SIM,1898,19,15-19,1917,1
STAT,1938,22,na,1960,3686.8069679287973
SIM,1864,45,50-100,1909,2
SIM,1851,28,20-24,1879,14
SIM,1868,26,25-29,1894,8
SIM,1917,36,na,1953,3881
STAT,1850,20,50-100,1870,0.3735121226825405
STAT,1856,41,30-34,1897,0.9248241057117291
STAT,1817,97,na,1914,2.621829005599213
SIM,1907,42,na,1949,3522
STAT,1863,70,na,1933,1254.9821395540534
STAT,1843,28,20-24,1871,11.571437939793087
STAT,1858,52,20-24,1910,5.938043990057522E-4
SIM,1860,34,25-29,1894,11
STAT,1867,37,25-29,1904,2.7574984342225264
STAT,1900,25,15-19,1925,0.6458648200211204
STAT,1841,22,30-34,1863,16.660644481105248
STAT,1820,46,30-34,1866,0.17916178572200653
SIM,1854,44,25-29,1898,1
STAT,1852,54,na,1906,1686.8951905808328
SIM,1875,37,25-29,1912,7
STAT,1848,31,30-34,1879,15.992588275727615
SIM,1851,45,50-100,1896,1
STAT,1865,26,35-39,1891,8.964629180320829
STAT,1830,42,25-29,1872,0.5539530612802166
STAT,1842,38,30-34,1880,4.852198341777512
SIM,1836,51,50-100,1887,1
SIM,1900,32,na,1932,3393
STAT,1873,52,45-49,1925,0.014929555114260218
SIM,1842,28,30-34,1870,28
STAT,1852,34,25-29,1886,8.367805347669382
SIM,1850,38,30-34,1888,8
STAT,1813,49,45-49,1862,0.5735630515830129
SIM,1882,42,35-39,1924,3
SIM,1780,75,na,1855,316
STAT,1842,34,15-19,1876,0.13213547564006448
STAT,1912,24,na,1936,3697.1765457805072
STAT,1849,49,20-24,1898,0.009121809021246336
SIM,1881,29,45-49,1910,3
SIM,1884,27,25-29,1911,48
SIM,1888,43,45-49,1931,4
STAT,1851,85,na,1936,226.16566954210737
SIM,1927,23,25-29,1950,130
SIM,1840,35,35-39,1875,11
SIM,1817,70,na,1887,609
STAT,1931,40,40-44,1971,0.34172881664215554
SIM,1820,44,30-34,1864,3
SIM,1913,39,na,1952,3848
STAT,1832,30,40-44,1862,3.8883510340466696
SIM,1900,63,na,1963,2590
STAT,1900,31,45-49,1931,2.475753250186242
SIM,1953,18,50-100,1971,2
STAT,1856,45,50-100,1901,0.19863812795820546
STAT,1859,65,na,1924,1376.8377477879237
STAT,1837,42,30-34,1879,0.9045077080631384
STAT,1921,16,40-44,1937,1.6309300594157223
SIM,1866,39,20-24,1905,1
STAT,1915,36,15-19,1951,0.019891201498979084
SIM,1835,82,na,1917,269
STAT,1855,99,na,1954,1.4681224574312544
STAT,1878,25,30-34,1903,26.92109380306219
SIM,1868,23,20-24,1891,73
STAT,1846,48,40-44,1894,0.1208905233807223
STAT,1823,66,na,1889,915.7748842804648
SIM,1909,32,20-24,1941,4
SIM,1876,80,na,1956,743
SIM,1891,1,na,1892,3465
STAT,1878,48,40-44,1926,0.17950643655325013
SIM,1940,17,na,1957,3851
STAT,1886,37,50-100,1923,1.325731493024618
SIM,1920,18,40-44,1938,2
STAT,1876,27,25-29,1903,44.56155973341605
STAT,1812,44,30-34,1856,2.887517424069331
SIM,1871,33,na,1904,2196
STAT,1824,31,45-49,1855,4.105851841986426
STAT,1897,45,35-39,1942,0.10879415707354546
STAT,1873,29,45-49,1902,1.1401232073601675
STAT,1854,51,50-100,1905,0.0116142642936308
SIM,1880,10,na,1890,2614
STAT,1937,31,40-44,1968,3.9514800343325547
STAT,1903,32,25-29,1935,14.853462774952035
STAT,1881,20,30-34,1901,17.67267216144838
STAT,1881,21,20-24,1902,68.17203334821858
STAT,1907,61,na,1968,3074.5420744914736
STAT,1846,22,30-34,1868,15.716872308221172
SIM,1886,25,30-34,1911,32
STAT,1896,60,na,1956,2593.1071633495785
SIM,1856,26,35-39,1882,13
SIM,1862,84,na,1946,215
STAT,1945,20,15-19,1965,5.956463280546708
SIM,1896,33,25-29,1929,3
SIM,1790,81,na,1871,148
SIM,1923,29,25-29,1952,81
SIM,1866,50,na,1916,2267
STAT,1920,43,na,1963,4179.257387061367
STAT,1825,49,35-39,1874,0.17519681686500202
STAT,1916,44,50-100,1960,0.12244753443828138
STAT,1855,34,25-29,1889,7.918442906161098
STAT,1911,31,20-24,1942,2.4326567675113964
SIM,1830,52,na,1882,1530
SIM,1828,32,30-34,1860,16
SIM,1918,37,40-44,1955,3
STAT,1923,41,45-49,1964,0.19875838636913265
STAT,1840,20,20-24,1860,63.978250852612746
SIM,1845,24,30-34,1869,1
STAT,1878,21,15-19,1899,3.51368189261176
STAT,1880,29,40-44,1909,3.1883812084621526
SIM,1832,31,45-49,1863,2
SIM,1910,30,20-24,1940,2
STAT,1936,34,30-34,1970,15.588230371967274
SIM,1949,19,40-44,1968,1
STAT,1860,40,45-49,1900,1.2512902539769597
SIM,1893,76,na,1969,1542
STAT,1837,47,40-44,1884,0.1184899333076971
SIM,1822,53,na,1875,1248
STAT,1851,32,15-19,1883,0.12228478958187974
STAT,1953,4,na,1957,4852.728068210118
SIM,1821,38,40-44,1859,4
STAT,1838,49,45-49,1887,0.17388167453849104
STAT,1873,36,35-39,1909,7.350374370711004
STAT,1921,49,20-24,1970,0.012638196135077079
SIM,1892,29,20-24,1921,19
STAT,1888,42,40-44,1930,2.7093323588001765
STAT,1936,6,na,1942,3913.8299355353474
STAT,1816,44,15-19,1860,0.029774593383628988
SIM,1857,39,30-34,1896,5
STAT,1943,16,na,1959,3983.3348978357208
SIM,1877,21,20-24,1898,80
SIM,1911,32,25-29,1943,12
STAT,1848,102,na,1950,0.22789462672099364
SIM,1857,14,na,1871,2365
SIM,1929,6,na,1935,5453
SIM,1822,37,40-44,1859,5
STAT,1891,13,na,1904,3256.6480596794463
STAT,1912,18,40-44,1930,0.2877723160607022
STAT,1919,30,15-19,1949,0.14261681943307017
SIM,1885,57,na,1942,2020
STAT,1851,39,35-39,1890,5.776553614276644
STAT,1918,49,na,1967,3966.1582063142223
SIM,1869,3,na,1872,3043
SIM,1927,35,na,1962,4653
STAT,1811,44,50-100,1855,3.1156227371500695
SIM,1900,48,35-39,1948,1
STAT,1869,28,40-44,1897,2.939970890049606
SIM,1926,6,na,1932,5335
STAT,1787,73,na,1860,577.9915283702188
STAT,1866,54,20-24,1920,6.752656940042556E-4
STAT,1924,40,45-49,1964,0.20253234232793155
STAT,1910,49,45-49,1959,0.20560354482218937
STAT,1953,15,25-29,1968,53.502485068518986
STAT,1841,33,35-39,1874,8.978536486296292
SIM,1843,26,25-29,1869,43
STAT,1852,52,25-29,1904,0.002838260999490836
SIM,1805,85,na,1890,39
STAT,1817,54,25-29,1871,0.007289600656761649
SIM,1929,21,30-34,1950,43
STAT,1869,21,20-24,1890,68.07740930399993
STAT,1838,28,na,1866,2007.3603584149378
SIM,1880,32,35-39,1912,18
SIM,1831,23,25-29,1854,91
STAT,1860,18,30-34,1878,1.5125775232898233
STAT,1881,28,40-44,1909,2.94405729607395
SIM,1843,15,na,1858,2392
STAT,1900,39,na,1939,3323.727245813545
SIM,1818,48,na,1866,1372
STAT,1896,1,na,1897,3667.3161863524438
SIM,1897,27,35-39,1924,18
SIM,1813,41,35-39,1854,2
STAT,1874,49,30-34,1923,0.09871807627360668
STAT,1915,24,50-100,1939,0.6897241636719624
STAT,1864,26,50-100,1890,0.5822449284893103
SIM,1864,95,na,1959,29
STAT,1826,29,35-39,1855,16.257394100492487
STAT,1846,49,50-100,1895,0.17196680327802744
STAT,1835,51,na,1886,1667.5453595560323
STAT,1877,93,na,1970,127.96483925885052
SIM,1855,44,na,1899,1752
STAT,1840,109,na,1949,5.119649862789112E-4
STAT,1872,46,na,1918,2306.8349097868845
SIM,1878,41,30-34,1919,2
SIM,1929,16,35-39,1945,1
STAT,1912,46,50-100,1958,0.22229476132591464
STAT,1884,45,25-29,1929,0.05871425582610504
STAT,1942,18,30-34,1960,12.99146067279009
SIM,1889,56,na,1945,2723
STAT,1851,46,25-29,1897,0.04765592165717983
STAT,1857,32,50-100,1889,0.7344969363444176
STAT,1889,27,35-39,1916,12.15903570711944
SIM,1950,18,30-34,1968,17
STAT,1871,40,20-24,1911,0.16210382666977147
STAT,1889,19,na,1908,3165.5587019505065
STAT,1919,23,25-29,1942,102.89747952746352
STAT,1947,15,na,1962,4232.540012799905
SIM,1837,41,20-24,1878,2
STAT,1900,47,30-34,1947,0.07684632775747943
STAT,1887,41,30-34,1928,1.3201706949987593
SIM,1902,43,na,1945,3364
STAT,1852,26,25-29,1878,39.979210116106806
STAT,1930,42,na,1972,4983.892939152541
SIM,1772,89,na,1861,28
SIM,1830,36,40-44,1866,7
STAT,1848,80,na,1928,480.8553797452189
STAT,1884,32,na,1916,2408.4622545058746
SIM,1858,29,20-24,1887,10
STAT,1789,84,na,1873,87.2066748206923
STAT,1835,26,25-29,1861,41.39089087738713
STAT,1896,32,20-24,1928,3.6419755160363603
STAT,1856,42,45-49,1898,1.1970391250212986
SIM,1889,20,25-29,1909,105
STAT,1904,25,na,1929,3512.926325624891
SIM,1820,39,35-39,1859,8
STAT,1837,48,50-100,1885,0.16781933554194362
SIM,1924,28,30-34,1952,49
STAT,1812,82,na,1894,212.811143899955
STAT,1849,39,30-34,1888,4.146913327035601
STAT,1856,35,50-100,1891,0.9925180884139484
STAT,1890,75,na,1965,1603.4302789811934
STAT,1898,20,25-29,1918,79.44452205027697
STAT,1916,28,30-34,1944,41.19768918478659
SIM,1881,22,25-29,1903,60
STAT,1832,28,45-49,1860,0.998552193989161
STAT,1873,51,30-34,1924,0.006185877968037195
SIM,1790,74,na,1864,309
STAT,1866,46,na,1912,2123.0437360929923
SIM,1880,27,40-44,1907,6
SIM,1810,90,na,1900,81
STAT,1872,32,35-39,1904,10.354212574786642
STAT,1941,19,25-29,1960,45.50751033390933
SIM,1919,41,40-44,1960,2
STAT,1827,59,na,1886,1315.5193962457247
STAT,1856,13,na,1869,2250.207397260022
SIM,1838,28,40-44,1866,2
SIM,1881,36,35-39,1917,9
STAT,1904,18,50-100,1922,0.07144168288117579
SIM,1815,74,na,1889,427
SIM,1878,15,30-34,1893,3
SIM,1840,28,45-49,1868,1
STAT,1853,52,20-24,1905,6.15450541677806E-4
STAT,1953,15,na,1968,4544.337832061551
SIM,1854,58,na,1912,1727
STAT,1816,101,na,1917,0.253193339931018
SIM,1860,26,25-29,1886,45
STAT,1883,35,15-19,1918,0.05674259700472352
STAT,1878,43,30-34,1921,1.2119694221350275
STAT,1884,31,na,1915,2418.304754858148
SIM,1911,11,na,1922,4105
STAT,1911,36,30-34,1947,1.8042777934321503
STAT,1887,49,40-44,1936,0.10808866577018622
STAT,1904,23,30-34,1927,25.962258475374245
STAT,1937,16,na,1953,3661.4446737313483
SIM,1831,37,na,1868,1702
SIM,1882,3,na,1885,2791
STAT,1866,47,30-34,1913,0.09066126662134007
STAT,1927,25,25-29,1952,82.17873723963457
STAT,1872,15,35-39,1887,0.5695514486361131
STAT,1893,4,na,1897,3404.4952411275817
SIM,1886,43,30-34,1929,2
STAT,1860,54,25-29,1914,0.002851152694982429
SIM,1784,74,na,1858,497
STAT,1931,27,na,1958,4932.487608247578
STAT,1897,19,40-44,1916,0.24814851885952116
STAT,1829,41,20-24,1870,0.13509301494173948
SIM,1849,21,45-49,1870,1
STAT,1842,52,45-49,1894,0.011320116618380772
SIM,1904,24,35-39,1928,11
SIM,1855,43,na,1898,1765
SIM,1862,39,40-44,1901,10
STAT,1915,29,25-29,1944,68.0182146533698
STAT,1804,63,na,1867,892.5165388399009
STAT,1872,47,na,1919,2289.579784661679
SIM,1903,26,40-44,1929,10
STAT,1840,27,40-44,1867,2.6877205593620954
SIM,1912,23,30-34,1935,32
STAT,1888,47,35-39,1935,0.16805567454369622
SIM,1906,57,na,1963,3115
STAT,1845,29,50-100,1874,0.599667318859925
SIM,1889,25,35-39,1914,19
STAT,1811,51,25-29,1862,0.00956418350559603
STAT,1840,25,50-100,1865,0.5822850955585469
SIM,1909,17,25-29,1926,19
STAT,1898,46,15-19,1944,3.1215648095255275E-4
STAT,1812,51,20-24,1863,0.0016995176807934394
STAT,1825,52,na,1877,1430.6644717012848
STAT,1877,26,25-29,1903,44.91213919145723
STAT,1857,94,na,1951,15.92328569175037
SIM,1837,40,30-34,1877,2
STAT,1888,33,25-29,1921,12.300658973611416
STAT,1916,46,30-34,1962,0.09353969015195096
SIM,1830,31,30-34,1861,23
SIM,1866,43,na,1909,2318
STAT,1905,20,40-44,1925,3.0884867928168083
STAT,1896,31,30-34,1927,23.620546042907435
STAT,1861,16,25-29,1877,5.522992488567992
STAT,1887,23,30-34,1910,20.29889755057649
SIM,1823,97,na,1920,2
SIM,1904,62,na,1966,2928
SIM,1838,47,na,1885,1534
STAT,1814,102,na,1916,0.1366157925840536
SIM,1895,23,30-34,1918,54
SIM,1863,31,20-24,1894,1
STAT,1846,26,50-100,1872,0.5574132606817288
SIM,1867,19,20-24,1886,25
SIM,1879,29,40-44,1908,9
STAT,1827,40,50-100,1867,1.2998457152875964
SIM,1814,40,40-44,1854,6
STAT,1916,22,45-49,1938,1.20317615605695
STAT,1900,29,30-34,1929,35.35145825576654
SIM,1869,48,40-44,1917,1
STAT,1853,80,na,1933,518.6921770473166
SIM,1829,42,25-29,1871,2
SIM,1935,25,25-29,1960,152
STAT,1832,53,35-39,1885,0.005895061585940518
SIM,1850,34,50-100,1884,4
STAT,1852,19,35-39,1871,0.5283524026986691
STAT,1822,36,40-44,1858,8.691414920295925
STAT,1829,40,30-34,1869,0.9914029215256142
SIM,1885,26,25-29,1911,48
STAT,1957,0,na,1957,5326.024376241708
STAT,1890,29,45-49,1919,1.3750237134309444
STAT,1921,23,30-34,1944,33.02388176026882
SIM,1853,39,50-100,1892,2
SIM,1840,21,25-29,1861,52
STAT,1823,38,45-49,1861,3.595980533083107
STAT,1888,40,15-19,1928,0.0168229877754733
SIM,1881,31,40-44,1912,3
SIM,1887,21,na,1908,2790
STAT,1897,40,40-44,1937,0.2152045789668874
STAT,1903,44,50-100,1947,0.10495122163188822
STAT,1878,31,na,1909,2544.286432101697
STAT,1846,40,30-34,1886,0.8537027534228955
SIM,1794,67,na,1861,823
SIM,1831,38,45-49,1869,4
STAT,1831,31,35-39,1862,9.395287183623386
STAT,1915,42,45-49,1957,0.17098289572893702
SIM,1810,68,na,1878,1079
STAT,1876,19,20-24,1895,18.575601670041113
STAT,1969,2,na,1971,5014.1061632638875
STAT,1832,81,na,1913,361.35395620760556
STAT,1892,44,20-24,1936,0.013910039069330138
SIM,1825,44,50-100,1869,2
SIM,1939,20,na,1959,3635
SIM,1803,89,na,1892,4
SIM,1913,20,40-44,1933,5
STAT,1930,4,na,1934,5322.074814022407
STAT,1908,2,na,1910,4032.2080318038934
STAT,1832,35,35-39,1867,6.137836233720441
STAT,1941,26,15-19,1967,0.7453798492670096
STAT,1777,99,na,1876,0.4183881575945896
STAT,1843,21,50-100,1864,0.4161994155477475
STAT,1896,39,40-44,1935,5.838682318941946
STAT,1903,40,na,1943,3397.1898400844625
SIM,1870,17,na,1887,2768
STAT,1825,53,20-24,1878,8.970761003241883E-4
SIM,1903,2,na,1905,3820
SIM,1854,40,30-34,1894,1
SIM,1862,29,na,1891,2175
STAT,1873,31,40-44,1904,4.503576787004331
SIM,1949,17,15-19,1966,59
STAT,1836,95,na,1931,8.27560285441694
SIM,1939,15,45-49,1954,2
STAT,1825,46,30-34,1871,0.12621821426467486
SIM,1858,1,na,1859,3024
SIM,1854,25,35-39,1879,2
STAT,1831,51,50-100,1882,0.011082808363754006
STAT,1938,21,30-34,1959,29.026363866796515
SIM,1844,25,25-29,1869,56
STAT,1904,16,40-44,1920,0.2680730907572758
SIM,1883,83,na,1966,648
STAT,1819,52,na,1871,1471.6872011679018
SIM,1858,95,na,1953,1
SIM,1877,28,40-44,1905,7
STAT,1892,37,30-34,1929,6.814195024653552
SIM,1840,41,na,1881,1679
STAT,1875,39,20-24,1914,0.7989640267448188
STAT,1899,34,na,1933,3305.0632414371717
SIM,1810,75,na,1885,679
SIM,1933,38,na,1971,5132
SIM,1840,32,30-34,1872,24
SIM,1848,24,35-39,1872,9
SIM,1835,67,na,1902,986
STAT,1873,22,25-29,1895,59.20624993306781
STAT,1855,25,50-100,1880,0.5762462880009066
STAT,1859,19,20-24,1878,16.569185988838253
STAT,1897,43,45-49,1940,0.14073992969959292
STAT,1887,43,35-39,1930,2.055048461152785
SIM,1881,26,40-44,1907,1
SIM,1888,40,40-44,1928,6
STAT,1851,14,na,1865,2372.873154383218
SIM,1871,32,30-34,1903,25
SIM,1804,90,na,1894,61
SIM,1853,48,na,1901,1866
STAT,1852,31,20-24,1883,2.2781663878421803
STAT,1805,108,na,1913,7.362189577859327E-4
SIM,1815,78,na,1893,276
STAT,1914,21,45-49,1935,1.1288731876058884
STAT,1860,22,15-19,1882,2.8149092336879376
STAT,1906,21,na,1927,3522.3345812252874
SIM,1871,98,na,1969,14
SIM,1886,8,na,1894,2932
STAT,1901,17,30-34,1918,2.2737809522893695
SIM,1888,61,na,1949,2091
STAT,1879,52,40-44,1931,0.011166448808034858
SIM,1863,25,50-100,1888,4
SIM,1939,16,na,1955,3729
STAT,1855,31,20-24,1886,2.1558257778890586
STAT,1865,31,30-34,1896,16.232066254568686
STAT,1876,61,na,1937,1968.4756197562472
SIM,1927,20,20-24,1947,183
STAT,1835,19,35-39,1854,1.1258035036522018
STAT,1829,48,50-100,1877,0.19621731359442346
STAT,1883,50,40-44,1933,0.010689246085540127
STAT,1832,32,30-34,1864,15.313746959742264
STAT,1949,19,50-100,1968,0.44425593931244445
SIM,1906,36,na,1942,3540
SIM,1932,26,15-19,1958,1
STAT,1837,20,15-19,1857,3.0420496549587517
STAT,1920,32,25-29,1952,10.33136459610899
SIM,1848,62,na,1910,1429
STAT,1862,19,40-44,1881,0.16359521139604466
SIM,1867,28,na,1895,2166
STAT,1851,43,20-24,1894,0.13007702694534287
SIM,1863,14,na,1877,2409
SIM,1946,21,30-34,1967,42
STAT,1846,25,35-39,1871,8.468659690886549
STAT,1906,29,20-24,1935,17.294895827665265
STAT,1802,67,na,1869,683.0283076816959
STAT,1836,25,25-29,1861,34.56699952893712
STAT,1875,51,45-49,1926,0.015267352765341293
STAT,1910,46,40-44,1956,0.1504020690095068
STAT,1926,15,30-34,1941,15.316136888930066
STAT,1824,33,35-39,1857,17.924418988422016
STAT,1838,66,na,1904,1204.266232835388
STAT,1924,44,15-19,1968,0.0018574368849015198
STAT,1922,20,40-44,1942,3.9578295842993128
SIM,1822,33,25-29,1855,11
SIM,1827,63,na,1890,981
STAT,1813,51,50-100,1864,0.03698143068893257
STAT,1834,32,15-19,1866,0.12275650960884758
SIM,1832,33,35-39,1865,17
SIM,1885,17,15-19,1902,8
SIM,1851,29,na,1880,1992
SIM,1860,31,20-24,1891,4
STAT,1843,81,na,1924,436.5445904121606
STAT,1869,27,na,1896,2350.506861424605
STAT,1921,19,45-49,1940,0.5779317757985232
STAT,1947,25,50-100,1972,1.1499002553319562
STAT,1842,50,40-44,1892,0.008374470993673307
STAT,1830,38,40-44,1868,3.8989270355378562
STAT,1832,50,30-34,1882,0.004325540628338008
STAT,1843,18,30-34,1861,1.6346135409802267
SIM,1914,29,20-24,1943,23
STAT,1854,42,30-34,1896,0.8788205848125633
STAT,1902,47,45-49,1949,0.19062488023998947
SIM,1851,18,30-34,1869,2
SIM,1931,24,na,1955,4622
SIM,1843,19,35-39,1862,1
SIM,1942,3,na,1945,4763
STAT,1834,50,45-49,1884,0.010418436861122359
STAT,1919,20,20-24,1939,124.9936930988922
STAT,1883,46,na,1929,2258.4067363582217
STAT,1910,39,50-100,1949,0.4054226629643424
STAT,1849,54,20-24,1903,5.571373538104477E-4
STAT,1912,43,50-100,1955,0.11489232629208884
STAT,1873,33,30-34,1906,17.981501915461603
STAT,1911,39,35-39,1950,2.359016838579291
STAT,1817,66,na,1883,894.2106396602622
STAT,1868,27,15-19,1895,0.4420729414499593
STAT,1901,39,25-29,1940,0.8776240940453901
STAT,1868,32,45-49,1900,1.6991234084897335
STAT,1930,18,50-100,1948,0.49272238866886625
SIM,1906,29,25-29,1935,67
STAT,1814,52,na,1866,1326.1106121757866
STAT,1870,19,50-100,1889,0.0487438764574033
SIM,1880,47,na,1927,2152
STAT,1850,23,35-39,1873,5.230652115705827
SIM,1878,23,30-34,1901,22
STAT,1840,23,25-29,1863,52.01015488044649
STAT,1767,105,na,1872,0.013633803030073385
STAT,1849,101,na,1950,0.4430096392405416
SIM,1916,10,na,1926,4335
STAT,1828,52,30-34,1880,0.004496211158567601
STAT,1891,24,35-39,1915,7.324060568623784
STAT,1803,53,na,1856,1293.4938980282047
STAT,1881,24,25-29,1905,56.10660342881841
SIM,1901,48,30-34,1949,1
SIM,1922,21,45-49,1943,1
STAT,1807,67,na,1874,913.270314538047
SIM,1921,24,35-39,1945,12
STAT,1917,33,50-100,1950,0.8797962678699864
SIM,1836,27,40-44,1863,4
STAT,1913,47,20-24,1960,0.011003860090206553
STAT,1821,34,na,1855,1466.0645051797305
STAT,1849,27,50-100,1876,0.5887105548722357
STAT,1901,31,15-19,1932,0.2039860446518371
STAT,1914,37,50-100,1951,0.42770528694859966
STAT,1850,41,35-39,1891,1.3682660660806791
SIM,1901,58,na,1959,3095
STAT,1808,48,20-24,1856,0.030639634296403862
STAT,1901,35,30-34,1936,1.6566400067281282
STAT,1903,28,40-44,1931,4.328769797089897
SIM,1945,23,na,1968,4658
STAT,1873,54,35-39,1927,0.008659064058590404
STAT,1847,32,25-29,1879,9.37812685815112
STAT,1895,43,30-34,1938,0.10549407500628573
SIM,1836,34,30-34,1870,33
STAT,1913,24,35-39,1937,9.639189443381232
STAT,1869,24,25-29,1893,56.02872642467084
STAT,1925,21,20-24,1946,136.20397934198894
STAT,1856,18,40-44,1874,0.17217042039377414
STAT,1851,36,30-34,1887,4.490467530529611
SIM,1933,21,20-24,1954,140
STAT,1893,32,20-24,1925,3.4981539147927307
STAT,1895,25,30-34,1920,33.744777140154106
SIM,1911,28,40-44,1939,2
SIM,1855,32,25-29,1887,16
STAT,1810,45,25-29,1855,0.18758285001447492
STAT,1852,36,15-19,1888,0.045958422299802855
SIM,1876,25,25-29,1901,60
STAT,1828,34,30-34,1862,16.137059283582445
SIM,1854,42,35-39,1896,3
SIM,1881,33,30-34,1914,24
STAT,1826,41,20-24,1867,0.13246563788164784
SIM,1885,0,na,1885,3419
STAT,1910,47,40-44,1957,0.15002907187836323
SIM,1947,0,na,1947,4933
STAT,1891,42,35-39,1933,2.2842383332542755
SIM,1916,16,25-29,1932,15
SIM,1937,32,45-49,1969,1
STAT,1892,47,25-29,1939,0.04134833465532726
STAT,1821,52,25-29,1873,0.005360025222786227
SIM,1831,30,na,1861,1802
SIM,1847,41,30-34,1888,1
STAT,1846,42,35-39,1888,1.31062914819717
STAT,1887,26,50-100,1913,0.7337631975165497
SIM,1944,27,40-44,1971,6
STAT,1870,76,na,1946,944.8103243447874
STAT,1832,25,40-44,1857,2.814480082334443
STAT,1822,39,45-49,1861,3.397180351266953
STAT,1830,48,na,1878,1508.0942050641133
STAT,1859,23,50-100,1882,0.34222797947043004
STAT,1918,39,40-44,1957,1.606741513456803
STAT,1934,21,50-100,1955,0.9020751730344755
SIM,1844,29,40-44,1873,1
SIM,1830,39,45-49,1869,2
SIM,1908,25,30-34,1933,57
STAT,1896,35,25-29,1931,3.916138388035517
SIM,1869,94,na,1963,43
STAT,1859,39,40-44,1898,3.530522640769349
SIM,1903,29,45-49,1932,6
STAT,1828,27,40-44,1855,4.396624215382549
STAT,1906,28,20-24,1934,17.358079236084617
SIM,1914,28,20-24,1942,20
STAT,1815,41,45-49,1856,5.000964460423652
STAT,1829,51,na,1880,1541.6693857079508
STAT,1874,16,35-39,1890,0.5729181616428485
STAT,1883,51,40-44,1934,0.010588232710031772
STAT,1829,44,25-29,1873,0.5244345535172297
STAT,1882,32,45-49,1914,1.733144467125547
STAT,1813,67,na,1880,807.1124923630013
STAT,1836,29,40-44,1865,2.3783041076209135
STAT,1860,51,20-24,1911,6.137087763294697E-4
SIM,1824,82,na,1906,166
STAT,1844,99,na,1943,1.4675791214808696
STAT,1897,38,na,1935,3197.699409549321
STAT,1921,26,35-39,1947,17.133226682015454
SIM,1886,21,15-19,1907,4
STAT,1805,104,na,1909,0.026808539587248527
SIM,1839,81,na,1920,316
STAT,1834,38,20-24,1872,0.6385882163114308
STAT,1912,17,na,1929,3984.1255209153574
STAT,1936,27,40-44,1963,4.549658741592608
STAT,1887,44,35-39,1931,2.0420605548782986
SIM,1831,43,45-49,1874,3
STAT,1845,49,40-44,1894,0.13097365209214842
SIM,1859,36,25-29,1895,3
SIM,1879,57,na,1936,2474
STAT,1824,51,35-39,1875,0.009873671490058376
STAT,1895,18,40-44,1913,0.2428081442400941
STAT,1867,42,20-24,1909,0.15191301611551525
STAT,1893,37,15-19,1930,0.07267222754206112
STAT,1867,47,15-19,1914,3.81306365030508E-4
SIM,1965,4,na,1969,4973
STAT,1862,15,25-29,1877,5.702993302501904
STAT,1838,108,na,1946,0.0013458628595644315
STAT,1890,34,45-49,1924,2.156511071723274
STAT,1830,52,na,1882,1413.5500516222498
STAT,1860,28,20-24,1888,9.743865249561827
STAT,1808,52,na,1860,1040.7783451139478
STAT,1843,44,25-29,1887,0.520244619478282
STAT,1839,41,30-34,1880,0.9308033605179389
SIM,1846,66,na,1912,1186
STAT,1769,85,na,1854,40.0
STAT,1842,33,na,1875,2031.9132554119487
STAT,1929,32,45-49,1961,2.0386476100586086
STAT,1857,45,15-19,1902,3.218644639138695E-4
STAT,1823,43,45-49,1866,2.3611763804529
STAT,1907,40,45-49,1947,0.1572458561096485
SIM,1878,13,na,1891,2828
STAT,1838,51,40-44,1889,0.007847932582668653
STAT,1841,108,na,1949,0.00135245800501244
STAT,1870,52,50-100,1922,0.01498122909975691
SIM,1896,37,40-44,1933,12
SIM,1851,44,25-29,1895,1
STAT,1908,16,25-29,1924,8.592823943680296
STAT,1949,19,15-19,1968,53.814213671668995
STAT,1822,50,50-100,1872,0.021541894000888597
STAT,1826,46,15-19,1872,3.1672646477024256E-4
STAT,1894,15,25-29,1909,7.470532928825895
SIM,1857,23,45-49,1880,4
STAT,1850,99,na,1949,1.4245759261828361
SIM,1767,93,na,1860,3
SIM,1872,44,45-49,1916,2
STAT,1821,93,na,1914,15.400007043723063
SIM,1818,39,40-44,1857,6
SIM,1863,34,25-29,1897,14
STAT,1843,18,na,1861,2354.120709395702
SIM,1862,24,30-34,1886,18
SIM,1835,24,25-29,1859,49
STAT,1846,43,35-39,1889,1.29394483914062
STAT,1884,19,30-34,1903,1.600037779442369
STAT,1861,53,50-100,1914,0.012526726103916409
STAT,1827,31,45-49,1858,2.8340418243945074
STAT,1848,26,35-39,1874,9.018853197412934
SIM,1828,35,35-39,1863,1
SIM,1854,43,35-39,1897,3
STAT,1831,96,na,1927,5.785871784459033
STAT,1762,97,na,1859,0.8597965243340167
STAT,1833,48,30-34,1881,0.06738395938727552
SIM,1907,31,20-24,1938,2
STAT,1882,61,na,1943,1857.1935927931388
STAT,1939,15,40-44,1954,1.431784276151774
STAT,1905,38,50-100,1943,0.3884960641132759
STAT,1854,24,30-34,1878,15.788766679487987
SIM,1882,22,50-100,1904,4
SIM,1907,43,na,1950,3500
STAT,1865,52,35-39,1917,0.007928717728577962
SIM,1891,10,na,1901,3346
SIM,1900,11,na,1911,3729
SIM,1904,21,30-34,1925,34
STAT,1812,54,50-100,1866,0.03274962466039574
STAT,1888,44,30-34,1932,1.3678076553961867
SIM,1861,44,na,1905,2403
SIM,1866,28,na,1894,2378
STAT,1844,66,na,1910,1270.087622431067
SIM,1850,44,na,1894,1708
STAT,1894,22,45-49,1916,0.9150380661749029
SIM,1925,24,na,1949,4478
STAT,1849,23,45-49,1872,0.6498365911271466
STAT,1864,44,45-49,1908,1.3392511081195169
SIM,1921,10,na,1931,5246
SIM,1904,25,na,1929,3690
SIM,1883,33,15-19,1916,2
STAT,1927,22,20-24,1949,139.74824572022172
SIM,1895,26,35-39,1921,10
SIM,1936,35,35-39,1971,2
STAT,1841,31,45-49,1872,1.578495325273611
SIM,1873,34,35-39,1907,16
SIM,1947,15,40-44,1962,2
SIM,1863,38,40-44,1901,9
SIM,1935,22,20-24,1957,136
STAT,1854,17,40-44,1871,0.16745629516008914
SIM,1845,81,na,1926,445
STAT,1848,19,45-49,1867,0.06220671935755164
STAT,1875,33,15-19,1908,0.14847313995842487
SIM,1869,49,50-100,1918,1
STAT,1887,26,35-39,1913,11.067864355933104
SIM,1895,26,50-100,1921,1
SIM,1897,42,na,1939,3136
SIM,1926,39,40-44,1965,6
STAT,1846,50,25-29,1896,0.0025693703593813563
SIM,1835,31,45-49,1866,2
SIM,1845,29,na,1874,2145
STAT,1930,0,na,1930,5940.42472960393
SIM,1840,25,40-44,1865,2
STAT,1916,42,15-19,1958,0.0016059649048093992
STAT,1861,62,na,1923,1540.719303551619
STAT,1928,35,35-39,1963,3.123384981572075
SIM,1912,34,35-39,1946,14
STAT,1909,47,30-34,1956,0.08354286582911405
STAT,1833,29,na,1862,1844.2491281281475
STAT,1942,21,50-100,1963,0.7041011012599633
SIM,1930,23,45-49,1953,3
SIM,1933,24,25-29,1957,133
STAT,1828,37,35-39,1865,6.200771819184481
SIM,1830,32,25-29,1862,2
SIM,1895,19,na,1914,3539
SIM,1901,20,15-19,1921,10
STAT,1814,48,50-100,1862,0.7205441503580947
STAT,1871,68,na,1939,1544.281260999001
SIM,1878,43,35-39,1921,1
SIM,1924,24,15-19,1948,6
STAT,1859,32,20-24,1891,2.2022224046647683
SIM,1846,44,50-100,1890,3
SIM,1884,31,na,1915,2608
STAT,1900,60,na,1960,2810.750731449739
STAT,1901,23,50-100,1924,0.5799477108828252
SIM,1834,82,na,1916,248
STAT,1906,20,25-29,1926,85.50806650720303
STAT,1788,102,na,1890,0.0970852945747949
STAT,1880,32,30-34,1912,18.717334080212048
SIM,1858,34,20-24,1892,2
SIM,1937,26,35-39,1963,23
STAT,1852,47,50-100,1899,0.19693334837449486
STAT,1874,22,45-49,1896,0.7263035497208058
STAT,1853,43,na,1896,1923.972030298353
STAT,1839,34,45-49,1873,1.450593061458784
STAT,1886,39,35-39,1925,7.5605588943455935
STAT,1898,17,na,1915,3484.2060568852016
SIM,1892,41,45-49,1933,6
STAT,1916,24,15-19,1940,5.656584640025942
SIM,1910,25,na,1935,3639
STAT,1829,104,na,1933,0.0443611195562051
STAT,1834,48,15-19,1882,2.8184051688565065E-4
STAT,1918,47,40-44,1965,0.1712133263496293
SIM,1795,84,na,1879,105
SIM,1886,32,na,1918,2632
STAT,1853,21,45-49,1874,0.6958476612138064
STAT,1920,28,40-44,1948,5.1994849602686015
SIM,1915,33,20-24,1948,2
SIM,1918,16,50-100,1934,1
STAT,1836,45,30-34,1881,0.06469596042972309
STAT,1949,21,45-49,1970,1.3399452639213032
STAT,1819,48,35-39,1867,0.27336022061572446
STAT,1907,33,20-24,1940,2.315054060501218
STAT,1856,31,40-44,1887,3.552069981176215
STAT,1840,21,35-39,1861,5.378751778696096
STAT,1931,15,50-100,1946,0.5024491910315279
STAT,1951,21,15-19,1972,6.490117963847007
STAT,1868,48,30-34,1916,0.09313364109094927
STAT,1845,45,25-29,1890,0.045454269901129316
STAT,1847,24,25-29,1871,53.942322769879766
STAT,1904,34,35-39,1938,8.429067218867369
STAT,1908,18,30-34,1926,2.4046484070264613
SIM,1929,22,50-100,1951,1
STAT,1813,41,30-34,1854,4.362087695544431
STAT,1922,23,45-49,1945,1.3125163430696307
STAT,1925,24,25-29,1949,112.0979128689527
SIM,1864,22,25-29,1886,69
SIM,1872,46,na,1918,2368
SIM,1851,48,40-44,1899,1
SIM,1899,28,30-34,1927,55
STAT,1875,25,15-19,1900,0.47825416232520873
STAT,1895,28,35-39,1923,12.797622616074593
SIM,1822,87,na,1909,110
STAT,1894,38,30-34,1932,6.958880918121712
STAT,1864,21,20-24,1885,63.9738377917751
SIM,1825,50,45-49,1875,1
STAT,1869,35,50-100,1904,1.220698253712012
STAT,1917,18,40-44,1935,0.30635519206506606
SIM,1874,31,50-100,1905,1
STAT,1812,57,na,1869,1172.0602262506109
SIM,1802,71,na,1873,602
SIM,1872,21,20-24,1893,79
SIM,1925,18,40-44,1943,1
SIM,1797,85,na,1882,62
STAT,1872,33,35-39,1905,10.310517797721042
STAT,1825,54,50-100,1879,0.01799909530794783
STAT,1948,15,na,1963,4299.912218332091
SIM,1865,74,na,1939,1050
SIM,1903,36,35-39,1939,3
SIM,1920,33,30-34,1953,21
STAT,1871,32,20-24,1903,2.731507438233919
STAT,1855,44,na,1899,1767.484913871799
STAT,1856,22,25-29,1878,53.24175974632599
STAT,1923,33,na,1956,4421.049856776355
STAT,1921,31,30-34,1952,17.96448527760029
SIM,1855,24,25-29,1879,4
STAT,1848,32,45-49,1880,1.5807899004414683
STAT,1849,21,40-44,1870,1.9700983268019714
STAT,1907,26,15-19,1933,0.68192730935712
STAT,1857,28,15-19,1885,0.36964993576415633
SIM,1879,84,na,1963,707
STAT,1827,47,30-34,1874,0.10871428256210934
STAT,1925,31,15-19,1956,0.15577862490309546
STAT,1851,42,45-49,1893,1.2332339748814982
STAT,1865,24,45-49,1889,0.6441498868251557
STAT,1822,51,na,1873,1430.9332137492
STAT,1845,52,30-34,1897,0.004626246657442864
SIM,1924,45,na,1969,4505
STAT,1845,38,35-39,1883,5.746562151064187
STAT,1889,30,25-29,1919,13.010902118533172
STAT,1913,39,na,1952,3749.498859912864
SIM,1835,21,20-24,1856,76
STAT,1880,30,20-24,1910,2.9210516170678313
SIM,1882,76,na,1958,841
SIM,1939,30,40-44,1969,4
SIM,1899,35,20-24,1934,1
STAT,1901,15,25-29,1916,8.121596389195362
STAT,1952,20,na,1972,4482.041749786235
STAT,1845,14,na,1859,2336.16884633607
SIM,1873,93,na,1966,45
SIM,1894,61,na,1955,2483
STAT,1884,41,45-49,1925,1.517367714033929
SIM,1853,38,35-39,1891,8
SIM,1883,25,15-19,1908,1
SIM,1897,30,25-29,1927,20
SIM,1889,22,30-34,1911,28
STAT,1817,50,45-49,1867,0.03235186832763568
STAT,1903,19,na,1922,3642.9032667846
STAT,1850,8,na,1858,2257.18784190267
STAT,1913,41,35-39,1954,0.20148318232626936
SIM,1968,1,na,1969,5243
SIM,1862,42,30-34,1904,2
STAT,1843,22,15-19,1865,3.342877444447379
SIM,1915,26,15-19,1941,1
STAT,1903,5,na,1908,3800.35735147496
SIM,1836,37,35-39,1873,9
STAT,1930,24,35-39,1954,12.225605243687376
STAT,1955,16,50-100,1971,0.5074194933214897
STAT,1831,28,50-100,1859,0.6154304776890781
SIM,1854,31,na,1885,2118
STAT,1866,50,40-44,1916,0.010048560598104281
STAT,1831,32,35-39,1863,9.274672812673623
STAT,1902,39,45-49,1941,0.6127853678970976
STAT,1851,36,50-100,1887,1.0344419839509351
SIM,1843,16,30-34,1859,2
STAT,1896,33,35-39,1929,13.587156505410022
STAT,1849,53,45-49,1902,0.011085963970088385
STAT,1932,1,na,1933,5639.365447626762
SIM,1867,32,20-24,1899,5
SIM,1910,39,45-49,1949,2
STAT,1830,31,20-24,1861,2.6300350348844934
STAT,1930,39,20-24,1969,0.34994391808434894
SIM,1929,31,25-29,1960,14
STAT,1844,105,na,1949,0.022720921809331086
STAT,1884,49,40-44,1933,0.16918147694693522
SIM,1892,49,40-44,1941,1
STAT,1875,49,15-19,1924,4.1005960336179775E-4
SIM,1856,32,45-49,1888,3
STAT,1920,26,30-34,1946,44.01386173118907
STAT,1911,38,na,1949,3688.213250921459
STAT,1946,23,30-34,1969,32.62097079915644
SIM,1857,21,40-44,1878,2
SIM,1945,3,na,1948,4732
STAT,1878,51,30-34,1929,0.0063510240595186515
STAT,1917,39,na,1956,3963.5287247499605
STAT,1798,82,na,1880,207.88388099779604
STAT,1932,18,20-24,1950,182.60081496971725
SIM,1853,79,na,1932,484
SIM,1874,47,na,1921,2306
SIM,1923,24,50-100,1947,4
SIM,1947,18,na,1965,4252
STAT,1803,84,na,1887,128.97358559102477
STAT,1929,26,35-39,1955,19.173205723264118
STAT,1824,52,na,1876,1322.4440419417076
STAT,1862,35,30-34,1897,4.672160148306887
SIM,1872,26,50-100,1898,4
SIM,1940,18,20-24,1958,154
STAT,1903,29,35-39,1932,13.892527722545474
SIM,1932,19,25-29,1951,68
STAT,1855,108,na,1963,0.007239409576313007
STAT,1819,99,na,1918,1.1165426160479088
STAT,1828,50,20-24,1878,5.79927708136732E-4
SIM,1943,16,35-39,1959,5
STAT,1879,32,20-24,1911,2.882420210745376
SIM,1902,38,40-44,1940,6
STAT,1907,39,na,1946,3521.035833120293
SIM,1847,79,na,1926,449
SIM,1888,35,45-49,1923,2
STAT,1914,15,35-39,1929,0.8897298859549495
SIM,1884,47,na,1931,2360
STAT,1845,50,20-24,1895,5.848566251662568E-4
STAT,1950,16,15-19,1966,54.760589632912655
SIM,1888,23,25-29,1911,94
SIM,1838,32,25-29,1870,11
STAT,1886,46,25-29,1932,0.06237376581478268
SIM,1950,16,25-29,1966,56
STAT,1825,52,45-49,1877,0.017996404191051987
SIM,1768,88,na,1856,23
SIM,1865,64,na,1929,1586
STAT,1803,74,na,1877,530.9404893514676
STAT,1880,17,35-39,1897,0.5882324502127313
SIM,1851,40,45-49,1891,3
SIM,1885,19,na,1904,2580
STAT,1897,23,25-29,1920,77.84382578447531
SIM,1843,23,20-24,1866,75
STAT,1808,52,45-49,1860,0.034633399261720064
STAT,1849,43,15-19,1892,0.01064395770024851
STAT,1835,23,20-24,1858,67.78892162740243
SIM,1911,26,30-34,1937,57
STAT,1837,50,30-34,1887,0.00414415273765682
STAT,1874,11,na,1885,2735.364686950535
STAT,1935,16,35-39,1951,5.864339980619725
STAT,1861,43,15-19,1904,0.011557153994248875
STAT,1829,42,35-39,1871,1.5195183108704322
STAT,1910,60,na,1970,3255.447130512678
STAT,1922,37,20-24,1959,0.30606039920414757
STAT,1917,25,30-34,1942,42.21799780465201
STAT,1926,39,30-34,1965,2.26748399237736
STAT,1889,43,50-100,1932,1.3216642380546435
STAT,1942,16,25-29,1958,46.21662795438194
SIM,1892,66,na,1958,2420
STAT,1889,30,40-44,1919,5.508813196639138
SIM,1922,15,35-39,1937,5
STAT,1913,39,20-24,1952,0.2627195076986869
STAT,1899,34,15-19,1933,0.19723596717145656
SIM,1842,42,45-49,1884,6
SIM,1837,42,35-39,1879,1
STAT,1848,23,30-34,1871,16.737969081798393
STAT,1907,19,25-29,1926,8.442598604595377
STAT,1835,85,na,1920,204.24821149494412
STAT,1878,72,na,1950,1341.019136305151
STAT,1962,10,na,1972,5133.995481116405
STAT,1880,11,na,1891,2772.6575161973583
STAT,1895,41,20-24,1936,0.014745209721513547
STAT,1948,16,45-49,1964,0.583424652082063
STAT,1938,31,25-29,1969,9.485728178067802
SIM,1916,18,15-19,1934,8
STAT,1772,112,na,1884,4.2418321029008457E-4
STAT,1903,36,40-44,1939,1.3767763425115842
STAT,1777,90,na,1867,34.647120784521725
STAT,1908,18,15-19,1926,8.953373261059715
SIM,1907,34,25-29,1941,8
SIM,1911,36,40-44,1947,4
STAT,1843,40,45-49,1883,1.2762624505851383
STAT,1912,33,30-34,1945,15.748210548525126
SIM,1880,33,35-39,1913,18
STAT,1787,102,na,1889,0.10416910930395276
STAT,1858,42,na,1900,1867.5086503041798
STAT,1854,43,25-29,1897,0.4879275245263406
SIM,1868,49,35-39,1917,1
SIM,1915,19,25-29,1934,10
SIM,1892,76,na,1968,1882
STAT,1933,23,20-24,1956,150.36785251295726
SIM,1931,29,20-24,1960,30
STAT,1854,27,35-39,1881,7.741732339640987
SIM,1836,77,na,1913,587
SIM,1852,21,20-24,1873,100
SIM,1896,22,20-24,1918,103
STAT,1848,16,40-44,1864,0.17729321181584018
STAT,1937,34,45-49,1971,1.5859466545100327
STAT,1860,38,15-19,1898,0.04624939085681372
STAT,1912,26,40-44,1938,4.701786274570969
STAT,1870,33,15-19,1903,0.1414185456235885
SIM,1840,82,na,1922,220
STAT,1834,102,na,1936,0.19701873520865704
STAT,1924,26,15-19,1950,0.8414899430658892
SIM,1834,72,na,1906,966
SIM,1898,22,40-44,1920,3
SIM,1941,23,20-24,1964,4
STAT,1881,22,35-39,1903,5.755402128213954
STAT,1844,47,30-34,1891,0.07466171509378212
STAT,1851,24,15-19,1875,3.2037961563585244
STAT,1858,33,15-19,1891,0.1147227188403792
SIM,1951,15,30-34,1966,22
STAT,1909,26,35-39,1935,14.80828607894347
SIM,1946,24,35-39,1970,12
SIM,1894,39,35-39,1933,13
STAT,1830,27,35-39,1857,10.91479294568516
SIM,1846,31,20-24,1877,6
STAT,1843,48,40-44,1891,0.13646858700666006
STAT,1904,49,20-24,1953,0.00969008700023061
STAT,1801,89,na,1890,37.48290588891216
STAT,1862,16,na,1878,2296.525558814149
SIM,1902,36,30-34,1938,2
STAT,1919,24,na,1943,4055.085121355961
STAT,1844,21,20-24,1865,67.15691042482995
SIM,1883,43,45-49,1926,2
STAT,1873,25,50-100,1898,0.6660901083347934
SIM,1857,45,na,1902,1908
SIM,1920,26,40-44,1946,10
STAT,1924,19,25-29,1943,52.367734825666815
STAT,1923,29,20-24,1952,21.23023460917243
STAT,1872,40,25-29,1912,0.6631853237193736
STAT,1869,51,20-24,1920,7.302604058429264E-4
STAT,1892,43,45-49,1935,1.8997240525327823
SIM,1836,49,50-100,1885,2
STAT,1869,53,30-34,1922,0.00576858399012082
STAT,1878,62,na,1940,1940.7968341733501
SIM,1866,33,15-19,1899,1
SIM,1884,24,20-24,1908,73
STAT,1910,20,15-19,1930,5.128949407840957
SIM,1859,64,na,1923,1522
SIM,1897,30,40-44,1927,10
STAT,1830,41,30-34,1871,1.0059965184266206
STAT,1876,24,20-24,1900,72.13999216504878
STAT,1875,43,45-49,1918,1.5556785678153926
STAT,1938,24,35-39,1962,9.49972260982438
SIM,1917,26,35-39,1943,1
STAT,1862,26,na,1888,2095.1400115890506
SIM,1879,33,25-29,1912,18
SIM,1861,37,30-34,1898,3
SIM,1847,34,45-49,1881,1
STAT,1933,16,15-19,1949,62.10835296131648
SIM,1842,24,15-19,1866,5
SIM,1862,27,35-39,1889,10
STAT,1834,66,na,1900,1101.4435670684097
STAT,1838,31,20-24,1869,2.493666017652568
STAT,1820,42,15-19,1862,0.02746037209509539
STAT,1834,24,15-19,1858,2.9267009880547916
SIM,1941,16,15-19,1957,39
STAT,1943,15,30-34,1958,13.194079495177013
STAT,1851,4,na,1855,2673.5956
STAT,1798,88,na,1886,58.408769690705896
STAT,1893,79,na,1972,1408.998180994432
STAT,1947,21,25-29,1968,106.5461572127019
SIM,1926,40,na,1966,4923
STAT,1853,37,30-34,1890,4.468843970878347
STAT,1830,86,na,1916,140.35713094913183
STAT,1864,11,na,1875,2472.8529058617796
STAT,1839,31,40-44,1870,3.7216301454670204
STAT,1933,23,na,1956,4938.302907454494
STAT,1907,36,25-29,1943,0.9353412608860078
STAT,1858,48,na,1906,1797.2683397736023
STAT,1836,48,35-39,1884,0.0900404515264027
STAT,1860,52,na,1912,1772.7199882425807
SIM,1872,24,25-29,1896,3
STAT,1825,34,15-19,1859,0.24317284828884064
STAT,1860,32,45-49,1892,1.4433864884379226
STAT,1873,6,na,1879,2835.3902714081596
STAT,1818,76,na,1894,482.8128190101186
SIM,1875,64,na,1939,1672
STAT,1863,33,25-29,1896,9.122853490842905
STAT,1889,24,30-34,1913,22.30551903051642
STAT,1845,42,20-24,1887,0.1263611882821941
STAT,1910,8,na,1918,4017.509704776855
SIM,1840,72,na,1912,774
STAT,1903,43,30-34,1946,0.1149380321544262
SIM,1916,20,na,1936,3942
STAT,1806,98,na,1904,1.1543169933352844
SIM,1839,26,na,1865,2016
STAT,1853,45,30-34,1898,0.08197586983410979
STAT,1817,48,15-19,1865,8.799476534759564E-4
SIM,1838,24,25-29,1862,61
STAT,1867,25,na,1892,2301.1555748499604
STAT,1946,20,na,1966,4148.977146120272
STAT,1809,99,na,1908,0.9662341755546743
STAT,1873,20,50-100,1893,0.42427350306131023
STAT,1897,15,25-29,1912,7.7655379019260415
STAT,1862,42,50-100,1904,0.9162933555157661
STAT,1892,25,15-19,1917,0.5840222743885816
STAT,1793,89,na,1882,41.267382063576946
STAT,1849,35,15-19,1884,0.045546559137630005
SIM,1847,31,40-44,1878,4
STAT,1859,35,25-29,1894,2.36800265677939
SIM,1861,13,na,1874,2965
STAT,1927,44,30-34,1971,0.16301215172425906
STAT,1911,34,25-29,1945,9.101863105989612
SIM,1837,25,na,1862,1841
STAT,1878,54,35-39,1932,0.008890237481757287
SIM,1913,23,45-49,1936,1
SIM,1914,55,na,1969,3589
STAT,1871,35,25-29,1906,2.937131534512383
SIM,1834,48,40-44,1882,1
SIM,1907,24,15-19,1931,3
SIM,1816,53,na,1869,1381
SIM,1918,21,na,1939,3989
SIM,1844,21,45-49,1865,1
STAT,1892,34,50-100,1926,1.1614469273883263
SIM,1844,48,35-39,1892,1
STAT,1940,29,20-24,1969,18.97066669464705
STAT,1915,18,20-24,1933,28.879505038700884
STAT,1893,39,40-44,1932,5.60811277321996
SIM,1892,15,15-19,1907,7
STAT,1884,39,15-19,1923,0.056105405915603965
SIM,1897,24,30-34,1921,31
STAT,1946,26,35-39,1972,17.070805468701472
SIM,1906,26,na,1932,3733
SIM,1848,31,40-44,1879,7
STAT,1905,23,45-49,1928,1.0242202966514105
STAT,1862,19,50-100,1881,0.04382013525369128
STAT,1912,19,35-39,1931,0.8609427767270434
STAT,1868,42,na,1910,2249.2239847426613
SIM,1814,52,na,1866,1225
STAT,1883,25,na,1908,2405.0338656504164
SIM,1874,21,40-44,1895,2
SIM,1937,23,30-34,1960,40
STAT,1852,16,30-34,1868,1.5621794027303606
STAT,1888,22,20-24,1910,83.10985979985394
SIM,1873,21,40-44,1894,4
STAT,1890,65,na,1955,2107.9525370758065
SIM,1860,16,30-34,1876,8
STAT,1897,30,15-19,1927,0.19581068088699946
STAT,1773,112,na,1885,7.713961313972136E-4
STAT,1922,41,50-100,1963,0.13778682102858464
SIM,1860,65,na,1925,1696
STAT,1857,22,45-49,1879,0.6413727801241706
SIM,1845,27,35-39,1872,14
SIM,1864,34,45-49,1898,2
STAT,1827,54,50-100,1881,0.014311768113687038
SIM,1929,24,35-39,1953,17
STAT,1820,45,50-100,1865,0.46126805538735327
SIM,1865,22,45-49,1887,1
STAT,1847,70,na,1917,1094.135524276297
STAT,1906,27,50-100,1933,0.9498445198757475
STAT,1920,18,30-34,1938,13.918849922585007
STAT,1866,53,45-49,1919,0.013436491204132811
STAT,1923,39,na,1962,4438.25865280194
STAT,1848,96,na,1944,6.6746932221882505
SIM,1804,68,na,1872,891
STAT,1856,34,45-49,1890,1.3845029911922269
STAT,1836,21,45-49,1857,0.577005896914799
STAT,1834,42,45-49,1876,1.2141918297248353
STAT,1883,18,15-19,1901,5.924716674321771
SIM,1923,18,20-24,1941,174
STAT,1866,21,40-44,1887,1.9911082935186466
STAT,1900,66,na,1966,2585.5493310859333
SIM,1903,33,30-34,1936,28
SIM,1861,9,na,1870,3030
SIM,1890,47,na,1937,2940
SIM,1853,35,30-34,1888,7
STAT,1849,7,na,1856,2365.3256143707
STAT,1865,32,45-49,1897,1.6146099023362719
STAT,1855,32,35-39,1887,7.993412457498741
STAT,1918,15,20-24,1933,30.35265109172191
SIM,1830,42,35-39,1872,5
SIM,1855,46,50-100,1901,1
SIM,1829,31,20-24,1860,2
STAT,1879,10,na,1889,2779.8583983502554
SIM,1832,23,45-49,1855,1
STAT,1830,34,25-29,1864,9.461650869834049
STAT,1837,43,25-29,1880,0.4987890664214115
STAT,1866,77,na,1943,813.3672364748644
STAT,1826,48,40-44,1874,0.13201795084449722
STAT,1865,21,40-44,1886,1.9669809673079244
STAT,1872,1,na,1873,3578.450959284776
STAT,1898,23,45-49,1921,0.9590191111035217
SIM,1946,16,35-39,1962,7
SIM,1941,26,25-29,1967,5
STAT,1881,82,na,1963,695.8641836545047
SIM,1891,18,15-19,1909,11
STAT,1849,44,na,1893,1770.1349175630685
STAT,1933,26,25-29,1959,89.1681223116039
SIM,1841,20,na,1861,1997
STAT,1929,23,30-34,1952,36.95589222752877
SIM,1856,23,30-34,1879,29
STAT,1914,56,na,1970,3578.9156719188636
STAT,1867,49,40-44,1916,0.1605402321829913
STAT,1912,6,na,1918,4120.974866304642
SIM,1917,39,30-34,1956,6
STAT,1843,43,na,1886,1896.5985461947919
STAT,1866,35,15-19,1901,0.05334159396583525
STAT,1887,83,na,1970,854.8137551528258
SIM,1785,84,na,1869,90
SIM,1926,15,20-24,1941,230
STAT,1921,38,na,1959,4282.323859290201
SIM,1842,46,50-100,1888,1
STAT,1839,44,na,1883,1638.6253293905816
STAT,1822,42,35-39,1864,2.8195492834687275
STAT,1864,24,25-29,1888,52.00656734914325
STAT,1927,37,40-44,1964,1.8985719483223866
SIM,1916,20,45-49,1936,1
STAT,1763,108,na,1871,0.0017233548893082842
SIM,1890,48,50-100,1938,1
STAT,1845,105,na,1950,0.02290961668027843
STAT,1904,18,45-49,1922,0.09525557717490107
SIM,1925,25,30-34,1950,71
SIM,1819,37,35-39,1856,11
STAT,1917,49,30-34,1966,0.09446444340395692
SIM,1934,17,na,1951,5229
STAT,1930,20,50-100,1950,0.8648516904848166
SIM,1845,43,25-29,1888,4
SIM,1863,79,na,1942,444
STAT,1783,90,na,1873,31.123840269841867
SIM,1811,54,na,1865,1025
SIM,1899,39,na,1938,3264
STAT,1850,19,15-19,1869,5.390864211955706
STAT,1878,28,35-39,1906,10.209757719619677
SIM,1911,43,30-34,1954,1
STAT,1861,68,na,1929,1288.221997819506
SIM,1836,36,na,1872,1976
SIM,1876,12,na,1888,3049
SIM,1886,28,35-39,1914,16
STAT,1889,17,40-44,1906,0.23048412371861682
STAT,1851,78,na,1929,644.6130617202739
STAT,1908,20,45-49,1928,1.0610963840035597
SIM,1801,54,na,1855,1330
STAT,1783,105,na,1888,0.022237147217051178
STAT,1909,39,30-34,1948,1.7416943109429566
STAT,1949,7,na,1956,4663.943435385355
STAT,1793,73,na,1866,537.9825152228167
STAT,1905,38,na,1943,3481.2033627762157
SIM,1827,29,40-44,1856,3
STAT,1773,90,na,1863,28.445870644221692
SIM,1820,36,30-34,1856,11
STAT,1902,38,30-34,1940,1.6467266453121154
STAT,1852,23,20-24,1875,65.47690769243238
STAT,1826,47,na,1873,1490.2033793309877
STAT,1880,40,30-34,1920,1.2449145423954575
STAT,1867,27,30-34,1894,24.117503883812613
STAT,1926,30,50-100,1956,1.0210430732140492
STAT,1862,57,na,1919,1745.163625035358
STAT,1796,87,na,1883,58.40180946208057
SIM,1888,32,40-44,1920,7
STAT,1840,53,50-100,1893,0.010693411640846535
STAT,1841,51,35-39,1892,0.006386935348850412
STAT,1874,8,na,1882,2800.9766597714993
STAT,1945,19,45-49,1964,0.5563711962660297
SIM,1934,30,50-100,1964,2
SIM,1910,38,30-34,1948,5
STAT,1875,82,na,1957,558.7594154546796
STAT,1839,42,45-49,1881,1.0886297103914426
STAT,1843,45,50-100,1888,0.20246384335404607
STAT,1905,42,na,1947,3412.805840022281
STAT,1925,16,25-29,1941,53.53980982522549
STAT,1934,16,15-19,1950,62.75468684736795
SIM,1888,20,20-24,1908,2
STAT,1952,16,35-39,1968,5.131080908769513
SIM,1855,41,40-44,1896,5
STAT,1858,49,15-19,1907,3.1684621607279195E-4
STAT,1876,67,na,1943,1669.9150445464068
SIM,1915,16,20-24,1931,48
STAT,1923,23,na,1946,4321.904484336857
SIM,1865,33,na,1898,2297
SIM,1871,33,25-29,1904,14
SIM,1878,26,35-39,1904,10
SIM,1896,32,na,1928,3230
STAT,1886,43,20-24,1929,0.17024944087613986
SIM,1839,32,45-49,1871,5
STAT,1876,43,50-100,1919,1.1048581383420526
STAT,1842,17,15-19,1859,5.976221821651729
STAT,1898,55,na,1953,2852.5192603585056
SIM,1863,32,35-39,1895,13
SIM,1814,68,na,1882,832
SIM,1887,35,25-29,1922,3
STAT,1908,56,na,1964,3261.735753723374
STAT,1845,35,30-34,1880,4.908959686365797
STAT,1938,16,35-39,1954,4.2327906321964415
STAT,1910,29,25-29,1939,64.36181564660318
SIM,1846,8,na,1854,2425
SIM,1899,27,50-100,1926,1
SIM,1884,43,50-100,1927,2
SIM,1881,33,na,1914,2167
SIM,1910,35,na,1945,3666
SIM,1850,17,15-19,1867,9
STAT,1879,35,25-29,1914,3.09940481149481
STAT,1943,23,30-34,1966,31.187663144232186
STAT,1819,52,20-24,1871,0.0014059324214068744
STAT,1830,70,na,1900,887.5737204869147
STAT,1878,44,25-29,1922,0.6726775349504757
STAT,1956,15,40-44,1971,1.8886437805980343
SIM,1879,25,25-29,1904,63
STAT,1830,24,30-34,1854,41.917110795071906
STAT,1907,15,45-49,1922,0.0983003338427
STAT,1911,37,45-49,1948,0.6716432802546399
SIM,1903,41,30-34,1944,1
SIM,1917,23,30-34,1940,41
SIM,1861,43,50-100,1904,4
SIM,1938,25,40-44,1963,5
SIM,1886,44,25-29,1930,2
SIM,1890,22,50-100,1912,1
STAT,1912,36,35-39,1948,2.4198356505398784
STAT,1895,10,na,1905,3447.7522651942536
STAT,1919,45,35-39,1964,0.14337630776271923
STAT,1847,41,40-44,1888,1.7865397498422837
STAT,1929,24,na,1953,4680.600128644188
SIM,1902,28,30-34,1930,52
SIM,1922,20,na,1942,4563
STAT,1891,47,50-100,1938,0.17415854681772003
STAT,1767,90,na,1857,19.082317692852
STAT,1884,23,15-19,1907,3.3193589823262593
SIM,1880,30,30-34,1910,19
STAT,1936,19,50-100,1955,0.36388490662442136
STAT,1908,26,15-19,1934,0.6886479015046121
STAT,1919,29,45-49,1948,1.891266282914598
STAT,1949,19,30-34,1968,14.453129497434169
STAT,1838,34,25-29,1872,9.159344966711929
STAT,1838,96,na,1934,6.309065107395312
STAT,1847,43,50-100,1890,0.8178837305378895
STAT,1845,15,50-100,1860,0.048957158734734704
STAT,1882,22,50-100,1904,0.4052934376665219
STAT,1877,25,na,1902,2542.2781671977477
STAT,1935,37,30-34,1972,2.598998777955397
SIM,1890,31,na,1921,3148
SIM,1892,23,15-19,1915,6
STAT,1880,17,50-100,1897,0.0525207447524341
STAT,1872,30,30-34,1902,17.99482433047997
STAT,1909,49,40-44,1958,0.14688745416846588
STAT,1781,88,na,1869,42.273097965877945
SIM,1915,36,25-29,1951,6
STAT,1852,26,na,1878,2044.51393283085
STAT,1928,4,na,1932,5187.520045629546
SIM,1848,21,30-34,1869,21
STAT,1842,71,na,1913,1046.7567899111366
STAT,1848,33,40-44,1881,3.5405014575890648
SIM,1832,29,15-19,1861,3
STAT,1898,29,15-19,1927,0.6214329677269502
STAT,1909,23,30-34,1932,27.158977771078717
STAT,1874,42,na,1916,2404.3353897381207
STAT,1894,46,30-34,1940,0.07185482567305962
SIM,1914,22,50-100,1936,1
SIM,1849,37,30-34,1886,5
STAT,1912,29,45-49,1941,1.7243399666735468
SIM,1872,50,na,1922,2290
SIM,1894,36,30-34,1930,8
STAT,1858,29,50-100,1887,0.522198542479032
SIM,1920,29,45-49,1949,5
STAT,1892,40,40-44,1932,2.9048566085774383
STAT,1917,23,na,1940,3948.477606291404
STAT,1844,24,25-29,1868,54.594198277382844
STAT,1876,37,15-19,1913,0.05915486542606479
STAT,1819,45,30-34,1864,0.19743664839183578
SIM,1852,24,25-29,1876,60
STAT,1858,51,45-49,1909,0.011796828835340794
STAT,1896,32,50-100,1928,1.2345066041496797
SIM,1846,34,25-29,1880,7
STAT,1837,59,na,1896,1295.7591524115646
STAT,1787,89,na,1876,44.336380004628424
STAT,1837,53,35-39,1890,0.005647874663876851
SIM,1856,33,40-44,1889,1
STAT,1873,25,na,1898,2485.0061553546584
STAT,1809,46,15-19,1855,0.0018092016065680767
STAT,1886,36,30-34,1922,5.782641436005661
STAT,1822,32,25-29,1854,32.2672963632004
STAT,1906,22,50-100,1928,0.6055058526323102
SIM,1900,15,15-19,1915,7
STAT,1882,52,35-39,1934,0.008510794615344305
SIM,1927,29,45-49,1956,7
SIM,1807,70,na,1877,636
SIM,1902,61,na,1963,2827
SIM,1907,26,25-29,1933,76
SIM,1914,20,25-29,1934,97
STAT,1925,20,45-49,1945,1.3822903645397742
SIM,1902,34,25-29,1936,1
STAT,1912,16,30-34,1928,2.520492802309056
STAT,1903,46,35-39,1949,0.11484705791740044
STAT,1862,38,35-39,1900,6.1116602919137275
SIM,1837,25,35-39,1862,1
STAT,1813,46,na,1859,1342.0296916561288
SIM,1888,27,40-44,1915,9
SIM,1854,65,na,1919,1419
STAT,1896,16,35-39,1912,0.7411209016423227
STAT,1857,31,40-44,1888,3.5127620763563567
STAT,1917,21,15-19,1938,5.790921906445904
STAT,1906,47,15-19,1953,3.3346845143857284E-4
STAT,1864,22,35-39,1886,5.378380765757892
SIM,1877,35,50-100,1912,3
STAT,1835,36,15-19,1871,0.0522870670671743
STAT,1882,24,45-49,1906,0.6887131275825664
SIM,1847,33,30-34,1880,13
SIM,1916,21,20-24,1937,95
STAT,1863,50,25-29,1913,0.0032136873130720433
STAT,1801,53,20-24,1854,0.0020372502387211145
STAT,1812,88,na,1900,62.61589804419203
SIM,1870,27,na,1897,2611
SIM,1864,85,na,1949,400
SIM,1862,5,na,1867,2632
STAT,1872,7,na,1879,2790.0739964771083
SIM,1837,83,na,1920,331
STAT,1946,24,45-49,1970,1.2766103557328186
STAT,1951,18,40-44,1969,1.6986163523787112
SIM,1929,35,40-44,1964,2
SIM,1843,31,20-24,1874,3
STAT,1850,21,45-49,1871,0.6341197984854929
STAT,1885,10,na,1895,2636.3788774877285
STAT,1922,44,na,1966,4335.153146945565
STAT,1827,38,50-100,1865,1.554487583004807
STAT,1909,48,45-49,1957,0.20311266026609628
STAT,1908,18,na,1926,3810.346436158258
STAT,1869,95,na,1964,39.93186936893692
SIM,1911,46,35-39,1957,1
STAT,1824,83,na,1907,218.58711828143473
SIM,1916,35,30-34,1951,2
STAT,1829,25,35-39,1854,30.199401495211983
SIM,1895,18,35-39,1913,1
STAT,1857,24,35-39,1881,4.814336460375626
SIM,1925,34,na,1959,4768
SIM,1870,38,35-39,1908,14
STAT,1877,22,45-49,1899,0.7378261684670938
STAT,1909,45,50-100,1954,0.21400196190884233
STAT,1873,18,40-44,1891,0.18867179310065668
SIM,1890,24,45-49,1914,1
STAT,1885,25,25-29,1910,43.345578140721365
SIM,1834,33,20-24,1867,3
STAT,1904,15,50-100,1919,0.07196215219766715
STAT,1882,77,na,1959,997.9573089291329
STAT,1863,30,20-24,1893,2.437189812360378
STAT,1874,21,30-34,1895,18.60860653723167
SIM,1908,55,na,1963,3470
STAT,1835,31,20-24,1866,2.591878369831972
STAT,1899,38,30-34,1937,1.5990229858429157
SIM,1902,39,35-39,1941,5
STAT,1910,59,na,1969,3287.367468633105
SIM,1875,23,15-19,1898,4
SIM,1823,33,45-49,1856,6
STAT,1821,65,na,1886,897.6869896415685
SIM,1825,98,na,1923,1
STAT,1904,38,15-19,1942,0.017633027522036427
SIM,1850,65,na,1915,1230
STAT,1800,70,na,1870,813.4129084238814
STAT,1888,55,na,1943,2493.704332041176
STAT,1821,51,30-34,1872,0.009189247031873314
SIM,1865,24,35-39,1889,7
SIM,1877,16,25-29,1893,11
STAT,1825,31,na,1856,1754.570710535726
STAT,1838,44,50-100,1882,0.8051837681137121
STAT,1893,15,na,1908,3283.690189729695
STAT,1877,42,15-19,1919,0.014593997119037833
SIM,1909,37,30-34,1946,3
SIM,1882,12,na,1894,2523
STAT,1893,24,20-24,1917,88.62456008886384
STAT,1867,23,15-19,1890,3.1498168200086107
STAT,1858,11,na,1869,2266.296211591366
STAT,1793,83,na,1876,146.87560767711713
STAT,1804,54,35-39,1858,0.024240580687962938
STAT,1889,34,40-44,1923,5.418097499491573
STAT,1838,32,35-39,1870,9.246063023637847
STAT,1932,37,15-19,1969,0.026313065784581674
STAT,1908,35,30-34,1943,1.756590182786051
STAT,1809,48,40-44,1857,0.7488341795706293
STAT,1919,42,30-34,1961,0.14138007102923708
SIM,1879,22,20-24,1901,3
STAT,1837,24,50-100,1861,0.35083241838261153
STAT,1887,18,35-39,1905,0.6256043526842368
STAT,1898,20,40-44,1918,2.8918757696814335
STAT,1936,20,20-24,1956,108.5023383218351
STAT,1899,30,35-39,1929,14.260921590285186
STAT,1893,18,na,1911,3259.940761225617
STAT,1894,62,na,1956,2422.9762224864444
SIM,1917,48,45-49,1965,1
STAT,1841,23,45-49,1864,0.6475537543895908
STAT,1799,74,na,1873,450.03429035752185
STAT,1870,45,na,1915,2266.0508294693473
STAT,1833,50,na,1883,1515.9203974496693
STAT,1845,78,na,1923,610.4919208346374
STAT,1867,28,50-100,1895,0.6104971438217152
SIM,1893,25,25-29,1918,67
SIM,1946,8,na,1954,4337
STAT,1908,21,20-24,1929,104.55513087136289
STAT,1911,15,35-39,1926,0.8604908830544096
SIM,1786,76,na,1862,322
SIM,1869,30,na,1899,2420
SIM,1902,34,40-44,1936,2
SIM,1775,91,na,1866,7
STAT,1808,83,na,1891,132.1608019296255
SIM,1832,53,na,1885,1377
STAT,1844,35,na,1879,1967.758938058481
SIM,1932,19,na,1951,5102
STAT,1876,32,20-24,1908,2.847481507973008
SIM,1881,64,na,1945,1602
SIM,1845,13,na,1858,2345
STAT,1867,5,na,1872,2705.4601310694734
SIM,1920,16,30-34,1936,21
STAT,1855,78,na,1933,605.6877674787594
SIM,1942,16,15-19,1958,56
SIM,1933,20,45-49,1953,6
STAT,1793,80,na,1873,277.09012927485514
STAT,1863,97,na,1960,9.807496689314323
STAT,1920,24,25-29,1944,104.13779621521701
SIM,1879,31,35-39,1910,17
SIM,1826,34,25-29,1860,15
SIM,1826,46,na,1872,1562
SIM,1847,26,40-44,1873,2
SIM,1817,48,40-44,1865,1
STAT,1942,26,50-100,1968,1.0663018286944737
SIM,1851,20,na,1871,2047
STAT,1845,19,40-44,1864,0.17850519047556943
SIM,1866,40,40-44,1906,7
STAT,1843,26,30-34,1869,25.19898480132378
STAT,1945,17,na,1962,4102.247800983193
STAT,1876,39,40-44,1915,4.564978501615542
STAT,1867,39,15-19,1906,0.053239722545023016
STAT,1826,40,45-49,1866,1.270900363403575
SIM,1887,58,na,1945,2322
STAT,1784,105,na,1889,0.018090137229147808
SIM,1863,15,35-39,1878,1
SIM,1925,21,15-19,1946,11
STAT,1889,10,na,1899,3264.182811760219
SIM,1846,32,35-39,1878,10
STAT,1867,51,50-100,1918,0.014533588667782236
STAT,1837,40,20-24,1877,0.12818995554520926
STAT,1839,33,30-34,1872,14.675408529026434
SIM,1865,31,40-44,1896,8
STAT,1821,44,25-29,1865,1.044448765400478
SIM,1851,26,30-34,1877,25
SIM,1860,23,20-24,1883,69
SIM,1944,20,20-24,1964,139
STAT,1855,15,35-39,1870,0.511934192489873
SIM,1884,39,40-44,1923,11
STAT,1939,26,45-49,1965,1.772529630369807
STAT,1863,43,35-39,1906,1.607985258361682
STAT,1833,22,40-44,1855,2.1456733359858595
SIM,1838,30,35-39,1868,2
SIM,1855,28,40-44,1883,4
SIM,1916,28,40-44,1944,8
STAT,1852,28,15-19,1880,0.42266034110408973
STAT,1902,36,40-44,1938,1.3658401370594542
STAT,1839,26,40-44,1865,2.6232606966084067
STAT,1893,31,45-49,1924,2.2659838780059487
SIM,1907,28,30-34,1935,3
STAT,1930,28,15-19,1958,0.9150861332565868
SIM,1826,53,na,1879,1418
SIM,1850,37,50-100,1887,2
STAT,1897,21,35-39,1918,7.983839680882286
STAT,1916,16,15-19,1932,9.850082848743725
SIM,1838,44,45-49,1882,3
STAT,1934,25,30-34,1959,53.800660811694165
SIM,1847,83,na,1930,210
STAT,1905,37,20-24,1942,0.2451364828378805
STAT,1931,39,20-24,1970,0.355291264774017
STAT,1866,18,15-19,1884,5.698003915725347
SIM,1834,26,30-34,1860,24
SIM,1933,28,40-44,1961,10
STAT,1856,26,40-44,1882,2.5037430471289848
SIM,1901,29,25-29,1930,67
STAT,1898,32,40-44,1930,5.982727755179226
STAT,1863,17,35-39,1880,0.5600419337232494
STAT,1889,20,15-19,1909,4.1820485985774205
STAT,1897,35,45-49,1932,2.7450132703313184
STAT,1906,24,40-44,1930,3.0747648609721345
STAT,1827,50,na,1877,1572.1320572166042
STAT,1836,41,15-19,1877,0.01035829112343251
STAT,1845,53,25-29,1898,0.0027231051046034682
SIM,1950,18,15-19,1968,49
STAT,1893,17,30-34,1910,2.0627005054238055
STAT,1910,15,50-100,1925,0.07606705531691356
SIM,1951,4,na,1955,5320
STAT,1878,41,20-24,1919,0.16940044551675312
STAT,1905,3,na,1908,3894.9949568305688
SIM,1906,20,na,1926,3454
SIM,1839,41,40-44,1880,6
SIM,1856,50,na,1906,2143
SIM,1816,91,na,1907,17
SIM,1933,18,15-19,1951,58
SIM,1868,78,na,1946,756
STAT,1835,38,40-44,1873,3.992238553281715
STAT,1948,17,20-24,1965,158.29714679659358
SIM,1843,38,40-44,1881,12
STAT,1865,23,30-34,1888,16.573067771114157
SIM,1910,36,40-44,1946,3
SIM,1869,21,15-19,1890,5
STAT,1821,37,35-39,1858,15.486591766844935
STAT,1846,23,50-100,1869,0.3572350471004574
STAT,1956,4,na,1960,5307.298176553035
STAT,1847,28,40-44,1875,2.7875688942210526
STAT,1861,26,15-19,1887,0.38802145688068895
STAT,1831,65,na,1896,1138.732550700173
STAT,1879,33,35-39,1912,10.753475509461207
SIM,1835,98,na,1933,3
SIM,1873,37,50-100,1910,2
STAT,1941,21,na,1962,3851.3782907471314
SIM,1829,32,35-39,1861,15
SIM,1928,34,45-49,1962,1
STAT,1920,29,35-39,1949,16.686955495311974
SIM,1860,28,15-19,1888,3
SIM,1867,38,na,1905,2166
STAT,1849,50,40-44,1899,0.008290704697337205
STAT,1813,52,35-39,1865,0.020662016455678486
SIM,1924,16,15-19,1940,57
SIM,1786,69,na,1855,682
STAT,1914,39,20-24,1953,0.2658357346448473
STAT,1926,26,35-39,1952,18.423557314953552
SIM,1897,20,15-19,1917,5
SIM,1867,35,25-29,1902,6
SIM,1859,32,45-49,1891,1
STAT,1859,37,50-100,1896,1.0002604002571422
SIM,1856,60,na,1916,1896
STAT,1812,98,na,1910,1.4816798080728948
STAT,1880,43,35-39,1923,1.9272228676393715
SIM,1890,5,na,1895,3445
STAT,1916,28,15-19,1944,0.7422591786203792
STAT,1868,44,15-19,1912,0.013274218402672858
SIM,1942,25,30-34,1967,69
STAT,1863,53,50-100,1916,0.013291783955860276
SIM,1864,26,40-44,1890,4
STAT,1925,28,40-44,1953,5.596924778733231
SIM,1829,38,40-44,1867,9
STAT,1849,75,na,1924,799.2337324772215
STAT,1911,17,25-29,1928,8.845519727758012
SIM,1907,23,20-24,1930,113
STAT,1882,16,40-44,1898,0.18222957367373988
SIM,1875,26,na,1901,2386
SIM,1907,15,na,1922,3871
STAT,1884,27,30-34,1911,25.41565358324646
STAT,1898,25,35-39,1923,13.401510183058576
SIM,1873,23,30-34,1896,29
SIM,1924,23,20-24,1947,127
SIM,1860,30,45-49,1890,2
STAT,1826,33,20-24,1859,2.7636659181918604
STAT,1900,45,20-24,1945,0.00966644424603882
STAT,1930,41,35-39,1971,0.27061296451994804
STAT,1934,35,50-100,1969,0.5918827811838754
STAT,1781,95,na,1876,2.3805584107786872
STAT,1837,27,35-39,1864,8.257162970911185
SIM,1864,20,35-39,1884,11
SIM,1887,33,35-39,1920,22
STAT,1918,44,50-100,1962,0.12704034616469936
STAT,1858,52,50-100,1910,0.012153196218474223
STAT,1863,63,na,1926,1595.974007627056
STAT,1909,45,25-29,1954,0.050189384849310376
STAT,1928,32,na,1960,4823.716649212173
SIM,1938,21,25-29,1959,146
STAT,1851,31,50-100,1882,0.7949879065611878
STAT,1931,27,20-24,1958,24.03461097946539
STAT,1935,15,20-24,1950,189.88799104261918
SIM,1917,45,40-44,1962,1
SIM,1947,19,20-24,1966,2
SIM,1895,40,na,1935,3259
STAT,1939,19,20-24,1958,138.34674363597463
SIM,1850,20,40-44,1870,2
SIM,1829,33,50-100,1862,4
STAT,1854,54,50-100,1908,0.011241095316330059
SIM,1879,23,na,1902,2899
STAT,1847,21,20-24,1868,66.35503135256853
SIM,1915,34,na,1949,4213
SIM,1875,34,20-24,1909,3
STAT,1831,54,45-49,1885,0.010035192573956788
SIM,1862,50,na,1912,1973
SIM,1942,18,40-44,1960,4
SIM,1918,30,20-24,1948,3
STAT,1854,53,35-39,1907,0.006483190009026452
STAT,1919,49,15-19,1968,4.0533739601528266E-4
STAT,1867,34,20-24,1901,2.5666407556582076
SIM,1825,36,30-34,1861,4
SIM,1839,34,35-39,1873,3
STAT,1826,38,15-19,1864,0.04885708536006485
STAT,1828,76,na,1904,521.7036805651217
SIM,1871,43,35-39,1914,2
STAT,1877,49,35-39,1926,0.14503915128306027
STAT,1916,23,20-24,1939,118.53593649738148
STAT,1847,44,45-49,1891,1.151345835893924
STAT,1942,18,15-19,1960,48.371893483464916
SIM,1838,21,20-24,1859,2
SIM,1938,29,20-24,1967,22
STAT,1852,30,45-49,1882,1.4850523063002945
STAT,1894,49,35-39,1943,0.10146437469216059
STAT,1893,29,15-19,1922,0.5829610126909713
STAT,1925,18,15-19,1943,55.78630550716084
STAT,1897,43,50-100,1940,0.09934583244443614
STAT,1934,18,40-44,1952,1.9243081197228695
SIM,1828,46,50-100,1874,2
STAT,1883,15,na,1898,2539.790106553068
SIM,1864,27,na,1891,2151
SIM,1914,24,40-44,1938,4
STAT,1841,49,20-24,1890,0.00867523744242773
STAT,1892,30,na,1922,3075.571103870845
STAT,1900,29,50-100,1929,0.8980283062257184
STAT,1842,20,40-44,1862,2.0910420750765275
STAT,1880,50,25-29,1930,0.003851709241106659
STAT,1926,45,25-29,1971,0.06708530049465064
STAT,1874,36,50-100,1910,1.2849248182485278
STAT,1846,17,35-39,1863,0.4929259254773674
STAT,1862,42,20-24,1904,0.13774344822616574
SIM,1855,44,45-49,1899,1
STAT,1861,21,20-24,1882,60.110785783986024
SIM,1896,29,40-44,1925,6
STAT,1843,38,15-19,1881,0.04766078845419058
STAT,1888,29,40-44,1917,3.5868898608820414
STAT,1911,24,15-19,1935,5.117397210884007
SIM,1889,32,40-44,1921,12
STAT,1852,38,40-44,1890,3.509031881967262
SIM,1844,65,na,1909,1320
STAT,1921,21,50-100,1942,0.7606743697846151
SIM,1878,21,25-29,1899,92
SIM,1967,2,na,1969,5238
SIM,1860,38,40-44,1898,8
STAT,1857,63,na,1920,1421.588902159129
STAT,1865,16,40-44,1881,0.1755465311621853
STAT,1920,24,40-44,1944,3.7907405295008503
SIM,1875,27,30-34,1902,50
SIM,1916,24,25-29,1940,114
STAT,1882,21,40-44,1903,2.07730199480359
SIM,1897,11,na,1908,3499
STAT,1835,34,25-29,1869,9.520083256136179
STAT,1885,27,15-19,1912,0.4617688240319805
SIM,1816,84,na,1900,120
STAT,1917,36,35-39,1953,2.576096358520684
STAT,1934,21,15-19,1955,7.297787309704799
SIM,1834,22,15-19,1856,3
STAT,1816,48,50-100,1864,0.4969382161559915
SIM,1870,35,30-34,1905,14
SIM,1944,1,na,1945,4453
STAT,1926,35,15-19,1961,0.0239835608903002
STAT,1869,54,25-29,1923,0.0033926253044819664
STAT,1885,22,20-24,1907,70.13767496762749
SIM,1817,79,na,1896,312
STAT,1839,22,25-29,1861,50.76279029348687
SIM,1908,33,30-34,1941,20
STAT,1836,64,na,1900,1082.0143923714286
STAT,1927,30,20-24,1957,3.064159212947191
SIM,1855,21,20-24,1876,89
SIM,1908,38,25-29,1946,1
STAT,1821,41,20-24,1862,0.2846273988060373
STAT,1921,34,35-39,1955,10.288587588708861
SIM,1865,21,30-34,1886,24
SIM,1901,32,50-100,1933,1
SIM,1857,50,40-44,1907,1
STAT,1865,33,40-44,1898,3.998433182840186
STAT,1867,56,na,1923,1953.4221723535761
SIM,1851,33,20-24,1884,2
SIM,1890,21,40-44,1911,4
STAT,1834,53,50-100,1887,0.01021681527671673
SIM,1806,91,na,1897,28
SIM,1920,22,25-29,1942,131
STAT,1848,54,50-100,1902,0.011417028667811243
SIM,1843,34,25-29,1877,17
SIM,1893,27,15-19,1920,1
STAT,1857,34,45-49,1891,1.3774411431931612
SIM,1929,38,45-49,1967,3
SIM,1942,21,15-19,1963,12
STAT,1810,105,na,1915,0.012500379418636175
STAT,1901,45,na,1946,3242.176779730801
STAT,1949,22,20-24,1971,132.37579558994125
SIM,1865,41,35-39,1906,5
SIM,1847,45,na,1892,1554
SIM,1928,24,35-39,1952,15
SIM,1892,27,30-34,1919,5
STAT,1818,83,na,1901,202.31124215750972
STAT,1901,19,40-44,1920,0.2595264024471255
SIM,1875,41,45-49,1916,1
STAT,1818,36,15-19,1854,0.235741922709165
SIM,1947,23,40-44,1970,6
STAT,1851,28,30-34,1879,24.15057446533584
STAT,1898,22,30-34,1920,24.572978354605507
SIM,1885,26,na,1911,2399
STAT,1923,47,15-19,1970,4.3967958798667384E-4
STAT,1860,30,50-100,1890,0.7644855488194743
SIM,1935,30,20-24,1965,5
STAT,1799,67,na,1866,735.328111270926
STAT,1894,58,na,1952,2595.0394276478223
STAT,1923,29,50-100,1952,1.1576418934641473
STAT,1771,95,na,1866,2.228780602065475
STAT,1909,45,40-44,1954,0.14917400613009085
STAT,1812,51,na,1863,1319.8116983715458
STAT,1881,28,50-100,1909,0.6286933300227335
SIM,1824,48,50-100,1872,1
STAT,1856,20,35-39,1876,5.506121075677185
SIM,1869,26,na,1895,2357
STAT,1867,41,45-49,1908,1.4398654599426859
SIM,1848,31,na,1879,2008
STAT,1804,69,na,1873,713.6021082724124
SIM,1859,30,na,1889,2321
SIM,1915,38,50-100,1953,1
STAT,1907,38,50-100,1945,0.39496747967636925
STAT,1880,45,na,1925,2435.941501587826
SIM,1874,78,na,1952,741
SIM,1785,91,na,1876,7
SIM,1839,31,30-34,1870,20
SIM,1866,12,na,1878,2702
SIM,1931,29,50-100,1960,1
SIM,1875,29,20-24,1904,1
STAT,1949,1,na,1950,4860.134871677152
SIM,1934,28,25-29,1962,137
STAT,1935,35,40-44,1970,2.1384118853524727
SIM,1933,18,30-34,1951,20
STAT,1834,35,na,1869,1827.8503826890988
STAT,1887,15,30-34,1902,1.8304706807005386
SIM,1917,25,20-24,1942,29
SIM,1937,18,na,1955,4239
STAT,1911,35,50-100,1946,0.4175781809239035
STAT,1903,26,30-34,1929,36.64322077497074
STAT,1783,80,na,1863,258.2246954486101
SIM,1836,46,na,1882,1770
STAT,1943,26,35-39,1969,16.320744524634012
SIM,1882,22,45-49,1904,1
STAT,1804,51,30-34,1855,0.01782020926516091
STAT,1856,21,50-100,1877,0.38201172370239916
STAT,1861,78,na,1939,658.6386560806611
STAT,1939,23,40-44,1962,3.4435959030245384
STAT,1871,42,30-34,1913,1.1603377394923486
STAT,1877,53,20-24,1930,7.682458500698819E-4
SIM,1865,34,45-49,1899,4
STAT,1853,49,na,1902,1847.1000928920562
SIM,1879,42,40-44,1921,6
STAT,1786,94,na,1880,3.550218381481618
STAT,1843,33,20-24,1876,2.596212065147255
STAT,1925,18,30-34,1943,14.982783221505992
STAT,1854,40,20-24,1894,0.12277475333742886
STAT,1908,31,15-19,1939,0.12419553334438128
STAT,1932,17,45-49,1949,0.6745779256887701
SIM,1833,32,na,1865,1904
SIM,1847,22,25-29,1869,67
STAT,1908,24,25-29,1932,86.05043705068034
STAT,1876,35,25-29,1911,3.0618359715746717
STAT,1895,44,25-29,1939,0.05855221512280259
STAT,1841,20,40-44,1861,1.9773750430524382
STAT,1885,44,15-19,1929,0.013865630865443436
STAT,1927,27,50-100,1954,1.2343526251745462
SIM,1935,27,50-100,1962,2
STAT,1908,28,40-44,1936,4.477281836849562
STAT,1865,37,50-100,1902,1.1367704989216063
STAT,1911,38,40-44,1949,1.4675479614015634
SIM,1891,31,35-39,1922,18
STAT,1874,24,35-39,1898,6.039964015813625
SIM,1874,85,na,1959,331
STAT,1776,115,na,1891,1.1425464524119846E-4
STAT,1844,26,15-19,1870,0.4335049358315377
STAT,1835,24,na,1859,2087.1319745155984
SIM,1905,3,na,1908,3813
STAT,1862,31,15-19,1893,0.12417220949504373
SIM,1940,17,45-49,1957,1
STAT,1836,37,50-100,1873,0.938068288712263
STAT,1872,52,40-44,1924,0.010706479879113325
STAT,1891,44,na,1935,2879.68880488802
STAT,1809,68,na,1877,947.6696832451717
STAT,1849,34,na,1883,1912.0933579605487
SIM,1871,30,20-24,1901,3
STAT,1886,29,na,1915,2558.578395853239
STAT,1821,34,30-34,1855,47.277006436241486
STAT,1909,25,20-24,1934,18.06450501540168
SIM,1829,64,na,1893,943
SIM,1801,92,na,1893,9
SIM,1889,77,na,1966,1586
STAT,1924,18,na,1942,4460.221217191906
SIM,1884,35,25-29,1919,4
SIM,1770,92,na,1862,4
SIM,1906,25,45-49,1931,2
STAT,1885,26,50-100,1911,0.6532996328488057
SIM,1824,40,35-39,1864,4
STAT,1876,77,na,1953,910.5760865062714
SIM,1834,40,45-49,1874,4
SIM,1895,15,30-34,1910,4
STAT,1853,12,na,1865,2407.909283014671
SIM,1826,31,20-24,1857,1
STAT,1885,48,30-34,1933,0.09728306777457973
SIM,1893,26,50-100,1919,2
SIM,1893,22,20-24,1915,94
SIM,1874,18,15-19,1892,2
STAT,1864,28,40-44,1892,2.707658403612287
SIM,1870,45,25-29,1915,1
STAT,1867,63,na,1930,1708.8847568031572
SIM,1851,13,na,1864,2315
STAT,1825,38,30-34,1863,7.898967912779549
STAT,1883,31,35-39,1914,10.178268605745107
STAT,1865,20,50-100,1885,0.3877115793970677
SIM,1821,47,na,1868,1415
SIM,1939,17,20-24,1956,134
SIM,1901,24,30-34,1925,37
STAT,1913,28,15-19,1941,0.7150735122813628
STAT,1898,35,45-49,1933,2.7762376328684613
STAT,1846,64,na,1910,1243.1379366993856
SIM,1936,19,45-49,1955,4
SIM,1842,46,na,1888,1652
STAT,1788,68,na,1856,771.2839743600001
SIM,1872,12,na,1884,2756
SIM,1911,29,35-39,1940,21
STAT,1858,47,25-29,1905,0.04638159518517729
SIM,1901,27,na,1928,3556
STAT,1863,40,30-34,1903,1.0386988789438545
STAT,1924,15,45-49,1939,0.6097371268067944
STAT,1927,40,15-19,1967,0.0019700942733330757
SIM,1921,41,na,1962,4911
SIM,1933,22,na,1955,5164
STAT,1930,21,30-34,1951,37.66603196039879
SIM,1903,56,na,1959,2930
SIM,1834,28,20-24,1862,9
STAT,1920,27,45-49,1947,1.9339921748699451
STAT,1939,17,na,1956,3758.514788373306
STAT,1832,39,50-100,1871,1.0202830943779018
STAT,1773,102,na,1875,0.08258257308381992
SIM,1888,34,30-34,1922,27
SIM,1900,42,na,1942,3285
SIM,1932,15,45-49,1947,1
SIM,1850,72,na,1922,766
STAT,1888,62,na,1950,2204.2806772847457
STAT,1892,29,30-34,1921,31.966501988466593
SIM,1858,38,50-100,1896,4
SIM,1840,39,50-100,1879,1
STAT,1828,53,25-29,1881,0.002386849971645161
STAT,1898,14,na,1912,3551.172883257199
SIM,1854,27,na,1881,2114
STAT,1850,22,40-44,1872,1.8813370352066447
SIM,1871,40,30-34,1911,3
STAT,1880,54,40-44,1934,0.010975595776548826
STAT,1899,45,20-24,1944,0.009550360474261634
STAT,1819,68,na,1887,932.165031719393
SIM,1921,0,na,1921,5435
STAT,1862,45,25-29,1907,0.05051851778920454
SIM,1925,16,15-19,1941,76
STAT,1906,27,45-49,1933,1.6486288640715094
STAT,1889,33,45-49,1922,2.1881931180509158
SIM,1838,41,40-44,1879,5
STAT,1859,37,na,1896,1919.4498521377338
STAT,1955,16,35-39,1971,5.683099378143709
SIM,1769,91,na,1860,31
STAT,1897,32,40-44,1929,5.915439977585153
SIM,1845,9,na,1854,2393
SIM,1833,38,30-34,1871,11
SIM,1864,21,50-100,1885,1
SIM,1847,43,40-44,1890,3
STAT,1877,46,30-34,1923,0.10271351854118331
STAT,1918,18,na,1936,4077.6160687522624
STAT,1944,27,30-34,1971,43.20664737990666
SIM,1841,19,15-19,1860,5
STAT,1868,48,na,1916,2164.626683886565
SIM,1821,42,25-29,1863,1
STAT,1869,16,25-29,1885,5.692020525564552
STAT,1873,63,na,1936,1845.41592313874
STAT,1875,40,40-44,1915,2.378778729740196
STAT,1916,26,25-29,1942,69.68809096820092
SIM,1916,26,na,1942,4101
SIM,1890,41,na,1931,3026
STAT,1928,19,45-49,1947,0.6385926134037921
STAT,1844,43,15-19,1887,0.010820492171626523
STAT,1885,44,na,1929,2320.578768120443
STAT,1917,16,15-19,1933,9.990720272425602
STAT,1926,28,25-29,1954,80.21029490281404
SIM,1839,44,45-49,1883,4
SIM,1896,20,30-34,1916,45
STAT,1830,49,45-49,1879,0.1908423511398268
STAT,1858,37,30-34,1895,4.311669303505285
SIM,1934,23,30-34,1957,49
STAT,1888,25,25-29,1913,51.36247992083709
STAT,1870,37,30-34,1907,5.314989117020238
SIM,1850,30,35-39,1880,18
SIM,1906,18,20-24,1924,37
STAT,1842,23,45-49,1865,0.6847776050678601
SIM,1861,15,50-100,1876,1
STAT,1794,68,na,1862,745.7945366325198
SIM,1929,22,45-49,1951,5
SIM,1897,33,45-49,1930,8
STAT,1884,37,25-29,1921,2.905923651891006
SIM,1911,39,45-49,1950,1
SIM,1914,27,45-49,1941,3
STAT,1913,30,na,1943,3869.5854105426524
STAT,1861,24,25-29,1885,48.86615743548076
SIM,1838,31,na,1869,1809
STAT,1813,42,25-29,1855,2.3372643038423426
STAT,1839,43,40-44,1882,1.6152562925609606
SIM,1926,37,30-34,1963,7
STAT,1852,64,na,1916,1400.4243858594405
STAT,1831,102,na,1933,0.1975475196660107
STAT,1857,21,30-34,1878,16.50161673385653
STAT,1904,31,30-34,1935,25.631576720267176
STAT,1826,28,20-24,1854,33.70976772560454
STAT,1837,49,na,1886,1517.714554511844
SIM,1892,37,25-29,1929,6
SIM,1924,26,25-29,1950,117
SIM,1832,22,30-34,1854,22
STAT,1938,32,na,1970,3879.27665027372
STAT,1880,33,25-29,1913,10.93403796723207
STAT,1821,54,35-39,1875,0.01251849097155515
STAT,1912,22,25-29,1934,90.30454096240005
SIM,1829,34,25-29,1863,8
STAT,1903,39,45-49,1942,0.6176919060047051
SIM,1804,99,na,1903,4
SIM,1807,80,na,1887,113
STAT,1926,23,30-34,1949,35.51096297647249
STAT,1952,18,25-29,1970,52.958838490544025
STAT,1911,28,30-34,1939,38.83981067527205
STAT,1833,21,45-49,1854,0.9147790854324392
SIM,1850,23,45-49,1873,1
SIM,1896,25,25-29,1921,65
STAT,1856,29,45-49,1885,0.9081639970855283
STAT,1917,47,40-44,1964,0.16805438147444857
STAT,1842,30,35-39,1872,9.795081592912776
STAT,1850,90,na,1940,59.304255397433735
SIM,1860,27,na,1887,2065
STAT,1947,25,40-44,1972,5.384775175433991
STAT,1893,19,20-24,1912,22.820275924440065
SIM,1864,31,40-44,1895,5
SIM,1915,41,na,1956,4181
SIM,1865,71,na,1936,1115
SIM,1837,20,25-29,1857,80
STAT,1843,49,na,1892,1778.3141199393315
STAT,1918,37,30-34,1955,1.9603694566538377
STAT,1836,52,20-24,1888,4.64767120040991E-4
STAT,1935,32,20-24,1967,3.441383563371436
SIM,1887,16,35-39,1903,1
SIM,1912,31,30-34,1943,16
STAT,1882,30,na,1912,2390.763311376109
STAT,1900,48,25-29,1948,0.04536366972713962
SIM,1912,39,na,1951,3780
STAT,1911,38,35-39,1949,2.3711809970943847
SIM,1837,30,20-24,1867,4
STAT,1861,39,40-44,1900,3.6529566725078446
SIM,1928,21,30-34,1949,1
SIM,1928,32,40-44,1960,7
STAT,1859,31,15-19,1890,0.11649580066148467
SIM,1926,24,30-34,1950,61
STAT,1904,40,35-39,1944,0.18570495317029032
SIM,1818,36,25-29,1854,5
STAT,1870,29,35-39,1899,9.55374248137249
SIM,1865,39,20-24,1904,4
STAT,1883,40,na,1923,2336.8148757565336
STAT,1896,21,20-24,1917,93.12980692021961
SIM,1915,49,25-29,1964,1
SIM,1931,17,20-24,1948,179
STAT,1868,26,15-19,1894,0.44359001931602
STAT,1854,99,na,1953,1.449479873363722
SIM,1883,19,15-19,1902,8
SIM,1909,27,35-39,1936,1
STAT,1902,43,35-39,1945,0.17959799869442702
STAT,1866,20,50-100,1886,0.3924673161872359
STAT,1879,35,na,1914,2536.1677312252214
STAT,1866,29,15-19,1895,0.4238692808910404
STAT,1923,17,20-24,1940,162.4305603416092
STAT,1900,35,25-29,1935,4.109703259933028
STAT,1940,26,na,1966,3898.8545530108768
SIM,1880,29,45-49,1909,2
SIM,1852,20,45-49,1872,1
SIM,1885,27,25-29,1912,60
STAT,1877,27,25-29,1904,44.75853967542246
STAT,1908,17,25-29,1925,8.571771525018281
STAT,1932,40,40-44,1972,0.3466787245958125
SIM,1856,35,na,1891,2312
SIM,1961,8,na,1969,5328
STAT,1928,40,20-24,1968,0.023028159325553233
SIM,1835,33,20-24,1868,4
STAT,1941,22,35-39,1963,9.927244818715891
STAT,1873,50,35-39,1923,0.009031868887408196
SIM,1852,45,na,1897,1915
STAT,1944,16,na,1960,4042.439181459174
STAT,1877,8,na,1885,2819.2641301461167
STAT,1859,47,30-34,1906,0.07849673857545068
STAT,1891,23,40-44,1914,2.6237138617396614
STAT,1894,24,20-24,1918,89.86213298630578
STAT,1912,17,45-49,1929,0.10304578212118325
SIM,1890,62,na,1952,2355
SIM,1926,35,40-44,1961,3
SIM,1910,32,25-29,1942,7
STAT,1910,28,50-100,1938,0.9768507880183481
STAT,1920,0,na,1920,5158.101713043653
STAT,1936,17,30-34,1953,11.90222053783664
STAT,1913,35,35-39,1948,2.458216436272553
STAT,1921,34,50-100,1955,0.9308592059599353
SIM,1877,80,na,1957,654
STAT,1866,84,na,1950,313.02614499384094
SIM,1882,67,na,1949,1399
SIM,1907,52,na,1959,3381
SIM,1928,38,na,1966,5012
STAT,1930,32,30-34,1962,20.737494188726817
SIM,1869,44,30-34,1913,2
SIM,1921,46,45-49,1967,1
STAT,1868,34,20-24,1902,2.6112228792981793
STAT,1860,52,20-24,1912,6.075348660395951E-4
STAT,1845,23,na,1868,2059.0753573700495
STAT,1765,92,na,1857,3.639561484767839
SIM,1853,26,50-100,1879,1
STAT,1929,27,40-44,1956,5.949750556291546
SIM,1828,39,50-100,1867,2
STAT,1824,32,40-44,1856,8.690441558500918
SIM,1864,30,na,1894,2203
SIM,1832,32,40-44,1864,6
SIM,1937,27,40-44,1964,5
STAT,1902,32,25-29,1934,14.735476639102172
STAT,1913,46,45-49,1959,0.21694726945618856
STAT,1864,21,50-100,1885,0.3785658593524312
STAT,1902,45,30-34,1947,0.07933789350633158
SIM,1871,20,25-29,1891,98
SIM,1891,29,20-24,1920,19
SIM,1898,42,na,1940,3548
STAT,1937,33,25-29,1970,9.321543828223765
STAT,1829,76,na,1905,630.102862933261
STAT,1930,30,35-39,1960,12.041860720044054
STAT,1918,35,40-44,1953,1.6254613262074824
SIM,1944,17,30-34,1961,17
STAT,1833,81,na,1914,355.117727020303
SIM,1935,17,35-39,1952,5
STAT,1876,20,35-39,1896,6.183944266227056
STAT,1822,35,40-44,1857,9.065069079483713
SIM,1872,8,na,1880,2834
SIM,1889,21,25-29,1910,83
SIM,1937,25,45-49,1962,1
SIM,1853,86,na,1939,186
STAT,1895,25,50-100,1920,0.8572140034476168
STAT,1885,21,45-49,1906,0.7118618136868387
SIM,1924,24,na,1948,4296
SIM,1848,20,25-29,1868,61
SIM,1905,27,20-24,1932,21
STAT,1904,42,30-34,1946,0.11658078738560639
STAT,1918,24,30-34,1942,31.434925876541442
SIM,1921,35,35-39,1956,5
STAT,1924,46,20-24,1970,0.013456349422421873
STAT,1851,44,50-100,1895,0.8598263245077884
STAT,1827,33,20-24,1860,3.9721530615995384
SIM,1835,20,15-19,1855,3
SIM,1830,35,40-44,1865,1
STAT,1877,15,30-34,1892,1.6942863844992533
STAT,1900,48,30-34,1948,0.07623616791508507
STAT,1807,103,na,1910,0.060649921605177556
STAT,1829,30,20-24,1859,2.638852496421394
SIM,1878,22,na,1900,2786
STAT,1863,20,25-29,1883,52.981954667154874
SIM,1910,45,30-34,1955,1
SIM,1924,27,30-34,1951,4
STAT,1862,94,na,1956,19.91668522630031
STAT,1863,33,30-34,1896,15.5509710929352
SIM,1920,34,na,1954,4008
STAT,1907,49,25-29,1956,0.047908127862226965
STAT,1872,29,45-49,1901,1.1270932988578053
SIM,1885,16,15-19,1901,10
STAT,1915,43,45-49,1958,0.17071274275368534
SIM,1869,31,25-29,1900,4
STAT,1887,30,na,1917,2749.7988581686272
STAT,1811,49,25-29,1860,0.1544953835373732
STAT,1837,71,na,1908,889.9470121952878
STAT,1932,40,50-100,1972,0.1628299145931901
STAT,1846,36,35-39,1882,5.337105208103698
SIM,1887,24,25-29,1911,100
STAT,1880,48,35-39,1928,0.148198333487606
STAT,1820,38,40-44,1858,10.063097876488046
STAT,1917,40,45-49,1957,0.17773495963601446
SIM,1903,62,na,1965,2792
STAT,1907,38,15-19,1945,0.018065042933741164
STAT,1865,30,30-34,1895,16.295946364316812
STAT,1915,32,35-39,1947,9.49736620019416
SIM,1907,24,20-24,1931,106
STAT,1821,108,na,1929,9.652070614215895E-4
SIM,1880,23,30-34,1903,26
SIM,1916,29,na,1945,3878
STAT,1806,49,50-100,1855,0.8281427157678077
SIM,1900,29,40-44,1929,7
STAT,1909,46,25-29,1955,0.049835047792274254
STAT,1830,54,30-34,1884,0.00417539639633564
SIM,1888,44,40-44,1932,9
SIM,1923,32,35-39,1955,3
STAT,1916,27,30-34,1943,41.3432173097168
STAT,1926,43,20-24,1969,0.022175356321134165
STAT,1849,13,na,1862,2270.977808022994
SIM,1915,38,15-19,1953,1
STAT,1879,24,25-29,1903,60.66199731633799
SIM,1882,36,50-100,1918,2
STAT,1828,51,na,1879,1295.9336924475103
SIM,1911,24,40-44,1935,6
SIM,1837,36,35-39,1873,13
STAT,1891,75,na,1966,1643.8702177937519
STAT,1890,10,na,1900,3231.0091046328944
SIM,1916,19,20-24,1935,130
STAT,1878,47,40-44,1925,0.18094312496547593
STAT,1830,41,25-29,1871,0.5619079675463449
STAT,1895,47,40-44,1942,0.1279378876395152
STAT,1896,27,35-39,1923,13.000516997013825
STAT,1891,51,na,1942,2732.5327582500495
STAT,1925,37,na,1962,4606.89525331221
SIM,1823,48,na,1871,1466
STAT,1922,36,15-19,1958,0.022316101127689194
STAT,1806,48,na,1854,1287.596745904628
STAT,1895,65,na,1960,2376.247184140533
STAT,1914,16,40-44,1930,0.29593010873518966
STAT,1924,33,15-19,1957,0.15286473054831107
STAT,1807,89,na,1896,44.395965192859386
STAT,1850,53,na,1903,1593.6183527960288
STAT,1942,17,30-34,1959,12.995619270956794
STAT,1946,22,40-44,1968,3.817495275603607
STAT,1810,53,na,1863,1134.6724500511186
STAT,1835,46,30-34,1881,0.07703457269259618
STAT,1917,43,25-29,1960,0.07592873159802492
STAT,1944,28,45-49,1972,1.9041235644656949
STAT,1844,20,15-19,1864,3.238230078754607
SIM,1950,17,30-34,1967,23
SIM,1919,3,na,1922,4620
STAT,1929,27,na,1956,4781.903609026838
STAT,1842,37,50-100,1879,1.1294388374403954
STAT,1808,105,na,1913,0.009761134353852978
STAT,1873,78,na,1951,808.093024137017
SIM,1852,39,35-39,1891,11
SIM,1874,32,na,1906,2403
STAT,1828,35,na,1863,1560.9258442232715
SIM,1910,44,50-100,1954,1
SIM,1849,15,20-24,1864,19
SIM,1886,47,40-44,1933,2
SIM,1859,48,50-100,1907,1
STAT,1858,73,na,1931,960.9010103841969
STAT,1903,24,40-44,1927,3.002948519588253
STAT,1914,4,na,1918,4245.923458063482
STAT,1875,17,50-100,1892,0.05129501900938384
STAT,1944,17,35-39,1961,4.607178248660556
STAT,1899,71,na,1970,2257.7535534300655
STAT,1952,20,15-19,1972,6.533421560179374
STAT,1853,109,na,1962,0.0024158438492071304
SIM,1922,16,40-44,1938,5
STAT,1891,46,15-19,1937,2.857832622502469E-4
STAT,1885,37,30-34,1922,5.424331251126195
STAT,1927,17,35-39,1944,5.322149368112648
SIM,1858,41,45-49,1899,7
STAT,1892,20,50-100,1912,0.5244961560235368
SIM,1879,63,na,1942,2156
STAT,1844,39,35-39,1883,5.672750779133878
SIM,1935,28,45-49,1963,2
SIM,1799,89,na,1888,59
SIM,1957,11,na,1968,5607
STAT,1848,30,30-34,1878,16.15951607680097
STAT,1838,23,25-29,1861,54.17845644205434
STAT,1851,18,15-19,1869,5.917708707258095
SIM,1866,15,20-24,1881,23
STAT,1774,85,na,1859,58.672474728319955
STAT,1818,46,30-34,1864,0.22330173233119452
SIM,1832,25,na,1857,1951
SIM,1836,39,na,1875,1934
STAT,1778,99,na,1877,0.22912896019832854
STAT,1924,39,50-100,1963,0.5040350808981336
STAT,1882,15,na,1897,2521.803889721625
STAT,1920,25,25-29,1945,74.18302748684046
STAT,1927,28,45-49,1955,2.134903303965022
SIM,1858,30,35-39,1888,15
SIM,1819,37,50-100,1856,1
SIM,1861,81,na,1942,369
STAT,1841,17,na,1858,2185.9061734945262
STAT,1901,26,50-100,1927,0.915703544103735
SIM,1856,30,30-34,1886,30
SIM,1910,0,na,1910,4221
SIM,1820,83,na,1903,213
STAT,1796,72,na,1868,548.2397216806476
STAT,1878,93,na,1971,134.81045302382722
STAT,1900,32,45-49,1932,2.465676934457984
SIM,1846,23,25-29,1869,81
STAT,1866,6,na,1872,2647.8168497593833
SIM,1783,74,na,1857,390
SIM,1865,95,na,1960,8
SIM,1893,37,30-34,1930,7
STAT,1953,18,45-49,1971,0.6162191352745963
SIM,1873,33,40-44,1906,8
STAT,1903,25,25-29,1928,61.76020342313596
SIM,1936,33,na,1969,3321
SIM,1863,23,25-29,1886,56
STAT,1874,23,35-39,1897,6.0592323747653785
STAT,1840,15,35-39,1855,0.5172990375830142
STAT,1869,33,na,1902,2340.379618415934
SIM,1916,17,25-29,1933,13
SIM,1864,32,50-100,1896,1
SIM,1826,46,30-34,1872,1
STAT,1858,15,20-24,1873,16.953085733115635
SIM,1838,65,na,1903,1029
STAT,1933,28,15-19,1961,0.9554806334548192
STAT,1949,15,15-19,1964,53.87883934628465
STAT,1821,51,25-29,1872,0.005467981652216736
SIM,1928,14,na,1942,5209
SIM,1878,31,20-24,1909,5
STAT,1861,20,45-49,1881,0.6126564665898437
STAT,1820,71,na,1891,735.1474676846742
STAT,1839,40,30-34,1879,0.9428052716257348
STAT,1915,19,na,1934,4102.859571410734
SIM,1931,18,na,1949,4765
STAT,1821,96,na,1917,4.524646883113568
SIM,1911,25,25-29,1936,100
SIM,1841,61,na,1902,1381
STAT,1908,19,20-24,1927,26.673232248596793
SIM,1878,37,35-39,1915,10
STAT,1845,82,na,1927,364.5627557860356
STAT,1933,39,25-29,1972,1.3647733157312765
SIM,1897,31,30-34,1928,34
STAT,1900,21,35-39,1921,8.275986241584574
SIM,1861,23,20-24,1884,66
STAT,1849,96,na,1945,6.666342065252097
STAT,1939,20,50-100,1959,0.6745814114487543
STAT,1804,51,25-29,1855,0.010603760782856908
STAT,1840,38,50-100,1878,1.0341478242933881
STAT,1889,31,30-34,1920,22.091664725590526
STAT,1848,49,20-24,1897,0.009133236226441079
STAT,1844,20,45-49,1864,0.6844714290680265
STAT,1875,45,na,1920,2379.0916564240765
SIM,1861,6,na,1867,3120
STAT,1927,44,na,1971,4735.514599311334
SIM,1894,52,na,1946,2870
STAT,1847,30,na,1877,2025.9766003475102
STAT,1884,19,50-100,1903,0.04918147912310334
SIM,1862,47,na,1909,2018
SIM,1914,46,na,1960,3746
STAT,1876,47,30-34,1923,0.1014965659491654
STAT,1923,40,45-49,1963,0.19902308707494235
SIM,1907,36,na,1943,3594
STAT,1855,23,25-29,1878,51.47076392099766
STAT,1895,40,15-19,1935,0.0185665056382524
STAT,1837,46,40-44,1883,0.12001775938466389
STAT,1871,42,25-29,1913,0.6481165778637081
STAT,1935,7,na,1942,5572.792174498426
SIM,1937,27,50-100,1964,3
SIM,1842,18,15-19,1860,6
STAT,1853,23,20-24,1876,67.78288859628663
SIM,1903,22,na,1925,3383
STAT,1816,66,na,1882,835.1639210388671
SIM,1835,36,25-29,1871,7
SIM,1815,53,na,1868,1282
STAT,1871,52,50-100,1923,0.015180454494326253
STAT,1850,45,15-19,1895,3.038813403360325E-4
STAT,1836,46,na,1882,1484.3930405905405
SIM,1897,34,35-39,1931,8
SIM,1926,27,35-39,1953,37
STAT,1839,35,na,1874,1803.4824550036074
SIM,1874,47,50-100,1921,1
STAT,1838,23,50-100,1861,0.3859414596200644
STAT,1856,107,na,1963,0.01892775162678045
SIM,1854,39,45-49,1893,4
SIM,1862,42,25-29,1904,1
STAT,1840,51,na,1891,1556.8284153835216
STAT,1810,47,50-100,1857,0.7721264297953242
STAT,1894,27,25-29,1921,55.50869478443797
SIM,1785,81,na,1866,145
STAT,1940,19,50-100,1959,0.38781510272661895
STAT,1924,38,15-19,1962,0.023079431460704725
SIM,1899,24,na,1923,3233
STAT,1817,51,na,1868,1336.4977369376013
SIM,1874,88,na,1962,234
SIM,1873,34,50-100,1907,3
STAT,1911,35,30-34,1946,1.8126886688556398
STAT,1907,37,30-34,1944,1.7230830931487042
STAT,1899,7,na,1906,3639.6036394241587
SIM,1777,86,na,1863,10
SIM,1915,31,na,1946,4286
STAT,1921,40,35-39,1961,0.23208125642483615
SIM,1811,63,na,1874,805
SIM,1885,16,na,1901,2538
STAT,1906,17,20-24,1923,26.324134381640633
SIM,1892,45,na,1937,3302
SIM,1914,17,20-24,1931,27
STAT,1772,103,na,1875,0.028457931722567963
SIM,1896,59,na,1955,2651
STAT,1815,42,40-44,1857,7.105809969694609
STAT,1896,24,25-29,1920,76.6472244943201
SIM,1899,31,35-39,1930,25
STAT,1917,40,15-19,1957,0.0016399997426935447
STAT,1790,105,na,1895,0.006603898143440597
STAT,1888,16,45-49,1904,0.07897374626470986
STAT,1853,29,35-39,1882,8.407041518275085
STAT,1878,44,30-34,1922,1.2043097753871337
STAT,1832,56,na,1888,1374.8799890522068
STAT,1909,19,50-100,1928,0.074529236378687
STAT,1835,49,40-44,1884,0.13110579890587232
SIM,1919,21,na,1940,4438
STAT,1829,33,25-29,1862,9.356555661459568
STAT,1835,30,45-49,1865,1.6895495304074601
SIM,1941,27,30-34,1968,60
SIM,1825,29,50-100,1854,1
SIM,1882,27,na,1909,2295
STAT,1915,43,15-19,1958,0.0015752041959775649
STAT,1827,36,25-29,1863,3.8389976719404553
SIM,1920,18,na,1938,4039
STAT,1833,22,35-39,1855,6.008724868506119
STAT,1902,40,30-34,1942,0.11601365058192664
SIM,1886,44,30-34,1930,6
STAT,1851,7,na,1858,2482.725779428788
STAT,1874,20,30-34,1894,18.663289976863876
STAT,1846,39,45-49,1885,1.458114029171826
STAT,1930,35,35-39,1965,3.2233334363115262
SIM,1861,29,35-39,1890,15
SIM,1886,73,na,1959,1361
STAT,1915,37,50-100,1952,0.4328107994632058
STAT,1954,18,na,1972,4639.789634134766
STAT,1776,100,na,1876,0.20419203568662558
SIM,1930,25,35-39,1955,25
SIM,1907,27,30-34,1934,53
STAT,1919,17,30-34,1936,13.745349718843762
SIM,1895,37,35-39,1932,14
SIM,1921,30,35-39,1951,17
SIM,1903,46,na,1949,3159
SIM,1888,41,30-34,1929,4
STAT,1862,52,25-29,1914,0.003059509596416457
SIM,1862,40,50-100,1902,3
SIM,1790,68,na,1858,556
STAT,1887,37,35-39,1924,8.085292681072547
SIM,1906,11,na,1917,3846
STAT,1846,20,25-29,1866,51.24455195159519
STAT,1901,28,25-29,1929,60.13390688093575
SIM,1824,73,na,1897,621
STAT,1894,16,15-19,1910,7.806551648218945
SIM,1915,37,30-34,1952,3
STAT,1813,54,30-34,1867,0.01372456962299302
STAT,1852,17,na,1869,2236.551925136557
STAT,1859,20,35-39,1879,5.499233416466805
SIM,1885,15,30-34,1900,3
SIM,1843,30,45-49,1873,1
SIM,1904,32,25-29,1936,10
STAT,1904,35,na,1939,3504.745948997873
STAT,1908,49,na,1957,3368.1250153026695
STAT,1785,69,na,1854,682.0
STAT,1781,79,na,1860,252.55247282655557
SIM,1902,21,na,1923,3441
STAT,1878,10,na,1888,2776.625021668918
SIM,1850,39,30-34,1889,6
SIM,1860,40,na,1900,2029
STAT,1868,37,25-29,1905,2.805395724040169
STAT,1842,39,30-34,1881,4.369888392381732
STAT,1833,97,na,1930,3.527928424271039
SIM,1846,76,na,1922,648
SIM,1849,65,na,1914,1316
STAT,1938,28,20-24,1966,18.438761786886783
STAT,1808,53,50-100,1861,0.0352927560759445
STAT,1832,101,na,1933,0.38130663251888
STAT,1880,45,30-34,1925,0.10480703357129895
STAT,1933,27,30-34,1960,53.05760964960772
SIM,1941,1,na,1942,4106
STAT,1902,48,35-39,1950,0.11218468073573368
STAT,1823,47,50-100,1870,0.36922135092550545
STAT,1822,32,30-34,1854,55.00338172644927
SIM,1876,37,25-29,1913,4
STAT,1842,28,20-24,1870,11.295313385365588
STAT,1913,30,35-39,1943,9.3498714678288
SIM,1860,41,50-100,1901,2
SIM,1850,28,20-24,1878,18
STAT,1917,41,50-100,1958,0.12529310938662608
SIM,1918,28,45-49,1946,2
STAT,1933,32,na,1965,5197.822191045312
SIM,1902,38,35-39,1940,3
SIM,1830,32,30-34,1862,4
SIM,1875,73,na,1948,1151
STAT,1946,1,na,1947,4664.934764561935
STAT,1890,16,50-100,1906,0.0612594618415873
STAT,1831,31,na,1862,1909.0251442022386
STAT,1836,101,na,1937,0.3551758570207696
STAT,1937,30,20-24,1967,2.464297698039759
STAT,1862,52,30-34,1914,0.005141675899087944
SIM,1837,33,25-29,1870,14
SIM,1847,41,50-100,1888,2
STAT,1835,45,na,1880,1812.6225534496618
STAT,1918,38,45-49,1956,0.7325202031078649
SIM,1842,86,na,1928,180
STAT,1841,32,40-44,1873,3.885013548593209
SIM,1837,22,15-19,1859,3
STAT,1811,94,na,1905,8.657137676917927
SIM,1926,38,45-49,1964,2
STAT,1899,16,20-24,1915,24.82704743875386
SIM,1835,39,35-39,1874,10
SIM,1904,35,35-39,1939,3
STAT,1827,39,35-39,1866,8.71724769018968
SIM,1928,37,40-44,1965,5
STAT,1891,20,30-34,1911,22.631106053357346
STAT,1852,42,15-19,1894,0.0111115243865361
SIM,1885,24,20-24,1909,112
STAT,1834,46,50-100,1880,0.19510061526814396
STAT,1859,31,45-49,1890,1.4265239855947087
STAT,1918,27,35-39,1945,16.304928739646517
STAT,1877,24,20-24,1901,72.45887982423363
STAT,1904,45,35-39,1949,0.11661286867204664
SIM,1867,31,45-49,1898,2
STAT,1857,48,na,1905,1769.9679408519562
SIM,1918,17,35-39,1935,8
STAT,1953,17,30-34,1970,15.04056293776224
SIM,1854,36,35-39,1890,9
SIM,1817,40,45-49,1857,3
SIM,1830,42,na,1872,1721
SIM,1866,37,na,1903,2352
STAT,1848,33,35-39,1881,8.267750952925068
STAT,1903,16,35-39,1919,0.7976729040910755
STAT,1921,43,45-49,1964,0.19098229913262182
SIM,1828,30,25-29,1858,13
STAT,1806,88,na,1894,48.78152133244472
SIM,1809,49,50-100,1858,1
SIM,1935,27,30-34,1962,82
SIM,1863,48,na,1911,1925
STAT,1816,49,30-34,1865,0.19272290971246492
SIM,1837,33,30-34,1870,19
STAT,1812,51,50-100,1863,0.03478346048973751
SIM,1943,20,15-19,1963,5
STAT,1903,27,45-49,1930,1.6101223444932793
STAT,1905,21,40-44,1926,3.0794375265138547
STAT,1944,25,40-44,1969,5.144208762122192
STAT,1912,19,40-44,1931,0.28698094219153525
SIM,1878,23,15-19,1901,3
STAT,1847,15,45-49,1862,0.06433292280074565
STAT,1802,74,na,1876,418.02585135817964
SIM,1930,22,25-29,1952,196
SIM,1949,16,na,1965,4467
SIM,1911,27,45-49,1938,2
STAT,1806,64,na,1870,889.2055643141464
STAT,1876,31,45-49,1907,1.8445006558178312
SIM,1917,49,35-39,1966,1
SIM,1893,67,na,1960,2229
SIM,1844,10,na,1854,2488
SIM,1895,21,25-29,1916,4
SIM,1910,48,35-39,1958,1
SIM,1913,21,40-44,1934,4
SIM,1848,24,na,1872,2004
STAT,1887,21,25-29,1908,65.63693714008592
STAT,1853,26,25-29,1879,41.38720719978053
SIM,1856,33,35-39,1889,3
STAT,1858,19,50-100,1877,0.045754926391719075
STAT,1893,43,15-19,1936,0.0012320991557462615
SIM,1878,62,na,1940,2052
SIM,1884,31,45-49,1915,3
STAT,1911,32,20-24,1943,2.4227558544676246
STAT,1927,27,30-34,1954,48.59108003527219
STAT,1795,87,na,1882,52.190678891630995
STAT,1855,20,20-24,1875,63.31474023260832
STAT,1929,25,45-49,1954,2.2136340244587087
SIM,1841,45,na,1886,1749
SIM,1862,30,25-29,1892,14
SIM,1889,35,45-49,1924,3
STAT,1865,27,na,1892,2209.6886207039443
SIM,1909,21,20-24,1930,100
STAT,1909,30,15-19,1939,0.12606991180938365
STAT,1909,49,35-39,1958,0.12011824550822857
SIM,1918,36,na,1954,4205
SIM,1853,16,25-29,1869,9
STAT,1911,29,na,1940,3699.8621667015914
STAT,1886,17,25-29,1903,6.119001950452659
SIM,1835,73,na,1908,661
STAT,1803,106,na,1909,0.004711400168253822
STAT,1883,29,20-24,1912,11.658849440570906
SIM,1840,20,na,1860,1880
STAT,1897,44,40-44,1941,0.2101789398137275
STAT,1854,30,25-29,1884,8.196300129869192
STAT,1935,36,25-29,1971,1.4053356588215045
STAT,1937,22,na,1959,3627.34513689273
SIM,1871,83,na,1954,516
STAT,1886,45,na,1931,2453.625421957872
STAT,1811,44,25-29,1855,1.8938099109562927
STAT,1849,111,na,1960,1.5977706605109062E-4
STAT,1917,40,20-24,1957,0.018859996022331002
STAT,1816,38,20-24,1854,2.3602959518115147
STAT,1831,28,45-49,1859,1.0681921389410731
STAT,1837,43,30-34,1880,0.8929933249394949
SIM,1911,57,na,1968,3394
STAT,1896,24,30-34,1920,23.84920040276312
SIM,1962,4,na,1966,5406
STAT,1829,33,30-34,1862,15.949343784469031
STAT,1861,36,30-34,1897,4.514288250129385
STAT,1881,14,na,1895,2538.8245567956446
STAT,1967,4,na,1971,5010.215863081082
SIM,1878,34,25-29,1912,15
SIM,1845,43,30-34,1888,1
SIM,1917,30,15-19,1947,1
STAT,1908,25,na,1933,3634.4633994034
STAT,1895,2,na,1897,3548.022557215695
STAT,1874,20,25-29,1894,59.98060113132961
SIM,1859,25,30-34,1884,6
SIM,1894,17,25-29,1911,12
STAT,1907,40,na,1947,3508.985232836142
SIM,1854,20,25-29,1874,72
SIM,1863,20,20-24,1883,61
SIM,1841,22,35-39,1863,8
STAT,1903,22,20-24,1925,99.93446297021471
SIM,1861,15,15-19,1876,10
SIM,1903,17,45-49,1920,1
STAT,1765,107,na,1872,0.0027249245966568278
STAT,1901,17,15-19,1918,8.466106529440125
SIM,1861,26,25-29,1887,61
STAT,1814,50,50-100,1864,0.04484333130856649
SIM,1911,22,20-24,1933,5
STAT,1828,40,25-29,1868,0.542452677982408
STAT,1845,16,25-29,1861,5.6293591265690335
STAT,1825,86,na,1911,133.05089888967944
STAT,1895,31,25-29,1926,13.688731614781345
SIM,1873,90,na,1963,101
STAT,1902,6,na,1908,3758.256076408108
STAT,1853,15,15-19,1868,6.057082398288509
STAT,1837,28,na,1865,1837.8978232678976
SIM,1927,17,30-34,1944,23
SIM,1873,30,30-34,1903,29
SIM,1878,34,30-34,1912,27
STAT,1949,18,25-29,1967,51.40360528005556
STAT,1903,30,50-100,1933,1.3393872516241592
SIM,1911,16,35-39,1927,1
STAT,1955,16,na,1971,4985.07975062699
SIM,1843,49,40-44,1892,1
STAT,1861,13,na,1874,2302.480238887446
STAT,1899,55,na,1954,2888.533196955549
STAT,1922,22,25-29,1944,108.08311836439312
STAT,1923,9,na,1932,4769.4144270127645
STAT,1938,17,40-44,1955,1.4074735132068907
STAT,1858,108,na,1966,0.012376545676726719
STAT,1889,34,35-39,1923,12.652298354077299
STAT,1820,35,50-100,1855,3.338730860217927
STAT,1800,54,20-24,1854,0.003004471910208329
STAT,1854,83,na,1937,303.8358297308521
STAT,1845,52,25-29,1897,0.0027528079018645873
SIM,1889,24,35-39,1913,13
SIM,1879,15,30-34,1894,2
SIM,1879,47,na,1926,2781
SIM,1919,23,50-100,1942,1
STAT,1872,26,35-39,1898,9.899205832010049
SIM,1858,61,na,1919,1502
SIM,1875,33,na,1908,2359
SIM,1789,71,na,1860,617
SIM,1924,34,50-100,1958,3
SIM,1871,36,40-44,1907,6
STAT,1952,11,na,1963,4802.7465879035735
STAT,1856,43,40-44,1899,1.7882162963912684
STAT,1915,46,25-29,1961,0.05468026195301419
SIM,1904,26,50-100,1930,1
STAT,1920,28,35-39,1948,16.74791791652814
STAT,1955,15,45-49,1970,0.6767285065552923
STAT,1815,84,na,1899,172.01196672135083
STAT,1928,41,35-39,1969,0.2622218538357301
SIM,1853,30,na,1883,2014
SIM,1890,2,na,1892,3500
STAT,1842,58,na,1900,1550.841053879014
SIM,1876,95,na,1971,81
SIM,1861,65,na,1926,1710
STAT,1876,46,na,1922,2376.777389106146
SIM,1878,43,50-100,1921,2
STAT,1839,51,na,1890,1493.107498596931
STAT,1849,17,45-49,1866,0.06242467683380092
STAT,1895,44,30-34,1939,0.104827352452246
STAT,1937,24,35-39,1961,9.346508485616456
STAT,1833,45,15-19,1878,3.1798316833551613E-4
STAT,1880,51,na,1931,2319.3036714323157
STAT,1924,36,25-29,1960,1.1856205513791782
STAT,1846,33,25-29,1879,8.566563429449362
SIM,1838,41,na,1879,1653
SIM,1880,20,20-24,1900,75
SIM,1934,9,na,1943,5652
SIM,1867,37,50-100,1904,2
SIM,1859,24,na,1883,2246
STAT,1939,32,45-49,1971,1.6378663431918665
SIM,1834,51,na,1885,1532
STAT,1937,35,45-49,1972,0.6965422577466949
SIM,1904,20,30-34,1924,37
STAT,1897,40,25-29,1937,0.06143983392214091
SIM,1847,43,35-39,1890,1
SIM,1874,24,45-49,1898,1
STAT,1769,104,na,1873,0.015832689038814567
SIM,1816,38,na,1854,1736
STAT,1838,26,35-39,1864,9.083486480541723
STAT,1855,23,30-34,1878,16.015407886376217
SIM,1854,36,40-44,1890,7
SIM,1918,23,15-19,1941,5
SIM,1885,32,na,1917,2406
SIM,1801,61,na,1862,1100
SIM,1796,84,na,1880,56
SIM,1831,26,50-100,1857,1
STAT,1864,17,40-44,1881,0.17162828009923578
STAT,1887,9,na,1896,2966.011719938085
STAT,1840,48,na,1888,1611.829771758074
SIM,1824,33,na,1857,1659
STAT,1865,83,na,1948,367.57138208353916
STAT,1941,27,na,1968,3953.589807331078
SIM,1805,75,na,1880,374
SIM,1927,13,na,1940,4864
STAT,1827,66,na,1893,1059.3239395046853
SIM,1932,36,25-29,1968,3
STAT,1857,109,na,1966,0.004613935505110893
SIM,1782,89,na,1871,10
SIM,1851,44,na,1895,1805
STAT,1900,29,na,1929,3350.3062734748883
STAT,1926,34,30-34,1960,19.40966684725884
SIM,1883,68,na,1951,1563
SIM,1913,25,35-39,1938,16
STAT,1854,43,na,1897,1756.1397541309207
SIM,1854,39,50-100,1893,2
SIM,1906,51,na,1957,3247
STAT,1853,98,na,1951,2.7238975179555784
SIM,1861,26,30-34,1887,37
SIM,1913,36,45-49,1949,1
STAT,1905,25,35-39,1930,14.312643592133256
SIM,1854,33,25-29,1887,3
STAT,1928,42,40-44,1970,0.3252460090869323
STAT,1902,42,20-24,1944,0.01584628470720806
STAT,1931,26,15-19,1957,0.9299338194188872
SIM,1920,15,25-29,1935,94
STAT,1856,32,50-100,1888,0.7427159773829873
STAT,1912,15,25-29,1927,8.980756338829567
STAT,1891,39,20-24,1930,0.9637819003595514
STAT,1911,46,50-100,1957,0.21895759913632135
STAT,1839,43,35-39,1882,1.3003866849074932
STAT,1853,26,30-34,1879,24.637671287001567
SIM,1873,47,na,1920,2263
STAT,1846,22,15-19,1868,2.910931687852043
STAT,1928,31,30-34,1959,20.10613182591568
STAT,1949,15,20-24,1964,160.95450720610887
STAT,1832,42,40-44,1874,1.8481615958937776
STAT,1824,48,20-24,1872,0.013797575314835145
STAT,1863,45,30-34,1908,0.08744612145542588
SIM,1871,33,30-34,1904,22
SIM,1827,78,na,1905,408
SIM,1934,34,30-34,1968,29
SIM,1864,70,na,1934,1299
SIM,1909,36,25-29,1945,3
STAT,1827,36,30-34,1863,7.106229772175043
STAT,1830,92,na,1922,26.347092019265098
STAT,1899,19,25-29,1918,7.873794715765697
STAT,1863,17,na,1880,2342.8513283738607
SIM,1900,25,25-29,1925,6
SIM,1846,26,35-39,1872,2
SIM,1898,9,na,1907,4014
SIM,1848,34,45-49,1882,2
SIM,1902,33,35-39,1935,10
STAT,1854,28,50-100,1882,0.5095663805464259
STAT,1883,29,15-19,1912,0.4508947333611172
SIM,1837,21,30-34,1858,20
SIM,1937,34,na,1971,4444
SIM,1788,89,na,1877,80
SIM,1917,14,na,1931,4233
STAT,1882,32,50-100,1914,0.9106352228683694
STAT,1852,47,20-24,1899,0.009622150953009844
STAT,1918,24,na,1942,3994.050446735166
SIM,1884,20,35-39,1904,9
STAT,1816,38,15-19,1854,0.17194211083783958
STAT,1854,43,30-34,1897,0.8735476613036876
STAT,1851,105,na,1956,0.029965324547039804
SIM,1813,89,na,1902,20
STAT,1909,50,na,1959,3411.860148625003
STAT,1917,45,15-19,1962,3.944981279312787E-4
SIM,1904,31,40-44,1935,4
STAT,1835,30,15-19,1865,0.13797554565477377
STAT,1917,20,50-100,1937,0.7179159254433726
STAT,1852,3,na,1855,2752.8412
STAT,1893,39,na,1932,3018.2928992034235
STAT,1915,21,50-100,1936,0.696164612709669
SIM,1863,23,30-34,1886,21
SIM,1913,24,na,1937,3819
STAT,1816,42,50-100,1858,2.506359159871855
STAT,1887,34,25-29,1921,11.608418087375133
STAT,1894,27,30-34,1921,33.0441474117329
SIM,1859,22,20-24,1881,81
SIM,1895,34,25-29,1929,19
SIM,1863,32,na,1895,2090
STAT,1900,44,15-19,1944,0.0013376507919398474
SIM,1830,44,30-34,1874,2
SIM,1847,39,na,1886,1675
STAT,1800,94,na,1894,9.632645426419465
SIM,1902,35,30-34,1937,3
STAT,1822,97,na,1919,3.1236580744047635
STAT,1875,50,45-49,1925,0.01541300566891252
STAT,1918,33,20-24,1951,2.633860948873791
STAT,1900,39,40-44,1939,1.3225181983796244
SIM,1945,24,35-39,1969,11
STAT,1841,47,45-49,1888,0.17504117904746505
SIM,1926,33,20-24,1959,5
STAT,1855,84,na,1939,257.8799337699781
STAT,1835,49,35-39,1884,0.10721268626840204
STAT,1789,99,na,1888,0.2958824477875092
STAT,1931,15,35-39,1946,5.627431982182291
SIM,1950,19,20-24,1969,157
SIM,1926,21,20-24,1947,7
STAT,1862,50,50-100,1912,0.013303699500085576
STAT,1865,33,35-39,1898,9.337109489610363
STAT,1878,40,15-19,1918,0.014812088928799275
STAT,1857,106,na,1963,0.04493170929344639
STAT,1836,23,20-24,1859,56.20644950038705
SIM,1943,21,20-24,1964,120
STAT,1885,42,50-100,1927,1.0739105388467771
SIM,1805,78,na,1883,278
STAT,1822,47,35-39,1869,0.19961976769679352
STAT,1873,43,40-44,1916,2.3095078358621977
SIM,1849,28,50-100,1877,4
STAT,1843,59,na,1902,1568.9061553219653
SIM,1907,27,25-29,1934,81
SIM,1933,19,20-24,1952,164
STAT,1850,49,30-34,1899,0.07129313887649365
STAT,1906,40,45-49,1946,0.1558768093309929
STAT,1852,30,50-100,1882,0.7802817154428203
SIM,1822,63,na,1885,1018
STAT,1901,19,35-39,1920,0.7785791622625693
STAT,1850,38,20-24,1888,0.5829337270279599
SIM,1918,25,40-44,1943,7
STAT,1942,19,20-24,1961,144.4528016321641
STAT,1921,45,35-39,1966,0.14901300517629515
STAT,1821,56,na,1877,1170.8364381728968
STAT,1829,36,na,1865,1842.2915055215965
SIM,1937,23,25-29,1960,129
STAT,1787,95,na,1882,3.085073081212002
STAT,1831,25,40-44,1856,3.2145005692215616
SIM,1881,43,40-44,1924,2
STAT,1906,42,35-39,1948,0.18648446312809613
SIM,1801,64,na,1865,1009
STAT,1858,50,45-49,1908,0.011909372404563922
SIM,1940,30,45-49,1970,4
SIM,1852,85,na,1937,160
STAT,1931,26,45-49,1957,2.275738688818456
STAT,1900,32,15-19,1932,0.2013572933598372
SIM,1919,34,35-39,1953,13
STAT,1918,21,20-24,1939,122.75164483479041
SIM,1835,36,30-34,1871,8
SIM,1895,31,20-24,1926,6
SIM,1830,47,35-39,1877,1
STAT,1818,73,na,1891,605.2987091620299
STAT,1898,30,na,1928,3318.503088292873
SIM,1844,23,20-24,1867,2
SIM,1831,86,na,1917,184
STAT,1818,41,50-100,1859,2.8189440506297077
STAT,1898,42,50-100,1940,0.10108237965226693
SIM,1914,42,35-39,1956,3
SIM,1871,43,na,1914,2094
SIM,1875,57,na,1932,1949
STAT,1920,23,35-39,1943,10.649421829647261
STAT,1923,26,50-100,1949,1.1699766576407717
SIM,1864,43,40-44,1907,7
STAT,1929,23,25-29,1952,118.76987572393085
SIM,1887,27,35-39,1914,1
STAT,1879,27,35-39,1906,10.289183103326852
STAT,1865,34,50-100,1899,0.8410910789443587
STAT,1935,21,20-24,1956,154.46862946443562
SIM,1928,36,35-39,1964,7
STAT,1902,48,40-44,1950,0.1371858378404738
SIM,1920,1,na,1921,4596
SIM,1840,28,50-100,1868,3
STAT,1842,21,50-100,1863,0.4062678168329589
STAT,1861,20,15-19,1881,2.8984739374089714
STAT,1905,36,45-49,1941,0.6369968919859187
STAT,1925,19,20-24,1944,166.1944654486077
STAT,1926,46,30-34,1972,0.11249141885705732
STAT,1852,45,25-29,1897,0.04686526852575555
STAT,1852,33,na,1885,1969.8711500158265
SIM,1882,9,na,1891,2534
STAT,1877,16,15-19,1893,6.294686859994413
STAT,1914,27,20-24,1941,18.775161199516244
SIM,1887,42,na,1929,2745
SIM,1918,18,40-44,1936,2
SIM,1876,37,30-34,1913,9
STAT,1912,14,na,1926,4060.7008547639784
SIM,1803,71,na,1874,466
STAT,1922,36,45-49,1958,0.792221495818456
STAT,1941,30,40-44,1971,4.196456027845892
SIM,1907,29,20-24,1936,16
STAT,1932,30,45-49,1962,2.135717600420313
SIM,1844,19,30-34,1863,1
STAT,1893,48,20-24,1941,0.008650006235154233
SIM,1890,33,40-44,1923,14
SIM,1840,42,40-44,1882,4
SIM,1895,37,40-44,1932,11
STAT,1846,36,40-44,1882,3.3031885282211877
SIM,1889,20,40-44,1909,4
STAT,1872,23,25-29,1895,58.34875426697293
SIM,1849,81,na,1930,509
STAT,1799,77,na,1876,338.65226866954606
SIM,1922,27,20-24,1949,30
SIM,1900,29,35-39,1929,19
STAT,1909,46,30-34,1955,0.083750567235859
STAT,1887,37,40-44,1924,5.0040696201525305
STAT,1944,23,20-24,1967,122.44974516768856
STAT,1866,24,45-49,1890,0.6520511399162319
STAT,1922,25,35-39,1947,17.452227382246896
STAT,1882,33,40-44,1915,4.291973149665096
SIM,1888,83,na,1971,814
SIM,1897,57,na,1954,2694
STAT,1876,43,na,1919,2417.139947425496
STAT,1920,25,30-34,1945,44.16091758675299
STAT,1874,46,15-19,1920,4.178072647468391E-4
STAT,1893,46,25-29,1939,0.04216775030840988
STAT,1944,9,na,1953,4327.36921530137
SIM,1828,63,na,1891,1076
STAT,1806,52,40-44,1858,0.03422438648120151
STAT,1868,37,30-34,1905,5.192966581516599
STAT,1889,33,50-100,1922,1.1497285803532404
STAT,1901,25,20-24,1926,16.84938553158608
SIM,1839,63,na,1902,1306
STAT,1845,52,50-100,1897,0.011737667108810558
STAT,1909,10,na,1919,3961.797766859428
SIM,1906,46,50-100,1952,1
SIM,1930,24,45-49,1954,1
STAT,1857,46,15-19,1903,3.1959210079863756E-4
STAT,1866,68,na,1934,1437.9883255253294
STAT,1870,29,50-100,1899,0.6333818707873539
STAT,1916,20,na,1936,3928.2612156052587
SIM,1829,88,na,1917,31
STAT,1882,45,40-44,1927,0.17184805217364435
STAT,1925,17,25-29,1942,53.40863729115369
SIM,1868,17,20-24,1885,34
SIM,1877,6,na,1883,2791
SIM,1803,68,na,1871,626
STAT,1837,34,40-44,1871,3.55077224927402
STAT,1804,105,na,1909,0.009893375751871571
STAT,1929,27,50-100,1956,1.2705488086212795
SIM,1924,29,20-24,1953,2
STAT,1833,41,na,1874,1694.2709519734344
STAT,1852,49,40-44,1901,0.13503935688437751
STAT,1921,40,40-44,1961,0.2882763367054455
SIM,1932,33,20-24,1965,7
SIM,1810,78,na,1888,474
STAT,1916,29,20-24,1945,19.12284003139368
SIM,1823,42,40-44,1865,2
SIM,1868,4,na,1872,2795
SIM,1917,46,30-34,1963,1
STAT,1859,58,na,1917,1611.1782588942717
STAT,1853,18,na,1871,2301.6820981203705
STAT,1922,24,45-49,1946,1.3083425410986702
STAT,1842,28,15-19,1870,0.4368353277984594
SIM,1933,17,25-29,1950,82
STAT,1815,54,40-44,1869,0.025993633950010073
STAT,1836,19,30-34,1855,1.5192565747616669
STAT,1952,20,45-49,1972,1.3809829083298792
SIM,1816,78,na,1894,360
STAT,1841,44,40-44,1885,1.6820786680107644
SIM,1842,30,na,1872,1988
STAT,1860,46,50-100,1906,0.20386378940996583
STAT,1856,47,na,1903,1793.2808401915806
SIM,1934,30,45-49,1964,4
SIM,1852,48,na,1900,1862
STAT,1877,53,50-100,1930,0.01572343110889847
SIM,1862,43,30-34,1905,1
STAT,1902,34,15-19,1936,0.1166315732301068
STAT,1818,52,na,1870,1323.2415899954187
STAT,1838,23,30-34,1861,16.857921127916086
STAT,1843,40,na,1883,1970.9136266537328
STAT,1915,40,40-44,1955,0.2576806559219259
SIM,1882,39,20-24,1921,2
SIM,1870,98,na,1968,6
STAT,1870,26,30-34,1896,25.199150360810297
STAT,1924,33,20-24,1957,2.901545508909123
SIM,1896,35,na,1931,3205
STAT,1849,17,50-100,1866,0.04681850762535068
SIM,1904,23,35-39,1927,16
SIM,1904,34,45-49,1938,2
SIM,1885,72,na,1957,1430
STAT,1925,30,50-100,1955,1.0028252969374465
STAT,1937,21,30-34,1958,28.558218732306745
SIM,1880,23,25-29,1903,67
SIM,1907,43,50-100,1950,1
SIM,1868,15,30-34,1883,5
SIM,1909,24,30-34,1933,31
SIM,1841,85,na,1926,126
STAT,1892,19,15-19,1911,7.546999205632726
SIM,1945,21,30-34,1966,44
STAT,1863,48,35-39,1911,0.12364980696484273
SIM,1854,30,20-24,1884,1
STAT,1855,35,50-100,1890,0.9607829048834745
STAT,1811,48,40-44,1859,0.4673167709781675
STAT,1874,39,20-24,1913,0.794806097344712
SIM,1903,16,30-34,1919,4
STAT,1909,31,50-100,1940,0.8079493880860144
SIM,1886,31,25-29,1917,15
STAT,1902,45,25-29,1947,0.04720932460662212
SIM,1868,1,na,1869,3372
STAT,1855,26,35-39,1881,7.852861701197852
STAT,1831,55,na,1886,1417.5086115596632
SIM,1909,35,40-44,1944,2
STAT,1802,54,30-34,1856,0.015150909164011442
STAT,1926,30,45-49,1956,1.9432755384354257
SIM,1873,33,35-39,1906,14
STAT,1863,39,45-49,1902,1.765131734819579
SIM,1904,47,na,1951,3433
STAT,1846,30,20-24,1876,2.3322790210129853
SIM,1901,36,na,1937,3586
STAT,1868,32,na,1900,2325.1435755740067
SIM,1825,74,na,1899,632
SIM,1865,20,25-29,1885,68
STAT,1806,67,na,1873,795.1006300917219
SIM,1893,21,15-19,1914,3
STAT,1940,17,20-24,1957,140.43146007323952
STAT,1885,21,15-19,1906,3.367813818227945
STAT,1849,24,45-49,1873,0.6451707644028536
STAT,1870,73,na,1943,1184.5014200355631
STAT,1877,18,35-39,1895,0.5790603193003439
STAT,1939,26,na,1965,3843.550488672026
SIM,1853,70,na,1923,1120
STAT,1841,92,na,1933,30.751955758271418
STAT,1911,23,30-34,1934,27.718293947611677
STAT,1853,58,na,1911,1658.2128905145903
STAT,1861,8,na,1869,2379.2634774598746
STAT,1888,18,40-44,1906,0.22000685115031396
SIM,1895,0,na,1895,3789
STAT,1844,84,na,1928,257.78449524699187
STAT,1876,46,25-29,1922,0.06084980678540641
SIM,1863,26,35-39,1889,11
SIM,1880,26,40-44,1906,2
STAT,1856,50,35-39,1906,0.006993236775619365
STAT,1842,18,na,1860,2297.945276806202
SIM,1839,66,na,1905,1153
STAT,1857,39,15-19,1896,0.044289118047738475
SIM,1913,33,40-44,1946,2
STAT,1868,22,20-24,1890,67.14608407009501
SIM,1926,36,25-29,1962,1
STAT,1811,46,20-24,1857,0.03392578347204482
STAT,1862,16,25-29,1878,5.6694026719501665
STAT,1916,23,15-19,1939,5.6746299633092665
STAT,1887,31,20-24,1918,3.1025842172655334
STAT,1878,31,25-29,1909,10.920671555064493
STAT,1905,22,30-34,1927,26.243630485113407
SIM,1826,49,35-39,1875,1
STAT,1932,32,35-39,1964,12.38894644670198
SIM,1898,25,45-49,1923,2
STAT,1844,36,30-34,1880,4.845906848916865
SIM,1913,21,na,1934,3906
SIM,1829,27,40-44,1856,5
STAT,1935,34,35-39,1969,12.87658846682987
SIM,1821,42,30-34,1863,2
SIM,1876,22,20-24,1898,77
SIM,1819,44,40-44,1863,9
SIM,1859,28,35-39,1887,1
STAT,1928,34,35-39,1962,11.640257072783365
SIM,1854,100,na,1954,4
SIM,1777,89,na,1866,1
SIM,1819,40,25-29,1859,1
STAT,1806,104,na,1910,0.023700789481701973
STAT,1948,22,45-49,1970,1.3180863671629275
SIM,1849,19,15-19,1868,6
STAT,1832,45,45-49,1877,0.19222885141940124
SIM,1917,31,50-100,1948,1
STAT,1865,43,na,1908,2124.5246721874814
STAT,1905,33,40-44,1938,3.6533557969068626
STAT,1863,36,40-44,1899,3.9343102771651264
STAT,1907,24,na,1931,3520.3983278813107
SIM,1846,23,30-34,1869,27
STAT,1765,89,na,1854,12.0
STAT,1831,41,50-100,1872,0.9073956104756303
STAT,1921,28,na,1949,4245.427967795743
SIM,1924,23,15-19,1947,5
STAT,1876,83,na,1959,546.6851748849327
STAT,1888,71,na,1959,1735.734994914926
STAT,1962,6,na,1968,5136.56328252881
STAT,1929,38,20-24,1967,0.344830782103008
SIM,1830,45,na,1875,1724
SIM,1839,30,25-29,1869,5
SIM,1852,36,30-34,1888,6
STAT,1829,36,35-39,1865,6.270056145895905
SIM,1935,25,40-44,1960,11
STAT,1937,32,40-44,1969,3.9491881759126426
SIM,1863,69,na,1932,1141
STAT,1898,21,25-29,1919,79.21174960066963
STAT,1868,102,na,1970,2.4980895250126216
SIM,1882,83,na,1965,543
STAT,1833,38,20-24,1871,0.6315429748567946
STAT,1842,55,na,1897,1621.5105026094934
SIM,1859,37,25-29,1896,3
STAT,1928,43,25-29,1971,0.09270940071016943
STAT,1813,42,30-34,1855,4.184457042984153
STAT,1907,32,50-100,1939,0.7880506533377003
STAT,1907,46,20-24,1953,0.010167983303067873
SIM,1935,8,na,1943,5590
SIM,1852,20,15-19,1872,4
SIM,1915,32,50-100,1947,1
STAT,1821,53,50-100,1874,0.022403326448087818
STAT,1822,38,45-49,1860,3.5904969040343566
SIM,1913,22,30-34,1935,33
SIM,1850,81,na,1931,395
STAT,1897,45,na,1942,3100.0366752081904
SIM,1851,5,na,1856,2423
STAT,1844,81,na,1925,419.0445720094591
STAT,1880,33,30-34,1913,18.63834693039355
STAT,1878,27,50-100,1905,0.6792645460862551
STAT,1820,34,25-29,1854,30.714482870415214
SIM,1895,3,na,1898,3667
STAT,1856,5,na,1861,2381.0221114944
STAT,1921,42,30-34,1963,0.14693828837446643
STAT,1913,8,na,1921,4146.47801829455
SIM,1849,25,na,1874,1945
STAT,1841,24,50-100,1865,0.3759674520055957
STAT,1864,58,na,1922,1793.843695539133
STAT,1933,36,20-24,1969,0.3665044852789878
SIM,1922,19,15-19,1941,49
STAT,1833,49,30-34,1882,0.06652556790470865
SIM,1895,23,15-19,1918,7
STAT,1922,21,40-44,1943,3.9462331436173175
STAT,1847,46,50-100,1893,0.19206584260362983
SIM,1845,30,25-29,1875,6
STAT,1916,23,45-49,1939,1.1994583417347335
STAT,1843,99,na,1942,1.528867736938119
SIM,1826,37,na,1863,1713
SIM,1882,20,30-34,1902,31
SIM,1887,24,30-34,1911,33
STAT,1873,46,45-49,1919,0.24477589820039097
STAT,1822,44,30-34,1866,1.686994608620168
STAT,1891,35,na,1926,3003.853887206887
STAT,1935,24,25-29,1959,128.18754043232545
SIM,1918,27,30-34,1945,55
STAT,1891,23,35-39,1914,7.347425381336434
STAT,1786,70,na,1856,541.10536348
STAT,1882,48,45-49,1930,0.23160774030261977
STAT,1887,23,15-19,1910,3.759571430603738
STAT,1824,32,35-39,1856,20.293850274407983
STAT,1804,108,na,1912,6.180598610297792E-4
STAT,1879,24,30-34,1903,18.875310102539096
SIM,1848,40,na,1888,1864
SIM,1832,32,35-39,1864,13
STAT,1890,50,na,1940,2724.3950937321083
SIM,1890,48,45-49,1938,1
STAT,1954,15,na,1969,4643.735696942114
STAT,1927,25,40-44,1952,5.819465484215422
SIM,1828,43,25-29,1871,1
SIM,1804,53,na,1857,1318
STAT,1905,36,15-19,1941,0.017943576556068378
SIM,1943,24,25-29,1967,93
STAT,1921,50,na,1971,4188.0716774163575
SIM,1895,36,50-100,1931,5
STAT,1887,36,50-100,1923,1.410228740404348
STAT,1933,16,na,1949,5037.223484655418
STAT,1818,49,35-39,1867,0.3081484415800937
STAT,1906,35,50-100,1941,0.39721732488565664
STAT,1914,19,45-49,1933,0.10486495865730036
STAT,1924,34,20-24,1958,2.899601473418153
STAT,1918,36,25-29,1954,1.0641474265981763
STAT,1907,21,45-49,1928,1.0476623541168177
SIM,1924,23,45-49,1947,3
SIM,1858,39,na,1897,1918
STAT,1926,30,15-19,1956,0.15869585232493286
STAT,1869,54,30-34,1923,0.005701495358315716
STAT,1930,41,50-100,1971,0.1578790598241338
SIM,1930,21,40-44,1951,6
SIM,1946,15,45-49,1961,1
SIM,1909,33,20-24,1942,1
STAT,1811,97,na,1908,2.327031933049389
STAT,1957,3,na,1960,5289.413048070673
SIM,1817,63,na,1880,899
SIM,1794,74,na,1868,449
SIM,1862,28,50-100,1890,2
SIM,1897,20,na,1917,3224
SIM,1798,88,na,1886,47
SIM,1952,3,na,1955,4888
SIM,1821,38,50-100,1859,1
SIM,1900,22,20-24,1922,3
STAT,1906,39,na,1945,3490.38025411729
SIM,1904,33,45-49,1937,1
STAT,1943,20,50-100,1963,0.7147321336968862
SIM,1920,17,45-49,1937,1
SIM,1890,40,35-39,1930,6
SIM,1928,33,30-34,1961,30
STAT,1829,92,na,1921,27.700352183430912
SIM,1951,20,50-100,1971,2
STAT,1887,6,na,1893,2986.2728495718334
SIM,1828,100,na,1928,6
SIM,1854,55,na,1909,1785
STAT,1902,44,25-29,1946,0.06328714360348271
STAT,1919,49,na,1968,4042.465701567617
STAT,1938,15,45-49,1953,0.5050044630581695
STAT,1848,43,50-100,1891,0.8152827595796204
STAT,1881,16,35-39,1897,0.5425085747799714
SIM,1844,26,25-29,1870,45
STAT,1913,32,25-29,1945,9.381135974581973
STAT,1833,103,na,1936,0.09424569741238034
SIM,1888,44,35-39,1932,6
SIM,1921,32,25-29,1953,21
STAT,1807,48,20-24,1855,0.05150008120849627
STAT,1832,96,na,1928,5.737844550014505
STAT,1837,49,45-49,1886,0.15920678737269528
STAT,1955,17,40-44,1972,1.8938361464234628
STAT,1868,94,na,1962,46.43083870086679
STAT,1840,17,50-100,1857,0.04564492021363742
STAT,1857,20,25-29,1877,53.41688871774884
STAT,1903,29,40-44,1932,4.31301307502849
SIM,1852,29,na,1881,2225
STAT,1858,18,25-29,1876,5.323677347022623
STAT,1914,19,15-19,1933,9.526983421856674
STAT,1910,49,50-100,1959,0.2139670784974492
STAT,1931,23,40-44,1954,4.433761202885287
STAT,1944,26,25-29,1970,72.61268729761441
STAT,1872,20,20-24,1892,70.87857075840343
SIM,1881,46,45-49,1927,1
SIM,1878,22,30-34,1900,2
SIM,1919,31,30-34,1950,33
STAT,1837,30,25-29,1867,8.741995093766777
STAT,1906,61,na,1967,3031.478866742692
SIM,1856,43,50-100,1899,2
STAT,1847,17,40-44,1864,0.17801651916932845
SIM,1886,57,na,1943,2279
STAT,1882,40,35-39,1922,1.817885737497239
SIM,1802,86,na,1888,144
SIM,1911,29,40-44,1940,4
STAT,1901,16,30-34,1917,2.279365397513277
SIM,1900,27,15-19,1927,1
STAT,1861,43,50-100,1904,0.884122215954108
SIM,1908,9,na,1917,4184
SIM,1775,82,na,1857,81
SIM,1950,16,na,1966,4422
STAT,1836,26,25-29,1862,34.318808472319326
STAT,1878,4,na,1882,3061.8115077880993
STAT,1830,30,na,1860,1807.468684900058
SIM,1919,42,40-44,1961,1
SIM,1900,38,25-29,1938,1
SIM,1901,21,50-100,1922,1
STAT,1808,74,na,1882,418.81180927752933
STAT,1828,53,30-34,1881,0.004011234018785591
STAT,1880,46,45-49,1926,0.2537172997175894
STAT,1850,22,35-39,1872,5.268479800674671
STAT,1888,31,na,1919,2889.7004163489833
SIM,1795,59,na,1854,1056
STAT,1841,33,na,1874,1921.4604090412581
STAT,1953,15,40-44,1968,1.7268814338430574
STAT,1864,98,na,1962,8.010509433122365
STAT,1868,33,15-19,1901,0.13817183163710692
SIM,1892,30,35-39,1922,21
SIM,1830,47,40-44,1877,1
SIM,1883,12,na,1895,2649
SIM,1921,23,35-39,1944,21
STAT,1934,19,25-29,1953,59.455233838200115
SIM,1898,15,35-39,1913,2
STAT,1918,36,30-34,1954,1.969804821750021
SIM,1862,34,40-44,1896,1
STAT,1836,50,25-29,1886,0.002321019920322864
STAT,1913,49,na,1962,3636.6376129394507
STAT,1883,77,na,1960,1033.7044317334346
STAT,1818,36,na,1854,1531.8817978456966
SIM,1868,19,40-44,1887,1
STAT,1852,49,35-39,1901,0.11042938088441077
STAT,1866,36,15-19,1902,0.05309408896983379
STAT,1879,17,25-29,1896,6.0427442215159575
STAT,1838,50,na,1888,1637.2041171875396
SIM,1800,60,na,1860,874
STAT,1814,46,na,1860,1449.5159420208918
STAT,1891,20,25-29,1911,72.7324789482451
STAT,1880,43,40-44,1923,2.393871684669952
SIM,1942,19,25-29,1961,79
STAT,1905,28,50-100,1933,0.9391697467294015
STAT,1921,42,25-29,1963,0.08207363888730762
SIM,1923,31,45-49,1954,4
STAT,1940,16,45-49,1956,0.5175783480158651
SIM,1885,15,25-29,1900,13
STAT,1884,30,35-39,1914,10.303230075947653
STAT,1900,47,25-29,1947,0.04572674004308169
STAT,1921,44,na,1965,4254.36519805678
STAT,1930,20,30-34,1950,37.77671774338692
SIM,1863,85,na,1948,134
STAT,1822,47,40-44,1869,0.24410645822056987
STAT,1919,15,40-44,1934,0.3179298206692146
SIM,1888,21,na,1909,2988
STAT,1861,24,30-34,1885,15.204970424964523
STAT,1870,19,30-34,1889,1.5858011031571329
STAT,1898,8,na,1906,3586.210310618054
SIM,1939,7,na,1946,4023
SIM,1821,68,na,1889,766
SIM,1874,17,15-19,1891,4
SIM,1937,15,40-44,1952,1
STAT,1915,31,45-49,1946,1.6420747715109627
SIM,1878,38,40-44,1916,5
STAT,1851,32,na,1883,2049.1139056935576
STAT,1908,62,na,1970,3083.9768314461735
STAT,1834,60,na,1894,1281.6581939031394
SIM,1871,27,na,1898,2324
SIM,1793,73,na,1866,428
SIM,1886,33,15-19,1919,1
SIM,1869,88,na,1957,125
STAT,1871,43,30-34,1914,1.1533757130553943
STAT,1822,107,na,1929,0.0027420630477554848
STAT,1805,85,na,1890,110.18199710630782
STAT,1873,51,25-29,1924,0.0036808529702986683
SIM,1913,29,15-19,1942,1
STAT,1854,34,40-44,1888,3.3291250722174133
STAT,1951,16,20-24,1967,164.74328071518633
STAT,1909,41,30-34,1950,0.12265735599651754
SIM,1926,36,30-34,1962,4
STAT,1872,27,40-44,1899,3.06275335585552
STAT,1913,23,35-39,1936,9.669939852110947
STAT,1856,63,na,1919,1428.8770863358661
STAT,1804,52,30-34,1856,0.017459769229441206
SIM,1842,19,20-24,1861,19
STAT,1877,5,na,1882,2886.888561493326
STAT,1944,26,30-34,1970,43.2260991245127
SIM,1920,31,na,1951,4035
SIM,1875,70,na,1945,1326
STAT,1817,88,na,1905,66.99885821140307
SIM,1899,46,30-34,1945,1
STAT,1864,53,40-44,1917,0.009396118069934827
STAT,1909,34,25-29,1943,8.91820031341694
SIM,1832,71,na,1903,756
SIM,1927,15,40-44,1942,1
STAT,1870,27,na,1897,2379.990603801147
STAT,1892,26,15-19,1918,0.5820774802148675
STAT,1826,65,na,1891,985.6548900939677
STAT,1861,35,25-29,1896,2.450121975060773
SIM,1828,42,25-29,1870,2
STAT,1929,37,45-49,1966,0.8926659723617861
STAT,1920,20,30-34,1940,32.801720647055895
STAT,1854,40,50-100,1894,0.8167189957627555
SIM,1899,38,50-100,1937,3
STAT,1872,39,50-100,1911,1.2426467653302744
STAT,1925,34,na,1959,4576.195035230708
STAT,1850,50,na,1900,1642.8978049800642
STAT,1926,31,20-24,1957,3.0105700717523765
SIM,1888,43,na,1931,2667
STAT,1843,40,15-19,1883,0.01177635561881288
SIM,1888,31,50-100,1919,2
STAT,1927,29,35-39,1956,18.543605832439425
SIM,1912,30,30-34,1942,5
STAT,1878,48,50-100,1926,0.25751624290467956
STAT,1849,43,50-100,1892,0.8142627045679612
STAT,1856,40,25-29,1896,0.5194304834840857
SIM,1876,25,50-100,1901,1
STAT,1786,73,na,1859,407.18354769407523
SIM,1915,37,25-29,1952,2
SIM,1910,59,na,1969,3263
STAT,1877,51,25-29,1928,0.0037656856997683136
SIM,1822,38,50-100,1860,2
STAT,1878,40,20-24,1918,0.17033901348103359
SIM,1917,34,25-29,1951,16
STAT,1899,15,45-49,1914,0.09167753738136532
STAT,1859,46,25-29,1905,0.04706081758463682
STAT,1835,34,30-34,1869,16.22809570131893
STAT,1927,40,50-100,1967,0.15071220089690782
STAT,1825,83,na,1908,238.05834245658747
STAT,1867,40,45-49,1907,1.4478430752875198
SIM,1935,29,35-39,1964,5
STAT,1904,30,30-34,1934,25.73244791609827
SIM,1867,75,na,1942,834
SIM,1870,79,na,1949,583
SIM,1941,17,na,1958,3640
STAT,1872,26,50-100,1898,0.6562849607274385
STAT,1930,42,35-39,1972,0.27022328185103933
STAT,1825,35,15-19,1860,0.09175476069358043
STAT,1854,53,40-44,1907,0.007928015192755147
STAT,1922,48,15-19,1970,4.306031264857797E-4
STAT,1853,29,40-44,1882,2.6100131462601883
STAT,1848,21,35-39,1869,5.563123830261865
SIM,1934,31,20-24,1965,6
STAT,1840,16,40-44,1856,0.17141739200874584
SIM,1856,21,35-39,1877,7
SIM,1875,40,45-49,1915,4
SIM,1861,84,na,1945,184
SIM,1873,30,25-29,1903,11
SIM,1811,47,30-34,1858,1
SIM,1890,65,na,1955,2075
SIM,1905,32,na,1937,3467
SIM,1843,65,na,1908,1270
STAT,1870,22,15-19,1892,3.289993602070803
SIM,1902,23,25-29,1925,90
SIM,1922,26,45-49,1948,2
SIM,1941,27,25-29,1968,96
STAT,1890,43,40-44,1933,2.7853376022561016
STAT,1953,19,35-39,1972,5.174430010747594
SIM,1843,34,30-34,1877,27
STAT,1818,45,25-29,1863,0.13497148354247418
STAT,1765,104,na,1869,0.011072298239185114
STAT,1835,45,25-29,1880,0.05102173427354417
STAT,1844,29,30-34,1873,23.54631114538231
STAT,1871,52,na,1923,2164.245931590002
STAT,1871,49,45-49,1920,0.23350445271864473
SIM,1889,28,15-19,1917,4
STAT,1805,63,na,1868,1063.0536100308207
SIM,1868,17,15-19,1885,10
STAT,1820,48,45-49,1868,0.4242052193391429
STAT,1835,27,50-100,1862,0.6214290042658025
SIM,1892,42,na,1934,3367
STAT,1860,19,30-34,1879,1.5036684416776467
STAT,1900,20,45-49,1920,0.9918605602654716
STAT,1809,45,15-19,1854,0.0018397275389332277
STAT,1933,20,40-44,1953,4.575534087843682
STAT,1870,38,30-34,1908,5.288626770999818
SIM,1877,17,25-29,1894,13
SIM,1852,29,30-34,1881,3
STAT,1839,50,35-39,1889,0.006089337463672136
SIM,1812,85,na,1897,110
STAT,1919,44,35-39,1963,0.22194330346398725
SIM,1920,15,30-34,1935,23
SIM,1924,20,40-44,1944,6
SIM,1896,72,na,1968,2054
STAT,1846,33,50-100,1879,0.7663163972395658
SIM,1826,45,25-29,1871,1
SIM,1907,23,15-19,1930,7
SIM,1821,62,na,1883,1027
STAT,1841,30,na,1871,1982.258201993317
SIM,1863,91,na,1954,9
SIM,1916,29,25-29,1945,79
STAT,1876,36,15-19,1912,0.059439581019146544
SIM,1897,33,50-100,1930,3
SIM,1911,20,30-34,1931,24
STAT,1854,32,15-19,1886,0.11161476791065962
STAT,1885,16,50-100,1901,0.049985359376997544
STAT,1903,25,30-34,1928,36.76565039077199
STAT,1873,39,50-100,1912,1.257012544693365
SIM,1880,22,25-29,1902,69
STAT,1843,34,50-100,1877,0.8709374495568291
SIM,1772,93,na,1865,7
STAT,1831,71,na,1902,899.4169366421548
SIM,1836,44,40-44,1880,4
STAT,1841,35,50-100,1876,1.0904560921934738
STAT,1916,20,40-44,1936,3.6169086465999727
STAT,1907,37,25-29,1944,0.9308609762463641
STAT,1776,89,na,1865,34.13012572505873
STAT,1840,52,40-44,1892,0.0075353457711389805
STAT,1889,41,35-39,1930,2.292210440180045
SIM,1852,35,25-29,1887,1
STAT,1827,29,30-34,1856,48.65680635850239
STAT,1832,28,50-100,1860,0.5753079725464333
STAT,1848,34,40-44,1882,3.5039280775321693
SIM,1868,23,na,1891,2332
SIM,1835,29,30-34,1864,34
SIM,1789,74,na,1863,475
SIM,1936,34,35-39,1970,12
SIM,1876,58,na,1934,2293
STAT,1952,14,na,1966,4800.249589499189
SIM,1941,20,40-44,1961,7
STAT,1928,44,45-49,1972,0.21569458818024928
SIM,1926,28,na,1954,4749
SIM,1905,26,45-49,1931,4
STAT,1868,88,na,1956,149.48914407447705
STAT,1923,6,na,1929,4801.994785118965
STAT,1830,45,35-39,1875,0.11924279201361522
SIM,1931,26,50-100,1957,6
STAT,1874,24,40-44,1898,2.1568286154974876
SIM,1922,44,na,1966,4288
STAT,1876,35,30-34,1911,5.667653850835133
STAT,1941,16,50-100,1957,0.39381061146673557
STAT,1908,29,25-29,1937,62.99514561852286
SIM,1826,93,na,1919,14
STAT,1899,41,35-39,1940,0.17645906218468088
SIM,1932,37,25-29,1969,1
STAT,1871,30,25-29,1901,10.433601970974077
SIM,1861,19,30-34,1880,2
SIM,1927,44,35-39,1971,1
STAT,1788,74,na,1862,489.9729479087554
STAT,1868,25,25-29,1893,41.49675385229269
SIM,1921,30,40-44,1951,5
STAT,1883,45,50-100,1928,0.24828800139161014
SIM,1887,31,50-100,1918,1
SIM,1899,30,45-49,1929,5
STAT,1848,40,35-39,1888,1.4423612985019012
SIM,1856,38,na,1894,2272
SIM,1888,41,25-29,1929,1
STAT,1916,23,50-100,1939,0.7014376534722402
SIM,1902,30,30-34,1932,39
STAT,1798,98,na,1896,1.1182396753940156
STAT,1813,52,40-44,1865,0.025266694350390362
SIM,1928,35,na,1963,5023
STAT,1849,50,35-39,1899,0.006779781894298555
SIM,1878,25,35-39,1903,15
SIM,1893,36,25-29,1929,3
STAT,1791,78,na,1869,277.49927679614535
STAT,1885,49,30-34,1934,0.09646394434391779
STAT,1924,37,25-29,1961,1.1845416366774233
STAT,1895,35,40-44,1930,5.8818391758273405
SIM,1884,35,30-34,1919,9
STAT,1884,45,50-100,1929,0.25035106480243696
SIM,1931,16,45-49,1947,1
SIM,1941,4,na,1945,4031
STAT,1853,19,30-34,1872,1.5887887163234844
STAT,1920,37,50-100,1957,0.4691149428599627
STAT,1906,45,na,1951,3374.598818984596
SIM,1871,22,15-19,1893,2
STAT,1881,53,40-44,1934,0.010216469670494298
STAT,1828,44,40-44,1872,1.7806519736278728
SIM,1919,40,na,1959,4208
SIM,1909,36,30-34,1945,1
SIM,1898,45,na,1943,3484
STAT,1830,29,50-100,1859,0.6464992124375528
STAT,1861,49,45-49,1910,0.19478677892288263
SIM,1900,23,20-24,1923,84
STAT,1885,36,25-29,1921,2.9444899390315653
SIM,1833,44,50-100,1877,2
STAT,1869,17,25-29,1886,5.658494524668978
SIM,1937,18,45-49,1955,1
STAT,1902,41,20-24,1943,0.015937607196443684
SIM,1901,15,20-24,1916,32
STAT,1912,15,30-34,1927,2.525999481178024
STAT,1823,52,40-44,1875,0.015237167543914035
STAT,1826,31,na,1857,1734.5335632481426
SIM,1855,50,na,1905,1688
STAT,1914,26,45-49,1940,1.7830409868830306
SIM,1859,27,50-100,1886,1
SIM,1876,36,na,1912,2741
SIM,1831,46,na,1877,1533
SIM,1884,87,na,1971,379
STAT,1885,20,na,1905,2421.4584266755396
STAT,1909,28,na,1937,3638.4481044083973
STAT,1933,27,25-29,1960,89.12799665656365
SIM,1856,40,35-39,1896,5
STAT,1813,98,na,1911,1.3969615553231656
STAT,1929,18,45-49,1947,0.6485270568453031
STAT,1830,52,40-44,1882,0.007683103849644933
STAT,1913,30,40-44,1943,4.003898248580722
STAT,1866,47,50-100,1913,0.23002486595745267
STAT,1917,41,20-24,1958,0.018834912227621306
STAT,1918,30,na,1948,4134.217891999518
SIM,1942,16,20-24,1958,161
STAT,1883,20,35-39,1903,5.875965267981287
SIM,1842,29,30-34,1871,1
STAT,1816,45,15-19,1861,8.496865899931261E-4
SIM,1838,25,na,1863,1955
SIM,1890,41,25-29,1931,1
STAT,1878,43,25-29,1921,0.6769558962145517
SIM,1906,31,45-49,1937,1
STAT,1951,19,25-29,1970,52.60835294262019
SIM,1897,35,40-44,1932,9
STAT,1883,36,15-19,1919,0.05647931135462162
SIM,1835,36,na,1871,1772
STAT,1872,38,40-44,1910,4.453489260368826
STAT,1894,28,50-100,1922,0.8364612570219916
STAT,1909,44,35-39,1953,0.18972830513132166
STAT,1814,62,na,1876,1050.6042221188884
STAT,1935,36,30-34,1971,2.6013660210345386
STAT,1861,25,15-19,1886,0.39082759904180914
SIM,1921,20,30-34,1941,47
STAT,1784,90,na,1874,25.319549134782356
STAT,1871,46,35-39,1917,0.1418751178586576
SIM,1880,38,40-44,1918,9
SIM,1822,32,35-39,1854,7
STAT,1900,44,20-24,1944,0.015382983276459958
SIM,1886,43,25-29,1929,1
STAT,1863,22,15-19,1885,3.009624337639675
STAT,1932,31,45-49,1963,2.1345429557400823
STAT,1825,29,20-24,1854,39.7528582633103
STAT,1903,18,50-100,1921,0.07086014961502247
SIM,1833,29,20-24,1862,14
STAT,1785,91,na,1876,18.79000237805937
STAT,1889,35,40-44,1924,5.568671082634112
STAT,1895,40,20-24,1935,0.21351480330778252
STAT,1899,16,50-100,1915,0.06860826026240548
STAT,1820,43,15-19,1863,0.026674981280049765
STAT,1818,42,15-19,1860,0.03535957789622776
STAT,1834,29,30-34,1863,21.903396309294042
SIM,1857,17,15-19,1874,8
STAT,1888,15,na,1903,3060.0838590963235
SIM,1934,34,25-29,1968,16
STAT,1885,33,15-19,1918,0.1443278658950311
STAT,1770,92,na,1862,6.6337036449428375
STAT,1884,40,45-49,1924,1.525774732811722
SIM,1937,34,40-44,1971,4
SIM,1891,20,35-39,1911,12
STAT,1892,54,na,1946,2677.326984610765
SIM,1938,18,20-24,1956,131
STAT,1838,16,25-29,1854,5.532288224475335
STAT,1810,72,na,1882,562.9470910624955
STAT,1823,109,na,1932,3.9596496876981237E-4
STAT,1880,24,40-44,1904,2.219920149389108
STAT,1776,95,na,1871,2.3748878939094245
SIM,1820,37,30-34,1857,1
SIM,1940,19,20-24,1959,207
STAT,1863,79,na,1942,625.3158961887007
SIM,1858,45,30-34,1903,1
STAT,1923,16,45-49,1939,0.5999611638154242
SIM,1867,59,na,1926,1729
STAT,1937,33,30-34,1970,15.889662018549295
STAT,1857,27,15-19,1884,0.37232321645832717
STAT,1932,19,20-24,1951,182.0986627285506
STAT,1936,15,40-44,1951,1.3721744798151903
SIM,1821,33,40-44,1854,6
STAT,1908,26,20-24,1934,17.80646702470386
SIM,1856,81,na,1937,401
STAT,1869,50,20-24,1919,7.372272029104297E-4
STAT,1831,26,40-44,1857,3.0707374180375555
STAT,1845,53,30-34,1898,0.004576329456009055
SIM,1904,30,40-44,1934,14
SIM,1860,46,30-34,1906,1
STAT,1904,42,25-29,1946,0.06511719682415276
SIM,1901,18,25-29,1919,10
STAT,1876,30,45-49,1906,1.851759553266636
SIM,1884,30,45-49,1914,1
STAT,1914,24,50-100,1938,0.6815880558076928
STAT,1881,36,na,1917,2334.830883875528
STAT,1878,7,na,1885,2843.226687737383
STAT,1905,17,50-100,1922,0.07218191806590812
STAT,1914,40,na,1954,3780.988530787697
SIM,1852,49,45-49,1901,1
SIM,1892,40,45-49,1932,2
SIM,1911,25,30-34,1936,55
STAT,1849,17,15-19,1866,5.671283037968176
STAT,1875,26,15-19,1901,0.47666157596466574
STAT,1929,34,40-44,1963,5.063380602144593
SIM,1850,19,na,1869,2155
STAT,1847,53,40-44,1900,0.008077784179381611
SIM,1816,53,50-100,1869,1
STAT,1835,35,15-19,1870,0.05283283020317308
STAT,1897,41,25-29,1938,0.061101300437229916
STAT,1938,23,50-100,1961,0.664084541518494
SIM,1868,24,20-24,1892,72
SIM,1878,5,na,1883,2974
SIM,1848,20,30-34,1868,23
STAT,1835,48,na,1883,1744.3495967933343
STAT,1896,10,na,1906,3490.084670184961
SIM,1816,39,30-34,1855,3
STAT,1920,29,40-44,1949,5.180558835013223
STAT,1926,34,25-29,1960,11.386526660965668
STAT,1861,44,15-19,1905,0.011484112781005222
STAT,1859,43,20-24,1902,0.12845268802191762
STAT,1921,30,30-34,1951,18.035183195727537
SIM,1809,81,na,1890,124
SIM,1916,26,20-24,1942,1
SIM,1878,44,35-39,1922,1
STAT,1839,41,50-100,1880,0.8553328158962987
STAT,1832,104,na,1936,0.04457083159624643
SIM,1856,34,40-44,1890,6
STAT,1842,35,15-19,1877,0.052742360829768804
STAT,1891,49,30-34,1940,0.06752389501325314
STAT,1903,31,na,1934,3474.685915101845
SIM,1881,39,50-100,1920,5
SIM,1898,18,15-19,1916,11
STAT,1909,31,20-24,1940,2.3835691763128484
STAT,1843,96,na,1939,6.931776879441871
STAT,1856,51,25-29,1907,0.002850027682911496
STAT,1901,47,50-100,1948,0.19671525021298725
STAT,1913,20,30-34,1933,28.581496154329436
SIM,1895,30,20-24,1925,6
SIM,1872,28,na,1900,2489
SIM,1887,28,40-44,1915,1
SIM,1859,25,25-29,1884,9
STAT,1861,39,35-39,1900,5.902240794084419
SIM,1815,50,na,1865,1356
STAT,1841,95,na,1936,9.816796189797223
STAT,1907,34,20-24,1941,2.3049604247974322
SIM,1934,37,35-39,1971,4
STAT,1859,24,15-19,1883,2.748745314610502
SIM,1935,26,30-34,1961,71
SIM,1938,13,na,1951,3944
STAT,1831,37,40-44,1868,3.850725186813948
SIM,1847,21,na,1868,1851
STAT,1837,32,15-19,1869,0.11904587899497475
STAT,1911,45,35-39,1956,0.12508941165580081
STAT,1869,45,40-44,1914,0.17029735576767988
STAT,1874,82,na,1956,521.205102976004
STAT,1829,35,50-100,1864,1.103858943830999
SIM,1905,26,na,1931,3364
STAT,1896,15,35-39,1911,0.7427400750058352
STAT,1858,70,na,1928,1135.0977931890025
SIM,1797,69,na,1866,661
SIM,1832,22,na,1854,1950
SIM,1834,88,na,1922,34
SIM,1895,38,40-44,1933,6
SIM,1861,29,40-44,1890,7
STAT,1887,38,40-44,1925,4.979249434836574
STAT,1844,48,30-34,1892,0.0740689010759375
STAT,1877,17,15-19,1894,6.279264877187429
SIM,1867,24,15-19,1891,2
STAT,1906,41,45-49,1947,0.15501792811157908
STAT,1881,23,35-39,1904,5.73761793563777
STAT,1822,40,15-19,1862,0.022796804985703665
STAT,1926,37,35-39,1963,3.0156143582312716
SIM,1915,34,20-24,1949,4
STAT,1927,26,30-34,1953,48.757831820096925
STAT,1844,32,15-19,1876,0.13196414517435176
STAT,1922,31,50-100,1953,0.9570894653118129
STAT,1949,18,30-34,1967,14.458189863886528
SIM,1877,45,40-44,1922,1
STAT,1851,19,20-24,1870,17.574093687422533
STAT,1885,33,20-24,1918,2.7395061607478977
SIM,1859,102,na,1961,3
STAT,1923,42,35-39,1965,0.24013530669392283
SIM,1803,65,na,1868,723
STAT,1879,28,40-44,1907,3.183090489877197
STAT,1933,23,45-49,1956,1.521563673893857
STAT,1938,27,45-49,1965,1.745943092934816
SIM,1920,18,35-39,1938,5
STAT,1841,40,25-29,1881,0.5054766132614392
STAT,1916,36,20-24,1952,0.27680606487762377
SIM,1909,62,na,1971,2976
SIM,1929,17,na,1946,4956
STAT,1915,3,na,1918,4317.764035599821
SIM,1806,79,na,1885,390
STAT,1799,107,na,1906,0.0015302746139330687
SIM,1860,34,30-34,1894,23
STAT,1901,24,na,1925,3352.807699485207
SIM,1941,24,20-24,1965,109
STAT,1898,47,15-19,1945,3.0982155047502765E-4
STAT,1863,57,na,1920,1797.517909132654
STAT,1958,2,na,1960,5270.97352058673
STAT,1928,41,40-44,1969,0.3257150387427217
STAT,1830,42,30-34,1872,0.9917546701697261
STAT,1846,37,40-44,1883,3.269066590724662
SIM,1842,25,15-19,1867,3
STAT,1902,49,40-44,1951,0.136030733085857
STAT,1852,34,30-34,1886,14.263903196903373
STAT,1869,36,na,1905,2331.5900953886944
STAT,1953,16,30-34,1969,15.044775474895207
SIM,1909,20,15-19,1929,8
SIM,1910,49,40-44,1959,1
STAT,1931,19,15-19,1950,60.25699714957233
STAT,1924,21,45-49,1945,1.358665417896127
STAT,1839,31,35-39,1870,8.69072122980353
SIM,1796,78,na,1874,311
STAT,1858,19,15-19,1877,5.542447871797049
SIM,1893,33,20-24,1926,4
SIM,1882,24,40-44,1906,1
SIM,1898,39,na,1937,3608
STAT,1902,30,20-24,1932,3.9200015733048543
SIM,1854,48,40-44,1902,1
SIM,1854,37,40-44,1891,9
STAT,1914,23,40-44,1937,3.4940257135511428
STAT,1935,31,30-34,1966,22.241638098138697
SIM,1850,48,50-100,1898,1
SIM,1936,31,30-34,1967,14
STAT,1875,42,na,1917,2416.913371761797
STAT,1898,70,na,1968,2272.8224633257787
STAT,1934,17,na,1951,5077.173992512405
STAT,1860,15,na,1875,2217.317837136153
STAT,1863,41,15-19,1904,0.012408116772820282
STAT,1905,48,15-19,1953,3.2825827145698954E-4
STAT,1834,25,15-19,1859,0.40617399255514874
STAT,1834,82,na,1916,313.551577476694
SIM,1818,64,na,1882,945
STAT,1847,33,na,1880,1963.8379214661304
STAT,1851,54,na,1905,1727.5509195927143
SIM,1902,20,20-24,1922,116
STAT,1859,43,15-19,1902,0.011169799561718168
STAT,1863,32,25-29,1895,9.161515084499493
STAT,1891,30,35-39,1921,12.893275057111055
SIM,1851,60,na,1911,1537
STAT,1855,81,na,1936,419.1997132059056
SIM,1839,21,35-39,1860,5
SIM,1847,31,35-39,1878,12
STAT,1890,46,45-49,1936,0.1665214873770652
STAT,1905,29,15-19,1934,0.6636825597999557
SIM,1860,80,na,1940,666
STAT,1840,22,35-39,1862,5.340132340925056
SIM,1880,57,na,1937,1882
STAT,1895,19,na,1914,3343.581782838262
SIM,1866,19,50-100,1885,1
SIM,1914,49,na,1963,3702
SIM,1823,94,na,1917,7
STAT,1910,42,25-29,1952,0.06883164638127308
STAT,1896,22,50-100,1918,0.5494378131364799
STAT,1818,42,20-24,1860,0.40663512384390277
STAT,1883,1,na,1884,3344.764418670174
STAT,1920,48,50-100,1968,0.25443679014732856
SIM,1929,39,na,1968,5131
SIM,1944,15,40-44,1959,1
SIM,1953,2,na,1955,4777
SIM,1866,19,15-19,1885,4
STAT,1876,31,15-19,1907,0.15062949020836208
SIM,1846,27,40-44,1873,4
STAT,1831,48,20-24,1879,0.009688730336479972
SIM,1852,32,20-24,1884,4
STAT,1878,33,15-19,1911,0.15057905108944042
SIM,1840,66,na,1906,1094
SIM,1838,19,na,1857,2013
SIM,1841,23,40-44,1864,6
STAT,1849,99,na,1948,1.4703236246949123
STAT,1880,48,40-44,1928,0.18122539024691736
SIM,1866,40,35-39,1906,6
SIM,1909,16,na,1925,3762
STAT,1865,49,20-24,1914,0.010878848632930687
SIM,1908,31,na,1939,3878
STAT,1860,45,20-24,1905,0.010031594924079314
STAT,1815,50,25-29,1865,0.009475645742514948
STAT,1820,38,35-39,1858,16.25938441823785
STAT,1916,23,na,1939,3892.895655954241
STAT,1930,32,25-29,1962,12.165486008581645
STAT,1827,39,40-44,1866,5.3951929829256855
SIM,1835,39,40-44,1874,9
STAT,1933,24,20-24,1957,150.31522376457778
STAT,1911,26,35-39,1937,14.986042007097675
STAT,1914,7,na,1921,4205.038379433323
SIM,1926,34,na,1960,4873
STAT,1913,33,45-49,1946,1.5904156267752225
SIM,1820,37,na,1857,1776
SIM,1887,17,25-29,1904,10
STAT,1924,48,25-29,1972,0.06425117363285505
SIM,1921,33,45-49,1954,6
SIM,1901,18,30-34,1919,6
STAT,1833,23,40-44,1856,1.9676301740898408
STAT,1838,27,40-44,1865,2.799771536703469
STAT,1844,32,20-24,1876,2.5048287554247888
STAT,1931,12,na,1943,5289.211408802275
SIM,1873,40,35-39,1913,2
STAT,1872,49,20-24,1921,0.012012985664713004
STAT,1902,55,na,1957,3016.4969223308744
STAT,1808,102,na,1910,0.09760078326186429
STAT,1929,15,40-44,1944,1.8291052822383422
STAT,1865,23,50-100,1888,0.3794200908541518
SIM,1902,39,40-44,1941,2
STAT,1846,85,na,1931,196.0394976100823
STAT,1802,101,na,1903,0.18106200465106853
SIM,1871,9,na,1880,2600
STAT,1882,41,25-29,1923,0.6411128118851488
STAT,1884,25,na,1909,2425.0176640708523
STAT,1948,15,45-49,1963,0.5835705447182422
SIM,1837,43,35-39,1880,1
STAT,1860,15,15-19,1875,5.732570704570129
STAT,1788,80,na,1868,277.45264487101645
STAT,1878,56,na,1934,2165.808283139061
STAT,1864,16,35-39,1880,0.5691598386700419
STAT,1894,39,50-100,1933,1.5948517451243172
STAT,1865,40,35-39,1905,1.6935554818156413
STAT,1871,46,40-44,1917,0.17349300086706365
SIM,1900,26,25-29,1926,74
STAT,1850,48,30-34,1898,0.07189852445238275
STAT,1884,41,15-19,1925,0.014001087156310323
SIM,1918,15,30-34,1933,3
STAT,1858,27,na,1885,1976.4648961928638
STAT,1837,42,25-29,1879,0.5052205236879592
STAT,1942,26,20-24,1968,19.555130230844895
STAT,1863,24,50-100,1887,0.36669488591207544
STAT,1934,16,20-24,1950,187.46969717506184
STAT,1896,34,35-39,1930,13.527916503046436
SIM,1818,42,na,1860,1463
STAT,1866,41,50-100,1907,0.9985877466982811
STAT,1912,18,35-39,1930,0.8633168981970853
SIM,1879,60,na,1939,2328
STAT,1829,43,35-39,1872,1.4990194352508905
SIM,1864,33,na,1897,2147
STAT,1926,17,50-100,1943,0.46860559054594514
STAT,1916,34,50-100,1950,0.8636296327931972
STAT,1892,76,na,1968,1612.3804977885382
STAT,1947,18,20-24,1965,155.76704221789328
STAT,1850,26,50-100,1876,0.5703474319701369
STAT,1818,49,40-44,1867,0.37682152197752106
SIM,1863,33,35-39,1896,17
STAT,1886,43,15-19,1929,0.014804300006213923
STAT,1893,47,30-34,1940,0.07033517567605335
SIM,1849,40,35-39,1889,1
SIM,1850,29,20-24,1879,10
SIM,1858,79,na,1937,573
SIM,1847,44,40-44,1891,5
STAT,1848,30,25-29,1878,9.479851564932106
STAT,1878,47,na,1925,2377.880962447752
SIM,1854,89,na,1943,92
STAT,1895,43,25-29,1938,0.058924618713069185
STAT,1926,44,35-39,1970,0.2524047826331959
SIM,1861,25,25-29,1886,58
STAT,1815,47,na,1862,1570.0271771263804
STAT,1842,29,20-24,1871,11.214213035258668
SIM,1896,19,na,1915,3455
STAT,1835,42,15-19,1877,0.012333792175261343
STAT,1867,45,30-34,1912,0.09363269281491622
STAT,1935,27,35-39,1962,20.870693951243346
STAT,1835,61,na,1896,1392.2566136770076
SIM,1855,34,na,1889,1814
STAT,1844,25,15-19,1869,0.43664001111131695
STAT,1912,48,na,1960,3591.722330063977
STAT,1813,48,45-49,1861,0.5832631675129476
STAT,1861,93,na,1954,24.636078708328018
STAT,1855,33,35-39,1888,7.910840506812777
STAT,1809,49,30-34,1858,0.41636972775006764
STAT,1830,45,40-44,1875,0.14581689961180747
STAT,1861,32,50-100,1893,0.7723659021922562
STAT,1851,29,30-34,1880,23.977173340674728
SIM,1890,16,na,1906,3291
STAT,1905,40,50-100,1945,0.10917842309159029
STAT,1872,56,na,1928,2085.3822966072757
SIM,1943,27,35-39,1970,26
SIM,1923,23,na,1946,4144
STAT,1904,19,45-49,1923,0.09499362433767011
SIM,1857,2,na,1859,2898
SIM,1803,74,na,1877,307
STAT,1828,97,na,1925,2.958315136808976
SIM,1904,32,30-34,1936,16
STAT,1823,42,na,1865,1533.0613335857026
SIM,1854,21,25-29,1875,71
STAT,1804,84,na,1888,114.30420448507468
SIM,1889,22,na,1911,3027
STAT,1884,41,na,1925,2343.248994642734
SIM,1904,41,na,1945,3637
STAT,1762,109,na,1871,0.002940243088859547
STAT,1896,38,50-100,1934,1.645998595435932
SIM,1930,22,30-34,1952,78
SIM,1843,39,30-34,1882,12
STAT,1939,22,40-44,1961,3.4447326648039236
SIM,1866,96,na,1962,17
SIM,1836,40,25-29,1876,3
STAT,1810,54,20-24,1864,0.0021226986795105313
STAT,1930,33,45-49,1963,2.0699121871578594
SIM,1950,17,25-29,1967,102
SIM,1821,84,na,1905,125
STAT,1850,23,40-44,1873,1.8678290352938611
STAT,1942,17,25-29,1959,46.203687298554726
SIM,1883,31,na,1914,2453
STAT,1828,52,25-29,1880,0.002675431407411828
SIM,1841,39,na,1880,1834
STAT,1897,29,na,1926,3232.038742992917
SIM,1825,77,na,1902,492
SIM,1852,39,40-44,1891,7
SIM,1935,30,na,1965,5340
SIM,1906,40,40-44,1946,1
STAT,1841,79,na,1920,516.18622636582
STAT,1868,21,45-49,1889,0.6843610855389672
STAT,1901,7,na,1908,3716.7468637705556
STAT,1835,39,30-34,1874,4.810312168972065
SIM,1895,22,25-29,1917,75
STAT,1797,97,na,1894,1.3528137818619426
STAT,1893,35,30-34,1928,6.962758300791378
SIM,1868,27,25-29,1895,42
STAT,1922,22,30-34,1944,33.630649603222054
STAT,1924,30,40-44,1954,4.67909674414746
SIM,1885,78,na,1963,1023
STAT,1915,48,15-19,1963,3.7772899620908465E-4
SIM,1916,29,30-34,1945,59
STAT,1921,33,35-39,1954,10.333642269001711
SIM,1881,88,na,1969,315
STAT,1869,53,25-29,1922,0.003432545812278768
STAT,1937,23,50-100,1960,0.6533740044209635
SIM,1947,22,40-44,1969,10
STAT,1844,39,40-44,1883,3.5109229753690023
STAT,1814,99,na,1913,0.882517794760944
SIM,1865,20,30-34,1885,27
SIM,1891,63,na,1954,2247
STAT,1826,87,na,1913,102.75580050180476
SIM,1859,27,na,1886,2268
STAT,1827,32,na,1859,1868.270728879029
SIM,1878,84,na,1962,470
STAT,1907,33,45-49,1940,1.49350903164701
STAT,1909,37,35-39,1946,2.3349150792490776
STAT,1861,32,15-19,1893,0.120045146351451
STAT,1831,29,45-49,1860,1.0438245728955142
SIM,1923,45,na,1968,4229
SIM,1909,8,na,1917,3810
SIM,1856,30,25-29,1886,11
STAT,1924,8,na,1932,4845.720493011645
STAT,1905,60,na,1965,3023.9348605952564
STAT,1861,48,30-34,1909,0.08057402745300325
STAT,1848,49,na,1897,1712.3605404097239
SIM,1880,39,50-100,1919,6
SIM,1918,26,50-100,1944,1
STAT,1836,50,50-100,1886,0.009896571118970842
SIM,1931,3,na,1934,5269
STAT,1870,22,20-24,1892,68.72385956677088
STAT,1910,18,25-29,1928,8.73478952918162
SIM,1932,30,40-44,1962,3
SIM,1909,19,na,1928,3751
STAT,1837,21,50-100,1858,0.3584991789143335
SIM,1902,23,30-34,1925,28
SIM,1892,29,na,1921,3432
STAT,1887,22,25-29,1909,65.43936995929424
SIM,1915,33,45-49,1948,3
STAT,1880,39,45-49,1919,2.1155680539050574
STAT,1797,94,na,1891,5.032803802337117
STAT,1872,53,na,1925,2166.115651951374
STAT,1908,29,30-34,1937,37.50080750638795
STAT,1845,42,15-19,1887,0.010987930009310577
SIM,1907,39,25-29,1946,2
STAT,1885,26,15-19,1911,0.4633534929779652
STAT,1830,33,40-44,1863,4.076124641269864
SIM,1835,28,50-100,1863,2
SIM,1929,28,20-24,1957,1
STAT,1821,42,50-100,1863,1.8330914665878681
SIM,1886,48,50-100,1934,1
STAT,1890,37,50-100,1927,1.5314088038667575
SIM,1821,87,na,1908,43
SIM,1946,24,40-44,1970,4
SIM,1916,17,30-34,1933,1
STAT,1839,18,50-100,1857,0.04396982641163165
STAT,1852,46,30-34,1898,0.0782036447443489
STAT,1867,54,50-100,1921,0.01406662112833678
STAT,1870,34,15-19,1904,0.14080196076466964
SIM,1877,41,25-29,1918,1
SIM,1893,26,15-19,1919,1
STAT,1825,39,30-34,1864,7.64199034105561
STAT,1917,47,50-100,1964,0.2410873601634438
SIM,1833,39,30-34,1872,8
STAT,1867,30,35-39,1897,9.776974279200953
STAT,1869,41,25-29,1910,0.6353276352675897
STAT,1881,11,na,1892,2550.871190891908
STAT,1839,20,50-100,1859,0.36685906832691306
SIM,1828,31,25-29,1859,14
STAT,1853,25,25-29,1878,41.686516387442346
STAT,1935,20,15-19,1955,7.3974864630558566
STAT,1839,44,40-44,1883,1.5946940799566607
SIM,1877,37,na,1914,2421
SIM,1931,40,na,1971,4919
STAT,1804,87,na,1891,59.44688961262249
STAT,1857,20,30-34,1877,16.62095519213607
STAT,1917,44,25-29,1961,0.07579585631772837
SIM,1771,92,na,1863,2
SIM,1924,27,25-29,1951,5
SIM,1827,84,na,1911,112
STAT,1905,24,45-49,1929,1.0209632761080591
SIM,1889,25,na,1914,3092
STAT,1811,45,30-34,1856,0.27851570699319833
SIM,1839,30,30-34,1869,9
STAT,1861,29,30-34,1890,21.07582451690407
STAT,1813,41,25-29,1854,2.436481425498173
SIM,1830,43,25-29,1873,3
STAT,1921,46,40-44,1967,0.18181890756389954
SIM,1918,4,na,1922,4643
STAT,1836,54,40-44,1890,0.006373171997904597
SIM,1807,55,na,1862,1146
STAT,1925,17,30-34,1942,15.02214123153261
SIM,1809,68,na,1877,541
SIM,1809,84,na,1893,52
SIM,1897,31,25-29,1928,19
SIM,1891,23,45-49,1914,2
SIM,1822,47,na,1869,1347
STAT,1819,54,40-44,1873,0.01927484429879762
STAT,1898,21,30-34,1919,24.647166325244502
STAT,1889,31,25-29,1920,12.959899382228521
SIM,1873,21,35-39,1894,11
STAT,1938,24,40-44,1962,3.3922840451554643
SIM,1909,2,na,1911,3887
STAT,1847,89,na,1936,81.92210343909967
STAT,1826,107,na,1933,0.002750536090024956
SIM,1932,39,50-100,1971,1
STAT,1865,34,40-44,1899,3.9810000141630026
STAT,1873,19,na,1892,2598.0988912917073
SIM,1834,32,na,1866,1801
STAT,1884,0,na,1884,3556.292112924047
STAT,1920,35,35-39,1955,2.7072126795828844
SIM,1836,61,na,1897,1485
SIM,1933,17,30-34,1950,20
STAT,1911,30,30-34,1941,15.774962766387755
STAT,1968,3,na,1971,5011.27029779372
STAT,1961,7,na,1968,5178.6328195700835
STAT,1883,23,45-49,1906,0.695837988722923
STAT,1911,23,25-29,1934,89.08182508944843
STAT,1916,27,25-29,1943,69.44975769708964
SIM,1895,47,50-100,1942,1
SIM,1927,25,50-100,1952,1
SIM,1913,24,45-49,1937,2
SIM,1918,18,35-39,1936,8
STAT,1820,47,30-34,1867,0.17655975270143628
STAT,1896,66,na,1962,2385.343679400029
SIM,1866,42,50-100,1908,1
STAT,1882,19,15-19,1901,5.866581588408975
STAT,1854,37,na,1891,1803.1580047826462
STAT,1870,29,40-44,1899,2.966012885527271
STAT,1904,40,40-44,1944,0.23067069022579897
STAT,1934,19,30-34,1953,16.722855421349134
STAT,1886,45,40-44,1931,0.1867068446045254
STAT,1935,33,20-24,1968,3.439249905562146
SIM,1867,22,na,1889,2106
SIM,1830,31,25-29,1861,12
SIM,1889,39,50-100,1928,5
STAT,1936,21,na,1957,3562.0946204945326
SIM,1894,45,40-44,1939,1
STAT,1865,21,35-39,1886,5.508316320065989
STAT,1880,32,25-29,1912,10.98037515036662
STAT,1934,32,50-100,1966,1.1512055451457646
STAT,1916,39,25-29,1955,1.0185898990077842
SIM,1924,39,25-29,1963,3
SIM,1858,64,na,1922,1385
SIM,1876,36,25-29,1912,5
STAT,1826,44,30-34,1870,0.9102385036011886
STAT,1880,20,25-29,1900,61.735153209286054
SIM,1829,30,50-100,1859,1
SIM,1858,45,na,1903,1889
SIM,1940,5,na,1945,4181
STAT,1874,66,na,1940,1707.1304443909178
SIM,1868,15,25-29,1883,9
STAT,1868,36,25-29,1904,2.818898246641582
SIM,1942,19,30-34,1961,31
STAT,1860,68,na,1928,1264.9108952373886
STAT,1822,43,25-29,1865,0.9706723280211755
STAT,1910,44,15-19,1954,0.0014620700028930623
STAT,1840,91,na,1931,41.69913005372673
STAT,1862,53,30-34,1915,0.005086197216136788
STAT,1861,16,na,1877,2237.218653366881
STAT,1886,51,na,1937,2336.204873201207
STAT,1915,43,20-24,1958,0.01811484727534336
STAT,1863,44,25-29,1907,0.5666254340136854
STAT,1891,29,na,1920,2992.631066486823
STAT,1930,30,50-100,1960,1.0894864636660027
STAT,1836,24,na,1860,1731.2061511889895
SIM,1911,20,na,1931,3816
SIM,1932,2,na,1934,5661
SIM,1834,44,30-34,1878,4
STAT,1816,39,20-24,1855,2.1219995588277256
STAT,1845,26,50-100,1871,0.6127718824392938
SIM,1928,22,30-34,1950,56
STAT,1866,22,na,1888,2243.6111707353534
STAT,1936,18,45-49,1954,0.48651779944770973
SIM,1854,71,na,1925,1092
STAT,1845,44,40-44,1889,1.7443842776178313
STAT,1919,18,45-49,1937,0.5618579555463826
SIM,1843,49,na,1892,1667
STAT,1902,33,25-29,1935,14.673292927685166
SIM,1910,33,25-29,1943,12
SIM,1833,72,na,1905,799
STAT,1879,31,50-100,1910,0.9810358438872707
STAT,1861,90,na,1951,66.46009412387023
STAT,1832,54,40-44,1886,0.007067445927133736
STAT,1827,35,25-29,1862,3.9351883270255654
STAT,1942,29,25-29,1971,70.41065612420691
SIM,1824,39,20-24,1863,3
SIM,1944,18,45-49,1962,1
STAT,1835,50,50-100,1885,0.011935959127952197
SIM,1851,34,50-100,1885,1
STAT,1846,21,25-29,1867,50.87661606858274
SIM,1917,34,30-34,1951,26
STAT,1894,26,25-29,1920,55.6991860005599
SIM,1873,53,na,1926,2114
SIM,1853,24,na,1877,1998
STAT,1924,45,20-24,1969,0.013486153822369309
SIM,1871,44,25-29,1915,1
STAT,1836,18,40-44,1854,0.2125381801457821
STAT,1838,72,na,1910,927.9147505731628
SIM,1917,11,na,1928,4248
SIM,1907,17,20-24,1924,36
SIM,1821,41,25-29,1862,1
STAT,1908,48,50-100,1956,0.20800382235970738
SIM,1866,74,na,1940,1214
STAT,1796,109,na,1905,1.547726591304815E-4
STAT,1896,44,na,1940,3082.6323220624768
STAT,1911,35,25-29,1946,0.9792685858453034
SIM,1889,21,30-34,1910,29
SIM,1891,66,na,1957,2104
SIM,1933,29,25-29,1962,11
SIM,1871,32,25-29,1903,12
STAT,1762,106,na,1868,0.011947210728508725
STAT,1854,49,45-49,1903,0.17685240487335724
SIM,1944,22,na,1966,3883
STAT,1915,19,20-24,1934,28.80008639984446
SIM,1790,84,na,1874,67
SIM,1923,19,20-24,1942,159
SIM,1862,49,45-49,1911,1
STAT,1876,17,50-100,1893,0.051609484613608925
STAT,1825,44,50-100,1869,1.3834990853683384
STAT,1950,20,40-44,1970,4.072177295786855
STAT,1925,29,25-29,1954,78.7484693392255
STAT,1877,15,25-29,1892,6.023743591700257
STAT,1823,76,na,1899,527.2802167975417
STAT,1903,41,50-100,1944,0.10686862686801359
SIM,1783,80,na,1863,170
STAT,1813,45,40-44,1858,0.4449797846447022
STAT,1915,41,na,1956,3821.033399847524
SIM,1881,82,na,1963,664
SIM,1884,40,50-100,1924,1
STAT,1850,47,50-100,1897,0.1838802317663555
STAT,1817,54,30-34,1871,0.012250578999571523
STAT,1879,15,35-39,1894,0.5878372861378626
STAT,1819,50,25-29,1869,0.007022662278172998
SIM,1898,36,na,1934,3625
SIM,1818,79,na,1897,258
STAT,1879,21,20-24,1900,73.7070407276663
STAT,1841,18,15-19,1859,5.618073651466484
STAT,1899,58,na,1957,2807.5471577048643
SIM,1819,43,na,1862,1477
STAT,1877,19,40-44,1896,0.19248931228565752
SIM,1857,82,na,1939,310
SIM,1932,37,na,1969,5308
STAT,1844,44,15-19,1888,0.010682747306281716
STAT,1901,16,25-29,1917,8.103891309066915
SIM,1846,33,35-39,1879,19
SIM,1873,34,40-44,1907,9
STAT,1842,22,45-49,1864,0.6897298655021658
SIM,1887,21,20-24,1908,82
SIM,1834,35,na,1869,1832
STAT,1865,30,25-29,1895,9.559887307863049
STAT,1870,25,25-29,1895,42.47183024470582
STAT,1930,23,35-39,1953,12.264606692971022
STAT,1911,25,50-100,1936,0.996845051220825
STAT,1849,29,15-19,1878,0.4115692164406778
STAT,1862,78,na,1940,678.5093464252079
STAT,1808,68,na,1876,659.2666761443936
STAT,1893,15,50-100,1908,0.06369724461516439
STAT,1926,46,25-29,1972,0.06693704198055743
SIM,1875,30,35-39,1905,5
STAT,1884,45,30-34,1929,0.09867256976986295
STAT,1876,40,50-100,1916,1.1241269983415119
SIM,1778,87,na,1865,99
SIM,1845,75,na,1920,840
SIM,1793,79,na,1872,197
STAT,1863,42,na,1905,2064.7472100266878
STAT,1858,40,35-39,1898,1.4797442346251968
SIM,1921,19,na,1940,5141
STAT,1930,30,40-44,1960,5.156689609320756
STAT,1903,34,na,1937,3460.100412098965
SIM,1807,58,na,1865,1092
SIM,1882,20,25-29,1902,83
STAT,1853,22,20-24,1875,68.27308937802081
SIM,1808,80,na,1888,225
STAT,1851,38,na,1889,1944.243448975693
SIM,1902,26,35-39,1928,22
STAT,1838,33,35-39,1871,9.150551192603668
STAT,1909,34,30-34,1943,15.202115808848589
SIM,1843,31,na,1874,2072
STAT,1886,41,25-29,1927,0.6965464468672561
SIM,1906,19,20-24,1925,30
SIM,1837,21,25-29,1858,50
STAT,1828,35,50-100,1863,1.1255684106605504
STAT,1909,43,20-24,1952,0.01674549247419874
STAT,1925,18,na,1943,4524.481407482428
STAT,1820,35,30-34,1855,14.493285030566701
STAT,1835,23,15-19,1858,3.245235640887513
STAT,1900,19,50-100,1919,0.06890056230444278
STAT,1893,55,na,1948,2675.924199550604
STAT,1826,40,15-19,1866,0.011726878455647726
STAT,1844,35,25-29,1879,2.645228900157579
STAT,1924,33,45-49,1957,1.871871805167427
SIM,1843,23,15-19,1866,7
STAT,1847,16,35-39,1863,0.5372137153706862
SIM,1908,15,na,1923,4082
STAT,1910,15,20-24,1925,27.52613728516535
STAT,1932,36,15-19,1968,0.026337032484142237
SIM,1861,22,20-24,1883,79
SIM,1856,3,na,1859,3189
STAT,1880,36,40-44,1916,4.715399407496153
SIM,1861,68,na,1929,1477
SIM,1855,16,35-39,1871,1
SIM,1865,12,na,1877,2625
SIM,1932,33,45-49,1965,5
STAT,1900,32,20-24,1932,3.8219892066580243
SIM,1878,22,25-29,1900,2
STAT,1818,39,30-34,1857,15.976027692009207
SIM,1870,64,na,1934,1854
SIM,1791,69,na,1860,682
SIM,1872,23,35-39,1895,8
STAT,1927,17,50-100,1944,0.47519181982545283
STAT,1884,59,na,1943,1961.5045752326016
STAT,1773,84,na,1857,101.242296648187
STAT,1900,42,na,1942,3275.2256689721034
STAT,1904,33,35-39,1937,8.465978886813875
SIM,1842,83,na,1925,382
STAT,1860,12,na,1872,2278.9041501189895
STAT,1843,44,30-34,1887,0.9314056859002763
STAT,1891,45,15-19,1936,2.878152378293218E-4
STAT,1961,10,na,1971,5176.768734945225
STAT,1898,34,45-49,1932,2.385097538131404
SIM,1829,26,35-39,1855,17
SIM,1845,72,na,1917,1094
STAT,1847,86,na,1933,173.02193554434925
STAT,1918,20,15-19,1938,5.893715700070468
STAT,1871,53,40-44,1924,0.010467637406768895
SIM,1846,20,20-24,1866,71
SIM,1865,23,35-39,1888,7
STAT,1828,42,15-19,1870,0.01129159981870524
STAT,1895,33,15-19,1928,0.18874628787969497
SIM,1845,97,na,1942,3
SIM,1938,31,50-100,1969,1
STAT,1857,23,35-39,1880,5.328740002846727
STAT,1795,68,na,1863,638.0454294124876
SIM,1926,39,35-39,1965,9
STAT,1840,19,45-49,1859,0.06014507542887643
STAT,1883,32,50-100,1915,0.9171301302002268
SIM,1851,44,30-34,1895,3
STAT,1913,46,15-19,1959,3.677069268734733E-4
STAT,1907,48,50-100,1955,0.2049081015540991
STAT,1906,46,15-19,1952,3.3598159375989705E-4
STAT,1903,56,na,1959,3041.3489418982635
STAT,1946,15,35-39,1961,4.750973357539443
STAT,1864,23,35-39,1887,5.339763991859751
SIM,1826,39,30-34,1865,11
SIM,1839,43,45-49,1882,4
STAT,1824,39,na,1863,1549.7401708410528
STAT,1839,38,na,1877,1748.1678886258667
STAT,1821,52,30-34,1873,0.009007820252887365
STAT,1885,26,na,1911,2437.2882716706426
STAT,1775,101,na,1876,0.12443079933520276
SIM,1915,30,40-44,1945,8
SIM,1891,32,50-100,1923,2
STAT,1802,107,na,1909,0.0014963980706848435
STAT,1852,30,15-19,1882,0.12127546342973938
STAT,1900,45,na,1945,3213.4739546267247
STAT,1893,20,35-39,1913,7.597025224989554
SIM,1915,48,50-100,1963,1
STAT,1841,48,20-24,1889,0.008787097189651998
STAT,1918,39,35-39,1957,2.5960820662466597
SIM,1908,37,na,1945,3884
STAT,1881,17,40-44,1898,0.18039315336846853
STAT,1935,24,30-34,1959,39.886249777177234
STAT,1854,17,50-100,1871,0.04485435386756416
STAT,1845,20,na,1865,2104.07244673398
STAT,1908,17,30-34,1925,2.410965135681948
STAT,1852,18,50-100,1870,0.047453815904925284
STAT,1830,48,45-49,1878,0.19333482794445989
SIM,1843,46,na,1889,1721
SIM,1912,33,35-39,1945,2
SIM,1857,60,na,1917,1586
STAT,1913,32,30-34,1945,15.991243803931749
STAT,1802,58,na,1860,922.5596664526084
STAT,1929,22,40-44,1951,4.336766359521426
STAT,1863,106,na,1969,0.12063229837536156
STAT,1888,17,35-39,1905,0.6617543115327548
STAT,1859,36,15-19,1895,0.04597015877986593
STAT,1839,40,25-29,1879,0.5266119556753108
STAT,1907,30,40-44,1937,3.759934255786901
STAT,1911,33,35-39,1944,9.038600842895223
SIM,1921,32,30-34,1953,35
SIM,1943,24,30-34,1967,29
STAT,1857,26,na,1883,1972.6228425827555
STAT,1888,18,na,1906,3037.9516728579893
STAT,1848,34,na,1882,1928.0629241003778
SIM,1864,29,15-19,1893,1
SIM,1891,41,na,1932,2983
SIM,1867,78,na,1945,604
STAT,1824,33,40-44,1857,7.675779291887486
STAT,1904,43,45-49,1947,0.1508544887008687
STAT,1880,54,50-100,1934,0.015745364023082707
STAT,1892,31,50-100,1923,1.1762640373822228
STAT,1818,52,50-100,1870,0.03286919202354874
SIM,1892,26,na,1918,3474
STAT,1820,45,40-44,1865,0.3215353873777968
STAT,1928,43,30-34,1971,0.16597973285039166
SIM,1905,23,40-44,1928,3
SIM,1837,37,40-44,1874,4
STAT,1936,16,50-100,1952,0.3667453945977046
SIM,1832,33,40-44,1865,6
SIM,1876,33,20-24,1909,2
STAT,1920,16,35-39,1936,4.816121956468617
STAT,1867,41,15-19,1908,0.013285956733864979
SIM,1862,46,40-44,1908,1
STAT,1854,42,25-29,1896,0.4908727610928981
SIM,1870,42,na,1912,2578
STAT,1868,33,20-24,1901,2.6226576667251016
SIM,1865,49,na,1914,2103
STAT,1854,46,40-44,1900,0.13140072523159096
SIM,1954,15,35-39,1969,10
STAT,1881,30,na,1911,2372.4829540353126
SIM,1894,23,50-100,1917,1
SIM,1859,29,40-44,1888,3
SIM,1810,44,na,1854,1658
STAT,1912,32,50-100,1944,0.8299319481732375
STAT,1782,80,na,1862,236.1128146798474
STAT,1946,25,45-49,1971,1.9651645931685413
STAT,1851,25,15-19,1876,0.4446298687403249
SIM,1924,24,20-24,1948,177
SIM,1839,33,35-39,1872,2
STAT,1852,41,50-100,1893,0.8549303040976853
SIM,1887,34,35-39,1921,21
STAT,1880,41,15-19,1921,0.014871533345575056
SIM,1901,42,na,1943,3490
STAT,1880,22,15-19,1902,3.5366514515119802
STAT,1898,24,35-39,1922,7.999954074927557
STAT,1829,37,40-44,1866,3.827523636033158
SIM,1894,55,na,1949,2743
STAT,1869,25,50-100,1894,0.6343128148725174
STAT,1838,20,20-24,1858,66.64550192216899
STAT,1916,24,20-24,1940,118.1589922193198
SIM,1926,20,15-19,1946,6
STAT,1801,73,na,1874,488.64616507319147
STAT,1859,74,na,1933,904.1613568745493
SIM,1929,17,40-44,1946,3
STAT,1811,48,35-39,1859,0.38215156593352523
STAT,1896,28,40-44,1924,4.021876333729675
STAT,1870,15,15-19,1885,6.0456924513831245
SIM,1910,56,na,1966,3323
SIM,1886,19,25-29,1905,12
SIM,1888,77,na,1965,1251
STAT,1874,63,na,1937,1858.4632389891012
STAT,1882,49,20-24,1931,0.0116775056870259
STAT,1848,12,na,1860,2300.3884962698653
SIM,1897,22,35-39,1919,12
STAT,1893,31,15-19,1924,0.18504953917355155
STAT,1925,46,50-100,1971,0.28031969761395453
STAT,1912,30,na,1942,3826.9254806085446
STAT,1920,22,20-24,1942,126.15121991070212
SIM,1886,11,na,1897,2910
STAT,1856,48,50-100,1904,0.19420608168867912
SIM,1930,29,15-19,1959,1
STAT,1903,28,35-39,1931,13.943281266355008
SIM,1933,26,20-24,1959,36
SIM,1812,43,40-44,1855,2
SIM,1911,28,35-39,1939,1
STAT,1922,29,15-19,1951,0.8092662175719083
STAT,1838,75,na,1913,756.3994773848548
SIM,1845,18,25-29,1863,11
STAT,1832,50,25-29,1882,0.002573875390402754
STAT,1889,22,35-39,1911,7.353543033088988
SIM,1809,65,na,1874,614
SIM,1948,18,20-24,1966,235
STAT,1833,35,na,1868,1794.9476450283114
STAT,1791,94,na,1885,3.8863871650488253
STAT,1837,54,25-29,1891,0.0022966723852275743
STAT,1871,34,40-44,1905,4.344838830898694
STAT,1939,32,na,1971,3936.576498433074
STAT,1861,46,40-44,1907,0.14472590312990571
STAT,1939,25,45-49,1964,1.773274405620168
STAT,1904,19,na,1923,3672.7997522778332
STAT,1925,26,20-24,1951,22.07200927221417
SIM,1836,35,50-100,1871,3
SIM,1848,86,na,1934,209
STAT,1879,34,35-39,1913,10.706590356239962
STAT,1853,64,na,1917,1457.6112459945127
STAT,1874,30,35-39,1904,10.63275169030601
STAT,1866,17,15-19,1883,5.731764005719031
SIM,1931,0,na,1931,5486
STAT,1837,18,25-29,1855,5.794586410537315
STAT,1869,11,na,1880,2631.472883788467
STAT,1832,49,50-100,1881,0.17293765482032258
STAT,1836,49,na,1885,1428.422658757283
SIM,1828,57,na,1885,1335
SIM,1890,19,na,1909,3324
SIM,1833,87,na,1920,94
STAT,1886,23,50-100,1909,0.43897637686026747
STAT,1809,52,15-19,1861,1.0448017173491156E-4
STAT,1827,32,20-24,1859,4.174363404888867
STAT,1900,37,15-19,1937,0.017137733731052984
STAT,1936,0,na,1936,4399.21510625829
SIM,1922,41,na,1963,4308
STAT,1816,72,na,1888,595.2104507933317
SIM,1812,88,na,1900,80
STAT,1885,45,15-19,1930,4.1116989886098653E-4
STAT,1913,45,45-49,1958,0.2174277848607308
STAT,1911,39,40-44,1950,1.4600194403595732
SIM,1826,49,40-44,1875,1
SIM,1882,30,35-39,1912,2
STAT,1893,30,45-49,1923,2.274901491854017
STAT,1801,95,na,1896,4.743823948067466
STAT,1924,33,na,1957,4499.003588987218
SIM,1942,18,na,1960,4324
SIM,1869,85,na,1954,182
SIM,1940,2,na,1942,4210
STAT,1919,41,30-34,1960,0.14158395192000192
STAT,1855,27,40-44,1882,2.420460328727359
STAT,1926,41,30-34,1967,0.1610161967086139
SIM,1846,20,na,1866,2109
STAT,1891,24,40-44,1915,2.6153704516593295
STAT,1894,23,20-24,1917,90.14880618999
STAT,1863,48,40-44,1911,0.1512060493111663
STAT,1845,40,25-29,1885,0.5241998924577765
STAT,1911,20,20-24,1931,108.21126384293844
STAT,1941,21,45-49,1962,1.1866662315870216
STAT,1875,19,15-19,1894,6.180215963402414
SIM,1929,32,50-100,1961,5
STAT,1869,43,15-19,1912,0.013503164013027147
SIM,1865,33,45-49,1898,3
SIM,1928,25,35-39,1953,2
SIM,1863,27,40-44,1890,8
STAT,1896,69,na,1965,2238.0778742677676
STAT,1945,2,na,1947,4506.505421734479
STAT,1770,95,na,1865,1.5219257917295308
STAT,1852,110,na,1962,8.006029665658899E-4
STAT,1857,33,45-49,1890,1.3834730858474564
STAT,1876,43,15-19,1919,0.014442591099057994
STAT,1850,26,15-19,1876,0.40451955201930495
STAT,1867,34,45-49,1901,1.6558149612881679
SIM,1857,54,na,1911,1735
SIM,1917,24,20-24,1941,133
STAT,1862,7,na,1869,2461.7095334094943
STAT,1893,42,45-49,1935,1.9344869879660462
STAT,1766,103,na,1869,0.07149545187237717
STAT,1890,16,45-49,1906,0.08167928245544977
STAT,1888,24,35-39,1912,6.993649581973393
STAT,1872,15,40-44,1887,0.18985049387082145
STAT,1905,48,20-24,1953,0.009847756806124491
SIM,1825,40,40-44,1865,6
STAT,1913,24,40-44,1937,3.4420866692672463
SIM,1873,37,45-49,1910,2
STAT,1894,35,15-19,1929,0.07438685328460146
SIM,1853,44,35-39,1897,2
STAT,1840,22,40-44,1862,1.9069236527395472
STAT,1884,31,40-44,1915,4.3948596410725145
STAT,1915,21,40-44,1936,3.557400912131996
STAT,1873,29,20-24,1902,12.046530004406677
SIM,1875,34,45-49,1909,6
SIM,1892,31,40-44,1923,8
STAT,1886,11,na,1897,2792.785854541228
STAT,1829,41,15-19,1870,0.011747219325063521
STAT,1862,42,15-19,1904,0.01197769179702687
STAT,1836,51,30-34,1887,0.0038241121352163153
STAT,1920,38,45-49,1958,0.7609329117431564
SIM,1880,66,na,1946,1557
STAT,1897,19,35-39,1916,0.7444455134760537
SIM,1853,28,30-34,1881,38
SIM,1853,64,na,1917,1390
STAT,1915,13,na,1928,4211.38082421791
STAT,1820,77,na,1897,476.06787918759784
STAT,1878,52,20-24,1930,7.793966516730611E-4
STAT,1824,67,na,1891,872.8452116855842
SIM,1915,27,20-24,1942,21
SIM,1949,17,20-24,1966,190
STAT,1911,23,na,1934,3680.331824083253
SIM,1874,18,20-24,1892,16
STAT,1854,52,35-39,1906,0.006553906661908445
STAT,1857,15,45-49,1872,0.061896244231618804
STAT,1911,27,40-44,1938,4.636589159487195
SIM,1922,35,na,1957,4328
STAT,1819,38,30-34,1857,13.714138266203253
STAT,1909,24,20-24,1933,104.7390281742625
STAT,1884,48,35-39,1932,0.13952413213646866
STAT,1864,95,na,1959,20.71914197163762
SIM,1931,28,15-19,1959,1
STAT,1845,28,30-34,1873,23.777006193026853
STAT,1843,49,30-34,1892,0.07651243987070626
SIM,1797,60,na,1857,918
STAT,1847,41,35-39,1888,1.4382810414992953
STAT,1896,32,15-19,1928,0.1918734702636992
STAT,1866,18,20-24,1884,17.021885093322712
STAT,1923,28,15-19,1951,0.8240583761121286
STAT,1826,51,45-49,1877,0.011168950141418508
STAT,1950,10,na,1960,4739.749511818089
STAT,1925,43,na,1968,4580.210295620179
SIM,1892,51,na,1943,3142
STAT,1855,18,45-49,1873,0.05987397592086482
STAT,1878,16,na,1894,2688.4298831739156
STAT,1782,100,na,1882,0.21038091164340353
SIM,1848,18,na,1866,2281
SIM,1848,28,20-24,1876,15
STAT,1782,98,na,1880,0.5613685247706168
STAT,1865,37,45-49,1902,1.8457749818854665
SIM,1855,41,35-39,1896,3
SIM,1842,25,20-24,1867,8
STAT,1883,48,50-100,1931,0.24274815905798033
STAT,1827,44,15-19,1871,0.01575649414769815
SIM,1774,91,na,1865,14
SIM,1839,40,40-44,1879,5
STAT,1883,62,na,1945,1829.4956981627192
SIM,1840,28,20-24,1868,11
STAT,1813,51,35-39,1864,0.02108062016356415
SIM,1896,41,na,1937,3165
SIM,1907,17,15-19,1924,12
SIM,1878,26,40-44,1904,4
SIM,1933,25,15-19,1958,1
SIM,1934,20,na,1954,5162
STAT,1922,17,45-49,1939,0.5898953342372912
STAT,1843,47,35-39,1890,0.11249132495773524
SIM,1837,43,40-44,1880,3
STAT,1850,75,na,1925,774.3663473519667
SIM,1827,38,30-34,1865,4
STAT,1834,25,20-24,1859,10.502498866145357
STAT,1872,23,50-100,1895,0.41564867048017573
STAT,1931,38,20-24,1969,0.3556896371676446
STAT,1898,31,40-44,1929,6.007176965428522
SIM,1871,26,25-29,1897,48
STAT,1832,28,20-24,1860,10.55069214292077
STAT,1876,37,20-24,1913,0.8120348686819117
STAT,1896,34,40-44,1930,5.793063720700724
SIM,1781,85,na,1866,82
STAT,1821,46,45-49,1867,0.3774488950340664
SIM,1894,29,30-34,1923,41
SIM,1930,30,na,1960,5407
SIM,1887,37,45-49,1924,2
STAT,1882,52,40-44,1934,0.010407485962763035
STAT,1879,37,45-49,1916,2.1257645190695786
SIM,1888,46,na,1934,2638
STAT,1817,40,40-44,1857,6.106791118733447
STAT,1863,26,25-29,1889,38.11021006933091
STAT,1924,33,50-100,1957,0.9835258576607613
SIM,1905,63,na,1968,2951
SIM,1917,22,25-29,1939,2
STAT,1807,83,na,1890,167.7680149353192
STAT,1871,31,30-34,1902,17.715576869546503
STAT,1827,28,50-100,1855,1.4660539176631942
STAT,1886,29,30-34,1915,26.99737575373936
STAT,1794,83,na,1877,142.20746023831532
SIM,1855,23,35-39,1878,7
STAT,1853,34,15-19,1887,0.12043881597782284
STAT,1847,23,35-39,1870,5.538517295905045
STAT,1868,47,40-44,1915,0.16603400551230457
STAT,1826,33,15-19,1859,0.14560069611618187
STAT,1923,46,15-19,1969,4.407727042933212E-4
SIM,1909,53,na,1962,3242
STAT,1849,40,50-100,1889,0.8345221781357299
STAT,1861,29,25-29,1890,35.40389454938131
SIM,1844,28,na,1872,2081
STAT,1929,33,na,1962,4896.8077416536335
STAT,1925,25,15-19,1950,0.8564656557403293
SIM,1869,37,25-29,1906,5
SIM,1886,34,20-24,1920,6
STAT,1845,46,30-34,1891,0.07584912425089665
STAT,1849,90,na,1939,61.208705098247194
SIM,1838,87,na,1925,67
STAT,1831,49,na,1880,1584.476516305354
STAT,1860,45,15-19,1905,3.343862033318127E-4
STAT,1880,42,35-39,1922,1.9388560036613387
STAT,1882,21,35-39,1903,5.8172583618553
SIM,1863,31,15-19,1894,1
STAT,1847,25,30-34,1872,23.94550276832161
SIM,1811,69,na,1880,607
STAT,1845,44,35-39,1889,1.4043431363946188
SIM,1849,59,na,1908,1512
SIM,1827,39,50-100,1866,3
STAT,1858,26,15-19,1884,0.37846361264598954
SIM,1926,25,na,1951,4815
STAT,1912,43,35-39,1955,0.19693145533757886
STAT,1867,52,45-49,1919,0.013825007598947569
STAT,1878,34,20-24,1912,2.8456991464109764
SIM,1836,92,na,1928,1
SIM,1874,26,na,1900,2435
STAT,1841,39,na,1880,1824.9142625844677
SIM,1890,21,35-39,1911,10
STAT,1855,31,15-19,1886,0.11357730755359165
STAT,1829,32,50-100,1861,0.8548264656645251
STAT,1907,18,na,1925,3773.160837709297
SIM,1838,28,35-39,1866,9
SIM,1855,25,30-34,1880,29
SIM,1959,12,na,1971,5719
STAT,1918,3,na,1921,4505.192177575047
STAT,1786,88,na,1874,38.59396861382373
SIM,1919,38,45-49,1957,6
STAT,1801,98,na,1899,1.159073598657189
SIM,1846,82,na,1928,207
SIM,1822,35,50-100,1857,1
SIM,1865,30,40-44,1895,7
SIM,1826,39,25-29,1865,2
SIM,1852,47,25-29,1899,1
SIM,1862,33,20-24,1895,5
STAT,1827,46,40-44,1873,0.19488402256112067
STAT,1950,17,20-24,1967,163.54279185948724
SIM,1833,41,50-100,1874,3
SIM,1868,38,na,1906,2333
SIM,1846,36,45-49,1882,5
STAT,1830,33,35-39,1863,9.518533967798122
STAT,1866,62,na,1928,1719.8405051061432
STAT,1844,46,40-44,1890,0.13304148918591932
STAT,1880,24,35-39,1904,6.216644996244691
SIM,1884,24,15-19,1908,4
SIM,1839,22,40-44,1861,2
STAT,1860,18,25-29,1878,5.3777090143823525
STAT,1903,32,30-34,1935,25.31946506376771
STAT,1876,24,15-19,1900,3.4535329385255635
SIM,1843,39,25-29,1882,4
SIM,1845,33,20-24,1878,2
STAT,1824,36,45-49,1860,2.862299477064862
STAT,1917,48,40-44,1965,0.16758719029394956
STAT,1908,31,na,1939,3655.23262461098
SIM,1869,79,na,1948,569
STAT,1862,47,45-49,1909,0.20398695562185754
STAT,1866,90,na,1956,83.60229788852726
STAT,1846,110,na,1956,2.130212498225009E-4
STAT,1923,48,na,1971,4372.773221275246
STAT,1812,42,na,1854,1466.911490711094
STAT,1891,27,45-49,1918,1.4023105544018994
SIM,1847,29,15-19,1876,2
STAT,1860,30,40-44,1890,3.618415480636755
SIM,1863,36,45-49,1899,6
SIM,1873,13,na,1886,2636
STAT,1835,39,25-29,1874,2.598674375869272
STAT,1897,54,na,1951,2856.3122395950045
SIM,1821,33,35-39,1854,12
SIM,1837,46,na,1883,1525
STAT,1855,36,45-49,1891,1.552785303053675
STAT,1813,83,na,1896,170.7152651721718
STAT,1848,22,40-44,1870,1.972288897409773
STAT,1919,25,50-100,1944,1.104927743900023
SIM,1842,21,na,1863,2003
SIM,1888,48,45-49,1936,1
SIM,1920,40,na,1960,3994
SIM,1941,17,20-24,1958,161
STAT,1935,33,na,1968,5332.743402106905
STAT,1891,27,15-19,1918,0.573025372497152
SIM,1838,16,na,1854,2043
STAT,1829,46,45-49,1875,0.1934698972624439
SIM,1835,46,40-44,1881,1
STAT,1788,83,na,1871,147.06776428196613
STAT,1870,50,25-29,1920,0.003583078212262152
STAT,1894,37,40-44,1931,5.744238906040194
STAT,1905,32,35-39,1937,8.567442117709529
STAT,1838,49,20-24,1887,0.008841441413763544
STAT,1844,47,25-29,1891,0.044426805247459795
STAT,1849,20,35-39,1869,5.556945011547152
STAT,1837,33,20-24,1870,2.2362835190862955
SIM,1842,92,na,1934,28
SIM,1910,10,na,1920,3998
STAT,1839,47,15-19,1886,2.8126709754734046E-4
STAT,1850,44,45-49,1894,1.110584056068666
SIM,1879,29,35-39,1908,25
SIM,1894,47,30-34,1941,1
STAT,1848,40,40-44,1888,1.7916079813731178
STAT,1824,36,15-19,1860,0.08062816387217658
SIM,1911,32,30-34,1943,26
STAT,1899,42,40-44,1941,0.21793010600903479
STAT,1837,51,20-24,1888,5.036635602689503E-4
SIM,1856,22,40-44,1878,1
STAT,1852,70,na,1922,1130.3188785364036
STAT,1933,17,20-24,1950,185.084306712445
SIM,1913,32,35-39,1945,20
STAT,1928,38,45-49,1966,0.8779090192827678
STAT,1886,47,30-34,1933,0.10403850677527843
SIM,1868,23,15-19,1891,8
STAT,1809,49,25-29,1858,0.24775719098409302
STAT,1926,38,40-44,1964,1.8645092445166775
STAT,1820,43,20-24,1863,0.3067622681520757
STAT,1845,29,na,1874,2027.9162626452999
STAT,1800,57,na,1857,1253.2797483369031
STAT,1881,53,35-39,1934,0.00835458970308207
SIM,1830,36,na,1866,1816
STAT,1867,34,15-19,1901,0.13522064235191492
STAT,1772,96,na,1868,0.8233226648742878
STAT,1913,27,50-100,1940,1.0117706511678544
STAT,1843,34,na,1877,2060.082509146293
SIM,1881,15,30-34,1896,5
SIM,1871,23,20-24,1894,63
STAT,1839,29,na,1868,1853.8954404614235
SIM,1938,22,na,1960,3592
SIM,1867,84,na,1951,201
STAT,1878,19,25-29,1897,5.985009799589692
STAT,1886,45,35-39,1931,0.1526808312202862
STAT,1899,1,na,1900,3802.364998338635
STAT,1913,42,40-44,1955,0.24883534310891003
SIM,1906,24,45-49,1930,1
STAT,1896,37,45-49,1933,2.685931184651313
SIM,1877,29,30-34,1906,45
STAT,1939,22,35-39,1961,9.646599266170446
STAT,1922,7,na,1929,4720.340872628753
STAT,1829,28,45-49,1857,1.2880231292381
STAT,1907,27,20-24,1934,17.5723879091901
SIM,1936,7,na,1943,3492
STAT,1869,45,35-39,1914,0.13926185667322846
STAT,1889,46,50-100,1935,0.31036997808246497
SIM,1789,65,na,1854,857
SIM,1855,4,na,1859,2328
SIM,1861,36,40-44,1897,1
STAT,1870,34,20-24,1904,2.6725804928116523
SIM,1815,90,na,1905,8
STAT,1853,36,40-44,1889,3.7088427034359257
STAT,1861,17,50-100,1878,0.04746796214420764
SIM,1851,30,40-44,1881,7
STAT,1815,45,50-100,1860,0.6831298005346849
STAT,1868,97,na,1965,19.436745240756327
SIM,1937,21,50-100,1958,1
STAT,1881,23,40-44,1904,2.048862959443999
STAT,1917,48,na,1965,3905.04781833752
STAT,1885,48,25-29,1933,0.05788744472944238
STAT,1918,16,40-44,1934,0.31246187931375985
STAT,1908,19,50-100,1927,0.07371009640456744
STAT,1933,35,50-100,1968,0.5842163332798678
SIM,1890,56,na,1946,2646
STAT,1840,20,15-19,1860,3.062808714523235
STAT,1857,30,40-44,1887,3.5494276641267866
STAT,1861,44,20-24,1905,0.13206728984849098
STAT,1841,54,45-49,1895,0.010420616481608741
STAT,1819,54,35-39,1873,0.015762139065739873
STAT,1873,15,30-34,1888,1.6680505754403494
SIM,1832,36,45-49,1868,8
STAT,1879,32,15-19,1911,0.15185713527142142
STAT,1937,28,45-49,1965,1.7169595089147711
STAT,1875,26,20-24,1901,12.325106365406315
STAT,1818,39,25-29,1857,8.630727556351928
STAT,1896,19,45-49,1915,0.08754050919061841
STAT,1765,113,na,1878,1.650395066716035E-4
STAT,1824,54,45-49,1878,0.015682022243576763
SIM,1947,22,35-39,1969,15
STAT,1880,26,na,1906,2567.2034199305526
SIM,1884,56,na,1940,2091
STAT,1868,15,20-24,1883,17.795882388595093
STAT,1918,46,35-39,1964,0.1403589883297574
STAT,1924,27,20-24,1951,21.68411133904635
STAT,1923,39,50-100,1962,0.49530172140106793
SIM,1793,70,na,1863,528
SIM,1811,43,20-24,1854,1
SIM,1932,27,20-24,1959,2
STAT,1849,39,25-29,1888,2.2402864977099948
SIM,1857,39,25-29,1896,6
SIM,1822,32,40-44,1854,5
SIM,1870,47,45-49,1917,2
STAT,1801,70,na,1871,649.3608650506992
STAT,1826,62,na,1888,1092.3802739197552
STAT,1843,30,40-44,1873,4.29709044877473
SIM,1873,84,na,1957,270
STAT,1847,39,20-24,1886,0.6108678496141458
STAT,1854,33,20-24,1887,2.0966896802516493
SIM,1818,37,50-100,1855,2
SIM,1868,39,30-34,1907,9
STAT,1838,36,45-49,1874,1.7858552412591984
SIM,1921,24,40-44,1945,8
STAT,1891,45,45-49,1936,0.16981113324645236
SIM,1849,31,na,1880,1900
STAT,1830,35,30-34,1865,4.949176583791301
SIM,1934,24,20-24,1958,153
STAT,1833,75,na,1908,676.0433224570519
STAT,1855,59,na,1914,1506.5700613469953
SIM,1917,20,na,1937,3847
STAT,1877,62,na,1939,1933.8966643463202
STAT,1878,87,na,1965,391.142636187878
SIM,1928,40,30-34,1968,2
STAT,1823,38,20-24,1861,1.3905071875892725
STAT,1930,24,40-44,1954,4.365677537535633
STAT,1847,28,35-39,1875,8.978961451726088
SIM,1881,31,35-39,1912,16
STAT,1846,41,15-19,1887,0.010124146271606505
STAT,1890,29,20-24,1919,14.528486319447293
STAT,1848,46,50-100,1894,0.19145504957763462
STAT,1868,18,25-29,1886,5.588335801156317
STAT,1868,25,50-100,1893,0.6275240180449468
SIM,1872,25,30-34,1897,42
SIM,1818,67,na,1885,833
STAT,1840,25,45-49,1865,1.010662266896097
STAT,1833,26,15-19,1859,0.40425171517733144
STAT,1897,16,30-34,1913,2.179435857004182
STAT,1862,41,30-34,1903,1.0028893272711394
SIM,1880,48,45-49,1928,1
SIM,1938,17,15-19,1955,44
SIM,1872,99,na,1971,12
STAT,1855,90,na,1945,61.11707180361036
STAT,1864,26,45-49,1890,1.0105925496020105
STAT,1943,23,50-100,1966,0.7140033545471794
SIM,1870,28,30-34,1898,34
STAT,1837,65,na,1902,1126.7428818591811
SIM,1838,25,30-34,1863,9
SIM,1876,18,25-29,1894,14
STAT,1861,26,20-24,1887,10.03312616175491
SIM,1862,13,na,1875,2508
SIM,1882,49,50-100,1931,1
STAT,1885,47,40-44,1932,0.17343139623806839
SIM,1842,28,25-29,1870,44
STAT,1966,2,na,1968,5012.86992314075
STAT,1838,18,45-49,1856,0.06302373132483924
STAT,1855,15,40-44,1870,0.17064474071008456
STAT,1873,31,35-39,1904,10.516716831881046
STAT,1845,60,na,1905,1490.169007935582
SIM,1834,47,35-39,1881,1
STAT,1874,15,45-49,1889,0.06860863527782834
STAT,1862,28,30-34,1890,21.7909873237437
SIM,1936,27,50-100,1963,1
SIM,1850,28,na,1878,1910
SIM,1853,3,na,1856,2744
SIM,1906,21,40-44,1927,2
STAT,1928,27,50-100,1955,1.2508082671632266
SIM,1855,28,35-39,1883,13
STAT,1874,45,45-49,1919,0.24825920365880347
SIM,1872,26,45-49,1898,2
STAT,1839,47,45-49,1886,0.16594772722831994
SIM,1809,90,na,1899,10
SIM,1899,48,20-24,1947,1
SIM,1826,62,na,1888,1118
STAT,1846,26,25-29,1872,36.86048694132499
SIM,1880,26,na,1906,2372
STAT,1874,97,na,1971,34.7039546701974
STAT,1844,29,25-29,1873,39.55390291608354
STAT,1871,36,30-34,1907,5.411591141296084
STAT,1939,33,50-100,1972,0.8600402802474664
SIM,1899,20,40-44,1919,3
SIM,1814,40,35-39,1854,4
SIM,1817,85,na,1902,127
STAT,1858,3,na,1861,2670.0133749273173
STAT,1851,69,na,1920,1210.7488001884067
STAT,1865,19,15-19,1884,5.5958035852699854
SIM,1873,19,15-19,1892,14
STAT,1865,77,na,1942,800.3431343505698
STAT,1934,15,15-19,1949,62.89179095164254
STAT,1942,25,15-19,1967,0.7565935301305426
STAT,1872,62,na,1934,1868.7265123164577
SIM,1844,87,na,1931,110
STAT,1807,54,45-49,1861,0.05757652861523168
STAT,1821,43,40-44,1864,3.7783840353705584
STAT,1902,46,na,1948,3246.516469977046
SIM,1852,29,25-29,1881,5
SIM,1884,84,na,1968,489
STAT,1864,25,30-34,1889,23.086202691300258
SIM,1775,85,na,1860,36
STAT,1882,19,20-24,1901,17.52548421613153
STAT,1826,47,35-39,1873,0.10939675048672684
STAT,1850,26,45-49,1876,0.9899422686757537
STAT,1922,29,50-100,1951,1.1410150799096523
SIM,1844,38,30-34,1882,10
SIM,1852,82,na,1934,314
SIM,1938,8,na,1946,3971
STAT,1868,48,25-29,1916,0.05541836441256633
STAT,1842,80,na,1922,485.1060603208977
STAT,1761,96,na,1857,0.6882697237566959
STAT,1944,22,15-19,1966,5.863929471262722
SIM,1946,23,50-100,1969,2
SIM,1916,25,15-19,1941,1
SIM,1875,16,15-19,1891,9
SIM,1898,19,20-24,1917,1
SIM,1892,11,na,1903,3793
SIM,1938,30,45-49,1968,1
STAT,1891,69,na,1960,1992.574760828299
STAT,1870,19,25-29,1889,5.638042848155929
STAT,1813,103,na,1916,0.06171538390968695
STAT,1881,21,15-19,1902,3.263576216028507
SIM,1878,29,45-49,1907,1
SIM,1863,54,na,1917,1762
SIM,1949,22,na,1971,4271
SIM,1855,59,na,1914,1447
STAT,1814,77,na,1891,402.7956769341291
SIM,1837,35,50-100,1872,1
SIM,1874,20,35-39,1894,9
SIM,1885,37,40-44,1922,5
STAT,1820,46,25-29,1866,0.1066086648566902
SIM,1867,44,na,1911,2054
STAT,1834,40,50-100,1874,0.8793216149304529
STAT,1825,49,na,1874,1506.538672515131
STAT,1838,31,15-19,1869,0.1313760486249464
SIM,1804,59,na,1863,1206
STAT,1867,16,15-19,1883,5.844880511596523
STAT,1888,29,35-39,1917,11.553632220252863
STAT,1871,32,15-19,1903,0.14390646200593968
SIM,1840,30,35-39,1870,7
STAT,1838,35,30-34,1873,4.824311126133059
STAT,1874,27,15-19,1901,0.4725592582969778
SIM,1876,28,50-100,1904,1
STAT,1844,31,50-100,1875,0.8579145441718955
SIM,1911,35,35-39,1946,5
SIM,1914,40,na,1954,3773
SIM,1820,36,25-29,1856,2
STAT,1908,25,15-19,1933,0.6909487608783368
STAT,1895,19,30-34,1914,2.1100807348035016
STAT,1919,45,40-44,1964,0.175328741659797
STAT,1893,38,35-39,1931,9.107995462133344
STAT,1839,29,15-19,1868,0.3888173414601523
STAT,1858,95,na,1953,10.756192496276103
SIM,1909,25,na,1934,3676
STAT,1872,18,45-49,1890,0.06661268229706478
SIM,1802,80,na,1882,215
STAT,1867,16,na,1883,2487.444561704411
STAT,1872,16,25-29,1888,5.847330047364632
STAT,1834,28,25-29,1862,37.06017011720402
SIM,1836,28,30-34,1864,32
SIM,1908,34,20-24,1942,5
STAT,1828,28,30-34,1856,31.806878551286513
STAT,1796,78,na,1874,310.44685518428287
STAT,1866,20,35-39,1886,5.6162066372998725
STAT,1793,98,na,1891,0.6507335600347853
STAT,1911,51,na,1962,3502.4702697309503
STAT,1914,22,35-39,1936,9.814967338402981
STAT,1826,51,50-100,1877,0.011623280297573337
SIM,1922,22,35-39,1944,13
STAT,1821,40,30-34,1861,2.127853417640395
STAT,1906,36,na,1942,3542.8367203515595
STAT,1836,38,30-34,1874,4.030048590571793
SIM,1880,16,25-29,1896,8
SIM,1861,28,na,1889,2491
STAT,1916,17,15-19,1933,9.825950145764303
STAT,1862,44,40-44,1906,1.9269057182807234
STAT,1903,35,35-39,1938,2.234887225717255
STAT,1854,36,25-29,1890,2.2142129341466603
STAT,1828,38,50-100,1866,1.053519602767136
STAT,1870,36,40-44,1906,4.386531750319487
SIM,1839,38,20-24,1877,1
STAT,1898,29,20-24,1927,16.068480893816663
SIM,1902,15,na,1917,3744
SIM,1891,20,40-44,1911,3
STAT,1889,59,na,1948,2449.043965943057
SIM,1900,16,20-24,1916,42
STAT,1866,50,35-39,1916,0.008217280881885738
SIM,1883,40,50-100,1923,1
STAT,1831,47,45-49,1878,0.1930130654251273
STAT,1860,15,20-24,1875,17.125147905434368
SIM,1914,31,40-44,1945,5
SIM,1939,4,na,1943,4040
SIM,1937,15,35-39,1952,8
STAT,1832,30,35-39,1862,9.08004652791131
STAT,1880,21,30-34,1901,19.15294535098057
STAT,1887,40,25-29,1927,0.741478188284242
STAT,1800,85,na,1885,109.45107704665993
STAT,1864,21,15-19,1885,3.062597449585368
SIM,1843,34,na,1877,1924
STAT,1827,49,45-49,1876,0.25798919010423266
SIM,1832,31,na,1863,1883
SIM,1828,97,na,1925,12
STAT,1854,18,30-34,1872,1.4506668896662878
SIM,1935,21,30-34,1956,53
STAT,1887,27,25-29,1914,48.356166546806534
STAT,1826,93,na,1919,17.04543855161906
STAT,1829,43,40-44,1872,1.8619850568774665
STAT,1813,49,15-19,1862,9.721399471605331E-4
STAT,1875,40,50-100,1915,1.1172774961927157
SIM,1856,25,45-49,1881,1
SIM,1862,36,25-29,1898,6
SIM,1791,75,na,1866,347
SIM,1872,21,15-19,1893,3
STAT,1809,46,20-24,1855,0.054276095940103644
STAT,1893,24,15-19,1917,4.242692967431686
STAT,1909,22,25-29,1931,87.55482358830832
SIM,1929,24,40-44,1953,8
STAT,1835,54,20-24,1889,5.387728653941295E-4
SIM,1852,7,na,1859,2590
SIM,1822,35,45-49,1857,2
STAT,1818,67,na,1885,869.9990260589834
STAT,1842,48,50-100,1890,0.19018061709222311
STAT,1890,47,20-24,1937,0.008403859979173832
STAT,1913,58,na,1971,3470.1514148493175
STAT,1862,27,50-100,1889,0.5575567572267788
STAT,1852,41,45-49,1893,1.2111512676090974
STAT,1835,39,na,1874,1932.2259522747472
STAT,1884,56,na,1940,2058.5671499650557
SIM,1895,27,25-29,1922,87
STAT,1927,21,30-34,1948,36.23073839729229
STAT,1852,23,45-49,1875,0.6625570729296772
STAT,1896,16,40-44,1912,0.2470403148507805
STAT,1921,49,15-19,1970,4.212728339366309E-4
SIM,1846,35,30-34,1881,4
SIM,1828,36,25-29,1864,3
SIM,1865,18,na,1883,2510
SIM,1866,41,40-44,1907,8
STAT,1896,41,na,1937,3138.9504407414884
STAT,1913,18,na,1931,4017.98303958798
STAT,1947,22,50-100,1969,0.7587334955607663
SIM,1820,46,na,1866,1627
STAT,1918,32,15-19,1950,0.1393501217360735
STAT,1877,52,30-34,1929,0.006264779936727185
STAT,1853,39,45-49,1892,1.654712718246554
STAT,1882,38,50-100,1920,1.2141727656679966
STAT,1906,31,40-44,1937,3.712588110324161
STAT,1860,33,45-49,1893,1.4372953974567155
STAT,1929,15,35-39,1944,5.487315529005984
SIM,1860,23,45-49,1883,1
STAT,1881,26,45-49,1907,1.0988248610107179
SIM,1857,36,20-24,1893,1
STAT,1963,5,na,1968,5093.989078681556
SIM,1863,94,na,1957,1
SIM,1865,28,20-24,1893,16
STAT,1848,43,45-49,1891,1.154983912714217
STAT,1802,52,na,1854,1038.809362636184
SIM,1896,2,na,1898,3648
SIM,1874,32,35-39,1906,18
STAT,1819,39,45-49,1858,4.7515927109477865
STAT,1828,46,25-29,1874,0.04564478466307152
STAT,1829,25,40-44,1854,9.375573409546446
SIM,1856,13,na,1869,2795
SIM,1906,21,35-39,1927,10
STAT,1895,59,na,1954,2586.7720553884083
STAT,1776,86,na,1862,64.3886421911089
STAT,1853,28,50-100,1881,0.5613901295756607
STAT,1830,31,15-19,1861,0.13856050015613527
SIM,1785,75,na,1860,387
STAT,1863,41,20-24,1904,0.1426933351804422
STAT,1847,24,na,1871,2014.7496982004511
STAT,1873,18,35-39,1891,0.5660153465303547
STAT,1888,42,35-39,1930,2.181189289030298
STAT,1911,45,40-44,1956,0.15296648018633532
SIM,1883,29,25-29,1912,51
STAT,1929,33,35-39,1962,11.831893634494003
SIM,1905,35,na,1940,3459
STAT,1875,29,25-29,1904,43.97348917122522
SIM,1834,97,na,1931,5
SIM,1850,6,na,1856,2403
SIM,1866,99,na,1965,10
STAT,1868,45,15-19,1913,3.9363221847252706E-4
STAT,1887,23,50-100,1910,0.4647184009168556
STAT,1861,47,25-29,1908,0.048328604497427374
STAT,1891,37,50-100,1928,1.5506365793893784
SIM,1862,18,30-34,1880,3
SIM,1834,33,45-49,1867,3
STAT,1833,49,50-100,1882,0.16878801069410684
STAT,1870,54,40-44,1924,0.010210121177851285
SIM,1848,46,na,1894,1805
STAT,1897,35,50-100,1932,1.690590746697308
STAT,1876,21,na,1897,2498.933486497628
SIM,1860,23,15-19,1883,6
STAT,1918,43,30-34,1961,0.13849215003929352
SIM,1854,26,25-29,1880,50
SIM,1927,19,na,1946,4439
SIM,1835,49,45-49,1884,2
STAT,1822,40,20-24,1862,0.26216324317592765
STAT,1853,103,na,1956,0.14607031026996323
STAT,1942,2,na,1944,4328.9885185134635
STAT,1838,34,50-100,1872,0.8193432866948608
STAT,1857,28,20-24,1885,9.558091119550545
SIM,1846,34,50-100,1880,1
SIM,1879,26,30-34,1905,42
STAT,1883,20,40-44,1903,2.0982658175562325
SIM,1851,69,na,1920,1113
STAT,1773,81,na,1854,191.0
SIM,1870,44,40-44,1914,10
SIM,1896,42,35-39,1938,1
STAT,1878,21,50-100,1899,0.4343241405584441
STAT,1849,36,20-24,1885,0.6187713349163037
SIM,1939,28,15-19,1967,1
STAT,1942,15,na,1957,3926.4809800306343
SIM,1827,39,45-49,1866,6
STAT,1881,50,30-34,1931,0.00595523185543657
SIM,1904,27,45-49,1931,1
STAT,1943,22,25-29,1965,100.26486784764279
STAT,1866,104,na,1970,0.6505175671666371
SIM,1863,33,40-44,1896,7
STAT,1871,77,na,1948,873.4895543326523
STAT,1864,39,20-24,1903,0.6921860185210227
STAT,1826,33,45-49,1859,1.7829216516788113
STAT,1852,23,15-19,1875,3.134553396003411
STAT,1829,39,na,1868,1785.9719709103654
SIM,1826,90,na,1916,24
STAT,1879,36,30-34,1915,5.710575581682402
SIM,1888,32,35-39,1920,12
SIM,1843,36,20-24,1879,5
STAT,1879,19,45-49,1898,0.06928342374596581
STAT,1867,48,35-39,1915,0.13239768899372298
STAT,1932,21,40-44,1953,4.512735758026543
STAT,1926,24,20-24,1950,136.94859147639465
STAT,1848,25,45-49,1873,1.0453055974037029
STAT,1872,48,45-49,1920,0.23826153792270668
SIM,1859,18,na,1877,2488
SIM,1937,33,35-39,1970,17
STAT,1841,51,40-44,1892,0.007810309494297033
STAT,1921,30,25-29,1951,10.580196760180542
STAT,1893,24,45-49,1917,0.8967868396898109
STAT,1921,49,45-49,1970,0.24855118122392844
SIM,1940,21,40-44,1961,5
STAT,1918,19,45-49,1937,0.5518793580350155
SIM,1926,19,45-49,1945,5
SIM,1857,18,20-24,1875,29
SIM,1874,41,50-100,1915,3
STAT,1831,29,15-19,1860,0.4265374476627572
SIM,1816,38,25-29,1854,4
STAT,1835,36,20-24,1871,0.7177587394349301
STAT,1849,18,20-24,1867,16.842271961595575
STAT,1855,33,40-44,1888,3.3876615907517276
SIM,1896,24,35-39,1920,14
SIM,1779,75,na,1854,251
SIM,1832,62,na,1894,1142
SIM,1887,36,30-34,1923,12
SIM,1829,33,35-39,1862,12
SIM,1911,35,na,1946,3797
SIM,1899,23,45-49,1922,1
SIM,1925,16,20-24,1941,234
SIM,1939,28,20-24,1967,23
STAT,1854,51,20-24,1905,5.674722192249146E-4
STAT,1913,39,15-19,1952,0.019138509591274156
STAT,1935,28,40-44,1963,6.476313757804393
STAT,1811,57,na,1868,1094.9672470486164
STAT,1864,23,40-44,1887,1.9067921178823104
SIM,1879,21,30-34,1900,41
STAT,1823,52,35-39,1875,0.012460300590346833
STAT,1842,24,50-100,1866,0.39757948992287695
STAT,1889,38,45-49,1927,2.49961965788955
STAT,1844,26,20-24,1870,11.209198965197091
STAT,1845,29,45-49,1874,1.040832294155018
STAT,1840,38,20-24,1878,0.649298634337475
SIM,1879,38,na,1917,2887
STAT,1916,38,na,1954,3912.1164731992903
STAT,1947,17,15-19,1964,52.15904831547905
STAT,1837,62,na,1899,1218.5968819281306
STAT,1819,53,20-24,1872,0.0013782132050450698
SIM,1849,41,40-44,1890,7
SIM,1871,58,na,1929,1812
SIM,1883,43,na,1926,2402
STAT,1895,28,na,1923,3165.3073154128533
STAT,1803,109,na,1912,2.7607126246865686E-4
SIM,1798,73,na,1871,430
SIM,1863,16,25-29,1879,9
STAT,1796,100,na,1896,0.23095280165631102
STAT,1874,57,na,1931,2093.154988479122
SIM,1954,12,na,1966,4715
STAT,1837,53,40-44,1890,0.006906543858756409
SIM,1833,31,35-39,1864,12
STAT,1846,14,na,1860,2125.1162650536094
STAT,1872,31,15-19,1903,0.14619684958662846
STAT,1943,24,20-24,1967,120.61718330204728
STAT,1857,45,45-49,1902,0.18990019354495705
STAT,1848,19,15-19,1867,5.651481597243992
STAT,1917,16,20-24,1933,29.845695965112377
STAT,1856,32,na,1888,1934.362834348163
STAT,1864,28,35-39,1892,8.721563969550086
SIM,1893,61,na,1954,2461
SIM,1886,19,30-34,1905,2
SIM,1923,18,15-19,1941,57
STAT,1855,16,25-29,1871,5.25579944215347
STAT,1932,24,45-49,1956,1.500409670457299
STAT,1825,38,25-29,1863,4.267258504169024
STAT,1862,44,35-39,1906,1.5512848027055708
SIM,1864,29,20-24,1893,16
SIM,1880,45,40-44,1925,1
SIM,1857,36,15-19,1893,2
STAT,1951,20,na,1971,4453.938141131282
STAT,1829,30,na,1859,1936.549593621505
STAT,1869,42,30-34,1911,1.130923867612238
STAT,1934,24,50-100,1958,0.9011643836906792
SIM,1852,26,20-24,1878,10
SIM,1872,23,40-44,1895,1
SIM,1896,22,15-19,1918,5
SIM,1888,33,40-44,1921,10
SIM,1817,47,35-39,1864,1
STAT,1923,18,50-100,1941,0.44769240889919304
STAT,1928,23,na,1951,4636.353518952411
STAT,1847,55,na,1902,1612.4299474070317
SIM,1865,30,35-39,1895,18
SIM,1838,39,20-24,1877,2
STAT,1821,45,30-34,1866,0.15715045321886875
STAT,1895,37,25-29,1932,3.8322429591643954
STAT,1891,38,na,1929,2960.8353597402565
SIM,1847,92,na,1939,17
STAT,1876,38,35-39,1914,7.413867223925006
SIM,1884,38,35-39,1922,11
STAT,1850,44,na,1894,1715.0588804415286
STAT,1883,17,15-19,1900,5.940280208467959
STAT,1905,51,na,1956,3205.9344078922754
SIM,1856,43,45-49,1899,3
STAT,1917,34,20-24,1951,2.5842115055231543
SIM,1877,42,30-34,1919,2
SIM,1836,52,na,1888,1670
SIM,1853,29,45-49,1882,1
STAT,1892,29,25-29,1921,53.69842895610265
SIM,1942,27,na,1969,4440
SIM,1853,33,na,1886,2004
SIM,1909,31,30-34,1940,27
STAT,1857,30,35-39,1887,8.28859535971103
STAT,1849,36,15-19,1885,0.04507606318173828
SIM,1861,38,30-34,1899,6
SIM,1923,20,na,1943,4454
STAT,1865,80,na,1945,572.7600557877004
STAT,1909,38,40-44,1947,1.437934908152281
SIM,1870,44,35-39,1914,5
STAT,1884,87,na,1971,455.7254225805095
SIM,1847,32,40-44,1879,2
STAT,1915,18,15-19,1933,9.66729195342053
SIM,1889,31,na,1920,3146
SIM,1877,47,25-29,1924,1
SIM,1920,22,30-34,1942,43
SIM,1911,21,15-19,1932,6
SIM,1860,18,na,1878,2232
STAT,1930,39,45-49,1969,0.9049874235341606
STAT,1869,17,30-34,1886,1.591553505550885
SIM,1882,30,40-44,1912,2
STAT,1825,31,35-39,1856,21.92052387426743
STAT,1870,16,20-24,1886,17.954172941232674
STAT,1833,26,45-49,1859,0.9892868170179667
SIM,1932,33,50-100,1965,3
SIM,1930,32,35-39,1962,23
STAT,1892,40,35-39,1932,2.338599064901693
STAT,1939,20,45-49,1959,1.1535341696244155
SIM,1856,44,na,1900,2211
STAT,1884,34,15-19,1918,0.14249903389160534
STAT,1851,28,25-29,1879,40.568965213766624
STAT,1852,101,na,1953,0.45969530067920594
STAT,1853,50,25-29,1903,0.0030126529167815636
SIM,1844,56,na,1900,1621
SIM,1927,10,na,1937,4884
STAT,1817,43,15-19,1860,0.03336783678089396
STAT,1871,19,45-49,1890,0.0656560020648342
STAT,1919,41,25-29,1960,0.0790829284230279
STAT,1922,44,35-39,1966,0.23504905201548862
SIM,1894,1,na,1895,3653
STAT,1853,38,30-34,1891,4.446678504782791
STAT,1839,32,40-44,1871,3.6831857060643447
STAT,1859,26,50-100,1885,0.5339969151005917
STAT,1873,16,na,1889,2627.5835532411666
STAT,1903,21,15-19,1924,4.798571744267537
STAT,1888,33,50-100,1921,1.1003475017678508
SIM,1889,43,35-39,1932,5
STAT,1821,43,35-39,1864,3.0418456270322705
STAT,1889,26,45-49,1915,1.4039428907425184
STAT,1857,54,na,1911,1668.295100373529
STAT,1869,47,25-29,1916,0.056466243624877496
STAT,1886,42,na,1928,2492.6320411455345
STAT,1892,22,35-39,1914,7.461022405486213
STAT,1889,44,45-49,1933,1.8605243754309346
STAT,1922,32,35-39,1954,10.535450516263431
STAT,1890,43,35-39,1933,2.2423784681274044
STAT,1882,49,15-19,1931,3.8924984717010174E-4
SIM,1846,38,35-39,1884,8
STAT,1886,44,20-24,1930,0.16917346440980274
SIM,1897,26,45-49,1923,4
STAT,1901,61,na,1962,2825.5991227377667
SIM,1857,40,50-100,1897,5
SIM,1856,19,15-19,1875,11
SIM,1852,51,na,1903,1801
STAT,1888,36,50-100,1924,1.4878091813930348
SIM,1917,38,40-44,1955,4
STAT,1910,10,na,1920,4003.260149859845
STAT,1864,34,50-100,1898,0.8239945013993543
STAT,1806,70,na,1876,710.9548537967861
STAT,1868,45,20-24,1913,0.011808976941745155
STAT,1862,46,30-34,1908,0.08429978836090177
SIM,1843,37,35-39,1880,13
SIM,1929,27,45-49,1956,4
STAT,1834,29,na,1863,1878.8584977900607
SIM,1805,60,na,1865,971
SIM,1877,17,30-34,1894,2
STAT,1912,22,30-34,1934,28.09874863572402
STAT,1839,47,50-100,1886,0.17269814296753883
STAT,1839,50,40-44,1889,0.007446389795546839
SIM,1855,21,15-19,1876,7
STAT,1838,38,35-39,1876,6.206011218785537
STAT,1869,29,30-34,1898,24.624601809680275
SIM,1892,16,15-19,1908,10
STAT,1841,50,50-100,1891,0.011311402156915914
SIM,1873,44,na,1917,2288
SIM,1919,23,40-44,1942,7
SIM,1878,24,20-24,1902,83
SIM,1947,20,45-49,1967,1
STAT,1848,37,15-19,1885,0.044983008196087304
STAT,1877,39,30-34,1916,5.582395895275407
STAT,1893,44,50-100,1937,0.09365988327071054
STAT,1833,22,50-100,1855,0.4198969651842928
STAT,1825,41,50-100,1866,1.4729497207787479
SIM,1821,35,25-29,1856,2
STAT,1839,44,50-100,1883,0.7490044309593765
STAT,1822,42,40-44,1864,3.5022618849966074
STAT,1823,45,na,1868,1487.124251877303
STAT,1894,39,30-34,1933,6.923181859011746
SIM,1869,25,25-29,1894,68
STAT,1826,30,40-44,1856,5.597192801939556
SIM,1873,22,40-44,1895,2
SIM,1914,34,45-49,1948,4
STAT,1870,39,45-49,1909,1.968021292886357
SIM,1841,32,45-49,1873,1
STAT,1849,50,na,1899,1695.6565187046237
STAT,1841,48,15-19,1889,2.929029820076238E-4
SIM,1889,31,35-39,1920,4
SIM,1921,25,na,1946,4837
SIM,1811,60,na,1871,914
STAT,1827,48,30-34,1875,0.10725699156789606
STAT,1906,34,45-49,1940,1.4740509249170108
SIM,1874,6,na,1880,2778
STAT,1795,101,na,1896,0.10208479214364362
SIM,1872,34,50-100,1906,5
STAT,1835,37,35-39,1872,6.517761747395006
STAT,1860,6,na,1866,2381.5479801648917
SIM,1861,59,na,1920,2020
SIM,1878,35,50-100,1913,5
SIM,1860,74,na,1934,1047
STAT,1833,44,45-49,1877,1.1693624578376713
SIM,1896,29,35-39,1925,21
STAT,1831,44,40-44,1875,1.8560005057098803
STAT,1888,46,na,1934,2721.0571390812656
SIM,1820,74,na,1894,730
SIM,1866,44,45-49,1910,1
STAT,1912,40,30-34,1952,0.12721042113056183
SIM,1868,94,na,1962,26
STAT,1868,43,25-29,1911,0.6211769528415045
STAT,1939,6,na,1945,4083.8539439870324
STAT,1898,28,15-19,1926,0.6237032475480252
STAT,1916,17,20-24,1933,29.353471283570723
STAT,1797,88,na,1885,48.97633766202379
SIM,1839,40,35-39,1879,4
SIM,1855,28,na,1883,1895
SIM,1885,39,30-34,1924,9
SIM,1905,22,35-39,1927,8
STAT,1833,32,45-49,1865,1.4896686861158117
STAT,1879,39,35-39,1918,7.4663358404156375
SIM,1850,34,45-49,1884,1
STAT,1859,37,20-24,1896,0.6280221227681706
STAT,1873,33,50-100,1906,0.9436275966266523
STAT,1841,18,20-24,1859,16.783106076351803
STAT,1893,21,40-44,1914,2.704895574649719
SIM,1830,67,na,1897,1070
SIM,1929,27,15-19,1956,1
STAT,1832,46,15-19,1878,3.216580560752537E-4
STAT,1862,24,15-19,1886,2.8907751999766313
SIM,1873,7,na,1880,2676
SIM,1858,76,na,1934,745
STAT,1866,31,na,1897,2254.623866585333
SIM,1829,38,35-39,1867,9
STAT,1831,30,15-19,1861,0.1338228119947194
STAT,1931,38,15-19,1969,0.025911168881517416
SIM,1912,34,40-44,1946,5
SIM,1895,31,na,1926,3306
STAT,1900,11,na,1911,3656.9870143928606
STAT,1915,49,20-24,1964,0.011296864345422
STAT,1852,37,35-39,1889,5.7288745312764915
STAT,1824,44,50-100,1868,1.2513373527163565
STAT,1866,36,20-24,1902,0.7288369477958062
STAT,1805,54,40-44,1859,0.035640159140558965
STAT,1839,69,na,1908,1012.8174903468087
SIM,1837,77,na,1914,538
SIM,1912,28,50-100,1940,1
SIM,1860,37,35-39,1897,8
SIM,1870,24,15-19,1894,7
STAT,1808,77,na,1885,315.1572500058985
STAT,1813,52,na,1865,1227.5706377378358
STAT,1878,54,40-44,1932,0.010871490381192296
STAT,1927,36,35-39,1963,3.070399241391248
SIM,1915,25,na,1940,4206
STAT,1851,21,35-39,1872,5.790878266678289
SIM,1841,26,45-49,1867,1
STAT,1918,15,50-100,1933,0.08387797988834736
STAT,1880,26,25-29,1906,45.5039995059571
STAT,1904,46,40-44,1950,0.1415941168695449
SIM,1867,13,na,1880,2450
SIM,1815,42,45-49,1857,3
SIM,1887,39,35-39,1926,11
STAT,1856,29,20-24,1885,9.59565139029459
SIM,1940,24,45-49,1964,5
STAT,1872,45,40-44,1917,0.17678502949174058
STAT,1911,48,45-49,1959,0.20929374811281848
STAT,1852,20,40-44,1872,2.0231892900443325
STAT,1897,23,na,1920,3216.0444518882177
STAT,1874,33,45-49,1907,1.808633894280714
SIM,1935,36,35-39,1971,3
SIM,1842,52,na,1894,1584
SIM,1874,94,na,1968,52
STAT,1822,54,40-44,1876,0.013865962510429956
STAT,1845,43,20-24,1888,0.12475261035536171
STAT,1889,38,15-19,1927,0.07041182972268893
SIM,1837,23,20-24,1860,65
SIM,1844,54,35-39,1898,2
STAT,1883,17,45-49,1900,0.06538556969089097
STAT,1879,6,na,1885,2869.117577316628
SIM,1848,42,35-39,1890,6
SIM,1869,19,25-29,1888,5
STAT,1930,42,40-44,1972,0.3356538954698815
SIM,1904,10,na,1914,4046
SIM,1882,27,45-49,1909,1
STAT,1813,53,25-29,1866,0.008332138682027307
STAT,1888,22,15-19,1910,3.978689624450739
STAT,1946,18,45-49,1964,0.5651113439188172
SIM,1824,67,na,1891,779
SIM,1848,41,50-100,1889,5
SIM,1921,27,50-100,1948,3
STAT,1852,39,30-34,1891,4.25030426001216
SIM,1841,44,45-49,1885,3
STAT,1874,30,50-100,1904,0.9619974277586416
SIM,1937,19,20-24,1956,155
STAT,1880,44,25-29,1924,0.6791190952396363
STAT,1852,104,na,1956,0.06584905623198062
STAT,1930,36,40-44,1966,1.9933178842565469
STAT,1904,34,40-44,1938,3.609581970288768
SIM,1877,46,na,1923,2272
STAT,1842,16,15-19,1858,6.011630324261631
SIM,1808,49,na,1857,1473
STAT,1833,25,50-100,1858,0.5767348161198803
STAT,1923,17,na,1940,4409.852245416356
STAT,1951,19,30-34,1970,14.797046843830527
STAT,1865,22,40-44,1887,1.9528580439626535
SIM,1860,39,30-34,1899,9
SIM,1849,28,na,1877,1919
SIM,1838,20,30-34,1858,20
STAT,1899,49,na,1948,3077.9089535830904
SIM,1830,42,40-44,1872,5
STAT,1853,54,50-100,1907,0.012315393992797519
STAT,1906,16,45-49,1922,0.09723206191511846
SIM,1860,20,40-44,1880,1
STAT,1864,53,35-39,1917,0.007683741430049474
STAT,1887,42,15-19,1929,0.015767041560994535
STAT,1883,35,45-49,1918,2.0143619541107864
SIM,1943,28,40-44,1971,12
STAT,1861,27,35-39,1888,8.192833603482308
SIM,1915,4,na,1919,4652
SIM,1807,64,na,1871,879
STAT,1801,67,na,1868,726.2166229000719
STAT,1879,34,50-100,1913,0.9686779756324675
STAT,1886,82,na,1968,865.2180466505462
STAT,1902,18,na,1920,3623.9322536806258
STAT,1915,24,45-49,1939,1.1794282749394616
SIM,1833,35,20-24,1868,2
STAT,1929,19,20-24,1948,175.526250350755
SIM,1848,30,35-39,1878,18
STAT,1846,70,na,1916,1003.3689020730471
SIM,1883,46,na,1929,2347
STAT,1874,27,45-49,1901,1.1564493778039098
STAT,1921,2,na,1923,4757.161706988652
STAT,1898,31,35-39,1929,14.027912055749184
SIM,1875,79,na,1954,681
STAT,1917,19,25-29,1936,47.17876823138383
STAT,1937,16,45-49,1953,0.4969197402671459
STAT,1858,44,15-19,1902,0.01102145355961725
SIM,1861,39,45-49,1900,1
SIM,1809,59,na,1868,829
STAT,1845,69,na,1914,1146.660538808635
STAT,1816,44,45-49,1860,3.2268213314024385
SIM,1923,24,45-49,1947,1
STAT,1890,18,35-39,1908,0.6826319459342519
SIM,1890,25,na,1915,3138
SIM,1891,35,45-49,1926,2
STAT,1921,34,40-44,1955,4.405884933129119
SIM,1962,7,na,1969,5403
STAT,1868,49,30-34,1917,0.09234945583296349
STAT,1766,96,na,1862,2.068450600550013
STAT,1844,44,na,1888,1787.8852267686127
SIM,1868,69,na,1937,1467
SIM,1871,43,40-44,1914,3
SIM,1838,41,35-39,1879,5
STAT,1859,80,na,1939,503.9796539380608
SIM,1887,20,15-19,1907,3
SIM,1908,32,25-29,1940,5
STAT,1873,47,15-19,1920,4.1177079660878826E-4
SIM,1863,35,50-100,1898,6
SIM,1897,30,50-100,1927,1
SIM,1825,43,45-49,1868,2
STAT,1816,63,na,1879,934.0105863285661
STAT,1889,30,50-100,1919,1.163881843451412
SIM,1936,27,na,1963,3191
STAT,1897,32,35-39,1929,13.813688568555094
STAT,1884,34,45-49,1918,1.744940921614313
STAT,1930,39,15-19,1969,0.02549260651152951
SIM,1875,31,40-44,1906,1
STAT,1857,19,50-100,1876,0.04533810154915773
STAT,1867,46,15-19,1913,3.8418003166737995E-4
STAT,1828,29,45-49,1857,1.259025927879807
STAT,1840,52,35-39,1892,0.00616208183640356
STAT,1940,28,15-19,1968,0.7340465622399974
STAT,1934,23,na,1957,5003.106371201666
STAT,1839,53,45-49,1892,0.00985485533071221
STAT,1879,16,40-44,1895,0.19551861160498843
STAT,1882,24,na,1906,2335.85204610199
SIM,1836,29,45-49,1865,5
STAT,1843,15,15-19,1858,6.195079296125046
STAT,1889,41,40-44,1930,2.847235657167727
SIM,1860,41,45-49,1901,1
SIM,1813,64,na,1877,896
STAT,1922,48,20-24,1970,0.012918105157768842
SIM,1787,70,na,1857,524
STAT,1819,51,30-34,1870,0.011569286992116692
STAT,1873,72,na,1945,1306.1485285280157
SIM,1850,59,na,1909,1474
STAT,1825,35,20-24,1860,1.2595424655961107
STAT,1926,26,40-44,1952,5.71969660056738
STAT,1860,77,na,1937,715.4697023498604
SIM,1821,90,na,1911,17
STAT,1877,35,15-19,1912,0.05998063793425893
SIM,1879,24,35-39,1903,9
SIM,1894,46,na,1940,3005
SIM,1910,23,20-24,1933,119
STAT,1862,40,25-29,1902,0.5632760704745875
STAT,1866,32,35-39,1898,9.52926715987098
STAT,1902,36,35-39,1938,2.2068472467306144
STAT,1949,22,na,1971,4347.41711950749
STAT,1863,43,40-44,1906,1.9973353595963164
SIM,1948,12,na,1960,4540
STAT,1902,47,50-100,1949,0.19837911233072655
SIM,1853,41,30-34,1894,3
STAT,1904,10,na,1914,3787.227137830513
STAT,1892,26,20-24,1918,15.050860439163541
STAT,1792,88,na,1880,41.70776846276761
STAT,1907,21,na,1928,3553.270811139602
STAT,1913,42,35-39,1955,0.20032868369153983
SIM,1910,18,35-39,1928,1
STAT,1836,54,35-39,1890,0.005211706085071617
SIM,1870,40,25-29,1910,1
STAT,1902,23,20-24,1925,98.83430473908028
STAT,1902,18,35-39,1920,0.787329717791863
SIM,1847,35,45-49,1882,5
SIM,1897,41,40-44,1938,2
STAT,1869,44,20-24,1913,0.15430496785519998
STAT,1817,43,45-49,1860,3.6162390572408296
STAT,1920,21,15-19,1941,6.057426651192372
STAT,1854,54,25-29,1908,0.002636348068619077
STAT,1890,40,30-34,1930,1.4484933794634816
STAT,1861,32,20-24,1893,2.2785926747982566
STAT,1833,44,na,1877,1630.3887934617094
STAT,1847,95,na,1942,10.368033826465425
STAT,1894,33,25-29,1927,13.383812875488328
SIM,1907,39,30-34,1946,3
SIM,1862,44,na,1906,2068
SIM,1883,22,35-39,1905,11
STAT,1892,79,na,1971,1376.8828881112477
STAT,1920,35,40-44,1955,1.6755213768458617
SIM,1892,34,45-49,1926,4
SIM,1912,30,25-29,1942,2
STAT,1853,54,40-44,1907,0.00858467204033681
STAT,1827,42,25-29,1869,0.7609930319886258
STAT,1900,38,20-24,1938,0.23408745385117757
STAT,1828,29,na,1857,1572.3934428436698
SIM,1897,7,na,1904,3538
STAT,1840,29,na,1869,1913.1868186154518
STAT,1950,19,na,1969,4437.074054689761
STAT,1895,34,20-24,1929,3.5669978421397714
STAT,1851,25,20-24,1876,11.496857942389271
STAT,1845,41,30-34,1886,0.9265399621570275
STAT,1903,20,30-34,1923,25.984864353138466
SIM,1910,36,35-39,1946,6
STAT,1889,23,40-44,1912,2.617784405943672
STAT,1921,13,na,1934,4601.626391085992
SIM,1887,34,40-44,1921,10
STAT,1885,45,20-24,1930,0.012335107816201172
STAT,1912,25,35-39,1937,15.195395042105794
SIM,1933,29,30-34,1962,7
STAT,1830,51,35-39,1881,0.006408645876848066
SIM,1864,31,35-39,1895,15
SIM,1894,47,25-29,1941,1
STAT,1892,47,50-100,1939,0.1763047059546695
STAT,1868,57,na,1925,1958.118831492882
STAT,1834,85,na,1919,184.22314565660884
SIM,1919,26,45-49,1945,4
SIM,1916,35,na,1951,3939
STAT,1858,44,45-49,1902,1.1944499456636959
SIM,1928,25,40-44,1953,3
SIM,1930,39,na,1969,5457
STAT,1886,47,25-29,1933,0.06190721004648811
SIM,1856,40,40-44,1896,7
STAT,1828,43,20-24,1871,0.12776821432827332
STAT,1832,59,na,1891,1298.6770620815446
SIM,1877,43,na,1920,2343
SIM,1888,36,45-49,1924,6
SIM,1849,62,na,1911,1400
SIM,1920,25,35-39,1945,1
SIM,1813,67,na,1880,764
STAT,1855,3,na,1858,2605.009911947734
STAT,1871,52,35-39,1923,0.008653353565386324
STAT,1882,21,na,1903,2357.663571426048
STAT,1925,29,30-34,1954,46.8787104326442
STAT,1893,36,15-19,1929,0.07302200293612514
STAT,1914,38,15-19,1952,0.019465376913386463
STAT,1867,15,50-100,1882,0.04853750391277404
STAT,1817,100,na,1917,0.5181173167156722
SIM,1897,23,40-44,1920,3
STAT,1778,81,na,1859,127.40365500866054
SIM,1858,35,20-24,1893,1
SIM,1873,31,50-100,1904,1
SIM,1842,21,35-39,1863,6
SIM,1812,43,35-39,1855,3
STAT,1858,41,40-44,1899,1.827915033474376
STAT,1836,34,15-19,1870,0.1097466240781698
STAT,1855,28,na,1883,1914.5008600961733
SIM,1921,50,na,1971,4789
SIM,1865,42,40-44,1907,2
STAT,1826,49,30-34,1875,0.07366456009475235
STAT,1850,47,na,1897,1684.4513180728081
STAT,1932,17,50-100,1949,0.5059334442665777
STAT,1871,34,35-39,1905,10.14603321443905
STAT,1939,23,na,1962,3740.029276322659
STAT,1887,24,na,1911,2686.6412323874083
STAT,1826,45,15-19,1871,3.2094742077289675E-4
SIM,1889,29,20-24,1918,2
STAT,1904,49,15-19,1953,3.230026158835806E-4
SIM,1853,92,na,1945,19
STAT,1847,21,15-19,1868,3.1765915068121906
STAT,1884,16,15-19,1900,6.004349572063885
STAT,1807,52,na,1859,1388.9468792823866
STAT,1879,34,40-44,1913,4.584886382996998
SIM,1801,79,na,1880,259
SIM,1906,18,15-19,1924,15
STAT,1854,19,45-49,1873,0.05910336756097877
SIM,1854,18,na,1872,2368
STAT,1856,31,35-39,1887,8.294765677550187
SIM,1834,49,30-34,1883,1
SIM,1848,77,na,1925,551
STAT,1841,70,na,1911,1035.9635805219039
SIM,1847,44,50-100,1891,3
STAT,1929,21,35-39,1950,12.181308371502059
STAT,1930,20,25-29,1950,121.40786762815236
STAT,1909,24,15-19,1933,5.014135334550571
STAT,1876,25,20-24,1901,12.442097974294459
SIM,1893,27,20-24,1920,18
SIM,1907,20,40-44,1927,3
SIM,1828,26,na,1854,1942
STAT,1917,47,35-39,1964,0.1374276487189263
STAT,1943,1,na,1944,4479.201235025212
STAT,1866,39,25-29,1905,2.6819714133672643
SIM,1873,25,45-49,1898,1
SIM,1928,20,na,1948,4658
SIM,1889,41,50-100,1930,3
SIM,1865,80,na,1945,476
SIM,1938,32,40-44,1970,5
STAT,1812,53,40-44,1865,0.023291843427603265
STAT,1893,64,na,1957,2301.217466139203
SIM,1961,5,na,1966,5331
SIM,1843,42,20-24,1885,1
SIM,1869,22,20-24,1891,70
STAT,1920,17,40-44,1937,1.6014409119466078
SIM,1912,7,na,1919,4254
STAT,1927,33,30-34,1960,19.75753753431837
SIM,1937,21,35-39,1958,14
STAT,1944,19,na,1963,4038.6000752247974
STAT,1764,114,na,1878,4.898846896197451E-4
STAT,1935,32,15-19,1967,0.18130550408838605
SIM,1846,11,na,1857,2387
SIM,1956,2,na,1958,5513
STAT,1865,25,45-49,1890,1.0350073147202001
STAT,1927,38,na,1965,4766.635258277931
SIM,1895,15,25-29,1910,9
STAT,1880,23,20-24,1903,73.64795658397392
STAT,1893,24,na,1917,3041.558655574856
STAT,1904,49,45-49,1953,0.19057170377228536
STAT,1816,41,40-44,1857,5.592480913857703
STAT,1894,49,na,1943,2891.1780856037176
SIM,1874,39,25-29,1913,5
SIM,1882,21,na,1903,2297
STAT,1848,37,45-49,1885,1.5968966010510401
STAT,1879,20,15-19,1899,3.5389207511397807
SIM,1819,89,na,1908,37
STAT,1840,85,na,1925,197.266573502981
STAT,1883,32,40-44,1915,4.340903325117724
SIM,1798,70,na,1868,606
SIM,1846,33,40-44,1879,13
STAT,1870,37,25-29,1907,2.871315944007862
STAT,1868,49,50-100,1917,0.23430812287174654
SIM,1878,27,25-29,1905,46
STAT,1818,54,20-24,1872,0.0015430614163688648
STAT,1810,78,na,1888,318.77506708150094
STAT,1899,45,45-49,1944,0.1878237488658478
SIM,1876,49,50-100,1925,2
STAT,1855,49,20-24,1904,0.009108153097430871
STAT,1944,21,30-34,1965,31.671321871604032
STAT,1938,23,35-39,1961,9.503048676861276
SIM,1859,58,na,1917,1800
SIM,1937,0,na,1937,4765
STAT,1885,27,20-24,1912,11.940022354234484
STAT,1966,5,na,1971,5008.50995434874
SIM,1896,26,30-34,1922,53
STAT,1916,35,na,1951,3968.956340840481
SIM,1884,25,20-24,1909,20
STAT,1900,51,na,1951,3059.121368137108
SIM,1799,95,na,1894,6
STAT,1937,29,50-100,1966,0.9887081836173337
SIM,1819,52,na,1871,1316
STAT,1921,37,45-49,1958,0.7767505283485967
SIM,1824,41,40-44,1865,4
SIM,1845,18,30-34,1863,2
SIM,1891,32,40-44,1923,8
STAT,1830,30,30-34,1860,17.282094975155907
SIM,1894,29,50-100,1923,1
STAT,1926,22,25-29,1948,114.47986463492384
SIM,1948,18,15-19,1966,68
SIM,1934,22,25-29,1956,133
STAT,1823,34,50-100,1857,1.9163659803201858
SIM,1925,34,20-24,1959,1
STAT,1858,98,na,1956,3.079315684262684
STAT,1911,54,na,1965,3455.0864504389165
STAT,1915,34,50-100,1949,0.8519167522205573
STAT,1835,70,na,1905,1045.3827224434078
STAT,1911,15,40-44,1926,0.2868303109586027
STAT,1821,41,15-19,1862,0.024750209928609594
SIM,1923,34,50-100,1957,2
SIM,1946,23,35-39,1969,11
SIM,1879,42,35-39,1921,7
STAT,1809,47,35-39,1856,0.6227081980366687
STAT,1874,30,40-44,1904,4.553266429051348
SIM,1826,36,20-24,1862,1
STAT,1856,69,na,1925,1175.2138798619962
SIM,1828,66,na,1894,970
STAT,1888,26,30-34,1914,30.47410123303102
STAT,1839,35,45-49,1874,1.6785922850502877
SIM,1783,71,na,1854,565
STAT,1843,33,15-19,1876,0.1367785742344665
STAT,1886,29,50-100,1915,0.6858106798667939
STAT,1837,18,30-34,1855,1.6298317997308112
SIM,1894,42,30-34,1936,1
STAT,1910,18,30-34,1928,2.4568168856240855
STAT,1878,50,25-29,1928,0.00381517512291322
STAT,1841,20,35-39,1861,5.5374237989928785
SIM,1771,86,na,1857,37
SIM,1926,31,30-34,1957,22
SIM,1837,26,25-29,1863,50
STAT,1798,73,na,1871,616.2385189531684
STAT,1785,107,na,1892,0.003527193006177908
STAT,1880,41,20-24,1921,0.17102262423703257
STAT,1946,15,40-44,1961,1.5836578775383834
STAT,1822,39,15-19,1861,0.0956952325429515
SIM,1820,35,40-44,1855,1
SIM,1843,24,20-24,1867,76
STAT,1905,17,45-49,1922,0.09624255742121084
SIM,1792,85,na,1877,101
STAT,1853,32,25-29,1885,8.844283794331526
STAT,1904,30,25-29,1934,15.095735880182987
STAT,1814,48,20-24,1862,0.03520574163939688
STAT,1896,17,25-29,1913,7.63508610659523
STAT,1933,38,na,1971,5220.666501350348
SIM,1856,37,45-49,1893,1
SIM,1833,38,25-29,1871,4
SIM,1851,33,45-49,1884,3
STAT,1818,36,20-24,1854,3.2360932591287757
STAT,1947,17,45-49,1964,0.574122595055475
SIM,1838,23,35-39,1861,9
STAT,1864,36,na,1900,2147.351028857244
STAT,1845,46,25-29,1891,0.04513336275562736
STAT,1899,27,15-19,1926,0.6338087002897528
SIM,1850,31,40-44,1881,8
SIM,1859,80,na,1939,446
STAT,1869,46,50-100,1915,0.2425802910650827
STAT,1830,44,50-100,1874,0.8856412134504213
STAT,1882,2,na,1884,3150.91544823682
STAT,1838,33,40-44,1871,3.9185432676457936
SIM,1844,59,na,1903,1536
SIM,1851,15,15-19,1866,5
SIM,1829,35,30-34,1864,6
STAT,1862,32,na,1894,2072.272594397526
STAT,1875,40,35-39,1915,1.915072054349273
STAT,1888,49,na,1937,2657.194627109765
STAT,1852,35,15-19,1887,0.04643812816373422
SIM,1923,21,40-44,1944,4
STAT,1858,16,50-100,1874,0.0465730342748377
STAT,1804,78,na,1882,322.07112361075593
STAT,1843,33,45-49,1876,1.6748922772580412
STAT,1918,31,30-34,1949,17.154669491451887
SIM,1935,33,30-34,1968,4
STAT,1853,95,na,1948,11.14829143958524
SIM,1917,24,15-19,1941,6
STAT,1835,24,20-24,1859,67.3021971701177
STAT,1829,26,25-29,1855,82.01217404079712
STAT,1886,42,30-34,1928,1.2398972717925227
STAT,1874,94,na,1968,82.90141696128067
STAT,1813,50,20-24,1863,0.0018435177042108132
STAT,1844,49,45-49,1893,0.17906071118704828
STAT,1864,50,30-34,1914,0.005477044757361061
SIM,1846,51,na,1897,1770
STAT,1887,15,25-29,1902,6.507923414567189
STAT,1844,44,20-24,1888,0.1228515873869188
STAT,1881,39,20-24,1920,0.7526190509661482
STAT,1951,15,15-19,1966,55.16090545232622
SIM,1877,46,50-100,1923,3
STAT,1835,42,20-24,1877,0.1418386023546793
SIM,1859,18,25-29,1877,13
SIM,1860,17,15-19,1877,7
STAT,1870,36,na,1906,2360.8365540263308
STAT,1843,51,45-49,1894,0.011771534301228813
STAT,1881,39,na,1920,2300.260570002696
SIM,1786,85,na,1871,44
SIM,1861,32,25-29,1893,16
STAT,1823,106,na,1929,0.006757492264145079
SIM,1825,52,na,1877,1370
SIM,1834,26,na,1860,1858
SIM,1902,27,40-44,1929,7
SIM,1954,15,40-44,1969,2
STAT,1909,42,15-19,1951,0.0014649193752635243
STAT,1899,45,15-19,1944,3.18345069114885E-4
SIM,1865,58,na,1923,1840
STAT,1791,63,na,1854,769.0
STAT,1819,77,na,1896,509.6084651512838
STAT,1840,40,50-100,1880,0.894069619723966
SIM,1836,26,40-44,1862,5
STAT,1858,64,na,1922,1406.345289017411
STAT,1900,36,30-34,1936,1.6343550988325055
STAT,1939,26,20-24,1965,18.728529722142888
SIM,1930,29,45-49,1959,3
STAT,1865,43,45-49,1908,1.3757330751516241
STAT,1907,39,20-24,1946,0.24671158339498658
STAT,1886,17,30-34,1903,1.7210795136866104
STAT,1882,40,40-44,1922,2.258060168355326
SIM,1919,31,25-29,1950,17
SIM,1881,11,na,1892,2377
SIM,1857,32,35-39,1889,17
STAT,1854,74,na,1928,849.3818092969345
STAT,1895,17,40-44,1912,0.2434459726885381
STAT,1954,16,45-49,1970,0.6300756261485767
STAT,1809,50,50-100,1859,0.06677679449152195
SIM,1924,39,30-34,1963,3
STAT,1916,39,30-34,1955,1.8854749297899942
STAT,1863,46,45-49,1909,0.21168993196772182
STAT,1892,44,15-19,1936,0.0012095686800542116
STAT,1871,54,25-29,1925,0.003480863115090687
STAT,1963,8,na,1971,5091.798976133818
STAT,1937,29,20-24,1966,18.132124292247553
SIM,1953,16,35-39,1969,10
STAT,1807,106,na,1913,0.005131118230324689
STAT,1873,40,30-34,1913,1.2010417722274511
STAT,1840,27,35-39,1867,8.657342728122073
SIM,1852,4,na,1856,2648
STAT,1945,16,35-39,1961,4.6779615766536775
SIM,1873,16,na,1889,2541
STAT,1952,19,45-49,1971,0.6102627344348598
SIM,1904,19,na,1923,3918
SIM,1804,50,na,1854,1346
STAT,1890,13,na,1903,3216.2658716929122
SIM,1915,39,20-24,1954,3
STAT,1840,34,40-44,1874,3.72285885839527
SIM,1873,43,45-49,1916,4
SIM,1890,40,40-44,1930,5
STAT,1870,17,35-39,1887,0.5524198588027434
STAT,1847,27,na,1874,2027.6235394371076
SIM,1865,49,25-29,1914,1
STAT,1923,16,15-19,1939,54.50648276233755
SIM,1841,46,50-100,1887,1
STAT,1823,37,45-49,1860,3.7350686753440723
STAT,1849,32,35-39,1881,8.284854198731498
STAT,1887,20,50-100,1907,0.4689402007751215
STAT,1891,60,na,1951,2408.7639954644897
SIM,1823,57,na,1880,1225
STAT,1892,14,na,1906,3291.208238776734
STAT,1846,79,na,1925,499.945381239154
SIM,1869,32,30-34,1901,26
STAT,1881,76,na,1957,1006.9054680307438
STAT,1922,29,45-49,1951,1.980440330724851
STAT,1817,109,na,1926,3.472155101585154E-4
SIM,1867,29,50-100,1896,1
STAT,1834,37,20-24,1871,0.6452536868970776
STAT,1943,19,35-39,1962,4.536775776926828
SIM,1951,19,35-39,1970,8
STAT,1889,56,na,1945,2570.2318112169974
STAT,1926,42,15-19,1968,0.0019313434808601434
STAT,1824,30,na,1854,1600.380260160631
SIM,1875,8,na,1883,2724
STAT,1831,34,30-34,1865,15.58025199342869
STAT,1844,27,35-39,1871,9.15318919244237
STAT,1924,36,50-100,1960,0.5055704637799162
SIM,1890,35,50-100,1925,1
STAT,1857,49,25-29,1906,0.044932838524099086
SIM,1912,14,na,1926,4197
STAT,1858,32,45-49,1890,1.4107655283837555
STAT,1940,4,na,1944,4163.630317768459
SIM,1852,27,35-39,1879,13
STAT,1854,46,35-39,1900,0.10745386433905525
SIM,1866,32,45-49,1898,3
SIM,1808,74,na,1882,564
SIM,1931,16,15-19,1947,59
STAT,1846,39,50-100,1885,0.8980190048589052
STAT,1896,20,15-19,1916,4.471472507997426
SIM,1831,37,45-49,1868,3
STAT,1809,52,20-24,1861,0.0031344079091769144
STAT,1874,46,20-24,1920,0.012534228967930345
STAT,1924,45,15-19,1969,4.495380653166446E-4
STAT,1942,12,na,1954,4193.95294432152
STAT,1846,24,35-39,1870,5.075328529271865
SIM,1887,30,25-29,1917,15
STAT,1786,85,na,1871,72.80996430628026
STAT,1827,32,15-19,1859,0.21992174003122048
SIM,1909,56,na,1965,3174
SIM,1884,53,na,1937,2211
SIM,1959,8,na,1967,5722
STAT,1869,22,50-100,1891,0.4016362121745777
SIM,1889,28,45-49,1917,2
STAT,1897,51,na,1948,2951.132814219334
STAT,1919,26,35-39,1945,16.610900123960498
STAT,1936,23,30-34,1959,28.01674417680253
STAT,1851,43,15-19,1894,0.011311046432253577
SIM,1851,66,na,1917,1303
STAT,1918,18,30-34,1936,13.502992302633729
SIM,1839,32,na,1871,1967
SIM,1871,80,na,1951,776
STAT,1899,33,45-49,1932,2.425786560536814
STAT,1875,43,50-100,1918,1.0981260447228678
SIM,1925,29,35-39,1954,33
STAT,1866,93,na,1959,45.525654406099214
STAT,1880,51,50-100,1931,0.01626806054191624
STAT,1863,21,30-34,1884,16.367256325010384
STAT,1780,94,na,1874,3.786394095108503
STAT,1894,23,15-19,1917,4.31566267478367
STAT,1917,29,35-39,1946,15.952790135835718
SIM,1824,42,50-100,1866,1
STAT,1826,30,50-100,1856,1.182554362244266
SIM,1823,42,35-39,1865,2
STAT,1823,82,na,1905,259.67778764241973
STAT,1890,28,45-49,1918,1.380047084819688
STAT,1929,20,20-24,1949,144.27452901475874
SIM,1905,26,15-19,1931,1
STAT,1811,54,50-100,1865,0.03839351477691199
STAT,1896,39,35-39,1935,9.433812677252488
SIM,1871,21,30-34,1892,22
STAT,1876,43,20-24,1919,0.16608978866851318
STAT,1880,36,35-39,1916,7.618875677553096
SIM,1854,24,35-39,1878,8
STAT,1856,50,40-44,1906,0.008551729523036126
SIM,1818,42,25-29,1860,2
STAT,1813,45,35-39,1858,0.3638853387495487
STAT,1898,25,40-44,1923,4.160573928591627
STAT,1879,32,na,1911,2544.654724658961
STAT,1879,30,25-29,1909,11.010046969322227
SIM,1894,17,30-34,1911,1
SIM,1875,17,na,1892,2538
SIM,1907,23,45-49,1930,2
STAT,1861,17,25-29,1878,5.490462062810324
STAT,1879,49,45-49,1928,0.24640531612479571
STAT,1896,46,40-44,1942,0.1304847685892589
STAT,1860,27,20-24,1887,9.814332154430636
STAT,1878,22,20-24,1900,73.17550548364723
STAT,1905,20,35-39,1925,8.648971437921318
STAT,1877,33,25-29,1910,10.791821388023639
STAT,1883,31,na,1914,2398.376275385075
STAT,1875,22,35-39,1897,6.109809808814351
SIM,1830,29,40-44,1859,3
SIM,1886,22,20-24,1908,77
STAT,1903,23,35-39,1926,8.436258105489747
STAT,1818,37,35-39,1855,26.59353709970082
SIM,1890,33,35-39,1923,22
SIM,1885,33,25-29,1918,2
STAT,1902,33,30-34,1935,25.01234448033644
SIM,1910,33,30-34,1943,22
STAT,1781,101,na,1882,0.12826655537914444
STAT,1878,19,na,1897,2667.4610544957254
STAT,1772,99,na,1871,0.18888935437188425
STAT,1815,42,35-39,1857,5.7206405649864065
STAT,1815,87,na,1902,91.09875637999106
SIM,1928,23,na,1951,4668
STAT,1900,29,25-29,1929,59.38459485891868
SIM,1825,29,30-34,1854,21
SIM,1909,20,45-49,1929,2
STAT,1925,37,15-19,1962,0.02351490486746279
SIM,1917,51,na,1968,3677
STAT,1919,33,40-44,1952,4.290271936814798
STAT,1895,15,15-19,1910,7.935651724581131
STAT,1873,41,na,1914,2401.2147463869665
STAT,1882,33,35-39,1915,10.02258169446884
STAT,1874,39,15-19,1913,0.0578997892104796
SIM,1839,34,40-44,1873,2
SIM,1911,23,35-39,1934,9
STAT,1867,47,na,1914,2144.698324142781
STAT,1910,28,40-44,1938,4.574415780006786
SIM,1845,66,na,1911,1304
STAT,1821,87,na,1908,92.83657013100941
STAT,1834,21,35-39,1855,5.29002730437628
STAT,1866,99,na,1965,7.281171900869904
STAT,1815,48,50-100,1863,0.6497862980883821
STAT,1855,51,35-39,1906,0.006705659109250049
SIM,1924,39,na,1963,4539
SIM,1826,34,30-34,1860,35
STAT,1838,48,45-49,1886,0.17612372961650924
STAT,1853,22,15-19,1875,3.2684140364535503
SIM,1802,89,na,1891,64
STAT,1885,25,30-34,1910,25.80348320728914
STAT,1826,54,50-100,1880,0.01095193212339119
STAT,1845,91,na,1936,45.2773495106536
STAT,1914,34,35-39,1948,9.304980114077122
STAT,1895,28,50-100,1923,0.8484405111404464
STAT,1872,35,30-34,1907,5.500869294541513
STAT,1929,37,15-19,1966,0.02514552333863665
SIM,1872,35,40-44,1907,6
SIM,1909,22,na,1931,3465
SIM,1822,44,40-44,1866,1
STAT,1876,28,25-29,1904,44.40470304315442
SIM,1902,31,15-19,1933,1
SIM,1930,33,na,1963,5414
STAT,1872,93,na,1965,89.6898228780871
STAT,1887,61,na,1948,2136.0997119874446
STAT,1829,48,35-39,1877,0.11185026053188603
STAT,1891,39,15-19,1930,0.07020928634307082
SIM,1861,22,15-19,1883,2
SIM,1840,29,na,1869,1872
STAT,1904,28,50-100,1932,0.931980224061965
SIM,1903,31,na,1934,3364
STAT,1890,19,na,1909,3133.3873061284003
STAT,1917,44,30-34,1961,0.1356990325297534
SIM,1922,34,35-39,1956,16
SIM,1867,24,45-49,1891,1
SIM,1813,44,30-34,1857,2
SIM,1913,20,35-39,1933,12
STAT,1850,32,45-49,1882,1.3721816739358703
STAT,1859,38,35-39,1897,5.733833375220013
STAT,1824,48,15-19,1872,4.599187726009483E-4
SIM,1848,49,na,1897,1750
SIM,1853,61,na,1914,1524
SIM,1946,20,30-34,1966,43
STAT,1917,17,na,1934,4241.400131463278
SIM,1828,34,35-39,1862,11
SIM,1936,24,na,1960,3112
STAT,1850,45,20-24,1895,0.009116448229212405
STAT,1924,15,20-24,1939,165.4826894877928
STAT,1945,21,15-19,1966,5.954318953765711
SIM,1859,86,na,1945,227
STAT,1854,16,40-44,1870,0.16844845656928212
SIM,1877,27,40-44,1904,5
STAT,1867,103,na,1970,1.305549929411502
SIM,1846,48,45-49,1894,1
SIM,1927,26,35-39,1953,27
SIM,1879,53,50-100,1932,1
SIM,1817,37,25-29,1854,2
STAT,1833,100,na,1933,0.6971777354070817
STAT,1928,21,15-19,1949,6.799775466916398
SIM,1936,26,45-49,1962,5
STAT,1953,17,50-100,1970,0.4623122913891915
SIM,1836,31,20-24,1867,7
SIM,1898,33,35-39,1931,26
STAT,1887,25,35-39,1912,11.104843484737279
STAT,1920,31,25-29,1951,10.373585087414769
STAT,1906,47,20-24,1953,0.010004062343063547
SIM,1935,23,20-24,1958,3
STAT,1841,42,45-49,1883,1.1482834458518525
STAT,1918,20,45-49,1938,1.2457669497342716
SIM,1853,95,na,1948,13
STAT,1908,47,25-29,1955,0.04891864890665504
STAT,1927,23,20-24,1950,139.3164236409462
SIM,1822,37,35-39,1859,12
STAT,1942,29,30-34,1971,41.915237051789106
SIM,1893,25,30-34,1918,46
STAT,1937,21,25-29,1958,91.78119875580443
SIM,1897,26,na,1923,3188
STAT,1919,28,50-100,1947,1.0936189283392665
STAT,1895,22,20-24,1917,91.72328370933157
SIM,1895,25,35-39,1920,26
STAT,1830,53,25-29,1883,0.0025342539293129215
STAT,1877,31,na,1908,2535.2406586539128
SIM,1834,29,na,1863,1805
SIM,1904,36,40-44,1940,1
STAT,1871,26,50-100,1897,0.6486432745941917
SIM,1945,21,25-29,1966,125
STAT,1836,55,na,1891,1287.0164294070457
SIM,1829,42,na,1871,1387
STAT,1770,114,na,1884,1.8850975404078517E-4
STAT,1828,31,20-24,1859,2.7614317358434075
STAT,1860,51,45-49,1911,0.012069605476434634
STAT,1873,47,na,1920,2316.048769202028
STAT,1891,33,45-49,1924,2.1931495210064518
STAT,1891,46,20-24,1937,0.00857350540904825
SIM,1932,15,20-24,1947,164
STAT,1881,28,35-39,1909,9.483021936398707
SIM,1891,35,na,1926,3043
STAT,1854,21,20-24,1875,62.41874499839766
SIM,1819,83,na,1902,149
STAT,1857,24,40-44,1881,1.7191656465476937
SIM,1884,25,na,1909,2566
STAT,1797,57,na,1854,1057.9999999999995
STAT,1822,35,na,1857,1698.4739778885717
STAT,1933,29,20-24,1962,24.693398978871947
SIM,1934,26,40-44,1960,3
STAT,1914,44,45-49,1958,0.16769889671628888
SIM,1835,42,na,1877,1705
SIM,1875,11,na,1886,2653
STAT,1859,12,na,1871,2257.6422874147956
SIM,1867,52,50-100,1919,1
SIM,1935,18,40-44,1953,3
SIM,1797,63,na,1860,844
STAT,1875,76,na,1951,991.9417209535349
STAT,1884,19,na,1903,2535.380321215381
STAT,1885,18,25-29,1903,5.752365260309558
STAT,1835,27,25-29,1862,41.09370428088745
STAT,1934,37,25-29,1971,1.3856325448138636
STAT,1837,21,20-24,1858,60.58276982393932
STAT,1938,20,30-34,1958,29.036817120960052
SIM,1901,33,20-24,1934,6
SIM,1921,36,40-44,1957,3
STAT,1833,38,15-19,1871,0.046006447665321144
STAT,1845,19,35-39,1864,0.5355155404209955
SIM,1880,63,na,1943,1617
STAT,1875,38,20-24,1913,0.8030838468793098
SIM,1864,43,35-39,1907,3
SIM,1884,28,25-29,1912,3
SIM,1912,4,na,1916,4306
STAT,1893,61,na,1954,2418.288117462163
SIM,1843,27,25-29,1870,45
STAT,1913,55,na,1968,3543.274496477126
SIM,1845,21,20-24,1866,57
STAT,1766,106,na,1872,0.01759523733443736
SIM,1952,18,40-44,1970,3
STAT,1839,91,na,1930,39.992386542385944
STAT,1944,18,40-44,1962,1.5352347394285892
STAT,1857,100,na,1957,1.1825723307627765
SIM,1936,21,15-19,1957,5
STAT,1848,40,na,1888,1840.9638911408688
STAT,1918,34,35-39,1952,9.82479135309415
SIM,1817,57,na,1874,1128
SIM,1941,29,20-24,1970,26
SIM,1865,24,40-44,1889,2
STAT,1808,47,20-24,1855,0.031819039208778356
STAT,1857,4,na,1861,2495.9436640363865
STAT,1928,26,45-49,1954,2.1784568075688844
SIM,1851,19,30-34,1870,5
SIM,1831,34,40-44,1865,10
SIM,1853,19,35-39,1872,1
SIM,1846,14,na,1860,2352
STAT,1864,37,50-100,1901,1.113663744525781
STAT,1852,79,na,1931,563.2003358726329
STAT,1814,44,40-44,1858,7.02513339029476
SIM,1893,18,25-29,1911,13
STAT,1932,37,20-24,1969,0.36120658487013485
STAT,1828,26,40-44,1854,6.142398229213288
STAT,1833,45,20-24,1878,0.009539503441330366
STAT,1860,37,30-34,1897,4.4113675093989055
STAT,1930,27,na,1957,4858.25071052771
STAT,1940,16,15-19,1956,47.022002432419136
SIM,1867,35,30-34,1902,7
SIM,1862,21,20-24,1883,57
STAT,1868,27,20-24,1895,11.430743108697067
STAT,1824,42,45-49,1866,1.8440612909421754
STAT,1898,39,na,1937,3242.87055465947
SIM,1814,74,na,1888,513
STAT,1859,24,45-49,1883,0.5810080160700243
STAT,1895,56,na,1951,2714.7752010921026
STAT,1843,19,30-34,1862,1.624985667223853
SIM,1926,34,35-39,1960,19
SIM,1925,19,25-29,1944,64
STAT,1850,38,15-19,1888,0.04246537618590992
SIM,1852,14,na,1866,2458
SIM,1931,34,45-49,1965,4
STAT,1919,31,15-19,1950,0.14205776150089253
SIM,1860,49,na,1909,1924
STAT,1923,34,45-49,1957,1.838205668147697
SIM,1910,19,na,1929,3813
STAT,1828,26,na,1854,1522.8725181491495
STAT,1881,35,40-44,1916,4.358435281618624
STAT,1927,18,40-44,1945,1.7694018813689891
STAT,1913,36,40-44,1949,1.5143557112359463
SIM,1832,42,45-49,1874,2
STAT,1842,107,na,1949,0.0036982726629962576
SIM,1918,39,na,1957,4165
STAT,1886,26,50-100,1912,0.693118045861172
SIM,1831,27,35-39,1858,1
SIM,1915,56,na,1971,3934
STAT,1861,22,na,1883,2048.165404269142
SIM,1799,58,na,1857,1235
STAT,1909,28,30-34,1937,38.056077937419715
STAT,1874,49,50-100,1923,0.2504665234521332
SIM,1869,35,35-39,1904,9
SIM,1853,26,40-44,1879,5
STAT,1844,29,50-100,1873,0.5981437530176629
STAT,1917,4,na,1921,4417.869916223328
SIM,1913,29,45-49,1942,2
STAT,1865,40,40-44,1905,2.1036251605409393
SIM,1934,19,35-39,1953,9
SIM,1821,39,40-44,1860,9
SIM,1858,70,na,1928,1124
SIM,1914,16,15-19,1930,12
SIM,1887,37,50-100,1924,1
STAT,1918,28,40-44,1946,5.044138401280185
STAT,1844,24,30-34,1868,16.987281459121515
STAT,1851,37,20-24,1888,0.6427741622691194
SIM,1912,42,na,1954,3710
STAT,1774,94,na,1868,2.860873511642831
STAT,1779,113,na,1892,1.5479725383037068E-4
SIM,1923,37,50-100,1960,1
STAT,1919,16,25-29,1935,9.828673395408545
SIM,1904,28,20-24,1932,17
STAT,1886,14,na,1900,2779.5967647043885
STAT,1900,39,35-39,1939,2.136850108336041
STAT,1869,32,20-24,1901,2.662265348544643
STAT,1905,29,45-49,1934,1.624167276091379
SIM,1887,46,40-44,1933,2
STAT,1778,84,na,1862,67.53213944738265
STAT,1926,19,35-39,1945,5.22023758125927
STAT,1831,39,50-100,1870,1.054364261248799
SIM,1877,32,20-24,1909,3
STAT,1840,40,35-39,1880,1.5324820818558011
SIM,1844,19,25-29,1863,5
SIM,1917,28,30-34,1945,47
SIM,1868,27,30-34,1895,33
STAT,1803,68,na,1871,835.7724493228608
STAT,1806,79,na,1885,302.9473607250595
SIM,1927,16,25-29,1943,68
STAT,1877,23,15-19,1900,3.479864907744119
STAT,1904,44,na,1948,3345.084686856549
STAT,1920,47,40-44,1967,0.17785428223782448
STAT,1814,50,35-39,1864,0.025562159618331422
STAT,1865,49,15-19,1914,3.626279687844394E-4
STAT,1913,15,45-49,1928,0.10467856822281457
SIM,1866,68,na,1934,1697
STAT,1845,26,40-44,1871,2.8695000331228875
STAT,1899,30,40-44,1929,6.106958707930694
SIM,1892,22,45-49,1914,1
STAT,1905,20,na,1925,3505.3222018126103
SIM,1885,23,15-19,1908,4
STAT,1895,47,35-39,1942,0.10462210461937882
STAT,1823,34,40-44,1857,9.070424340216839
SIM,1833,47,na,1880,1610
STAT,1928,23,40-44,1951,4.268877809035773
SIM,1846,85,na,1931,140
SIM,1825,31,45-49,1856,1
SIM,1909,18,30-34,1927,5
STAT,1890,25,40-44,1915,3.761826758984613
STAT,1893,43,20-24,1936,0.014169139525794471
STAT,1871,51,20-24,1922,7.492535375927514E-4
STAT,1851,23,50-100,1874,0.39888333029539735
STAT,1875,44,15-19,1919,0.01426386886087612
STAT,1952,16,40-44,1968,1.7103604019509981
SIM,1906,25,20-24,1931,26
STAT,1851,111,na,1962,2.6376521756175855E-4
SIM,1921,15,45-49,1936,3
SIM,1843,17,15-19,1860,6
STAT,1905,44,35-39,1949,0.1827673328251661
STAT,1953,16,25-29,1969,53.48910944725185
SIM,1926,28,40-44,1954,12
SIM,1915,7,na,1922,4604
STAT,1911,18,45-49,1929,0.10169847476049582
STAT,1901,30,na,1931,3431.6255823672914
STAT,1836,19,25-29,1855,5.401455232182507
STAT,1881,41,35-39,1922,1.7940457798864184
STAT,1851,91,na,1942,47.807956008228686
SIM,1854,21,30-34,1875,20
SIM,1871,52,na,1923,1996
SIM,1886,82,na,1968,860
STAT,1935,18,30-34,1953,16.948256049793198
STAT,1793,67,na,1860,799.5393667437887
SIM,1773,87,na,1860,23
SIM,1886,25,25-29,1911,54
SIM,1788,80,na,1868,259
SIM,1843,71,na,1914,934
STAT,1900,26,20-24,1926,16.644607055236342
SIM,1936,23,40-44,1959,5
SIM,1875,42,na,1917,2307
SIM,1903,22,30-34,1925,34
STAT,1855,38,35-39,1893,5.455721276797259
STAT,1914,26,15-19,1940,0.7286030348121542
SIM,1871,36,35-39,1907,4
STAT,1845,24,15-19,1869,3.1542388840593136
SIM,1852,24,30-34,1876,24
SIM,1839,37,45-49,1876,5
STAT,1834,47,30-34,1881,0.06908491350682662
STAT,1853,16,20-24,1869,17.98799819420002
STAT,1856,43,35-39,1899,1.4396307708388236
STAT,1928,31,25-29,1959,11.79510230063591
SIM,1870,27,50-100,1897,1
STAT,1855,45,40-44,1900,0.13403704615034787
STAT,1842,38,25-29,1880,2.6213025380652395
SIM,1850,38,25-29,1888,7
SIM,1889,25,40-44,1914,6
STAT,1864,64,na,1928,1576.8341683574613
STAT,1938,27,15-19,1965,0.7134437432901688
STAT,1908,34,na,1942,3609.188554460989
STAT,1906,16,15-19,1922,8.833534612506016
SIM,1880,35,30-34,1915,4
SIM,1928,21,25-29,1949,6
STAT,1867,53,20-24,1920,6.953815060655978E-4
STAT,1856,38,na,1894,1877.316855950208
SIM,1893,28,35-39,1921,15
SIM,1827,29,35-39,1856,16
SIM,1899,21,na,1920,3266
STAT,1837,109,na,1946,4.7434911582040285E-4
SIM,1872,28,35-39,1900,10
SIM,1927,41,na,1968,4655
STAT,1893,18,50-100,1911,0.06323655159314119
STAT,1858,0,na,1858,3179.990489713917
STAT,1869,25,15-19,1894,0.44988707115940874
SIM,1839,19,15-19,1858,7
STAT,1871,16,40-44,1887,0.18712389274469574
SIM,1854,5,na,1859,2627
SIM,1896,10,na,1906,3551
STAT,1879,46,40-44,1925,0.18307829776419007
SIM,1860,43,na,1903,1998
STAT,1937,15,30-34,1952,12.151334035821488
STAT,1834,43,15-19,1877,0.011060994250455529
SIM,1928,22,50-100,1950,1
STAT,1901,18,20-24,1919,25.22489082762037
SIM,1817,88,na,1905,71
SIM,1943,21,50-100,1964,1
SIM,1792,88,na,1880,20
SIM,1936,31,25-29,1967,7
STAT,1873,50,40-44,1923,0.011044685356846
SIM,1878,53,na,1931,2425
SIM,1943,18,30-34,1961,18
STAT,1846,21,30-34,1867,15.830535553495272
STAT,1944,24,35-39,1968,10.365362118638235
SIM,1873,40,40-44,1913,3
STAT,1854,31,30-34,1885,13.827226350904315
SIM,1867,81,na,1948,384
STAT,1825,77,na,1902,518.343835366118
SIM,1863,38,50-100,1901,1
STAT,1931,19,45-49,1950,0.6632579521872952
SIM,1918,23,20-24,1941,122
STAT,1842,16,45-49,1858,0.06617093129084202
STAT,1848,74,na,1922,862.6754060676766
SIM,1957,1,na,1958,5615
STAT,1880,28,50-100,1908,0.6833552760698932
SIM,1844,22,15-19,1866,2
STAT,1931,34,35-39,1965,12.196307549173305
STAT,1946,21,35-39,1967,10.6940094486413
STAT,1883,39,25-29,1922,2.852971045153966
STAT,1790,84,na,1874,115.12169701308989
STAT,1887,22,30-34,1909,20.361815560658922
STAT,1885,28,35-39,1913,9.785906686998397
SIM,1836,38,50-100,1874,1
STAT,1809,53,na,1862,1466.6922728705897
STAT,1831,40,na,1871,1771.5170348982792
SIM,1849,96,na,1945,4
SIM,1922,38,na,1960,4315
SIM,1935,26,25-29,1961,103
STAT,1936,33,40-44,1969,3.8744647370681413
SIM,1887,36,na,1923,2813
SIM,1937,20,20-24,1957,127
SIM,1886,15,15-19,1901,4
STAT,1908,44,20-24,1952,0.016456776873424707
STAT,1843,21,45-49,1864,0.7117009734688035
STAT,1902,23,50-100,1925,0.5848530399072034
SIM,1829,73,na,1902,492
STAT,1771,104,na,1875,0.029554160185989484
STAT,1843,45,15-19,1888,3.297453962152672E-4
STAT,1850,48,25-29,1898,0.04278259265024239
STAT,1846,45,30-34,1891,0.06991391838170302
STAT,1860,33,15-19,1893,0.11737543834146094
SIM,1929,15,45-49,1944,2
STAT,1852,42,20-24,1894,0.12778252354352002
STAT,1910,44,na,1954,3535.8967755153744
STAT,1911,31,15-19,1942,0.12816184345216902
STAT,1940,27,50-100,1967,1.035457059342523
STAT,1865,46,na,1911,2089.0483436143663
STAT,1911,20,na,1931,3713.7663176230612
SIM,1826,37,35-39,1863,7
STAT,1901,28,30-34,1929,35.79752129163992
SIM,1876,27,20-24,1903,13
SIM,1828,31,30-34,1859,25
STAT,1840,54,na,1894,1506.8071610953796
SIM,1895,22,30-34,1917,29
SIM,1903,29,50-100,1932,1
STAT,1867,31,40-44,1898,4.170384370215303
SIM,1934,23,na,1957,5115
STAT,1915,47,30-34,1962,0.09166532370717739
SIM,1940,23,na,1963,3801
SIM,1930,18,20-24,1948,186
STAT,1917,45,na,1962,3934.3647222589384
STAT,1860,43,50-100,1903,0.8681235265153932
STAT,1903,17,40-44,1920,0.26523955051573783
SIM,1926,24,25-29,1950,152
STAT,1914,31,30-34,1945,16.2470481809524
STAT,1914,41,40-44,1955,0.2532379375017595
STAT,1822,45,45-49,1867,0.34651989952209783
STAT,1841,32,35-39,1873,9.072252858322766
STAT,1875,48,30-34,1923,0.10007715729535623
STAT,1922,18,20-24,1940,159.67817012183085
STAT,1761,107,na,1868,0.00366899860199675
STAT,1862,22,25-29,1884,50.88971360399539
STAT,1845,16,30-34,1861,1.5833586500501102
STAT,1837,37,50-100,1874,0.9966403418630159
STAT,1856,2,na,1858,2835.801401390679
STAT,1918,24,25-29,1942,101.02644029702715
SIM,1871,24,35-39,1895,9
SIM,1898,18,45-49,1916,1
STAT,1878,25,25-29,1903,45.22297883972054
SIM,1870,22,25-29,1892,66
STAT,1859,35,30-34,1894,4.383324090866054
SIM,1913,6,na,1919,4287
SIM,1944,23,30-34,1967,44
STAT,1859,21,40-44,1880,1.9496378909566279
STAT,1787,67,na,1854,859.0
STAT,1898,28,45-49,1926,1.5263297034123615
SIM,1922,31,30-34,1953,4
STAT,1838,45,40-44,1883,0.13277056683243554
STAT,1826,52,20-24,1878,5.567611859531321E-4
SIM,1867,21,40-44,1888,3
STAT,1855,22,na,1877,1936.339713688116
STAT,1828,41,30-34,1869,0.955434279821405
STAT,1784,84,na,1868,90.11533999303677
SIM,1853,16,30-34,1869,1
STAT,1880,29,na,1909,2540.1380519409736
STAT,1913,39,45-49,1952,0.6794170096909344
STAT,1944,20,50-100,1964,0.7253372502206742
STAT,1868,23,na,1891,2297.305466338514
SIM,1908,29,35-39,1937,26
SIM,1869,36,50-100,1905,3
STAT,1863,24,35-39,1887,5.247403203228305
STAT,1885,15,20-24,1900,18.127557091181803
SIM,1899,29,15-19,1928,1
STAT,1837,24,25-29,1861,49.24984974797648
STAT,1957,14,na,1971,5279.9526308484565
STAT,1836,32,25-29,1868,8.0591151692813
STAT,1934,34,20-24,1968,3.3918454566342553
STAT,1871,46,na,1917,2279.9744613587045
STAT,1916,49,40-44,1965,0.16405628527187222
STAT,1946,25,50-100,1971,1.1322140841724504
STAT,1815,53,na,1868,1425.8696408559938
STAT,1860,9,na,1869,2325.7609885806246
SIM,1844,32,25-29,1876,15
STAT,1891,30,40-44,1921,5.5212910249368665
STAT,1817,82,na,1899,227.70740500913553
STAT,1830,50,20-24,1880,6.157200288160329E-4
SIM,1887,67,na,1954,1835
STAT,1842,89,na,1931,82.38345568809302
STAT,1908,21,50-100,1929,0.6187060888367117
SIM,1855,96,na,1951,2
STAT,1895,32,30-34,1927,23.239074973612027
SIM,1893,15,20-24,1908,39
SIM,1903,37,na,1940,3363
STAT,1860,74,na,1934,918.5878236156066
STAT,1927,26,25-29,1953,81.90508204462651
STAT,1864,35,40-44,1899,4.0084661166793145
STAT,1919,2,na,1921,4612.134039600671
STAT,1871,29,50-100,1900,0.6418047947197245
STAT,1906,38,50-100,1944,0.39152873115159037
SIM,1918,33,30-34,1951,22
SIM,1830,45,45-49,1875,1
STAT,1884,22,45-49,1906,0.7037945393358078
SIM,1891,39,25-29,1930,7
SIM,1845,24,25-29,1869,3
SIM,1835,26,20-24,1861,13
SIM,1836,41,30-34,1877,3
STAT,1832,25,na,1857,1935.832933706771
SIM,1876,4,na,1880,3237
SIM,1921,39,45-49,1960,2
SIM,1928,31,35-39,1959,19
STAT,1940,31,40-44,1971,4.134221091454006
SIM,1881,40,30-34,1921,1
SIM,1905,66,na,1971,2835
STAT,1894,17,20-24,1911,23.26370175241035
SIM,1867,38,35-39,1905,1
SIM,1872,38,45-49,1910,5
STAT,1802,83,na,1885,125.47249319315817
SIM,1872,68,na,1940,1506
STAT,1816,48,25-29,1864,0.11654576974208722
SIM,1841,41,40-44,1882,3
SIM,1921,20,25-29,1941,142
STAT,1931,28,50-100,1959,1.3099298150995011
STAT,1857,27,45-49,1884,0.91115123543848
STAT,1851,49,20-24,1900,0.009693500133231267
STAT,1897,44,35-39,1941,0.1692077573326832
SIM,1784,90,na,1874,15
SIM,1848,15,na,1863,2302
SIM,1827,47,na,1874,1438
SIM,1919,25,30-34,1944,58
STAT,1799,83,na,1882,135.0799818961172
STAT,1891,49,25-29,1940,0.04017950738923689
STAT,1800,54,na,1854,1329.7590155547687
STAT,1864,38,45-49,1902,1.7992875776919257
STAT,1874,29,na,1903,2467.9457228441224
SIM,1959,2,na,1961,5723
STAT,1887,46,30-34,1933,0.11096948303506259
STAT,1904,37,45-49,1941,0.6290927023927336
STAT,1926,28,na,1954,4565.157920503899
STAT,1913,20,25-29,1933,91.85600838301589
SIM,1893,36,na,1929,3138
STAT,1833,41,40-44,1874,1.8267837595165846
SIM,1865,27,45-49,1892,1
STAT,1926,29,45-49,1955,2.0976498865859483
STAT,1857,88,na,1945,109.37642989107705
SIM,1854,48,35-39,1902,1
SIM,1917,19,35-39,1936,7
STAT,1862,107,na,1969,0.050658097015095
SIM,1907,22,50-100,1929,1
STAT,1856,47,15-19,1903,3.1882777682759264E-4
SIM,1875,48,na,1923,2219
SIM,1923,25,20-24,1948,24
STAT,1781,73,na,1854,445.99999999999994
STAT,1855,50,na,1905,1693.1180138770503
SIM,1812,48,na,1860,1356
SIM,1908,19,25-29,1927,10
STAT,1838,19,na,1857,2201.6186970975364
STAT,1899,18,na,1917,3518.9513628562954
SIM,1886,35,35-39,1921,11
SIM,1870,26,40-44,1896,5
STAT,1884,46,15-19,1930,4.048589209521136E-4
STAT,1937,25,40-44,1962,4.638563544297498
STAT,1827,29,25-29,1856,81.73537600127705
STAT,1858,33,na,1891,1922.3970477324804
SIM,1958,3,na,1961,5146
STAT,1890,15,30-34,1905,1.997329074487572
SIM,1881,42,na,1923,2122
STAT,1879,3,na,1882,3249.2866056904063
STAT,1853,30,50-100,1883,0.8077618576616579
SIM,1882,42,40-44,1924,3
STAT,1887,47,45-49,1934,0.2685217537479904
STAT,1810,48,20-24,1858,0.037067991990577
STAT,1921,15,35-39,1936,4.903479480227344
SIM,1874,20,50-100,1894,1
SIM,1900,38,30-34,1938,5
STAT,1775,79,na,1854,245.0
STAT,1862,26,40-44,1888,2.629819681234766
STAT,1937,26,50-100,1963,0.9901332921781317
STAT,1930,27,45-49,1957,2.24047878688094
STAT,1878,35,35-39,1913,7.581788844305739
SIM,1902,52,na,1954,3102
SIM,1952,11,na,1963,4885
STAT,1861,54,30-34,1915,0.004879823705761087
SIM,1895,62,na,1957,2524
STAT,1882,35,50-100,1917,1.2318137075384383
SIM,1845,46,35-39,1891,1
STAT,1795,93,na,1888,6.346860873273535
STAT,1848,52,40-44,1900,0.008139925628714753
STAT,1837,100,na,1937,0.7078269371178647
SIM,1823,88,na,1911,43
SIM,1844,29,35-39,1873,16
STAT,1843,68,na,1911,1233.6726349802325
SIM,1826,68,na,1894,893
STAT,1874,42,40-44,1916,2.339875591738615
STAT,1901,24,15-19,1925,4.6768565918279785
STAT,1832,28,na,1860,1896.3249428373354
STAT,1909,26,40-44,1935,4.597315388012286
SIM,1894,25,15-19,1919,2
SIM,1945,25,40-44,1970,6
SIM,1826,31,na,1857,1855
STAT,1855,48,45-49,1903,0.18064806079007248
STAT,1871,12,na,1883,2668.068239565987
STAT,1910,36,25-29,1946,0.9650513909865882
STAT,1941,27,20-24,1968,19.264720063907447
SIM,1850,35,20-24,1885,1
STAT,1893,41,50-100,1934,1.3733897461318236
STAT,1806,73,na,1879,534.9958421360163
STAT,1842,35,20-24,1877,0.72400868029875
STAT,1851,47,30-34,1898,0.07948936325145815
STAT,1877,27,50-100,1904,0.6768495376510875
STAT,1905,42,45-49,1947,0.15293583199737887
STAT,1920,21,50-100,1941,0.7487549256541751
STAT,1882,52,na,1934,2128.5912428836145
STAT,1833,46,50-100,1879,0.19275450499880947
STAT,1876,18,15-19,1894,6.235250896875897
SIM,1919,18,na,1937,4115
STAT,1901,38,40-44,1939,1.341211376460451
SIM,1932,36,50-100,1968,1
STAT,1928,25,30-34,1953,49.572919540645294
STAT,1836,29,35-39,1865,7.660689910509731
SIM,1868,60,na,1928,1827
STAT,1824,98,na,1922,1.7886965200216807
SIM,1831,24,30-34,1855,16
STAT,1852,54,20-24,1906,5.781215592025717E-4
SIM,1858,16,15-19,1874,7
STAT,1849,59,na,1908,1508.8288733981701
STAT,1901,36,15-19,1937,0.017374029976260176
SIM,1914,5,na,1919,4200
STAT,1855,35,30-34,1890,4.170716681267066
STAT,1856,40,30-34,1896,0.9299481198521143
STAT,1917,44,50-100,1961,0.1246964079969504
SIM,1928,30,20-24,1958,3
STAT,1902,41,15-19,1943,0.0013858789614997998
STAT,1807,51,40-44,1858,0.044390509549345786
SIM,1900,26,30-34,1926,33
STAT,1965,6,na,1971,5005.235972507776
SIM,1831,83,na,1914,311
STAT,1868,28,35-39,1896,9.368507202592347
STAT,1846,48,na,1894,1588.694094579235
STAT,1886,25,15-19,1911,0.4932372267666543
SIM,1848,100,na,1948,4
SIM,1851,35,na,1886,1914
SIM,1917,26,40-44,1943,2
SIM,1858,34,45-49,1892,4
SIM,1906,42,na,1948,3424
STAT,1819,39,50-100,1858,2.9263970254807306
SIM,1814,49,50-100,1863,1
SIM,1894,20,20-24,1914,6
SIM,1819,80,na,1899,322
STAT,1787,98,na,1885,0.7077874657916676
STAT,1902,15,na,1917,3650.333445072229
SIM,1899,35,45-49,1934,7
STAT,1923,24,35-39,1947,11.108305178872923
STAT,1855,53,na,1908,1642.3321841353197
STAT,1886,20,20-24,1906,74.85653244749648
STAT,1919,48,45-49,1967,0.23989052666429198
STAT,1871,24,25-29,1895,57.48596137023843
SIM,1931,24,35-39,1955,16
STAT,1768,91,na,1859,23.635228648371402
STAT,1859,29,50-100,1888,0.5225770103600771
STAT,1837,46,35-39,1883,0.09814536420912033
STAT,1860,49,30-34,1909,0.07844983836834689
STAT,1940,21,30-34,1961,29.878928703078202
SIM,1868,49,40-44,1917,1
SIM,1927,36,45-49,1963,1
SIM,1820,77,na,1897,529
STAT,1844,52,50-100,1896,0.011640989909395577
STAT,1954,15,30-34,1969,15.37769282689289
SIM,1874,0,na,1874,3699
STAT,1888,40,na,1928,2815.5277337872944
SIM,1884,21,40-44,1905,6
STAT,1831,35,45-49,1866,1.7960210169146527
STAT,1914,34,na,1948,3851.0064463146714
STAT,1933,23,15-19,1956,7.198508288727656
SIM,1850,50,na,1900,1590
STAT,1894,15,30-34,1909,2.1012219450546747
SIM,1845,34,35-39,1879,4
SIM,1868,63,na,1931,1666
STAT,1869,73,na,1942,1169.827608022524
STAT,1909,19,35-39,1928,0.8347276020964471
SIM,1835,24,30-34,1859,19
SIM,1862,31,30-34,1893,16
STAT,1870,40,15-19,1910,0.013910992656699941
STAT,1882,37,15-19,1919,0.05581071766864551
SIM,1868,37,40-44,1905,5
STAT,1881,3,na,1884,2967.6246127774684
SIM,1932,37,30-34,1969,5
SIM,1861,19,25-29,1880,4
STAT,1872,38,35-39,1910,7.195696074467822
STAT,1930,15,45-49,1945,0.661749314865402
STAT,1851,60,na,1911,1573.456378215051
SIM,1877,23,25-29,1900,69
SIM,1895,47,45-49,1942,1
SIM,1909,24,25-29,1933,99
STAT,1898,47,20-24,1945,0.009294654690138595
SIM,1877,35,25-29,1912,1
STAT,1890,31,35-39,1921,12.683484502308373
SIM,1880,38,35-39,1918,13
STAT,1836,22,15-19,1858,2.7102112685169155
STAT,1869,35,25-29,1904,2.862676996225128
STAT,1871,15,na,1886,2599.1985539447046
STAT,1933,35,15-19,1968,0.02672091674975711
SIM,1903,25,35-39,1928,14
STAT,1843,65,na,1908,1364.261127945016
STAT,1830,27,40-44,1857,3.388558628504457
STAT,1924,37,30-34,1961,2.192662190566866
SIM,1919,15,na,1934,4455
STAT,1910,43,30-34,1953,0.12249146517352655
STAT,1853,19,25-29,1872,5.648664792491865
SIM,1890,37,15-19,1927,4
STAT,1815,46,15-19,1861,0.0010941543596989067
SIM,1863,35,30-34,1898,5
STAT,1823,40,35-39,1863,3.0770574353348525
STAT,1926,22,na,1948,4525.927600170564
STAT,1909,30,45-49,1939,1.5437616809938277
SIM,1935,24,35-39,1959,15
SIM,1880,26,35-39,1906,17
STAT,1867,22,45-49,1889,0.6705982299088226
STAT,1902,49,na,1951,3169.7322243545987
STAT,1820,53,30-34,1873,0.010231958491179626
SIM,1825,83,na,1908,210
SIM,1767,87,na,1854,72
STAT,1907,55,na,1962,3232.8145259681437
STAT,1919,36,45-49,1955,0.7480492022811613
STAT,1887,24,20-24,1911,78.28302008922972
SIM,1824,36,na,1860,1624
STAT,1826,110,na,1936,1.6117161432293008E-4
SIM,1788,86,na,1874,142
SIM,1960,6,na,1966,5242
SIM,1773,81,na,1854,105
STAT,1902,44,50-100,1946,0.10411755817706404
STAT,1837,34,35-39,1871,8.29173522429391
STAT,1868,51,50-100,1919,0.01478603468910063
STAT,1936,36,45-49,1972,0.6832260745237396
SIM,1895,24,20-24,1919,90
STAT,1811,53,20-24,1864,0.001914003478580049
SIM,1853,24,15-19,1877,3
SIM,1845,35,na,1880,1969
SIM,1858,23,20-24,1881,1
STAT,1848,49,15-19,1897,3.0444093975141233E-4
SIM,1919,35,40-44,1954,1
STAT,1895,25,na,1920,3198.0388964924477
STAT,1920,34,na,1954,4191.364826141505
STAT,1894,40,na,1934,3063.453463395501
STAT,1877,37,40-44,1914,4.631774282921616
SIM,1876,25,30-34,1901,35
STAT,1919,5,na,1924,4534.237819548922
SIM,1891,36,20-24,1927,1
STAT,1946,23,25-29,1969,104.83818450265207
STAT,1872,33,40-44,1905,4.415276113078169
STAT,1935,20,45-49,1955,1.5636221045870056
STAT,1925,47,25-29,1972,0.06557968795103798
SIM,1794,80,na,1874,181
STAT,1916,35,15-19,1951,0.020258683049256675
SIM,1844,50,na,1894,1732
SIM,1828,33,20-24,1861,1
SIM,1851,49,30-34,1900,1
SIM,1944,26,35-39,1970,23
STAT,1931,16,40-44,1947,1.8717215018574866
STAT,1858,22,35-39,1880,5.416622179815902
SIM,1907,46,50-100,1953,1
SIM,1836,21,na,1857,2288
SIM,1894,27,40-44,1921,7
STAT,1916,47,15-19,1963,3.855687318060337E-4
STAT,1941,15,20-24,1956,142.5425975716848
SIM,1952,17,na,1969,4874
STAT,1857,85,na,1942,218.40807937444222
STAT,1883,48,20-24,1931,0.011860659706955136
STAT,1858,9,na,1867,2302.3932786957744
STAT,1873,53,45-49,1926,0.01476846521457735
STAT,1866,48,20-24,1914,0.011149762747071256
STAT,1927,24,35-39,1951,11.759739008300684
SIM,1848,24,40-44,1872,1
SIM,1813,42,40-44,1855,4
SIM,1818,36,30-34,1854,6
SIM,1838,56,na,1894,1289
STAT,1859,52,50-100,1911,0.012238933173842722
SIM,1885,27,30-34,1912,32
SIM,1905,34,35-39,1939,10
SIM,1918,30,na,1948,4234
SIM,1830,35,35-39,1865,1
SIM,1827,36,40-44,1863,7
STAT,1877,27,30-34,1904,26.644614662840155
SIM,1899,55,na,1954,2883
STAT,1822,35,35-39,1857,14.646825932756043
STAT,1886,39,40-44,1925,4.6793065590731375
SIM,1867,25,20-24,1892,2
SIM,1894,39,40-44,1933,13
SIM,1937,6,na,1943,4661
STAT,1851,94,na,1945,16.48886149312662
STAT,1864,33,na,1897,2155.446015773271
SIM,1857,20,na,1877,2298
STAT,1916,45,25-29,1961,0.055783261388088194
STAT,1907,33,15-19,1940,0.12196607431338974
STAT,1874,26,na,1900,2494.241875966998
STAT,1819,48,40-44,1867,0.3342804975820538
STAT,1836,24,50-100,1860,0.33021417307046497
STAT,1835,20,40-44,1855,2.803570862977727
STAT,1911,22,50-100,1933,0.636543314302219
STAT,1825,47,20-24,1872,0.015433958439261267
STAT,1945,26,45-49,1971,1.9346354046166057
STAT,1842,47,20-24,1889,0.009412028046443508
STAT,1901,31,20-24,1932,3.871885879866962
SIM,1862,78,na,1940,612
STAT,1929,21,50-100,1950,0.8512445700379341
STAT,1831,32,40-44,1863,3.9716959060450563
STAT,1886,27,40-44,1913,3.2346461491549645
STAT,1862,19,35-39,1881,0.490785605772231
STAT,1907,45,15-19,1952,3.413423556633558E-4
SIM,1937,30,30-34,1967,22
SIM,1943,20,45-49,1963,1
SIM,1883,77,na,1960,1150
STAT,1864,41,35-39,1905,1.6499893323586337
STAT,1887,30,15-19,1917,0.1640995036095034
STAT,1802,80,na,1882,236.71179925097405
STAT,1942,5,na,1947,4255.874459090156
STAT,1881,9,na,1890,2559.0279907631516
SIM,1909,34,35-39,1943,17
SIM,1849,22,35-39,1871,10
STAT,1819,36,40-44,1855,13.453412424925157
STAT,1929,42,30-34,1971,0.16886607125692674
SIM,1835,29,25-29,1864,61
SIM,1814,43,na,1857,1377
SIM,1870,19,35-39,1889,1
STAT,1841,36,15-19,1877,0.049360124693456506
SIM,1912,22,40-44,1934,4
SIM,1880,33,40-44,1913,12
STAT,1877,17,20-24,1894,18.75831024177443
SIM,1844,36,40-44,1880,9
STAT,1831,37,35-39,1868,6.221783974464271
SIM,1904,30,35-39,1934,23
STAT,1827,103,na,1930,0.09275653206198115
STAT,1859,25,20-24,1884,9.863902921551283
SIM,1927,28,50-100,1955,1
STAT,1867,78,na,1945,748.3071072010547
STAT,1932,18,15-19,1950,61.12484915787833
STAT,1827,72,na,1899,816.2333895116625
STAT,1910,33,20-24,1943,2.3885893146417385
SIM,1859,21,15-19,1880,3
SIM,1872,37,50-100,1909,2
SIM,1872,41,35-39,1913,4
STAT,1850,13,na,1863,2184.3442101613755
SIM,1940,18,15-19,1958,48
SIM,1943,16,40-44,1959,1
STAT,1946,19,20-24,1965,153.31756963948283
SIM,1843,20,40-44,1863,3
STAT,1816,45,20-24,1861,0.025490620122192057
STAT,1915,37,20-24,1952,0.27174399482974093
SIM,1958,0,na,1958,5157
STAT,1853,17,35-39,1870,0.5534606052369759
STAT,1844,13,na,1857,2340.8608852973516
STAT,1847,53,35-39,1900,0.006605664647905298
STAT,1845,38,40-44,1883,3.5566055818580526
STAT,1892,38,20-24,1930,0.9806895406803737
STAT,1897,41,30-34,1938,0.10939103743198395
SIM,1925,18,na,1943,4619
STAT,1882,55,na,1937,2055.052597876914
STAT,1835,53,50-100,1888,0.011247446637035583
STAT,1846,46,45-49,1892,0.16924790235966783
SIM,1932,39,20-24,1971,5
STAT,1904,22,40-44,1926,3.046665697583459
SIM,1901,45,50-100,1946,1
STAT,1847,103,na,1950,0.11191488077190813
STAT,1931,32,45-49,1963,2.1028454139509583
SIM,1822,72,na,1894,625
STAT,1840,20,na,1860,1985.0344635297708
STAT,1846,23,20-24,1869,60.36914421135329
SIM,1875,22,45-49,1897,1
STAT,1899,42,50-100,1941,0.10235857591234668
SIM,1861,17,35-39,1878,1
SIM,1900,57,na,1957,2829
SIM,1913,26,40-44,1939,6
STAT,1908,45,50-100,1953,0.21164989753709898
SIM,1946,17,na,1963,4324
STAT,1812,73,na,1885,572.4286339409464
STAT,1888,77,na,1965,1377.8467119469212
SIM,1820,43,na,1863,1658
SIM,1886,47,35-39,1933,1
STAT,1964,7,na,1971,5048.689310735549
STAT,1878,47,35-39,1925,0.14796750907468006
STAT,1915,25,20-24,1940,19.128177411876706
STAT,1935,16,40-44,1951,1.9547801067193447
SIM,1819,44,35-39,1863,5
SIM,1918,36,35-39,1954,5
STAT,1836,36,40-44,1872,3.3795828690263363
STAT,1883,36,20-24,1919,0.7753068128676152
SIM,1853,38,40-44,1891,3
STAT,1831,25,35-39,1856,10.354139320978929
STAT,1807,58,na,1865,1233.545297150308
STAT,1911,41,25-29,1952,0.06992224885448366
STAT,1929,30,30-34,1959,20.434690465583785
STAT,1832,52,45-49,1884,0.010136170077211713
STAT,1865,12,na,1877,2502.9947672092976
STAT,1905,26,40-44,1931,4.428643744229531
STAT,1924,39,20-24,1963,0.3164627744674252
SIM,1854,23,20-24,1877,80
STAT,1837,34,na,1871,1774.4338392151462
STAT,1880,4,na,1884,3062.1215467532425
SIM,1912,15,35-39,1927,1
STAT,1884,42,50-100,1926,1.0649457830888596
SIM,1892,42,50-100,1934,4
STAT,1806,52,35-39,1858,0.027987232000103755
SIM,1854,49,na,1903,1888
SIM,1877,77,na,1954,805
SIM,1876,7,na,1883,3152
STAT,1862,29,45-49,1891,0.9572960403863022
STAT,1887,44,40-44,1931,2.5365156374946607
SIM,1881,36,50-100,1917,1
STAT,1933,39,30-34,1972,2.5262825344766378
STAT,1920,9,na,1929,4557.85003283101
SIM,1928,29,20-24,1957,28
STAT,1899,23,35-39,1922,8.126799187140582
STAT,1847,50,30-34,1897,0.004708581263185749
SIM,1836,44,35-39,1880,8
STAT,1842,45,50-100,1887,0.19763253035520428
SIM,1940,25,20-24,1965,21
STAT,1827,106,na,1933,0.007847408867949754
STAT,1897,48,15-19,1945,3.039046698365575E-4
SIM,1886,37,25-29,1923,1
SIM,1904,24,40-44,1928,3
STAT,1913,27,45-49,1940,1.756112989475322
SIM,1895,49,35-39,1944,1
SIM,1903,15,25-29,1918,17
STAT,1887,49,35-39,1936,0.08839026426824272
STAT,1836,26,30-34,1862,20.4298762663805
STAT,1815,52,45-49,1867,0.03729809901325663
STAT,1910,26,15-19,1936,0.6976659131732569
STAT,1932,25,20-24,1957,24.40397677878347
STAT,1844,17,25-29,1861,5.581984013574838
STAT,1853,27,na,1880,2101.3214982158843
SIM,1817,54,na,1871,1206
STAT,1926,43,50-100,1969,0.14751432401987713
SIM,1795,68,na,1863,726
SIM,1852,17,25-29,1869,7
STAT,1861,53,na,1914,1785.9093755510544
SIM,1889,62,na,1951,2417
STAT,1859,18,15-19,1877,5.579327044813737
SIM,1930,26,40-44,1956,9
STAT,1882,43,45-49,1925,1.4767307967024155
STAT,1868,26,na,1894,2333.3303145305213
STAT,1891,42,40-44,1933,2.8373332212028934
SIM,1894,23,25-29,1917,104
SIM,1899,32,40-44,1931,8
SIM,1869,34,20-24,1903,3
SIM,1926,16,40-44,1942,2
STAT,1863,23,20-24,1886,62.415908425193834
STAT,1876,16,25-29,1892,5.984159449104411
STAT,1891,66,na,1957,2123.6864302717086
STAT,1803,100,na,1903,0.4119553923938112
STAT,1848,71,na,1919,1037.5847157643166
SIM,1805,69,na,1874,656
STAT,1904,15,35-39,1919,0.8059762539420846
SIM,1921,27,45-49,1948,3
STAT,1909,29,45-49,1938,1.6718348820490967
SIM,1890,30,30-34,1920,35
SIM,1847,61,na,1908,1314
STAT,1922,26,40-44,1948,5.400099368207575
STAT,1935,19,45-49,1954,0.6926903651384421
STAT,1964,4,na,1968,5051.265024543795
SIM,1946,20,50-100,1966,5
STAT,1810,46,30-34,1856,0.3097323458575713
STAT,1873,43,35-39,1916,1.8593044659699896
SIM,1890,43,45-49,1933,3
SIM,1960,9,na,1969,5241
STAT,1909,16,30-34,1925,2.4437453566554863
SIM,1859,27,20-24,1886,14
SIM,1917,16,30-34,1933,3
STAT,1872,23,30-34,1895,18.155531957556256
STAT,1884,81,na,1965,837.4517880903959
SIM,1874,63,na,1937,1804
STAT,1895,35,35-39,1930,9.503543085820011
STAT,1834,20,na,1854,1838.3354196899759
STAT,1932,22,na,1954,4886.450749739721
STAT,1938,20,50-100,1958,0.6647623688205919
SIM,1827,32,25-29,1859,12
STAT,1789,90,na,1879,24.502306579258548
STAT,1873,36,50-100,1909,1.275904021067316
SIM,1881,43,35-39,1924,2
STAT,1896,49,45-49,1945,0.17561961765189676
SIM,1903,31,50-100,1934,1
SIM,1869,48,na,1917,2199
SIM,1872,31,25-29,1903,10
STAT,1866,17,45-49,1883,0.06309040006453484
SIM,1850,45,50-100,1895,1
STAT,1828,44,35-39,1872,1.4335409975643505
SIM,1835,27,35-39,1862,16
SIM,1822,34,30-34,1856,2
STAT,1831,46,na,1877,1646.5614732205686
STAT,1935,19,50-100,1954,0.5195177738538316
SIM,1905,41,40-44,1946,2
STAT,1941,3,na,1944,4237.692517777237
STAT,1882,30,30-34,1912,17.49229286716476
STAT,1910,41,na,1951,3600.495804343753
SIM,1858,31,40-44,1889,6
STAT,1857,46,20-24,1903,0.009587771457682163
STAT,1769,110,na,1879,9.589326587079648E-4
STAT,1919,40,na,1959,4118.501478213934
SIM,1931,21,30-34,1952,61
STAT,1936,26,35-39,1962,14.661378186848406
SIM,1871,89,na,1960,246
SIM,1855,30,50-100,1885,1
SIM,1830,25,25-29,1855,55
SIM,1926,20,45-49,1946,3
STAT,1878,37,25-29,1915,3.057307853932329
STAT,1800,88,na,1888,58.01611733414403
STAT,1803,99,na,1902,0.7348866196796315
SIM,1863,38,35-39,1901,9
STAT,1894,18,35-39,1912,0.7181396613677299
STAT,1929,40,40-44,1969,0.3312961717080047
STAT,1896,30,25-29,1926,13.911337890013163
STAT,1850,16,na,1866,2122.4310766325166
STAT,1868,21,15-19,1889,3.237708044204117
SIM,1866,22,35-39,1888,8
STAT,1881,25,30-34,1906,25.004836559020294
STAT,1832,42,35-39,1874,1.4878906474013611
STAT,1865,37,15-19,1902,0.05199366764488033
SIM,1828,94,na,1922,31
STAT,1928,35,40-44,1963,1.9330946342751512
SIM,1861,90,na,1951,24
STAT,1889,25,na,1914,3027.7649884114003
STAT,1836,86,na,1922,138.10340973354033
SIM,1868,33,25-29,1901,5
SIM,1798,79,na,1877,222
STAT,1824,47,50-100,1871,0.28622938568010436
STAT,1827,27,35-39,1854,32.188958499946345
STAT,1923,21,30-34,1944,34.22372713280044
STAT,1790,87,na,1877,61.02191099288979
SIM,1928,33,25-29,1961,18
STAT,1947,21,na,1968,4212.270822986029
SIM,1851,38,na,1889,1848
STAT,1868,25,30-34,1893,24.702884056787106
SIM,1927,33,40-44,1960,1
STAT,1892,48,30-34,1940,0.06893643808464724
SIM,1862,34,35-39,1896,1
SIM,1819,46,25-29,1865,1
SIM,1835,76,na,1911,550
STAT,1846,33,30-34,1879,14.60270960077144
SIM,1840,42,35-39,1882,6
SIM,1888,15,na,1903,2995
STAT,1856,53,45-49,1909,0.011434994832799762
SIM,1924,30,na,1954,4556
SIM,1870,29,45-49,1899,1
SIM,1849,32,45-49,1881,3
STAT,1770,111,na,1881,7.659794404204088E-4
SIM,1914,28,15-19,1942,1
STAT,1906,28,15-19,1934,0.6713069371648276
STAT,1818,98,na,1916,1.6555111648550243
SIM,1844,26,30-34,1870,33
SIM,1893,30,na,1923,3167
STAT,1925,40,na,1965,4600.192202130405
STAT,1807,48,15-19,1855,0.0017166678635769984
STAT,1840,37,45-49,1877,1.696673113099948
STAT,1871,28,40-44,1899,3.01643574287277
STAT,1846,48,35-39,1894,0.09885907308604766
STAT,1876,52,na,1928,2256.1352689901028
STAT,1865,52,40-44,1917,0.009695689085730255
SIM,1866,34,na,1900,2309
SIM,1858,26,25-29,1884,38
SIM,1904,16,na,1920,3962
STAT,1883,50,35-39,1933,0.008741205931230754
STAT,1838,31,50-100,1869,0.8452684961172023
STAT,1925,44,20-24,1969,0.02174158206965112
STAT,1857,1,na,1858,2972.6731667452714
SIM,1931,31,40-44,1962,8
SIM,1853,22,25-29,1875,52
SIM,1865,89,na,1954,11
STAT,1850,41,40-44,1891,1.6995716726303385
SIM,1853,6,na,1859,2438
SIM,1905,31,30-34,1936,14
SIM,1831,49,45-49,1880,1
STAT,1795,90,na,1885,27.664419867103547
STAT,1829,45,30-34,1874,0.08038466589746607
SIM,1836,24,15-19,1860,2
STAT,1881,38,45-49,1919,1.9563788821263914
SIM,1936,35,40-44,1971,1
STAT,1898,16,45-49,1914,0.09033714598328357
STAT,1904,41,na,1945,3406.1976762446857
SIM,1865,45,50-100,1910,1
STAT,1895,49,50-100,1944,0.18054666695835203
SIM,1846,31,50-100,1877,1
SIM,1859,37,30-34,1896,9
SIM,1862,75,na,1937,844
STAT,1922,20,35-39,1942,11.083471397831284
STAT,1774,91,na,1865,12.469850465138954
SIM,1918,26,25-29,1944,71
STAT,1837,31,30-34,1868,14.74781828443578
STAT,1910,46,35-39,1956,0.12299234643626852
SIM,1854,33,30-34,1887,4
SIM,1913,22,25-29,1935,106
STAT,1905,18,20-24,1923,26.051800319346654
STAT,1900,19,15-19,1919,8.346156469371849
SIM,1887,42,25-29,1929,1
STAT,1822,32,na,1854,1652.6835981667646
STAT,1871,18,30-34,1889,1.6114985022646844
STAT,1814,47,45-49,1861,0.7036716738113583
STAT,1854,34,35-39,1888,7.774146492507087
STAT,1825,46,na,1871,1565.5665742852627
STAT,1791,104,na,1895,0.011768425612574225
STAT,1828,34,25-29,1862,9.466677465823933
STAT,1904,30,50-100,1934,1.3503793007139904
SIM,1914,38,25-29,1952,2
STAT,1857,45,50-100,1902,0.1976249468561179
STAT,1845,22,25-29,1867,55.527774504797925
STAT,1824,61,na,1885,1087.418498219968
STAT,1839,97,na,1936,3.707625273140773
STAT,1916,42,20-24,1958,0.018468595407803202
STAT,1946,20,20-24,1966,126.3334378791734
SIM,1877,74,na,1951,1026
STAT,1896,36,30-34,1932,7.215386699493141
STAT,1880,1,na,1881,3646.991992048899
SIM,1856,75,na,1931,936
SIM,1912,30,50-100,1942,1
STAT,1833,72,na,1905,829.3376577985302
STAT,1823,49,45-49,1872,0.3448783571191177
SIM,1818,49,45-49,1867,1
STAT,1837,31,na,1868,1830.5794983482226
SIM,1818,39,35-39,1857,13
SIM,1897,1,na,1898,3629
STAT,1846,43,40-44,1889,1.6072546481028827
SIM,1898,73,na,1971,2227
SIM,1862,24,25-29,1886,53
STAT,1931,22,35-39,1953,12.454751327049848
SIM,1810,84,na,1894,327
STAT,1847,30,50-100,1877,0.8565185546377411
STAT,1846,45,na,1891,1624.9502492478905
SIM,1845,31,30-34,1876,31
STAT,1833,48,25-29,1881,0.04009623991011887
STAT,1876,24,45-49,1900,0.729980442487646
SIM,1878,40,25-29,1918,3
SIM,1854,43,40-44,1897,3
STAT,1879,66,na,1945,1747.7666654881125
SIM,1904,20,25-29,1924,105
STAT,1840,19,15-19,1859,5.464181208422519
SIM,1900,28,20-24,1928,24
SIM,1841,76,na,1917,679
SIM,1894,15,na,1909,3413
SIM,1927,44,na,1971,4631
SIM,1801,70,na,1871,776
STAT,1879,52,35-39,1931,0.009131441803329652
STAT,1839,60,na,1899,1316.2302039084914
STAT,1854,24,25-29,1878,50.742378097965485
STAT,1863,36,35-39,1899,6.356836036198492
SIM,1876,28,35-39,1904,17
SIM,1912,25,45-49,1937,3
STAT,1886,23,25-29,1909,61.623497346534826
SIM,1842,24,na,1866,1919
STAT,1907,49,30-34,1956,0.08051227121109707
STAT,1843,52,20-24,1895,5.925311750032558E-4
SIM,1917,29,45-49,1946,2
STAT,1802,54,25-29,1856,0.009015416936324131
STAT,1887,34,30-34,1921,19.78790674350702
SIM,1831,30,25-29,1861,10
SIM,1863,23,na,1886,2104
STAT,1810,47,na,1857,1248.4874993643614
STAT,1920,37,na,1957,4203.606335987244
STAT,1937,31,35-39,1968,9.227464869217764
STAT,1940,24,35-39,1964,9.778749272920512
SIM,1836,34,25-29,1870,16
STAT,1824,51,40-44,1875,0.012074089679998566
SIM,1936,25,30-34,1961,51
SIM,1877,25,15-19,1902,1
SIM,1885,17,20-24,1902,23
STAT,1890,21,25-29,1911,71.62013808384742
SIM,1895,34,30-34,1929,36
STAT,1830,61,na,1891,1182.0841840445783
SIM,1912,45,na,1957,3700
STAT,1780,91,na,1871,16.503969146463568
STAT,1895,25,25-29,1920,56.685636687863415
STAT,1901,34,25-29,1935,14.486784864687305
STAT,1906,38,25-29,1944,0.918179647280216
STAT,1838,51,35-39,1889,0.006417701893150491
STAT,1945,23,40-44,1968,3.758528172978428
SIM,1789,68,na,1857,776
SIM,1913,18,20-24,1931,40
STAT,1819,46,na,1865,1609.8563192087927
STAT,1835,23,45-49,1858,0.685952209311529
STAT,1891,34,50-100,1925,1.1473086210861854
SIM,1904,39,45-49,1943,3
SIM,1859,89,na,1948,133
STAT,1874,49,25-29,1923,0.05874133407600562
STAT,1919,23,30-34,1942,32.01710990032712
STAT,1836,39,45-49,1875,1.4918364943371154
STAT,1923,31,40-44,1954,4.596047825172696
SIM,1819,41,30-34,1860,4
SIM,1874,44,50-100,1918,6
STAT,1840,24,30-34,1864,16.067046634643745
STAT,1868,28,50-100,1896,0.6211013778142239
SIM,1937,9,na,1946,4620
STAT,1904,25,45-49,1929,1.6343495016120748
STAT,1864,67,na,1931,1437.9230560856029
STAT,1878,32,30-34,1910,18.53979697843537
SIM,1927,23,30-34,1950,48
STAT,1876,21,40-44,1897,2.2017727971439047
SIM,1881,29,20-24,1910,12
SIM,1845,36,25-29,1881,4
STAT,1905,22,25-29,1927,84.34251058183993
STAT,1870,67,na,1937,1580.8786113981105
STAT,1866,44,50-100,1910,0.9806713812469434
SIM,1864,40,30-34,1904,3
SIM,1867,28,25-29,1895,46
STAT,1872,36,45-49,1908,2.0480098859144604
SIM,1899,8,na,1907,3638
SIM,1928,29,na,1957,4817
SIM,1802,55,na,1857,1032
STAT,1890,81,na,1971,1146.748530011822
STAT,1936,16,25-29,1952,42.420225870067455
SIM,1886,32,30-34,1918,26
STAT,1920,40,20-24,1960,0.019959795312268633
SIM,1857,23,na,1880,2116
SIM,1804,84,na,1888,153
STAT,1885,66,na,1951,1668.149769441578
SIM,1897,29,na,1926,3163
STAT,1837,36,25-29,1873,2.3616312216241595
STAT,1862,16,30-34,1878,1.59462161845066
STAT,1935,36,na,1971,5369.808677555297
STAT,1781,107,na,1888,0.0077686733233689916
SIM,1918,21,30-34,1939,61
SIM,1944,16,25-29,1960,56
SIM,1828,43,30-34,1871,1
SIM,1880,36,45-49,1916,1
STAT,1859,28,25-29,1887,34.80675646351617
STAT,1880,35,30-34,1915,5.767726678021691
STAT,1958,12,na,1970,5261.493269619431
STAT,1843,36,na,1879,2039.5484063430106
STAT,1914,48,30-34,1962,0.08995410834217638
STAT,1866,27,20-24,1893,11.038945873524954
STAT,1885,44,20-24,1929,0.1594547463403101
STAT,1879,33,40-44,1912,4.6049640261510145
SIM,1926,15,15-19,1941,73
SIM,1926,11,na,1937,5270
SIM,1934,30,na,1964,5378
SIM,1888,20,na,1908,3004
STAT,1882,43,40-44,1925,2.2193543590307705
STAT,1827,73,na,1900,767.6675028357189
SIM,1925,22,45-49,1947,4
SIM,1844,44,25-29,1888,1
STAT,1877,25,30-34,1902,26.82538047753541
STAT,1926,20,45-49,1946,1.4028251932676503
SIM,1785,77,na,1862,297
SIM,1841,43,45-49,1884,2
SIM,1899,35,50-100,1934,5
STAT,1843,34,15-19,1877,0.13536565156262448
STAT,1845,42,25-29,1887,0.5109387113085541
STAT,1866,39,15-19,1905,0.05230795951902211
STAT,1865,46,45-49,1911,0.2191334669975927
SIM,1830,81,na,1911,323
SIM,1945,20,20-24,1965,136
SIM,1836,25,35-39,1861,1
STAT,1769,94,na,1863,1.9504024842244791
SIM,1865,29,20-24,1894,13
SIM,1885,25,30-34,1910,44
STAT,1929,21,25-29,1950,119.4977002593526
SIM,1928,23,25-29,1951,159
STAT,1861,18,30-34,1879,1.5351954730158357
SIM,1800,83,na,1883,119
STAT,1856,48,45-49,1904,0.18661496479560583
SIM,1834,95,na,1929,5
STAT,1824,50,40-44,1874,0.012316139414327215
STAT,1870,16,30-34,1886,1.6141555665092127
SIM,1853,22,30-34,1875,23
SIM,1873,46,45-49,1919,1
SIM,1890,43,40-44,1933,6
SIM,1878,35,40-44,1913,14
STAT,1836,44,25-29,1880,0.4634990601934332
STAT,1820,34,20-24,1854,8.105658368728617
SIM,1887,33,40-44,1920,10
STAT,1815,52,40-44,1867,0.02705692603917743
STAT,1818,37,na,1855,1525.41752339806
SIM,1909,31,na,1940,3518
SIM,1854,29,45-49,1883,2
SIM,1839,39,20-24,1878,2
STAT,1896,45,35-39,1941,0.10746352687252408
STAT,1873,45,40-44,1918,0.1788287757913583
SIM,1870,31,20-24,1901,4
SIM,1826,76,na,1902,518
SIM,1871,26,40-44,1897,4
SIM,1917,30,50-100,1947,1
STAT,1863,38,35-39,1901,6.2950079130988374
STAT,1852,72,na,1924,1017.3902048469018
SIM,1906,24,50-100,1930,1
STAT,1863,26,40-44,1889,2.6987644194136613
STAT,1854,28,40-44,1882,2.386207311007187
SIM,1862,28,40-44,1890,2
STAT,1847,50,35-39,1897,0.0068099315820737485
STAT,1838,52,35-39,1890,0.006291850759025811
STAT,1813,44,30-34,1857,3.510774682738397
SIM,1951,10,na,1961,5316
SIM,1821,44,30-34,1865,2
SIM,1900,18,na,1918,3617
STAT,1872,36,35-39,1908,7.266370549992166
STAT,1881,53,na,1934,2089.5236324706766
STAT,1885,67,na,1952,1613.4010940085057
STAT,1845,22,30-34,1867,17.277768775339045
SIM,1917,50,na,1967,3702
STAT,1822,42,30-34,1864,1.790104691033016
STAT,1846,29,45-49,1875,0.946802129037423
STAT,1856,86,na,1942,177.6792245347526
STAT,1872,24,40-44,1896,2.117210344353044
SIM,1871,38,35-39,1909,3
STAT,1895,16,35-39,1911,0.7321315981954984
SIM,1894,23,30-34,1917,35
STAT,1835,28,30-34,1863,24.287305963103833
SIM,1892,15,20-24,1907,32
SIM,1936,22,20-24,1958,154
SIM,1834,40,50-100,1874,3
STAT,1886,18,35-39,1904,0.5909504154505671
STAT,1837,36,40-44,1873,3.59060066998379
STAT,1892,37,na,1929,3012.2626136414488
STAT,1875,37,15-19,1912,0.05879442449862037
STAT,1879,53,35-39,1932,0.009032913546271726
STAT,1889,19,15-19,1908,7.438281298887489
STAT,1880,22,25-29,1902,61.36899086005961
STAT,1858,28,25-29,1886,34.781548237544435
STAT,1825,38,15-19,1863,0.08322668317073147
STAT,1853,19,35-39,1872,0.5469600400179473
STAT,1859,37,30-34,1896,4.342086766697098
STAT,1861,38,25-29,1899,2.4150335042367943
SIM,1919,30,20-24,1949,4
STAT,1899,46,15-19,1945,3.1609755292693383E-4
SIM,1842,16,20-24,1858,19
SIM,1877,26,35-39,1903,11
STAT,1877,48,na,1925,2350.613566156822
STAT,1894,37,25-29,1931,3.7781349673267806
STAT,1843,47,20-24,1890,0.009642113920284816
STAT,1857,29,20-24,1886,9.489464025312172
STAT,1871,37,30-34,1908,5.385669619729276
SIM,1919,25,25-29,1944,71
STAT,1792,70,na,1862,584.7622834491804
STAT,1881,85,na,1966,521.9305170777056
SIM,1910,28,na,1938,3610
STAT,1844,43,20-24,1887,0.12443565325282727
SIM,1897,19,15-19,1916,8
STAT,1856,53,40-44,1909,0.00829521658300796
STAT,1816,51,45-49,1867,0.029130154006164588
SIM,1827,32,30-34,1859,18
STAT,1827,46,25-29,1873,0.06556845567834328
STAT,1848,67,na,1915,1232.2423110575196
SIM,1937,21,25-29,1958,146
STAT,1873,34,na,1907,2446.9108253724353
SIM,1843,28,30-34,1871,51
SIM,1929,15,40-44,1944,3
STAT,1833,43,45-49,1876,1.184549647280306
SIM,1856,42,50-100,1898,3
STAT,1886,23,30-34,1909,19.174486061730256
STAT,1827,51,20-24,1878,8.155765278900152E-4
STAT,1859,49,25-29,1908,0.045947769365097896
STAT,1878,54,30-34,1932,0.006146964198886526
STAT,1917,22,45-49,1939,1.22035485368028
STAT,1831,35,35-39,1866,6.372310170098805
STAT,1881,17,45-49,1898,0.0644261105362019
STAT,1871,43,na,1914,2318.6931072802854
SIM,1876,27,30-34,1903,36
SIM,1806,88,na,1894,95
STAT,1876,46,20-24,1922,0.012677043671641852
STAT,1823,100,na,1923,0.590861586335125
STAT,1882,38,45-49,1920,1.971453091615833
STAT,1808,46,15-19,1854,0.0011034632728126026
SIM,1885,45,25-29,1930,1
SIM,1821,39,35-39,1860,6
SIM,1890,30,35-39,1920,23
STAT,1867,38,na,1905,2245.2023267093346
SIM,1890,38,45-49,1928,1
SIM,1902,31,50-100,1933,2
STAT,1833,26,na,1859,1883.8167093598763
SIM,1840,44,40-44,1884,3
SIM,1939,32,50-100,1971,1
STAT,1892,29,15-19,1921,0.5759407864577015
STAT,1894,42,20-24,1936,0.014453722851319309
STAT,1895,49,35-39,1944,0.10291748147768572
STAT,1928,22,20-24,1950,141.61128473615352
STAT,1818,108,na,1926,9.334771204316033E-4
STAT,1850,40,40-44,1890,1.708988197599109
STAT,1859,41,15-19,1900,0.011301983263211047
STAT,1902,64,na,1966,2757.928094523291
SIM,1866,28,25-29,1894,41
STAT,1877,45,25-29,1922,0.06155335398233558
STAT,1882,30,35-39,1912,10.14596058412048
STAT,1830,39,35-39,1869,6.209224373447899
STAT,1837,53,30-34,1890,0.0039051019086822963
SIM,1872,34,35-39,1906,17
SIM,1901,67,na,1968,2634
STAT,1873,22,50-100,1895,0.42175706024843157
STAT,1894,17,30-34,1911,2.09150451007548
SIM,1872,25,45-49,1897,4
STAT,1899,26,20-24,1925,16.444722928504554
STAT,1818,48,25-29,1866,0.12877911058157482
SIM,1830,38,na,1868,1816
SIM,1863,76,na,1939,683
STAT,1847,18,na,1865,2220.957053174535
SIM,1938,12,na,1950,3949
STAT,1865,51,40-44,1916,0.009794218928147415
SIM,1874,42,45-49,1916,4
STAT,1835,48,25-29,1883,0.044679127194495134
SIM,1873,18,15-19,1891,7
STAT,1832,44,40-44,1876,1.800811865975917
SIM,1855,57,na,1912,1532
STAT,1855,37,na,1892,1826.3494442147755
SIM,1852,26,30-34,1878,37
SIM,1877,39,40-44,1916,10
STAT,1771,105,na,1876,0.01852070556375403
SIM,1815,92,na,1907,3
STAT,1896,28,45-49,1924,1.4907049218636865
SIM,1822,43,35-39,1865,3
SIM,1831,55,na,1886,1332
SIM,1837,60,na,1897,1152
STAT,1805,50,30-34,1855,0.021835809263963363
STAT,1861,30,15-19,1891,0.1210100862976484
STAT,1876,33,15-19,1909,0.14938335885628073
STAT,1850,35,45-49,1885,1.5552208149925422
SIM,1895,37,50-100,1932,5
STAT,1854,15,35-39,1869,0.5083394598675722
STAT,1829,37,45-49,1866,1.7430297162383226
STAT,1869,39,40-44,1908,4.268046709934071
STAT,1895,46,30-34,1941,0.07288388375452937
STAT,1865,18,15-19,1883,5.628958148766217
STAT,1872,92,na,1964,111.91921794665093
SIM,1896,71,na,1967,2054
STAT,1838,32,40-44,1870,3.959444327549379
STAT,1864,25,45-49,1889,1.0179010793517558
STAT,1805,62,na,1867,1103.439495568633
STAT,1813,81,na,1894,232.54352673838295
STAT,1855,32,40-44,1887,3.423021401832659
STAT,1876,29,30-34,1905,26.337757178334634
STAT,1844,108,na,1952,0.001419423473659847
SIM,1826,28,30-34,1854,25
STAT,1849,53,50-100,1902,0.011536918417720777
STAT,1948,21,35-39,1969,11.033942034287273
SIM,1828,39,45-49,1867,2
STAT,1860,26,15-19,1886,0.3823047582852326
SIM,1880,36,35-39,1916,1
STAT,1814,43,35-39,1857,5.919538142469493
STAT,1844,30,15-19,1874,0.13473335912533557
STAT,1884,18,na,1902,2542.3718437857924
SIM,1883,30,50-100,1913,1
STAT,1859,54,20-24,1913,5.846615277570546E-4
SIM,1852,38,25-29,1890,4
SIM,1879,16,na,1895,3103
SIM,1893,19,30-34,1912,2
STAT,1809,76,na,1885,498.06616261147855
STAT,1937,15,25-29,1952,43.201976477266065
STAT,1869,43,25-29,1912,0.6278970846700017
SIM,1843,88,na,1931,100
STAT,1857,52,45-49,1909,0.011500762293471224
STAT,1871,15,35-39,1886,0.5646977152743026
SIM,1888,52,na,1940,2464
STAT,1849,35,20-24,1884,0.6252299604073112
STAT,1830,31,25-29,1861,9.965898185297219
STAT,1839,28,15-19,1867,0.3916292393990374
STAT,1853,36,25-29,1889,2.439402074908758
STAT,1862,16,50-100,1878,0.04901499879859878
SIM,1841,38,50-100,1879,6
STAT,1840,46,40-44,1886,0.12583436709614396
SIM,1850,26,na,1876,1954
STAT,1881,34,35-39,1915,9.902582271727788
STAT,1879,28,45-49,1907,1.1798096873846744
STAT,1829,54,35-39,1883,0.0058904633663783325
STAT,1821,33,25-29,1854,32.27824574534169
SIM,1835,26,30-34,1861,32
STAT,1864,47,40-44,1911,0.1545685101032426
STAT,1844,38,25-29,1882,2.3333284171240636
STAT,1932,29,50-100,1961,1.3282262772625404
SIM,1886,29,40-44,1915,4
SIM,1827,27,35-39,1854,9
SIM,1863,41,30-34,1904,1
STAT,1823,46,40-44,1869,0.26104562673665294
STAT,1930,28,na,1958,4855.9187501866645
SIM,1776,84,na,1860,98
STAT,1867,104,na,1971,0.743575962296321
SIM,1927,15,50-100,1942,5
STAT,1854,40,25-29,1894,0.49643703976065745
SIM,1874,46,50-100,1920,2
STAT,1855,27,45-49,1882,0.8971414896448651
STAT,1841,45,45-49,1886,0.17958429299155626
STAT,1891,41,40-44,1932,2.853684835309216
SIM,1877,23,30-34,1900,26
STAT,1891,36,45-49,1927,2.529887762268419
SIM,1836,38,40-44,1874,6
STAT,1818,40,15-19,1858,0.03841966929787604
STAT,1777,81,na,1858,232.63833800734471
SIM,1846,32,40-44,1878,10
SIM,1863,27,45-49,1890,1
STAT,1801,80,na,1881,251.6792371843433
STAT,1892,69,na,1961,2040.8772817275346
SIM,1864,40,35-39,1904,4
SIM,1836,42,25-29,1878,1
STAT,1881,51,25-29,1932,0.00351012189870709
STAT,1885,31,15-19,1916,0.14553182515828336
STAT,1853,41,20-24,1894,0.1337670565173033
STAT,1860,91,na,1951,47.96423404823724
STAT,1890,37,40-44,1927,5.460220613457484
SIM,1884,29,30-34,1913,32
SIM,1893,39,25-29,1932,6
STAT,1845,25,35-39,1870,9.309711315758111
STAT,1819,52,25-29,1871,0.006748475307955368
STAT,1848,18,15-19,1866,5.684966047262368
STAT,1890,24,35-39,1914,7.233242775209526
STAT,1851,36,15-19,1887,0.04731336075529578
STAT,1918,15,15-19,1933,10.160421353162622
SIM,1817,38,30-34,1855,8
SIM,1827,27,50-100,1854,1
STAT,1856,54,na,1910,1676.8480947970256
STAT,1892,40,45-49,1932,1.9328554705271217
STAT,1895,29,40-44,1924,3.958631588792386
STAT,1797,58,na,1855,1037.2526199999998
STAT,1834,36,15-19,1870,0.047495873759256756
STAT,1875,40,45-49,1915,1.5828097908087584
SIM,1851,75,na,1926,684
STAT,1880,36,na,1916,2537.8335144252
STAT,1929,31,na,1960,4902.689205693426
STAT,1885,39,25-29,1924,2.9008928022578915
SIM,1916,33,na,1949,3938
SIM,1768,97,na,1865,1
SIM,1862,15,35-39,1877,1
STAT,1881,47,40-44,1928,0.16806350066376105
STAT,1947,1,na,1948,4729.41819140818
STAT,1828,38,40-44,1866,3.7563121206995254
STAT,1838,27,45-49,1865,1.0377328549004168
STAT,1851,23,na,1874,2091.4261595510366
STAT,1840,33,35-39,1873,8.784332666948256
SIM,1901,7,na,1908,3853
STAT,1844,26,30-34,1870,24.06087000453592
STAT,1939,31,35-39,1970,9.517258446617825
SIM,1882,41,40-44,1923,5
STAT,1805,94,na,1899,8.03294192704053
STAT,1854,4,na,1858,2440.3096525847886
STAT,1829,42,40-44,1871,1.8874474352755068
SIM,1908,14,na,1922,4156
SIM,1832,45,45-49,1877,1
STAT,1874,41,40-44,1915,2.3533603465241995
STAT,1942,29,na,1971,4007.4128250340377
STAT,1871,2,na,1873,3347.1410302155787
STAT,1937,20,20-24,1957,110.52635989908258
SIM,1855,89,na,1944,91
SIM,1873,0,na,1873,3667
STAT,1891,26,50-100,1917,0.8107027715658709
STAT,1824,45,45-49,1869,0.282573211096882
STAT,1835,40,15-19,1875,0.012653910124191287
SIM,1856,2,na,1858,3427
STAT,1807,50,40-44,1857,0.04530105106858347
SIM,1883,17,20-24,1900,19
STAT,1818,53,20-24,1871,0.001574209622403142
STAT,1946,17,50-100,1963,0.42396917807609724
STAT,1868,87,na,1955,171.6648033743794
SIM,1829,41,na,1870,1428
SIM,1842,39,na,1881,1835
STAT,1954,15,25-29,1969,54.67273978507963
SIM,1831,48,50-100,1879,1
STAT,1864,73,na,1937,1077.389427344433
STAT,1886,43,25-29,1929,0.6883999043123463
SIM,1845,36,50-100,1881,1
SIM,1846,27,45-49,1873,2
STAT,1940,3,na,1943,4184.132567348466
SIM,1868,33,30-34,1901,6
SIM,1942,1,na,1943,4839
STAT,1854,45,30-34,1899,0.07482493592841764
SIM,1928,19,40-44,1947,2
STAT,1840,30,30-34,1870,15.623960295140508
SIM,1827,44,25-29,1871,3
STAT,1809,50,15-19,1859,1.0875690292556294E-4
STAT,1813,47,35-39,1860,0.3518597769886162
SIM,1830,25,40-44,1855,3
STAT,1888,43,35-39,1931,2.1681021532961173
STAT,1909,20,45-49,1929,1.072888343408421
SIM,1871,20,na,1891,2162
STAT,1896,33,40-44,1929,5.818432084589532
SIM,1875,18,25-29,1893,7
STAT,1886,35,25-29,1921,3.1385184266530564
STAT,1849,27,20-24,1876,10.796484877921124
SIM,1905,49,na,1954,3175
STAT,1825,41,45-49,1866,2.0866787770828723
STAT,1834,109,na,1943,4.781134409318388E-4
STAT,1834,75,na,1909,691.8165732654367
SIM,1894,35,25-29,1929,5
SIM,1901,35,na,1936,3601
SIM,1945,23,25-29,1968,9
STAT,1830,44,30-34,1874,0.9637860285168615
STAT,1870,28,25-29,1898,42.03713567085993
STAT,1882,46,45-49,1928,0.23522087616295223
STAT,1869,51,25-29,1920,0.00350524978453588
SIM,1893,27,30-34,1920,54
STAT,1876,41,15-19,1917,0.01461350510159431
STAT,1937,23,25-29,1960,91.72063315959812
SIM,1810,93,na,1903,40
STAT,1867,43,15-19,1910,0.013130569232569255
STAT,1868,55,na,1923,2014.7125879941773
SIM,1792,79,na,1871,249
SIM,1857,27,20-24,1884,12
STAT,1873,15,45-49,1888,0.06836271460281053
STAT,1864,17,45-49,1881,0.0612957994155466
SIM,1880,20,25-29,1900,73
STAT,1864,41,na,1905,2105.970802734951
STAT,1873,48,45-49,1921,0.24101599138446617
SIM,1844,73,na,1917,813
SIM,1848,87,na,1935,209
SIM,1867,90,na,1957,38
STAT,1761,98,na,1859,0.257938957300205
SIM,1870,22,30-34,1892,26
STAT,1833,58,na,1891,1298.679768645371
STAT,1910,27,50-100,1937,0.9803014491192477
SIM,1870,34,25-29,1904,14
SIM,1771,85,na,1856,49
STAT,1892,32,45-49,1924,2.2295845919004043
SIM,1873,30,35-39,1903,14
STAT,1928,30,20-24,1958,3.1144812986799484
SIM,1886,29,na,1915,2618
STAT,1819,44,25-29,1863,1.3076730875978846
STAT,1893,25,15-19,1918,0.591141007056732
SIM,1882,36,45-49,1918,7
STAT,1844,51,20-24,1895,5.74558085461543E-4
SIM,1917,20,45-49,1937,1
STAT,1862,47,30-34,1909,0.0836692259439622
SIM,1868,28,35-39,1896,15
STAT,1793,76,na,1869,404.8335942134956
SIM,1859,35,30-34,1894,12
SIM,1880,24,na,1904,2301
SIM,1884,38,na,1922,2480
STAT,1863,24,na,1887,2126.7082545204375
SIM,1922,29,na,1951,4204
STAT,1841,50,40-44,1891,0.00788482105325025
STAT,1935,15,15-19,1950,63.56420047357151
STAT,1909,0,na,1909,4491.006680020812
STAT,1873,40,35-39,1913,1.8917309614700417
STAT,1853,16,30-34,1869,1.6171965988388288
STAT,1878,29,40-44,1907,3.1581388696395534
SIM,1923,22,50-100,1945,1
STAT,1861,35,20-24,1896,0.6559723707524995
STAT,1836,41,20-24,1877,0.11912034148568074
SIM,1867,37,30-34,1904,1
STAT,1835,53,20-24,1888,5.495495317109818E-4
STAT,1917,30,na,1947,4074.0489101919793
STAT,1838,89,na,1927,77.18830132808158
STAT,1883,19,20-24,1902,17.650480914119086
STAT,1943,20,45-49,1963,1.222191902052665
SIM,1846,21,na,1867,2104
SIM,1817,40,na,1857,1463
STAT,1826,34,15-19,1860,0.13738884261358283
SIM,1815,45,45-49,1860,2
SIM,1935,9,na,1944,5579
STAT,1876,49,25-29,1925,0.059410631425140366
SIM,1833,41,45-49,1874,5
SIM,1819,38,40-44,1857,6
STAT,1910,51,na,1961,3451.380552136072
STAT,1867,18,25-29,1885,5.515553147478281
STAT,1919,32,20-24,1951,2.6854425941313838
SIM,1928,20,20-24,1948,207
SIM,1881,40,35-39,1921,1
SIM,1919,22,20-24,1941,127
SIM,1927,32,20-24,1959,2
SIM,1868,49,50-100,1917,2
SIM,1936,30,20-24,1966,2
STAT,1894,45,25-29,1939,0.04306059789217983
STAT,1852,24,15-19,1876,3.112047302620106
SIM,1814,75,na,1889,513
STAT,1821,46,30-34,1867,0.15481802149862675
SIM,1810,61,na,1871,1271
SIM,1842,19,25-29,1861,10
STAT,1804,54,30-34,1858,0.016760630068081712
STAT,1815,40,na,1855,1690.0312770879939
STAT,1814,40,30-34,1854,4.3527290472896905
STAT,1923,38,30-34,1961,2.1524939610444664
STAT,1878,65,na,1943,1794.5056732621981
SIM,1835,69,na,1904,880
SIM,1863,32,40-44,1895,7
STAT,1875,17,20-24,1892,18.561961277650724
SIM,1931,38,30-34,1969,5
STAT,1812,64,na,1876,951.4218361787312
STAT,1885,27,30-34,1912,25.629603561188812
SIM,1849,28,25-29,1877,51
SIM,1919,33,25-29,1952,16
STAT,1840,16,45-49,1856,0.06122048225868689
STAT,1877,42,20-24,1919,0.16783095780423923
STAT,1872,27,45-49,1899,1.135206834615521
SIM,1861,10,na,1871,3011
SIM,1873,38,45-49,1911,4
STAT,1833,40,40-44,1873,1.8505091176441288
SIM,1843,56,na,1899,1519
SIM,1850,58,na,1908,1474
STAT,1945,22,20-24,1967,124.33724554649973
SIM,1924,33,50-100,1957,1
STAT,1877,50,20-24,1927,7.920023125677427E-4
STAT,1890,45,40-44,1935,0.21567301303013042
STAT,1818,36,30-34,1854,22.37404894962228
STAT,1832,31,35-39,1863,8.980824348487388
STAT,1800,63,na,1863,1056.0015758649956
STAT,1871,45,30-34,1916,0.09879399562694309
STAT,1816,45,50-100,1861,0.5217080045117456
STAT,1920,22,50-100,1942,0.7465011733279563
STAT,1823,54,40-44,1877,0.014642889916351954
STAT,1804,77,na,1881,354.09162968298847
STAT,1827,54,25-29,1881,0.003356505853146798
SIM,1860,24,15-19,1884,1
STAT,1871,75,na,1946,1040.2967847091825
SIM,1890,35,40-44,1925,8
SIM,1918,21,15-19,1939,12
STAT,1845,17,35-39,1862,0.5418800889101243
STAT,1847,25,45-49,1872,1.0557887513774675
STAT,1881,31,30-34,1912,17.29049705772139
SIM,1876,51,na,1927,2481
SIM,1938,33,35-39,1971,17
STAT,1817,95,na,1912,6.488655246755355
STAT,1875,89,na,1964,245.90738493317042
STAT,1895,41,25-29,1936,0.05962193419912719
SIM,1838,34,na,1872,1721
STAT,1870,20,15-19,1890,3.3096235775582814
STAT,1934,10,na,1944,5482.031687033438
STAT,1840,49,45-49,1889,0.16692267402063687
SIM,1826,36,30-34,1862,7
STAT,1893,33,15-19,1926,0.183518656793658
STAT,1854,48,35-39,1902,0.10580330756489476
SIM,1836,22,30-34,1858,22
STAT,1836,32,30-34,1868,13.737704672987084
STAT,1860,34,15-19,1894,0.11686368143029215
SIM,1844,32,30-34,1876,25
STAT,1871,41,15-19,1912,0.01401831680799542
SIM,1839,44,50-100,1883,2
SIM,1865,35,na,1900,2330
SIM,1873,86,na,1959,206
STAT,1769,111,na,1880,6.009343292325204E-4
SIM,1856,46,45-49,1902,1
STAT,1819,54,na,1873,1414.5335928813504
STAT,1849,52,na,1901,1662.7354610029606
STAT,1938,24,na,1962,3684.300365016811
STAT,1870,33,20-24,1903,2.6842839709248842
SIM,1869,49,na,1918,2162
STAT,1820,37,25-29,1857,7.004223870047485
SIM,1862,48,35-39,1910,1
SIM,1878,38,45-49,1916,5
STAT,1866,42,45-49,1908,1.4065599424860866
SIM,1822,40,30-34,1862,4
STAT,1835,45,20-24,1880,0.010629528469492996
STAT,1846,76,na,1922,677.5089737927744
STAT,1880,27,30-34,1907,26.995742226522882
STAT,1880,18,40-44,1898,0.19556377172063372
STAT,1865,90,na,1955,72.99870412004562
SIM,1869,49,35-39,1918,1
STAT,1842,62,na,1904,1433.3151781433264
STAT,1826,42,15-19,1868,0.011317403215863752
STAT,1832,47,45-49,1879,0.18735921372190834
SIM,1856,74,na,1930,1024
SIM,1850,18,20-24,1868,21
STAT,1773,99,na,1872,0.34350373539052564
STAT,1828,50,25-29,1878,0.0027836528692066396
SIM,1925,30,45-49,1955,2
SIM,1842,44,15-19,1886,1
SIM,1861,33,20-24,1894,4
SIM,1852,60,na,1912,1579
STAT,1924,20,35-39,1944,11.40329504353824
SIM,1900,47,40-44,1947,1
STAT,1872,53,25-29,1925,0.0035633125947256727
STAT,1913,16,na,1929,4038.4319669657016
STAT,1827,29,35-39,1856,18.643789690891317
STAT,1863,43,30-34,1906,1.0208943574711982
STAT,1882,35,40-44,1917,4.39201771653526
STAT,1891,20,35-39,1911,7.414174103513876
STAT,1813,101,na,1914,0.2453837506727999
SIM,1822,94,na,1916,15
STAT,1840,41,35-39,1881,1.3768060854397732
SIM,1899,9,na,1908,3621
SIM,1930,16,na,1946,5352
SIM,1898,28,20-24,1926,25
STAT,1815,44,40-44,1859,6.380817170549057
SIM,1797,78,na,1875,206
SIM,1837,34,40-44,1871,4
STAT,1867,35,15-19,1902,0.05429176914877741
STAT,1799,92,na,1891,13.514772170435373
STAT,1839,74,na,1913,765.9148539350958
SIM,1835,29,35-39,1864,16
SIM,1899,68,na,1967,2428
STAT,1830,40,15-19,1870,0.012256819572905692
STAT,1819,86,na,1905,130.80866356262686
SIM,1823,44,40-44,1867,8
STAT,1849,38,25-29,1887,2.2636702109895173
STAT,1890,15,50-100,1905,0.06139329923391724
SIM,1857,38,25-29,1895,7
STAT,1831,27,35-39,1858,9.547971992964602
STAT,1887,47,35-39,1934,0.15929256600477473
STAT,1836,24,30-34,1860,14.423753515421813
SIM,1845,36,40-44,1881,5
SIM,1891,40,na,1931,3013
STAT,1851,28,15-19,1879,0.43512114200012364
STAT,1818,69,na,1887,807.4805132468136
STAT,1918,23,15-19,1941,5.840655441926494
STAT,1834,44,15-19,1878,0.010920187793647231
SIM,1879,91,na,1970,312
SIM,1895,54,na,1949,2855
SIM,1840,31,35-39,1871,7
STAT,1869,40,20-24,1909,0.15799459103375185
STAT,1814,55,na,1869,1249.7740242405291
SIM,1839,19,na,1858,2190
STAT,1884,18,50-100,1902,0.04931710115126934
STAT,1876,38,20-24,1914,0.8080071757332496
STAT,1884,48,20-24,1932,0.01195921176316624
SIM,1820,35,25-29,1855,2
STAT,1856,24,50-100,1880,0.37384213063720445
STAT,1829,34,40-44,1863,3.883573024478128
STAT,1946,11,na,1957,4445.850115690999
SIM,1832,37,45-49,1869,2
STAT,1848,54,45-49,1902,0.010970760464285788
SIM,1926,23,15-19,1949,8
STAT,1896,25,40-44,1921,4.063465461795874
SIM,1926,43,na,1969,4902
STAT,1833,51,45-49,1884,0.010090921039715666
SIM,1884,38,20-24,1922,1
SIM,1844,24,30-34,1868,18
STAT,1868,27,30-34,1895,24.536420920669173
STAT,1888,32,na,1920,2877.939335654443
SIM,1823,34,50-100,1857,2
STAT,1838,57,na,1895,1476.5807036003694
SIM,1858,22,na,1880,2070
SIM,1873,35,50-100,1908,1
STAT,1875,45,15-19,1920,4.22979204755084E-4
STAT,1880,30,25-29,1910,11.06863696626546
SIM,1858,39,30-34,1897,10
STAT,1851,31,45-49,1882,1.5130415089241571
STAT,1872,28,35-39,1900,9.830624514135385
SIM,1863,24,40-44,1887,2
SIM,1886,37,40-44,1923,2
STAT,1846,46,35-39,1892,0.10040129814994106
STAT,1962,7,na,1969,5135.844163669256
SIM,1964,5,na,1969,5234
STAT,1872,19,45-49,1891,0.06642949742074784
SIM,1821,77,na,1898,416
STAT,1896,42,30-34,1938,0.10743396265524055
SIM,1872,37,na,1909,2467
STAT,1775,102,na,1877,0.07797704901939152
STAT,1857,37,20-24,1894,0.6141498710781655
STAT,1874,44,45-49,1918,1.5378018597998093
STAT,1863,88,na,1951,122.7935438213361
STAT,1891,28,45-49,1919,1.397374421250405
STAT,1888,26,45-49,1914,1.343643255331302
STAT,1834,43,na,1877,1681.5790852598104
SIM,1830,42,30-34,1872,3
SIM,1851,43,na,1894,1807
STAT,1882,47,50-100,1929,0.24295815950213662
STAT,1914,25,50-100,1939,1.0307172931213724
STAT,1807,53,45-49,1860,0.05875743800530985
STAT,1931,18,50-100,1949,0.49881520595685275
STAT,1862,22,30-34,1884,15.83461092281098
SIM,1951,20,45-49,1971,2
SIM,1951,6,na,1957,5318
SIM,1882,44,45-49,1926,1
STAT,1851,87,na,1938,145.35220870349045
SIM,1888,41,35-39,1929,3
STAT,1917,30,45-49,1947,1.6950636150921965
SIM,1829,35,45-49,1864,7
SIM,1896,26,45-49,1922,4
STAT,1829,51,30-34,1880,0.004749675690540176
STAT,1791,103,na,1894,0.02532151134472465
SIM,1880,88,na,1968,132
STAT,1852,32,15-19,1884,0.1187828535265805
STAT,1901,15,na,1916,3619.7170587752335
STAT,1905,29,na,1934,3491.040304275223
STAT,1869,33,50-100,1902,0.8986097669338027
STAT,1877,15,50-100,1892,0.052078464345291155
STAT,1878,37,40-44,1915,4.648300517100441
SIM,1814,41,35-39,1855,2
SIM,1949,16,20-24,1965,165
STAT,1841,42,40-44,1883,1.7257362524333772
STAT,1855,24,40-44,1879,1.8601450340589587
SIM,1880,28,35-39,1908,15
STAT,1822,42,na,1864,1603.8227859047995
STAT,1826,56,na,1882,1273.987227588843
STAT,1859,16,25-29,1875,5.3908529557363245
STAT,1856,45,40-44,1901,0.13846436291237937
STAT,1845,34,25-29,1879,9.320057106504754
STAT,1848,51,40-44,1899,0.00822264544185986
SIM,1793,64,na,1857,717
SIM,1878,27,40-44,1905,5
STAT,1897,68,na,1965,2339.092122724577
STAT,1863,34,40-44,1897,3.8457732344960545
SIM,1888,49,45-49,1937,1
SIM,1906,30,35-39,1936,13
STAT,1842,18,20-24,1860,17.747862793873388
STAT,1893,54,na,1947,2709.9613136500498
STAT,1895,30,20-24,1925,3.626720410071399
SIM,1867,16,25-29,1883,10
SIM,1881,32,35-39,1913,15
STAT,1868,47,25-29,1915,0.05586190796178292
STAT,1873,32,35-39,1905,10.473913794375287
STAT,1880,38,35-39,1918,7.54477265199285
STAT,1814,51,35-39,1865,0.02505552652042666
SIM,1930,3,na,1933,5853
STAT,1881,42,35-39,1923,1.7837658975676691
SIM,1819,46,40-44,1865,1
STAT,1853,44,25-29,1897,0.5311797944872682
STAT,1850,110,na,1960,4.92433824798658E-4
SIM,1898,39,25-29,1937,4
STAT,1831,52,25-29,1883,0.0025482460333518813
STAT,1889,17,na,1906,3182.6264752991083
STAT,1900,45,25-29,1945,0.04639893021660511
STAT,1842,19,na,1861,2284.4103791258117
SIM,1853,34,25-29,1887,18
SIM,1891,31,40-44,1922,7
SIM,1894,32,20-24,1926,7
STAT,1877,16,na,1893,2678.871632441368
STAT,1924,32,na,1956,4501.7947017022725
STAT,1835,37,20-24,1872,0.7103442916565673
STAT,1830,47,35-39,1877,0.11618805159299986
SIM,1850,26,20-24,1876,16
SIM,1837,71,na,1908,809
STAT,1809,46,30-34,1855,0.4378271577131302
SIM,1848,9,na,1857,2381
STAT,1896,17,40-44,1913,0.24643506607939603
SIM,1861,28,25-29,1889,56
STAT,1833,48,15-19,1881,2.7844587854519216E-4
STAT,1847,106,na,1953,0.009468247769743683
STAT,1899,18,20-24,1917,24.70133367305689
STAT,1916,13,na,1929,4269.282491853153
STAT,1901,49,35-39,1950,0.11030708344141237
SIM,1852,34,30-34,1886,23
SIM,1877,47,40-44,1924,1
STAT,1919,35,25-29,1954,1.0854455543567962
STAT,1853,28,25-29,1881,37.123468348966526
SIM,1866,73,na,1939,1333
STAT,1839,53,40-44,1892,0.00714894589440343
SIM,1858,18,25-29,1876,8
STAT,1863,51,30-34,1914,0.005349742747720954
STAT,1846,30,25-29,1876,8.837621915611049
STAT,1896,36,45-49,1932,2.6988587179101025
SIM,1837,26,40-44,1863,5
STAT,1893,49,25-29,1942,0.04117042935625414
STAT,1844,22,15-19,1866,3.1918960333560045
SIM,1879,43,35-39,1922,4
STAT,1814,52,25-29,1866,0.01010424776700476
SIM,1923,46,na,1969,4208
SIM,1857,3,na,1860,2719
SIM,1835,37,35-39,1872,13
STAT,1883,50,45-49,1933,0.014735175692103942
SIM,1858,54,na,1912,1718
STAT,1895,38,30-34,1933,7.058541484822712
STAT,1952,15,15-19,1967,55.50896158843849
STAT,1869,72,na,1941,1243.835840534316
SIM,1824,40,40-44,1864,4
STAT,1850,27,45-49,1877,0.982834483186662
SIM,1895,38,45-49,1933,6
STAT,1869,47,40-44,1916,0.1678302254138191
SIM,1874,17,na,1891,2595
SIM,1963,4,na,1967,5153
STAT,1829,45,45-49,1874,0.195979143945786
SIM,1854,38,35-39,1892,6
SIM,1865,7,na,1872,2716
STAT,1907,49,50-100,1956,0.2042749355202968
STAT,1946,17,40-44,1963,1.582818649719339
SIM,1817,46,30-34,1863,1
STAT,1842,26,20-24,1868,11.459277862190582
STAT,1922,20,na,1942,4298.529482792768
STAT,1864,34,35-39,1898,9.107434879498449
SIM,1847,40,35-39,1887,2
STAT,1841,77,na,1918,638.2262461939958
STAT,1883,31,40-44,1914,4.358643002136416
STAT,1836,35,35-39,1871,5.517534999952431
STAT,1875,32,45-49,1907,1.8258004156585443
STAT,1893,41,15-19,1934,0.017952808450853078
SIM,1845,32,25-29,1877,13
STAT,1894,71,na,1965,2030.5987848754748
SIM,1927,15,30-34,1942,25
STAT,1887,38,45-49,1925,2.2675182584836775
STAT,1851,24,20-24,1875,66.92330252300751
STAT,1859,51,na,1910,1762.6112027399931
SIM,1831,30,30-34,1861,20
STAT,1827,41,na,1868,1753.9886572985124
STAT,1890,21,30-34,1911,22.284995148934847
SIM,1882,33,40-44,1915,2
SIM,1854,30,25-29,1884,10
STAT,1870,40,50-100,1910,1.064190860473363
STAT,1910,27,40-44,1937,4.590574602607965
SIM,1798,63,na,1861,858
STAT,1827,37,35-39,1864,9.194100706599876
STAT,1816,89,na,1905,46.613656412098535
STAT,1844,34,30-34,1878,15.846763538205806
STAT,1834,27,25-29,1861,37.328186496247085
SIM,1877,36,na,1913,2462
STAT,1849,39,15-19,1888,0.04369353634761473
SIM,1842,27,25-29,1869,46
SIM,1843,36,30-34,1879,13
STAT,1870,41,20-24,1911,0.1590949369095018
STAT,1894,28,35-39,1922,12.616931133976486
STAT,1847,17,45-49,1864,0.063577312814344
STAT,1839,40,35-39,1879,1.4849890854868724
STAT,1880,26,40-44,1906,3.2223536575706384
SIM,1869,48,45-49,1917,1
STAT,1837,32,25-29,1869,8.562318323809817
STAT,1844,10,na,1854,2381.0
SIM,1861,20,15-19,1881,4
SIM,1895,39,35-39,1934,24
STAT,1821,42,15-19,1863,0.023961981706383438
STAT,1841,88,na,1929,101.3637049586439
SIM,1954,17,40-44,1971,3
SIM,1844,35,35-39,1879,6
STAT,1809,47,20-24,1856,0.05337499035432925
SIM,1863,35,45-49,1898,3
STAT,1874,52,45-49,1926,0.01503510889139998
SIM,1838,42,35-39,1880,3
STAT,1899,16,na,1915,3536.860542699962
SIM,1861,27,35-39,1888,13
STAT,1857,40,50-100,1897,0.8501881849329298
SIM,1815,42,40-44,1857,6
STAT,1853,27,35-39,1880,9.372614810213301
STAT,1812,52,50-100,1864,0.034091853783372976
STAT,1855,52,35-39,1907,0.006638200178610991
STAT,1847,22,40-44,1869,1.9920685754710463
STAT,1835,28,50-100,1863,0.6169671440151742
SIM,1883,32,45-49,1915,1
STAT,1884,50,na,1934,2204.3838622807048
SIM,1884,37,30-34,1921,6
STAT,1885,23,15-19,1908,3.3473014776362957
SIM,1927,35,25-29,1962,1
STAT,1826,40,50-100,1866,0.8971061363023394
STAT,1939,20,30-34,1959,29.465712856443254
SIM,1794,81,na,1875,181
STAT,1888,64,na,1952,2096.495363956354
STAT,1860,59,na,1919,1608.6329818797958
STAT,1871,51,50-100,1922,0.015334721795589881
STAT,1870,36,25-29,1906,2.885135744222689
STAT,1853,42,50-100,1895,0.8847429138461538
STAT,1862,39,na,1901,2025.339267912413
SIM,1798,95,na,1893,1
SIM,1819,74,na,1893,614
SIM,1843,37,20-24,1880,1
STAT,1853,20,15-19,1873,3.3158588287537705
STAT,1887,39,35-39,1926,8.003917806575737
SIM,1862,37,30-34,1899,7
STAT,1783,77,na,1860,343.1542568002079
STAT,1937,31,25-29,1968,9.332739759882406
STAT,1886,32,20-24,1918,2.918795541398963
STAT,1870,24,30-34,1894,17.652322767885554
STAT,1825,34,20-24,1859,4.615695741655305
SIM,1850,30,40-44,1880,6
STAT,1926,42,50-100,1968,0.14774776548935026
STAT,1898,38,20-24,1936,0.22839278170774907
STAT,1781,86,na,1867,64.54238287195112
STAT,1844,21,na,1865,2083.6578037210465
STAT,1853,33,20-24,1886,2.3099265104856794
SIM,1815,60,na,1875,1070
SIM,1816,41,45-49,1857,2
SIM,1893,23,15-19,1916,4
SIM,1898,8,na,1906,4014
STAT,1870,69,na,1939,1463.526275902677
SIM,1859,27,30-34,1886,31
SIM,1895,31,25-29,1926,18
STAT,1890,40,35-39,1930,2.2814858207084203
SIM,1862,40,25-29,1902,2
STAT,1890,48,45-49,1938,0.16396361595267192
STAT,1831,26,45-49,1857,1.1381661202333835
SIM,1896,28,na,1924,3231
STAT,1920,41,35-39,1961,0.2272823656885594
STAT,1834,54,50-100,1888,0.010016463529140315
STAT,1876,37,30-34,1913,5.6143338420291835
STAT,1799,81,na,1880,206.2395312714659
STAT,1829,26,40-44,1855,5.8076703554615134
SIM,1894,16,na,1910,3418
STAT,1855,53,25-29,1908,0.00270167613219577
STAT,1841,21,35-39,1862,5.497665096116106
STAT,1906,38,30-34,1944,1.6996091436569782
SIM,1882,20,35-39,1902,12
STAT,1855,35,45-49,1890,1.5600238135485407
STAT,1885,29,50-100,1914,0.6464120621821269
STAT,1838,44,35-39,1882,1.3801270840813964
SIM,1847,70,na,1917,929
STAT,1862,53,50-100,1915,0.012904649101821033
STAT,1876,41,50-100,1917,1.1179330585806504
STAT,1909,43,na,1952,3521.5310231548237
STAT,1819,41,20-24,1860,0.3529651517113582
STAT,1848,35,na,1883,1926.8757848600892
SIM,1927,28,na,1955,4425
SIM,1914,38,30-34,1952,3
SIM,1815,81,na,1896,179
STAT,1887,31,25-29,1918,11.75651198955846
STAT,1903,19,50-100,1922,0.07066528420358115
STAT,1822,50,30-34,1872,0.008490453357788069
STAT,1892,25,20-24,1917,15.1011472595378
STAT,1855,41,30-34,1896,0.89525339755963
SIM,1923,14,na,1937,4548
SIM,1928,27,40-44,1955,8
STAT,1821,45,50-100,1866,0.39872057036002745
STAT,1863,18,40-44,1881,0.1688788058078258
STAT,1866,19,20-24,1885,16.921626190123042
STAT,1882,51,40-44,1933,0.010513249250220251
STAT,1846,37,45-49,1883,1.4887119594382106
STAT,1875,28,25-29,1903,44.134137431475764
STAT,1911,43,35-39,1954,0.1948671595544865
STAT,1906,14,na,1920,3822.213530191084
STAT,1911,38,50-100,1949,0.41159799709337613
SIM,1835,30,15-19,1865,4
STAT,1845,31,20-24,1876,2.537420500432952
STAT,1920,49,45-49,1969,0.2437359001963973
SIM,1947,20,30-34,1967,35
SIM,1880,24,40-44,1904,3
STAT,1879,71,na,1950,1423.3713108765867
SIM,1945,24,50-100,1969,1
SIM,1904,32,na,1936,3727
STAT,1846,18,40-44,1864,0.16334087338267694
STAT,1863,46,35-39,1909,0.1255787733762593
STAT,1832,51,50-100,1883,0.01075949340547397
STAT,1862,31,20-24,1893,2.3569290018654825
SIM,1864,18,na,1882,2434
SIM,1908,46,na,1954,3636
STAT,1875,7,na,1882,2827.4125502186944
STAT,1894,21,15-19,1915,4.342109155106782
SIM,1862,91,na,1953,42
STAT,1861,26,30-34,1887,21.53639569309303
STAT,1845,50,25-29,1895,0.0028073116698447403
STAT,1887,44,30-34,1931,1.2964845835799599
STAT,1941,20,35-39,1961,9.93409816627976
STAT,1795,100,na,1895,0.1899287282435834
STAT,1919,40,20-24,1959,0.019584190812160753
SIM,1939,20,45-49,1959,4
SIM,1905,17,na,1922,3644
SIM,1846,44,35-39,1890,7
STAT,1898,53,na,1951,2922.794723921007
STAT,1831,78,na,1909,526.4785321729462
STAT,1892,42,50-100,1934,1.3490761371207562
SIM,1885,21,15-19,1906,4
SIM,1841,22,na,1863,1949
STAT,1892,5,na,1897,3350.6485258136836
SIM,1876,38,35-39,1914,12
SIM,1855,22,40-44,1877,2
STAT,1884,1,na,1885,3355.0059793325463
SIM,1864,32,35-39,1896,19
STAT,1811,44,20-24,1855,0.4683615968658096
SIM,1845,36,na,1881,1952
SIM,1881,41,25-29,1922,1
SIM,1804,97,na,1901,7
STAT,1880,68,na,1948,1638.2730239620962
SIM,1872,31,30-34,1903,18
STAT,1865,30,35-39,1895,9.452050154251655
STAT,1867,3,na,1870,3039.830684575546
SIM,1885,17,30-34,1902,4
SIM,1874,19,20-24,1893,18
STAT,1830,93,na,1923,18.487754469918315
STAT,1838,20,50-100,1858,0.3943754600006769
STAT,1828,49,45-49,1877,0.17978034328278955
SIM,1780,78,na,1858,294
SIM,1860,16,15-19,1876,9
SIM,1933,38,40-44,1971,2
STAT,1855,50,50-100,1905,0.011875868905666342
STAT,1827,43,20-24,1870,0.18467375860756394
STAT,1872,20,25-29,1892,58.878831754776904
STAT,1867,30,50-100,1897,0.8845710293816738
STAT,1873,41,25-29,1914,0.6671557683861834
SIM,1809,48,25-29,1857,1
STAT,1842,33,45-49,1875,1.634924998672767
STAT,1899,27,na,1926,3333.9006506043365
SIM,1917,25,15-19,1942,1
STAT,1897,33,35-39,1930,13.755394802795795
STAT,1901,29,40-44,1930,4.242866213874554
STAT,1868,39,25-29,1907,2.777160663917724
STAT,1771,97,na,1868,0.8352675189747498
STAT,1855,16,40-44,1871,0.16963964318730218
SIM,1861,21,na,1882,2554
STAT,1894,34,20-24,1928,3.5166348844192172
SIM,1876,39,25-29,1915,7
STAT,1900,37,25-29,1937,0.8786982397940662
STAT,1886,20,na,1906,2569.0455779267922
STAT,1807,96,na,1903,3.6287498246253675
STAT,1947,16,45-49,1963,0.5742833944059086
SIM,1839,18,15-19,1857,5
STAT,1936,27,50-100,1963,0.9715640074441843
SIM,1881,73,na,1954,1022
STAT,1766,97,na,1863,1.266264088644707
STAT,1871,21,20-24,1892,69.84801495884871
STAT,1806,50,25-29,1856,0.012014617816640621
STAT,1888,18,45-49,1906,0.07857385630362505
STAT,1835,36,30-34,1871,4.962517419680227
STAT,1892,37,15-19,1929,0.07179708243438761
STAT,1895,34,na,1929,3149.0127213277133
STAT,1945,25,25-29,1970,73.73861350962012
STAT,1852,40,15-19,1892,0.01123747885582186
STAT,1936,15,30-34,1951,11.957519990277357
SIM,1896,23,40-44,1919,2
STAT,1899,48,na,1947,3104.04501258909
SIM,1870,47,30-34,1917,1
STAT,1827,38,25-29,1865,3.6454511434365564
SIM,1829,32,40-44,1861,4
STAT,1924,20,50-100,1944,0.7968760571780406
STAT,1941,12,na,1953,4139.698681112656
STAT,1852,36,30-34,1888,4.361871568561808
SIM,1940,29,50-100,1969,2
SIM,1830,29,35-39,1859,14
STAT,1837,47,45-49,1884,0.1633389269049064
STAT,1955,15,40-44,1970,1.8948402791325842
SIM,1865,41,40-44,1906,5
STAT,1816,40,40-44,1856,5.7473333043426615
STAT,1945,26,na,1971,4195.060396967802
STAT,1842,46,15-19,1888,3.177793230257928E-4
STAT,1894,29,25-29,1923,55.11196375158594
SIM,1899,16,20-24,1915,28
STAT,1909,25,15-19,1934,0.6986272713906195
SIM,1818,38,25-29,1856,7
SIM,1819,42,25-29,1861,2
STAT,1802,97,na,1899,1.7046420285064252
STAT,1968,4,na,1972,5009.867142110338
STAT,1868,38,35-39,1906,6.857441295248803
SIM,1824,36,20-24,1860,1
SIM,1914,6,na,1920,4181
STAT,1774,103,na,1877,0.037058701051238936
STAT,1856,32,35-39,1888,8.209080748101092
SIM,1855,42,35-39,1897,4
SIM,1867,33,15-19,1900,1
STAT,1900,42,20-24,1942,0.01557426767802285
STAT,1817,48,30-34,1865,0.21294751157585798
SIM,1860,36,30-34,1896,6
STAT,1879,45,35-39,1924,0.15077805466696834
SIM,1779,81,na,1860,111
STAT,1846,38,35-39,1884,5.227410131130216
STAT,1919,15,30-34,1934,2.7705311839566105
STAT,1837,28,40-44,1865,2.5450767069893043
STAT,1888,21,50-100,1909,0.49328826894910854
STAT,1970,0,na,1970,5057.57594729619
SIM,1849,18,na,1867,2213
SIM,1891,27,20-24,1918,14
SIM,1827,93,na,1920,5
STAT,1901,48,50-100,1949,0.19515333112629613
STAT,1915,36,50-100,1951,0.4348939414427166
SIM,1828,28,40-44,1856,4
SIM,1854,37,45-49,1891,5
STAT,1864,50,35-39,1914,0.007921345727045847
SIM,1826,44,na,1870,1566
STAT,1874,49,15-19,1923,4.0792559128673497E-4
STAT,1836,48,40-44,1884,0.11010660904122542
STAT,1827,30,15-19,1857,0.24393023490465338
SIM,1835,38,25-29,1873,4
SIM,1885,29,25-29,1914,46
STAT,1866,21,na,1887,2259.8367989518283
SIM,1845,28,40-44,1873,5
STAT,1898,45,45-49,1943,0.18548198156672077
STAT,1826,88,na,1914,80.0693748670163
STAT,1862,25,35-39,1887,8.532100283041261
SIM,1907,48,40-44,1955,1
SIM,1908,15,20-24,1923,33
STAT,1888,23,40-44,1911,2.5053500282318493
STAT,1861,27,20-24,1888,9.961088315913505
SIM,1912,51,na,1963,3616
STAT,1846,43,30-34,1889,0.8215131191585275
STAT,1847,42,35-39,1889,1.4199717238410094
SIM,1934,25,15-19,1959,2
STAT,1877,29,25-29,1906,44.43864201356357
SIM,1886,33,25-29,1919,17
SIM,1870,25,35-39,1895,17
SIM,1932,28,na,1960,5137
STAT,1926,25,15-19,1951,0.8691890140180901
STAT,1893,17,15-19,1910,7.680177899135429
SIM,1854,43,30-34,1897,2
STAT,1878,33,25-29,1911,10.830326754775237
STAT,1883,27,20-24,1910,11.742777267952869
STAT,1887,19,40-44,1906,0.20796132561216438
SIM,1944,15,30-34,1959,14
SIM,1886,38,30-34,1924,9
STAT,1893,20,45-49,1913,0.9078206960335939
STAT,1936,12,na,1948,3869.1114435174086
SIM,1835,34,30-34,1869,25
STAT,1847,38,15-19,1885,0.044964798896980206
STAT,1821,37,40-44,1858,9.584808668904351
STAT,1860,109,na,1969,0.007584950643806964
STAT,1896,21,25-29,1917,77.36293458429186
STAT,1880,51,30-34,1931,0.006411841467937544
STAT,1850,48,15-19,1898,2.9710109036761576E-4
STAT,1928,16,35-39,1944,5.406346590895382
SIM,1880,38,50-100,1918,2
SIM,1908,22,45-49,1930,2
STAT,1849,73,na,1922,922.1242935627523
STAT,1922,20,25-29,1942,108.72800380209362
SIM,1879,40,30-34,1919,3
SIM,1841,27,45-49,1868,1
STAT,1829,29,45-49,1858,1.1407661646724332
SIM,1886,72,na,1958,1409
STAT,1776,96,na,1872,1.4538588708934714
STAT,1772,82,na,1854,85.0
SIM,1900,39,40-44,1939,3
SIM,1949,20,40-44,1969,5
STAT,1861,22,15-19,1883,2.8570012749555884
SIM,1874,50,45-49,1924,1
SIM,1891,34,45-49,1925,5
STAT,1844,18,30-34,1862,1.5607860486154672
STAT,1865,43,40-44,1908,2.0675665490409885
STAT,1794,101,na,1895,0.11310702162796644
STAT,1834,24,20-24,1858,61.13513034505848
SIM,1933,13,na,1946,5275
SIM,1898,36,20-24,1934,1
STAT,1772,104,na,1876,0.017833732072581668
SIM,1852,37,35-39,1889,1
STAT,1825,43,50-100,1868,1.4126893129172304
SIM,1853,25,35-39,1878,9
STAT,1833,27,45-49,1860,0.9786337386800963
SIM,1923,30,35-39,1953,16
STAT,1863,27,50-100,1890,0.5721739589007829
STAT,1878,30,20-24,1908,2.8933449449524606
STAT,1902,32,na,1934,3433.055659112148
STAT,1879,50,na,1929,2329.0362137169573
SIM,1897,31,35-39,1928,18
STAT,1889,48,20-24,1937,0.008422733095732634
SIM,1860,36,na,1896,2040
SIM,1858,15,20-24,1873,19
STAT,1823,33,35-39,1856,22.98136584264925
SIM,1819,47,30-34,1866,1
SIM,1837,30,25-29,1867,11
STAT,1820,50,20-24,1870,0.0013465396435675086
STAT,1868,44,20-24,1912,0.1526535033857895
STAT,1894,25,30-34,1919,33.268329757898435
STAT,1905,16,40-44,1921,0.2701410719362422
STAT,1828,42,25-29,1870,0.5250593565023213
STAT,1906,46,na,1952,3350.7741513225646
STAT,1844,37,35-39,1881,5.791791148601487
STAT,1883,34,45-49,1917,1.7305614190854224
STAT,1934,2,na,1936,5641.464522065939
SIM,1833,78,na,1911,475
STAT,1857,17,na,1874,2149.4964527388556
STAT,1895,33,25-29,1928,13.575487139135785
STAT,1895,42,15-19,1937,0.0012748452575345633
STAT,1878,86,na,1964,444.1421147397754
STAT,1857,41,40-44,1898,1.8001491131026797
STAT,1922,38,15-19,1960,0.022273274724252574
SIM,1876,44,20-24,1920,3
SIM,1930,20,25-29,1950,4
SIM,1939,17,15-19,1956,44
SIM,1831,33,35-39,1864,13
STAT,1876,8,na,1884,2814.892724468213
STAT,1816,43,45-49,1859,3.381631821870432
STAT,1810,103,na,1913,0.06118523716774083
STAT,1829,30,25-29,1859,9.99930987858798
SIM,1837,38,35-39,1875,11
STAT,1851,20,50-100,1871,0.40760015010232664
STAT,1885,47,25-29,1932,0.05835074968191679
STAT,1904,16,50-100,1920,0.07180527470587625
STAT,1874,72,na,1946,1315.3831580689834
STAT,1831,23,40-44,1854,4.7946178084924505
SIM,1937,27,na,1964,4331
STAT,1836,77,na,1913,538.0275644569476
STAT,1864,31,30-34,1895,15.902122463243284
SIM,1871,8,na,1879,2628
STAT,1833,110,na,1943,1.8147003428843302E-4
STAT,1915,30,35-39,1945,9.573707379398543
SIM,1824,43,45-49,1867,3
STAT,1858,49,30-34,1907,0.07667684889936609
STAT,1825,46,15-19,1871,5.215624293809207E-4
STAT,1917,15,20-24,1932,29.910901730885698
SIM,1801,57,na,1858,1283
STAT,1893,46,20-24,1939,0.00878494839071215
STAT,1872,38,50-100,1910,1.2490544144765399
STAT,1897,32,50-100,1929,1.249792458044932
SIM,1846,35,45-49,1881,2
STAT,1896,29,35-39,1925,12.907599868339386
SIM,1852,92,na,1944,28
STAT,1866,50,45-49,1916,0.013851987753010725
STAT,1877,49,40-44,1926,0.17736216173141045
SIM,1836,22,na,1858,2103
STAT,1844,46,25-29,1890,0.0447616221813765
STAT,1829,38,35-39,1867,6.101849629593784
STAT,1835,32,15-19,1867,0.1351396941002499
SIM,1830,26,30-34,1856,35
SIM,1827,35,35-39,1862,10
STAT,1852,16,15-19,1868,5.816557319778818
STAT,1925,38,40-44,1963,1.831242075703379
STAT,1938,15,40-44,1953,1.4140128404154333
STAT,1886,26,35-39,1912,10.454785059001066
STAT,1858,45,15-19,1903,3.268289765814385E-4
STAT,1854,36,40-44,1890,3.3664673688409716
STAT,1875,29,15-19,1904,0.47163625508053986
SIM,1857,42,45-49,1899,1
SIM,1868,32,na,1900,2364
STAT,1831,32,30-34,1863,15.990136344540254
STAT,1885,19,30-34,1904,1.6135069608072055
SIM,1850,33,45-49,1883,2
STAT,1812,51,25-29,1863,0.008157684487275182
SIM,1842,24,20-24,1866,96
SIM,1897,13,na,1910,3499
SIM,1806,56,na,1862,1256
STAT,1902,45,50-100,1947,0.20129531606218393
STAT,1838,41,30-34,1879,1.0006185894451523
STAT,1859,83,na,1942,323.4312450180031
SIM,1865,37,20-24,1902,1
STAT,1948,20,45-49,1968,1.3189963179255342
STAT,1931,13,na,1944,5281.0131311186315
STAT,1935,27,na,1962,5207.6099912261625
STAT,1874,28,45-49,1902,1.15237867599404
SIM,1861,24,30-34,1885,29
STAT,1822,45,35-39,1867,0.2055626525454449
SIM,1878,39,35-39,1917,10
SIM,1869,17,na,1886,2540
SIM,1873,54,na,1927,2114
SIM,1916,40,45-49,1956,1
STAT,1838,16,40-44,1854,0.1785637771643694
STAT,1928,25,25-29,1953,83.27429441796195
SIM,1838,33,50-100,1871,2
STAT,1915,50,na,1965,3743.5783637953496
SIM,1833,89,na,1922,70
SIM,1885,49,40-44,1934,1
SIM,1837,29,45-49,1866,1
SIM,1877,68,na,1945,1523
SIM,1862,32,25-29,1894,9
STAT,1804,56,na,1860,1080.4405006649843
SIM,1862,36,40-44,1898,9
STAT,1819,35,35-39,1854,23.534663425921153
SIM,1840,40,25-29,1880,5
SIM,1835,37,na,1872,1779
STAT,1903,41,35-39,1944,0.18317841494080483
SIM,1911,49,45-49,1960,2
SIM,1936,16,35-39,1952,7
STAT,1888,39,15-19,1927,0.06704192865189965
SIM,1831,23,na,1854,1735
STAT,1850,92,na,1942,31.32889028539837
SIM,1828,44,40-44,1872,3
STAT,1853,24,30-34,1877,17.394510529781854
SIM,1860,25,na,1885,2193
SIM,1848,29,20-24,1877,14
STAT,1843,33,50-100,1876,0.8800281402455661
SIM,1857,91,na,1948,15
SIM,1901,27,40-44,1928,6
SIM,1936,25,25-29,1961,76
STAT,1849,42,45-49,1891,1.1605018458520044
STAT,1864,22,40-44,1886,1.920581895894835
STAT,1885,28,20-24,1913,11.897993475547588
STAT,1887,35,40-44,1922,5.051593875695497
STAT,1840,17,35-39,1857,0.5112232011102279
STAT,1931,31,30-34,1962,21.066593790823653
SIM,1893,28,20-24,1921,21
SIM,1895,35,40-44,1930,8
STAT,1861,51,20-24,1912,6.250188443306447E-4
STAT,1808,59,na,1867,906.1688217264073
STAT,1818,37,20-24,1855,2.898321234475888
STAT,1860,47,20-24,1907,0.009886265290373222
STAT,1854,32,25-29,1886,8.027839187357026
STAT,1854,53,50-100,1907,0.011373367581300585
SIM,1873,43,40-44,1916,5
STAT,1832,40,25-29,1872,0.5415112239586437
SIM,1851,33,50-100,1884,1
SIM,1894,26,35-39,1920,3
SIM,1848,55,na,1903,1686
STAT,1921,35,na,1956,4294.078931513016
SIM,1818,89,na,1907,41
STAT,1859,38,50-100,1897,0.9952991086718669
STAT,1852,45,20-24,1897,0.009763598064977118
STAT,1837,37,30-34,1874,4.326372251113193
STAT,1903,49,45-49,1952,0.18902045552529997
STAT,1842,30,40-44,1872,4.194550713291883
STAT,1860,21,45-49,1881,0.5992961677879316
SIM,1805,82,na,1887,89
STAT,1875,25,20-24,1900,12.366286098113035
SIM,1870,38,40-44,1908,10
STAT,1922,44,50-100,1966,0.13713061903959065
STAT,1848,105,na,1953,0.02279192846205342
SIM,1947,23,35-39,1970,18
STAT,1909,16,25-29,1925,8.688315958019926
STAT,1866,47,15-19,1913,3.7463301747100883E-4
STAT,1871,40,25-29,1911,0.6554632907682888
STAT,1860,38,30-34,1898,4.389487126552285
STAT,1825,37,25-29,1862,4.4111436899656775
STAT,1920,50,na,1970,4106.93449677253
SIM,1861,40,45-49,1901,3
SIM,1877,18,35-39,1895,1
STAT,1855,44,35-39,1899,1.3847918732804603
SIM,1856,30,35-39,1886,18
STAT,1791,96,na,1887,1.4564793690851945
STAT,1869,18,35-39,1887,0.5446846518733073
STAT,1884,35,15-19,1919,0.05721408002065512
STAT,1847,31,50-100,1878,0.8476707179683334
SIM,1854,34,40-44,1888,7
STAT,1834,28,15-19,1862,0.3974876721441393
STAT,1932,28,30-34,1960,52.31315605931998
STAT,1892,28,25-29,1920,53.89460531946551
STAT,1916,42,45-49,1958,0.17404643433928382
STAT,1846,34,40-44,1880,3.5896133904150185
SIM,1940,28,30-34,1968,42
STAT,1919,29,50-100,1948,1.0896381554401118
SIM,1917,16,25-29,1933,16
SIM,1904,30,25-29,1934,22
STAT,1924,6,na,1930,4869.601131884996
SIM,1774,82,na,1856,191
STAT,1822,74,na,1896,645.2799141090735
SIM,1778,96,na,1874,4
SIM,1878,31,25-29,1909,16
SIM,1845,37,30-34,1882,2
STAT,1872,17,na,1889,2590.748598592973
STAT,1889,39,45-49,1928,2.4867966090445766
SIM,1868,36,35-39,1904,8
STAT,1850,32,40-44,1882,3.412482609599255
STAT,1890,15,45-49,1905,0.08185773231188964
STAT,1852,40,na,1892,1880.726170564229
SIM,1890,22,35-39,1912,17
STAT,1944,17,30-34,1961,13.38275610650222
SIM,1924,42,45-49,1966,1
STAT,1862,34,25-29,1896,8.818525248616213
STAT,1908,40,45-49,1948,0.15879555979697033
STAT,1832,27,15-19,1859,0.4132448856458938
SIM,1876,35,30-34,1911,10
STAT,1838,35,45-49,1873,1.80449568165065
SIM,1837,92,na,1929,28
STAT,1897,30,30-34,1927,24.007127278071202
STAT,1838,47,50-100,1885,0.18565142708532958
STAT,1859,29,30-34,1888,20.571578021644406
STAT,1870,27,35-39,1897,9.622516407471768
SIM,1867,29,30-34,1896,4
STAT,1842,36,50-100,1878,1.1412277197857825
STAT,1828,46,40-44,1874,0.13566644436028122
SIM,1846,41,30-34,1887,1
STAT,1870,58,na,1928,1972.184198916089
STAT,1811,47,25-29,1858,0.16001059301392856
STAT,1907,22,50-100,1929,0.6108239358068454
SIM,1855,31,50-100,1886,1
STAT,1791,85,na,1876,79.70431121746918
SIM,1883,25,20-24,1908,14
SIM,1817,42,50-100,1859,1
SIM,1877,27,25-29,1904,59
STAT,1848,47,20-24,1895,0.009284510097571677
STAT,1875,44,50-100,1919,1.0911858881202186
STAT,1901,47,na,1948,3195.2067448186394
STAT,1939,23,35-39,1962,9.643415888412608
SIM,1853,55,na,1908,1733
SIM,1857,69,na,1926,1089
STAT,1895,37,40-44,1932,5.826504159804075
SIM,1885,26,20-24,1911,12
STAT,1871,48,35-39,1919,0.13969582967477687
STAT,1880,31,15-19,1911,0.15328913021806362
STAT,1882,22,35-39,1904,5.799748414186115
SIM,1947,7,na,1954,4682
STAT,1821,89,na,1910,55.356824041576935
SIM,1899,19,25-29,1918,17
STAT,1868,35,30-34,1903,5.242284814390936
SIM,1840,59,na,1899,1307
SIM,1825,59,na,1884,1147
STAT,1885,35,na,1920,2420.6364039601244
STAT,1851,55,na,1906,1705.8996300425385
SIM,1855,25,na,1880,1961
SIM,1821,45,na,1866,1466
STAT,1881,21,na,1902,2339.636302741617
STAT,1857,44,45-49,1901,1.1763063222064074
SIM,1832,42,40-44,1874,4
STAT,1855,69,na,1924,1137.6371055942545
STAT,1837,40,na,1877,1697.006687835399
SIM,1851,11,na,1862,2330
SIM,1897,39,45-49,1936,1
STAT,1898,42,40-44,1940,0.21521297572690107
STAT,1766,113,na,1879,6.678323637466442E-4
STAT,1855,19,45-49,1874,0.05952131820269093
STAT,1900,18,50-100,1918,0.06909056134815017
STAT,1911,48,40-44,1959,0.15182665103489726
SIM,1854,40,na,1894,2022
SIM,1872,69,na,1941,1434
STAT,1877,17,30-34,1894,1.686450887722602
STAT,1877,26,20-24,1903,12.455481697590395
STAT,1806,54,40-44,1860,0.03280180289911636
STAT,1872,52,35-39,1924,0.008755298986755358
SIM,1880,33,30-34,1913,30
STAT,1840,42,25-29,1882,0.4820323331895236
STAT,1881,22,50-100,1903,0.402194465537759
STAT,1936,18,35-39,1954,4.086750272538296
STAT,1940,27,na,1967,3897.1000684620244
SIM,1823,31,35-39,1854,12
STAT,1890,57,na,1947,2506.6868210092957
SIM,1836,46,40-44,1882,1
STAT,1888,48,50-100,1936,0.16498128139068488
SIM,1886,30,20-24,1916,6
STAT,1847,51,25-29,1898,0.0027753233803419343
SIM,1900,29,na,1929,3373
STAT,1836,19,35-39,1855,0.5230227458135984
SIM,1866,17,20-24,1883,2
STAT,1889,49,na,1938,2776.443443040341
STAT,1867,27,15-19,1894,0.4345253090016311
STAT,1891,33,40-44,1924,5.454149944459341
STAT,1858,17,20-24,1875,16.753966521325104
SIM,1883,21,na,1904,2388
STAT,1905,41,30-34,1946,0.11815716053202405
STAT,1831,51,35-39,1882,0.00631756179005236
STAT,1889,31,35-39,1920,12.813709514559264
STAT,1872,33,30-34,1905,17.77600015637016
STAT,1896,35,50-100,1931,1.6699136150789062
STAT,1881,43,25-29,1924,0.6287698288315672
SIM,1928,26,50-100,1954,4
STAT,1824,42,40-44,1866,2.77140930053831
STAT,1878,38,30-34,1916,5.631202026804977
STAT,1934,30,45-49,1964,2.193482050572995
SIM,1896,27,35-39,1923,4
STAT,1862,43,15-19,1905,0.011905825646244716
STAT,1851,27,25-29,1878,40.86235693657121
STAT,1860,18,15-19,1878,5.63187163359554
STAT,1817,44,15-19,1861,0.03208783181349479
STAT,1862,38,40-44,1900,3.7825685230978
SIM,1887,35,na,1922,2866
SIM,1880,27,45-49,1907,1
STAT,1852,48,25-29,1900,0.04581960301996892
SIM,1887,36,45-49,1923,7
SIM,1905,1,na,1906,3901
SIM,1860,39,35-39,1899,11
STAT,1823,59,na,1882,1168.2882367301438
SIM,1842,31,45-49,1873,5
STAT,1827,34,30-34,1861,24.448407040765318
SIM,1891,72,na,1963,1746
SIM,1907,4,na,1911,4005
STAT,1852,39,35-39,1891,5.640609720698108
SIM,1887,42,30-34,1929,1
STAT,1803,82,na,1885,196.91631184219014
STAT,1883,0,na,1883,3545.4361020459764
SIM,1896,48,50-100,1944,1
STAT,1846,34,50-100,1880,0.7584003488560809
STAT,1911,40,30-34,1951,0.12587696256521955
STAT,1879,42,50-100,1921,1.1251657830106534
SIM,1790,67,na,1857,587
SIM,1865,44,45-49,1909,8
SIM,1820,60,na,1880,1307
SIM,1813,42,30-34,1855,1
SIM,1824,74,na,1898,567
STAT,1835,92,na,1927,31.031557320620742
STAT,1853,52,25-29,1905,0.002954162462249996
SIM,1913,5,na,1918,4287
SIM,1829,36,35-39,1865,9
STAT,1868,31,15-19,1899,0.13932443827746988
SIM,1903,47,na,1950,3125
STAT,1879,42,30-34,1921,1.2244451194926333
STAT,1834,31,45-49,1865,1.5188781463656051
STAT,1879,36,45-49,1915,2.1359959396203605
STAT,1923,41,50-100,1964,0.140300037034987
STAT,1918,5,na,1923,4465.9912299737725
STAT,1913,43,45-49,1956,0.16531033980093646
SIM,1845,58,na,1903,1554
SIM,1842,48,30-34,1890,1
STAT,1888,27,35-39,1915,11.636802627037746
STAT,1820,40,na,1860,1536.5922896146653
STAT,1883,18,45-49,1901,0.0652142594983008
STAT,1903,17,na,1920,3662.5447434218995
STAT,1886,19,25-29,1905,6.086186997387783
STAT,1841,38,20-24,1879,0.6636533132262026
STAT,1911,35,35-39,1946,2.4056323266883446
STAT,1882,9,na,1891,2578.7457071904423
STAT,1892,23,50-100,1915,0.5197741940473595
STAT,1858,88,na,1946,111.06347749218487
SIM,1830,41,40-44,1871,7
STAT,1858,51,50-100,1909,0.012276699818649837
STAT,1914,36,15-19,1950,0.01965656137837779
STAT,1788,76,na,1864,405.36323593020506
STAT,1916,44,25-29,1960,0.07442889394994481
SIM,1827,28,25-29,1855,60
STAT,1796,95,na,1891,2.8923432201021066
SIM,1940,30,35-39,1970,17
SIM,1813,44,45-49,1857,1
STAT,1861,37,35-39,1898,5.9622481699065455
STAT,1873,28,15-19,1901,0.4675899318101958
STAT,1859,53,30-34,1912,0.004771765110934261
STAT,1859,38,20-24,1897,0.6249071330392408
STAT,1931,9,na,1940,5314.04239252949
SIM,1921,18,40-44,1939,2
SIM,1944,18,35-39,1962,4
SIM,1876,46,35-39,1922,1
SIM,1880,35,45-49,1915,5
STAT,1887,40,15-19,1927,0.015945768554963775
STAT,1845,54,40-44,1899,0.00799954414475777
STAT,1857,45,20-24,1902,0.00965594241110456
SIM,1832,93,na,1925,2
SIM,1928,13,na,1941,5215
STAT,1828,26,25-29,1854,86.73898512996665
SIM,1924,19,20-24,1943,175
STAT,1872,35,45-49,1907,2.0575569501632174
SIM,1879,70,na,1949,1609
SIM,1894,19,25-29,1913,7
STAT,1798,96,na,1894,2.9557701681538053
SIM,1844,25,20-24,1869,14
SIM,1899,28,15-19,1927,1
STAT,1845,38,na,1883,1914.169312758999
STAT,1770,106,na,1876,0.007925425535660849
STAT,1804,52,50-100,1856,0.04429875321976729
SIM,1910,49,na,1959,3437
SIM,1871,37,45-49,1908,1
STAT,1862,18,na,1880,2269.5521590256576
STAT,1901,31,45-49,1932,2.497866736570231
STAT,1834,48,30-34,1882,0.06820546255788475
STAT,1836,25,20-24,1861,9.586464544427379
STAT,1843,25,na,1868,2180.393391809113
SIM,1870,57,na,1927,2153
STAT,1818,40,50-100,1858,2.9391044865167784
SIM,1876,28,20-24,1904,18
STAT,1826,49,35-39,1875,0.1065396530778817
STAT,1933,26,50-100,1959,1.3484220619683354
SIM,1921,43,45-49,1964,1
STAT,1853,18,50-100,1871,0.049125055386878114
STAT,1920,33,35-39,1953,10.17171848586676
STAT,1866,38,25-29,1904,2.6958008718398023
STAT,1922,41,45-49,1963,0.1951979970165265
SIM,1828,88,na,1916,78
STAT,1881,74,na,1955,1094.5593925301278
STAT,1848,56,na,1904,1585.4750574870918
SIM,1874,38,25-29,1912,4
STAT,1850,60,na,1910,1434.5897634136325
SIM,1912,45,45-49,1957,1
STAT,1904,45,45-49,1949,0.19657597834454787
STAT,1843,46,30-34,1889,0.07878261881591274
SIM,1869,38,30-34,1907,7
STAT,1894,49,40-44,1943,0.1240764350517076
STAT,1938,31,40-44,1969,4.0162552981347615
SIM,1839,40,na,1879,1828
SIM,1891,35,20-24,1926,5
STAT,1935,31,15-19,1966,0.1814107223073243
STAT,1864,24,50-100,1888,0.37046995855307663
SIM,1853,18,25-29,1871,12
STAT,1863,27,30-34,1890,22.523993601192362
SIM,1868,21,na,1889,2327
SIM,1829,35,50-100,1864,1
SIM,1855,26,35-39,1881,12
STAT,1883,35,20-24,1918,0.7789210063370184
STAT,1865,36,na,1901,2191.9051530884835
STAT,1900,34,20-24,1934,3.7892668608087097
SIM,1802,95,na,1897,5
STAT,1879,17,40-44,1896,0.1950395910065563
STAT,1850,36,20-24,1886,0.5951663543620893
STAT,1921,42,40-44,1963,0.28747836335961136
SIM,1836,26,25-29,1862,65
STAT,1803,60,na,1863,1126.2502878635999
STAT,1940,26,15-19,1966,0.7347297021613913
STAT,1883,87,na,1970,440.50714819465634
STAT,1838,48,15-19,1886,2.9851454470534127E-4
STAT,1894,18,20-24,1912,23.202750853819033
SIM,1893,29,50-100,1922,1
STAT,1929,20,35-39,1949,12.21710448765087
STAT,1871,54,na,1925,2115.9951240479427
STAT,1923,34,15-19,1957,0.1501154156914301
STAT,1895,48,45-49,1943,0.17496265408218187
SIM,1802,63,na,1865,843
STAT,1913,30,25-29,1943,9.4565428787152
STAT,1827,27,20-24,1854,39.136283480596475
STAT,1879,29,35-39,1908,10.215644385552306
SIM,1871,27,30-34,1898,3
STAT,1873,55,na,1928,2138.531892661985
STAT,1909,41,15-19,1950,0.0014733617380223922
STAT,1875,36,na,1911,2478.605720058052
STAT,1924,43,20-24,1967,0.021397969469238227
STAT,1907,46,25-29,1953,0.048806317578046605
STAT,1923,47,na,1970,4384.9634195816825
STAT,1812,43,na,1855,1449.7677259753157
STAT,1822,41,40-44,1863,3.606877704090484
SIM,1804,76,na,1880,495
SIM,1862,38,na,1900,2150
SIM,1835,27,20-24,1862,14
STAT,1895,17,25-29,1912,7.54247759197539
STAT,1932,30,35-39,1962,12.402957832509165
STAT,1917,18,25-29,1935,9.491539933142908
SIM,1787,79,na,1866,213
STAT,1845,18,25-29,1863,5.563240570347803
STAT,1847,26,35-39,1873,9.10930141367628
STAT,1934,37,50-100,1971,0.5908592656353583
STAT,1920,49,50-100,1969,0.2536505804657733
STAT,1870,32,30-34,1902,17.411924871870802
SIM,1862,44,40-44,1906,10
SIM,1856,38,45-49,1894,4
STAT,1843,109,na,1952,5.743422658424587E-4
STAT,1777,101,na,1878,0.16050827414772806
STAT,1916,19,20-24,1935,29.196054634538534
SIM,1887,29,35-39,1916,15
SIM,1910,42,30-34,1952,1
SIM,1936,32,na,1968,3279
STAT,1860,42,15-19,1902,0.011416519903108106
SIM,1921,30,25-29,1951,14
STAT,1939,19,15-19,1958,46.3109862770056
SIM,1947,19,15-19,1966,2
STAT,1862,15,20-24,1877,17.84198710218352
SIM,1833,37,25-29,1870,7
STAT,1911,24,50-100,1935,0.6325584425234592
STAT,1839,105,na,1944,0.020235509713306142
STAT,1905,19,45-49,1924,0.09572642831548515
STAT,1871,36,40-44,1907,4.4448653164727805
SIM,1777,79,na,1856,241
SIM,1910,17,na,1927,3870
STAT,1815,48,20-24,1863,0.03174851745025027
STAT,1881,18,35-39,1899,0.5397615386683786
STAT,1848,38,45-49,1886,1.5804006591621829
STAT,1880,54,35-39,1934,0.008975370398717134
STAT,1920,46,40-44,1966,0.1782964574523062
STAT,1882,39,20-24,1921,0.7584181000888198
STAT,1894,36,35-39,1930,9.325887352464836
STAT,1895,9,na,1904,3453.4850503778807
STAT,1902,42,30-34,1944,0.11471331996716605
STAT,1837,19,na,1856,2013.5395881844604
STAT,1845,49,45-49,1894,0.18054779160010195
SIM,1937,20,35-39,1957,17
SIM,1890,39,20-24,1929,1
SIM,1912,40,50-100,1952,1
STAT,1926,18,50-100,1944,0.46737784389871473
STAT,1920,20,15-19,1940,6.075227066497205
STAT,1861,54,25-29,1915,0.0029036967225501125
SIM,1869,70,na,1939,1206
SIM,1900,32,20-24,1932,3
STAT,1854,29,50-100,1883,0.5059076939341028
STAT,1851,40,35-39,1891,1.5090273651681436
STAT,1868,17,50-100,1885,0.04860038891264645
SIM,1852,42,30-34,1894,3
STAT,1855,28,35-39,1883,7.740499441036218
STAT,1929,42,na,1971,4905.571378004945
SIM,1920,31,35-39,1951,15
STAT,1835,38,na,1873,1952.394184197508
STAT,1900,52,na,1952,3028.346607173649
SIM,1916,12,na,1928,4319
STAT,1824,46,20-24,1870,0.0141753192089329
SIM,1907,61,na,1968,3131
STAT,1937,24,50-100,1961,0.6531453235194162
SIM,1850,34,20-24,1884,5
SIM,1846,28,35-39,1874,19
SIM,1852,45,35-39,1897,1
STAT,1896,21,50-100,1917,0.5510966139444528
STAT,1838,28,35-39,1866,8.953515890209587
STAT,1844,45,35-39,1889,0.11019843666523182
STAT,1851,47,50-100,1898,0.20167962359634697
STAT,1923,47,20-24,1970,0.01319039924231461
STAT,1842,22,50-100,1864,0.40335081390809835
STAT,1848,88,na,1936,106.71508051720784
STAT,1885,15,50-100,1900,0.05009456552985263
STAT,1828,36,na,1864,1545.0640871704077
STAT,1878,53,40-44,1931,0.010999413560905624
SIM,1864,6,na,1870,2619
STAT,1903,46,40-44,1949,0.1404415447865468
STAT,1786,95,na,1881,2.173372688775417
STAT,1842,34,20-24,1876,2.5080808014758613
SIM,1936,0,na,1936,3670
SIM,1820,92,na,1912,28
STAT,1818,91,na,1909,29.531180965954466
STAT,1883,55,na,1938,2069.709812807894
SIM,1905,17,45-49,1922,3
STAT,1859,48,35-39,1907,0.11262692593908345
STAT,1840,60,na,1900,1372.4025795573066
SIM,1948,8,na,1956,4542
STAT,1832,41,na,1873,1730.4531065260758
STAT,1891,74,na,1965,1711.2596216961454
STAT,1939,30,45-49,1969,1.6397187022551492
STAT,1870,17,20-24,1887,17.848422862608817
STAT,1912,44,40-44,1956,0.24418744844964008
STAT,1874,37,20-24,1911,0.8028867958205992
STAT,1825,93,na,1918,17.52538210235863
SIM,1810,82,na,1892,421
SIM,1846,20,50-100,1866,1
STAT,1915,48,25-29,1963,0.05439302076273933
SIM,1863,87,na,1950,75
STAT,1838,68,na,1906,1122.8464375975284
STAT,1928,41,25-29,1969,0.0929900189966481
STAT,1852,18,na,1870,2223.3786342975013
SIM,1924,31,na,1955,4502
SIM,1902,18,30-34,1920,3
STAT,1903,49,na,1952,3195.1120926812187
STAT,1873,16,35-39,1889,0.5708645947635391
SIM,1882,37,20-24,1919,1
SIM,1858,27,50-100,1885,1
STAT,1844,50,45-49,1894,0.011407442247827707
STAT,1778,76,na,1854,230.0
STAT,1891,49,15-19,1940,2.7902412444628515E-4
STAT,1915,28,na,1943,3885.390167443361
SIM,1856,42,na,1898,2234
STAT,1885,43,30-34,1928,1.1616553495405126
SIM,1882,36,na,1918,2268
STAT,1820,62,na,1882,1041.3232671458268
STAT,1818,47,35-39,1865,0.3179405392304854
SIM,1821,43,40-44,1864,6
SIM,1911,33,35-39,1944,15
STAT,1835,47,35-39,1882,0.10999534262743736
STAT,1844,27,20-24,1871,11.128716916626967
STAT,1875,49,30-34,1924,0.09923450763092934
SIM,1861,35,35-39,1896,1
SIM,1884,48,35-39,1932,1
STAT,1825,50,35-39,1875,0.011108443324660036
STAT,1830,38,45-49,1868,1.7755463664310085
STAT,1940,32,35-39,1972,9.648600901783052
STAT,1880,34,40-44,1914,4.609284869208127
SIM,1852,27,20-24,1879,13
SIM,1944,3,na,1947,4367
SIM,1795,66,na,1861,809
SIM,1811,46,na,1857,1240
STAT,1870,44,25-29,1914,0.6317550680396607
STAT,1856,49,20-24,1905,0.00940900036344845
STAT,1828,58,na,1886,1128.2104717386258
STAT,1911,46,na,1957,3556.4848014182103
SIM,1869,92,na,1961,78
SIM,1850,90,na,1940,39
STAT,1833,36,20-24,1869,0.6451439359847657
STAT,1922,30,50-100,1952,0.9608560209137945
STAT,1813,43,40-44,1856,7.81116484572347
STAT,1876,85,na,1961,447.03602005452507
STAT,1903,33,35-39,1936,8.397066059530362
SIM,1832,32,50-100,1864,2
STAT,1876,48,35-39,1924,0.14562702124547877
STAT,1898,46,20-24,1944,0.00936470266608088
SIM,1843,16,15-19,1859,9
STAT,1818,52,30-34,1870,0.012954958453170774
STAT,1853,35,35-39,1888,6.055087334319908
STAT,1892,41,35-39,1933,2.3257133840540853
SIM,1896,50,na,1946,2947
STAT,1820,53,25-29,1873,0.006088438051774504
SIM,1919,30,na,1949,4240
STAT,1833,80,na,1913,406.22952597897785
STAT,1913,18,40-44,1931,0.29098020367239785
SIM,1856,20,na,1876,2430
SIM,1820,82,na,1902,267
STAT,1833,90,na,1923,51.77426161638174
STAT,1938,7,na,1945,4022.3558984214646
SIM,1862,16,25-29,1878,9
STAT,1885,38,35-39,1923,7.162964085495426
SIM,1937,24,50-100,1961,1
STAT,1940,29,50-100,1969,1.034432210333662
STAT,1798,109,na,1907,2.449045555291575E-4
STAT,1854,16,25-29,1870,5.2188939297103785
STAT,1883,33,na,1916,2378.534929134014
STAT,1891,52,na,1943,2705.043478702054
SIM,1855,68,na,1923,1191
STAT,1830,43,40-44,1873,1.9127889392764665
STAT,1868,66,na,1934,1596.9979716626278
STAT,1778,98,na,1876,0.37428364239003
STAT,1891,42,na,1933,2915.4971744240684
STAT,1828,68,na,1896,841.5275587793822
STAT,1837,52,40-44,1889,0.007044690234250054
STAT,1929,10,na,1939,5173.127302312709
SIM,1893,38,35-39,1931,3
SIM,1901,44,30-34,1945,1
STAT,1853,17,20-24,1870,17.882048884836173
STAT,1882,33,50-100,1915,0.9067923422278648
STAT,1903,27,na,1930,3460.851651294999
SIM,1795,76,na,1871,423
SIM,1861,17,20-24,1878,26
SIM,1882,58,na,1940,1952
STAT,1891,37,20-24,1928,0.973580555603065
SIM,1870,35,na,1905,2620
STAT,1832,63,na,1895,1192.3219676138194
STAT,1933,36,25-29,1969,1.3689306644276278
STAT,1861,46,25-29,1907,0.048692826842207056
SIM,1914,31,na,1945,3875
SIM,1920,7,na,1927,4414
STAT,1793,65,na,1858,861.4430428369938
STAT,1863,35,na,1898,2127.3211949393944
STAT,1857,28,45-49,1885,0.9046091695680316
STAT,1883,44,50-100,1927,1.043197940725234
SIM,1830,44,45-49,1874,5
STAT,1813,92,na,1905,17.910387026898157
STAT,1807,54,20-24,1861,0.002927620210183588
STAT,1863,54,35-39,1917,0.007488632234397907
STAT,1924,47,50-100,1971,0.2747235988887911
SIM,1876,40,na,1916,2715
SIM,1880,32,40-44,1912,10
STAT,1897,0,na,1897,4005.270420596664
SIM,1880,17,30-34,1897,3
SIM,1931,20,40-44,1951,6
SIM,1940,24,15-19,1964,6
STAT,1846,20,50-100,1866,0.36504172463694035
STAT,1826,46,30-34,1872,0.07664786905973
STAT,1912,40,50-100,1952,0.11689606240399954
SIM,1875,88,na,1963,337
STAT,1931,34,na,1965,5047.625939796116
STAT,1861,76,na,1937,798.6311923310201
SIM,1909,27,30-34,1936,2
SIM,1873,75,na,1948,918
STAT,1913,40,40-44,1953,0.25165601131702725
SIM,1813,41,40-44,1854,2
STAT,1872,17,30-34,1889,1.6349798095770514
SIM,1879,27,35-39,1906,15
STAT,1840,82,na,1922,335.7517595567283
STAT,1874,45,20-24,1919,0.012623349817642899
STAT,1931,36,15-19,1967,0.02596099012180526
STAT,1803,53,25-29,1856,0.01402118796694972
STAT,1932,24,15-19,1956,7.098428829885068
SIM,1846,33,50-100,1879,1
STAT,1821,79,na,1900,368.38599708851564
SIM,1869,29,40-44,1898,5
STAT,1820,49,40-44,1869,0.3032611235681412
STAT,1901,46,30-34,1947,0.07811703640054775
STAT,1898,2,na,1900,3677.417627884974
STAT,1915,22,50-100,1937,0.6940691572254131
SIM,1812,63,na,1875,857
STAT,1843,49,35-39,1892,0.11065848746645847
SIM,1865,28,45-49,1893,5
STAT,1920,30,30-34,1950,17.752579538995175
STAT,1843,18,15-19,1861,6.086255740013241
STAT,1881,40,20-24,1921,0.15821419526548053
STAT,1885,46,35-39,1931,0.14289358425157417
STAT,1908,58,na,1966,3213.9313924641347
SIM,1916,17,20-24,1933,30
STAT,1883,23,na,1906,2360.0168555217147
STAT,1802,65,na,1867,735.9112111132252
STAT,1925,28,na,1953,4498.33224866456
STAT,1927,29,50-100,1956,1.2293804000049258
STAT,1866,53,na,1919,1993.535925357228
STAT,1830,35,40-44,1865,4.065056425738133
STAT,1901,68,na,1969,2523.1201288110224
STAT,1840,100,na,1940,0.7639575917046633
STAT,1946,20,35-39,1966,10.69786067848556
SIM,1844,28,25-29,1872,40
SIM,1848,33,na,1881,1970
STAT,1891,20,na,1911,3004.8739644580755
STAT,1836,28,25-29,1864,33.827759599598735
SIM,1939,29,na,1968,3768
STAT,1914,42,35-39,1956,0.20357948217048966
STAT,1925,7,na,1932,4926.520867026538
STAT,1919,32,na,1951,4163.9243058291995
SIM,1850,80,na,1930,395
SIM,1851,6,na,1857,2398
STAT,1872,32,40-44,1904,4.433987540499077
STAT,1795,78,na,1873,277.43031048309496
STAT,1870,16,50-100,1886,0.04961542740783345
STAT,1908,17,20-24,1925,26.81704657186717
SIM,1845,16,25-29,1861,10
STAT,1811,43,30-34,1854,3.550937469158498
SIM,1854,19,na,1873,2396
SIM,1880,2,na,1882,3230
SIM,1933,34,25-29,1967,15
STAT,1879,26,30-34,1905,26.944996623681046
STAT,1922,41,30-34,1963,0.14994448203661556
STAT,1816,47,25-29,1863,0.11844653583565252
SIM,1890,55,na,1945,2692
SIM,1837,39,na,1876,1607
SIM,1838,23,na,1861,1771
STAT,1871,86,na,1957,269.32242925785573
SIM,1869,16,20-24,1885,16
STAT,1850,39,25-29,1889,2.15482371650106
STAT,1849,20,na,1869,2036.072157260245
SIM,1920,27,na,1947,3970
STAT,1846,27,30-34,1873,21.785379049153455
SIM,1886,17,25-29,1903,10
SIM,1928,30,35-39,1958,17
SIM,1799,80,na,1879,322
STAT,1821,101,na,1922,0.3006839678730441
STAT,1920,29,na,1949,4163.692705357124
STAT,1925,34,25-29,1959,11.18336461940354
SIM,1875,66,na,1941,1553
STAT,1928,29,40-44,1957,5.85151186440877
SIM,1878,21,na,1899,2557
STAT,1859,40,na,1899,1902.0017826207118
STAT,1833,44,20-24,1877,0.12408459961195406
SIM,1897,34,na,1931,3274
STAT,1765,114,na,1879,1.0342530764589378E-4
STAT,1842,41,na,1883,1899.391485700854
STAT,1883,38,25-29,1921,2.867682255122744
SIM,1817,94,na,1911,12
STAT,1881,25,45-49,1906,1.1024961732676992
STAT,1898,29,45-49,1927,1.5207738632919403
STAT,1862,18,25-29,1880,5.602813791959029
SIM,1789,80,na,1869,199
STAT,1910,29,na,1939,3663.143899833658
STAT,1912,31,35-39,1943,9.210547134845891
SIM,1889,26,50-100,1915,1
SIM,1870,18,25-29,1888,9
STAT,1832,48,20-24,1880,0.00940529811669823
SIM,1936,29,40-44,1965,6
STAT,1864,38,15-19,1902,0.05068416314566822
STAT,1923,20,40-44,1943,4.015502875158727
STAT,1836,87,na,1923,109.66101249891777
STAT,1861,54,na,1915,1765.139249513395
STAT,1866,51,35-39,1917,0.00813962757755192
STAT,1811,52,20-24,1863,0.0019528761112858938
STAT,1817,42,na,1859,1488.9438212796197
STAT,1871,39,45-49,1910,1.9941926981819686
STAT,1844,42,30-34,1886,0.9124210291405283
STAT,1860,37,na,1897,1950.075889451156
STAT,1893,37,30-34,1930,6.8972542414958085
STAT,1931,31,45-49,1962,2.1040657720987763
SIM,1887,26,30-34,1913,46
STAT,1926,46,35-39,1972,0.16269420090005166
SIM,1854,27,30-34,1881,38
STAT,1878,54,na,1932,2223.4917544251725
STAT,1907,31,na,1938,3619.5607992550263
SIM,1863,22,na,1885,2031
STAT,1883,47,15-19,1930,3.9851921839149235E-4
STAT,1926,41,15-19,1967,0.0019341286260817021
SIM,1876,19,30-34,1895,3
STAT,1851,48,30-34,1899,0.07885821770724157
STAT,1846,87,na,1933,125.99071303986283
SIM,1935,17,30-34,1952,19
SIM,1921,40,40-44,1961,1
STAT,1927,17,30-34,1944,15.45957701474513
STAT,1859,45,30-34,1904,0.0796506528119421
SIM,1867,37,na,1904,2179
STAT,1869,27,25-29,1896,41.66302608926386
SIM,1835,58,na,1893,1362
STAT,1812,75,na,1887,473.58027495962983
SIM,1849,72,na,1921,1224
STAT,1903,41,20-24,1944,0.0160652187243132
STAT,1906,34,15-19,1940,0.1203770454952567
STAT,1907,43,20-24,1950,0.01639982020491278
STAT,1821,50,50-100,1871,0.02378445218511117
STAT,1884,19,15-19,1903,5.957517709983879
STAT,1822,44,45-49,1866,2.1961326226057665
STAT,1868,19,30-34,1887,1.562562080473823
SIM,1873,22,na,1895,2377
SIM,1834,46,30-34,1880,1
STAT,1878,48,45-49,1926,0.2474504618294599
SIM,1860,89,na,1949,88
STAT,1812,96,na,1908,3.916427821177587
SIM,1870,42,25-29,1912,3
STAT,1914,44,15-19,1958,0.001547394772688133
STAT,1933,33,20-24,1966,3.350156689471602
SIM,1925,30,50-100,1955,1
STAT,1861,108,na,1969,0.02008385225558608
SIM,1833,34,20-24,1867,5
SIM,1846,25,30-34,1871,27
STAT,1919,10,na,1929,4481.791004984875
SIM,1883,75,na,1958,1281
STAT,1858,29,15-19,1887,0.37036989846534857
SIM,1844,19,na,1863,2345
SIM,1830,36,45-49,1866,2
SIM,1811,44,35-39,1855,2
STAT,1866,75,na,1941,968.6931191055285
SIM,1901,34,50-100,1935,5
STAT,1826,54,30-34,1880,0.004316559577699072
SIM,1920,49,na,1969,3917
SIM,1842,93,na,1935,17
SIM,1943,19,30-34,1962,19
SIM,1875,47,30-34,1922,1
STAT,1845,15,20-24,1860,17.715967402833048
STAT,1887,28,30-34,1915,28.684942692702784
STAT,1893,45,30-34,1938,0.07136911367158814
STAT,1842,17,45-49,1859,0.06578118450553896
STAT,1932,30,na,1962,5133.151278217334
STAT,1901,30,20-24,1931,3.8871234036091096
STAT,1930,35,45-49,1965,0.908489141552484
SIM,1824,64,na,1888,880
SIM,1935,20,25-29,1955,166
STAT,1845,46,40-44,1891,0.1341463847902109
SIM,1907,29,na,1936,3568
STAT,1877,36,35-39,1913,7.519778670617215
STAT,1910,40,15-19,1950,0.0014970299101878283
STAT,1855,50,20-24,1905,5.802542040323977E-4
SIM,1926,32,na,1958,4888
SIM,1839,38,45-49,1877,3
STAT,1915,45,20-24,1960,0.01141695323826
STAT,1908,16,na,1924,3829.738627909505
STAT,1862,42,25-29,1904,0.5569626313635332
STAT,1838,25,30-34,1863,23.87764338758913
SIM,1845,22,50-100,1867,1
SIM,1865,88,na,1953,15
STAT,1879,49,15-19,1928,4.1763577750782686E-4
SIM,1898,27,45-49,1925,2
SIM,1853,15,20-24,1868,27
SIM,1859,39,25-29,1898,2
SIM,1899,15,na,1914,3536
STAT,1823,69,na,1892,816.7654736224615
STAT,1811,79,na,1890,302.8233199899391
STAT,1910,23,25-29,1933,88.19775695951785
STAT,1938,18,45-49,1956,0.5025081355463683
STAT,1925,40,45-49,1965,0.20614539905266765
SIM,1885,36,35-39,1921,10
SIM,1826,44,30-34,1870,5
STAT,1870,40,45-49,1910,1.5076037233241633
STAT,1842,37,25-29,1879,2.6486632292231134
SIM,1936,10,na,1946,3469
STAT,1830,52,30-34,1882,0.004344184894998281
STAT,1853,48,40-44,1901,0.14174725202398383
STAT,1838,19,45-49,1857,0.06265252154733593
SIM,1868,17,30-34,1885,5
SIM,1892,36,na,1928,3484
STAT,1870,37,na,1907,2349.528146932546
STAT,1897,17,35-39,1914,0.7484593475226514
STAT,1899,41,45-49,1940,0.1458436671709195
STAT,1841,100,na,1941,0.7838684453370749
STAT,1916,3,na,1919,4377.12835066699
SIM,1857,29,50-100,1886,2
SIM,1850,37,25-29,1887,4
STAT,1918,44,35-39,1962,0.2177537966565374
SIM,1886,40,na,1926,2565
STAT,1832,110,na,1942,1.846568330268288E-4
STAT,1867,47,30-34,1914,0.09227621809153565
SIM,1864,24,50-100,1888,1
SIM,1902,40,30-34,1942,2
STAT,1870,35,35-39,1905,7.120549265182979
STAT,1935,19,30-34,1954,16.90164834565626
STAT,1820,45,25-29,1865,0.10818012949054336
STAT,1822,36,45-49,1858,3.9580146127938063
STAT,1858,66,na,1924,1325.9717781906054
STAT,1852,53,20-24,1905,5.849242279739082E-4
STAT,1866,35,20-24,1901,0.732234515949813
SIM,1824,42,na,1866,1510
STAT,1818,58,na,1876,1175.099190279987
STAT,1830,46,45-49,1876,0.19841786510545867
SIM,1857,26,45-49,1883,1
STAT,1852,44,30-34,1896,0.9136729938516215
SIM,1825,81,na,1906,331
SIM,1905,30,40-44,1935,7
STAT,1927,20,25-29,1947,116.78152601881098
SIM,1866,20,na,1886,2530
STAT,1819,51,50-100,1870,0.02935348014384058
STAT,1913,27,na,1940,3807.952670135593
SIM,1838,26,35-39,1864,9
SIM,1849,17,20-24,1866,23
SIM,1880,35,na,1915,2359
SIM,1883,53,na,1936,2231
STAT,1858,40,45-49,1898,1.2230107254389544
SIM,1790,77,na,1867,235
STAT,1871,27,50-100,1898,0.6464249145950798
SIM,1855,1,na,1856,2830
STAT,1863,37,45-49,1900,1.78307761793113
SIM,1851,18,15-19,1869,6
SIM,1872,15,30-34,1887,2
STAT,1885,35,30-34,1920,5.475846782303065
STAT,1909,29,30-34,1938,37.917553813727494
SIM,1874,35,20-24,1909,1
SIM,1917,29,30-34,1946,61
STAT,1840,24,45-49,1864,0.628998435853478
STAT,1865,35,50-100,1900,1.1475665460962665
SIM,1895,28,30-34,1923,45
SIM,1914,53,na,1967,3640
SIM,1853,87,na,1940,151
STAT,1812,47,40-44,1859,0.4051836041655527
STAT,1803,92,na,1895,16.161428715029096
STAT,1818,44,30-34,1862,2.7172971962576513
STAT,1871,53,30-34,1924,0.005918617423205325
SIM,1893,35,30-34,1928,6
STAT,1876,17,15-19,1893,6.251630167915834
SIM,1906,44,na,1950,3370
STAT,1912,47,45-49,1959,0.21307597345664803
STAT,1906,40,35-39,1946,0.18859835414486792
STAT,1851,76,na,1927,781.6244815287081
STAT,1941,4,na,1945,4216.9278244401285
STAT,1849,26,45-49,1875,1.0292045149882687
STAT,1869,40,na,1909,2299.3288180228406
SIM,1927,18,35-39,1945,5
STAT,1877,91,na,1968,195.44031435626198
STAT,1916,45,na,1961,3863.4092798674833
STAT,1845,107,na,1952,0.003684796057343275
STAT,1824,49,25-29,1873,0.06534025559153324
SIM,1942,28,na,1970,4637
STAT,1905,41,45-49,1946,0.15381720457962006
SIM,1869,46,50-100,1915,1
SIM,1828,37,30-34,1865,9
STAT,1823,37,15-19,1860,0.10521321463479114
STAT,1886,16,20-24,1902,19.190499468156272
SIM,1900,35,25-29,1935,3
STAT,1853,35,na,1888,2016.9384854359334
SIM,1894,16,20-24,1910,26
STAT,1898,49,25-29,1947,0.04388743250487704
STAT,1886,47,40-44,1933,0.18400198684839095
STAT,1940,17,na,1957,3812.5952913580736
STAT,1928,32,35-39,1960,11.655287552119148
SIM,1929,30,na,1959,5097
STAT,1919,18,35-39,1937,4.719607701020565
SIM,1868,86,na,1954,184
STAT,1890,28,15-19,1918,0.5639278634536815
SIM,1913,41,45-49,1954,1
SIM,1851,21,na,1872,2024
STAT,1821,41,25-29,1862,1.1508846848154812
SIM,1839,72,na,1911,950
STAT,1907,63,na,1970,2998.52222985655
SIM,1917,29,na,1946,3805
SIM,1945,19,40-44,1964,1
STAT,1879,17,na,1896,2693.1927286531673
SIM,1877,5,na,1882,2806
SIM,1922,31,45-49,1953,1
SIM,1921,33,na,1954,4857
STAT,1836,107,na,1943,0.002935372709608288
STAT,1862,49,45-49,1911,0.20066336653500466
STAT,1858,34,na,1892,1914.0153966043663
STAT,1918,26,na,1944,4082.331798047793
SIM,1863,17,30-34,1880,1
STAT,1864,15,30-34,1879,1.6630693252300068
SIM,1889,69,na,1958,2075
STAT,1855,17,30-34,1872,1.4695811424190335
SIM,1881,41,na,1922,2148
STAT,1884,43,15-19,1927,0.01383733576134324
STAT,1929,24,50-100,1953,0.8433694250336299
SIM,1915,16,na,1931,4457
STAT,1846,54,35-39,1900,0.005987225209218238
STAT,1896,73,na,1969,1994.7096123199333
STAT,1937,19,40-44,1956,1.3838457523937553
SIM,1870,49,45-49,1919,3
SIM,1926,4,na,1930,5357
STAT,1840,37,15-19,1877,0.04779361450354577
SIM,1807,62,na,1869,956
SIM,1868,26,20-24,1894,2
STAT,1820,34,50-100,1854,2.747544222391387
STAT,1820,94,na,1914,11.00742258606436
STAT,1875,16,45-49,1891,0.06856133394734948
SIM,1838,47,50-100,1885,1
SIM,1864,61,na,1925,1731
STAT,1910,47,35-39,1957,0.12268732541710656
SIM,1840,69,na,1909,932
SIM,1864,71,na,1935,1236
STAT,1932,21,45-49,1953,1.5101327619606508
SIM,1940,15,na,1955,3833
STAT,1882,47,20-24,1929,0.01187092031538205
SIM,1911,13,na,1924,4093
STAT,1839,52,na,1891,1478.086837161046
STAT,1949,18,20-24,1967,160.81773443607824
STAT,1831,40,50-100,1871,0.919605978861071
STAT,1940,20,40-44,1960,3.4967105356485324
STAT,1843,47,50-100,1890,0.19734192375521273
SIM,1828,35,na,1863,1855
STAT,1874,48,25-29,1922,0.059240136021305
STAT,1851,34,50-100,1885,0.7706048518744197
STAT,1853,32,30-34,1885,15.076116454289027
STAT,1878,45,40-44,1923,0.18360301697732334
STAT,1922,30,na,1952,4395.303542779047
SIM,1876,19,na,1895,2896
STAT,1846,42,40-44,1888,1.6279788184619026
STAT,1913,48,15-19,1961,3.6577532355675543E-4
STAT,1917,31,20-24,1948,2.617179474374672
STAT,1882,20,50-100,1902,0.4077116491310129
SIM,1859,43,30-34,1902,1
STAT,1909,30,50-100,1939,0.8111290138201894
STAT,1921,21,35-39,1942,10.885248957572157
STAT,1830,39,na,1869,1668.3711986201708
SIM,1836,54,na,1890,1629
STAT,1883,51,35-39,1934,0.008658601535180626
STAT,1920,36,50-100,1956,0.46954222628588305
STAT,1918,18,50-100,1936,0.4150509085247043
STAT,1865,22,50-100,1887,0.3821640285793514
STAT,1861,43,20-24,1904,0.1329072637554253
SIM,1900,50,na,1950,3001
SIM,1832,61,na,1893,1174
SIM,1930,30,40-44,1960,7
STAT,1840,28,50-100,1868,0.5698325136520627
STAT,1856,22,na,1878,1988.5836180652516
STAT,1814,47,15-19,1861,0.0011926628500726069
STAT,1878,17,25-29,1895,6.017279234582513
STAT,1866,46,50-100,1912,0.231758418931057
STAT,1914,31,45-49,1945,1.622704567934098
STAT,1837,44,40-44,1881,1.5696245083450362
STAT,1821,54,30-34,1875,0.008655642324981321
STAT,1899,17,50-100,1916,0.06844017002476258
SIM,1886,45,40-44,1931,1
STAT,1854,53,30-34,1907,0.004482662804209713
STAT,1833,47,25-29,1880,0.04463035361523687
STAT,1849,16,50-100,1865,0.0470959024910228
STAT,1873,49,20-24,1922,0.01215186334609929
SIM,1861,32,30-34,1893,27
STAT,1823,50,25-29,1873,0.005334582344777079
STAT,1910,20,20-24,1930,107.13735084702721
STAT,1807,47,50-100,1854,1.0764655376517724
SIM,1861,44,25-29,1905,3
STAT,1829,27,30-34,1856,35.82519542253329
SIM,1817,72,na,1889,491
STAT,1877,52,50-100,1929,0.015894937484354655
STAT,1811,46,35-39,1857,0.3958007927048872
STAT,1894,27,50-100,1921,0.8394160013467316
STAT,1936,31,30-34,1967,15.61741677266874
SIM,1845,44,40-44,1889,3
SIM,1918,17,30-34,1935,17
STAT,1896,18,30-34,1914,2.141879025840569
SIM,1922,30,40-44,1952,6
SIM,1826,40,50-100,1866,2
STAT,1880,39,50-100,1919,1.302929867260219
STAT,1920,41,20-24,1961,0.019933248784503328
STAT,1827,42,30-34,1869,1.362423003308517
STAT,1896,49,15-19,1945,2.976601183658329E-4
STAT,1805,53,35-39,1858,0.029735715882781864
STAT,1897,14,na,1911,3511.232818967986
STAT,1937,30,35-39,1967,9.232542767740025
STAT,1799,60,na,1859,954.6291142398234
STAT,1904,40,25-29,1944,0.06585533154645068
SIM,1872,90,na,1962,90
STAT,1940,21,45-49,1961,1.1697108900331827
STAT,1856,16,35-39,1872,0.5226499154568868
SIM,1925,26,na,1951,4532
STAT,1914,30,40-44,1944,4.051390175317361
SIM,1926,41,30-34,1967,1
STAT,1875,14,na,1889,2702.308644945768
STAT,1881,22,40-44,1903,2.0552135693733637
STAT,1920,42,25-29,1962,0.08048359359261865
SIM,1919,29,40-44,1948,1
STAT,1841,53,45-49,1894,0.010543234296476767
STAT,1912,17,50-100,1929,0.07728433659088745
SIM,1880,44,35-39,1924,3
STAT,1872,44,35-39,1916,1.8264388778249245
STAT,1840,54,40-44,1894,0.007367348912159569
STAT,1810,47,30-34,1857,0.3043234470572647
STAT,1888,54,na,1942,2525.423653124419
STAT,1872,50,20-24,1922,7.653127215106689E-4
STAT,1949,18,50-100,1967,0.4444114833316105
SIM,1848,28,45-49,1876,1
SIM,1885,8,na,1893,2648
SIM,1909,30,25-29,1939,8
STAT,1888,40,30-34,1928,1.4005136330409647
STAT,1873,23,na,1896,2438.4922376659233
STAT,1801,59,na,1860,961.6583766506694
SIM,1818,42,30-34,1860,2
SIM,1934,18,50-100,1952,3
SIM,1914,31,45-49,1945,1
STAT,1888,19,35-39,1907,0.6582054588196388
STAT,1933,15,na,1948,5048.228623053674
STAT,1840,39,na,1879,1785.4417583163709
SIM,1862,29,50-100,1891,4
SIM,1851,49,35-39,1900,2
STAT,1916,48,40-44,1964,0.16456479047443823
STAT,1877,33,30-34,1910,18.395922132667007
STAT,1886,73,na,1959,1412.3542016431434
STAT,1849,19,20-24,1868,16.743070979741788
SIM,1830,33,40-44,1863,7
SIM,1885,33,30-34,1918,7
STAT,1872,49,na,1921,2252.275328783201
STAT,1831,31,40-44,1862,4.023346634107052
STAT,1953,2,na,1955,4855.932466967102
SIM,1844,17,20-24,1861,16
SIM,1874,71,na,1945,1345
STAT,1762,116,na,1878,1.1159778380367012E-4
STAT,1912,42,25-29,1954,0.0702580608640665
STAT,1894,33,30-34,1927,22.814274870125388
STAT,1936,32,35-39,1968,9.053232361290007
STAT,1821,57,na,1878,1147.8763356203256
SIM,1857,19,20-24,1876,26
STAT,1820,42,20-24,1862,0.31579426203727456
SIM,1928,15,25-29,1943,69
STAT,1853,67,na,1920,1329.2030699768766
STAT,1918,41,30-34,1959,0.13891134625388532
STAT,1890,29,50-100,1919,0.7922090698303658
STAT,1841,46,20-24,1887,0.009015162288319828
STAT,1914,33,na,1947,3867.8703610890175
SIM,1949,19,25-29,1968,68
STAT,1904,40,50-100,1944,0.1083426415405497
SIM,1931,33,na,1964,4959
STAT,1912,8,na,1920,4100.765508305278
STAT,1937,28,na,1965,3723.0523238940923
STAT,1890,41,25-29,1931,0.8046104106654244
STAT,1831,43,35-39,1874,1.5142969619628437
STAT,1901,42,15-19,1943,0.001366380717626128
SIM,1896,34,50-100,1930,1
SIM,1826,54,na,1880,1382
STAT,1822,53,35-39,1875,0.01156715629334786
STAT,1876,54,20-24,1930,7.559694630229157E-4
STAT,1925,31,20-24,1956,2.9568545200082412
STAT,1854,41,na,1895,1776.9219581227806
STAT,1868,34,na,1902,2305.236624477256
STAT,1904,5,na,1909,3831.5460271291886
SIM,1866,52,na,1918,2242
STAT,1824,32,50-100,1856,1.8360846121421672
STAT,1953,13,na,1966,4846.3746754530475
SIM,1882,46,50-100,1928,1
STAT,1887,43,40-44,1930,2.5526483752260907
SIM,1930,30,50-100,1960,4
STAT,1793,97,na,1890,1.0761440738804766
SIM,1901,13,na,1914,3826
SIM,1866,40,45-49,1906,3
SIM,1834,42,na,1876,1680
STAT,1926,43,30-34,1969,0.1605302941386045
STAT,1880,46,35-39,1926,0.15051026275415788
STAT,1927,42,35-39,1969,0.2576135180884095
STAT,1861,86,na,1947,187.03457637130728
SIM,1829,28,35-39,1857,14
STAT,1839,20,na,1859,1923.5164623180033
SIM,1836,18,25-29,1854,7
SIM,1837,17,na,1854,1908
STAT,1930,30,25-29,1960,12.179244669879564
SIM,1914,24,50-100,1938,4
SIM,1958,10,na,1968,5140
STAT,1821,48,45-49,1869,0.3663332743073388
STAT,1840,21,40-44,1861,1.9207143820023251
STAT,1836,39,50-100,1875,0.9187878981026814
SIM,1897,66,na,1963,2358
STAT,1877,53,25-29,1930,0.0036875799083200727
STAT,1900,49,40-44,1949,0.13369563204636417
STAT,1897,46,50-100,1943,0.1895085913654519
STAT,1789,82,na,1871,133.14677338789085
STAT,1892,49,30-34,1941,0.06835599327597451
SIM,1933,31,20-24,1964,1
STAT,1910,6,na,1916,4037.308762227304
SIM,1855,18,35-39,1873,3
STAT,1922,33,45-49,1955,1.8064879559993985
STAT,1929,42,45-49,1971,0.21983015597301495
SIM,1940,21,45-49,1961,1
STAT,1802,54,20-24,1856,0.001878211949347561
STAT,1911,30,15-19,1941,0.12866621501502795
SIM,1818,57,na,1875,1159
STAT,1902,20,20-24,1922,99.73217892033934
STAT,1866,18,45-49,1884,0.06271879760815471
STAT,1922,46,15-19,1968,4.328770754750694E-4
STAT,1853,89,na,1942,88.087240046581
STAT,1898,32,na,1930,3292.041193343085
SIM,1930,33,45-49,1963,2
STAT,1810,44,50-100,1854,3.5265255328450307
SIM,1931,11,na,1942,5176
STAT,1842,50,35-39,1892,0.006848282370432312
STAT,1914,11,na,1925,4174.383117297113
STAT,1771,87,na,1858,48.903845744612894
STAT,1847,45,50-100,1892,0.1934314687731684
SIM,1839,94,na,1933,18
STAT,1884,30,45-49,1914,1.7741566255030692
SIM,1937,17,40-44,1954,3
SIM,1889,47,na,1936,2912
SIM,1857,37,na,1894,1989
SIM,1885,34,na,1919,2402
STAT,1836,52,25-29,1888,0.0022308820721323045
SIM,1841,43,na,1884,1787
STAT,1847,18,35-39,1865,0.5309039748755544
STAT,1790,79,na,1869,295.04135479657793
STAT,1859,19,na,1878,2145.3333917319883
STAT,1869,20,50-100,1889,0.40576215932748977
STAT,1906,31,45-49,1937,1.4928560671719509
SIM,1889,26,40-44,1915,8
STAT,1839,42,na,1881,1681.1551022337871
STAT,1864,51,25-29,1915,0.0032282697315069637
STAT,1822,33,40-44,1855,11.564596613423369
SIM,1892,30,45-49,1922,5
SIM,1890,33,50-100,1923,1
STAT,1808,91,na,1899,19.291387452165683
STAT,1874,33,50-100,1907,0.9502991589253924
SIM,1858,86,na,1944,161
STAT,1837,107,na,1944,0.003144251595441226
STAT,1857,48,25-29,1905,0.0453143856512829
SIM,1923,0,na,1923,4839
STAT,1812,43,25-29,1855,1.7147616389200173
STAT,1821,47,na,1868,1368.7233896510138
STAT,1929,41,40-44,1970,0.330855547799633
STAT,1905,46,15-19,1951,3.333791786015533E-4
STAT,1916,41,20-24,1957,0.018495228536896332
SIM,1916,44,na,1960,3842
SIM,1876,43,30-34,1919,2
SIM,1835,91,na,1926,51
STAT,1863,30,25-29,1893,9.235156644707534
STAT,1921,20,30-34,1941,33.323891871897324
STAT,1853,57,na,1910,1685.0729533916528
STAT,1867,16,45-49,1883,0.06433549068630375
SIM,1878,15,25-29,1893,12
STAT,1868,43,30-34,1911,1.1121071206983195
STAT,1893,48,35-39,1941,0.10091673572100132
SIM,1820,43,25-29,1863,2
STAT,1860,45,50-100,1905,0.20531330131726575
SIM,1872,42,35-39,1914,3
STAT,1912,52,na,1964,3541.1306629125306
SIM,1837,42,40-44,1879,4
STAT,1846,45,45-49,1891,0.17045128845616836
SIM,1867,15,na,1882,2410
STAT,1927,41,30-34,1968,0.1637922028823507
SIM,1825,91,na,1916,34
SIM,1837,49,na,1886,1441
SIM,1946,10,na,1956,4331
STAT,1872,60,na,1932,1949.9570491312124
SIM,1856,16,35-39,1872,1
STAT,1842,94,na,1936,15.673174210437777
SIM,1854,93,na,1947,49
SIM,1909,15,15-19,1924,14
STAT,1911,32,30-34,1943,15.64917249395028
STAT,1822,49,15-19,1871,5.538645782789859E-4
STAT,1900,20,na,1920,3364.0124260100083
STAT,1871,32,25-29,1903,10.35040395308528
SIM,1895,22,na,1917,3292
SIM,1842,61,na,1903,1397
STAT,1832,52,40-44,1884,0.007353018286593225
STAT,1861,34,30-34,1895,14.5919777330937
STAT,1954,4,na,1958,4958.871323102598
STAT,1918,41,50-100,1959,0.12764826384508052
STAT,1763,99,na,1862,0.11835438325806817
STAT,1850,43,45-49,1893,1.1176475888300723
SIM,1848,25,40-44,1873,5
STAT,1820,36,35-39,1856,18.193140846647818
STAT,1824,45,50-100,1869,0.29406771411617044
SIM,1901,47,50-100,1948,1
STAT,1840,51,50-100,1891,0.010919906361030286
STAT,1844,53,na,1897,1641.724375083971
STAT,1924,46,25-29,1970,0.06459047421465874
STAT,1858,16,45-49,1874,0.06209737903311696
STAT,1848,16,35-39,1864,0.5318796046523241
STAT,1831,57,na,1888,1362.4590297276366
STAT,1864,42,35-39,1906,1.6405348934842188
STAT,1923,40,35-39,1963,0.2408018666808939
SIM,1832,45,50-100,1877,1
SIM,1866,27,50-100,1893,3
STAT,1810,62,na,1872,916.9426803021582
STAT,1824,53,45-49,1877,0.015996399924976187
STAT,1854,47,45-49,1901,0.17978161279491497
STAT,1901,34,50-100,1935,1.2959059810294808
STAT,1929,17,40-44,1946,1.8206462940328916
STAT,1910,44,30-34,1954,0.12171731911362985
STAT,1879,50,30-34,1929,0.006438747611784836
STAT,1864,18,35-39,1882,0.511852138952724
SIM,1871,34,40-44,1905,8
STAT,1862,46,40-44,1908,0.1490921874033527
STAT,1858,27,50-100,1885,0.5297788554721429
SIM,1907,19,20-24,1926,37
STAT,1888,6,na,1894,3150.555676849836
STAT,1912,40,25-29,1952,0.0710544697510328
SIM,1833,24,na,1857,1893
STAT,1842,109,na,1951,5.579300238882023E-4
SIM,1903,30,30-34,1933,36
STAT,1891,44,45-49,1935,1.864738586890224
STAT,1933,25,na,1958,5077.123829460345
SIM,1859,49,na,1908,2062
SIM,1889,15,na,1904,3289
STAT,1776,101,na,1877,0.12796102300373768
STAT,1856,40,35-39,1896,1.464738106171333
SIM,1844,39,50-100,1883,5
SIM,1846,42,na,1888,1901
STAT,1806,58,na,1864,1073.934658115979
STAT,1839,16,35-39,1855,0.49831501027870134
SIM,1848,23,na,1871,2216
SIM,1827,39,na,1866,1596
STAT,1867,19,15-19,1886,5.7422085921719574
SIM,1860,57,na,1917,1849
SIM,1926,30,25-29,1956,14
STAT,1881,49,20-24,1930,0.011588216640388678
SIM,1894,48,na,1942,3005
STAT,1852,47,35-39,1899,0.11225842368137452
STAT,1872,41,30-34,1913,1.1807735460883952
STAT,1902,45,35-39,1947,0.1147448873545453
STAT,1837,40,25-29,1877,0.5183332918862671
STAT,1868,28,20-24,1896,11.390506892954459
STAT,1901,37,40-44,1938,1.347896945309185
STAT,1877,29,50-100,1906,0.6720119672992614
STAT,1861,50,45-49,1911,0.012409304735096402
STAT,1825,61,na,1886,1176.4070788925972
STAT,1864,106,na,1970,0.13906555842452661
STAT,1809,54,na,1863,1437.9304986026436
STAT,1865,47,20-24,1912,0.01105903509754691
SIM,1862,16,na,1878,2427
SIM,1878,43,40-44,1921,5
STAT,1938,14,na,1952,3974.1750923042423
STAT,1931,40,35-39,1971,0.2751139896852511
SIM,1845,40,25-29,1885,2
STAT,1948,24,na,1972,4274.999730882158
STAT,1855,48,15-19,1903,3.0618289617230813E-4
STAT,1908,48,na,1956,3378.5647804743353
SIM,1870,89,na,1959,109
STAT,1921,45,45-49,1966,0.251193351232711
STAT,1815,61,na,1876,1195.9798066872809
STAT,1873,53,40-44,1926,0.010713395095041182
STAT,1840,50,25-29,1890,0.0025854528961474703
STAT,1882,70,na,1952,1394.4829387529503
STAT,1828,54,40-44,1882,0.006954991961205157
SIM,1865,56,na,1921,1899
SIM,1890,23,na,1913,3083
STAT,1827,45,35-39,1872,0.16153326332170231
STAT,1847,71,na,1918,1040.8948896650122
STAT,1895,45,40-44,1940,0.12981859443846047
STAT,1923,15,na,1938,4430.341062082186
SIM,1885,18,20-24,1903,17
STAT,1890,49,20-24,1939,0.00826693466829268
STAT,1901,33,25-29,1934,14.550223840632462
STAT,1834,53,na,1887,1454.5354762290224
STAT,1924,34,50-100,1958,0.9828668953361284
SIM,1852,38,na,1890,1967
STAT,1845,41,50-100,1886,0.8514150984921663
STAT,1809,54,30-34,1863,0.024289949920736624
STAT,1880,43,30-34,1923,1.2235752417078134
SIM,1915,48,na,1963,4113
STAT,1858,56,na,1914,1650.079562403028
STAT,1868,52,20-24,1920,7.15176926367595E-4
STAT,1930,32,40-44,1962,5.150864195046208
SIM,1866,19,na,1885,2518
STAT,1794,61,na,1855,968.217
SIM,1926,19,30-34,1945,18
STAT,1823,41,35-39,1864,3.002950258732648
STAT,1821,45,40-44,1866,0.2779355117894481
SIM,1853,41,50-100,1894,1
SIM,1875,56,na,1931,1989
STAT,1928,14,na,1942,5076.028991008985
SIM,1840,80,na,1920,323
STAT,1797,109,na,1906,1.7915658359699625E-4
SIM,1891,42,45-49,1933,4
SIM,1945,14,na,1959,4697
STAT,1857,71,na,1928,1063.4608657915887
SIM,1829,25,30-34,1854,4
STAT,1810,48,35-39,1858,0.43245989074764557
STAT,1916,47,50-100,1963,0.23673940019964002
STAT,1843,42,15-19,1885,0.01147843799733737
STAT,1820,47,50-100,1867,0.4479656523910651
STAT,1888,22,na,1910,2852.2963971205313
STAT,1823,80,na,1903,344.2815367532557
STAT,1884,47,30-34,1931,0.09724308138541166
SIM,1929,18,45-49,1947,1
STAT,1888,16,30-34,1904,1.926959800629591
STAT,1908,41,20-24,1949,0.016757433784856647
SIM,1896,16,30-34,1912,3
SIM,1903,31,35-39,1934,28
STAT,1926,32,25-29,1958,11.401229510964077
STAT,1849,50,45-49,1899,0.011428775177313373
SIM,1934,32,25-29,1966,4
SIM,1867,17,15-19,1884,7
STAT,1844,75,na,1919,797.7418843488815
SIM,1924,47,50-100,1971,2
STAT,1883,42,45-49,1925,1.4962407015919659
STAT,1851,44,15-19,1895,0.011239560618801736
SIM,1847,16,35-39,1863,1
STAT,1908,26,na,1934,3622.360636283386
STAT,1886,40,20-24,1926,0.17321861178359338
STAT,1870,49,45-49,1919,0.23043998473819288
STAT,1866,15,40-44,1881,0.17875266826504826
SIM,1871,30,25-29,1901,12
STAT,1798,64,na,1862,1024.2373432475258
STAT,1831,34,45-49,1865,1.556107041581939
STAT,1841,49,25-29,1890,0.04164113778120967
SIM,1906,34,na,1940,3544
STAT,1924,11,na,1935,4821.145732140944
STAT,1846,51,30-34,1897,0.004277164859940884
STAT,1922,30,40-44,1952,4.547863993121099
SIM,1884,48,na,1932,2340
STAT,1876,45,30-34,1921,0.10298858121666794
STAT,1899,40,50-100,1939,0.1035188595653716
STAT,1890,32,35-39,1922,12.631862720383975
STAT,1784,83,na,1867,111.34973432971307
STAT,1878,41,25-29,1919,0.6849670100769479
STAT,1827,51,50-100,1878,0.016692132276597115
SIM,1837,27,30-34,1864,36
STAT,1942,24,50-100,1966,0.7033901984448184
STAT,1831,40,30-34,1871,1.000747685074266
STAT,1816,44,20-24,1860,0.3424078054179902
STAT,1918,30,25-29,1948,10.10325515987576
STAT,1847,93,na,1940,22.790342326199756
STAT,1862,60,na,1922,1656.1948899424424
STAT,1869,29,na,1898,2333.70734887112
STAT,1904,42,40-44,1946,0.228085234471894
STAT,1854,44,40-44,1898,1.698256717838544
SIM,1887,23,50-100,1910,1
SIM,1883,85,na,1968,572
SIM,1777,80,na,1857,183
STAT,1879,23,50-100,1902,0.4335056576437536
SIM,1855,15,30-34,1870,1
STAT,1843,57,na,1900,1622.3208680870148
STAT,1813,46,45-49,1859,0.6031818371128642
STAT,1866,85,na,1951,257.9523250436247
STAT,1892,45,15-19,1937,2.913619905653053E-4
STAT,1844,54,25-29,1898,0.002669267406578816
STAT,1870,1,na,1871,3512.0646884939915
SIM,1911,30,30-34,1941,27
SIM,1875,34,na,1909,2342
STAT,1835,44,30-34,1879,1.000812494122942
STAT,1944,20,25-29,1964,101.82283254969906
SIM,1843,24,na,1867,2033
STAT,1881,38,15-19,1919,0.05510927083908973
STAT,1919,42,35-39,1961,0.22268422621539907
STAT,1868,46,35-39,1914,0.13679872658541806
STAT,1896,51,na,1947,2915.038353308431
SIM,1820,34,35-39,1854,14
SIM,1899,47,na,1946,3147
STAT,1878,16,20-24,1894,18.871475264436093
STAT,1880,37,45-49,1917,2.1370767811354336
STAT,1899,17,45-49,1916,0.09125356003301678
STAT,1897,36,na,1933,3229.106479319308
STAT,1845,18,50-100,1863,0.0480971710160986
SIM,1816,76,na,1892,473
SIM,1931,40,35-39,1971,3
STAT,1873,47,20-24,1920,0.012353134764492327
STAT,1851,49,35-39,1900,0.11309083075352813
STAT,1845,16,na,1861,2280.3049742562216
STAT,1897,41,35-39,1938,0.17229909666973908
STAT,1768,98,na,1866,0.7615769081646522
STAT,1887,46,45-49,1933,0.2705454335912531
SIM,1831,41,35-39,1872,1
SIM,1941,11,na,1952,3965
STAT,1903,3,na,1906,3833.7155919483
SIM,1868,29,25-29,1897,57
STAT,1918,19,30-34,1937,13.46585907380149
STAT,1813,52,30-34,1865,0.014286308514309202
STAT,1859,17,15-19,1876,5.612383986494188
SIM,1878,28,30-34,1906,37
SIM,1893,2,na,1895,3477
SIM,1924,44,25-29,1968,2
STAT,1934,31,20-24,1965,3.3981961300752137
SIM,1843,44,30-34,1887,2
STAT,1849,19,na,1868,2167.847550095453
STAT,1842,41,45-49,1883,1.2299483850425528
STAT,1870,48,40-44,1918,0.16858612804217496
SIM,1906,12,na,1918,3846
STAT,1847,15,30-34,1862,1.569723635479092
STAT,1893,33,na,1926,3075.2036526856123
SIM,1864,93,na,1957,48
STAT,1865,54,45-49,1919,0.013067574244229522
STAT,1903,30,30-34,1933,25.522986522143462
SIM,1845,68,na,1913,1262
SIM,1813,58,na,1871,1151
SIM,1821,46,45-49,1867,1
SIM,1787,78,na,1865,234
STAT,1891,3,na,1894,3338.9138754273504
STAT,1918,33,30-34,1951,17.01275191967813
STAT,1896,29,na,1925,3192.5086020553813
STAT,1930,18,na,1948,4840.689872506517
SIM,1910,23,25-29,1933,104
SIM,1872,59,na,1931,2074
STAT,1832,46,20-24,1878,0.009649750170499188
STAT,1812,48,45-49,1860,0.549051504779696
SIM,1912,31,35-39,1943,12
SIM,1843,20,35-39,1863,9
STAT,1892,15,na,1907,3244.1468111674453
SIM,1846,21,15-19,1867,4
SIM,1857,33,40-44,1890,8
STAT,1770,105,na,1875,0.012646888371329167
SIM,1918,27,45-49,1945,3
STAT,1854,15,20-24,1869,16.424206141195906
STAT,1900,28,20-24,1928,16.529293856710574
STAT,1873,56,na,1929,2109.490629559635
STAT,1921,43,30-34,1964,0.14670612587883475
SIM,1944,24,35-39,1968,11
STAT,1925,36,25-29,1961,1.2067713180019723
STAT,1911,16,30-34,1927,2.494072225392066
STAT,1845,9,na,1854,2406.0
STAT,1844,30,50-100,1874,0.8668693040830737
STAT,1936,24,35-39,1960,9.175349905309576
STAT,1903,16,na,1919,3671.540016462232
STAT,1792,103,na,1895,0.02380554406482311
STAT,1845,37,na,1882,1934.149072679782
STAT,1916,38,25-29,1954,1.0238422095427377
STAT,1904,46,35-39,1950,0.11578958181922196
STAT,1892,47,30-34,1939,0.06948817418769754
STAT,1838,21,15-19,1859,3.167589334897991
SIM,1845,57,na,1902,1584
STAT,1928,26,50-100,1954,1.2551007115968877
SIM,1910,18,30-34,1928,5
STAT,1902,23,25-29,1925,82.10166116594165
STAT,1913,37,45-49,1950,0.6863245611214572
STAT,1907,45,20-24,1952,0.010240279677591668
STAT,1881,49,50-100,1930,0.23717215784968862
STAT,1867,24,45-49,1891,0.6636661436139916
STAT,1927,31,30-34,1958,19.781267942505412
STAT,1930,34,40-44,1964,5.144221719903586
STAT,1933,35,20-24,1968,0.3668052655967771
STAT,1805,72,na,1877,677.4448038443737
STAT,1809,86,na,1895,113.19926295354261
STAT,1861,48,40-44,1909,0.14250282514870052
SIM,1837,23,15-19,1860,1
STAT,1822,64,na,1886,1031.4800389686002
STAT,1812,101,na,1913,0.2602649637820366
SIM,1866,26,45-49,1892,5
SIM,1917,35,30-34,1952,4
SIM,1840,38,na,1878,1709
STAT,1792,80,na,1872,226.64212359205513
STAT,1796,94,na,1890,4.347819163162327
STAT,1803,81,na,1884,243.31683163498107
STAT,1922,35,45-49,1957,0.7928716505719248
STAT,1828,69,na,1897,808.1273299714287
SIM,1905,18,20-24,1923,26
SIM,1867,19,15-19,1886,9
STAT,1815,49,25-29,1864,0.14987999828825324
STAT,1876,22,45-49,1898,0.7345790349160569
SIM,1926,33,30-34,1959,34
SIM,1909,36,35-39,1945,7
SIM,1862,16,50-100,1878,1
STAT,1865,37,na,1902,2181.4059274051892
STAT,1904,31,35-39,1935,14.866945636432291
STAT,1837,18,na,1855,2023.2797787686102
SIM,1909,29,45-49,1938,2
SIM,1830,28,na,1858,1916
SIM,1863,86,na,1949,100
STAT,1894,18,na,1912,3305.463292782485
SIM,1838,20,25-29,1858,55
STAT,1843,26,na,1869,2164.738167255923
STAT,1852,44,50-100,1896,0.8395913979131445
SIM,1920,30,30-34,1950,5
STAT,1927,26,35-39,1953,18.68249953644746
STAT,1921,45,na,1966,4246.05322156432
SIM,1922,40,35-39,1962,1
STAT,1938,6,na,1944,4033.16478003195
SIM,1939,19,30-34,1958,24
STAT,1898,19,50-100,1917,0.06722441048012881
STAT,1913,26,na,1939,3821.0205604523417
SIM,1926,26,40-44,1952,9
STAT,1851,45,na,1896,1874.6628387343019
STAT,1903,17,35-39,1920,0.7957186054760526
STAT,1944,23,30-34,1967,31.650422248175722
STAT,1869,5,na,1874,2759.2268472187325
SIM,1899,32,35-39,1931,19
STAT,1904,39,45-49,1943,0.6227611641635847
SIM,1855,67,na,1922,1257
SIM,1911,17,35-39,1928,2
STAT,1863,51,50-100,1914,0.01357331420915435
STAT,1823,81,na,1904,300.96403379896094
STAT,1938,21,50-100,1959,0.6645230543678166
STAT,1934,29,30-34,1963,53.700661238297826
SIM,1942,29,30-34,1971,43
STAT,1883,30,50-100,1913,0.9245021525217336
SIM,1804,75,na,1879,581
SIM,1808,89,na,1897,40
SIM,1900,28,na,1928,3364
SIM,1793,86,na,1879,46
STAT,1902,18,30-34,1920,2.2870054119727277
SIM,1887,22,15-19,1909,3
SIM,1912,29,na,1941,3762
STAT,1930,41,30-34,1971,0.1718095654797528
STAT,1879,22,15-19,1901,3.5179307726817917
STAT,1841,39,25-29,1880,2.4532049400630016
STAT,1842,49,50-100,1891,0.18857929629630657
STAT,1913,44,35-39,1957,0.1996621430836574
STAT,1835,20,35-39,1855,7.851095356625356
STAT,1924,39,15-19,1963,0.023053582497468725
STAT,1945,22,35-39,1967,10.528823978298332
STAT,1914,40,35-39,1954,0.2050026238333126
STAT,1942,28,25-29,1970,70.44658388198677
STAT,1818,59,na,1877,1152.0554951585957
SIM,1935,26,35-39,1961,30
STAT,1853,49,45-49,1902,0.19375398778312325
STAT,1835,52,50-100,1887,0.011472420809102074
STAT,1930,21,35-39,1951,12.339764485416563
STAT,1939,32,50-100,1971,0.8605738360258021
STAT,1788,75,na,1863,445.6646942293667
STAT,1904,44,40-44,1948,0.22528387337529143
SIM,1953,11,na,1964,4772
STAT,1846,16,25-29,1862,5.120795382774695
STAT,1910,24,15-19,1934,5.066611006427651
STAT,1814,45,na,1859,1468.196210348063
STAT,1910,42,15-19,1952,0.0014802505586747508
STAT,1817,108,na,1925,8.939407073930006E-4
STAT,1849,33,40-44,1882,3.5111765473444922
STAT,1929,29,20-24,1958,23.277795781256064
SIM,1909,34,40-44,1943,9
STAT,1881,75,na,1956,1051.4556436522917
SIM,1837,21,20-24,1858,55
SIM,1854,16,25-29,1870,8
STAT,1952,18,40-44,1970,1.7093343389581195
STAT,1833,24,50-100,1857,0.3700645574565708
SIM,1907,30,na,1937,3703
STAT,1939,25,15-19,1964,0.7246121222082321
STAT,1820,47,40-44,1867,0.3122627025462506
STAT,1907,47,15-19,1954,3.363972636922024E-4
STAT,1884,41,50-100,1925,1.0710830891899177
STAT,1918,26,40-44,1944,5.07932778915728
STAT,1918,42,50-100,1960,0.12746445034514356
STAT,1852,94,na,1946,16.1008169631645
STAT,1930,36,35-39,1966,3.2206903028937504
STAT,1864,49,20-24,1913,0.010657717908911237
STAT,1902,31,50-100,1933,1.3235393481920936
STAT,1877,38,na,1915,2480.4619550796288
STAT,1899,27,45-49,1926,1.5510598178486208
SIM,1906,16,15-19,1922,8
STAT,1859,30,45-49,1889,1.4414137900458828
STAT,1899,32,40-44,1931,6.058261540716337
SIM,1923,16,15-19,1939,50
SIM,1927,32,35-39,1959,12
STAT,1860,38,na,1898,1940.403513039478
STAT,1892,47,na,1939,2863.682327626857
SIM,1935,19,45-49,1954,4
STAT,1920,32,30-34,1952,17.61101966023359
STAT,1935,34,50-100,1969,1.1650083952106685
STAT,1912,38,40-44,1950,1.4830942087791774
SIM,1864,5,na,1869,2637
STAT,1929,37,50-100,1966,0.5497725089628587
SIM,1858,32,45-49,1890,2
SIM,1934,27,30-34,1961,63
STAT,1895,16,20-24,1911,23.65482367703392
SIM,1776,94,na,1870,5
STAT,1925,43,15-19,1968,0.0018938867578203466
STAT,1852,19,na,1871,2210.2829341414886
STAT,1908,39,30-34,1947,1.7225516026299268
STAT,1825,92,na,1917,24.975605105256708
STAT,1810,45,30-34,1855,0.3152434037570411
SIM,1860,58,na,1918,1849
STAT,1834,22,40-44,1856,1.875468250888238
SIM,1886,16,20-24,1902,24
STAT,1915,16,15-19,1931,9.716492198704541
STAT,1877,28,50-100,1905,0.6744670272785551
SIM,1869,71,na,1940,1125
STAT,1823,35,50-100,1858,2.4435893320784987
STAT,1869,29,25-29,1898,41.365252642485395
STAT,1943,27,30-34,1970,42.57492533622736
SIM,1836,76,na,1912,652
STAT,1917,41,15-19,1958,0.001637818543035763
SIM,1887,20,20-24,1907,86
STAT,1903,22,30-34,1925,25.83074342719502
STAT,1888,34,50-100,1922,1.095549986660143
STAT,1874,18,na,1892,2623.682895571313
STAT,1927,19,45-49,1946,0.6301912846800691
STAT,1912,30,30-34,1942,15.942072448653068
STAT,1926,27,30-34,1953,47.917600440929085
STAT,1776,102,na,1878,0.0801893342857523
STAT,1929,41,na,1970,4912.645587651166
STAT,1935,28,35-39,1963,20.860676018146744
STAT,1947,17,20-24,1964,155.8169036270538
STAT,1874,46,50-100,1920,0.2565338760534603
SIM,1907,50,na,1957,3396
STAT,1938,29,15-19,1967,0.7127376086353397
STAT,1880,43,50-100,1923,1.124366435858789
STAT,1875,67,na,1942,1659.7399605009168
SIM,1920,48,na,1968,3936
STAT,1918,28,35-39,1946,16.247535390482977
STAT,1884,28,na,1912,2400.197871422916
STAT,1928,40,35-39,1968,0.2625710733633035
STAT,1868,65,na,1933,1646.644297223929
STAT,1887,17,25-29,1904,6.477826487976701
SIM,1824,95,na,1919,2
STAT,1908,44,25-29,1952,0.06654261868147444
SIM,1902,24,30-34,1926,27
SIM,1910,18,na,1928,3821
STAT,1859,19,15-19,1878,5.546464808519783
STAT,1919,32,35-39,1951,10.06106673733081
SIM,1919,31,na,1950,4199
SIM,1943,28,35-39,1971,20
SIM,1935,31,30-34,1966,35
STAT,1908,43,15-19,1951,0.0014401257479679864
STAT,1883,86,na,1969,500.19547412158516
STAT,1841,38,50-100,1879,1.057010739993734
STAT,1849,18,45-49,1867,0.06205699548724982
SIM,1957,2,na,1959,5614
STAT,1834,41,50-100,1875,0.8681278507723886
SIM,1795,77,na,1872,378
SIM,1877,16,20-24,1893,21
SIM,1888,30,na,1918,2835
SIM,1882,89,na,1971,278
STAT,1934,34,25-29,1968,12.852599312451543
SIM,1948,9,na,1957,4541
STAT,1917,34,25-29,1951,9.792260715815313
SIM,1901,25,25-29,1926,9
STAT,1883,22,na,1905,2367.3319111270976
STAT,1895,67,na,1962,2290.4903527776146
SIM,1828,26,25-29,1854,45
SIM,1929,27,20-24,1956,34
STAT,1903,15,40-44,1918,0.2664718921500163
SIM,1866,31,40-44,1897,8
SIM,1878,22,20-24,1900,3
SIM,1925,29,30-34,1954,78
SIM,1901,45,na,1946,3435
STAT,1828,39,50-100,1867,1.031768297631828
STAT,1944,26,35-39,1970,16.562909930774982
SIM,1870,88,na,1958,130
STAT,1927,24,40-44,1951,4.19931998559569
STAT,1839,45,50-100,1884,0.17718044447912623
SIM,1823,58,na,1881,1225
SIM,1878,24,15-19,1902,4
STAT,1858,26,45-49,1884,0.9261780436662623
SIM,1862,15,20-24,1877,38
STAT,1823,48,20-24,1871,0.017786350989748474
STAT,1907,36,50-100,1943,0.39884675962182825
SIM,1919,1,na,1920,4647
STAT,1933,37,15-19,1970,0.02667470950292811
STAT,1947,19,15-19,1966,52.124107594921114
SIM,1845,15,20-24,1860,23
STAT,1868,20,45-49,1888,0.6893103337351856
SIM,1882,69,na,1951,1274
SIM,1842,22,40-44,1864,2
STAT,1944,24,40-44,1968,3.7013978177585303
SIM,1925,34,25-29,1959,1
STAT,1869,16,20-24,1885,17.80765843753202
STAT,1861,55,na,1916,1743.01686773341
SIM,1926,28,35-39,1954,26
STAT,1950,22,15-19,1972,6.4425020628025935
SIM,1877,20,50-100,1897,4
STAT,1930,37,45-49,1967,0.9069181332521953
SIM,1935,24,40-44,1959,9
STAT,1890,39,20-24,1929,0.9518310781751704
STAT,1909,38,35-39,1947,2.323333900456002
SIM,1920,8,na,1928,4414
STAT,1944,19,45-49,1963,0.5481060835963436
SIM,1879,21,25-29,1900,124
SIM,1909,33,30-34,1942,14
SIM,1870,29,50-100,1899,1
SIM,1900,26,20-24,1926,19
SIM,1877,90,na,1967,195
STAT,1845,92,na,1937,32.54264218728716
SIM,1902,19,35-39,1921,1
SIM,1930,32,40-44,1962,10
STAT,1840,48,20-24,1888,0.008597034161248946
SIM,1828,89,na,1917,78
SIM,1876,20,45-49,1896,1
SIM,1899,33,45-49,1932,2
STAT,1927,15,50-100,1942,0.4773996303224199
STAT,1910,25,25-29,1935,65.81892577167848
STAT,1953,16,35-39,1969,5.179348840575652
STAT,1837,73,na,1910,791.9062354327523
STAT,1858,31,40-44,1889,3.5450573522810678
SIM,1811,77,na,1888,290
SIM,1851,7,na,1858,2398
SIM,1916,39,30-34,1955,2
STAT,1911,15,na,1926,3960.67948996606
STAT,1938,27,20-24,1965,18.447616642875367
SIM,1884,21,35-39,1905,10
STAT,1851,110,na,1961,6.690473253900123E-4
SIM,1906,24,15-19,1930,5
STAT,1922,32,40-44,1954,4.511599118257354
SIM,1951,19,30-34,1970,24
STAT,1925,33,20-24,1958,2.953307357869116
SIM,1831,77,na,1908,597
SIM,1860,20,35-39,1880,8
SIM,1863,21,15-19,1884,3
SIM,1861,43,na,1904,2434
SIM,1869,17,25-29,1886,9
STAT,1878,39,50-100,1917,1.2905713555480087
STAT,1863,50,50-100,1913,0.01370280572323896
STAT,1870,54,50-100,1924,0.014647229903323261
STAT,1896,49,50-100,1945,0.18276346620537454
STAT,1835,21,45-49,1856,0.6959095952900741
STAT,1838,35,na,1873,1938.7532821224806
STAT,1882,37,20-24,1919,0.766128846151221
SIM,1904,37,45-49,1941,2
STAT,1798,108,na,1906,6.305310252803929E-4
STAT,1898,30,50-100,1928,1.2741690550007156
STAT,1904,33,na,1937,3503.7731266250744
STAT,1922,34,35-39,1956,10.483961951171695
STAT,1874,73,na,1947,1237.1178601638787
STAT,1878,24,20-24,1902,72.7174141014167
STAT,1915,49,15-19,1964,3.765618136107985E-4
STAT,1940,23,45-49,1963,1.1689390082272761
SIM,1920,20,30-34,1940,64
STAT,1862,29,50-100,1891,0.5515385649709463
STAT,1879,19,40-44,1898,0.1939936336631042
SIM,1784,81,na,1865,236
SIM,1886,24,20-24,1910,87
SIM,1842,60,na,1902,1434
SIM,1846,74,na,1920,784
SIM,1920,46,40-44,1966,1
STAT,1912,46,40-44,1958,0.15495465458790691
STAT,1859,22,45-49,1881,0.5894420162731066
STAT,1863,66,na,1929,1466.015447450402
SIM,1935,26,na,1961,5194
STAT,1804,55,na,1859,1102.0517351921014
STAT,1904,21,35-39,1925,8.557614427547115
STAT,1808,69,na,1877,635.1375157975092
STAT,1901,34,15-19,1935,0.20141648240665222
SIM,1829,51,na,1880,1215
STAT,1830,36,45-49,1866,1.8264174071274926
STAT,1855,21,15-19,1876,3.009281798745584
SIM,1875,21,40-44,1896,2
STAT,1911,17,40-44,1928,0.2855038185795552
SIM,1837,24,25-29,1861,3
STAT,1934,23,50-100,1957,0.9014799016562592
SIM,1903,23,35-39,1926,10
SIM,1910,20,20-24,1930,105
STAT,1815,46,20-24,1861,0.03282465966463084
STAT,1841,54,20-24,1895,5.298618751054618E-4
STAT,1857,18,na,1875,2136.835918632225
SIM,1869,16,na,1885,2574
STAT,1849,36,45-49,1885,1.600200052648789
STAT,1814,101,na,1915,0.2659032904824119
SIM,1799,59,na,1858,1211
SIM,1921,36,35-39,1957,5
STAT,1880,58,na,1938,2120.043061893915
STAT,1924,47,15-19,1971,4.4743219561853775E-4
SIM,1825,92,na,1917,17
STAT,1896,15,25-29,1911,7.670559830148766
SIM,1900,34,20-24,1934,4
SIM,1910,22,15-19,1932,8
SIM,1942,26,25-29,1968,96
STAT,1917,3,na,1920,4439.624074186843
STAT,1847,20,25-29,1867,55.51975924864746
STAT,1910,32,15-19,1942,0.12637349436200634
STAT,1826,30,35-39,1856,13.070520285409884
STAT,1921,46,35-39,1967,0.14868368643485558
SIM,1834,23,45-49,1857,3
SIM,1851,20,40-44,1871,2
STAT,1912,20,30-34,1932,28.26640177237477
STAT,1774,83,na,1857,89.58088028033305
STAT,1852,39,na,1891,1878.876752531241
STAT,1815,62,na,1877,1152.2069457625266
STAT,1859,25,50-100,1884,0.5378587408599662
SIM,1908,38,40-44,1946,4
STAT,1854,18,25-29,1872,5.157596413608487
STAT,1893,32,na,1925,3088.2360086420817
STAT,1917,29,30-34,1946,41.6338004979972
STAT,1853,56,na,1909,1710.230443211291
STAT,1887,24,50-100,1911,0.4632405964019404
STAT,1923,16,na,1939,4420.682918566845
STAT,1924,32,15-19,1956,0.15295956547890807
SIM,1906,13,na,1919,3831
STAT,1901,19,25-29,1920,8.040683743360988
SIM,1930,34,35-39,1964,13
STAT,1938,19,20-24,1957,136.3330021509971
SIM,1865,57,na,1922,1870
STAT,1840,93,na,1933,21.03053333002007
STAT,1948,19,30-34,1967,14.222044883382308
STAT,1902,40,15-19,1942,0.0013935574631215996
STAT,1897,46,na,1943,3078.1504162812193
STAT,1930,33,30-34,1963,20.724636942329806
STAT,1824,39,25-29,1863,3.716702246254084
STAT,1871,37,45-49,1908,2.0144674166959042
STAT,1896,22,15-19,1918,4.444951396557411
SIM,1908,45,30-34,1953,1
STAT,1798,65,na,1863,986.7502564846664
STAT,1913,36,35-39,1949,2.4468103120082483
STAT,1768,99,na,1867,0.46622215164023684
STAT,1850,47,25-29,1897,0.043125005191462604
SIM,1855,20,25-29,1875,63
STAT,1830,54,45-49,1884,0.010179685419504531
SIM,1847,60,na,1907,1314
SIM,1878,25,25-29,1903,51
STAT,1921,39,45-49,1960,0.7750969283834118
SIM,1867,68,na,1935,1234
SIM,1926,29,45-49,1955,4
STAT,1810,63,na,1873,883.382578203099
STAT,1914,33,45-49,1947,1.6092802176659609
STAT,1768,111,na,1879,0.001670705845512383
STAT,1846,23,15-19,1869,2.890031198333268
SIM,1912,47,45-49,1959,1
SIM,1946,19,20-24,1965,213
STAT,1887,48,na,1935,2539.5524947092554
STAT,1916,37,15-19,1953,0.020068093929488155
SIM,1925,31,50-100,1956,1
SIM,1844,95,na,1939,2
STAT,1904,47,45-49,1951,0.1937281445609434
SIM,1899,46,na,1945,3170
STAT,1831,54,50-100,1885,0.010443403780152622
SIM,1926,36,35-39,1962,5
STAT,1772,105,na,1877,0.011175864877924754
STAT,1764,115,na,1879,3.069960384440056E-4
SIM,1936,22,35-39,1958,18
STAT,1817,73,na,1890,579.6619375118602
STAT,1860,15,45-49,1875,0.06309927952174846
STAT,1908,46,50-100,1954,0.21015564926048702
STAT,1876,84,na,1960,496.7618847144405
STAT,1934,33,15-19,1967,0.17881544982755512
STAT,1918,29,45-49,1947,1.8628000932430062
SIM,1849,26,45-49,1875,2
STAT,1843,20,40-44,1863,2.142159564390079
STAT,1917,31,50-100,1948,0.8871353832924181
SIM,1854,23,15-19,1877,2
SIM,1901,24,15-19,1925,3
STAT,1784,93,na,1877,5.808893029546914
SIM,1884,16,na,1900,2801
STAT,1928,22,35-39,1950,11.991582118248228
SIM,1867,22,45-49,1889,1
SIM,1832,39,25-29,1871,8
STAT,1943,19,30-34,1962,13.178253684920998
SIM,1883,86,na,1969,471
STAT,1921,31,35-39,1952,10.419843809194575
STAT,1852,20,35-39,1872,5.665721616100061
SIM,1912,21,35-39,1933,12
STAT,1891,48,25-29,1939,0.0405206916126151
STAT,1916,46,25-29,1962,0.05565998038042051
SIM,1902,21,25-29,1923,99
SIM,1925,16,na,1941,4532
SIM,1833,56,na,1889,1372
STAT,1867,32,45-49,1899,1.6701138090114924
SIM,1835,27,na,1862,1887
SIM,1840,49,25-29,1889,1
SIM,1857,36,45-49,1893,4
SIM,1918,26,35-39,1944,17
SIM,1846,43,na,1889,1863
SIM,1901,28,30-34,1929,1
SIM,1933,33,20-24,1966,4
SIM,1838,46,50-100,1884,2
SIM,1942,23,50-100,1965,1
SIM,1788,95,na,1883,2
STAT,1832,49,25-29,1881,0.04055866794535091
STAT,1907,35,50-100,1942,0.4007060356271381
STAT,1918,36,35-39,1954,2.614142316816015
STAT,1908,36,25-29,1944,0.9445593212963795
STAT,1841,36,20-24,1877,0.6775798082690383
STAT,1831,88,na,1919,92.5045920145471
SIM,1884,22,45-49,1906,1
SIM,1922,33,45-49,1955,1
STAT,1828,80,na,1908,340.6404017311262
STAT,1834,21,na,1855,1935.339191376603
SIM,1888,74,na,1962,1488
STAT,1829,31,15-19,1860,0.1358344412260898
STAT,1851,33,50-100,1884,0.7786482886966558
STAT,1901,27,25-29,1928,60.346325948273666
STAT,1932,39,20-24,1971,0.3604376234412504
STAT,1872,24,50-100,1896,0.4143269077080488
STAT,1871,54,35-39,1925,0.008460431267886568
STAT,1818,90,na,1908,40.178477504699956
STAT,1918,25,30-34,1943,42.84150871427908
STAT,1877,18,20-24,1895,18.709163468940975
SIM,1817,62,na,1879,928
SIM,1921,28,50-100,1949,2
SIM,1896,20,15-19,1916,6
STAT,1895,19,25-29,1914,7.502028830857531
SIM,1810,83,na,1893,421
SIM,1893,1,na,1894,3477
STAT,1913,28,50-100,1941,1.0082092184757434
STAT,1855,27,50-100,1882,0.5168809949061876
SIM,1847,48,na,1895,1496
SIM,1876,29,na,1905,2749
STAT,1828,28,25-29,1856,53.43028801893546
STAT,1926,28,40-44,1954,5.680070762154998
SIM,1836,28,25-29,1864,42
SIM,1934,28,40-44,1962,10
STAT,1850,29,25-29,1879,36.90921547995249
SIM,1904,45,45-49,1949,2
STAT,1886,74,na,1960,1360.944508703333
STAT,1922,42,35-39,1964,0.23583372624362683
STAT,1833,36,na,1869,1776.4110138921062
STAT,1879,15,25-29,1894,6.070819692443995
STAT,1882,60,na,1942,1895.501681781952
STAT,1924,28,50-100,1952,1.1782288606513769
SIM,1917,43,50-100,1960,1
STAT,1901,26,15-19,1927,0.649463759596147
SIM,1870,24,na,1894,2589
STAT,1849,15,40-44,1864,0.17686648900959903
STAT,1888,20,15-19,1908,4.0024287526214115
SIM,1876,40,50-100,1916,3
SIM,1903,15,35-39,1918,1
STAT,1869,51,na,1920,2130.819629330579
STAT,1828,89,na,1917,57.849480220937025
STAT,1870,0,na,1870,3722.773678708916
SIM,1896,35,50-100,1931,2
STAT,1875,23,40-44,1898,2.1750283868369857
STAT,1927,30,na,1957,4751.144951526399
SIM,1871,41,na,1912,2131
STAT,1904,36,40-44,1940,1.3880752354376256
SIM,1918,34,35-39,1952,14
STAT,1944,16,40-44,1960,1.5361562955663242
STAT,1948,15,15-19,1963,53.017394716032875
STAT,1924,37,20-24,1961,0.3171379194895236
SIM,1905,28,15-19,1933,1
SIM,1952,16,40-44,1968,1
SIM,1849,41,35-39,1890,5
SIM,1914,16,20-24,1930,39
STAT,1856,47,20-24,1903,0.00956484171838105
STAT,1898,1,na,1899,3754.957500265456
STAT,1826,34,na,1860,1689.6897993922
STAT,1869,19,25-29,1888,5.592033764226278
STAT,1936,17,45-49,1953,0.4877958245079205
SIM,1944,17,45-49,1961,1
STAT,1909,32,25-29,1941,8.995213742591686
SIM,1862,18,25-29,1880,5
SIM,1932,28,50-100,1960,1
SIM,1845,23,20-24,1868,56
STAT,1920,44,25-29,1964,0.08021580576309152
SIM,1925,31,20-24,1956,4
STAT,1967,2,na,1969,5013.524255650831
SIM,1824,75,na,1899,567
STAT,1869,26,20-24,1895,11.594056970674817
STAT,1820,39,40-44,1859,9.497145099903845
STAT,1940,30,35-39,1970,9.659513070167678
STAT,1837,22,50-100,1859,0.35592515480972853
STAT,1837,23,20-24,1860,59.71592443645062
SIM,1876,73,na,1949,1247
SIM,1898,37,45-49,1935,1
STAT,1906,16,20-24,1922,26.388786909569074
STAT,1867,31,35-39,1898,9.738648540026487
STAT,1896,0,na,1896,3956.2831042897683
SIM,1922,32,35-39,1954,10
STAT,1846,47,50-100,1893,0.1748150909378286
STAT,1902,30,15-19,1932,0.20652096698545014
SIM,1969,0,na,1969,5106
STAT,1843,108,na,1951,0.0014787010268593975
STAT,1923,18,15-19,1941,54.23048477184535
SIM,1899,30,40-44,1929,6
STAT,1869,82,na,1951,459.54096981812444
SIM,1941,10,na,1951,3976
SIM,1945,24,na,1969,4342
STAT,1934,26,25-29,1960,90.33824153877828
SIM,1911,25,35-39,1936,24
SIM,1907,3,na,1910,4017
STAT,1916,45,15-19,1961,3.873834369542076E-4
SIM,1894,48,45-49,1942,1
STAT,1780,79,na,1859,245.9108745725496
STAT,1845,47,45-49,1892,0.18353820624418601
SIM,1869,27,25-29,1896,56
SIM,1889,40,25-29,1929,1
STAT,1940,28,na,1968,3895.229460429162
SIM,1931,18,15-19,1949,54
STAT,1939,31,na,1970,3938.8610378350186
STAT,1779,82,na,1861,128.85070589729048
STAT,1869,19,na,1888,2492.315431550564
STAT,1791,95,na,1886,2.3791684946995897
STAT,1846,54,na,1900,1497.4342262397984
STAT,1886,48,45-49,1934,0.25163363698874963
SIM,1912,36,40-44,1948,1
STAT,1863,21,20-24,1884,63.32194718847002
STAT,1910,22,20-24,1932,106.50189985943422
STAT,1903,25,35-39,1928,14.08746494136912
SIM,1849,34,45-49,1883,3
STAT,1914,32,35-39,1946,9.385333593681045
SIM,1825,30,40-44,1855,8
STAT,1862,92,na,1954,36.16835232030287
SIM,1852,39,na,1891,1958
STAT,1858,55,na,1913,1672.7961339014091
SIM,1926,25,30-34,1951,74
STAT,1830,53,35-39,1883,0.00615964502923719
STAT,1888,35,50-100,1923,1.4947447972522847
SIM,1918,14,na,1932,4545
STAT,1834,25,45-49,1859,0.9939910238206326
STAT,1884,21,40-44,1905,2.109501629957471
SIM,1782,79,na,1861,251
SIM,1839,41,na,1880,1801
SIM,1837,93,na,1930,20
STAT,1803,61,na,1864,1085.0295273277914
STAT,1933,0,na,1933,6150.306868682783
STAT,1903,18,45-49,1921,0.0944801994866966
SIM,1841,75,na,1916,679
STAT,1926,35,30-34,1961,2.276257693918272
SIM,1892,21,40-44,1913,6
SIM,1853,56,na,1909,1698
STAT,1906,49,20-24,1955,0.009841064702718163
SIM,1827,60,na,1887,1074
STAT,1904,43,30-34,1947,0.11588130266129279
SIM,1840,58,na,1898,1339
SIM,1842,25,45-49,1867,4
SIM,1906,33,na,1939,3567
STAT,1903,43,35-39,1946,0.1810360298074549
SIM,1872,91,na,1963,90
STAT,1908,33,20-24,1941,2.337869592195779
SIM,1902,51,na,1953,3146
STAT,1808,60,na,1868,888.3988511323527
STAT,1852,21,45-49,1873,0.6721748515714246
SIM,1897,15,35-39,1912,2
STAT,1838,18,40-44,1856,0.1764664906217869
STAT,1824,54,20-24,1878,7.973909917990131E-4
SIM,1920,23,35-39,1943,18
STAT,1841,78,na,1919,576.8990861972148
SIM,1828,34,na,1862,1836
SIM,1821,36,45-49,1857,3
SIM,1923,24,15-19,1947,5
STAT,1905,32,40-44,1937,3.6688382945096945
STAT,1837,31,20-24,1868,2.2832110198193716
SIM,1879,24,30-34,1903,37
SIM,1934,24,25-29,1958,166
STAT,1837,33,15-19,1870,0.11781613506495664
STAT,1870,68,na,1938,1524.0144077461202
SIM,1807,63,na,1870,920
STAT,1834,30,40-44,1864,3.816729308775493
STAT,1909,39,45-49,1948,0.6514670759576929
STAT,1878,27,25-29,1905,44.91823875896923
STAT,1877,90,na,1967,234.99178101968522
SIM,1887,68,na,1955,1749
SIM,1904,40,50-100,1944,1
STAT,1935,17,30-34,1952,16.99277712586295
SIM,1858,40,45-49,1898,6
STAT,1926,24,25-29,1950,113.76320078570876
SIM,1914,7,na,1921,4175
SIM,1858,55,na,1913,1690
SIM,1913,32,40-44,1945,7
STAT,1935,36,35-39,1971,3.4522917814121827
SIM,1904,36,35-39,1940,1
STAT,1821,53,40-44,1874,0.015616651020821265
STAT,1943,21,20-24,1964,120.73908874706756
SIM,1930,31,30-34,1961,26
STAT,1871,47,45-49,1918,0.23737198900186504
SIM,1917,39,45-49,1956,3
STAT,1931,18,20-24,1949,180.50463215503723
STAT,1847,49,20-24,1896,0.009162373702857524
SIM,1900,18,20-24,1918,24
SIM,1850,49,50-100,1899,1
STAT,1844,48,40-44,1892,0.13099789091636505
SIM,1871,21,20-24,1892,66
STAT,1950,19,20-24,1969,163.43323650573407
SIM,1891,50,na,1941,2789
STAT,1917,45,30-34,1962,0.09546862740352277
STAT,1915,24,15-19,1939,5.579867841734332
SIM,1895,64,na,1959,2412
STAT,1912,23,35-39,1935,9.176983101565614
STAT,1836,49,45-49,1885,0.14985028430908995
STAT,1918,18,40-44,1936,1.54952376863099
SIM,1847,17,na,1864,2032
STAT,1836,108,na,1944,0.001140128114138955
STAT,1922,31,30-34,1953,18.238027496541747
SIM,1900,37,25-29,1937,4
SIM,1905,26,50-100,1931,4
SIM,1839,20,40-44,1859,3
STAT,1864,20,25-29,1884,53.52739649144768
STAT,1929,37,20-24,1966,0.34517941331045143
STAT,1945,27,na,1972,4193.172619789164
STAT,1910,16,15-19,1926,9.194170749874232
SIM,1852,30,50-100,1882,3
SIM,1877,19,25-29,1896,7
STAT,1891,45,20-24,1936,0.008634464730042347
SIM,1845,26,na,1871,2113
SIM,1809,75,na,1884,273
STAT,1912,41,35-39,1953,0.19926194735429467
STAT,1854,16,50-100,1870,0.04512011132325813
STAT,1923,23,45-49,1946,1.3316422642846018
SIM,1805,61,na,1866,924
SIM,1916,33,20-24,1949,3
SIM,1923,36,na,1959,4269
SIM,1931,23,45-49,1954,2
STAT,1805,49,15-19,1854,0.0014276313349670944
STAT,1920,40,30-34,1960,0.14449155927975402
SIM,1918,1,na,1919,4688
STAT,1891,45,50-100,1936,0.17671870447811078
STAT,1783,99,na,1882,0.3758420871030883
STAT,1912,49,45-49,1961,0.21182704785768472
SIM,1916,32,50-100,1948,1
SIM,1815,82,na,1897,150
STAT,1944,27,45-49,1971,1.9050379826973893
STAT,1826,31,45-49,1857,2.0509333420925056
STAT,1903,44,25-29,1947,0.0637938802164631
SIM,1939,15,15-19,1954,65
SIM,1845,26,25-29,1871,42
SIM,1866,83,na,1949,442
STAT,1839,21,30-34,1860,15.909347157636262
SIM,1929,19,20-24,1948,181
STAT,1860,20,40-44,1880,1.982231473779251
STAT,1940,16,20-24,1956,140.47079189497
STAT,1863,23,15-19,1886,2.9880152348954216
STAT,1891,27,20-24,1918,14.816798798625037
STAT,1911,42,30-34,1953,0.1244660797312117
SIM,1844,49,45-49,1893,2
SIM,1942,25,15-19,1967,1
STAT,1829,54,na,1883,1452.7439001681742
STAT,1869,102,na,1971,2.800570328432131
SIM,1892,41,50-100,1933,1
STAT,1850,44,20-24,1894,0.11784744499795666
STAT,1944,15,30-34,1959,13.389851790661648
SIM,1943,22,25-29,1965,101
SIM,1823,89,na,1912,43
SIM,1838,55,na,1893,1322
STAT,1813,54,45-49,1867,0.033460727561763735
STAT,1934,23,20-24,1957,152.3410724352012
STAT,1924,42,na,1966,4507.055289906928
STAT,1931,22,40-44,1953,4.4475039902150515
SIM,1832,36,20-24,1868,1
STAT,1915,42,15-19,1957,0.0015776969571698934
STAT,1847,16,40-44,1863,0.17907124882490713
SIM,1796,62,na,1858,760
SIM,1888,15,40-44,1903,1
STAT,1819,35,20-24,1854,2.564947058297021
STAT,1824,36,20-24,1860,1.1068046557191202
STAT,1858,35,na,1893,1924.1051467377424
STAT,1876,18,50-100,1894,0.051474267763921285
SIM,1841,23,na,1864,1882
SIM,1861,41,50-100,1902,3
SIM,1932,29,20-24,1961,35
STAT,1923,30,35-39,1953,10.774892044392315
STAT,1860,48,25-29,1908,0.04707728585502015
STAT,1924,29,20-24,1953,21.529130936040552
STAT,1854,21,na,1875,1936.6481318398849
STAT,1921,47,50-100,1968,0.2601867987756569
STAT,1880,45,45-49,1925,0.2555212799540651
SIM,1816,45,50-100,1861,1
STAT,1886,26,20-24,1912,12.71123549394902
SIM,1952,15,30-34,1967,25
STAT,1831,39,15-19,1870,0.048224566900719974
SIM,1845,37,na,1882,1944
STAT,1870,17,50-100,1887,0.04932319254040131
STAT,1934,25,15-19,1959,0.9693270446360011
SIM,1905,33,45-49,1938,4
STAT,1927,18,35-39,1945,5.308205336768193
SIM,1870,36,40-44,1906,8
SIM,1942,23,20-24,1965,116
SIM,1832,31,50-100,1863,1
SIM,1904,65,na,1969,2762
STAT,1889,15,35-39,1904,0.6946649194935026
STAT,1837,26,25-29,1863,36.46164082055977
STAT,1872,50,35-39,1922,0.008928648091227114
STAT,1844,11,na,1855,2362.2615299999998
STAT,1935,22,25-29,1957,128.27475244825638
STAT,1848,25,na,1873,2036.631868854574
STAT,1959,9,na,1968,5241.980082349739
SIM,1837,70,na,1907,863
SIM,1848,8,na,1856,2381
SIM,1871,23,15-19,1894,2
STAT,1871,18,25-29,1889,5.729405527224628
SIM,1879,49,na,1928,2719
STAT,1902,27,40-44,1929,4.30955452976367
STAT,1933,29,15-19,1962,0.9549933383317575
SIM,1917,28,na,1945,3887
SIM,1877,29,25-29,1906,67
STAT,1862,54,40-44,1916,0.008890806387639984
SIM,1894,26,20-24,1920,3
SIM,1904,34,40-44,1938,4
STAT,1923,19,25-29,1942,51.640695558160076
STAT,1909,27,30-34,1936,38.19050852743627
STAT,1847,105,na,1952,0.022864640834927993
SIM,1809,74,na,1883,314
SIM,1827,35,20-24,1862,1
SIM,1917,27,30-34,1944,49
SIM,1820,37,40-44,1857,4
SIM,1834,41,na,1875,1702
STAT,1838,30,25-29,1868,9.547788576080144
SIM,1878,30,20-24,1908,5
SIM,1847,21,30-34,1868,25
SIM,1926,42,50-100,1968,1
SIM,1931,30,35-39,1961,13
SIM,1902,32,30-34,1934,7
SIM,1794,71,na,1865,627
STAT,1860,69,na,1929,1214.706581805417
SIM,1941,29,15-19,1970,1
SIM,1845,31,20-24,1876,6
SIM,1837,18,na,1855,1898
SIM,1931,19,25-29,1950,79
STAT,1880,27,45-49,1907,1.1902778260122666
SIM,1909,44,35-39,1953,1
SIM,1930,26,35-39,1956,34
SIM,1913,28,20-24,1941,22
STAT,1942,27,15-19,1969,0.7559354367555065
SIM,1904,29,45-49,1933,2
SIM,1886,32,20-24,1918,3
SIM,1853,25,20-24,1878,12
STAT,1827,63,na,1890,1153.230326492704
STAT,1888,21,25-29,1909,69.24779996154177
STAT,1936,16,35-39,1952,4.1075491805253685
SIM,1837,36,50-100,1873,1
STAT,1868,15,15-19,1883,5.9570962310032165
STAT,1899,26,na,1925,3345.341719284287
SIM,1925,27,na,1952,4622
SIM,1885,47,40-44,1932,1
STAT,1919,16,35-39,1935,0.9517101458775815
SIM,1927,16,35-39,1943,8
STAT,1878,32,20-24,1910,2.8702732804248803
STAT,1762,115,na,1877,1.7808062266211897E-4
STAT,1911,24,30-34,1935,27.630149772858285
SIM,1860,46,25-29,1906,1
STAT,1900,36,20-24,1936,0.23638660710286433
STAT,1799,91,na,1890,18.80342289344599
SIM,1846,30,25-29,1876,5
STAT,1942,25,20-24,1967,19.563346836516235
STAT,1888,17,40-44,1905,0.2205847832825141
SIM,1910,27,40-44,1937,7
STAT,1769,101,na,1870,0.06433361685718217
STAT,1914,32,na,1946,3884.2619465032635
STAT,1926,13,na,1939,4948.182215272175
STAT,1918,46,na,1964,3999.4612139255173
STAT,1878,34,15-19,1912,0.14992252642669046
SIM,1914,30,35-39,1944,14
STAT,1867,91,na,1958,79.47783109727325
STAT,1925,27,15-19,1952,0.8506942665088488
STAT,1884,72,na,1956,1307.785714073378
SIM,1933,27,15-19,1960,1
STAT,1905,28,20-24,1933,17.223628631162494
STAT,1907,39,15-19,1946,0.017972369263491057
STAT,1850,26,20-24,1876,10.459719761204397
SIM,1913,46,na,1959,3771
SIM,1896,21,25-29,1917,90
STAT,1785,78,na,1863,307.80809607513777
SIM,1908,34,25-29,1942,14
STAT,1893,22,45-49,1915,0.9024362474422187
STAT,1909,32,na,1941,3680.811085982688
STAT,1810,94,na,1904,8.520731140673181
SIM,1935,18,35-39,1953,6
SIM,1885,28,50-100,1913,2
STAT,1887,30,20-24,1917,3.1147942105709707
SIM,1864,17,na,1881,2412
STAT,1858,24,na,1882,1969.1302749385845
SIM,1874,61,na,1935,1907
SIM,1878,75,na,1953,1060
STAT,1935,29,45-49,1964,2.399215767586551
STAT,1878,32,na,1910,2533.931186323044
STAT,1849,41,40-44,1890,1.7541503658752067
STAT,1897,48,20-24,1945,0.009117148114843794
STAT,1797,80,na,1877,266.1398962975361
STAT,1859,72,na,1931,1028.8993759570665
SIM,1855,23,30-34,1878,23
SIM,1944,16,35-39,1960,5
STAT,1877,47,40-44,1924,0.18029981276024581
SIM,1865,34,50-100,1899,5
STAT,1907,53,na,1960,3266.5687323166367
STAT,1890,2,na,1892,3324.9758985107687
SIM,1890,24,na,1914,2959
STAT,1847,23,30-34,1870,16.905830717217167
SIM,1836,39,50-100,1875,4
SIM,1829,30,25-29,1859,5
STAT,1876,53,na,1929,2231.7915694376984
STAT,1790,78,na,1868,324.37454489107824
STAT,1902,34,30-34,1936,14.29947033784487
SIM,1879,20,15-19,1899,5
STAT,1863,45,45-49,1908,0.21319508929816694
STAT,1898,31,na,1929,3305.494556186768
SIM,1874,33,50-100,1907,1
SIM,1869,24,20-24,1893,70
STAT,1920,48,40-44,1968,0.17735984733320329
SIM,1912,28,40-44,1940,9
STAT,1839,21,na,1860,1909.7056141185608
STAT,1920,15,40-44,1935,0.32278858498081275
STAT,1943,22,50-100,1965,0.7142390534348129
SIM,1878,31,50-100,1909,5
STAT,1880,52,35-39,1932,0.009180034797422703
STAT,1909,43,30-34,1952,0.12122280217057756
SIM,1943,17,30-34,1960,15
SIM,1814,42,na,1856,1399
SIM,1854,62,na,1916,1570
SIM,1881,40,na,1921,2145
STAT,1847,40,na,1887,1859.4265378337648
STAT,1818,53,50-100,1871,0.0322188223295568
SIM,1908,24,na,1932,3751
STAT,1898,52,na,1950,2954.6756744483027
SIM,1905,29,25-29,1934,6
STAT,1879,31,25-29,1910,10.966887585202478
STAT,1885,13,na,1898,2624.348967744325
SIM,1885,54,na,1939,2051
STAT,1790,103,na,1893,0.032323904787691676
SIM,1849,42,45-49,1891,7
STAT,1904,28,40-44,1932,4.3642950345076
SIM,1869,2,na,1871,3255
STAT,1920,22,30-34,1942,32.60716771462731
STAT,1896,20,20-24,1916,93.40347911402368
STAT,1936,21,30-34,1957,28.035244385058565
STAT,1947,20,50-100,1967,0.7592572928930961
STAT,1898,44,40-44,1942,0.21256971274198522
SIM,1889,16,na,1905,3336
STAT,1811,45,25-29,1856,0.16572835297719923
SIM,1858,21,40-44,1879,3
SIM,1839,22,35-39,1861,7
STAT,1821,78,na,1899,411.71487000817643
STAT,1879,72,na,1951,1346.6942983596648
STAT,1887,24,15-19,1911,3.7476159934544193
STAT,1915,21,45-49,1936,1.1904414423743068
STAT,1845,25,20-24,1870,11.319021122619837
STAT,1826,78,na,1904,455.70501997741854
SIM,1895,24,15-19,1919,3
STAT,1827,40,na,1867,1776.5426567311627
STAT,1925,8,na,1933,4915.534725493069
SIM,1906,2,na,1908,3948
SIM,1829,26,40-44,1855,3
SIM,1917,43,30-34,1960,2
STAT,1926,31,15-19,1957,0.15860856960615416
SIM,1901,14,na,1915,3815
SIM,1923,21,45-49,1944,1
STAT,1891,21,na,1912,2996.0696837422124
SIM,1838,23,30-34,1861,32
STAT,1922,31,na,1953,4378.073952891354
SIM,1903,41,35-39,1944,3
SIM,1881,51,na,1932,1997
STAT,1906,13,na,1919,3828.6840061614967
SIM,1819,36,25-29,1855,6
SIM,1877,35,na,1912,2451
STAT,1832,38,20-24,1870,0.6475833431364248
STAT,1863,52,35-39,1915,0.007659394703833067
STAT,1813,59,na,1872,1068.7809459397088
STAT,1916,35,20-24,1951,0.2780964323236053
SIM,1886,27,25-29,1913,4
SIM,1958,11,na,1969,5139
STAT,1914,43,na,1957,3748.808170130729
SIM,1840,38,20-24,1878,2
STAT,1862,108,na,1970,0.023742436909034728
STAT,1821,35,40-44,1856,10.684999205993348
STAT,1899,24,40-44,1923,2.8927943269225165
STAT,1935,33,30-34,1968,22.214956130513997
SIM,1881,39,20-24,1920,1
SIM,1941,19,20-24,1960,134
SIM,1920,17,na,1937,3954
STAT,1789,92,na,1881,9.182591057482087
SIM,1935,27,45-49,1962,1
STAT,1896,20,na,1916,3205.5692019819853
STAT,1890,48,50-100,1938,0.17063332208406912
STAT,1901,69,na,1970,2465.264984257386
STAT,1876,21,35-39,1897,6.165825309527007
STAT,1889,45,50-100,1934,0.3125767700792245
SIM,1850,32,40-44,1882,9
SIM,1902,16,30-34,1918,1
SIM,1934,21,20-24,1955,224
STAT,1836,46,40-44,1882,0.11296437584555065
STAT,1839,47,20-24,1886,0.008438020348783888
STAT,1849,104,na,1953,0.05178327976009278
SIM,1858,24,45-49,1882,3
SIM,1944,21,30-34,1965,40
SIM,1922,39,50-100,1961,2
SIM,1847,24,35-39,1871,10
STAT,1931,35,na,1966,5090.291241397743
STAT,1905,35,45-49,1940,0.6399663357839566
SIM,1820,38,na,1858,1759
SIM,1887,31,25-29,1918,19
SIM,1921,34,40-44,1955,7
SIM,1893,21,na,1914,3096
STAT,1903,40,30-34,1943,0.11694256538212217
SIM,1873,76,na,1949,822
STAT,1833,30,50-100,1863,0.7997920567620042
STAT,1842,40,na,1882,1923.8825100538388
SIM,1843,55,na,1898,1550
STAT,1900,46,15-19,1946,3.199396902255403E-4
STAT,1911,20,15-19,1931,5.180360473924866
STAT,1830,50,30-34,1880,0.004966808048630912
STAT,1876,20,na,1896,2506.2768777494352
STAT,1902,3,na,1905,3803.263077575414
STAT,1920,43,35-39,1963,0.22659649005701832
SIM,1897,35,na,1932,3253
STAT,1952,17,30-34,1969,14.900395343620202
STAT,1836,88,na,1924,85.45005415940669
STAT,1925,45,50-100,1970,0.28094057628755015
SIM,1897,45,50-100,1942,1
SIM,1902,35,35-39,1937,4
STAT,1832,74,na,1906,741.5917424762451
STAT,1855,18,40-44,1873,0.16764717334602122
STAT,1815,93,na,1908,15.111733317446935
STAT,1889,27,na,1916,3007.362056743971
STAT,1854,37,45-49,1891,1.5257242550785997
SIM,1863,4,na,1867,2526
STAT,1793,66,na,1859,829.91422746916
STAT,1842,32,40-44,1874,4.108338891447882
STAT,1873,39,20-24,1912,0.7892261719664239
SIM,1916,43,na,1959,3850
SIM,1910,34,30-34,1944,2
SIM,1862,69,na,1931,1317
STAT,1919,42,na,1961,4107.101116873312
STAT,1834,22,na,1856,1921.4434559825168
SIM,1863,55,na,1918,1743
SIM,1867,69,na,1936,1164
STAT,1909,36,40-44,1945,1.4520579748327114
STAT,1862,39,45-49,1901,1.7137207264260719
STAT,1920,28,na,1948,4178.903915609944
STAT,1922,19,45-49,1941,0.5867318464883203
SIM,1827,38,25-29,1865,2
STAT,1881,15,30-34,1896,1.5793011459448114
STAT,1855,50,35-39,1905,0.00676963213290601
STAT,1871,15,20-24,1886,18.245114564869027
STAT,1854,31,20-24,1885,2.1406878610132907
STAT,1908,9,na,1917,3924.7693421588947
STAT,1914,39,50-100,1953,0.4234006234787738
STAT,1812,74,na,1886,520.6639125736668
STAT,1943,24,25-29,1967,100.19669931809865
STAT,1839,24,35-39,1863,5.100595822446047
SIM,1894,29,25-29,1923,71
STAT,1804,53,40-44,1857,0.030254692854940222
STAT,1889,71,na,1960,1839.3581981819289
STAT,1911,19,35-39,1930,0.8519181110613426
SIM,1907,39,na,1946,3549
SIM,1869,32,50-100,1901,5
STAT,1868,4,na,1872,2905.6191389507326
STAT,1933,38,25-29,1971,1.3663035757361004
SIM,1870,39,45-49,1909,6
STAT,1768,112,na,1880,0.0010469812322072452
SIM,1859,21,20-24,1880,62
STAT,1930,18,40-44,1948,1.839497365016854
STAT,1931,32,35-39,1963,12.212056028562074
STAT,1921,32,25-29,1953,10.495829788757888
STAT,1907,29,20-24,1936,17.299945124021853
STAT,1927,15,30-34,1942,15.531404464183055
SIM,1917,36,40-44,1953,3
SIM,1920,48,50-100,1968,1
STAT,1871,44,40-44,1915,2.2422680978447436
STAT,1889,16,na,1905,3190.4430607980653
SIM,1873,21,na,1894,2344
STAT,1886,29,25-29,1915,45.35111988282089
STAT,1931,25,45-49,1956,2.2766949006767403
SIM,1824,42,40-44,1866,5
SIM,1908,31,20-24,1939,1
STAT,1819,38,25-29,1857,7.408787298543737
STAT,1815,47,50-100,1862,0.6606981961022399
SIM,1918,31,30-34,1949,27
STAT,1903,48,40-44,1951,0.138284277157813
SIM,1888,25,35-39,1913,18
STAT,1926,19,50-100,1945,0.4660925548279931
SIM,1882,80,na,1962,671
STAT,1817,74,na,1891,541.6129279335813
SIM,1901,22,20-24,1923,110
STAT,1806,48,20-24,1854,0.042140320378427715
STAT,1847,19,45-49,1866,0.06283057769988491
STAT,1883,33,40-44,1916,4.322584713085726
SIM,1911,22,30-34,1933,4
STAT,1831,89,na,1920,70.78728894729187
STAT,1925,27,na,1952,4514.222311199984
STAT,1872,39,na,1911,2384.5772054551576
STAT,1923,16,20-24,1939,162.82949259847547
SIM,1875,87,na,1962,337
STAT,1938,34,45-49,1972,1.6119445368299583
SIM,1784,82,na,1866,191
SIM,1862,31,20-24,1893,2
SIM,1878,20,na,1898,2632
SIM,1926,22,25-29,1948,139
SIM,1900,28,15-19,1928,1
STAT,1828,41,20-24,1869,0.1319819147541869
STAT,1838,99,na,1937,1.3915228751153008
STAT,1913,34,40-44,1947,3.9379645514371147
STAT,1813,60,na,1873,1047.8221515898308
SIM,1816,56,na,1872,1324
SIM,1868,39,25-29,1907,6
STAT,1902,54,na,1956,3032.965927316201
SIM,1931,16,20-24,1947,175
SIM,1841,44,na,1885,1762
SIM,1943,26,40-44,1969,7
STAT,1870,38,40-44,1908,4.343867282729806
STAT,1918,22,25-29,1940,101.66286751668801
STAT,1895,38,50-100,1933,1.6260337276058248
STAT,1789,81,na,1870,164.52091114282817
STAT,1933,19,20-24,1952,184.09173751782905
STAT,1816,42,40-44,1858,5.336251628542864
SIM,1877,26,20-24,1903,15
SIM,1938,32,45-49,1970,4
SIM,1899,18,20-24,1917,34
STAT,1893,47,25-29,1940,0.04185233553610298
SIM,1933,35,na,1968,5109
STAT,1802,75,na,1877,380.2237736198596
SIM,1856,20,40-44,1876,3
STAT,1953,17,45-49,1970,0.616416388518922
SIM,1927,39,40-44,1966,4
SIM,1846,22,na,1868,2077
STAT,1871,51,30-34,1922,0.00604397831289772
SIM,1892,35,na,1927,3489
SIM,1952,18,35-39,1970,5
STAT,1912,16,45-49,1928,0.10329886433881334
STAT,1913,41,30-34,1954,0.1279197324058818
SIM,1896,49,na,1945,2988
STAT,1944,18,35-39,1962,4.605703951620985
SIM,1891,33,40-44,1924,8
STAT,1873,87,na,1960,283.7799851337675
STAT,1915,47,20-24,1962,0.01136347030160987
SIM,1825,37,na,1862,1642
SIM,1871,10,na,1881,2572
STAT,1925,47,30-34,1972,0.1102103099799077
SIM,1844,46,40-44,1890,1
SIM,1886,28,na,1914,2608
STAT,1919,39,40-44,1958,1.637654657621436
STAT,1836,33,na,1869,1687.4674490647894
STAT,1848,20,40-44,1868,2.000918941232243
STAT,1872,22,25-29,1894,58.529610764234434
SIM,1863,25,30-34,1888,28
SIM,1883,31,40-44,1914,7
STAT,1941,5,na,1946,4200.819160150767
STAT,1849,10,na,1859,2309.918626461175
STAT,1885,20,45-49,1905,0.7139536980220429
SIM,1868,54,na,1922,2056
STAT,1922,26,35-39,1948,17.394111465064007
STAT,1819,44,na,1863,1636.1511410870082
STAT,1939,17,15-19,1956,46.34203024696367
STAT,1845,28,25-29,1873,39.94143238774534
STAT,1943,28,40-44,1971,5.062155495704919
SIM,1838,88,na,1926,67
SIM,1917,46,35-39,1963,1
STAT,1861,18,50-100,1879,0.04718837584717828
SIM,1868,18,20-24,1886,17
SIM,1856,73,na,1929,1093
SIM,1817,93,na,1910,22
STAT,1901,24,20-24,1925,97.69369625169128
SIM,1894,39,50-100,1933,3
SIM,1832,30,na,1862,1921
STAT,1871,21,na,1892,2397.1553061565305
STAT,1910,36,30-34,1946,1.7863717335471718
STAT,1870,80,na,1950,616.903005353343
STAT,1857,43,40-44,1900,1.7790952531324935
STAT,1903,42,50-100,1945,0.10625626963605987
SIM,1869,39,na,1908,2290
STAT,1890,35,na,1925,2966.6063277118583
SIM,1947,17,15-19,1964,53
STAT,1839,17,45-49,1856,0.05897379084357754
SIM,1921,9,na,1930,5247
STAT,1866,33,50-100,1899,0.8585214318368052
STAT,1885,57,na,1942,2045.3598158884274
SIM,1913,42,35-39,1955,1
STAT,1869,48,45-49,1917,0.22951779348077345
STAT,1882,34,50-100,1916,0.9028387276157513
STAT,1935,26,40-44,1961,6.482340934688011
SIM,1829,29,45-49,1858,1
SIM,1865,43,40-44,1908,6
STAT,1896,19,40-44,1915,0.24511348533920085
SIM,1918,20,25-29,1938,119
STAT,1858,23,40-44,1881,1.747518318944644
STAT,1875,31,40-44,1906,4.55914409874962
SIM,1870,40,50-100,1910,6
STAT,1921,36,40-44,1957,1.7072221438673405
STAT,1862,40,50-100,1902,0.9266799810847928
SIM,1935,15,30-34,1950,21
SIM,1837,28,40-44,1865,6
SIM,1925,18,25-29,1943,70
SIM,1909,25,30-34,1934,4
SIM,1802,64,na,1866,789
STAT,1899,41,50-100,1940,0.1029484706491664
STAT,1917,25,15-19,1942,0.7606420892424699
STAT,1853,36,na,1889,1996.1035108813824
STAT,1940,19,25-29,1959,44.85728926884676
STAT,1887,33,25-29,1920,11.65925242796105
STAT,1893,53,na,1946,2741.8490177262047
SIM,1816,40,40-44,1856,1
STAT,1841,55,na,1896,1526.7018249511755
STAT,1863,16,25-29,1879,5.818034719096764
STAT,1932,20,na,1952,4915.606097755535
STAT,1936,34,na,1970,3741.985002277276
STAT,1920,18,45-49,1938,0.5704445529811564
STAT,1818,107,na,1925,0.0024033292665781077
STAT,1820,48,50-100,1868,0.44146102414655586
STAT,1829,28,40-44,1857,3.475047049756005
STAT,1861,109,na,1970,0.00890799182944265
STAT,1843,15,45-49,1858,0.06819018208601477
SIM,1872,20,25-29,1892,59
STAT,1909,46,35-39,1955,0.12112685349518372
STAT,1849,51,na,1900,1679.6325646028652
SIM,1884,17,na,1901,2794
SIM,1914,25,50-100,1939,3
STAT,1862,36,40-44,1898,3.8197200430811695
SIM,1856,84,na,1940,217
STAT,1828,47,45-49,1875,0.18457273425725557
STAT,1917,38,40-44,1955,1.5788649075100445
SIM,1895,33,25-29,1928,16
STAT,1927,34,35-39,1961,11.45218016424126
STAT,1906,18,15-19,1924,8.788805294479287
SIM,1915,29,20-24,1944,28
STAT,1863,42,40-44,1905,2.0093917098554486
SIM,1819,41,na,1860,1532
STAT,1906,25,50-100,1931,0.9562885769822909
STAT,1885,49,40-44,1934,0.1706056533169228
SIM,1886,50,na,1936,2483
STAT,1852,46,25-29,1898,0.04653439972996374
STAT,1820,93,na,1913,16.096017585564823
STAT,1884,16,45-49,1900,0.06609079094164622
SIM,1789,81,na,1870,135
STAT,1840,27,50-100,1867,0.5739534997804867
STAT,1923,49,20-24,1972,0.013113084906929796
SIM,1933,17,20-24,1950,201
STAT,1821,38,45-49,1859,4.101676111480486
STAT,1910,29,40-44,1939,4.5577649065675585
STAT,1857,39,na,1896,1858.1598299384054
SIM,1829,74,na,1903,492
STAT,1873,35,50-100,1908,1.2818518134818715
STAT,1846,32,25-29,1878,8.655979699747753
STAT,1912,21,na,1933,3742.1109343493918
SIM,1842,30,40-44,1872,3
SIM,1914,18,15-19,1932,9
SIM,1935,34,35-39,1969,28
SIM,1915,17,na,1932,4470
SIM,1925,25,15-19,1950,4
STAT,1853,25,na,1878,2131.82459877992
SIM,1893,49,40-44,1942,1
STAT,1900,39,25-29,1939,0.8698545328555162
STAT,1811,49,40-44,1860,0.45919461575531767
SIM,1855,36,na,1891,1834
STAT,1926,21,20-24,1947,138.22737866502055
SIM,1914,32,na,1946,3887
SIM,1854,32,25-29,1886,12
STAT,1927,27,45-49,1954,2.142444709341906
SIM,1887,42,50-100,1929,6
SIM,1858,31,35-39,1889,17
SIM,1925,38,40-44,1963,1
SIM,1873,37,20-24,1910,4
STAT,1898,40,25-29,1938,0.06213870837544194
STAT,1895,38,45-49,1933,2.6401919973855468
STAT,1905,42,35-39,1947,0.18504000901914
STAT,1855,25,30-34,1880,22.68430343907689
STAT,1891,4,na,1895,3322.5531974377564
STAT,1854,73,na,1927,909.0519813529418
SIM,1913,35,45-49,1948,2
SIM,1898,20,na,1918,3655
STAT,1907,48,25-29,1955,0.04805662282676166
STAT,1862,40,na,1902,2027.332852089742
STAT,1890,68,na,1958,1989.1681610302937
STAT,1866,54,na,1920,1970.3511025453238
STAT,1900,31,15-19,1931,0.20218016663805408
STAT,1920,25,35-39,1945,16.9211035754782
STAT,1824,46,50-100,1870,0.2901215216561565
SIM,1881,35,50-100,1916,1
SIM,1840,37,na,1877,1729
SIM,1853,28,25-29,1881,49
SIM,1904,29,50-100,1933,1
STAT,1919,31,na,1950,4180.940734619097
SIM,1905,26,20-24,1931,26
SIM,1909,18,40-44,1927,1
SIM,1964,6,na,1970,5232
STAT,1795,77,na,1872,305.0125998912618
STAT,1865,37,20-24,1902,0.7137311660538088
STAT,1850,23,50-100,1873,0.36552429964491406
SIM,1880,3,na,1883,2939
STAT,1867,39,na,1906,2233.684438773315
STAT,1915,20,35-39,1935,9.587744845239655
STAT,1918,21,15-19,1939,5.87644711306926
STAT,1840,47,45-49,1887,0.17125507587061833
SIM,1928,35,40-44,1963,3
STAT,1947,24,45-49,1971,1.2965521225515835
SIM,1867,23,20-24,1890,68
STAT,1865,22,35-39,1887,5.468766608887916
STAT,1922,16,40-44,1938,1.6557639592184157
STAT,1819,46,40-44,1865,0.34413928728965465
STAT,1827,45,20-24,1872,0.013845708790863682
SIM,1847,25,45-49,1872,1
STAT,1920,1,na,1921,4781.353963922945
STAT,1880,23,15-19,1903,3.525723198526807
SIM,1885,39,40-44,1924,7
STAT,1929,35,35-39,1964,3.172678955985932
SIM,1850,35,45-49,1885,4
STAT,1843,48,25-29,1891,0.045914664429845646
STAT,1868,23,15-19,1891,3.2045286150283516
STAT,1871,44,na,1915,2304.0389668422736
STAT,1847,31,30-34,1878,16.152974640968438
SIM,1853,36,25-29,1889,6
SIM,1806,87,na,1893,120
STAT,1812,102,na,1914,0.13371893309193467
SIM,1953,12,na,1965,4771
SIM,1917,23,15-19,1940,5
STAT,1880,49,40-44,1929,0.17969947246103837
SIM,1864,22,40-44,1886,2
SIM,1887,27,40-44,1914,2
SIM,1903,34,25-29,1937,11
SIM,1914,20,40-44,1934,3
STAT,1925,17,20-24,1942,167.09053774899527
STAT,1852,61,na,1913,1505.375878537613
STAT,1845,36,25-29,1881,2.3883604374571767
STAT,1888,25,40-44,1913,3.6372203945092907
SIM,1920,31,20-24,1951,2
STAT,1848,23,45-49,1871,0.655263945591237
STAT,1875,19,20-24,1894,18.46241728452076
SIM,1914,22,35-39,1936,14
SIM,1955,13,na,1968,5089
STAT,1841,24,na,1865,1971.2735643325639
STAT,1862,33,20-24,1895,2.3374305416383954
STAT,1941,18,30-34,1959,12.804288461111014
SIM,1868,31,na,1899,2376
STAT,1794,82,na,1876,175.7166195951011
STAT,1862,8,na,1870,2442.3358793815614
STAT,1908,32,50-100,1940,0.7958171219333638
SIM,1844,38,25-29,1882,5
STAT,1909,21,20-24,1930,105.7170515765803
STAT,1829,75,na,1904,684.6785936316383
STAT,1878,42,15-19,1920,0.014646068700954857
SIM,1825,42,50-100,1867,2
STAT,1839,25,45-49,1864,0.9793409353515323
STAT,1887,79,na,1966,1151.548404076906
SIM,1876,23,15-19,1899,5
STAT,1854,34,25-29,1888,7.862840671635291
STAT,1912,31,20-24,1943,2.458426749063782
SIM,1864,24,35-39,1888,11
STAT,1875,41,35-39,1916,1.9045200073298083
SIM,1872,36,na,1908,2468
SIM,1878,36,30-34,1914,12
SIM,1910,37,35-39,1947,3
STAT,1905,38,15-19,1943,0.017769052995315962
SIM,1836,39,45-49,1875,2
SIM,1873,22,35-39,1895,7
STAT,1856,22,40-44,1878,1.9380638333774673
STAT,1889,38,20-24,1927,0.9665622682208589
SIM,1879,28,45-49,1907,2
STAT,1892,16,na,1908,3237.0745711190993
STAT,1811,89,na,1900,45.50481661316058
SIM,1896,25,40-44,1921,5
SIM,1899,26,20-24,1925,20
STAT,1874,20,35-39,1894,6.114278325884406
SIM,1829,34,40-44,1863,2
STAT,1929,33,40-44,1962,5.066775341623481
STAT,1881,16,40-44,1897,0.1808362020635242
SIM,1908,23,20-24,1931,97
STAT,1822,41,na,1863,1624.27596504783
STAT,1854,3,na,1857,2586.717884868336
STAT,1897,18,45-49,1915,0.08886883877663845
SIM,1917,21,20-24,1938,114
SIM,1940,28,50-100,1968,1
STAT,1859,25,15-19,1884,0.3814769116269696
SIM,1883,41,35-39,1924,2
STAT,1837,37,45-49,1874,1.6182455567712557
STAT,1807,74,na,1881,558.9381822998057
STAT,1828,39,45-49,1867,1.6752828408882894
STAT,1872,18,40-44,1890,0.18651555578769974
SIM,1919,37,40-44,1956,4
SIM,1853,36,40-44,1889,4
SIM,1791,84,na,1875,96
STAT,1794,92,na,1886,12.118460092489935
SIM,1813,59,na,1872,1128
STAT,1930,40,40-44,1970,0.3365855929335798
SIM,1880,18,40-44,1898,1
SIM,1897,38,20-24,1935,2
STAT,1867,49,na,1916,2109.7544429373265
SIM,1878,29,40-44,1907,4
STAT,1864,19,45-49,1883,0.060575861378434376
STAT,1832,50,50-100,1882,0.010974718755945165
STAT,1879,34,30-34,1913,18.45885488784858
STAT,1826,57,na,1883,1249.0043380558266
SIM,1838,34,35-39,1872,18
STAT,1883,36,45-49,1919,2.005015314643713
STAT,1825,42,50-100,1867,1.4425180327958647
STAT,1875,68,na,1943,1600.0391141216985
SIM,1851,74,na,1925,756
STAT,1893,29,50-100,1922,0.8219388033712112
STAT,1863,27,45-49,1890,0.9931125401842534
SIM,1806,77,na,1883,510
STAT,1869,44,15-19,1913,0.01341782401646481
STAT,1809,75,na,1884,547.584201998173
STAT,1818,38,na,1856,1518.5571981203134
SIM,1937,33,40-44,1970,7
STAT,1877,49,na,1926,2330.8213999297827
STAT,1889,31,50-100,1920,1.1593194266250826
STAT,1829,35,30-34,1864,4.791803525438625
STAT,1887,38,50-100,1925,1.3965125149639122
SIM,1922,21,30-34,1943,43
STAT,1934,15,20-24,1949,187.87927399236523
STAT,1889,7,na,1896,3283.1229943241938
SIM,1856,23,45-49,1879,1
STAT,1877,69,na,1946,1552.7870582101236
SIM,1800,62,na,1862,846
SIM,1894,37,40-44,1931,10
STAT,1896,26,30-34,1922,34.045354531340955
STAT,1850,51,45-49,1901,0.010968538333702045
STAT,1902,37,35-39,1939,2.1962764484187756
STAT,1907,21,50-100,1928,0.6126680666875748
SIM,1861,74,na,1935,1048
STAT,1892,48,20-24,1940,0.008545839748257166
STAT,1816,45,45-49,1861,0.5013155100447116
STAT,1816,57,na,1873,1108.4988690656282
STAT,1927,45,25-29,1972,0.06824188729863008
STAT,1792,102,na,1894,0.04863038091359518
SIM,1872,23,30-34,1895,21
SIM,1891,19,na,1910,3301
STAT,1872,91,na,1963,136.98299688707996
STAT,1894,17,na,1911,3314.146356235823
STAT,1929,28,45-49,1957,2.204211275470451
STAT,1842,49,20-24,1891,0.009213972496546631
STAT,1824,31,50-100,1855,2.1573119714555062
STAT,1859,23,20-24,1882,57.83310012133462
STAT,1930,22,25-29,1952,120.68777562684815
SIM,1865,98,na,1963,1
SIM,1930,16,40-44,1946,3
STAT,1862,50,25-29,1912,0.003120085854230594
STAT,1892,36,na,1928,3026.7607978632136
SIM,1849,27,20-24,1876,10
STAT,1849,51,35-39,1900,0.006715712955397435
STAT,1854,96,na,1950,6.571837988759686
STAT,1831,49,45-49,1880,0.18810855554843625
STAT,1850,18,20-24,1868,16.19977047565323
STAT,1886,37,40-44,1923,4.7268805088785495
SIM,1823,35,na,1858,1692
STAT,1864,23,30-34,1887,16.299153960034964
STAT,1833,26,20-24,1859,10.452794265774612
STAT,1877,39,25-29,1916,3.0157770762952407
STAT,1894,36,20-24,1930,1.0163904576756382
SIM,1857,44,45-49,1901,1
SIM,1881,19,na,1900,2305
SIM,1837,35,30-34,1872,9
SIM,1888,30,30-34,1918,29
SIM,1907,27,20-24,1934,22
STAT,1884,17,na,1901,2549.0503557177735
STAT,1792,81,na,1873,183.42147062305023
STAT,1848,30,35-39,1878,9.372917228103685
STAT,1828,44,25-29,1872,0.5083672571375083
STAT,1897,25,35-39,1922,13.2507833117177
STAT,1906,20,40-44,1926,3.112596051468433
SIM,1855,31,30-34,1886,23
STAT,1909,23,15-19,1932,5.0301311516127
SIM,1841,26,20-24,1867,14
STAT,1923,15,45-49,1938,0.6012719366372934
SIM,1885,39,25-29,1924,1
SIM,1821,44,na,1865,1468
STAT,1865,15,45-49,1880,0.06930399703268202
STAT,1881,54,na,1935,2065.222472625042
SIM,1877,15,30-34,1892,2
STAT,1855,26,40-44,1881,2.4379649168301993
STAT,1906,39,50-100,1945,0.38952018876078265
STAT,1834,40,35-39,1874,1.5072032304212117
SIM,1860,30,50-100,1890,1
STAT,1854,29,45-49,1883,0.8780953190999324
SIM,1872,48,45-49,1920,1
STAT,1782,81,na,1863,191.08610092040047
STAT,1908,25,20-24,1933,17.865960673747438
SIM,1859,49,25-29,1908,1
SIM,1897,23,35-39,1920,11
STAT,1854,41,15-19,1895,0.010617240960101994
SIM,1850,37,na,1887,1824
STAT,1831,24,na,1855,1865.027681569085
STAT,1917,45,50-100,1962,0.24222205402619296
SIM,1816,43,45-49,1859,3
STAT,1904,66,na,1970,2744.5930395840605
STAT,1784,82,na,1866,137.58771077438908
STAT,1876,47,25-29,1923,0.060394650230651575
STAT,1777,80,na,1857,287.4562436764423
STAT,1840,29,15-19,1869,0.40125251742650586
SIM,1849,40,na,1889,1867
STAT,1859,18,25-29,1877,5.327535727927577
STAT,1829,36,50-100,1865,1.0883785567091575
STAT,1937,27,40-44,1964,4.634528870702469
SIM,1938,11,na,1949,3954
STAT,1946,25,40-44,1971,5.3019540307594095
SIM,1879,35,35-39,1914,5
SIM,1863,26,40-44,1889,4
SIM,1943,12,na,1955,3903
STAT,1862,54,50-100,1916,0.01275456803276686
SIM,1866,27,20-24,1893,11
STAT,1865,105,na,1970,0.3093041535899741
STAT,1846,77,na,1923,618.1456375090518
SIM,1830,27,na,1857,1913
STAT,1868,16,25-29,1884,5.654752611678813
STAT,1869,15,30-34,1884,1.6104689593417463
STAT,1914,24,35-39,1938,9.753523937023251
STAT,1889,23,35-39,1912,7.3308205851167445
SIM,1887,34,30-34,1921,32
SIM,1888,26,45-49,1914,2
STAT,1887,69,na,1956,1706.876450410407
SIM,1877,37,25-29,1914,4
SIM,1925,15,20-24,1940,186
SIM,1846,26,40-44,1872,1
STAT,1847,24,40-44,1871,1.9635651666433123
STAT,1830,25,40-44,1855,4.141944330917362
STAT,1845,43,15-19,1888,0.010848053660292052
STAT,1851,24,na,1875,2076.4097197254596
SIM,1881,29,na,1910,2146
SIM,1886,35,40-44,1921,6
STAT,1857,46,45-49,1903,0.18855949817852968
SIM,1873,29,20-24,1902,13
STAT,1830,25,25-29,1855,58.489865736791415
STAT,1849,29,20-24,1878,10.642003939781194
SIM,1857,29,20-24,1886,18
SIM,1856,1,na,1857,3427
STAT,1869,47,50-100,1916,0.24076579048791583
STAT,1912,41,50-100,1953,0.11625196510015352
STAT,1838,26,40-44,1864,2.8200192750986774
STAT,1881,48,45-49,1929,0.22983681122926486
SIM,1811,78,na,1889,233
STAT,1868,86,na,1954,216.18890923037517
STAT,1940,16,50-100,1956,0.38818376101189883
SIM,1865,46,45-49,1911,1
STAT,1857,34,50-100,1891,0.7237402572101349
STAT,1888,49,50-100,1937,0.16359213900137534
STAT,1908,20,50-100,1928,0.6205242248154207
STAT,1911,14,na,1925,4018.1353456810352
STAT,1861,44,na,1905,1922.0033007455265
SIM,1942,0,na,1942,4839
STAT,1878,35,40-44,1913,4.692445990361952
STAT,1858,27,20-24,1885,9.715724228842262
STAT,1848,37,20-24,1885,0.6174939439103561
STAT,1947,0,na,1947,5102.073650867545
SIM,1922,24,35-39,1946,12
SIM,1905,22,40-44,1927,5
SIM,1927,5,na,1932,4943
STAT,1808,50,35-39,1858,0.021427524523619283
SIM,1847,69,na,1916,999
SIM,1850,27,na,1877,1942
SIM,1862,34,25-29,1896,3
STAT,1809,55,na,1864,1409.9687512929509
STAT,1955,5,na,1960,5323.592834335689
STAT,1829,36,40-44,1865,3.8806013231627667
STAT,1886,44,15-19,1930,0.014710736830174652
SIM,1957,3,na,1960,5612
STAT,1767,112,na,1879,5.174749695822287E-4
STAT,1826,53,50-100,1879,0.011171291766186373
SIM,1872,24,40-44,1896,1
SIM,1901,39,35-39,1940,2
STAT,1867,17,20-24,1884,17.357812420980252
SIM,1876,16,25-29,1892,11
SIM,1912,32,25-29,1944,15
STAT,1878,25,50-100,1903,0.6838728998050325
STAT,1938,26,45-49,1964,1.7467291210392837
STAT,1853,35,20-24,1888,0.6599192928669437
STAT,1902,31,na,1933,3447.0852962679555
STAT,1914,22,40-44,1936,3.504855717718895
STAT,1845,39,45-49,1884,1.6029243318933666
STAT,1879,27,40-44,1906,3.194334547484341
STAT,1891,19,20-24,1910,22.271019745660688
SIM,1924,21,na,1945,4374
STAT,1820,35,25-29,1855,7.829705663188131
SIM,1858,28,25-29,1886,44
STAT,1872,71,na,1943,1364.7397272301862
STAT,1863,31,15-19,1894,0.12789733133441328
STAT,1864,24,40-44,1888,1.8931013504759153
SIM,1922,22,40-44,1944,5
STAT,1860,90,na,1950,65.25746129011868
STAT,1938,33,35-39,1971,9.367476451572411
STAT,1873,21,30-34,1894,18.477965068553246
SIM,1912,20,na,1932,3800
STAT,1833,59,na,1892,1276.2645558385516
SIM,1875,17,20-24,1892,18
SIM,1896,70,na,1966,2153
STAT,1869,37,25-29,1906,2.835745576864574
SIM,1906,21,45-49,1927,1
SIM,1862,29,45-49,1891,1
STAT,1904,32,25-29,1936,8.598853248265248
SIM,1847,32,35-39,1879,15
STAT,1847,49,na,1896,1717.823430411211
STAT,1910,39,35-39,1949,2.3356054232556445
SIM,1882,19,20-24,1901,24
STAT,1838,33,30-34,1871,15.776142636264987
STAT,1895,34,15-19,1929,0.18792335406453944
STAT,1956,10,na,1966,5302.682483233327
SIM,1842,40,35-39,1882,5
STAT,1954,17,50-100,1971,0.47242440372994154
SIM,1837,36,40-44,1873,6
SIM,1929,31,40-44,1960,10
STAT,1837,94,na,1931,13.325248705938144
STAT,1910,50,na,1960,3464.406721408568
SIM,1916,25,20-24,1941,19
STAT,1884,46,20-24,1930,0.01214577831239445
STAT,1829,85,na,1914,182.322380175429
STAT,1896,27,40-44,1923,4.036083347111509
SIM,1883,34,45-49,1917,3
SIM,1950,5,na,1955,4746
STAT,1937,34,30-34,1971,15.879015944996866
STAT,1810,46,20-24,1856,0.038396573221558164
STAT,1886,37,25-29,1923,3.1089919533448622
STAT,1875,34,45-49,1909,1.8101686413592009
STAT,1917,48,35-39,1965,0.13704559985548764
STAT,1909,24,25-29,1933,87.0067151756172
STAT,1839,32,35-39,1871,8.600946079499659
STAT,1852,71,na,1923,1075.3175619068227
STAT,1928,37,40-44,1965,1.9297518230330724
SIM,1846,33,30-34,1879,36
STAT,1890,38,45-49,1928,2.4742161632807975
STAT,1882,16,na,1898,2516.306357242032
SIM,1894,37,25-29,1931,8
SIM,1816,87,na,1903,54
STAT,1914,17,45-49,1931,0.10543036006510574
SIM,1832,28,20-24,1860,12
SIM,1888,51,na,1939,2498
STAT,1819,46,25-29,1865,0.11578517986897309
STAT,1828,43,15-19,1871,0.01111028010688222
STAT,1848,22,35-39,1870,5.5231806011605835
SIM,1845,34,40-44,1879,1
SIM,1864,25,45-49,1889,1
SIM,1868,39,40-44,1907,3
SIM,1859,40,na,1899,2221
STAT,1823,47,45-49,1870,0.35478924658601846
SIM,1903,31,20-24,1934,7
STAT,1929,32,30-34,1961,20.411605784023934
STAT,1797,79,na,1876,292.5996858928242
STAT,1895,27,25-29,1922,56.30365421026232
STAT,1932,20,35-39,1952,12.674562267299226
STAT,1830,32,15-19,1862,0.13618935407654675
SIM,1948,11,na,1959,4540
SIM,1829,33,30-34,1862,17
STAT,1880,35,na,1915,2549.6639551772223
SIM,1835,48,40-44,1883,1
STAT,1900,17,30-34,1917,2.253651285885443
SIM,1914,23,45-49,1937,1
STAT,1912,34,25-29,1946,9.19828231623999
SIM,1895,23,na,1918,3151
STAT,1884,39,30-34,1923,5.3249124460685
SIM,1896,24,30-34,1920,39
SIM,1871,74,na,1945,1200
STAT,1794,102,na,1896,0.0581121255720166
STAT,1894,39,40-44,1933,5.686425696488367
STAT,1879,19,50-100,1898,0.05196256780947437
SIM,1846,36,35-39,1882,15
STAT,1888,24,30-34,1912,21.347492408445827
SIM,1892,39,30-34,1931,12
SIM,1866,41,35-39,1907,8
SIM,1917,24,25-29,1941,126
STAT,1947,21,40-44,1968,3.8784077547988365
SIM,1853,39,45-49,1892,1
SIM,1856,22,35-39,1878,10
STAT,1864,42,na,1906,2093.9035900352806
SIM,1843,39,35-39,1882,17
STAT,1887,36,30-34,1923,6.1217414486782475
STAT,1839,31,50-100,1870,0.7862923645683105
SIM,1894,47,na,1941,3003
SIM,1867,26,25-29,1893,45
SIM,1929,26,45-49,1955,4
STAT,1942,17,20-24,1959,144.5496336971823
STAT,1854,33,15-19,1887,0.11046178735814254
STAT,1861,36,25-29,1897,2.4387534090964906
STAT,1906,23,45-49,1929,1.0322155362961591
SIM,1836,36,25-29,1872,6
SIM,1918,45,na,1963,4153
SIM,1934,23,15-19,1957,6
STAT,1906,47,na,1953,3325.710360670672
STAT,1929,36,45-49,1965,0.8934790382866271
SIM,1842,18,20-24,1860,19
STAT,1844,52,na,1896,1659.6318022300313
SIM,1833,79,na,1912,412
STAT,1837,34,25-29,1871,8.386334502809689
SIM,1867,14,na,1881,2441
STAT,1845,33,20-24,1878,2.4852681582444465
STAT,1787,80,na,1867,297.69693769609455
STAT,1880,90,na,1970,271.84986115834306
STAT,1802,98,na,1900,1.0307799882175501
SIM,1940,20,35-39,1960,20
STAT,1850,37,50-100,1887,0.9381383952490674
STAT,1867,105,na,1972,0.4049068545088387
STAT,1832,27,50-100,1859,0.5826496102014878
STAT,1872,47,40-44,1919,0.17422391096819614
STAT,1857,20,35-39,1877,5.445189257239964
STAT,1813,51,40-44,1864,0.025778586883424343
STAT,1834,33,45-49,1867,1.4876602016779246
STAT,1885,15,15-19,1900,6.06812293243639
SIM,1828,45,30-34,1873,2
STAT,1842,95,na,1937,10.426422411751629
STAT,1859,26,25-29,1885,35.31201660272661
STAT,1840,15,40-44,1855,0.1724330225113376
SIM,1901,34,na,1935,3581
STAT,1921,14,na,1935,4593.849642485056
STAT,1856,25,45-49,1881,0.9347214559442721
STAT,1828,36,25-29,1864,2.580426876160138
SIM,1863,45,na,1908,1980
SIM,1882,27,20-24,1909,14
STAT,1776,97,na,1873,0.8900233235835653
STAT,1926,23,15-19,1949,6.577007522055378
SIM,1937,32,30-34,1969,19
STAT,1838,36,35-39,1874,6.33624184184089
STAT,1843,45,20-24,1888,0.009892370588116586
SIM,1869,39,40-44,1908,3
STAT,1826,41,50-100,1867,0.8811844438932426
SIM,1842,33,45-49,1875,2
STAT,1835,46,25-29,1881,0.04583875355711291
STAT,1819,107,na,1926,0.002780323686018405
SIM,1893,15,15-19,1908,13
STAT,1868,49,40-44,1917,0.16332878935235498
SIM,1854,35,30-34,1889,8
STAT,1836,20,15-19,1856,2.884137650327346
STAT,1813,50,na,1863,1277.1700366808493
STAT,1864,105,na,1969,0.2677891017398598
SIM,1841,54,na,1895,1592
SIM,1920,34,25-29,1954,4
SIM,1909,21,15-19,1930,5
STAT,1791,64,na,1855,740.8546
STAT,1831,46,40-44,1877,0.14182983675187846
SIM,1833,25,na,1858,1922
SIM,1878,37,40-44,1915,7
STAT,1927,42,20-24,1969,0.022593368960898207
SIM,1862,26,25-29,1888,41
SIM,1878,33,25-29,1911,2
SIM,1871,24,40-44,1895,2
SIM,1872,26,35-39,1898,16
SIM,1888,33,35-39,1921,19
STAT,1867,69,na,1936,1405.5128355579204
STAT,1900,24,50-100,1924,0.5729855566648594
SIM,1878,31,na,1909,2630
SIM,1895,29,40-44,1924,6
STAT,1864,16,40-44,1880,0.18971995720790652
SIM,1803,59,na,1862,887
STAT,1906,30,35-39,1936,8.703724942752137
SIM,1831,44,na,1875,1552
SIM,1854,28,50-100,1882,1
SIM,1872,16,40-44,1888,4
STAT,1961,11,na,1972,5176.1475226970315
STAT,1814,49,45-49,1863,0.6812761749794018
STAT,1836,23,na,1859,1743.726104620163
STAT,1868,36,50-100,1904,1.2020301876896136
SIM,1830,26,45-49,1856,3
STAT,1846,28,50-100,1874,0.5494375422497193
SIM,1929,33,35-39,1962,22
STAT,1865,68,na,1933,1414.9624327117033
STAT,1860,23,45-49,1883,0.5907211699742574
SIM,1895,36,30-34,1931,14
SIM,1945,25,50-100,1970,3
STAT,1887,29,40-44,1916,3.3998547890023736
SIM,1937,25,40-44,1962,6
STAT,1923,26,15-19,1949,0.8298072488676855
STAT,1927,39,na,1966,4761.296626788652
SIM,1859,16,25-29,1875,9
SIM,1865,20,35-39,1885,5
SIM,1845,34,25-29,1879,2
SIM,1911,44,na,1955,3605
SIM,1886,18,na,1904,2817
SIM,1888,23,40-44,1911,6
STAT,1875,30,50-100,1905,0.9670299978421726
SIM,1816,77,na,1893,416
SIM,1819,39,45-49,1858,4
STAT,1864,48,45-49,1912,0.2113816107499893
STAT,1901,38,30-34,1939,1.6329150799148522
SIM,1901,68,na,1969,2568
STAT,1863,24,40-44,1887,1.8738107306838663
SIM,1871,31,15-19,1902,2
STAT,1823,60,na,1883,1145.3781044078644
SIM,1896,20,50-100,1916,6
SIM,1859,23,15-19,1882,2
SIM,1918,16,40-44,1934,1
STAT,1888,20,50-100,1908,0.49473785085210514
SIM,1851,38,30-34,1889,12
SIM,1854,41,na,1895,2017
SIM,1776,83,na,1859,118
STAT,1854,26,25-29,1880,37.566619473089325
STAT,1864,26,35-39,1890,8.782408156010458
STAT,1937,35,40-44,1972,1.5295390148453738
STAT,1871,23,20-24,1894,69.42259171700205
SIM,1906,20,35-39,1926,14
STAT,1853,38,40-44,1891,3.652324527732217
SIM,1818,58,na,1876,1159
STAT,1806,57,na,1863,1095.4157611929725
STAT,1843,38,30-34,1881,4.523441573721397
SIM,1908,26,25-29,1934,80
STAT,1819,49,45-49,1868,0.4541672506923579
STAT,1866,29,20-24,1895,10.960048460876202
SIM,1881,21,30-34,1902,1
SIM,1861,38,40-44,1899,6
STAT,1796,63,na,1859,860.3036173391198
STAT,1809,49,35-39,1858,0.6021876230519199
SIM,1843,89,na,1932,100
SIM,1827,49,45-49,1876,1
SIM,1937,28,na,1965,4499
SIM,1824,31,50-100,1855,1
SIM,1828,38,40-44,1866,6
SIM,1876,36,50-100,1912,2
STAT,1859,33,15-19,1892,0.11553205133597559
STAT,1934,18,25-29,1952,59.61918660135383
STAT,1929,25,40-44,1954,5.9723169649019034
STAT,1862,36,25-29,1898,2.512328977993755
STAT,1901,48,na,1949,3169.8368032647836
SIM,1925,23,20-24,1948,150
SIM,1942,18,25-29,1960,66
SIM,1844,41,na,1885,1897
STAT,1917,23,20-24,1940,120.22836781787925
STAT,1860,30,35-39,1890,8.44969516224547
SIM,1898,45,45-49,1943,1
STAT,1888,5,na,1893,3160.5429927067894
STAT,1837,41,15-19,1878,0.011005052543185347
STAT,1880,19,45-49,1899,0.06965211568677264
SIM,1952,6,na,1958,4887
SIM,1867,15,20-24,1882,13
STAT,1840,39,45-49,1879,1.6618008967048614
STAT,1922,24,40-44,1946,3.909725235877721
STAT,1854,52,40-44,1906,0.008014491556651418
STAT,1872,26,40-44,1898,3.0732639184566417
STAT,1862,28,25-29,1890,36.60524961753923
SIM,1896,32,30-34,1928,25
STAT,1878,35,25-29,1913,3.086343477085663
STAT,1836,25,50-100,1861,0.5227305854662161
STAT,1931,28,15-19,1959,0.9290691818325328
STAT,1898,21,35-39,1919,8.074655381967847
STAT,1862,61,na,1923,1622.7231912167053
STAT,1926,16,25-29,1942,54.33517876730019
STAT,1854,37,30-34,1891,4.0790169652574235
STAT,1876,18,25-29,1894,5.953858173016957
SIM,1823,79,na,1902,491
STAT,1899,20,25-29,1919,80.44753367577651
SIM,1923,28,30-34,1951,56
STAT,1919,43,25-29,1962,0.07884427790866916
STAT,1888,32,30-34,1920,21.056771899441905
STAT,1906,15,45-49,1921,0.09744449090529196
STAT,1871,26,40-44,1897,3.0374792827041377
STAT,1908,28,25-29,1936,63.22528565831916
SIM,1854,28,40-44,1882,7
STAT,1839,39,20-24,1878,0.6226768953460595
SIM,1904,26,40-44,1930,5
STAT,1929,40,30-34,1969,0.1693348043549727
STAT,1922,23,30-34,1945,33.526730895948084
STAT,1959,0,na,1959,5283.7558722713875
SIM,1886,38,45-49,1924,2
SIM,1930,23,30-34,1953,47
SIM,1929,34,45-49,1963,6
STAT,1830,28,45-49,1858,1.1789161516724442
STAT,1872,25,30-34,1897,25.92139519424166
SIM,1903,15,na,1918,3614
STAT,1856,46,45-49,1902,0.18952620265189107
STAT,1819,38,40-44,1857,11.264246675915645
STAT,1838,29,45-49,1867,1.0228845087232754
STAT,1844,15,25-29,1859,5.648325333738973
SIM,1891,36,45-49,1927,5
STAT,1832,95,na,1927,8.884450319766046
STAT,1849,44,45-49,1893,1.1462484693411024
SIM,1873,55,na,1928,2073
STAT,1793,102,na,1895,0.0587275313471013
STAT,1855,68,na,1923,1184.6561064596372
STAT,1859,15,20-24,1874,16.965372627682846
STAT,1878,16,35-39,1894,0.5840839709607528
STAT,1890,16,35-39,1906,0.6861060997449043
STAT,1886,29,40-44,1915,3.211527527601195
STAT,1904,24,25-29,1928,83.17289581083232
STAT,1825,30,50-100,1855,2.2250522687161296
SIM,1930,24,40-44,1954,10
STAT,1811,48,na,1859,1287.8186089766496
STAT,1864,38,50-100,1902,1.108139972352934
STAT,1868,46,20-24,1914,0.011725605564536435
SIM,1886,35,25-29,1921,4
STAT,1916,27,20-24,1943,19.260498419160722
SIM,1890,36,45-49,1926,4
STAT,1825,49,20-24,1874,0.015016870565959737
SIM,1887,37,35-39,1924,6
STAT,1914,21,30-34,1935,28.835776237268444
STAT,1857,70,na,1927,1117.8557253890178
STAT,1766,112,na,1878,0.0010656842736155299
STAT,1882,15,45-49,1897,0.06522416344776798
SIM,1887,0,na,1887,3477
SIM,1883,19,20-24,1902,21
SIM,1877,14,na,1891,2703
SIM,1801,78,na,1879,297
SIM,1876,49,40-44,1925,1
STAT,1870,90,na,1960,135.66362136188002
STAT,1867,25,20-24,1892,11.311808783434907
STAT,1871,33,15-19,1904,0.1432991767362746
STAT,1937,25,50-100,1962,0.9905493228937473
SIM,1934,16,25-29,1950,81
SIM,1870,28,25-29,1898,54
SIM,1864,92,na,1956,61
STAT,1861,29,35-39,1890,8.075606873171367
STAT,1846,35,30-34,1881,4.063584799868806
SIM,1819,44,25-29,1863,1
STAT,1898,47,45-49,1945,0.18279486863560881
SIM,1839,30,35-39,1869,5
STAT,1915,28,30-34,1943,40.63895012006802
SIM,1912,24,25-29,1936,178
STAT,1845,36,40-44,1881,3.631239504446765
STAT,1854,52,na,1906,1639.1640214255738
STAT,1864,27,45-49,1891,1.0071363230823716
SIM,1887,14,na,1901,3045
STAT,1874,27,20-24,1901,12.219032152278029
SIM,1947,22,45-49,1969,1
SIM,1840,50,50-100,1890,2
SIM,1879,42,50-100,1921,4
SIM,1820,34,20-24,1854,3
STAT,1872,16,na,1888,2606.098518869112
STAT,1897,15,na,1912,3461.025230404511
STAT,1896,30,15-19,1926,0.19341577648515118
SIM,1909,22,25-29,1931,102
STAT,1933,27,50-100,1960,1.3478152720404493
SIM,1859,24,25-29,1883,69
SIM,1888,22,30-34,1910,29
STAT,1880,42,40-44,1922,2.408321614356088
STAT,1810,49,25-29,1859,0.1748265744167876
SIM,1838,78,na,1916,465
SIM,1823,45,45-49,1868,1
SIM,1916,28,25-29,1944,76
SIM,1884,39,25-29,1923,4
STAT,1870,52,25-29,1922,0.0035135129888373222
STAT,1877,21,15-19,1898,3.501189600090319
SIM,1933,12,na,1945,5285
SIM,1901,29,40-44,1930,7
STAT,1906,22,35-39,1928,8.664787737012828
STAT,1896,50,na,1946,2942.848269454779
STAT,1828,47,30-34,1875,0.07570610463098876
STAT,1846,28,40-44,1874,2.5729167588571906
STAT,1878,38,45-49,1916,2.106306884899634
STAT,1835,39,35-39,1874,6.383800292880353
SIM,1840,27,na,1867,1819
STAT,1856,24,35-39,1880,5.349680263274054
STAT,1954,3,na,1957,4960.260195957466
SIM,1941,27,50-100,1968,1
SIM,1956,1,na,1957,5513
STAT,1819,43,20-24,1862,0.33293283618119235
STAT,1939,22,45-49,1961,1.1527383680872334
SIM,1894,34,20-24,1928,6
SIM,1850,19,25-29,1869,6
STAT,1827,48,40-44,1875,0.18969418308263858
STAT,1886,34,20-24,1920,2.893805979156685
SIM,1894,29,40-44,1923,5
SIM,1922,25,50-100,1947,1
STAT,1885,34,na,1919,2407.9429103009456
SIM,1840,20,30-34,1860,19
STAT,1836,38,25-29,1874,2.1771526749094456
STAT,1842,19,25-29,1861,5.639494085985344
SIM,1839,43,50-100,1882,4
STAT,1879,37,35-39,1916,7.5422451833958615
SIM,1837,32,25-29,1869,18
SIM,1852,91,na,1943,28
SIM,1936,26,50-100,1962,1
SIM,1878,28,45-49,1906,2
SIM,1902,30,na,1932,3461
SIM,1827,38,40-44,1865,3
STAT,1912,31,na,1943,3811.9239327245587
STAT,1884,49,25-29,1933,0.056920870305377305
SIM,1943,2,na,1945,3983
SIM,1950,17,20-24,1967,218
STAT,1928,15,na,1943,4752.679622556673
STAT,1880,16,25-29,1896,6.089820763321545
STAT,1910,21,45-49,1931,1.0809402454532975
SIM,1852,15,25-29,1867,10
STAT,1811,102,na,1913,0.1269912125251755
STAT,1893,40,50-100,1933,1.380999050902295
STAT,1851,48,50-100,1899,0.20007828738499203
STAT,1871,29,45-49,1900,1.1139695892679795
SIM,1826,77,na,1903,458
STAT,1847,94,na,1941,15.585403503194968
SIM,1872,27,45-49,1899,3
STAT,1829,32,25-29,1861,9.556007369365842
STAT,1856,17,45-49,1873,0.06185373942745411
STAT,1896,23,25-29,1919,76.89174022824598
STAT,1816,88,na,1904,60.914570014372885
SIM,1890,18,15-19,1908,11
STAT,1851,47,20-24,1898,0.009854053660327575
STAT,1908,35,15-19,1943,0.01850813628031407
STAT,1842,35,45-49,1877,1.8723535867881618
SIM,1847,22,40-44,1869,3
STAT,1865,29,20-24,1894,10.784549886504887
SIM,1864,72,na,1936,1149
STAT,1882,18,15-19,1900,5.882759176143371
SIM,1904,33,30-34,1937,13
STAT,1839,22,40-44,1861,1.8478263757223115
STAT,1919,47,40-44,1966,0.17450741080317986
SIM,1819,48,40-44,1867,1
STAT,1893,36,20-24,1929,1.0023928232790706
STAT,1875,26,45-49,1901,1.1664885900953987
SIM,1828,34,40-44,1862,4
STAT,1855,22,25-29,1877,51.84299663685022
SIM,1852,36,25-29,1888,3
SIM,1938,21,40-44,1959,6
STAT,1837,45,30-34,1882,0.06873551200451362
SIM,1876,18,na,1894,2927
SIM,1874,92,na,1966,94
STAT,1936,32,20-24,1968,2.4164371862646794
SIM,1863,36,35-39,1899,10
STAT,1857,53,50-100,1910,0.011839448807591848
SIM,1875,39,30-34,1914,10
STAT,1822,95,na,1917,7.730611077332217
STAT,1932,28,50-100,1960,1.328904018311879
STAT,1887,25,40-44,1912,3.4475608832574034
STAT,1916,20,35-39,1936,10.128759381704542
SIM,1913,15,na,1928,4227
STAT,1905,34,35-39,1939,8.49409109842059
STAT,1897,29,15-19,1926,0.6144437071366052
STAT,1908,47,30-34,1955,0.08221050798268384
STAT,1899,42,35-39,1941,0.17544795175836275
SIM,1902,20,15-19,1922,6
SIM,1913,34,35-39,1947,4
STAT,1895,24,20-24,1919,91.1490800118044
STAT,1901,16,20-24,1917,25.35326915962493
SIM,1813,80,na,1893,293
STAT,1867,70,na,1937,1343.7686566918608
SIM,1886,39,40-44,1925,8
STAT,1774,102,na,1876,0.05913591052904868
STAT,1910,28,30-34,1938,38.4543556314843
STAT,1914,12,na,1926,4168.163286452341
SIM,1894,3,na,1897,3590
STAT,1855,36,35-39,1891,5.509306119160574
STAT,1878,39,40-44,1917,4.6015174399598955
SIM,1833,32,40-44,1865,7
SIM,1892,38,20-24,1930,1
SIM,1951,7,na,1958,5317
STAT,1919,21,15-19,1940,5.966247440395037
SIM,1856,53,na,1909,2032
STAT,1818,80,na,1898,315.24706218363525
SIM,1895,25,40-44,1920,6
SIM,1904,22,25-29,1926,105
STAT,1826,45,20-24,1871,0.0096284310926755
STAT,1926,38,35-39,1964,3.0125685877294583
SIM,1837,39,45-49,1876,1
STAT,1851,18,20-24,1869,17.678218393761796
STAT,1905,20,25-29,1925,84.84574603318906
STAT,1877,15,na,1892,2684.724331484003
STAT,1919,21,30-34,1940,32.213311487612756
STAT,1858,48,20-24,1906,0.009586109888708508
STAT,1943,23,15-19,1966,5.776286473302514
STAT,1860,16,20-24,1876,17.024280784271365
STAT,1811,58,na,1869,1073.4949393339928
STAT,1817,42,50-100,1859,2.6562222108177544
SIM,1838,32,50-100,1870,1
STAT,1880,16,40-44,1896,0.19655906446483562
SIM,1854,24,25-29,1878,88
STAT,1825,32,40-44,1857,8.597645624799684
STAT,1884,38,20-24,1922,0.7741454778793044
SIM,1863,22,25-29,1885,81
SIM,1887,45,na,1932,2680
STAT,1884,24,45-49,1908,0.6993886632000744
SIM,1826,39,35-39,1865,12
STAT,1830,51,40-44,1881,0.007836858368472938
STAT,1859,41,na,1900,1891.521752798471
SIM,1814,47,45-49,1861,1
SIM,1934,8,na,1942,5665
STAT,1829,39,45-49,1868,1.697414223954665
STAT,1881,23,30-34,1904,17.5135676856473
SIM,1921,34,na,1955,4835
STAT,1907,18,30-34,1925,2.3811811733843746
SIM,1915,18,30-34,1933,3
STAT,1846,31,15-19,1877,0.1216042685971248
STAT,1873,38,45-49,1911,2.051536450046641
STAT,1815,45,45-49,1860,0.6564276595723146
STAT,1843,19,25-29,1862,5.777356820604708
SIM,1880,25,30-34,1905,4
SIM,1891,30,50-100,1921,1
SIM,1832,40,na,1872,1703
SIM,1881,24,35-39,1905,7
STAT,1858,37,15-19,1895,0.045429471169168116
STAT,1867,60,na,1927,1826.5664483232151
SIM,1918,23,30-34,1941,37
STAT,1859,0,na,1859,3182.2952151477953
SIM,1884,18,25-29,1902,1
SIM,1822,32,30-34,1854,14
SIM,1922,25,45-49,1947,2
STAT,1882,36,45-49,1918,1.9908162514587275
STAT,1926,44,na,1970,4655.255481159342
SIM,1885,9,na,1894,2642
SIM,1915,27,na,1942,4230
STAT,1869,48,30-34,1917,0.09414119673662504
SIM,1901,21,45-49,1922,4
STAT,1818,39,35-39,1857,21.20190263683179
STAT,1892,23,40-44,1915,2.6560459383445885
SIM,1881,38,45-49,1919,6
STAT,1799,61,na,1860,919.689688658646
SIM,1868,85,na,1953,244
STAT,1867,28,25-29,1895,40.370804903411496
STAT,1846,23,na,1869,1873.055768114068
SIM,1849,19,na,1868,2178
STAT,1951,11,na,1962,4772.632073557116
SIM,1848,20,35-39,1868,7
STAT,1917,26,25-29,1943,70.68308296223545
STAT,1835,24,15-19,1859,3.22193484898594
STAT,1885,37,25-29,1922,2.930385832223605
STAT,1889,20,30-34,1909,22.579960939968807
STAT,1940,18,15-19,1958,46.99379344413111
STAT,1817,47,20-24,1864,0.02681160686146437
STAT,1869,34,20-24,1903,2.6394720954067314
STAT,1814,46,40-44,1860,0.5187910781049789
SIM,1828,34,25-29,1862,11
STAT,1879,30,15-19,1909,0.15307778450541462
SIM,1807,73,na,1880,430
STAT,1854,42,na,1896,1766.7401953027381
SIM,1845,38,40-44,1883,3
SIM,1897,31,50-100,1928,1
SIM,1860,35,20-24,1895,1
SIM,1796,83,na,1879,85
STAT,1925,31,50-100,1956,1.002273743024131
STAT,1849,37,20-24,1886,0.6123794270266182
SIM,1891,71,na,1962,1820
SIM,1901,17,25-29,1918,11
SIM,1929,30,30-34,1959,30
STAT,1914,25,45-49,1939,1.7889983513931702
SIM,1862,23,20-24,1885,3
SIM,1819,36,40-44,1855,13
SIM,1874,33,40-44,1907,8
STAT,1881,37,40-44,1918,4.317432105752155
STAT,1927,16,40-44,1943,1.7784069892098187
STAT,1843,30,35-39,1873,10.0345315708061
STAT,1899,38,15-19,1937,0.01684794531322962
STAT,1877,18,40-44,1895,0.19302011760908253
SIM,1912,21,20-24,1933,157
STAT,1841,17,15-19,1858,5.651360162825525
SIM,1927,21,15-19,1948,2
SIM,1833,42,50-100,1875,4
SIM,1836,43,na,1879,1825
SIM,1833,28,20-24,1861,10
STAT,1869,23,30-34,1892,17.489258529506277
SIM,1845,45,30-34,1890,1
SIM,1877,4,na,1881,2837
SIM,1925,26,25-29,1951,137
SIM,1869,35,40-44,1904,7
SIM,1893,37,25-29,1930,5
STAT,1940,22,35-39,1962,9.78540221621358
STAT,1852,30,na,1882,2032.2007289951075
STAT,1841,35,45-49,1876,1.770574250233168
SIM,1843,24,15-19,1867,4
SIM,1831,25,35-39,1856,8
SIM,1851,23,45-49,1874,1
STAT,1930,26,40-44,1956,6.047464672832716
SIM,1915,21,50-100,1936,4
SIM,1950,14,na,1964,4736
STAT,1821,49,35-39,1870,0.2140939594292972
STAT,1917,33,15-19,1950,0.13674253541765405
SIM,1910,31,50-100,1941,4
SIM,1913,20,25-29,1933,115
STAT,1818,46,25-29,1864,0.1328737568007537
SIM,1896,18,na,1914,3414
STAT,1887,25,25-29,1912,48.684230658522296
STAT,1925,32,45-49,1957,1.9064468837341655
STAT,1939,29,30-34,1968,40.143468934657164
SIM,1863,29,45-49,1892,1
STAT,1848,42,50-100,1890,0.8202039834805038
SIM,1895,25,25-29,1920,90
STAT,1855,29,45-49,1884,0.8843047876504956
SIM,1798,64,na,1862,822
SIM,1861,20,na,1881,2612
SIM,1836,53,na,1889,1670
SIM,1864,39,20-24,1903,2
STAT,1843,23,45-49,1866,0.7015176373830562
STAT,1878,27,40-44,1905,3.18087316561365
STAT,1892,19,20-24,1911,22.545465952233336
SIM,1826,46,25-29,1872,1
SIM,1940,14,na,1954,4107
STAT,1856,23,na,1879,1974.305587687544
STAT,1929,39,15-19,1968,0.025091991818541357
STAT,1852,35,20-24,1887,0.6374687700439973
STAT,1913,29,45-49,1942,1.7435617211951906
SIM,1933,32,45-49,1965,1
STAT,1911,27,35-39,1938,14.934789743433404
SIM,1815,61,na,1876,1030
STAT,1912,9,na,1921,4093.015061494581
SIM,1885,23,na,1908,2396
SIM,1843,17,25-29,1860,12
SIM,1910,15,25-29,1925,17
STAT,1888,35,35-39,1923,8.611097439199265
SIM,1869,32,20-24,1901,4
STAT,1937,29,na,1966,3721.1535672089035
STAT,1925,39,30-34,1964,2.2270268195434313
STAT,1801,58,na,1859,980.8937021498274
SIM,1928,31,25-29,1959,22
SIM,1818,44,25-29,1862,2
SIM,1842,41,50-100,1883,2
STAT,1835,108,na,1943,0.0013647547634425639
SIM,1821,36,30-34,1857,9
SIM,1848,42,50-100,1890,2
SIM,1857,90,na,1947,25
SIM,1831,35,50-100,1866,2
STAT,1857,27,20-24,1884,9.627214519802727
SIM,1921,29,45-49,1950,4
STAT,1904,4,na,1908,3846.238658805827
STAT,1925,25,20-24,1950,22.145754635149217
STAT,1929,43,35-39,1972,0.26555649688185745
SIM,1870,25,20-24,1895,16
STAT,1843,26,15-19,1869,0.4540103615230208
SIM,1903,38,40-44,1941,2
SIM,1914,19,25-29,1933,15
STAT,1840,36,40-44,1876,3.7646175459274187
STAT,1940,15,45-49,1955,0.5177077749596053
SIM,1885,35,25-29,1920,2
STAT,1877,35,25-29,1912,3.0753705129085485
STAT,1804,76,na,1880,389.29563385224714
STAT,1848,15,45-49,1863,0.06369414735023757
STAT,1862,25,20-24,1887,10.373578733916995
STAT,1931,14,na,1945,5272.088218927041
STAT,1882,29,20-24,1911,11.576284116175714
STAT,1900,38,15-19,1938,0.017052730571746957
SIM,1825,29,25-29,1854,36
STAT,1840,22,30-34,1862,16.300278312747096
STAT,1873,49,50-100,1922,0.24870812663649328
STAT,1868,49,25-29,1917,0.05495174178421255
STAT,1888,49,45-49,1937,0.1571976582562353
STAT,1961,6,na,1967,5179.357929680239
STAT,1897,47,45-49,1944,0.1807389735707794
SIM,1933,25,20-24,1958,33
STAT,1846,24,40-44,1870,1.8123640763958684
STAT,1921,21,20-24,1942,128.54634812606804
SIM,1822,40,na,1862,1467
SIM,1803,80,na,1883,183
SIM,1848,43,40-44,1891,6
STAT,1878,46,30-34,1924,0.10308000178433306
SIM,1896,35,35-39,1931,15
SIM,1855,45,40-44,1900,1
STAT,1852,17,25-29,1869,5.52134654528817
STAT,1904,21,20-24,1925,101.05878952514918
SIM,1877,47,50-100,1924,1
STAT,1893,29,30-34,1922,32.35614634275089
SIM,1875,31,35-39,1906,3
STAT,1872,17,45-49,1889,0.06700735562167644
STAT,1934,37,30-34,1971,2.5648942991606143
SIM,1823,38,20-24,1861,4
SIM,1878,85,na,1963,470
STAT,1905,27,45-49,1932,1.6358590670765931
SIM,1851,30,35-39,1881,16
SIM,1905,27,na,1932,3414
STAT,1867,46,20-24,1913,0.011525411088156764
STAT,1934,32,na,1966,5266.031227273772
SIM,1851,19,25-29,1870,5
SIM,1865,27,20-24,1892,11
STAT,1826,38,30-34,1864,4.636981012200198
STAT,1941,11,na,1952,4145.876036406902
SIM,1837,43,30-34,1880,1
SIM,1909,26,40-44,1935,9
STAT,1833,38,50-100,1871,1.0058681150043391
STAT,1906,26,15-19,1932,0.6759901711122708
STAT,1951,18,25-29,1969,52.62677231292973
SIM,1932,29,na,1961,5070
SIM,1860,17,25-29,1877,11
STAT,1836,35,20-24,1871,0.6013336545782758
STAT,1909,31,15-19,1940,0.12557571775509088
SIM,1834,38,30-34,1872,3
SIM,1849,71,na,1920,1224
SIM,1866,34,45-49,1900,4
STAT,1895,24,50-100,1919,0.5393756415890458
SIM,1893,52,na,1945,2832
STAT,1857,39,20-24,1896,0.6079687257996267
SIM,1829,44,35-39,1873,6
STAT,1859,47,25-29,1906,0.046708802669103745
SIM,1854,24,40-44,1878,4
STAT,1797,89,na,1886,39.63655006987586
STAT,1893,21,35-39,1914,7.574765941080334
STAT,1931,17,45-49,1948,0.666834046477575
SIM,1892,24,45-49,1916,3
STAT,1832,23,35-39,1855,6.1379145357647324
SIM,1830,34,30-34,1864,7
STAT,1919,15,50-100,1934,0.08515975268481257
SIM,1820,37,25-29,1857,3
STAT,1932,16,50-100,1948,0.5071760255291237
SIM,1840,37,45-49,1877,5
SIM,1919,22,35-39,1941,10
STAT,1808,90,na,1898,26.246785649205012
STAT,1856,28,15-19,1884,0.37378632877223505
SIM,1858,85,na,1943,216
SIM,1881,20,na,1901,2134
STAT,1831,24,30-34,1855,22.31634689535651
SIM,1935,15,50-100,1950,1
STAT,1918,25,na,1943,4095.971382752358
SIM,1914,26,15-19,1940,1
STAT,1821,58,na,1879,1125.3664806788108
STAT,1867,21,40-44,1888,2.018443792567342
SIM,1830,27,40-44,1857,4
STAT,1846,24,25-29,1870,49.78858336166439
STAT,1896,48,40-44,1944,0.12848044310460083
SIM,1899,29,25-29,1928,86
STAT,1866,52,50-100,1918,0.014135583258251925
SIM,1889,44,40-44,1933,9
STAT,1829,43,30-34,1872,0.9517130055946568
STAT,1859,82,na,1941,380.131687529974
STAT,1887,15,na,1902,2900.518601521576
SIM,1851,26,15-19,1877,3
SIM,1840,19,15-19,1859,6
STAT,1902,22,15-19,1924,4.746126077728916
STAT,1880,89,na,1969,321.43811991810986
SIM,1857,38,na,1895,1978
SIM,1885,33,na,1918,2452
SIM,1922,18,20-24,1940,242
STAT,1832,37,45-49,1869,1.69296905193542
SIM,1859,20,45-49,1879,1
SIM,1890,29,20-24,1919,13
SIM,1864,28,15-19,1892,2
STAT,1896,34,30-34,1930,23.323003809437004
SIM,1834,30,35-39,1864,3
STAT,1840,38,na,1878,1804.0778828461716
STAT,1902,15,25-29,1917,8.190290689982511
STAT,1830,83,na,1913,251.13085461690423
SIM,1849,38,25-29,1887,4
STAT,1921,28,40-44,1949,5.28225566182604
SIM,1885,28,35-39,1913,15
STAT,1822,34,30-34,1856,39.9582724246578
SIM,1840,23,35-39,1863,8
SIM,1943,21,15-19,1964,6
SIM,1839,37,20-24,1876,3
STAT,1902,29,35-39,1931,13.782174622530688
SIM,1854,72,na,1926,1092
SIM,1872,15,na,1887,2661
SIM,1910,29,35-39,1939,24
SIM,1930,27,45-49,1957,7
STAT,1927,23,15-19,1950,6.669447049852808
SIM,1908,45,na,1953,3675
SIM,1825,40,35-39,1865,2
STAT,1851,22,40-44,1873,2.0530344569165435
STAT,1837,36,50-100,1873,1.0070430970555997
STAT,1857,49,15-19,1906,3.120333409421417E-4
STAT,1914,18,20-24,1932,28.53883730450021
STAT,1898,28,20-24,1926,16.127183843005202
SIM,1818,37,35-39,1855,9
STAT,1863,24,25-29,1887,51.476622707156835
SIM,1938,17,20-24,1955,139
STAT,1872,21,15-19,1893,3.3832034311652084
SIM,1871,24,25-29,1895,71
STAT,1884,31,35-39,1915,10.262841414049934
SIM,1892,31,35-39,1923,17
STAT,1889,16,45-49,1905,0.08251790732675135
STAT,1771,98,na,1869,0.5113340697659623
STAT,1918,15,na,1933,4324.0378976791635
SIM,1862,60,na,1922,1727
STAT,1822,48,40-44,1870,0.24055396628105527
STAT,1867,39,30-34,1906,5.052933074429122
STAT,1916,49,30-34,1965,0.09276079698448071
STAT,1931,24,35-39,1955,12.376782419106737
STAT,1817,40,35-39,1857,4.9163652201111026
STAT,1876,36,20-24,1912,0.8159432367861174
SIM,1868,25,30-34,1893,37
STAT,1922,27,45-49,1949,1.994696802177253
SIM,1924,20,35-39,1944,17
SIM,1913,31,30-34,1944,24
STAT,1898,21,na,1919,3272.558937852175
STAT,1925,35,15-19,1960,0.02355563854492803
SIM,1771,84,na,1855,63
STAT,1816,48,15-19,1864,8.093449490352709E-4
SIM,1814,44,40-44,1858,1
STAT,1826,48,25-29,1874,0.044417254143952756
SIM,1886,16,35-39,1902,1
SIM,1835,22,15-19,1857,3
STAT,1873,35,40-44,1908,4.570428012232163
STAT,1877,28,35-39,1905,10.17345867949464
STAT,1838,22,25-29,1860,54.57027098774635
STAT,1834,76,na,1910,636.6718742104487
STAT,1884,27,15-19,1911,0.45791408513677145
SIM,1859,71,na,1930,1088
SIM,1814,65,na,1879,935
SIM,1907,38,25-29,1945,2
STAT,1909,11,na,1920,3955.736216276133
SIM,1917,38,35-39,1955,5
SIM,1863,33,30-34,1896,23
STAT,1865,49,50-100,1914,0.22265375987186975
SIM,1833,35,45-49,1868,1
STAT,1827,48,25-29,1875,0.06382234147487724
SIM,1927,24,35-39,1951,21
STAT,1850,38,na,1888,1781.6443331932664
STAT,1825,35,45-49,1860,3.257293617250231
STAT,1936,35,25-29,1971,0.9875947305025653
SIM,1846,22,25-29,1868,73
STAT,1863,49,40-44,1912,0.1499328943759663
STAT,1828,90,na,1918,43.414877916208816
STAT,1848,19,50-100,1867,0.04665503951816373
STAT,1830,29,40-44,1859,3.0274390269322824
STAT,1866,33,40-44,1899,4.063500277034398
STAT,1877,36,20-24,1913,0.8195500326977544
STAT,1882,0,na,1882,3540.340274860046
SIM,1871,49,40-44,1920,1
STAT,1887,28,45-49,1915,1.2647568991087683
SIM,1881,35,40-44,1916,7
STAT,1935,21,15-19,1956,7.3948233679291535
STAT,1892,26,45-49,1918,1.424462917632898
SIM,1822,35,35-39,1857,9
SIM,1873,49,50-100,1922,1
SIM,1832,35,45-49,1867,2
SIM,1837,38,na,1875,1606
SIM,1828,31,20-24,1859,4
SIM,1838,31,30-34,1869,17
SIM,1879,25,40-44,1904,4
SIM,1834,48,25-29,1882,1
STAT,1855,33,30-34,1888,13.638801158677557
SIM,1907,20,35-39,1927,10
STAT,1813,91,na,1904,24.919146042933697
STAT,1928,44,30-34,1972,0.16568926831790348
SIM,1838,24,na,1862,1823
STAT,1916,20,50-100,1936,0.7078099627678671
STAT,1938,30,30-34,1968,16.178431588792222
STAT,1894,39,25-29,1933,3.7401097193950714
STAT,1847,34,35-39,1881,8.264404134735662
SIM,1855,27,45-49,1882,2
STAT,1883,39,15-19,1922,0.055643059129959496
STAT,1893,39,25-29,1932,3.688601277870673
SIM,1844,34,25-29,1878,15
SIM,1931,17,50-100,1948,4
STAT,1843,16,20-24,1859,18.397813974449306
STAT,1913,22,25-29,1935,91.31119379891553
SIM,1864,21,30-34,1885,27
STAT,1869,26,35-39,1895,9.53592384059912
STAT,1923,22,35-39,1945,11.178283174329847
SIM,1854,21,20-24,1875,77
STAT,1814,76,na,1890,441.4779773056499
STAT,1923,17,50-100,1940,0.4488684442230572
STAT,1841,28,20-24,1869,10.681311035245745
STAT,1837,48,35-39,1885,0.09566248797724773
STAT,1842,16,20-24,1858,17.95879436318173
SIM,1878,25,40-44,1903,5
SIM,1921,22,25-29,1943,157
STAT,1910,17,25-29,1927,8.757734794342799
SIM,1877,37,40-44,1914,7
SIM,1931,22,35-39,1953,15
STAT,1920,17,35-39,1937,4.804322457675268
STAT,1869,37,40-44,1906,4.31143943006946
STAT,1836,34,25-29,1870,7.893473829198637
STAT,1764,105,na,1869,0.03286576345064732
STAT,1897,69,na,1966,2285.4567403505025
STAT,1845,47,30-34,1892,0.07528177280149997
STAT,1876,74,na,1950,1169.083893829505
STAT,1938,25,na,1963,3789.196166830189
STAT,1857,49,na,1906,1755.0648107899835
STAT,1934,22,45-49,1956,1.5420394461126923
STAT,1945,9,na,1954,4386.429018540413
SIM,1823,80,na,1903,431
STAT,1856,21,30-34,1877,16.68627028164848
STAT,1849,47,15-19,1896,3.090961822243936E-4
STAT,1846,21,20-24,1867,61.24547183585387
STAT,1852,38,25-29,1890,2.307981313378934
SIM,1838,24,40-44,1862,2
STAT,1842,38,15-19,1880,0.05112470116751769
SIM,1849,31,40-44,1880,7
SIM,1916,32,45-49,1948,2
STAT,1886,84,na,1970,721.1398983764053
STAT,1897,15,40-44,1912,0.25064561411431013
STAT,1951,15,20-24,1966,164.784476834395
SIM,1943,18,40-44,1961,4
SIM,1868,36,50-100,1904,1
STAT,1941,29,20-24,1970,19.245652707047658
STAT,1895,27,40-44,1922,3.9871283414390772
SIM,1885,36,20-24,1921,4
SIM,1793,65,na,1858,683
STAT,1908,32,45-49,1940,1.5146196930293312
STAT,1913,26,40-44,1939,4.754198550183519
STAT,1849,41,na,1890,1802.4743787604643
SIM,1852,44,50-100,1896,2
STAT,1846,27,45-49,1873,0.9605460518882529
STAT,1836,27,35-39,1863,7.771893643459948
STAT,1861,75,na,1936,867.8038361071183
STAT,1906,19,25-29,1925,8.369093885876149
SIM,1860,38,25-29,1898,3
STAT,1909,1,na,1910,4162.983552112092
SIM,1890,34,na,1924,3171
STAT,1852,28,30-34,1880,23.45896132386888
STAT,1923,26,na,1949,4403.385028333228
STAT,1862,28,40-44,1890,2.5921910441283695
SIM,1844,27,35-39,1871,15
SIM,1895,22,20-24,1917,87
SIM,1855,34,35-39,1889,12
STAT,1828,36,40-44,1864,3.9232554115764
STAT,1862,24,25-29,1886,50.161560803513616
SIM,1860,28,30-34,1888,20
STAT,1935,18,40-44,1953,1.9448819193117837
SIM,1870,28,40-44,1898,6
SIM,1865,67,na,1932,1434
STAT,1921,33,50-100,1954,0.9349355248482738
STAT,1899,47,na,1946,3128.8883863769215
STAT,1905,31,30-34,1936,14.831187776603393
STAT,1907,37,20-24,1944,0.24921987053896277
STAT,1932,16,15-19,1948,61.435934991016055
SIM,1810,62,na,1872,1233
STAT,1917,37,30-34,1954,1.931838441294989
SIM,1888,29,15-19,1917,1
STAT,1871,85,na,1956,302.5142980386572
STAT,1876,15,20-24,1891,18.762526206195073
SIM,1836,36,40-44,1872,6
STAT,1830,43,50-100,1873,0.8984089230751365
SIM,1858,46,20-24,1904,1
SIM,1874,36,45-49,1910,8
STAT,1887,22,20-24,1909,78.77617262113681
SIM,1846,53,na,1899,1717
STAT,1946,21,25-29,1967,104.90741197013516
STAT,1897,22,30-34,1919,24.296605908789754
STAT,1834,42,na,1876,1703.261605497798
STAT,1899,28,20-24,1927,16.330794519533235
SIM,1870,24,25-29,1894,60
SIM,1829,37,45-49,1866,3
STAT,1824,35,45-49,1859,2.9774231146221712
SIM,1841,98,na,1939,3
STAT,1860,19,25-29,1879,5.346034308287642
STAT,1819,75,na,1894,606.9266027599986
STAT,1870,19,35-39,1889,0.5459315174710309
STAT,1870,38,na,1908,2337.8744873237615
SIM,1937,29,20-24,1966,21
STAT,1881,26,35-39,1907,9.549178276812013
STAT,1927,29,na,1956,4626.96004416367
SIM,1850,68,na,1918,1074
STAT,1855,46,50-100,1901,0.19092924562499963
STAT,1888,28,45-49,1916,1.334334546454268
SIM,1896,28,45-49,1924,2
STAT,1891,26,45-49,1917,1.407122914770414
SIM,1786,83,na,1869,77
STAT,1881,23,50-100,1904,0.4009516846392471
STAT,1927,23,30-34,1950,36.01006787154357
STAT,1875,48,20-24,1923,0.012406259627993604
STAT,1844,42,na,1886,1834.288972152232
SIM,1808,58,na,1866,1285
STAT,1866,36,45-49,1902,1.8848399342755364
SIM,1894,37,na,1931,3118
STAT,1844,29,35-39,1873,9.022221264509426
SIM,1881,74,na,1955,953
STAT,1884,17,20-24,1901,17.893098509580156
SIM,1896,46,40-44,1942,1
STAT,1877,70,na,1947,1484.5731227429528
STAT,1848,89,na,1937,81.66158106418294
SIM,1920,15,35-39,1935,9
SIM,1906,28,30-34,1934,60
STAT,1907,30,na,1937,3633.805316094114
STAT,1855,5,na,1860,2318.4680954687697
STAT,1915,39,20-24,1954,0.26900901239350866
SIM,1887,23,25-29,1910,73
SIM,1917,28,40-44,1945,8
SIM,1862,26,40-44,1888,2
SIM,1938,31,35-39,1969,18
SIM,1832,39,na,1871,1708
STAT,1878,55,na,1933,2195.6248688581545
STAT,1905,24,40-44,1929,3.050948631657338
SIM,1931,15,45-49,1946,1
STAT,1873,17,45-49,1890,0.0675597734709207
STAT,1935,25,30-34,1960,54.51602888608155
STAT,1858,41,35-39,1899,1.4715908438924115
STAT,1860,37,20-24,1897,0.6380426132457571
STAT,1827,94,na,1921,12.917388373842524
SIM,1841,29,25-29,1870,41
SIM,1801,88,na,1889,36
SIM,1855,2,na,1857,2636
STAT,1854,23,20-24,1877,61.52562965633034
SIM,1831,54,na,1885,1352
STAT,1833,29,25-29,1862,36.56135127535546
STAT,1881,19,45-49,1900,0.06408060651274892
SIM,1941,27,20-24,1968,27
SIM,1884,7,na,1891,2843
STAT,1830,36,30-34,1866,4.882918761051431
STAT,1883,17,20-24,1900,17.74564718209902
SIM,1921,26,40-44,1947,9
STAT,1914,28,15-19,1942,0.7235553009653322
SIM,1908,30,45-49,1938,1
SIM,1913,24,40-44,1937,3
SIM,1902,27,35-39,1929,23
STAT,1798,75,na,1873,509.82496322268827
SIM,1884,15,20-24,1899,23
STAT,1919,17,45-49,1936,0.5633338903390713
STAT,1878,49,35-39,1927,0.14555665296444395
STAT,1887,32,15-19,1919,0.16279096668478388
STAT,1863,45,25-29,1908,0.052034055240574875
STAT,1850,49,50-100,1899,0.1808842444507767
SIM,1869,35,25-29,1904,5
STAT,1888,46,40-44,1934,0.20705686690395053
STAT,1904,12,na,1916,3775.798345615971
SIM,1943,25,30-34,1968,2
STAT,1933,27,20-24,1960,24.71786361291572
STAT,1851,25,45-49,1876,1.0881004361460234
SIM,1897,20,30-34,1917,31
STAT,1931,21,30-34,1952,38.13179575757101
SIM,1839,31,50-100,1870,2
STAT,1879,23,25-29,1902,60.85551786314278
SIM,1877,34,20-24,1911,5
STAT,1837,38,40-44,1875,3.5168020091897603
STAT,1838,90,na,1928,57.92827638069866
STAT,1925,28,25-29,1953,79.03616096513856
STAT,1870,26,25-29,1896,42.33039904999096
STAT,1863,56,na,1919,1824.3541588087298
SIM,1902,20,na,1922,3420
STAT,1928,25,na,1953,4739.545032182587
SIM,1895,32,15-19,1927,3
STAT,1862,17,35-39,1879,0.545734666215202
STAT,1870,89,na,1959,160.41008520672088
SIM,1781,84,na,1865,110
STAT,1930,29,45-49,1959,2.2382612613511355
SIM,1869,38,45-49,1907,1
STAT,1856,39,20-24,1895,0.6110856522476269
SIM,1880,34,na,1914,2310
SIM,1892,17,20-24,1909,30
STAT,1799,108,na,1907,5.943739627977433E-4
SIM,1883,52,na,1935,2250
STAT,1869,41,na,1910,2286.659516235535
SIM,1847,38,na,1885,1671
SIM,1871,19,na,1890,2374
STAT,1844,44,50-100,1888,0.8172301092126629
SIM,1876,34,20-24,1910,3
STAT,1836,38,40-44,1874,3.3101213185226657
SIM,1878,6,na,1884,2942
STAT,1823,91,na,1914,32.25102335505629
SIM,1880,21,15-19,1901,4
STAT,1840,25,35-39,1865,8.783014024055335
STAT,1783,76,na,1859,377.27086073662053
STAT,1876,30,na,1906,2534.0165448092716
SIM,1933,28,25-29,1961,98
STAT,1871,26,25-29,1897,42.89332285262798
STAT,1899,35,45-49,1934,2.8112884903606155
STAT,1928,40,15-19,1968,0.0020024487451586197
STAT,1861,6,na,1867,2417.159862303862
STAT,1866,3,na,1869,2998.662687184489
SIM,1923,15,na,1938,4224
SIM,1844,38,40-44,1882,10
SIM,1911,34,na,1945,3780
STAT,1919,11,na,1930,4474.933864747248
STAT,1902,26,30-34,1928,36.35215113755104
STAT,1865,36,45-49,1901,1.8546587975256135
SIM,1840,34,40-44,1874,7
SIM,1868,21,15-19,1889,4
SIM,1863,47,40-44,1910,1
STAT,1847,27,45-49,1874,1.0406820533517125
STAT,1866,105,na,1971,0.35423283602492067
SIM,1905,32,35-39,1937,15
STAT,1820,102,na,1922,0.16146744953685085
SIM,1830,37,35-39,1867,4
STAT,1834,47,20-24,1881,0.008564245793010187
STAT,1862,71,na,1933,1159.1408966403249
STAT,1913,33,30-34,1946,15.923760755079154
STAT,1916,44,na,1960,3870.9722013475853
STAT,1938,23,40-44,1961,3.39347176027156
STAT,1863,35,30-34,1898,4.812323280430136
STAT,1911,30,50-100,1941,0.8278335298188725
SIM,1889,47,45-49,1936,1
SIM,1895,33,na,1928,3293
SIM,1928,7,na,1935,5273
SIM,1948,21,na,1969,4507
SIM,1805,51,na,1856,1173
SIM,1830,44,25-29,1874,2
SIM,1850,5,na,1855,2403
STAT,1858,34,45-49,1892,1.3986871171073334
STAT,1909,35,30-34,1944,1.7761111616892464
STAT,1886,15,30-34,1901,1.7290759001097362
STAT,1886,48,30-34,1934,0.10321244103148272
SIM,1834,20,40-44,1854,1
SIM,1921,33,30-34,1954,35
STAT,1839,75,na,1914,710.4779368072737
SIM,1922,28,15-19,1950,1
SIM,1844,72,na,1916,899
STAT,1821,44,50-100,1865,1.718286667761106
STAT,1928,33,25-29,1961,11.780952419393937
SIM,1874,29,20-24,1903,17
STAT,1893,22,na,1915,3060.7192902850525
STAT,1840,83,na,1923,285.67102710124675
SIM,1932,18,30-34,1950,27
SIM,1936,33,25-29,1969,7
SIM,1894,15,30-34,1909,4
SIM,1851,16,20-24,1867,18
SIM,1926,33,na,1959,4878
STAT,1822,37,35-39,1859,13.408055326997987
STAT,1939,8,na,1947,4063.826627866767
STAT,1832,34,40-44,1866,3.720441811578077
STAT,1855,47,40-44,1902,0.1320952258348845
STAT,1828,33,20-24,1861,2.579608463941325
SIM,1861,38,25-29,1899,4
SIM,1852,29,35-39,1881,1
STAT,1912,15,35-39,1927,0.8696063630836754
STAT,1812,95,na,1907,6.064177602740021
STAT,1902,19,40-44,1921,0.26172153550934324
SIM,1859,38,35-39,1897,13
STAT,1876,25,15-19,1901,0.48118611336125844
STAT,1941,27,50-100,1968,1.0504663477530882
SIM,1889,21,35-39,1910,11
SIM,1910,26,30-34,1936,62
SIM,1946,23,40-44,1969,5
SIM,1898,51,na,1949,3307
STAT,1844,36,25-29,1880,2.6179036856189515
SIM,1927,17,45-49,1944,2
SIM,1895,28,45-49,1923,4
STAT,1863,28,40-44,1891,2.6699558476183665
SIM,1900,6,na,1906,3768
SIM,1900,29,25-29,1929,72
STAT,1867,49,25-29,1916,0.05401353564107626
SIM,1871,28,40-44,1899,5
STAT,1924,18,30-34,1942,14.76998612628457
SIM,1873,36,45-49,1909,2
SIM,1898,30,25-29,1928,17
STAT,1822,44,25-29,1866,0.9422852807422955
SIM,1828,37,45-49,1865,5
STAT,1873,24,35-39,1897,5.997560530726659
STAT,1911,7,na,1918,4066.8491027618206
STAT,1946,10,na,1956,4446.3836817328065
STAT,1919,24,35-39,1943,10.455766358759375
STAT,1943,16,25-29,1959,46.89755114392201
STAT,1854,26,40-44,1880,2.6602701954984473
SIM,1836,33,20-24,1869,4
STAT,1824,76,na,1900,521.6549592167103
STAT,1896,37,35-39,1933,9.52972512178149
SIM,1951,16,25-29,1967,81
STAT,1853,38,25-29,1891,2.4022286043396344
STAT,1840,18,45-49,1858,0.06050142884477213
STAT,1871,52,40-44,1923,0.01058181519269811
STAT,1921,24,25-29,1945,105.7955678055274
SIM,1879,32,30-34,1911,41
STAT,1909,28,40-44,1937,4.5270378500262805
STAT,1877,39,40-44,1916,4.585157534977211
SIM,1934,20,45-49,1954,2
STAT,1879,20,20-24,1899,73.92363698402949
STAT,1962,8,na,1970,5135.176503927979
SIM,1858,25,20-24,1883,16
STAT,1829,46,35-39,1875,0.11477027819704334
STAT,1843,29,20-24,1872,11.48835501538537
STAT,1881,27,45-49,1908,1.0950668799860612
STAT,1820,47,25-29,1867,0.10506034770234782
STAT,1894,16,na,1910,3322.2859568300564
STAT,1883,64,na,1947,1740.0366882047329
SIM,1823,56,na,1879,1260
SIM,1870,58,na,1928,2108
SIM,1856,11,na,1867,2829
SIM,1948,20,45-49,1968,1
STAT,1911,49,45-49,1960,0.20864703043114982
SIM,1862,33,35-39,1895,16
SIM,1871,28,35-39,1899,12
SIM,1822,36,45-49,1858,8
SIM,1862,38,40-44,1900,2
STAT,1853,51,20-24,1904,6.217048929003844E-4
STAT,1863,28,35-39,1891,8.600121304006374
STAT,1871,31,15-19,1902,0.1444945548441554
SIM,1844,39,30-34,1883,9
STAT,1854,22,25-29,1876,51.478962130106495
STAT,1856,30,35-39,1886,8.381344971101669
SIM,1811,47,na,1858,1218
STAT,1963,7,na,1970,5092.460996063306
STAT,1879,59,na,1938,2072.4227151443765
STAT,1946,9,na,1955,4446.872837744959
STAT,1824,52,35-39,1876,0.009679623789712164
SIM,1858,33,15-19,1891,1
STAT,1827,50,50-100,1877,0.017026758290438825
STAT,1831,33,40-44,1864,3.9204963930448833
SIM,1817,38,50-100,1855,3
STAT,1950,20,35-39,1970,11.403689730299991
STAT,1844,19,40-44,1863,0.17805166499181932
STAT,1903,18,na,1921,3652.9488761941343
SIM,1862,22,25-29,1884,64
SIM,1885,38,35-39,1923,17
STAT,1845,40,30-34,1885,0.9384869003991083
STAT,1883,49,15-19,1932,3.9202608690124923E-4
STAT,1794,81,na,1875,217.12173433226377
STAT,1862,19,na,1881,2258.994860994633
SIM,1845,59,na,1904,1523
STAT,1858,65,na,1923,1367.1926361711664
STAT,1927,20,na,1947,4616.923102452138
SIM,1824,33,45-49,1857,2
STAT,1884,17,15-19,1901,5.9896389156123275
STAT,1849,17,20-24,1866,16.942060699113366
STAT,1852,38,30-34,1890,4.272220752472346
SIM,1851,29,20-24,1880,13
STAT,1875,69,na,1944,1536.5335616822085
STAT,1868,45,30-34,1913,0.0952590771379328
STAT,1790,91,na,1881,19.80129355791038
STAT,1843,32,20-24,1875,2.6233108663971367
STAT,1826,35,25-29,1861,2.698294586304673
STAT,1862,70,na,1932,1218.4296851181753
SIM,1872,41,25-29,1913,2
SIM,1830,24,30-34,1854,3
STAT,1923,48,25-29,1971,0.06313790073041295
STAT,1796,96,na,1892,1.8679620218385435
STAT,1840,20,30-34,1860,16.536895617151785
STAT,1812,103,na,1915,0.06545809212716387
SIM,1841,30,40-44,1871,10
STAT,1845,48,40-44,1893,0.13208581465151417
STAT,1877,38,35-39,1915,7.446639486488265
STAT,1850,42,35-39,1892,1.360425901522037
STAT,1803,83,na,1886,159.36437117388462
STAT,1874,26,45-49,1900,1.160418007389181
SIM,1864,30,35-39,1894,14
STAT,1879,48,40-44,1927,0.18026610365246443
SIM,1833,36,20-24,1869,1
STAT,1828,67,na,1895,872.9267333790258
STAT,1864,18,na,1882,2355.9601950101346
SIM,1818,49,30-34,1867,1
STAT,1960,6,na,1966,5221.341479253161
STAT,1894,35,30-34,1929,7.059987792885425
SIM,1840,36,na,1876,1763
SIM,1860,38,30-34,1898,8
STAT,1816,44,50-100,1860,2.277756227403932
SIM,1891,24,45-49,1915,5
STAT,1883,24,45-49,1907,0.6936252239187841
STAT,1944,23,15-19,1967,5.861994374537204
SIM,1870,34,na,1904,2621
STAT,1833,30,40-44,1863,3.7855260494418213
STAT,1885,46,15-19,1931,4.08267039375028E-4
SIM,1874,48,na,1922,2305
STAT,1893,26,25-29,1919,54.93210201631508
SIM,1882,26,45-49,1908,2
STAT,1859,39,25-29,1898,2.3221163430378096
SIM,1828,44,50-100,1872,3
SIM,1869,61,na,1930,1858
STAT,1938,25,40-44,1963,4.714601933618603
SIM,1857,17,20-24,1874,39
SIM,1859,48,35-39,1907,1
STAT,1827,44,30-34,1871,1.3117280448217294
STAT,1922,49,20-24,1971,0.012878188212831342
STAT,1837,95,na,1932,8.86448844913829
STAT,1849,40,45-49,1889,1.182239755746811
STAT,1872,34,40-44,1906,4.396025509225149
SIM,1865,87,na,1952,30
SIM,1891,43,50-100,1934,2
STAT,1811,54,20-24,1865,0.0018759047050657181
STAT,1923,46,na,1969,4395.865165191357
STAT,1845,24,25-29,1869,54.733258252951416
STAT,1828,32,25-29,1860,10.10678691462842
STAT,1867,26,50-100,1893,0.6147561508280152
STAT,1891,32,50-100,1923,1.1572162446118266
STAT,1843,16,15-19,1859,6.158590279070872
SIM,1836,43,35-39,1879,7
STAT,1864,52,35-39,1916,0.0077675533304854116
SIM,1835,44,30-34,1879,2
STAT,1880,53,30-34,1933,0.006278850562051605
STAT,1889,6,na,1895,3291.9454080176815
STAT,1911,45,na,1956,3564.3620415299924
STAT,1813,51,20-24,1864,0.0018069103657878272
SIM,1840,28,na,1868,1801
SIM,1851,32,20-24,1883,4
STAT,1895,34,35-39,1929,13.363831876395508
STAT,1841,19,15-19,1860,5.584983197659344
SIM,1874,37,20-24,1911,1
STAT,1846,47,45-49,1893,0.1679819280500175
SIM,1832,92,na,1924,8
STAT,1886,49,40-44,1935,0.1810040157595816
STAT,1845,39,na,1884,1894.3959437581982
STAT,1895,23,25-29,1918,75.95909457767212
STAT,1812,44,na,1856,1432.381922317103
SIM,1922,20,25-29,1942,4
STAT,1864,41,25-29,1905,0.5851249128015641
STAT,1877,16,50-100,1893,0.05196493329301841
STAT,1817,42,20-24,1859,0.3993013857085332
SIM,1910,48,na,1958,3449
STAT,1817,39,20-24,1856,2.252962508504763
STAT,1792,101,na,1893,0.09465214861145856
STAT,1847,43,45-49,1890,1.1586686215823236
SIM,1880,34,40-44,1914,7
STAT,1866,106,na,1972,0.1839566540761015
SIM,1870,29,30-34,1899,33
STAT,1896,32,30-34,1928,23.524410420512805
STAT,1947,18,45-49,1965,0.5739388758250573
SIM,1853,24,25-29,1877,69
STAT,1854,75,na,1929,787.9035539400224
STAT,1858,89,na,1947,84.98910488134463
SIM,1881,10,na,1891,2380
SIM,1886,36,30-34,1922,6
STAT,1838,17,45-49,1855,0.06339714048227986
STAT,1874,31,40-44,1905,4.535417624649467
STAT,1828,43,35-39,1871,1.4568353772270657
STAT,1845,90,na,1935,61.60183606891646
STAT,1880,40,25-29,1920,0.6953576751740469
STAT,1840,15,50-100,1855,0.04618740551248368
SIM,1838,40,35-39,1878,2
STAT,1767,111,na,1878,8.25753537878355E-4
SIM,1869,39,35-39,1908,5
SIM,1844,18,na,1862,2337
STAT,1866,37,20-24,1903,0.725345818815864
SIM,1886,41,na,1927,2562
SIM,1863,37,45-49,1900,2
STAT,1865,53,35-39,1918,0.007843166864286608
SIM,1887,35,35-39,1922,1
STAT,1837,18,40-44,1855,0.18702988611353416
SIM,1836,32,25-29,1868,13
STAT,1823,36,40-44,1859,8.474649896762465
STAT,1879,35,35-39,1914,7.613874799822437
STAT,1889,37,15-19,1926,0.0707628132765406
STAT,1949,15,45-49,1964,0.5930525970675367
SIM,1897,37,15-19,1934,1
STAT,1862,29,30-34,1891,21.711668129885275
STAT,1848,44,45-49,1892,1.147684414385864
STAT,1882,50,30-34,1932,0.0060011178611419
STAT,1862,44,25-29,1906,0.5501219717681158
SIM,1853,54,na,1907,1732
SIM,1860,42,45-49,1902,2
STAT,1807,73,na,1880,614.5081547322425
STAT,1821,80,na,1901,325.9626656638024
SIM,1841,77,na,1918,602
STAT,1829,41,30-34,1870,0.9779559394948726
SIM,1813,43,40-44,1856,2
SIM,1791,85,na,1876,73
SIM,1892,20,45-49,1912,4
STAT,1911,13,na,1924,4024.9374900392013
STAT,1897,31,35-39,1928,13.87014003851184
SIM,1828,87,na,1915,116
SIM,1837,41,30-34,1878,1
STAT,1812,50,20-24,1862,0.0017339951230865383
SIM,1851,16,15-19,1867,5
SIM,1849,41,na,1890,1818
STAT,1938,8,na,1946,4013.386044767985
STAT,1834,29,25-29,1863,36.794078095762494
STAT,1914,26,50-100,1940,1.027285004535278
SIM,1843,22,15-19,1865,2
SIM,1932,30,35-39,1962,5
SIM,1774,81,na,1855,191
STAT,1900,38,50-100,1938,0.3728346531047095
STAT,1890,27,40-44,1917,3.736477270301694
STAT,1867,36,25-29,1903,2.7707704245561495
STAT,1911,44,50-100,1955,0.11296948167130685
STAT,1894,19,25-29,1913,7.396106602264251
STAT,1925,32,50-100,1957,1.001692424253177
SIM,1870,66,na,1936,1724
STAT,1853,43,50-100,1896,0.8794344563630766
SIM,1906,20,40-44,1926,3
STAT,1914,20,25-29,1934,92.94555126088314
SIM,1915,30,35-39,1945,10
SIM,1868,35,25-29,1903,1
STAT,1883,32,na,1915,2388.6148839442576
SIM,1856,41,40-44,1897,3
STAT,1884,20,45-49,1904,0.7079937783697947
STAT,1939,24,45-49,1963,1.1519546391382163
STAT,1800,54,45-49,1854,0.059087945325026266
STAT,1899,28,15-19,1927,0.6315776936647327
STAT,1850,93,na,1943,21.983482313264037
STAT,1886,41,30-34,1927,1.2470428271923344
STAT,1887,46,na,1933,2579.170117919263
SIM,1837,47,45-49,1884,2
STAT,1879,18,45-49,1897,0.06947447856201135
STAT,1828,59,na,1887,1106.0862643878318
STAT,1870,23,20-24,1893,68.51150284070951
STAT,1866,45,50-100,1911,0.23340626717732896
STAT,1844,28,25-29,1872,39.83995378425449
STAT,1861,40,15-19,1901,0.011758712162288023
SIM,1852,28,25-29,1880,4
SIM,1919,18,35-39,1937,11
STAT,1767,103,na,1870,0.03471676152018889
STAT,1894,48,na,1942,2915.7285197399256
STAT,1870,41,50-100,1911,1.058327168832155
STAT,1880,42,20-24,1922,0.1700426646001544
STAT,1830,37,40-44,1867,3.955003394773986
STAT,1838,34,35-39,1872,9.056025998784074
STAT,1890,34,na,1924,2951.049840769632
SIM,1804,77,na,1881,435
STAT,1840,40,25-29,1880,0.543454085993408
STAT,1869,41,30-34,1910,1.1374414068736236
SIM,1936,9,na,1945,3479
STAT,1835,22,15-19,1857,3.2687049423737555
SIM,1900,46,30-34,1946,1
STAT,1833,25,45-49,1858,1.0010287419404063
STAT,1824,45,na,1869,1465.822421274714
STAT,1878,36,30-34,1914,5.686510400824308
STAT,1865,50,30-34,1915,0.005590684739487956
STAT,1904,48,15-19,1952,3.2574539208493576E-4
STAT,1830,30,15-19,1860,0.14095892211685535
STAT,1843,52,45-49,1895,0.011653112666158448
STAT,1819,50,30-34,1869,0.01180197422011979
SIM,1875,36,25-29,1911,8
STAT,1903,26,na,1929,3472.728382362683
SIM,1933,8,na,1941,5318
SIM,1877,49,40-44,1926,1
SIM,1894,30,20-24,1924,1
STAT,1835,35,20-24,1870,0.7252505779046853
SIM,1890,78,na,1968,1257
SIM,1897,37,45-49,1934,7
STAT,1900,53,na,1953,2995.670747282245
STAT,1946,23,50-100,1969,0.7468171780446712
SIM,1888,31,35-39,1919,19
SIM,1907,60,na,1967,3175
STAT,1928,18,35-39,1946,5.37897111701831
STAT,1835,37,na,1872,1972.7729285494238
STAT,1823,40,25-29,1863,1.0911967297158078
STAT,1879,51,40-44,1930,0.011279924852046447
STAT,1895,36,30-34,1931,7.1278688594427715
STAT,1930,38,15-19,1968,0.02552119024460346
STAT,1815,60,na,1875,1241.415618317709
SIM,1950,6,na,1956,4744
SIM,1826,29,40-44,1855,4
STAT,1869,29,40-44,1898,2.9292693960098246
SIM,1815,69,na,1884,705
STAT,1887,48,45-49,1935,0.2663896910232315
SIM,1887,48,40-44,1935,1
STAT,1850,25,45-49,1875,0.9971014571380047
STAT,1890,42,35-39,1932,2.2559139518384344
STAT,1841,57,na,1898,1483.8164070279222
STAT,1830,30,50-100,1860,0.9069243393988912
STAT,1864,24,35-39,1888,5.3014244863982
SIM,1938,20,50-100,1958,3
STAT,1861,48,25-29,1909,0.04794487537771778
STAT,1886,30,20-24,1916,2.942257234755834
SIM,1882,59,na,1941,1901
STAT,1890,31,25-29,1921,12.828188650538893
STAT,1840,26,45-49,1866,1.0034057118197828
STAT,1823,51,35-39,1874,0.012710635002260513
SIM,1795,75,na,1870,423
SIM,1936,18,35-39,1954,4
SIM,1873,23,na,1896,2318
STAT,1851,29,25-29,1880,40.27768004353178
STAT,1828,45,30-34,1873,0.0777244208164386
STAT,1870,30,15-19,1900,0.1431594207460948
STAT,1928,23,30-34,1951,36.49013229786453
STAT,1844,44,30-34,1888,0.8893386502124038
STAT,1869,49,40-44,1918,0.16509574318220296
STAT,1860,28,na,1888,1982.1896098925533
SIM,1787,88,na,1875,28
SIM,1861,41,na,1902,2468
SIM,1862,35,30-34,1897,9
SIM,1894,25,25-29,1919,61
STAT,1885,26,20-24,1911,11.980997365223557
SIM,1946,25,40-44,1971,8
SIM,1846,34,35-39,1880,9
SIM,1879,41,35-39,1920,6
SIM,1866,27,15-19,1893,1
SIM,1880,37,50-100,1917,5
STAT,1937,30,na,1967,3821.027157344877
SIM,1802,62,na,1864,888
SIM,1878,42,30-34,1920,4
SIM,1861,18,25-29,1879,15
STAT,1838,47,40-44,1885,0.12941174405627157
STAT,1880,20,30-34,1900,19.20922839016374
STAT,1896,15,40-44,1911,0.24758003933653405
STAT,1868,17,30-34,1885,1.581132974085298
STAT,1948,22,na,1970,4277.908214369531
SIM,1893,26,20-24,1919,26
STAT,1848,36,15-19,1884,0.04545253286053664
SIM,1941,20,35-39,1961,7
STAT,1825,39,25-29,1864,4.128431540896326
SIM,1936,23,30-34,1959,31
STAT,1862,9,na,1871,2423.1146960108285
STAT,1918,33,15-19,1951,0.1387620642223473
STAT,1854,35,30-34,1889,4.141430473132371
SIM,1877,25,25-29,1902,44
STAT,1848,87,na,1935,136.95115694824028
STAT,1907,30,35-39,1937,8.780168684745068
SIM,1845,35,30-34,1880,8
STAT,1889,37,45-49,1926,2.5120795725694958
SIM,1869,18,na,1887,2527
SIM,1828,79,na,1907,406
STAT,1839,51,40-44,1890,0.007300366091656167
STAT,1837,63,na,1900,1189.643020013518
SIM,1894,25,50-100,1919,1
STAT,1891,43,35-39,1934,2.270532903254749
STAT,1924,30,35-39,1954,10.92658964518463
SIM,1821,37,40-44,1858,6
STAT,1858,27,15-19,1885,0.3757462439071914
STAT,1870,14,na,1884,2617.1518849553413
SIM,1842,29,25-29,1871,3
SIM,1877,30,20-24,1907,3
SIM,1935,28,50-100,1963,3
STAT,1870,18,25-29,1888,5.671447674961449
STAT,1886,25,25-29,1911,45.98747788455069
STAT,1844,45,15-19,1889,3.148524107412828E-4
STAT,1840,51,35-39,1891,0.006224702341963714
STAT,1854,33,35-39,1887,7.855291655306404
STAT,1817,75,na,1892,502.4109842097489
STAT,1899,44,20-24,1943,0.015198249916967544
SIM,1921,38,15-19,1959,2
STAT,1821,40,15-19,1861,0.02555980262415368
STAT,1855,34,35-39,1889,7.829121524377402
STAT,1849,37,15-19,1886,0.04461042744907095
SIM,1847,46,45-49,1893,1
STAT,1837,35,30-34,1872,4.4171594143923
STAT,1913,38,15-19,1951,0.019237196408851576
STAT,1838,50,40-44,1888,0.008004908845121485
SIM,1773,88,na,1861,22
SIM,1846,47,40-44,1893,1
SIM,1861,34,30-34,1895,19
SIM,1846,84,na,1930,140
STAT,1809,45,20-24,1854,0.05519187471660765
STAT,1853,34,30-34,1887,14.766252644146531
STAT,1879,52,25-29,1931,0.0037569360183156955
SIM,1924,32,na,1956,4582
STAT,1870,38,25-29,1908,2.857074216925583
STAT,1877,51,50-100,1928,0.016056465527561924
STAT,1831,36,45-49,1867,1.774754824616628
SIM,1842,70,na,1912,1152
STAT,1851,21,50-100,1872,0.40467358102459194
STAT,1880,28,40-44,1908,3.2000293151693686
SIM,1832,84,na,1916,116
STAT,1910,45,35-39,1955,0.12326476155931461
SIM,1827,34,25-29,1861,5
STAT,1881,21,30-34,1902,17.620891232015328
STAT,1786,86,na,1872,58.92510411307262
STAT,1839,46,45-49,1885,0.16808748085966352
STAT,1865,59,na,1924,1799.4589547382675
STAT,1865,104,na,1969,0.5680099783119222
STAT,1889,42,40-44,1931,2.8309209968521567
SIM,1898,18,20-24,1916,35
SIM,1863,34,35-39,1897,18
STAT,1852,92,na,1944,33.552836025354374
STAT,1853,54,25-29,1907,0.002888300850899164
SIM,1837,44,35-39,1881,4
STAT,1810,85,na,1895,116.87264546566446
STAT,1850,30,40-44,1880,3.828672758686915
STAT,1868,46,15-19,1914,3.9085317501011115E-4
STAT,1832,29,15-19,1861,0.403388071142165
STAT,1870,51,20-24,1921,7.39420476816134E-4
SIM,1836,48,40-44,1884,1
STAT,1822,41,20-24,1863,0.25466826857110464
SIM,1823,35,50-100,1858,4
SIM,1937,31,25-29,1968,17
STAT,1918,16,25-29,1934,9.680738182043099
STAT,1832,32,na,1864,1870.632458338439
SIM,1863,56,na,1919,1704
STAT,1859,27,30-34,1886,20.870198158395414
SIM,1872,40,40-44,1912,5
SIM,1830,58,na,1888,1341
STAT,1871,22,25-29,1893,57.84810053357852
STAT,1896,35,35-39,1931,9.620230076012708
STAT,1862,52,50-100,1914,0.01304540906563928
SIM,1822,33,40-44,1855,3
STAT,1850,69,na,1919,1103.8932244095752
STAT,1807,52,35-39,1859,0.035571036187392734
STAT,1895,39,40-44,1934,5.767862987064695
STAT,1816,46,20-24,1862,0.02507960376328355
STAT,1895,57,na,1952,2674.8408578840376
SIM,1902,49,45-49,1951,2
STAT,1820,44,20-24,1864,0.2979458279703639
SIM,1867,46,na,1913,2036
STAT,1834,26,15-19,1860,0.40325766328860274
STAT,1822,52,30-34,1874,0.00815879906122892
STAT,1872,46,35-39,1918,0.14354655293438792
SIM,1899,48,na,1947,3120
STAT,1887,14,na,1901,2942.595164063387
SIM,1867,27,30-34,1894,31
STAT,1779,84,na,1863,84.39289457557064
STAT,1814,75,na,1889,485.36998505409167
STAT,1861,77,na,1938,728.6551272589762
STAT,1882,20,35-39,1902,5.834353016192744
SIM,1847,30,35-39,1877,15
STAT,1833,33,45-49,1866,1.4736613592796903
STAT,1864,40,40-44,1904,2.0608654742440056
SIM,1872,37,40-44,1909,9
SIM,1811,87,na,1898,15
STAT,1832,47,50-100,1879,0.194980605146305
STAT,1845,41,15-19,1886,0.011129609943896373
STAT,1867,53,45-49,1920,0.013675835766954926
STAT,1883,21,40-44,1904,2.092117898710794
SIM,1883,30,45-49,1913,1
STAT,1911,46,40-44,1957,0.15262842426512352
SIM,1833,34,na,1867,1840
SIM,1897,8,na,1905,3523
STAT,1901,39,35-39,1940,2.1559365038691007
SIM,1836,23,na,1859,2075
STAT,1829,44,35-39,1873,1.4788490455492689
STAT,1894,38,35-39,1932,9.235181518940383
STAT,1874,43,35-39,1917,1.8724499755135728
STAT,1849,72,na,1921,980.4617688067542
SIM,1825,90,na,1915,46
STAT,1848,41,50-100,1889,0.830779810467758
STAT,1853,18,25-29,1871,5.682132553230392
SIM,1841,33,45-49,1874,4
STAT,1842,108,na,1950,0.0014364460850343765
STAT,1882,53,40-44,1935,0.010295189189224821
STAT,1855,51,25-29,1906,0.0027588997199655893
STAT,1839,30,35-39,1869,8.781433437209909
STAT,1871,30,30-34,1901,17.785295226835686
SIM,1852,44,30-34,1896,1
STAT,1871,38,40-44,1909,4.401633482525306
STAT,1936,13,na,1949,3863.1143207799564
STAT,1903,22,15-19,1925,4.784128043317292
STAT,1835,29,50-100,1864,0.6125373199211455
STAT,1844,33,20-24,1877,2.478953874381251
STAT,1845,54,50-100,1899,0.011475981545079877
SIM,1969,2,na,1971,5106
STAT,1846,28,35-39,1874,8.287551365697922
STAT,1861,19,40-44,1880,0.1751323381579746
SIM,1854,28,35-39,1882,9
STAT,1933,20,35-39,1953,12.81328569415795
SIM,1812,47,40-44,1859,1
SIM,1808,59,na,1867,1285
SIM,1929,22,30-34,1951,53
STAT,1866,49,15-19,1915,3.685290673206396E-4
STAT,1881,24,40-44,1905,2.0423475752329674
SIM,1862,30,30-34,1892,23
SIM,1884,23,15-19,1907,3
SIM,1852,33,20-24,1885,6
STAT,1862,17,50-100,1879,0.04872630045567504
STAT,1878,85,na,1963,498.87913323872885
STAT,1875,30,45-49,1905,1.8404764588672782
STAT,1860,16,15-19,1876,5.698805863120212
STAT,1915,51,na,1966,3729.5025091474795
STAT,1895,20,20-24,1915,92.27055705652346
SIM,1939,30,45-49,1969,2
SIM,1882,43,35-39,1925,6
STAT,1881,52,35-39,1933,0.008445719011213063
SIM,1906,35,na,1941,3570
STAT,1905,49,20-24,1954,0.009764838693816925
STAT,1824,40,40-44,1864,2.884896673197464
STAT,1840,23,35-39,1863,5.301790190717217
SIM,1891,37,20-24,1928,2
SIM,1857,92,na,1949,10
SIM,1881,33,45-49,1914,1
STAT,1822,43,40-44,1865,3.399962472739162
STAT,1838,51,25-29,1889,0.0026404258951087224
SIM,1876,48,35-39,1924,1
SIM,1896,25,35-39,1921,19
SIM,1830,43,40-44,1873,2
SIM,1927,25,30-34,1952,62
SIM,1836,40,30-34,1876,4
STAT,1900,21,na,1921,3354.1558696017983
STAT,1853,26,na,1879,2116.5180981606777
SIM,1842,62,na,1904,1364
STAT,1938,28,45-49,1966,1.7451050402502073
SIM,1829,34,35-39,1863,12
SIM,1814,42,45-49,1856,3
STAT,1862,41,20-24,1903,0.13853726676472763
STAT,1848,41,40-44,1889,1.768800811770238
STAT,1861,45,20-24,1906,0.010216467660347095
STAT,1872,18,35-39,1890,0.5595466349660149
STAT,1857,16,na,1873,2162.2319992142284
STAT,1847,40,35-39,1887,1.4568264421073218
SIM,1795,67,na,1862,756
SIM,1929,36,50-100,1965,3
STAT,1875,27,20-24,1902,12.282954501636627
SIM,1931,34,na,1965,4877
STAT,1858,57,na,1915,1625.8068920400797
STAT,1818,43,20-24,1861,0.3905291254666942
STAT,1821,88,na,1909,72.34011217748512
STAT,1855,17,45-49,1872,0.06022872309992338
STAT,1845,24,50-100,1869,0.38989360286590385
STAT,1883,37,20-24,1920,0.7715930932339792
STAT,1891,31,40-44,1922,5.499647564119114
STAT,1874,34,45-49,1908,1.8007482505016499
STAT,1823,36,na,1859,1608.4981409504314
STAT,1882,48,50-100,1930,0.24102907171568963
STAT,1885,41,15-19,1926,0.014118948862225136
SIM,1881,31,25-29,1912,14
STAT,1828,48,40-44,1876,0.1321437040762282
STAT,1863,42,20-24,1905,0.1418757023698583
SIM,1818,44,30-34,1862,1
SIM,1811,79,na,1890,205
SIM,1926,16,25-29,1942,97
STAT,1836,50,30-34,1886,0.003900602959247151
STAT,1886,42,15-19,1928,0.014893661978082425
SIM,1918,12,na,1930,4561
SIM,1855,40,35-39,1895,3
SIM,1841,22,40-44,1863,2
SIM,1883,27,20-24,1910,15
STAT,1864,39,50-100,1903,1.1024552142947637
STAT,1923,45,20-24,1968,0.013252480742801893
SIM,1891,21,40-44,1912,5
STAT,1942,4,na,1946,4272.194241091124
STAT,1877,35,30-34,1912,5.692707150888556
SIM,1881,18,na,1899,2289
SIM,1885,35,30-34,1920,9
STAT,1881,41,25-29,1922,0.6362107075064942
STAT,1919,25,30-34,1944,43.496186861065446
STAT,1863,53,30-34,1916,0.005238781312096904
STAT,1893,43,45-49,1936,0.13352873662922882
SIM,1868,38,35-39,1906,12
STAT,1818,54,30-34,1872,0.012447361631373204
STAT,1868,3,na,1871,3079.9439675119065
SIM,1824,30,40-44,1854,7
SIM,1831,36,40-44,1867,7
STAT,1771,96,na,1867,1.3644149089724422
STAT,1828,40,30-34,1868,0.9711652743498261
STAT,1861,85,na,1946,231.08661844559006
STAT,1906,37,50-100,1943,0.3934803939053609
STAT,1861,28,30-34,1889,21.22824330382554
STAT,1868,48,35-39,1916,0.13469741486200135
SIM,1827,62,na,1889,1030
STAT,1826,52,45-49,1878,0.010949636241536472
STAT,1814,50,25-29,1864,0.010517002708271798
SIM,1815,43,45-49,1858,3
STAT,1885,34,20-24,1919,2.727561913887035
STAT,1885,45,30-34,1930,0.09950319936813909
STAT,1873,33,45-49,1906,1.7959364046660204
STAT,1890,30,40-44,1920,5.452827436605708
SIM,1832,40,40-44,1872,6
SIM,1778,95,na,1873,4
SIM,1814,40,25-29,1854,1
SIM,1911,33,na,1944,3809
STAT,1827,28,25-29,1855,96.94685271966989
STAT,1895,31,30-34,1926,23.33404453486894
SIM,1812,72,na,1884,462
STAT,1836,54,na,1890,1303.3512472246136
STAT,1859,23,15-19,1882,2.7686240351831177
STAT,1859,44,20-24,1903,0.12764086703361915
STAT,1920,23,50-100,1943,0.7441944847023728
STAT,1787,71,na,1858,698.633195908778
STAT,1883,56,na,1939,2041.6031535499626
SIM,1851,48,30-34,1899,1
STAT,1828,48,35-39,1876,0.10806144049845412
STAT,1886,21,na,1907,2561.518274383465
STAT,1832,40,na,1872,1752.7646524894012
STAT,1855,31,30-34,1886,13.925005857638817
SIM,1819,51,na,1870,1353
STAT,1853,37,35-39,1890,5.930635361701712
SIM,1906,23,45-49,1929,2
STAT,1825,48,15-19,1873,5.074651837026184E-4
SIM,1781,83,na,1864,110
STAT,1898,48,20-24,1946,0.009220855131898895
SIM,1835,28,25-29,1863,51
SIM,1842,26,20-24,1868,12
SIM,1825,42,20-24,1867,2
STAT,1824,33,50-100,1857,1.6217104906767457
SIM,1850,4,na,1854,2428
STAT,1886,28,35-39,1914,10.382354709576052
STAT,1900,27,25-29,1927,59.812083013034794
SIM,1852,69,na,1921,1188
SIM,1878,45,50-100,1923,1
STAT,1848,53,35-39,1901,0.006584657821057223
SIM,1907,20,na,1927,3604
SIM,1863,39,50-100,1902,2
STAT,1884,33,20-24,1917,2.716637399580147
SIM,1892,33,20-24,1925,7
STAT,1764,113,na,1877,7.817267295701805E-4
STAT,1829,52,na,1881,1511.4414037127672
SIM,1938,15,35-39,1953,7
STAT,1819,37,35-39,1856,20.050253124921813
STAT,1881,24,35-39,1905,5.719372310602443
STAT,1855,4,na,1859,2457.5663509314923
SIM,1855,26,na,1881,1947
STAT,1813,54,25-29,1867,0.008166685977947662
SIM,1914,22,na,1936,3734
SIM,1953,15,30-34,1968,14
SIM,1897,34,40-44,1931,3
STAT,1844,16,30-34,1860,1.5793358342664299
STAT,1865,41,40-44,1906,2.092034185906358
SIM,1867,23,15-19,1890,3
SIM,1861,37,35-39,1898,3
SIM,1877,44,35-39,1921,10
SIM,1863,31,30-34,1894,23
STAT,1812,53,25-29,1865,0.007836508008093601
STAT,1869,33,25-29,1902,10.045455890662069
STAT,1869,49,na,1918,2169.6211158563096
SIM,1788,73,na,1861,582
SIM,1836,48,35-39,1884,1
STAT,1891,46,45-49,1937,0.16861226664573248
SIM,1908,17,20-24,1925,37
SIM,1827,37,35-39,1864,8
STAT,1896,35,40-44,1931,5.954057937191071
SIM,1825,39,20-24,1864,2
STAT,1797,108,na,1905,4.612563620838708E-4
STAT,1861,25,20-24,1886,10.105684979910665
STAT,1900,38,35-39,1938,2.1478686746369284
STAT,1810,96,na,1906,3.660778328576557
SIM,1872,0,na,1872,3644
STAT,1832,32,45-49,1864,1.5294893488956207
STAT,1935,17,50-100,1952,0.5223188628398748
SIM,1884,39,30-34,1923,14
STAT,1833,25,15-19,1858,0.4090498113489631
STAT,1820,44,15-19,1864,0.025908334266319746
STAT,1876,39,30-34,1915,5.557828069164855
STAT,1934,30,na,1964,5271.986890696438
STAT,1824,77,na,1901,475.94755169014206
STAT,1880,45,25-29,1925,0.06236451524301851
SIM,1770,91,na,1861,4
STAT,1874,95,na,1969,63.59699300767685
STAT,1837,54,40-44,1891,0.006826220753679076
STAT,1871,34,25-29,1905,10.26178792632022
STAT,1869,44,35-39,1913,1.7594120512303046
STAT,1829,27,45-49,1856,1.5795800451117985
STAT,1809,48,30-34,1857,0.42340624250438774
SIM,1837,44,40-44,1881,2
SIM,1840,32,45-49,1872,1
SIM,1845,67,na,1912,1262
SIM,1869,34,35-39,1903,13
STAT,1854,38,35-39,1892,5.386443171257156
SIM,1873,41,40-44,1914,5
SIM,1872,81,na,1953,301
STAT,1844,40,15-19,1884,0.011244475279677053
STAT,1850,45,45-49,1895,0.17929014170373236
STAT,1904,11,na,1915,3781.4326803096324
SIM,1811,43,30-34,1854,2
SIM,1873,20,35-39,1893,8
SIM,1832,49,na,1881,1519
SIM,1877,33,25-29,1910,12
STAT,1832,29,45-49,1861,0.9871733030203534
STAT,1838,37,na,1875,1898.9055215439382
STAT,1845,27,35-39,1872,9.176503799225461
STAT,1866,52,45-49,1918,0.013583052338869205
STAT,1831,45,35-39,1876,0.11748463046795989
STAT,1842,36,20-24,1878,0.7165296706312639
STAT,1870,34,30-34,1904,17.262850921958258
STAT,1945,15,30-34,1960,13.591762765548253
STAT,1854,30,30-34,1884,13.971552488106456
SIM,1893,3,na,1896,3457
STAT,1827,47,35-39,1874,0.15723140047099826
STAT,1836,39,30-34,1875,3.9884181886311865
SIM,1828,38,35-39,1866,10
STAT,1866,44,na,1910,2145.451880787132
SIM,1894,28,35-39,1922,1
STAT,1860,44,15-19,1904,0.011276301292336541
SIM,1853,27,35-39,1880,20
STAT,1874,26,15-19,1900,0.4741809571705009
SIM,1860,56,na,1916,1849
STAT,1864,37,40-44,1901,3.9707553717635533
STAT,1849,29,na,1878,1962.377220440539
STAT,1919,41,na,1960,4113.023871247908
STAT,1889,45,45-49,1934,0.3003587860743033
STAT,1910,42,30-34,1952,0.12323085027517759
SIM,1850,36,20-24,1886,2
SIM,1874,16,na,1890,2592
STAT,1854,38,40-44,1892,3.3337242938731078
SIM,1876,29,25-29,1905,57
STAT,1831,47,na,1878,1625.6007909864231
SIM,1833,30,50-100,1863,4
STAT,1811,70,na,1881,710.6637558235565
STAT,1892,39,15-19,1931,0.07107447673502772
STAT,1920,39,45-49,1959,0.760080666882004
STAT,1854,50,25-29,1904,0.002749852632596821
SIM,1838,89,na,1927,33
SIM,1884,18,na,1902,2783
STAT,1865,20,35-39,1885,5.5481520517978975
SIM,1883,84,na,1967,648
SIM,1895,29,35-39,1924,17
SIM,1834,29,50-100,1863,1
STAT,1858,97,na,1955,4.346185211588664
STAT,1835,38,30-34,1873,4.860521354564724
STAT,1840,23,40-44,1863,1.8932319409128782
SIM,1879,71,na,1950,1511
SIM,1892,69,na,1961,2356
STAT,1843,48,30-34,1891,0.07716214513272378
STAT,1880,23,35-39,1903,6.236476993082692
SIM,1822,33,35-39,1855,14
STAT,1895,39,35-39,1934,9.319386806077635
SIM,1834,75,na,1909,763
STAT,1852,25,25-29,1877,40.26833677414516
STAT,1768,113,na,1881,6.561117287873144E-4
STAT,1888,44,45-49,1932,1.780614471508253
SIM,1948,22,40-44,1970,7
STAT,1830,33,25-29,1863,9.62712962618859
STAT,1834,26,20-24,1860,10.427090924286434
STAT,1929,31,25-29,1960,11.981255296327047
STAT,1857,20,50-100,1877,0.38051641471439523
SIM,1843,38,30-34,1881,15
STAT,1887,29,35-39,1916,10.951178697396472
SIM,1860,25,25-29,1885,9
STAT,1826,29,50-100,1855,1.0778120416762504
STAT,1861,45,15-19,1906,3.4054862245339816E-4
STAT,1939,21,40-44,1960,3.4458698018385308
STAT,1858,43,20-24,1901,0.1275528430580252
STAT,1849,54,50-100,1903,0.011402744056522685
SIM,1947,21,40-44,1968,4
STAT,1875,27,15-19,1902,0.4750313933748667
SIM,1893,16,25-29,1909,7
STAT,1898,27,45-49,1925,1.5317213626087447
SIM,1963,5,na,1968,5151
STAT,1870,35,20-24,1905,0.7760396467397225
SIM,1895,24,35-39,1919,11
STAT,1838,37,45-49,1875,1.7674073566169917
STAT,1872,69,na,1941,1500.4598731442338
STAT,1921,35,45-49,1956,0.7780960539065798
STAT,1843,67,na,1910,1279.7035724824257
STAT,1885,17,30-34,1902,1.6222065218314508
SIM,1916,27,20-24,1943,25
STAT,1864,43,45-49,1907,1.3477690082516678
SIM,1834,44,15-19,1878,1
SIM,1828,33,35-39,1861,15
SIM,1854,44,35-39,1898,6
STAT,1849,53,20-24,1902,5.636931046171448E-4
STAT,1855,34,40-44,1889,3.352667046519263
STAT,1890,35,40-44,1925,5.512076990257256
STAT,1894,72,na,1966,1971.203770417867
STAT,1943,15,na,1958,3984.3309805808653
STAT,1855,46,35-39,1901,0.1088358895303905
STAT,1876,39,25-29,1915,3.002504802492282
STAT,1763,114,na,1877,1.0437780227037772E-4
SIM,1796,60,na,1856,845
STAT,1887,24,35-39,1911,6.628972158634851
SIM,1886,15,25-29,1901,6
STAT,1797,70,na,1867,686.670999235778
STAT,1844,48,25-29,1892,0.04407405641379499
STAT,1835,54,30-34,1889,0.004346100953332868
SIM,1923,47,na,1970,4198
STAT,1906,45,20-24,1951,0.01015112361172139
STAT,1809,48,25-29,1857,0.25194420798763206
STAT,1939,21,35-39,1960,9.649783694789722
STAT,1893,35,15-19,1928,0.07336240449297254
STAT,1871,18,40-44,1889,0.1849260650089628
SIM,1863,34,40-44,1897,9
SIM,1889,46,na,1935,2938
SIM,1857,36,na,1893,1987
STAT,1901,36,30-34,1937,1.6489531970969096
SIM,1854,25,30-34,1879,6
SIM,1792,70,na,1862,591
STAT,1824,85,na,1909,150.94261491203667
SIM,1883,43,20-24,1926,1
SIM,1824,44,50-100,1868,2
SIM,1843,22,20-24,1865,63
STAT,1846,25,30-34,1871,22.101618905132714
STAT,1908,27,20-24,1935,17.745568907479374
STAT,1927,28,50-100,1955,1.2300077039339319
SIM,1894,45,25-29,1939,1
STAT,1916,21,40-44,1937,3.6063111042654357
STAT,1826,44,15-19,1870,0.01093379661403124
STAT,1816,49,25-29,1865,0.11467809393026532
STAT,1859,113,na,1972,1.3662293350734476E-4
SIM,1847,15,na,1862,2044
STAT,1846,44,35-39,1890,1.2774729213383595
SIM,1868,35,30-34,1903,7
SIM,1889,28,20-24,1917,17
SIM,1838,54,na,1892,1345
SIM,1861,15,20-24,1876,28
SIM,1921,32,na,1953,4862
SIM,1894,17,na,1911,3404
STAT,1919,33,30-34,1952,17.272730553315718
STAT,1886,45,25-29,1931,0.06281725563959824
SIM,1880,31,30-34,1911,31
SIM,1812,42,35-39,1854,2
SIM,1843,19,20-24,1862,17
STAT,1840,50,50-100,1890,0.01102408395439936
STAT,1842,100,na,1942,0.8325469296002779
STAT,1872,31,30-34,1903,17.924284619104487
STAT,1837,50,25-29,1887,0.0024659421011203075
STAT,1869,25,25-29,1894,41.94568173840704
STAT,1823,44,40-44,1867,3.460684171267686
SIM,1805,49,45-49,1854,1
SIM,1831,44,40-44,1875,6
STAT,1926,46,na,1972,4635.892250104024
SIM,1872,43,45-49,1915,5
SIM,1809,52,na,1861,986
SIM,1938,15,40-44,1953,2
STAT,1853,15,20-24,1868,18.094575242377616
STAT,1885,16,25-29,1901,5.781641068171169
STAT,1835,22,20-24,1857,68.27916603956649
STAT,1862,24,30-34,1886,15.608042222155552
SIM,1868,87,na,1955,127
STAT,1932,35,20-24,1967,0.36183228472345563
STAT,1862,109,na,1971,0.01053072046663326
SIM,1884,23,20-24,1907,77
SIM,1927,28,35-39,1955,28
STAT,1816,100,na,1916,0.47106614063706875
STAT,1815,49,na,1864,1530.3279055299074
SIM,1946,22,30-34,1968,62
STAT,1883,43,50-100,1926,1.0498328845556255
STAT,1896,18,45-49,1914,0.0877819094415827
SIM,1817,39,40-44,1856,3
SIM,1865,26,45-49,1891,2
SIM,1879,25,35-39,1904,17
SIM,1943,1,na,1944,4014
STAT,1864,45,40-44,1909,0.15684069118437077
SIM,1924,21,40-44,1945,6
SIM,1908,17,15-19,1925,7
STAT,1836,109,na,1945,4.428371608127114E-4
STAT,1835,38,25-29,1873,2.625798878281924
STAT,1815,49,50-100,1864,0.6390716638763672
STAT,1896,20,50-100,1916,0.5527160720355169
STAT,1829,44,40-44,1873,1.8369307024557513
STAT,1871,52,20-24,1923,7.417160470045684E-4
SIM,1917,27,na,1944,3906
STAT,1926,23,20-24,1949,137.38547729419025
SIM,1831,42,45-49,1873,1
SIM,1858,77,na,1935,745
STAT,1919,17,25-29,1936,48.86922485010416
SIM,1927,33,30-34,1960,6
SIM,1921,43,na,1964,4895
STAT,1904,6,na,1910,3819.4383416834603
STAT,1890,33,45-49,1923,2.165954633927197
STAT,1774,104,na,1878,0.023223576187779905
STAT,1914,10,na,1924,4180.779710253802
SIM,1843,38,25-29,1881,5
SIM,1894,33,25-29,1927,26
STAT,1875,80,na,1955,647.676907231056
SIM,1852,16,30-34,1868,2
SIM,1856,51,na,1907,2109
STAT,1910,45,40-44,1955,0.1507351937877778
SIM,1900,41,na,1941,3309
STAT,1917,46,35-39,1963,0.13776931662415423
SIM,1820,38,30-34,1858,2
SIM,1894,27,50-100,1921,1
SIM,1794,82,na,1876,158
SIM,1947,21,35-39,1968,19
STAT,1869,48,50-100,1917,0.2388541101114419
STAT,1924,31,na,1955,4504.407257911866
STAT,1896,74,na,1970,1922.102182431487
STAT,1835,43,20-24,1878,0.14003299694670424
STAT,1919,28,35-39,1947,16.495820445760266
SIM,1846,37,45-49,1883,6
STAT,1857,26,45-49,1883,0.917740613040108
STAT,1874,46,45-49,1920,0.2465064936809724
STAT,1920,22,15-19,1942,6.039193796972284
SIM,1883,76,na,1959,1218
STAT,1892,60,na,1952,2438.4472407147614
SIM,1917,38,na,1955,3823
STAT,1883,16,15-19,1899,5.954869639083712
STAT,1838,80,na,1918,454.5149562782889
STAT,1874,40,30-34,1914,1.2095332841707738
SIM,1858,36,25-29,1894,2
STAT,1867,33,15-19,1900,0.13581278609930794
SIM,1879,39,na,1918,2864
SIM,1866,72,na,1938,1440
STAT,1874,23,40-44,1897,2.1637092107877933
STAT,1901,28,50-100,1929,0.9093595851132008
SIM,1895,45,35-39,1940,1
SIM,1831,39,45-49,1870,3
SIM,1919,15,30-34,1934,3
SIM,1843,25,na,1868,2084
SIM,1903,45,45-49,1948,1
SIM,1850,89,na,1939,62
SIM,1853,28,40-44,1881,5
STAT,1811,59,na,1870,1052.4437035736532
STAT,1938,34,50-100,1972,0.8469539039536207
SIM,1880,15,30-34,1895,3
SIM,1882,46,45-49,1928,1
STAT,1878,32,50-100,1910,0.972925629180288
STAT,1841,101,na,1942,0.4213214506842244
STAT,1885,49,25-29,1934,0.05740003244482048
STAT,1910,26,50-100,1936,0.9836655854213884
STAT,1872,15,30-34,1887,1.6544113806358842
SIM,1946,19,na,1965,3921
STAT,1858,30,45-49,1888,1.4403698696054255
STAT,1938,22,30-34,1960,29.01678516672046
SIM,1832,60,na,1892,1201
SIM,1902,46,40-44,1948,1
SIM,1935,0,na,1935,5877
STAT,1870,54,25-29,1924,0.0034351809302914788
STAT,1919,40,50-100,1959,0.13027744074528697
SIM,1882,40,30-34,1922,2
STAT,1825,30,na,1855,1761.381258164891
SIM,1850,19,30-34,1869,2
STAT,1867,45,15-19,1912,3.869116277593609E-4
SIM,1927,17,25-29,1944,94
STAT,1813,53,40-44,1866,0.024764967942152157
STAT,1887,45,35-39,1932,0.16163419144063254
SIM,1868,84,na,1952,314
STAT,1845,28,40-44,1873,2.8284419422607496
STAT,1842,19,30-34,1861,1.5862092899362716
SIM,1893,54,na,1947,2796
STAT,1872,40,na,1912,2386.9243951145527
STAT,1876,54,na,1930,2205.8358334851378
STAT,1897,13,na,1910,3517.176847840837
STAT,1825,62,na,1887,1133.3505798051287
STAT,1846,21,na,1867,1900.2453288287584
STAT,1886,25,30-34,1911,27.376197624753523
STAT,1867,2,na,1869,3222.2076368195317
STAT,1847,37,40-44,1884,3.541796799321615
STAT,1836,42,25-29,1878,0.47552896684109663
STAT,1899,44,15-19,1943,0.001321587020681585
SIM,1844,34,30-34,1878,23
STAT,1882,53,35-39,1935,0.00841896314144474
SIM,1892,13,na,1905,3789
SIM,1863,21,na,1884,2121
SIM,1919,23,25-29,1942,162
STAT,1902,35,35-39,1937,2.2171347519798017
STAT,1909,43,15-19,1952,0.0014561298590119425
STAT,1931,17,50-100,1948,0.5001255348581812
SIM,1878,86,na,1964,398
SIM,1860,29,40-44,1889,4
STAT,1836,53,35-39,1889,0.005315951901867235
SIM,1827,34,30-34,1861,9
STAT,1836,34,30-34,1870,13.45534962979735
STAT,1878,51,25-29,1929,0.0037791217180016914
STAT,1831,30,30-34,1861,16.40718098580456
STAT,1910,28,na,1938,3676.526456133988
SIM,1953,18,35-39,1971,7
STAT,1845,44,25-29,1889,0.49801301081852806
SIM,1843,29,40-44,1872,3
SIM,1889,49,na,1938,2877
SIM,1848,27,20-24,1875,12
SIM,1907,16,15-19,1923,8
STAT,1894,16,20-24,1910,23.320837805032678
STAT,1926,43,15-19,1969,0.0019282919581603847
STAT,1863,44,40-44,1907,1.9847122001236677
STAT,1846,32,na,1878,1831.5355908377214
STAT,1927,22,25-29,1949,116.08887368557176
STAT,1915,20,40-44,1935,3.423716165553314
STAT,1847,40,40-44,1887,1.8095756478392782
SIM,1908,20,15-19,1928,6
STAT,1893,40,40-44,1933,2.9402643293829875
STAT,1879,38,45-49,1917,2.1152207270549934
SIM,1838,24,35-39,1862,7
SIM,1855,37,40-44,1892,4
STAT,1861,28,25-29,1889,35.65993286736902
SIM,1894,25,30-34,1919,39
STAT,1857,72,na,1929,1006.1722289513956
STAT,1851,42,20-24,1893,0.13086220014622016
STAT,1852,34,15-19,1886,0.11634147496036003
SIM,1853,32,25-29,1885,12
STAT,1934,17,20-24,1951,187.01039641698299
STAT,1904,3,na,1907,3865.178031158504
SIM,1942,17,20-24,1959,176
STAT,1851,39,20-24,1890,0.6295630378004435
STAT,1853,35,15-19,1888,0.04807359691951796
SIM,1958,12,na,1970,5139
SIM,1889,78,na,1967,1493
SIM,1835,25,20-24,1860,11
STAT,1835,19,20-24,1854,36.37417568032455
STAT,1769,112,na,1881,3.765875161001436E-4
STAT,1852,22,15-19,1874,3.1572222517711284
STAT,1877,36,15-19,1913,0.05970232777424397
STAT,1830,51,20-24,1881,5.493125238106065E-4
STAT,1888,25,35-39,1913,11.71575051703137
STAT,1904,41,50-100,1945,0.10774567358566123
SIM,1873,36,50-100,1909,2
STAT,1848,36,na,1884,1906.9711580024848
SIM,1828,35,30-34,1863,2
SIM,1858,33,20-24,1891,2
SIM,1895,26,30-34,1921,35
STAT,1823,39,15-19,1862,0.09715493097531738
SIM,1934,23,20-24,1957,153
SIM,1889,38,na,1927,3093
STAT,1826,39,40-44,1865,3.7122097375958774
STAT,1862,41,15-19,1903,0.012046719499760503
SIM,1918,22,25-29,1940,132
STAT,1842,15,45-49,1857,0.0665629872859563
STAT,1945,23,30-34,1968,32.127691728944626
SIM,1853,24,30-34,1877,25
SIM,1855,40,40-44,1895,1
STAT,1879,19,na,1898,2678.749688153912
SIM,1831,26,45-49,1857,1
SIM,1835,89,na,1924,72
STAT,1893,23,15-19,1916,4.256227771745835
STAT,1894,36,15-19,1930,0.07404169828536088
SIM,1939,30,na,1969,3943
STAT,1843,32,15-19,1875,0.1382062447426582
SIM,1925,17,na,1942,4987
SIM,1932,27,na,1959,5322
STAT,1887,26,30-34,1913,28.885057260215348
STAT,1935,33,15-19,1968,0.18119309467585132
STAT,1810,93,na,1903,12.459759513165233
SIM,1935,22,25-29,1957,129
SIM,1870,24,30-34,1894,24
STAT,1847,24,35-39,1871,5.498750741720446
STAT,1826,32,15-19,1858,0.15524482191634836
SIM,1856,44,45-49,1900,2
SIM,1907,21,40-44,1928,5
STAT,1786,110,na,1896,1.1939885296263196E-4
STAT,1797,100,na,1897,0.26733865754685154
SIM,1935,24,na,1959,5045
STAT,1836,35,15-19,1871,0.04380576842775423
STAT,1916,48,50-100,1964,0.2360812646670849
STAT,1929,22,35-39,1951,12.14464263330383
SIM,1931,10,na,1941,5186
STAT,1890,17,45-49,1907,0.08147916821343386
STAT,1926,35,na,1961,4698.711453259221
STAT,1899,31,45-49,1930,2.4460220721070836
SIM,1908,33,20-24,1941,3
SIM,1853,54,50-100,1907,1
SIM,1893,43,na,1936,3041
STAT,1862,32,25-29,1894,8.894677930300013
STAT,1814,86,na,1900,103.39146186065722
STAT,1888,38,40-44,1926,5.253171214956109
SIM,1855,24,35-39,1879,1
STAT,1845,24,30-34,1869,17.030550726172194
STAT,1852,29,40-44,1881,2.521220228184193
STAT,1872,61,na,1933,1910.548417168271
STAT,1827,45,15-19,1872,4.6152322039057307E-4
STAT,1857,26,15-19,1883,0.37501583011857875
STAT,1861,33,20-24,1894,2.268977013710608
STAT,1835,29,40-44,1864,2.86840161922224
SIM,1850,39,25-29,1889,3
SIM,1854,23,35-39,1877,8
STAT,1945,18,35-39,1963,4.6751552188530425
STAT,1920,36,40-44,1956,1.6741474493168484
SIM,1899,34,20-24,1933,3
STAT,1842,39,25-29,1881,2.3607442909713825
STAT,1897,15,35-39,1912,0.7519367988066838
SIM,1908,20,45-49,1928,1
SIM,1876,26,20-24,1902,17
STAT,1900,35,30-34,1935,7.607323097380063
SIM,1921,35,na,1956,4906
SIM,1900,70,na,1970,2373
STAT,1797,81,na,1878,215.38701807359593
STAT,1801,57,na,1858,1000.5137773231338
STAT,1946,22,35-39,1968,10.690480425523251
SIM,1839,36,45-49,1875,3
STAT,1846,23,35-39,1869,5.1120329256782355
STAT,1859,50,na,1909,1779.426785866431
STAT,1843,53,50-100,1896,0.011996285753893388
STAT,1793,96,na,1889,1.757888323500403
SIM,1825,41,50-100,1866,3
STAT,1867,50,40-44,1917,0.010227555866050807
STAT,1841,52,35-39,1893,0.006322682779240977
STAT,1900,24,20-24,1924,96.82881895850564
SIM,1833,23,na,1856,2056
SIM,1861,39,30-34,1900,13
SIM,1846,44,na,1890,1831
SIM,1812,64,na,1876,805
SIM,1896,38,40-44,1934,7
SIM,1880,34,35-39,1914,16
STAT,1844,45,20-24,1889,0.009445580630885733
STAT,1838,53,45-49,1891,0.01049182111882542
STAT,1825,70,na,1895,841.3714397200105
STAT,1860,29,20-24,1889,9.673904297069972
SIM,1871,25,30-34,1896,32
SIM,1839,33,40-44,1872,1
STAT,1842,15,15-19,1857,6.047248618625333
STAT,1876,35,15-19,1911,0.05971666635101524
STAT,1904,35,45-49,1939,0.63506727201669
SIM,1880,25,na,1905,2482
STAT,1888,41,40-44,1929,2.72494630110551
STAT,1883,24,na,1907,2352.5120019211563
STAT,1855,37,45-49,1892,1.545347461452048
STAT,1921,48,20-24,1969,0.012677369205923392
SIM,1822,71,na,1893,676
SIM,1878,24,35-39,1902,8
STAT,1840,44,40-44,1884,1.6456956670316942
STAT,1854,18,40-44,1872,0.16646997758159615
STAT,1836,22,na,1858,1756.3366014183468
SIM,1843,25,25-29,1868,46
SIM,1826,29,35-39,1855,12
STAT,1870,15,20-24,1885,18.060549578248562
STAT,1884,50,40-44,1934,0.01077806468476683
STAT,1903,58,na,1961,2996.77459421607
SIM,1856,36,45-49,1892,3
STAT,1898,24,40-44,1922,2.8567272629926728
SIM,1900,49,50-100,1949,1
SIM,1913,30,25-29,1943,11
SIM,1833,39,25-29,1872,4
SIM,1854,41,30-34,1895,1
SIM,1813,43,35-39,1856,4
STAT,1917,43,50-100,1960,0.12491500926316096
STAT,1910,46,25-29,1956,0.05060256488028982
SIM,1912,35,45-49,1947,1
STAT,1931,24,40-44,1955,4.419661842260113
SIM,1844,74,na,1918,756
SIM,1836,24,25-29,1860,80
STAT,1832,26,40-44,1858,2.7678869386684113
STAT,1860,32,20-24,1892,2.2373602570356415
SIM,1845,35,50-100,1880,1
STAT,1863,25,30-34,1888,22.85095529767915
STAT,1932,38,25-29,1970,1.3477798461537787
STAT,1848,98,na,1946,2.525198630987074
SIM,1893,29,25-29,1922,55
STAT,1876,23,20-24,1899,72.37012917582793
SIM,1821,33,25-29,1854,9
STAT,1868,24,na,1892,2290.000034955555
STAT,1891,40,30-34,1931,1.4666801010469046
STAT,1900,41,50-100,1941,0.10419980004179562
STAT,1854,54,40-44,1908,0.007835812376063405
STAT,1895,15,25-29,1910,7.577521042863958
STAT,1853,39,30-34,1892,4.423867044053257
SIM,1879,40,50-100,1919,5
STAT,1833,29,30-34,1862,21.764854781880043
SIM,1938,31,40-44,1969,3
STAT,1848,36,45-49,1884,1.6135647246567444
STAT,1863,40,25-29,1903,0.5801741509730496
STAT,1846,41,30-34,1887,0.8428351173718222
STAT,1910,48,45-49,1958,0.2062408289837492
STAT,1905,30,25-29,1935,15.212188067139474
SIM,1878,54,na,1932,2388
SIM,1829,29,na,1858,1590
STAT,1845,43,35-39,1888,1.4224509368203415
STAT,1861,44,30-34,1905,0.9560523212545287
SIM,1826,38,25-29,1864,6
SIM,1841,29,30-34,1870,34
STAT,1912,48,50-100,1960,0.22112702347034272
STAT,1874,28,na,1902,2476.9618640291887
STAT,1859,28,na,1887,1963.6960530937656
STAT,1867,49,30-34,1916,0.09077274827166339
SIM,1854,95,na,1949,18
SIM,1840,22,25-29,1862,54
STAT,1845,32,25-29,1877,9.515634716841255
STAT,1898,27,15-19,1925,0.6259064382105259
STAT,1860,36,na,1896,1959.4617110470695
STAT,1928,15,30-34,1943,15.738459746629463
STAT,1943,23,20-24,1966,120.65941409698127
SIM,1840,26,40-44,1866,7
SIM,1853,43,35-39,1896,1
STAT,1828,28,40-44,1856,3.7836516766032777
STAT,1876,26,25-29,1902,44.714483266186384
SIM,1874,17,20-24,1891,21
STAT,1814,54,40-44,1868,0.028853423146168542
STAT,1885,29,25-29,1914,42.74577778727081
SIM,1924,24,45-49,1948,2
STAT,1912,54,na,1966,3507.745887287246
STAT,1882,90,na,1972,269.1652386719695
STAT,1837,108,na,1945,0.001221258762185327
SIM,1870,27,35-39,1897,16
STAT,1865,44,45-49,1909,1.3670384421166655
STAT,1862,27,35-39,1889,8.410019173223422
STAT,1774,93,na,1867,4.673255434092638
STAT,1887,42,30-34,1929,1.312606116916417
SIM,1873,44,45-49,1917,7
SIM,1792,78,na,1870,294
SIM,1910,40,na,1950,3616
SIM,1895,42,30-34,1937,1
SIM,1907,28,na,1935,3725
STAT,1896,47,35-39,1943,0.10590668221169547
STAT,1906,17,45-49,1923,0.09699384336342642
STAT,1832,22,25-29,1854,94.3774189656228
STAT,1791,102,na,1893,0.05172722533241676
STAT,1912,7,na,1919,4109.930653662946
STAT,1881,45,40-44,1926,0.1705340601999906
STAT,1895,19,40-44,1914,0.2421404218434338
STAT,1929,3,na,1932,5279.603592178357
SIM,1890,34,50-100,1924,3
SIM,1850,15,15-19,1865,6
SIM,1869,36,30-34,1905,8
STAT,1837,35,50-100,1872,1.017554434362565
STAT,1861,21,na,1882,2062.9775833173608
SIM,1890,54,na,1944,2692
STAT,1906,48,25-29,1954,0.04763822220049543
STAT,1834,42,20-24,1876,0.12884158032754867
SIM,1825,82,na,1907,266
SIM,1936,15,30-34,1951,12
SIM,1894,68,na,1962,2194
STAT,1859,9,na,1868,2304.0619580095536
STAT,1874,32,50-100,1906,0.9543264164026116
SIM,1859,62,na,1921,1618
STAT,1863,87,na,1950,157.58520548925347
STAT,1842,51,45-49,1893,0.011435154270340395
SIM,1948,17,15-19,1965,50
SIM,1821,53,40-44,1874,1
SIM,1846,34,40-44,1880,8
STAT,1917,17,20-24,1934,29.772574009997832
SIM,1925,17,20-24,1942,1
STAT,1916,24,45-49,1940,1.195644064208017
STAT,1947,15,40-44,1962,1.6083959943590336
STAT,1896,42,na,1938,3120.9642547160397
SIM,1852,25,20-24,1877,14
STAT,1829,47,45-49,1876,0.19099284797031607
STAT,1838,88,na,1926,100.86941354636066
STAT,1834,39,20-24,1873,0.6319916000369338
STAT,1880,44,40-44,1924,2.378742415622838
STAT,1844,25,20-24,1869,11.290263053924255
SIM,1830,27,35-39,1857,12
SIM,1944,20,na,1964,3936
STAT,1896,38,45-49,1934,2.6726089659754417
STAT,1838,34,40-44,1872,3.8780647156910133
STAT,1866,17,20-24,1883,17.122738020262055
STAT,1844,19,35-39,1863,0.5341549640485206
STAT,1893,31,na,1924,3100.856494575002
SIM,1856,43,na,1899,2242
SIM,1884,26,25-29,1910,3
SIM,1905,21,30-34,1926,1
STAT,1836,37,35-39,1873,5.40413149694397
SIM,1949,21,15-19,1970,7
STAT,1895,35,25-29,1930,3.868638234913677
SIM,1891,16,15-19,1907,6
SIM,1866,10,na,1876,2719
SIM,1900,49,35-39,1949,1
STAT,1851,45,25-29,1896,0.04799476469593313
STAT,1893,39,30-34,1932,6.827836445453838
STAT,1942,23,50-100,1965,0.7036364712097418
SIM,1896,34,25-29,1930,3
STAT,1899,18,50-100,1917,0.06826085677929769
STAT,1931,20,25-29,1951,122.90915105223388
SIM,1876,28,na,1904,2721
SIM,1930,17,na,1947,5358
SIM,1879,6,na,1885,3294
STAT,1800,86,na,1886,88.5787566538619
STAT,1851,26,20-24,1877,11.414310502362914
SIM,1923,23,45-49,1946,1
STAT,1886,44,35-39,1930,1.9289452320828666
SIM,1832,43,45-49,1875,2
STAT,1915,23,45-49,1938,1.1831908217526352
STAT,1819,42,25-29,1861,1.3861578997976993
STAT,1886,33,25-29,1919,11.013414527223159
SIM,1808,67,na,1875,942
STAT,1873,27,40-44,1900,3.098160713908789
STAT,1888,34,25-29,1922,12.247028100486471
STAT,1830,54,25-29,1884,0.002484533368915302
STAT,1819,53,35-39,1872,0.016079153471066532
STAT,1895,23,50-100,1918,0.5410963279118055
STAT,1821,44,30-34,1865,1.8699002013727493
STAT,1823,42,45-49,1865,2.4210501837793736
STAT,1823,39,45-49,1862,3.4489996394533593
STAT,1885,46,20-24,1931,0.012248021955018791
SIM,1882,31,40-44,1913,7
SIM,1887,35,40-44,1922,1
STAT,1840,35,35-39,1875,6.146145804400363
SIM,1833,26,na,1859,1882
SIM,1939,32,40-44,1971,5
SIM,1827,42,25-29,1869,3
STAT,1879,15,40-44,1894,0.19594577339098077
STAT,1879,54,45-49,1933,0.015049822405933066
SIM,1881,27,40-44,1908,3
SIM,1836,28,40-44,1864,3
SIM,1836,74,na,1910,786
STAT,1873,30,40-44,1903,4.521300284118074
SIM,1815,40,40-44,1855,7
STAT,1948,1,na,1949,4794.608362485576
SIM,1866,21,na,1887,2349
STAT,1859,105,na,1964,0.12078976935014209
STAT,1862,62,na,1924,1587.2017805609719
SIM,1827,53,35-39,1880,1
STAT,1824,43,45-49,1867,1.8078591486315427
STAT,1879,35,40-44,1914,4.712304313562861
SIM,1858,21,na,1879,2001
SIM,1822,93,na,1915,20
STAT,1880,13,na,1893,2764.235040800652
SIM,1843,33,na,1876,1957
STAT,1808,49,20-24,1857,0.02955982624911012
STAT,1905,34,40-44,1939,3.6374271656323494
SIM,1897,24,45-49,1921,1
STAT,1818,38,25-29,1856,9.633147077300173
STAT,1889,24,45-49,1913,0.8732243641369076
SIM,1777,78,na,1855,277
STAT,1842,48,15-19,1890,3.0974015852241245E-4
SIM,1829,43,25-29,1872,1
STAT,1793,99,na,1892,0.3793711581646794
SIM,1886,39,35-39,1925,9
STAT,1809,53,20-24,1862,0.003072161369527121
STAT,1850,29,na,1879,1887.5161635126221
SIM,1865,23,40-44,1888,2
STAT,1854,52,20-24,1906,5.617634486995119E-4
STAT,1878,39,35-39,1917,7.434871635139516
STAT,1882,79,na,1961,893.5815647381078
STAT,1873,65,na,1938,1747.8430255847145
SIM,1865,36,na,1901,2275
STAT,1857,23,40-44,1880,1.9028555290387386
STAT,1938,23,na,1961,3685.5903216293814
STAT,1839,54,45-49,1893,0.009740243363216031
STAT,1852,95,na,1947,10.710907476575551
STAT,1891,34,45-49,1925,2.183587389094864
STAT,1831,33,35-39,1864,9.155112115561314
STAT,1861,15,25-29,1876,5.5557156537686865
STAT,1825,36,20-24,1861,1.2204113885531582
STAT,1876,44,20-24,1920,0.16504010120412815
STAT,1882,39,na,1921,2317.984442422969
STAT,1815,101,na,1916,0.2950554452623622
STAT,1901,14,na,1915,3672.2267207120058
STAT,1905,28,na,1933,3503.7941148532855
STAT,1862,45,30-34,1907,0.08489917654732589
STAT,1883,52,45-49,1935,0.014449093243298518
STAT,1875,43,20-24,1918,0.16507777457574924
SIM,1876,5,na,1881,3216
STAT,1837,38,35-39,1875,5.6822497894856365
STAT,1904,43,na,1947,3366.360082578446
STAT,1833,45,45-49,1878,0.18761022722630283
STAT,1892,27,20-24,1919,14.999386496461597
STAT,1873,23,50-100,1896,0.4204538309322639
STAT,1918,17,50-100,1935,0.08349007283375494
SIM,1892,17,15-19,1909,8
STAT,1881,36,35-39,1917,7.0094378261010855
SIM,1902,32,15-19,1934,1
SIM,1906,43,na,1949,3390
SIM,1899,37,25-29,1936,2
STAT,1780,78,na,1858,270.3594825824836
SIM,1834,96,na,1930,5
STAT,1873,54,na,1927,2165.6741537920575
STAT,1830,32,35-39,1862,9.68486136432418
SIM,1830,82,na,1912,267
STAT,1904,22,30-34,1926,26.04273051265837
STAT,1869,45,25-29,1914,0.05729630616737804
STAT,1847,62,na,1909,1425.288527944816
STAT,1859,36,20-24,1895,0.6310448274918566
SIM,1880,87,na,1967,167
SIM,1912,22,30-34,1934,33
STAT,1871,33,35-39,1904,10.19046363589154
STAT,1835,25,25-29,1860,41.69022670512996
STAT,1808,52,20-24,1860,0.0017610203682746108
SIM,1868,76,na,1944,945
STAT,1849,21,na,1870,2021.4531591711157
STAT,1921,32,50-100,1953,0.9388976730284541
SIM,1831,23,40-44,1854,5
SIM,1844,37,35-39,1881,10
STAT,1872,34,35-39,1906,10.265563940122975
SIM,1879,79,na,1958,1020
STAT,1826,48,30-34,1874,0.074645663933567
STAT,1880,24,25-29,1904,60.98481031134502
STAT,1827,49,30-34,1876,0.10581929502367607
STAT,1897,16,na,1913,3453.480195402228
STAT,1911,22,30-34,1933,27.804208953277303
SIM,1919,20,20-24,1939,148
SIM,1845,38,35-39,1883,6
SIM,1871,51,na,1922,1997
SIM,1867,39,25-29,1906,2
SIM,1891,28,na,1919,3043
STAT,1847,73,na,1920,926.2249799822118
STAT,1856,30,50-100,1886,0.7583015702989282
SIM,1849,22,45-49,1871,1
STAT,1908,34,50-100,1942,0.7890036534255654
STAT,1813,102,na,1915,0.12607326342067113
STAT,1834,44,na,1878,1660.1725835044535
STAT,1850,33,45-49,1883,1.3580070372441126
STAT,1886,39,50-100,1925,1.3123885952326935
SIM,1848,101,na,1949,1
STAT,1820,43,30-34,1863,2.220692034163426
STAT,1875,19,50-100,1894,0.05101993433791543
STAT,1913,17,na,1930,4028.5378086466358
STAT,1814,45,35-39,1859,0.4311737755634319
SIM,1877,13,na,1890,2714
STAT,1832,45,15-19,1877,3.2581133834514467E-4
SIM,1877,29,40-44,1906,9
STAT,1845,47,na,1892,1749.7107630236187
SIM,1808,56,na,1864,1320
SIM,1916,34,50-100,1950,2
STAT,1822,65,na,1887,993.7278695423496
STAT,1834,42,15-19,1876,0.011203616285773424
STAT,1873,57,na,1930,2078.4600223988127
STAT,1910,43,20-24,1953,0.01692074322230704
STAT,1865,20,40-44,1885,1.98120602657876
SIM,1891,17,na,1908,3314
SIM,1887,16,30-34,1903,1
STAT,1826,55,na,1881,1299.4698309742487
STAT,1845,25,15-19,1870,0.4377522016222735
STAT,1847,33,25-29,1880,9.281250807706416
STAT,1829,53,30-34,1882,0.004154318155081707
STAT,1875,58,na,1933,2070.565634077775
SIM,1768,96,na,1864,2
STAT,1873,51,40-44,1924,0.0109403130802238
SIM,1802,73,na,1875,469
STAT,1830,60,na,1890,1206.4668796829712
STAT,1836,30,15-19,1866,0.11440092795337412
STAT,1766,104,na,1870,0.044804054824862605
STAT,1865,17,40-44,1882,0.17451256209364002
STAT,1858,42,45-49,1900,1.2093026981465478
SIM,1830,80,na,1910,388
SIM,1903,32,30-34,1935,23
SIM,1813,49,na,1862,1353
STAT,1860,92,na,1952,34.47381357983002
SIM,1857,28,50-100,1885,1
STAT,1856,54,45-49,1910,0.011302005842894302
STAT,1894,43,25-29,1937,0.05809265351087947
STAT,1861,47,35-39,1908,0.11746535933881597
SIM,1817,39,na,1856,1459
SIM,1919,42,35-39,1961,1
STAT,1864,82,na,1946,423.22866969311735
SIM,1910,35,40-44,1945,1
SIM,1858,23,na,1881,2181
STAT,1922,21,35-39,1943,11.050996826635643
SIM,1926,12,na,1938,5270
STAT,1934,19,na,1953,5049.9461492112305
SIM,1926,10,na,1936,5287
SIM,1896,40,na,1936,3182
SIM,1914,33,45-49,1947,6
SIM,1900,28,35-39,1928,24
STAT,1833,42,40-44,1875,1.8033617850006667
STAT,1827,74,na,1901,717.2778079495827
STAT,1896,28,na,1924,3204.171787361377
SIM,1821,78,na,1899,369
STAT,1896,31,25-29,1927,13.856805445484312
STAT,1902,35,40-44,1937,1.3722071783670773
SIM,1822,85,na,1907,143
SIM,1855,33,25-29,1888,12
STAT,1813,50,30-34,1863,0.014871042263599372
SIM,1887,12,na,1899,3058
STAT,1880,21,20-24,1901,74.09927295909655
SIM,1908,15,50-100,1923,2
STAT,1911,8,na,1919,4057.780029262662
SIM,1889,24,40-44,1913,3
STAT,1863,44,35-39,1907,1.5978227915288363
STAT,1848,58,na,1906,1537.2520050443572
STAT,1940,2,na,1942,4218.981353326947
STAT,1880,41,30-34,1921,1.2380550632668585
STAT,1918,4,na,1922,4483.11673590493
STAT,1856,42,35-39,1898,1.4483206950088765
STAT,1866,103,na,1969,1.1421605954993193
STAT,1805,61,na,1866,1145.3596590913771
STAT,1831,54,40-44,1885,0.007279766809722562
STAT,1829,40,25-29,1869,0.5537565890637832
STAT,1873,23,25-29,1896,59.02330262077464
SIM,1850,35,na,1885,1851
SIM,1910,22,20-24,1932,157
SIM,1892,32,45-49,1924,4
SIM,1905,24,35-39,1929,12
STAT,1865,48,50-100,1913,0.22454442392128693
STAT,1859,39,50-100,1898,0.9901932242443803
STAT,1886,27,50-100,1913,0.690747582144327
STAT,1882,44,45-49,1926,1.4673978580672566
STAT,1805,93,na,1898,11.746471393326892
STAT,1839,30,40-44,1869,3.760475861112311
STAT,1839,27,40-44,1866,2.6044256848067597
STAT,1871,15,15-19,1886,6.107474798679181
STAT,1921,22,30-34,1943,33.12624184757784
SIM,1950,3,na,1953,4792
SIM,1868,19,25-29,1887,7
SIM,1871,44,35-39,1915,4
STAT,1836,26,50-100,1862,0.5189773798625685
STAT,1827,96,na,1923,5.549722745627379
STAT,1844,50,50-100,1894,0.011871473777394954
STAT,1930,40,25-29,1970,0.09609350799922511
STAT,1852,63,na,1915,1437.4384253112041
STAT,1827,52,25-29,1879,0.0038378304416093723
SIM,1928,17,40-44,1945,2
STAT,1879,36,50-100,1915,1.3155109337847937
SIM,1873,32,35-39,1905,14
STAT,1871,15,50-100,1886,0.050419429522255296
STAT,1917,49,45-49,1966,0.23030587419790713
SIM,1842,48,na,1890,1622
STAT,1944,22,25-29,1966,101.7525868917923
SIM,1869,72,na,1941,1056
SIM,1825,41,45-49,1866,5
STAT,1894,27,na,1921,3131.6392544315777
STAT,1877,16,20-24,1893,18.804380975163568
SIM,1825,68,na,1893,892
SIM,1909,17,30-34,1926,4
STAT,1815,53,45-49,1868,0.03655787524244582
STAT,1875,43,15-19,1918,0.014354589868847235
SIM,1873,20,40-44,1893,4
SIM,1935,27,25-29,1962,102
STAT,1938,5,na,1943,4045.9499819749913
STAT,1809,110,na,1919,1.4098524333671468E-4
STAT,1869,20,na,1889,2353.285433658112
STAT,1896,44,30-34,1940,0.10611445013119188
STAT,1884,32,45-49,1916,1.7600094196697653
SIM,1872,40,35-39,1912,5
STAT,1913,25,na,1938,3833.7870714001037
SIM,1863,30,25-29,1893,10
STAT,1850,82,na,1932,350.96555812622233
STAT,1866,16,45-49,1882,0.06346420422743441
STAT,1922,34,40-44,1956,4.489550154664424
SIM,1870,32,25-29,1902,18
STAT,1811,104,na,1915,0.028891683798020335
SIM,1855,66,na,1921,1257
STAT,1850,29,30-34,1879,21.971937223659808
STAT,1946,12,na,1958,4445.183238173645
STAT,1955,3,na,1958,5326.202360311543
STAT,1817,49,40-44,1866,0.37081544920514514
STAT,1847,44,50-100,1891,0.8127147053608903
SIM,1827,49,na,1876,1414
STAT,1904,32,40-44,1936,3.6407526410126647
STAT,1904,17,50-100,1921,0.07162935178284685
SIM,1910,19,35-39,1929,1
SIM,1880,79,na,1959,613
SIM,1890,44,45-49,1934,5
STAT,1885,68,na,1953,1555.3670566570195
STAT,1927,27,25-29,1954,81.62496666403395
STAT,1902,22,20-24,1924,99.14064934555805
STAT,1930,29,na,1959,4853.442231624066
SIM,1912,32,40-44,1944,5
STAT,1864,40,35-39,1904,1.6591311449674044
SIM,1904,38,20-24,1942,3
STAT,1845,41,20-24,1886,0.12799050744192983
STAT,1832,50,40-44,1882,0.007650129692141585
SIM,1940,23,45-49,1963,2
STAT,1877,31,15-19,1908,0.1512953328858445
STAT,1856,87,na,1943,141.0861882418203
STAT,1822,38,50-100,1860,2.211304734885006
STAT,1788,96,na,1884,1.760188159785609
STAT,1928,22,40-44,1950,4.282109527475673
STAT,1908,27,15-19,1935,0.6862927256814663
STAT,1940,17,50-100,1957,0.3880750695588155
STAT,1850,21,35-39,1871,5.3065810526325725
SIM,1880,33,na,1913,2325
STAT,1937,32,35-39,1969,9.222112939593618
STAT,1797,59,na,1856,1016.9120961217998
STAT,1880,27,na,1907,2558.423584234391
SIM,1851,84,na,1935,129
STAT,1924,39,35-39,1963,2.9037031621498604
SIM,1886,32,50-100,1918,1
SIM,1928,5,na,1933,5300
STAT,1778,101,na,1879,0.08790185212252952
STAT,1853,42,25-29,1895,0.5377849117967489
STAT,1881,20,25-29,1901,56.796926005792585
STAT,1932,23,45-49,1955,1.5009349977064967
STAT,1872,18,na,1890,2575.4890893472602
STAT,1843,53,20-24,1896,5.861377636249707E-4
STAT,1881,40,35-39,1921,1.8039857413210976
STAT,1815,71,na,1886,777.7137054751381
STAT,1834,41,45-49,1875,1.229847792118504
STAT,1917,33,20-24,1950,2.59552800763645
SIM,1815,91,na,1906,8
STAT,1920,19,na,1939,4191.637422844508
STAT,1855,15,30-34,1870,1.4870469669071185
STAT,1869,15,15-19,1884,5.996356754777075
SIM,1900,27,na,1927,3383
STAT,1922,28,20-24,1950,21.001758430122642
SIM,1932,39,35-39,1971,8
STAT,1889,21,40-44,1910,2.633826249108673
STAT,1897,43,35-39,1940,0.17028395190874646
STAT,1923,49,na,1972,4359.2613520215045
SIM,1930,28,20-24,1958,27
SIM,1881,34,50-100,1915,2
SIM,1897,21,40-44,1918,3
STAT,1814,42,30-34,1856,3.940864130653222
STAT,1895,32,20-24,1927,3.5978007761430386
STAT,1880,47,45-49,1927,0.2518194943157017
SIM,1870,55,na,1925,2225
SIM,1925,20,15-19,1945,10
STAT,1840,32,30-34,1872,15.302836491059644
STAT,1831,49,15-19,1880,3.188277918994126E-4
STAT,1814,78,na,1892,364.0910403375284
SIM,1863,15,30-34,1878,1
SIM,1916,27,15-19,1943,1
SIM,1919,22,40-44,1941,6
STAT,1926,41,50-100,1967,0.1479608290832302
STAT,1921,12,na,1933,4608.769984562063
SIM,1883,45,50-100,1928,1
SIM,1888,43,35-39,1931,6
STAT,1855,38,na,1893,1817.2907509714698
STAT,1927,43,30-34,1970,0.163297923089666
SIM,1925,46,40-44,1971,1
STAT,1907,39,35-39,1946,2.263701334378464
SIM,1915,39,35-39,1954,6
STAT,1879,19,35-39,1898,0.5819808672933126
SIM,1847,27,40-44,1874,7
STAT,1767,114,na,1881,2.032203321780037E-4
SIM,1873,85,na,1958,241
STAT,1923,30,40-44,1953,4.614135235295054
STAT,1908,30,15-19,1938,0.12468429578385402
SIM,1836,41,20-24,1877,2
SIM,1877,15,15-19,1892,7
STAT,1817,107,na,1924,0.0023015388568600205
SIM,1825,36,na,1861,1655
SIM,1842,22,35-39,1864,9
SIM,1804,66,na,1870,927
STAT,1934,33,20-24,1967,3.3941195167104516
SIM,1851,31,45-49,1882,4
STAT,1871,50,50-100,1921,0.015481017410115478
STAT,1877,39,na,1916,2467.73718525007
SIM,1847,30,40-44,1877,7
STAT,1953,17,25-29,1970,53.474132496606636
SIM,1832,39,30-34,1871,13
STAT,1860,32,15-19,1892,0.11787286181833428
SIM,1901,35,50-100,1936,1
STAT,1841,31,35-39,1872,9.166947425225342
STAT,1917,20,15-19,1937,5.807939168208757
STAT,1833,44,50-100,1877,0.8254323208141501
STAT,1843,31,45-49,1874,1.710039210953176
SIM,1829,40,na,1869,1450
SIM,1859,41,15-19,1900,1
STAT,1845,93,na,1938,22.835172022819403
STAT,1886,42,20-24,1928,0.1712771034971227
SIM,1920,47,na,1967,3937
STAT,1929,32,na,1961,4899.845645954125
STAT,1934,17,15-19,1951,62.60093786459192
STAT,1820,46,35-39,1866,0.2591182852525595
SIM,1848,26,45-49,1874,1
SIM,1888,31,40-44,1919,12
STAT,1889,18,40-44,1907,0.22988025531447398
SIM,1822,42,30-34,1864,1
STAT,1934,20,15-19,1954,7.31923266140271
SIM,1838,86,na,1924,90
SIM,1843,87,na,1930,100
SIM,1942,17,15-19,1959,51
STAT,1860,31,45-49,1891,1.4492850787082665
STAT,1793,100,na,1893,0.2126640901323744
STAT,1771,106,na,1877,0.011606370555637742
SIM,1781,86,na,1867,60
STAT,1917,17,15-19,1934,9.966243007758164
STAT,1897,33,50-100,1930,1.2445183338719825
STAT,1933,29,35-39,1962,20.309920213747716
SIM,1941,29,35-39,1970,23
SIM,1876,20,na,1896,2737
SIM,1931,30,40-44,1961,10
STAT,1843,39,40-44,1882,3.6769948334479743
SIM,1851,39,40-44,1890,5
STAT,1881,33,30-34,1914,17.147455808316046
SIM,1916,34,na,1950,3910
STAT,1915,23,50-100,1938,0.6919244835295866
STAT,1908,43,20-24,1951,0.0165614452071338
SIM,1815,39,30-34,1854,3
SIM,1818,80,na,1898,258
SIM,1878,41,25-29,1919,5
STAT,1819,51,20-24,1870,0.0014342091843333065
STAT,1890,30,35-39,1920,12.733399428066393
SIM,1846,15,30-34,1861,1
STAT,1856,53,na,1909,1696.579312197886
STAT,1843,35,na,1878,2060.8368510139862
SIM,1925,33,20-24,1958,3
STAT,1860,108,na,1968,0.017100939360163603
STAT,1860,39,na,1899,1930.4492430175835
STAT,1824,39,30-34,1863,6.879853131895901
SIM,1883,23,35-39,1906,1
SIM,1810,60,na,1870,1323
SIM,1900,25,30-34,1925,4
SIM,1909,34,20-24,1943,1
STAT,1886,26,15-19,1912,0.49159474680152143
SIM,1951,19,na,1970,4892
STAT,1796,93,na,1889,7.102190798723134
STAT,1860,39,40-44,1899,3.5868543641595965
SIM,1830,37,na,1867,1822
SIM,1889,60,na,1949,2543
STAT,1817,41,50-100,1858,2.7652969654423143
STAT,1879,48,na,1927,2368.9838236828027
STAT,1839,107,na,1946,0.0032546911391193034
STAT,1850,49,25-29,1899,0.04242236322012735
SIM,1888,28,40-44,1916,4
STAT,1814,49,15-19,1863,0.001154704409425073
SIM,1855,58,na,1913,1481
SIM,1832,31,35-39,1863,20
SIM,1889,30,50-100,1919,1
STAT,1819,35,15-19,1854,0.18685047146414607
STAT,1896,16,30-34,1912,2.1527798007367642
STAT,1860,48,30-34,1908,0.07911599504663966
STAT,1891,22,35-39,1913,7.370199297164673
SIM,1936,22,40-44,1958,10
STAT,1899,43,45-49,1942,0.1441379350602819
STAT,1849,15,50-100,1864,0.04737494089288188
STAT,1885,50,20-24,1935,7.618314450223802E-4
SIM,1875,26,50-100,1901,1
SIM,1926,32,25-29,1958,17
STAT,1829,25,30-34,1854,78.81479329350603
STAT,1869,42,20-24,1911,0.156223720083159
SIM,1942,20,15-19,1962,6
STAT,1824,31,35-39,1855,23.844307530483274
STAT,1856,85,na,1941,219.5278111799951
STAT,1860,100,na,1960,1.944056814758585
STAT,1847,32,50-100,1879,0.8389142794517207
STAT,1918,32,25-29,1950,10.022691342522469
STAT,1914,40,40-44,1954,0.25464100946390567
STAT,1846,53,30-34,1899,0.0041884502477360355
SIM,1884,71,na,1955,1170
STAT,1858,19,20-24,1877,16.55718602598585
STAT,1882,36,15-19,1918,0.05607933769621033
STAT,1884,49,na,1933,2223.3141674085055
STAT,1871,84,na,1955,336.16434941510965
SIM,1808,49,40-44,1857,1
STAT,1942,30,na,1972,4114.969446593545
STAT,1950,17,na,1967,4440.048389825526
STAT,1926,39,45-49,1965,0.8481345762076932
SIM,1837,25,30-34,1862,3
STAT,1857,47,50-100,1904,0.19476191646512342
STAT,1834,49,40-44,1883,0.11909225021055159
STAT,1882,46,50-100,1928,0.2447891825878941
SIM,1892,58,na,1950,2832
STAT,1921,32,40-44,1953,4.443932105801293
SIM,1900,59,na,1959,2761
SIM,1933,14,na,1947,5264
STAT,1815,45,15-19,1860,0.0011125883170648825
STAT,1831,29,50-100,1860,0.6013912966608357
STAT,1902,33,na,1935,3418.5681642306936
STAT,1868,56,na,1924,1987.3527910492164
STAT,1877,43,25-29,1920,0.6745490957875094
SIM,1842,49,40-44,1891,1
STAT,1936,33,30-34,1969,15.598681488564614
SIM,1935,24,20-24,1959,159
STAT,1768,102,na,1870,0.112085607649516
SIM,1919,27,40-44,1946,8
STAT,1850,46,20-24,1896,0.009052086104714167
SIM,1889,27,45-49,1916,1
STAT,1927,24,20-24,1951,138.87339741376792
STAT,1850,15,na,1865,2135.0062635246773
SIM,1890,46,50-100,1936,1
STAT,1889,26,na,1915,3017.6825309999913
STAT,1885,36,na,1921,2409.4046510457497
STAT,1868,50,20-24,1918,7.293369544731145E-4
SIM,1921,31,50-100,1952,4
STAT,1922,19,50-100,1941,0.4400488848662403
STAT,1772,83,na,1855,68.79050000000001
SIM,1926,17,30-34,1943,21
SIM,1905,48,na,1953,3215
STAT,1895,16,15-19,1911,7.918352003821543
SIM,1818,66,na,1884,870
STAT,1883,40,45-49,1923,1.5132013090601117
STAT,1865,23,45-49,1888,0.6488083306391446
SIM,1830,69,na,1899,1019
STAT,1875,46,25-29,1921,0.06047903828420914
SIM,1896,48,na,1944,3012
STAT,1933,24,15-19,1957,7.195988810826606
SIM,1868,34,50-100,1902,2
SIM,1909,32,25-29,1941,9
STAT,1884,33,15-19,1917,0.14312305039131143
STAT,1951,17,15-19,1968,55.13167403369987
SIM,1941,24,15-19,1965,6
STAT,1834,22,35-39,1856,5.252044908330861
STAT,1817,64,na,1881,963.4441609840044
SIM,1860,67,na,1927,1602
STAT,1832,43,na,1875,1686.678481974728
STAT,1911,32,15-19,1943,0.1276402247493187
SIM,1899,70,na,1969,2284
STAT,1918,17,30-34,1935,2.716210921758336
STAT,1817,42,15-19,1859,0.03472186150218678
STAT,1852,43,20-24,1895,0.1270158284022589
STAT,1876,51,na,1927,2279.0626391398487
SIM,1891,40,45-49,1931,1
SIM,1873,23,45-49,1896,1
STAT,1849,83,na,1932,308.205037332003
STAT,1954,15,45-49,1969,0.630233184444688
SIM,1948,13,na,1961,4536
STAT,1840,39,15-19,1879,0.0468112984319332
SIM,1871,47,45-49,1918,2
SIM,1868,16,20-24,1884,17
STAT,1854,19,30-34,1873,1.4421224616861532
SIM,1922,1,na,1923,4868
STAT,1863,33,na,1896,2125.4326935635163
STAT,1863,55,na,1918,1849.469960877446
SIM,1879,15,25-29,1894,7
STAT,1860,50,na,1910,1807.8186665293968
SIM,1834,39,40-44,1873,5
STAT,1921,1,na,1922,4857.46843006959
STAT,1856,23,25-29,1879,52.85948391134738
SIM,1937,23,50-100,1960,1
STAT,1850,37,na,1887,1800.240820872882
STAT,1877,19,25-29,1896,5.963731125126476
STAT,1928,42,35-39,1970,0.26184425436620673
STAT,1886,83,na,1969,793.6126011097472
STAT,1915,46,30-34,1961,0.09189321889002465
SIM,1878,26,30-34,1904,28
STAT,1938,25,35-39,1963,15.186074543289042
STAT,1949,16,20-24,1965,160.91426857930728
STAT,1940,30,40-44,1970,4.136496164344396
SIM,1864,23,25-29,1887,66
STAT,1837,54,35-39,1891,0.005582189881535966
SIM,1866,19,20-24,1885,24
SIM,1828,30,30-34,1858,29
STAT,1839,33,45-49,1872,1.4657340946565862
STAT,1789,91,na,1880,14.999822041690496
STAT,1910,42,na,1952,3579.8649633848636
SIM,1928,32,35-39,1960,15
STAT,1826,53,20-24,1879,5.45828609535198E-4
STAT,1891,47,20-24,1938,0.008509375588588566
SIM,1936,25,50-100,1961,2
STAT,1887,21,30-34,1908,20.423289662543176
SIM,1870,25,15-19,1895,1
SIM,1814,44,na,1858,1358
STAT,1937,17,40-44,1954,1.3879667408485736
SIM,1908,47,na,1955,3596
SIM,1946,25,35-39,1971,37
STAT,1849,16,45-49,1865,0.06279453665469707
STAT,1909,12,na,1921,3949.8421693138816
SIM,1862,15,15-19,1877,12
STAT,1882,21,50-100,1903,0.40651705399905913
STAT,1865,14,na,1879,2480.319165449981
STAT,1929,23,50-100,1952,0.8460598955013241
STAT,1856,46,15-19,1902,3.2123058157779475E-4
STAT,1917,43,30-34,1960,0.13593692214350458
STAT,1854,15,15-19,1869,5.497933418780149
STAT,1892,78,na,1970,1459.1033625933849
SIM,1898,34,35-39,1932,3
SIM,1862,19,30-34,1881,2
STAT,1844,52,25-29,1896,0.0027301344220314497
STAT,1862,25,15-19,1887,0.40118813104777684
STAT,1863,47,45-49,1910,0.21010649127660333
SIM,1863,43,30-34,1906,2
SIM,1945,17,40-44,1962,1
STAT,1893,44,20-24,1937,0.01407959056399145
SIM,1879,34,25-29,1913,19
SIM,1847,33,45-49,1880,1
STAT,1860,32,50-100,1892,0.7583895061926469
STAT,1874,43,40-44,1917,2.325836338188184
SIM,1915,36,30-34,1951,5
SIM,1835,60,na,1895,1287
SIM,1910,32,30-34,1942,13
STAT,1828,29,30-34,1857,28.554963104220494
STAT,1878,15,25-29,1893,6.045236391467441
SIM,1888,40,30-34,1928,1
SIM,1846,52,na,1898,1743
STAT,1817,41,45-49,1858,3.9175040456027244
SIM,1892,17,50-100,1909,1
STAT,1780,92,na,1872,10.103399832082067
STAT,1807,52,40-44,1859,0.043498295580271046
STAT,1834,45,25-29,1879,0.04634648653980352
STAT,1834,84,na,1918,223.5555003963411
SIM,1837,21,15-19,1858,3
STAT,1854,51,30-34,1905,0.004577609065666566
STAT,1818,60,na,1878,1129.463686898536
STAT,1822,33,na,1855,1657.115490903431
SIM,1883,22,na,1905,2382
STAT,1819,45,na,1864,1630.610623429203
STAT,1849,33,35-39,1882,8.199271654858602
STAT,1860,44,50-100,1904,0.8626369858278159
SIM,1839,50,na,1889,1578
SIM,1956,3,na,1959,5513
STAT,1902,32,30-34,1934,25.118343891558816
SIM,1909,37,25-29,1946,2
STAT,1855,30,25-29,1885,8.254260429600171
STAT,1846,20,30-34,1866,15.945020802859801
SIM,1930,34,40-44,1964,10
STAT,1893,23,na,1916,3051.261667678068
STAT,1858,43,15-19,1901,0.011091552169327399
SIM,1820,59,na,1879,1307
STAT,1901,39,40-44,1940,1.334330962099209
STAT,1939,7,na,1946,4072.909215417147
STAT,1897,45,50-100,1942,0.19085603497235668
STAT,1869,21,50-100,1890,0.4028487870235185
SIM,1818,88,na,1906,53
STAT,1787,82,na,1869,194.98151836655978
STAT,1841,35,15-19,1876,0.04987533692388021
STAT,1881,20,na,1901,2346.5115816759308
SIM,1812,61,na,1873,964
SIM,1836,29,30-34,1865,36
SIM,1882,43,40-44,1925,7
STAT,1841,43,45-49,1884,1.1336657975861584
STAT,1852,48,40-44,1900,0.13618604336954912
STAT,1884,17,50-100,1901,0.049446651377879354
STAT,1838,18,35-39,1856,0.5293994412137627
STAT,1907,36,30-34,1943,1.7313763860378255
STAT,1911,42,25-29,1953,0.06952159436854745
STAT,1869,101,na,1970,4.528809211714502
SIM,1854,20,30-34,1874,26
STAT,1862,20,15-19,1882,2.9753101999211693
STAT,1902,33,50-100,1935,1.312589939313303
STAT,1868,26,20-24,1894,11.469970407490685
SIM,1832,38,na,1870,1736
SIM,1908,49,45-49,1957,1
SIM,1892,40,50-100,1932,1
STAT,1928,25,45-49,1953,2.1857353061383242
SIM,1832,33,50-100,1865,5
SIM,1849,94,na,1943,7
STAT,1913,29,50-100,1942,1.0045393369204916
STAT,1850,46,15-19,1896,3.017359380732603E-4
SIM,1857,33,35-39,1890,15
STAT,1890,80,na,1970,1230.034141749694
SIM,1898,21,na,1919,3891
STAT,1883,16,45-49,1899,0.06554615777744568
STAT,1819,54,25-29,1873,0.006484994293035553
SIM,1913,4,na,1917,4294
STAT,1951,13,na,1964,4771.104952995695
SIM,1907,24,45-49,1931,1
STAT,1788,98,na,1886,0.6596557758042014
STAT,1875,23,35-39,1898,6.090930496505114
STAT,1907,34,15-19,1941,0.12143430222938333
SIM,1850,23,50-100,1873,2
SIM,1920,16,25-29,1936,65
STAT,1842,23,50-100,1865,0.4004547550642381
SIM,1876,42,na,1918,2663
STAT,1906,33,45-49,1939,1.4805059307751909
SIM,1840,90,na,1930,33
STAT,1901,46,na,1947,3219.287011665901
SIM,1904,44,40-44,1948,3
STAT,1799,109,na,1908,2.3086079089027154E-4
STAT,1917,24,30-34,1941,30.97742519984822
STAT,1812,54,30-34,1866,0.012907832554216759
STAT,1935,20,50-100,1955,0.9143989264125637
STAT,1854,72,na,1926,966.5624469462432
SIM,1936,25,45-49,1961,6
STAT,1830,62,na,1892,1156.2083612558422
SIM,1901,16,15-19,1917,10
STAT,1909,34,na,1943,3649.2974508442885
SIM,1870,20,15-19,1890,6
STAT,1798,74,na,1872,560.5120696842334
STAT,1879,16,30-34,1895,1.7038049760645615
STAT,1856,31,na,1887,1954.5533706671558
STAT,1943,13,na,1956,4249.147285370347
SIM,1821,46,na,1867,1439
SIM,1925,24,30-34,1949,48
STAT,1912,16,25-29,1928,8.961178290010917
SIM,1888,34,45-49,1922,3
STAT,1908,46,25-29,1954,0.049287318045636394
STAT,1913,31,35-39,1944,9.313219971674911
STAT,1857,50,45-49,1907,0.011728469747817626
STAT,1835,69,na,1904,1093.4165097151965
STAT,1897,24,25-29,1921,77.59628241848068
STAT,1905,21,35-39,1926,8.62362995160821
STAT,1868,40,50-100,1908,1.0397589633996849
SIM,1847,37,na,1884,1701
SIM,1912,29,50-100,1941,4
STAT,1822,43,35-39,1865,2.7371915832163825
SIM,1863,24,na,1887,2046
SIM,1899,37,na,1936,3263
SIM,1909,40,na,1949,3383
STAT,1853,41,50-100,1894,0.8898417068262681
STAT,1867,54,20-24,1921,6.872942191500547E-4
SIM,1941,26,30-34,1967,6
SIM,1859,70,na,1929,1150
SIM,1878,7,na,1885,2909
STAT,1763,106,na,1869,0.004388306078267084
STAT,1841,54,na,1895,1546.0787347568096
STAT,1860,35,25-29,1895,2.4057856380039477
STAT,1933,26,30-34,1959,53.08149632295306
STAT,1848,53,40-44,1901,0.00805209583118092
STAT,1889,72,na,1961,1785.5569708851074
SIM,1887,19,35-39,1906,1
SIM,1913,21,35-39,1934,14
STAT,1843,80,na,1923,499.37609006401493
STAT,1911,28,45-49,1939,1.7124984016135123
STAT,1783,75,na,1858,414.77935808856984
SIM,1921,31,35-39,1952,19
SIM,1838,33,25-29,1871,10
STAT,1904,29,50-100,1933,0.92858781604638
STAT,1865,36,15-19,1901,0.05224391600253245
STAT,1904,48,20-24,1952,0.009772370358650452
STAT,1872,43,30-34,1915,1.1669636673872923
STAT,1896,19,35-39,1915,0.7353404134422672
STAT,1877,52,20-24,1929,7.766256407333952E-4
STAT,1844,12,na,1856,2351.5368626537997
STAT,1901,35,25-29,1936,0.8949664355035505
SIM,1853,46,na,1899,1884
SIM,1898,7,na,1905,4014
SIM,1900,23,15-19,1923,5
STAT,1891,47,15-19,1938,2.83645603448615E-4
SIM,1895,63,na,1958,2458
STAT,1774,101,na,1875,0.09436531273086103
SIM,1837,28,35-39,1865,12
STAT,1892,42,45-49,1934,1.911191199731169
SIM,1891,73,na,1964,1682
SIM,1834,64,na,1898,1191
SIM,1930,30,25-29,1960,21
SIM,1902,31,25-29,1933,19
STAT,1916,14,na,1930,4262.067404441922
STAT,1914,43,45-49,1957,0.1679928842637504
STAT,1899,40,40-44,1939,0.22040044850110696
SIM,1887,69,na,1956,1698
SIM,1918,24,20-24,1942,8
STAT,1866,40,45-49,1906,1.422503975447857
STAT,1869,71,na,1940,1314.6563797092535
SIM,1884,19,15-19,1903,7
SIM,1885,56,na,1941,2019
SIM,1845,30,30-34,1875,6
STAT,1829,28,35-39,1857,11.193378419231028
STAT,1867,71,na,1938,1278.3808738572345
SIM,1934,36,40-44,1970,2
SIM,1880,43,30-34,1923,3
SIM,1902,50,na,1952,3195
STAT,1865,81,na,1946,500.6953855684918
SIM,1927,32,40-44,1959,5
SIM,1849,19,20-24,1868,19
STAT,1872,51,25-29,1923,0.0036387863084642114
STAT,1878,31,30-34,1909,18.61556231706583
STAT,1849,28,50-100,1877,0.5844836130882529
SIM,1920,35,35-39,1955,3
STAT,1836,18,25-29,1854,6.5848879876100135
SIM,1832,22,45-49,1854,1
STAT,1867,17,15-19,1884,5.81045416538322
SIM,1949,8,na,1957,4778
STAT,1805,52,30-34,1857,0.020976847735362326
SIM,1879,41,40-44,1920,10
SIM,1847,23,25-29,1870,56
STAT,1820,84,na,1904,183.2157558046569
STAT,1799,82,na,1881,166.90965265799738
STAT,1909,63,na,1972,3093.1536684272464
STAT,1921,47,45-49,1968,0.2500166311559489
STAT,1831,110,na,1941,1.8620245820615526E-4
STAT,1878,34,na,1912,2512.2366790510746
SIM,1887,36,50-100,1923,1
STAT,1853,46,40-44,1899,0.14395854288465298
SIM,1819,40,30-34,1859,3
STAT,1846,24,na,1870,1859.60722769901
STAT,1912,35,35-39,1947,2.4311160289140394
SIM,1875,17,15-19,1892,4
STAT,1915,49,35-39,1964,0.13179674587860307
STAT,1833,46,20-24,1879,0.009417972929827274
SIM,1879,38,40-44,1917,6
STAT,1852,41,na,1893,1870.36336936442
SIM,1863,18,35-39,1881,3
SIM,1886,31,30-34,1917,23
SIM,1849,27,na,1876,1939
STAT,1808,50,na,1858,1082.8301971449216
SIM,1843,18,15-19,1861,5
SIM,1830,38,50-100,1868,2
STAT,1926,43,na,1969,4663.416459964283
STAT,1831,50,25-29,1881,0.0026512246355858736
STAT,1873,30,35-39,1903,10.558104601920574
STAT,1884,49,30-34,1933,0.09565868574070374
STAT,1867,93,na,1960,52.03822923895528
STAT,1871,19,30-34,1890,1.6020067760863457
STAT,1879,81,na,1960,754.4965089220473
STAT,1837,30,30-34,1867,14.901753397027068
SIM,1887,34,na,1921,2779
STAT,1915,48,50-100,1963,0.23192579849949185
STAT,1916,36,na,1952,3950.5403834189815
STAT,1831,52,50-100,1883,0.01086543802441565
STAT,1859,42,na,1901,1880.6833331549356
STAT,1821,40,20-24,1861,0.2939377143019361
STAT,1851,46,50-100,1897,0.20319955627730113
STAT,1862,48,40-44,1910,0.14680204063751345
SIM,1883,44,na,1927,2380
STAT,1885,48,35-39,1933,0.1406986518038559
SIM,1874,19,na,1893,2576
STAT,1907,19,20-24,1926,26.412925181942718
STAT,1796,101,na,1897,0.1241348213622506
SIM,1929,25,35-39,1954,3
SIM,1829,75,na,1904,439
STAT,1806,51,35-39,1857,0.028588115884581256
SIM,1844,18,25-29,1862,7
SIM,1870,26,na,1896,2639
STAT,1918,48,na,1966,3978.451621825662
STAT,1922,30,25-29,1952,10.74129965034938
SIM,1902,53,na,1955,3053
STAT,1825,51,45-49,1876,0.018357411920000104
SIM,1892,36,25-29,1928,7
STAT,1951,10,na,1961,4773.204858140093
STAT,1855,18,35-39,1873,0.5029414909183496
STAT,1837,51,30-34,1888,0.004062885902471367
STAT,1856,33,45-49,1889,1.3989541879537892
STAT,1908,0,na,1908,4441.6466801819415
STAT,1862,106,na,1968,0.1025509069498664
STAT,1897,47,15-19,1944,3.063369855014389E-4
STAT,1920,21,25-29,1941,105.11020548365929
STAT,1932,20,40-44,1952,4.525996929028594
STAT,1871,28,50-100,1899,0.6441494988957049
STAT,1920,52,na,1972,4074.5536444331765
SIM,1920,42,40-44,1962,3
SIM,1862,93,na,1955,25
STAT,1859,1,na,1860,3002.17730597043
STAT,1926,36,40-44,1962,1.8680942685468453
SIM,1880,30,25-29,1910,9
STAT,1949,19,25-29,1968,51.38561401820754
STAT,1827,42,na,1869,1731.7216126466885
SIM,1870,48,40-44,1918,1
STAT,1860,52,45-49,1912,0.0119481852453417
STAT,1882,20,40-44,1902,2.083406375483757
STAT,1892,36,50-100,1928,1.5773003726986838
STAT,1892,30,45-49,1922,2.247506309700242
SIM,1879,19,40-44,1898,4
SIM,1915,26,na,1941,4231
STAT,1891,43,40-44,1934,2.8203092218756765
SIM,1893,51,na,1944,2884
STAT,1884,36,25-29,1920,2.919910020891074
STAT,1912,42,40-44,1954,0.2460920780880022
STAT,1872,30,25-29,1902,10.556520552919276
STAT,1830,94,na,1924,12.643035771798344
SIM,1803,81,na,1884,132
STAT,1945,22,40-44,1967,3.7597688967143443
SIM,1873,31,na,1904,2464
SIM,1885,16,20-24,1901,28
SIM,1865,34,na,1899,2274
SIM,1836,20,na,1856,2151
STAT,1841,86,na,1927,163.82287191882682
STAT,1878,52,30-34,1930,0.006287132757479895
STAT,1831,79,na,1910,471.0719314470652
SIM,1849,49,na,1898,1785
SIM,1881,42,35-39,1923,2
STAT,1865,99,na,1964,6.3576734929881855
STAT,1868,29,25-29,1897,40.9225368572661
SIM,1864,33,45-49,1897,2
SIM,1820,36,35-39,1856,11
SIM,1838,57,na,1895,1263
STAT,1838,50,35-39,1888,0.006546070332368233
SIM,1864,30,40-44,1894,4
STAT,1863,23,35-39,1886,5.2853520308095145
STAT,1894,47,40-44,1941,0.12613151412565277
STAT,1874,47,20-24,1921,0.012440472935250222
SIM,1904,31,na,1935,3754
SIM,1880,37,45-49,1917,4
STAT,1898,54,na,1952,2888.802621281805
STAT,1815,49,30-34,1864,0.25188166621758035
STAT,1897,28,40-44,1925,4.071675835664712
SIM,1841,21,na,1862,1950
SIM,1823,49,30-34,1872,1
SIM,1940,20,40-44,1960,9
STAT,1891,11,na,1902,3266.5708910427434
SIM,1886,19,na,1905,2823
STAT,1873,42,35-39,1915,1.8705276317605524
SIM,1798,94,na,1892,1
STAT,1841,52,40-44,1893,0.0077317377807844066
STAT,1911,25,40-44,1936,4.668045302780227
STAT,1910,20,na,1930,3676.9100628244723
SIM,1940,25,na,1965,3902
STAT,1790,69,na,1859,718.7057209882919
SIM,1881,30,35-39,1911,1
STAT,1892,43,15-19,1935,0.017529173572396042
SIM,1864,43,50-100,1907,2
STAT,1836,51,20-24,1887,4.7406350538152254E-4
STAT,1875,45,50-100,1920,0.2597094498861339
STAT,1888,41,35-39,1929,2.1937595311437534
STAT,1852,49,na,1901,1774.6323104446024
STAT,1941,30,35-39,1971,9.799530868363794
STAT,1915,40,35-39,1955,0.2074497375198775
STAT,1945,25,na,1970,4196.823062654112
STAT,1868,41,15-19,1909,0.01351673159570675
SIM,1913,48,na,1961,3738
SIM,1938,19,15-19,1957,51
SIM,1859,29,25-29,1888,47
STAT,1858,15,50-100,1873,0.046848974736032944
STAT,1841,40,40-44,1881,1.7705269495420157
SIM,1784,72,na,1856,606
SIM,1903,42,40-44,1945,1
STAT,1872,37,45-49,1909,2.038199918560932
SIM,1896,41,35-39,1937,1
STAT,1766,95,na,1861,3.378827469943503
SIM,1865,5,na,1870,2744
STAT,1857,47,20-24,1904,0.009516054927178698
STAT,1851,41,45-49,1892,1.240341129553842
SIM,1876,71,na,1947,1451
STAT,1935,18,na,1953,5118.0123380863515
STAT,1930,40,na,1970,4997.727071493691
SIM,1910,47,35-39,1957,1
SIM,1819,65,na,1884,927
STAT,1845,61,na,1906,1460.0526922852039
SIM,1890,32,35-39,1922,20
STAT,1822,40,30-34,1862,1.8978338805430168
SIM,1869,31,30-34,1900,4
SIM,1810,44,50-100,1854,6
STAT,1822,46,45-49,1868,0.34147310514370893
SIM,1899,18,15-19,1917,10
STAT,1881,53,50-100,1934,0.01465633732033252
SIM,1919,34,50-100,1953,4
STAT,1870,37,35-39,1907,7.053560744092056
SIM,1855,32,50-100,1887,1
STAT,1852,19,20-24,1871,17.0708148043037
SIM,1838,40,40-44,1878,4
STAT,1894,70,na,1964,2086.3673850786267
STAT,1847,104,na,1951,0.05201355998755201
STAT,1909,42,25-29,1951,0.06811874640026395
STAT,1764,116,na,1880,1.9238520741170502E-4
STAT,1858,46,25-29,1904,0.0467311441433697
STAT,1850,42,40-44,1892,1.6898331269461662
STAT,1830,103,na,1933,0.09078647471050208
SIM,1840,41,35-39,1881,3
STAT,1930,38,20-24,1968,0.3503362947344517
SIM,1871,23,35-39,1894,7
STAT,1897,31,40-44,1928,5.939614207409311
STAT,1852,22,20-24,1874,65.95043179270402
STAT,1853,17,50-100,1870,0.04941611631195551
STAT,1917,19,50-100,1936,0.40788552198307754
STAT,1919,32,40-44,1951,4.308453611053445
STAT,1925,38,50-100,1963,0.5136020016904806
STAT,1841,16,40-44,1857,0.17520708366694476
SIM,1798,72,na,1870,478
SIM,1841,44,50-100,1885,1
STAT,1867,4,na,1871,2867.7762678285703
STAT,1906,23,na,1929,3500.8811011615194
STAT,1887,41,25-29,1928,0.7373926434667958
SIM,1904,63,na,1967,2881
STAT,1831,42,30-34,1873,0.974347680975278
STAT,1902,47,35-39,1949,0.11308255623221747
SIM,1874,93,na,1967,65
SIM,1810,47,30-34,1857,1
STAT,1821,47,40-44,1868,0.26974785923245964
STAT,1925,43,20-24,1968,0.02177969653859366
STAT,1899,29,50-100,1928,0.8872439360585725
STAT,1921,48,15-19,1969,4.225786018162433E-4
SIM,1849,43,20-24,1892,1
STAT,1899,17,na,1916,3528.1952343703447
SIM,1838,37,40-44,1875,3
SIM,1868,19,30-34,1887,2
STAT,1906,30,40-44,1936,3.7271987293431867
STAT,1877,40,20-24,1917,0.1697334023730122
STAT,1832,41,35-39,1873,1.5073223000500353
STAT,1934,33,na,1967,5262.7662879128575
SIM,1903,41,50-100,1944,1
STAT,1852,46,50-100,1898,0.19841751135946362
STAT,1932,40,35-39,1972,0.2790989884895263
STAT,1843,44,15-19,1887,0.011188057080090096
SIM,1914,30,40-44,1944,6
SIM,1927,26,na,1953,4505
SIM,1952,18,na,1970,4569
SIM,1910,38,45-49,1948,1
STAT,1912,32,30-34,1944,15.814949635989008
STAT,1830,30,20-24,1860,2.6755597968334026
STAT,1839,46,15-19,1885,2.848937955648814E-4
STAT,1880,59,na,1939,2083.451118645625
STAT,1931,0,na,1931,6013.881757989215
SIM,1810,51,na,1861,1554
STAT,1873,54,45-49,1927,0.014596707964131816
STAT,1851,42,15-19,1893,0.01137932236645229
STAT,1815,41,35-39,1856,6.050763230405359
STAT,1826,29,20-24,1855,19.76621841224563
STAT,1921,15,na,1936,4301.2156990435415
STAT,1812,45,40-44,1857,0.4192942820038794
STAT,1935,32,25-29,1967,13.040312297825071
SIM,1927,35,45-49,1962,1
STAT,1802,53,25-29,1855,0.009199117747712076
STAT,1901,32,20-24,1933,3.856127304335904
STAT,1868,53,50-100,1921,0.01447935085145469
STAT,1879,51,35-39,1930,0.009224237633926952
STAT,1870,60,na,1930,1901.9591455684658
SIM,1861,12,na,1873,2986
SIM,1816,54,na,1870,1354
STAT,1899,47,25-29,1946,0.04517761025759195
SIM,1830,41,50-100,1871,3
SIM,1860,22,20-24,1882,3
STAT,1882,17,40-44,1899,0.18178311121823926
SIM,1854,40,25-29,1894,1
SIM,1827,91,na,1918,19
STAT,1813,53,35-39,1866,0.02025172616762162
STAT,1865,67,na,1932,1467.7576763292673
STAT,1833,57,na,1890,1319.7160423605978
SIM,1869,15,na,1884,2593
SIM,1799,57,na,1856,1267
STAT,1917,5,na,1922,4400.993653143355
SIM,1848,64,na,1912,1335
STAT,1833,49,25-29,1882,0.03958546151219195
STAT,1914,46,15-19,1960,3.736738263536303E-4
STAT,1882,32,35-39,1914,10.065056231766901
STAT,1878,88,na,1966,340.61483044512806
STAT,1894,40,20-24,1934,0.2105001569615846
STAT,1933,25,50-100,1958,1.348988637195958
STAT,1837,33,35-39,1870,8.378282886511572
SIM,1944,17,25-29,1961,69
STAT,1890,4,na,1894,3281.3537907608825
STAT,1913,40,25-29,1953,0.07184653604980029
SIM,1948,10,na,1958,4540
STAT,1838,34,na,1872,1938.04362731836
STAT,1822,41,50-100,1863,1.6940975803746487
STAT,1925,46,25-29,1971,0.06574272992124268
SIM,1810,101,na,1911,5
SIM,1918,27,25-29,1945,78
STAT,1932,8,na,1940,5385.93326614018
STAT,1875,42,45-49,1917,1.5650689817056267
SIM,1845,33,35-39,1878,17
STAT,1888,22,50-100,1910,0.49180347125957175
STAT,1882,37,na,1919,2341.5511128518892
STAT,1902,38,45-49,1940,0.6159451666017646
SIM,1883,42,45-49,1925,5
STAT,1834,48,50-100,1882,0.1730502227370226
SIM,1842,48,50-100,1890,1
STAT,1791,87,na,1878,52.203652955973425
STAT,1868,6,na,1874,2719.5881578630715
STAT,1908,34,30-34,1942,15.035031569759512
STAT,1808,51,45-49,1859,0.0353691020989703
SIM,1878,52,na,1930,2425
STAT,1841,39,30-34,1880,4.541038956533387
STAT,1828,27,na,1855,1565.3720629862107
STAT,1922,40,35-39,1962,0.2364883460396763
SIM,1885,85,na,1970,537
STAT,1883,9,na,1892,2597.1380491293708
SIM,1774,84,na,1858,151
STAT,1917,46,40-44,1963,0.16847219251187803
STAT,1897,34,45-49,1931,2.358272330758893
SIM,1827,94,na,1921,5
STAT,1884,45,15-19,1929,4.077375480412852E-4
STAT,1923,33,45-49,1956,1.8394380916691155
STAT,1836,54,25-29,1890,0.0021442447676489657
SIM,1871,41,30-34,1912,2
STAT,1915,24,20-24,1939,116.55647406582364
STAT,1856,27,40-44,1883,2.4857661720505986
STAT,1936,17,25-29,1953,42.3162963166858
SIM,1913,45,na,1958,3783
SIM,1904,34,na,1938,3697
STAT,1846,40,25-29,1886,0.4768429813403658
STAT,1878,34,35-39,1912,10.661471255790104
SIM,1890,41,40-44,1931,8
STAT,1846,44,40-44,1890,1.5867942964325321
STAT,1913,38,20-24,1951,0.26407420838771595
STAT,1876,19,15-19,1895,6.218103956909487
SIM,1916,34,30-34,1950,23
SIM,1797,79,na,1876,165
SIM,1911,21,25-29,1932,110
SIM,1862,90,na,1952,69
SIM,1912,5,na,1917,4287
STAT,1832,72,na,1904,843.9016722482976
STAT,1912,45,45-49,1957,0.21407882984537224
SIM,1956,0,na,1956,5518
STAT,1864,23,50-100,1887,0.373149169590738
STAT,1858,50,50-100,1908,0.012393821431174437
STAT,1894,31,15-19,1925,0.1876336117391664
SIM,1850,57,na,1907,1474
SIM,1886,34,35-39,1920,16
STAT,1857,19,na,1876,2124.2499550714806
STAT,1802,52,20-24,1854,0.0019555339309761145
STAT,1882,41,40-44,1923,2.245618256827689
STAT,1820,39,na,1859,1519.412406819688
STAT,1915,35,50-100,1950,0.4369212560708853
SIM,1903,38,na,1941,3343
SIM,1819,43,35-39,1862,5
STAT,1827,40,15-19,1867,0.01699144850028642
STAT,1917,2,na,1919,4476.600796768148
STAT,1921,44,40-44,1965,0.2865218552872985
SIM,1941,25,50-100,1966,4
SIM,1852,83,na,1935,253
SIM,1885,29,50-100,1914,1
STAT,1863,41,30-34,1904,1.0329756481208738
STAT,1893,23,20-24,1916,88.90728525597783
SIM,1864,27,40-44,1891,4
STAT,1842,35,50-100,1877,1.153139652395023
SIM,1887,37,na,1924,2829
SIM,1814,76,na,1890,513
STAT,1850,25,15-19,1875,0.4074450071707913
STAT,1871,31,20-24,1902,2.742670105563564
STAT,1847,52,35-39,1899,0.006677717216673203
STAT,1826,32,20-24,1858,2.9467223354730465
STAT,1903,21,25-29,1924,83.2661938991466
SIM,1854,44,40-44,1898,9
STAT,1873,34,50-100,1907,0.9395133803053602
STAT,1890,66,na,1956,2071.442799133654
SIM,1834,32,20-24,1866,2
SIM,1852,16,na,1868,2391
STAT,1856,30,40-44,1886,3.5891458578882
STAT,1888,47,50-100,1935,0.29481766816146365
SIM,1878,24,50-100,1902,6
STAT,1817,45,25-29,1862,0.13275571145645326
SIM,1825,50,na,1875,1369
STAT,1824,52,40-44,1876,0.011836797064122438
SIM,1842,41,45-49,1883,2
STAT,1819,108,na,1927,0.0010799055228864092
SIM,1834,29,20-24,1863,15
SIM,1850,35,50-100,1885,4
SIM,1897,44,na,1941,3073
SIM,1915,6,na,1921,4625
STAT,1766,98,na,1864,0.7751815497865165
STAT,1878,19,40-44,1897,0.19317611679240626
STAT,1893,77,na,1970,1573.5777107301383
STAT,1791,65,na,1856,713.7393216400001
STAT,1863,20,30-34,1883,16.485623098860206
SIM,1864,42,35-39,1906,3
SIM,1904,31,35-39,1935,9
SIM,1859,26,20-24,1885,15
STAT,1818,68,na,1886,838.1570617052248
SIM,1932,36,30-34,1968,2
STAT,1874,41,na,1915,2418.1916277652163
STAT,1854,54,35-39,1908,0.006407790509221475
STAT,1833,101,na,1934,0.37472606100395234
STAT,1867,33,20-24,1900,2.5778803138264923
SIM,1875,33,20-24,1908,2
SIM,1915,19,20-24,1934,26
STAT,1947,15,35-39,1962,4.825187703704472
STAT,1902,42,15-19,1944,0.001377937875050406
SIM,1829,72,na,1901,550
STAT,1815,50,40-44,1865,0.02816372506506057
SIM,1898,18,50-100,1916,1
STAT,1945,25,45-49,1970,1.9354482928996244
STAT,1832,94,na,1926,13.355255726904641
STAT,1835,83,na,1918,295.781466293232
SIM,1823,32,45-49,1855,5
SIM,1903,16,na,1919,3601
STAT,1838,21,50-100,1859,0.39154384419787214
SIM,1861,75,na,1936,967
STAT,1845,29,30-34,1874,23.60628728856092
STAT,1851,46,30-34,1897,0.08008842466797458
STAT,1885,33,na,1918,2418.4875158701398
STAT,1793,103,na,1896,0.02874830114503302
STAT,1910,35,25-29,1945,0.9695501034666733
SIM,1869,15,25-29,1884,8
SIM,1863,6,na,1869,2503
SIM,1872,38,na,1910,2469
SIM,1878,29,35-39,1907,10
SIM,1846,21,50-100,1867,5
SIM,1898,29,na,1927,3588
SIM,1923,24,20-24,1947,140
SIM,1852,61,na,1913,1546
STAT,1821,43,25-29,1864,1.0787097967044403
STAT,1899,24,35-39,1923,8.100955965725475
STAT,1832,53,45-49,1885,0.009937389516731811
STAT,1895,39,50-100,1934,1.6176921745832071
STAT,1924,36,30-34,1960,2.194659330557673
STAT,1902,44,30-34,1946,0.11330440179426374
SIM,1853,29,30-34,1882,30
SIM,1863,53,na,1916,1791
STAT,1882,23,45-49,1905,0.6909102220888086
STAT,1842,31,na,1873,2074.552129226058
SIM,1901,32,20-24,1933,7
STAT,1916,43,20-24,1959,0.01843941502705887
STAT,1889,58,na,1947,2492.056867475687
STAT,1897,40,30-34,1937,0.1099971215718448
SIM,1903,16,25-29,1919,15
STAT,1839,23,25-29,1862,50.39831345917962
STAT,1935,36,40-44,1971,2.1366583876064826
SIM,1928,22,na,1950,4731
SIM,1927,29,na,1956,4442
STAT,1807,76,na,1883,462.4193870886712
SIM,1947,9,na,1956,4673
STAT,1816,87,na,1903,78.17377635888822
STAT,1913,44,40-44,1957,0.24800740944608096
SIM,1918,29,40-44,1947,3
STAT,1849,52,45-49,1901,0.011206886272973778
SIM,1877,59,na,1936,2003
SIM,1918,15,na,1933,4468
STAT,1803,69,na,1872,805.1831776776442
STAT,1858,23,35-39,1881,4.8937350365069205
STAT,1924,34,15-19,1958,0.15276231117884378
STAT,1889,40,na,1929,2941.8821773227405
SIM,1930,21,35-39,1951,18
SIM,1895,45,40-44,1940,1
STAT,1880,26,50-100,1906,0.6881225627607939
STAT,1912,33,35-39,1945,9.134349893929276
SIM,1821,53,35-39,1874,1
SIM,1851,35,25-29,1886,2
SIM,1887,66,na,1953,1913
STAT,1891,26,15-19,1917,0.5749918446057036
SIM,1920,33,35-39,1953,11
STAT,1771,103,na,1874,0.04716064305932864
SIM,1930,15,na,1945,5170
SIM,1874,40,45-49,1914,3
SIM,1838,43,45-49,1881,3
STAT,1880,44,35-39,1924,1.915042819115891
STAT,1865,53,40-44,1918,0.009591072600495224
STAT,1857,30,na,1887,1953.0994157274436
STAT,1876,22,na,1898,2491.4116967032696
SIM,1879,44,45-49,1923,1
STAT,1887,45,40-44,1932,0.19765552507730014
STAT,1934,24,30-34,1958,39.362856010597895
STAT,1890,37,na,1927,2938.697164647134
STAT,1844,97,na,1941,4.163011711730576
STAT,1843,35,25-29,1878,2.770352145975068
STAT,1909,46,40-44,1955,0.14812083764681244
SIM,1888,24,25-29,1912,76
STAT,1861,23,na,1884,2033.4595766664904
SIM,1871,20,30-34,1891,34
SIM,1900,21,15-19,1921,5
STAT,1863,89,na,1952,93.96530353840105
SIM,1929,19,15-19,1948,62
STAT,1804,51,50-100,1855,0.04521325810142101
STAT,1805,95,na,1900,5.343834287544441
STAT,1939,10,na,1949,4049.4127931875028
SIM,1827,39,30-34,1866,6
SIM,1886,81,na,1967,860
STAT,1824,35,15-19,1859,0.08387108362565059
SIM,1942,24,30-34,1966,3
SIM,1920,32,30-34,1952,9
SIM,1785,76,na,1861,338
SIM,1838,34,50-100,1872,1
STAT,1856,51,40-44,1907,0.008470915679043435
SIM,1801,77,na,1878,337
STAT,1841,19,45-49,1860,0.06147476133742723
STAT,1844,47,35-39,1891,0.10798181939944608
SIM,1805,62,na,1867,890
STAT,1853,30,15-19,1883,0.1255465707961517
SIM,1876,74,na,1950,1247
STAT,1868,53,25-29,1921,0.003395808644788983
SIM,1866,23,35-39,1889,1
STAT,1819,39,30-34,1858,12.703361839751993
STAT,1881,52,na,1933,2112.3155168980034
STAT,1932,29,na,1961,4998.981531247291
STAT,1841,22,45-49,1863,0.6522368147192752
STAT,1902,46,50-100,1948,0.1998741711307849
STAT,1953,19,50-100,1972,0.46200259393293736
SIM,1825,39,na,1864,1576
STAT,1919,35,45-49,1954,0.751536330856335
STAT,1854,109,na,1963,0.0026540826522778362
STAT,1956,11,na,1967,5302.046161335339
SIM,1821,55,na,1876,1245
SIM,1889,23,35-39,1912,1
STAT,1916,25,20-24,1941,19.39116796466674
SIM,1944,19,40-44,1963,1
SIM,1898,52,na,1950,3307
SIM,1901,38,30-34,1939,5
SIM,1918,16,35-39,1934,1
STAT,1941,17,25-29,1958,45.538015704173375
SIM,1889,21,40-44,1910,3
STAT,1829,74,na,1903,738.1024488816958
STAT,1916,27,15-19,1943,0.7448811603046513
SIM,1828,41,20-24,1869,2
STAT,1825,84,na,1909,199.4857492283466
SIM,1919,43,40-44,1962,1
SIM,1936,31,na,1967,3319
SIM,1928,36,na,1964,5008
STAT,1848,17,45-49,1865,0.06294603997818106
SIM,1829,28,40-44,1857,5
SIM,1857,78,na,1935,505
SIM,1910,26,na,1936,3579
STAT,1911,47,na,1958,3547.6647191106927
STAT,1861,38,40-44,1899,3.671792970446233
SIM,1903,35,30-34,1938,2
STAT,1920,27,35-39,1947,16.807078834023905
SIM,1873,16,35-39,1889,1
STAT,1841,23,na,1864,1985.5296673440946
STAT,1856,76,na,1932,758.6841625525732
SIM,1853,88,na,1941,118
STAT,1931,15,45-49,1946,0.6699322547087039
SIM,1924,25,20-24,1949,24
STAT,1865,16,35-39,1881,0.5266395629947517
STAT,1922,24,35-39,1946,10.948760400683481
SIM,1933,18,25-29,1951,72
STAT,1830,42,50-100,1872,0.9113421273453043
STAT,1850,21,50-100,1871,0.3708303056416798
STAT,1876,16,50-100,1892,0.05173623839768324
STAT,1920,2,na,1922,4682.619004567936
STAT,1860,81,na,1941,447.59849007928506
STAT,1872,15,na,1887,2621.5393858517778
SIM,1802,96,na,1898,3
SIM,1893,29,na,1922,3131
SIM,1907,28,25-29,1935,3
SIM,1912,28,35-39,1940,19
STAT,1844,106,na,1950,0.009408733721244003
STAT,1883,78,na,1961,980.8614611832213
SIM,1855,30,25-29,1885,8
SIM,1848,40,50-100,1888,2
STAT,1926,8,na,1934,4988.558213381981
SIM,1950,15,20-24,1965,169
STAT,1900,33,15-19,1933,0.20050756558185864
STAT,1911,21,25-29,1932,89.62772056643747
STAT,1877,15,15-19,1892,6.3084392575759285
SIM,1837,30,na,1867,1720
STAT,1807,54,50-100,1861,0.05991862459608894
STAT,1862,51,30-34,1913,0.005193926802723343
SIM,1866,101,na,1967,3
STAT,1816,48,na,1864,1304.4436172155872
SIM,1903,33,35-39,1936,15
STAT,1904,28,35-39,1932,14.057710630952325
SIM,1861,83,na,1944,241
SIM,1860,44,25-29,1904,3
STAT,1908,47,50-100,1955,0.20858368500401858
SIM,1837,34,50-100,1871,1
STAT,1847,30,25-29,1877,9.57492303862405
STAT,1911,36,25-29,1947,0.9747247796069815
SIM,1868,16,25-29,1884,9
STAT,1903,4,na,1907,3814.930385547753
STAT,1931,33,45-49,1964,2.1015416497943087
STAT,1925,18,25-29,1943,53.26870666145084
SIM,1895,25,50-100,1920,1
STAT,1870,53,50-100,1923,0.014819581637770534
SIM,1906,29,20-24,1935,17
SIM,1930,22,40-44,1952,7
STAT,1859,17,20-24,1876,16.766109102532486
STAT,1813,50,50-100,1863,0.037730660852325695
STAT,1921,25,30-34,1946,44.86391608718272
STAT,1835,31,45-49,1866,1.6720964837583516
SIM,1831,36,50-100,1867,5
SIM,1950,17,15-19,1967,67
STAT,1902,29,40-44,1931,4.2787533367908415
SIM,1826,78,na,1904,400
SIM,1826,86,na,1912,95
STAT,1928,42,30-34,1970,0.1662423958358122
SIM,1822,96,na,1918,6
STAT,1777,100,na,1877,0.2561288623162558
SIM,1920,32,25-29,1952,3
STAT,1896,25,25-29,1921,57.38163777635565
SIM,1888,22,na,1910,2766
SIM,1910,29,40-44,1939,5
STAT,1848,18,50-100,1866,0.04693146585203219
STAT,1904,26,40-44,1930,4.394741635802358
STAT,1923,16,50-100,1939,0.4499708728615681
STAT,1850,51,na,1901,1627.3724207230032
SIM,1907,26,30-34,1933,50
STAT,1926,45,30-34,1971,0.1127405755289764
STAT,1929,41,35-39,1970,0.26636029896176977
SIM,1851,53,na,1904,1708
STAT,1798,97,na,1895,1.8492776057054283
STAT,1839,24,40-44,1863,1.8213868488513916
STAT,1889,18,45-49,1907,0.08210007121905183
STAT,1909,48,35-39,1957,0.12049056134277777
STAT,1862,17,na,1879,2282.9990232727346
SIM,1800,61,na,1861,874
STAT,1873,20,25-29,1893,59.55950813823884
SIM,1852,47,na,1899,1874
STAT,1843,54,25-29,1897,0.0027807405811694336
STAT,1870,46,40-44,1916,0.17121611175510218
STAT,1811,43,25-29,1854,1.983406522419843
STAT,1903,28,45-49,1931,1.604454713840663
SIM,1905,30,35-39,1935,11
STAT,1867,48,na,1915,2127.669419449086
STAT,1856,37,50-100,1893,0.983180702150231
STAT,1892,49,25-29,1941,0.04067464023500984
STAT,1907,32,15-19,1939,0.12248295237240125
STAT,1912,32,25-29,1944,9.277714403297436
SIM,1912,26,40-44,1938,7
SIM,1867,60,na,1927,1692
STAT,1936,19,40-44,1955,1.358503981752032
STAT,1871,0,na,1871,3760.8175749494517
SIM,1842,37,na,1879,1892
STAT,1915,27,25-29,1942,68.50785310417541
SIM,1851,73,na,1924,840
SIM,1797,76,na,1873,283
SIM,1834,73,na,1907,906
STAT,1888,19,40-44,1907,0.21940183230965063
STAT,1900,15,15-19,1915,8.430143058577286
STAT,1826,58,na,1884,1224.5113629865514
STAT,1855,35,na,1890,1843.6945061915442
STAT,1898,20,30-34,1918,24.71959473782633
STAT,1911,5,na,1916,4090.7041717694647
SIM,1917,48,35-39,1965,1
SIM,1830,91,na,1921,38
SIM,1922,28,20-24,1950,25
STAT,1854,2,na,1856,2741.909990320475
SIM,1913,25,45-49,1938,4
STAT,1835,48,40-44,1883,0.13279629575077975
STAT,1914,28,20-24,1942,18.709072632093942
SIM,1865,21,25-29,1886,64
STAT,1927,44,35-39,1971,0.2567563773745526
SIM,1867,17,20-24,1884,25
STAT,1922,22,40-44,1944,3.9343549818550287
STAT,1942,17,15-19,1959,48.38737744424708
STAT,1905,25,45-49,1930,1.6469572721258534
SIM,1909,23,30-34,1932,2
STAT,1925,44,50-100,1969,0.1446287823150177
STAT,1940,5,na,1945,4147.725249954583
STAT,1864,71,na,1935,1210.7740271952844
SIM,1888,24,30-34,1912,23
STAT,1835,94,na,1929,14.890944661837565
STAT,1918,39,45-49,1957,0.7316997804803841
STAT,1912,21,50-100,1933,0.6452285776503963
STAT,1940,20,35-39,1960,9.792157641678006
SIM,1893,39,40-44,1932,9
STAT,1937,35,35-39,1972,2.4713426352703824
SIM,1820,81,na,1901,310
STAT,1930,26,na,1956,4860.437907586126
STAT,1906,24,50-100,1930,0.6017152807579147
SIM,1904,31,30-34,1935,15
SIM,1814,73,na,1887,513
SIM,1854,42,na,1896,2007
SIM,1942,21,20-24,1963,183
SIM,1921,31,30-34,1952,29
STAT,1796,62,na,1858,892.9869393181646
STAT,1874,81,na,1955,563.2396803181473
STAT,1874,21,25-29,1895,59.804857970014815
STAT,1913,19,45-49,1932,0.10363569198134932
SIM,1925,21,20-24,1946,188
SIM,1923,27,25-29,1950,7
STAT,1874,10,na,1884,2757.0627709579744
SIM,1858,42,45-49,1900,3
STAT,1930,19,45-49,1949,0.6551565361333692
SIM,1916,11,na,1927,4335
STAT,1937,33,40-44,1970,3.9467396792435774
SIM,1925,23,15-19,1948,6
STAT,1864,18,40-44,1882,0.17061738952945127
STAT,1816,56,na,1872,1130.6713339238754
STAT,1810,47,25-29,1857,0.1810850246028531
STAT,1782,82,na,1864,154.6459814748801
STAT,1905,43,45-49,1948,0.15201821700539456
SIM,1865,65,na,1930,1534
SIM,1943,13,na,1956,3901
STAT,1837,23,50-100,1860,0.3533696121981946
SIM,1888,27,35-39,1915,19
STAT,1799,106,na,1905,0.003939843500252487
STAT,1908,33,15-19,1941,0.12316808548091977
SIM,1926,39,45-49,1965,2
STAT,1934,21,20-24,1955,152.44166733474455
SIM,1897,15,40-44,1912,1
STAT,1829,34,25-29,1863,9.172354677498912
STAT,1920,45,35-39,1965,0.14612611687768615
SIM,1842,17,na,1859,2187
SIM,1881,3,na,1884,2634
STAT,1885,39,40-44,1924,4.410488624966183
SIM,1879,14,na,1893,3162
STAT,1917,21,20-24,1938,120.96513002646276
STAT,1805,64,na,1869,1024.1458479036933
STAT,1871,53,na,1924,2140.8937179881464
SIM,1843,78,na,1921,553
SIM,1847,24,40-44,1871,6
STAT,1864,51,na,1915,1962.445170959368
STAT,1942,15,20-24,1957,144.62627549935758
STAT,1821,53,35-39,1874,0.01277062586423428
STAT,1807,51,na,1858,1416.7288095153276
STAT,1873,88,na,1961,247.12128665418746
STAT,1841,15,na,1856,2211.885449134136
SIM,1906,27,25-29,1933,67
STAT,1847,18,40-44,1865,0.176968001871421
STAT,1890,12,na,1902,3221.2588228683585
SIM,1837,34,25-29,1871,14
SIM,1916,31,20-24,1947,3
STAT,1889,15,40-44,1904,0.23155498657125834
STAT,1869,21,15-19,1890,3.2590463118286572
STAT,1887,68,na,1955,1746.933638746873
SIM,1892,1,na,1893,3910
SIM,1847,26,35-39,1873,10
STAT,1847,48,na,1895,1732.4103253506637
SIM,1905,59,na,1964,2987
STAT,1842,96,na,1938,6.733696386181553
STAT,1859,24,50-100,1883,0.3397707825778323
SIM,1884,32,45-49,1916,1
STAT,1914,30,35-39,1944,9.460774238873126
STAT,1891,73,na,1964,1775.902471664742
SIM,1867,49,40-44,1916,1
STAT,1891,53,na,1944,2675.856059566859
SIM,1863,78,na,1941,550
STAT,1824,43,na,1867,1494.6846601313512
SIM,1811,45,na,1856,1275
SIM,1848,22,na,1870,2231
SIM,1897,17,35-39,1914,1
STAT,1876,49,40-44,1925,0.17658160033272913
STAT,1903,41,15-19,1944,0.001396975616696488
STAT,1875,35,na,1910,2490.1600627492076
STAT,1889,17,35-39,1906,0.6914523311215826
STAT,1860,54,30-34,1914,0.004791520547469899
STAT,1902,30,na,1932,3460.651048377597
SIM,1786,92,na,1878,4
SIM,1874,30,na,1904,2416
SIM,1812,86,na,1898,110
STAT,1876,32,45-49,1908,1.836993538148652
STAT,1928,43,40-44,1971,0.32473212039257493
STAT,1891,39,50-100,1930,1.5350301119409753
STAT,1917,23,15-19,1940,5.755651143602146
STAT,1913,31,30-34,1944,16.056594142090052
SIM,1901,23,30-34,1924,35
STAT,1908,31,20-24,1939,2.3573717149102316
SIM,1882,37,na,1919,2259
STAT,1820,61,na,1881,1080.8836071681822
SIM,1878,35,25-29,1913,4
STAT,1839,26,35-39,1865,8.449712838131267
SIM,1927,6,na,1933,4922
STAT,1831,33,na,1864,1870.0099743205242
STAT,1897,1,na,1898,3712.7254690762834
STAT,1903,45,35-39,1948,0.11566364323866542
STAT,1933,22,15-19,1955,7.200884580639274
STAT,1904,57,na,1961,3063.361569261425
SIM,1939,18,20-24,1957,148
SIM,1888,25,40-44,1913,8
STAT,1834,49,35-39,1883,0.09738852259303088
STAT,1858,20,30-34,1878,16.773763245284684
SIM,1806,86,na,1892,155
STAT,1922,21,30-34,1943,33.73218347548326
SIM,1803,58,na,1861,887
SIM,1931,20,35-39,1951,16
SIM,1916,19,35-39,1935,3
SIM,1942,23,15-19,1965,5
STAT,1908,19,35-39,1927,0.8255532326865157
STAT,1934,23,15-19,1957,7.292971564809434
SIM,1817,41,45-49,1858,3
STAT,1915,29,na,1944,3871.247347233869
SIM,1868,22,na,1890,2510
SIM,1930,21,30-34,1951,58
SIM,1842,49,35-39,1891,1
SIM,1902,37,35-39,1939,2
STAT,1909,49,45-49,1958,0.20248504214587396
STAT,1934,22,50-100,1956,0.901777488227374
STAT,1938,32,45-49,1970,1.6140259598517828
SIM,1917,49,45-49,1966,2
STAT,1920,41,15-19,1961,0.0017333260748796009
SIM,1911,45,35-39,1956,1
STAT,1778,77,na,1855,209.2011
STAT,1859,49,40-44,1908,0.13656698223164807
STAT,1852,43,50-100,1895,0.8449313641344744
STAT,1923,20,35-39,1943,11.244979177801124
STAT,1836,56,na,1892,1269.5387462956985
STAT,1912,35,30-34,1947,1.831891112118697
STAT,1933,25,20-24,1958,24.73938219968621
SIM,1883,47,30-34,1930,1
STAT,1927,43,25-29,1970,0.09121145290976138
SIM,1862,37,na,1899,2174
STAT,1907,22,na,1929,3542.5754659980757
SIM,1912,29,45-49,1941,3
STAT,1818,82,na,1900,237.77824521356513
STAT,1878,63,na,1941,1894.6835013933917
SIM,1900,5,na,1905,3768
SIM,1905,31,45-49,1936,1
STAT,1908,47,na,1955,3387.9833742547626
SIM,1905,28,20-24,1933,17
STAT,1779,100,na,1879,0.17528893226993597
STAT,1937,6,na,1943,3977.267438796443
SIM,1890,21,50-100,1911,1
STAT,1841,37,50-100,1878,1.0680436306988534
STAT,1941,16,15-19,1957,47.70360172210731
SIM,1895,49,50-100,1944,1
STAT,1823,38,na,1861,1577.6264125270022
SIM,1902,18,25-29,1920,8
SIM,1907,48,50-100,1955,1
STAT,1920,26,25-29,1946,73.93599800530926
STAT,1862,54,35-39,1916,0.007270519258995611
STAT,1838,33,50-100,1871,0.8278954466588464
STAT,1856,43,50-100,1899,0.8398989789610471
SIM,1839,30,40-44,1869,3
SIM,1849,63,na,1912,1359
STAT,1887,35,25-29,1922,3.3225643596456327
SIM,1924,45,50-100,1969,1
STAT,1902,25,50-100,1927,0.9265341306272505
STAT,1837,41,20-24,1878,0.12655809741111873
SIM,1879,34,30-34,1913,29
SIM,1920,16,na,1936,4027
SIM,1858,27,20-24,1885,12
STAT,1936,11,na,1947,3874.885022200487
SIM,1881,20,25-29,1901,66
SIM,1919,42,30-34,1961,1
STAT,1913,31,50-100,1944,0.8426128924904696
STAT,1904,29,45-49,1933,1.6117339673228297
STAT,1849,74,na,1923,861.5960549332933
STAT,1914,15,45-49,1929,0.10592020489395036
STAT,1826,54,25-29,1880,0.002568531294206297
SIM,1907,25,20-24,1932,28
STAT,1903,42,25-29,1945,0.0645871446945734
STAT,1916,40,15-19,1956,0.0016104226913829917
STAT,1885,22,45-49,1907,0.7097191096276414
STAT,1919,37,40-44,1956,1.6411484473471611
SIM,1923,9,na,1932,4590
STAT,1919,19,40-44,1938,1.5688763507836554
SIM,1877,21,15-19,1898,4
SIM,1878,32,20-24,1910,4
STAT,1879,29,40-44,1908,3.1715040404940433
STAT,1778,97,na,1875,0.6113947570812996
SIM,1856,31,25-29,1887,17
STAT,1893,45,25-29,1938,0.042467571362227195
SIM,1790,66,na,1856,604
STAT,1855,15,na,1870,2141.5998172515187
STAT,1882,17,na,1899,2510.1414066667894
SIM,1908,27,30-34,1935,77
STAT,1876,76,na,1952,998.0228484910579
STAT,1931,28,20-24,1959,24.023074366195253
STAT,1826,41,45-49,1867,1.2483446324260519
STAT,1830,31,na,1861,1789.112978195458
STAT,1915,44,45-49,1959,0.17041399545386637
STAT,1910,38,30-34,1948,1.7689970504792811
SIM,1886,27,na,1913,2767
STAT,1893,32,45-49,1925,2.256761323622465
STAT,1835,51,50-100,1886,0.011701894969453052
SIM,1926,41,na,1967,4922
SIM,1927,19,40-44,1946,5
STAT,1819,76,na,1895,558.548483253999
SIM,1913,22,40-44,1935,6
SIM,1833,88,na,1921,94
SIM,1854,34,25-29,1888,16
STAT,1888,30,15-19,1918,0.1731270545955934
STAT,1921,28,35-39,1949,17.014528345478364
STAT,1876,17,20-24,1893,18.675755920512852
STAT,1908,18,25-29,1926,8.549313483622734
SIM,1879,16,30-34,1895,3
SIM,1933,15,20-24,1948,174
STAT,1905,38,20-24,1943,0.24392060588300465
STAT,1910,23,30-34,1933,27.443211344953674
STAT,1922,25,45-49,1947,2.0082294802466607
SIM,1808,81,na,1889,171
STAT,1868,33,na,1901,2315.331469685082
STAT,1860,53,20-24,1913,6.009795648350281E-4
STAT,1936,34,35-39,1970,9.041557452256662
STAT,1822,100,na,1922,0.6172871443528609
STAT,1911,33,20-24,1944,2.4125318247617713
SIM,1793,66,na,1859,655
STAT,1909,2,na,1911,4077.017941760977
STAT,1852,31,45-49,1883,1.4697117159762119
STAT,1868,10,na,1878,2634.980887663793
STAT,1931,30,40-44,1961,5.235486827066368
SIM,1931,21,45-49,1952,2
STAT,1839,76,na,1915,653.8457404643659
STAT,1925,15,20-24,1940,167.8668647558904
SIM,1810,91,na,1901,81
STAT,1848,31,25-29,1879,9.38192469826636
SIM,1921,47,45-49,1968,1
SIM,1892,67,na,1959,2356
STAT,1902,31,25-29,1933,14.795695118233384
STAT,1913,47,45-49,1960,0.21640924022793717
SIM,1930,25,45-49,1955,4
STAT,1795,69,na,1864,614.6929666959902
STAT,1858,21,40-44,1879,1.9482258974958229
STAT,1905,22,40-44,1927,3.070168419559048
STAT,1884,71,na,1955,1347.1910523547542
STAT,1815,94,na,1909,10.33430994646926
STAT,1860,61,na,1921,1546.696302067076
SIM,1901,35,25-29,1936,2
SIM,1823,81,na,1904,359
STAT,1790,77,na,1867,356.62405850135576
STAT,1895,43,na,1938,3064.610380569357
SIM,1884,60,na,1944,1898
STAT,1875,47,30-34,1922,0.10087812964473546
SIM,1941,25,20-24,1966,30
STAT,1921,40,25-29,1961,0.08230145629750261
SIM,1840,81,na,1921,268
SIM,1916,18,25-29,1934,14
STAT,1852,44,25-29,1896,0.5103398725276973
SIM,1911,25,40-44,1936,7
SIM,1901,39,40-44,1940,2
STAT,1867,43,50-100,1910,1.0044884728900298
STAT,1923,21,45-49,1944,1.339802598767091
STAT,1899,21,30-34,1920,24.958344411811584
STAT,1838,28,40-44,1866,2.7796691770699393
STAT,1846,34,25-29,1880,8.478070829223153
SIM,1860,31,45-49,1891,1
SIM,1895,32,na,1927,3302
STAT,1916,28,25-29,1944,69.20529454999591
SIM,1924,28,25-29,1952,82
SIM,1868,2,na,1870,3140
STAT,1901,16,15-19,1917,8.4868994330511
STAT,1842,17,na,1859,2311.560367370011
SIM,1864,24,40-44,1888,3
SIM,1908,16,na,1924,4138
STAT,1902,22,na,1924,3402.466537875477
STAT,1880,47,40-44,1927,0.18267583638783674
SIM,1902,36,25-29,1938,1
SIM,1903,24,na,1927,3296
STAT,1818,54,50-100,1872,0.0315813224046289
STAT,1863,31,20-24,1894,2.4276360282959244
STAT,1856,24,40-44,1880,1.91033314857213
STAT,1801,54,20-24,1855,0.001996772430495296
STAT,1928,25,50-100,1953,1.2592941611535287
STAT,1945,27,40-44,1972,5.217238398557825
STAT,1903,25,40-44,1928,4.373532426897889
STAT,1951,21,20-24,1972,135.57046288432258
SIM,1943,21,na,1964,3592
SIM,1846,28,40-44,1874,5
STAT,1917,52,na,1969,3850.0427646945504
STAT,1887,22,50-100,1909,0.46615883170682976
SIM,1859,23,20-24,1882,64
STAT,1930,16,40-44,1946,1.8488592134015085
STAT,1918,43,50-100,1961,0.12726305651359823
STAT,1938,22,50-100,1960,0.6643037617598749
STAT,1844,21,45-49,1865,0.6795569242073182
STAT,1908,27,na,1935,3609.972162907297
STAT,1924,47,20-24,1971,0.013422977675854262
SIM,1848,21,25-29,1869,73
SIM,1904,2,na,1906,4120
SIM,1925,24,25-29,1949,158
STAT,1897,24,30-34,1921,24.144504933050627
STAT,1895,0,na,1895,3908.2960224692542
STAT,1917,30,50-100,1947,0.8906266397201213
STAT,1919,19,na,1938,4128.5429416115785
SIM,1910,31,25-29,1941,6
STAT,1834,46,30-34,1880,0.07689633390367645
STAT,1857,20,40-44,1877,1.9444387377252637
SIM,1841,20,25-29,1861,45
STAT,1823,58,na,1881,1191.6566231093166
STAT,1913,32,40-44,1945,3.971970981368779
SIM,1950,15,na,1965,4421
STAT,1851,48,25-29,1899,0.046923897687600455
SIM,1904,34,35-39,1938,14
SIM,1851,20,50-100,1871,2
STAT,1884,40,50-100,1924,1.0770174553690004
SIM,1860,46,50-100,1906,1
STAT,1812,66,na,1878,883.0522444053195
STAT,1937,32,30-34,1969,15.899519720776176
STAT,1821,50,30-34,1871,0.009374328084146052
STAT,1918,36,40-44,1954,1.6179191856538806
STAT,1773,103,na,1876,0.051752021074437424
STAT,1799,59,na,1858,973.7238387170651
SIM,1836,45,na,1881,1795
STAT,1900,33,45-49,1933,2.4552717777945725
SIM,1911,42,30-34,1953,1
STAT,1924,7,na,1931,4856.550600851544
STAT,1915,44,15-19,1959,0.0015724475886346044
STAT,1921,23,35-39,1944,10.818950181542998
STAT,1829,31,20-24,1860,2.578291352629446
STAT,1968,2,na,1970,5013.175304409396
STAT,1874,22,35-39,1896,6.078013436283494
SIM,1838,33,30-34,1871,19
STAT,1843,20,50-100,1863,0.4192093385988876
STAT,1926,17,30-34,1943,15.245304978621446
STAT,1909,47,25-29,1956,0.0497114568737494
SIM,1896,31,25-29,1927,16
SIM,1881,75,na,1956,916
SIM,1827,40,na,1867,1586
SIM,1866,21,40-44,1887,2
STAT,1923,18,20-24,1941,162.0049922735143
STAT,1896,22,20-24,1918,92.84948620138974
SIM,1891,42,na,1933,2962
SIM,1901,20,20-24,1921,112
STAT,1831,25,na,1856,1945.1077993809765
STAT,1843,58,na,1901,1596.461073449708
STAT,1924,19,20-24,1943,163.83404289116325
SIM,1917,29,25-29,1946,101
STAT,1901,37,na,1938,3387.5086234442965
SIM,1921,8,na,1929,5255
SIM,1884,40,na,1924,2490
STAT,1872,24,25-29,1896,58.16320522840397
SIM,1875,55,na,1930,2021
SIM,1796,82,na,1878,111
STAT,1866,86,na,1952,208.77887332055843
SIM,1913,40,40-44,1953,1
SIM,1839,17,na,1856,2204
STAT,1917,24,25-29,1941,99.55611188011527
SIM,1903,32,25-29,1935,9
STAT,1917,42,25-29,1959,0.07604888884239591
SIM,1921,32,40-44,1953,12
SIM,1931,18,20-24,1949,165
STAT,1932,29,20-24,1961,24.358616977802697
SIM,1786,84,na,1870,60
SIM,1820,61,na,1881,1253
SIM,1932,19,20-24,1951,176
SIM,1937,26,45-49,1963,5
STAT,1881,12,na,1893,2547.0703928174794
STAT,1905,40,40-44,1945,0.23245014016827018
STAT,1917,32,na,1949,4041.562258405474
STAT,1909,29,25-29,1938,63.69521039212448
SIM,1865,20,40-44,1885,3
SIM,1882,14,na,1896,2512
SIM,1964,7,na,1971,5230
STAT,1843,89,na,1932,84.80687287284688
SIM,1819,73,na,1892,614
SIM,1778,97,na,1875,4
SIM,1940,29,20-24,1969,27
SIM,1930,24,35-39,1954,15
STAT,1854,15,50-100,1869,0.04538744336467608
STAT,1938,19,15-19,1957,45.63689484684067
STAT,1878,42,20-24,1920,0.16842978096394212
STAT,1901,44,15-19,1945,0.001349598720341787
STAT,1903,42,30-34,1945,0.11563182309298412
STAT,1850,91,na,1941,43.5886277171138
SIM,1887,29,40-44,1916,4
STAT,1907,35,20-24,1942,0.2515867418483027
STAT,1896,48,50-100,1944,0.1843154018892824
SIM,1836,20,15-19,1856,3
STAT,1855,53,40-44,1908,0.008029981899872392
STAT,1925,19,na,1944,4512.039083611848
SIM,1866,44,50-100,1910,3
STAT,1806,66,na,1872,825.3068612120832
STAT,1905,5,na,1910,3861.103507322608
STAT,1904,25,30-34,1929,37.06737779143593
STAT,1949,17,50-100,1966,0.44455374052857954
SIM,1892,27,na,1919,3628
SIM,1916,31,50-100,1947,1
SIM,1912,25,30-34,1937,47
STAT,1819,84,na,1903,196.1239230558362
SIM,1844,32,na,1876,2038
SIM,1844,71,na,1915,971
STAT,1942,18,25-29,1960,46.18890211861919
SIM,1915,18,na,1933,4462
SIM,1933,34,30-34,1967,23
SIM,1837,31,20-24,1868,5
SIM,1950,18,25-29,1968,55
SIM,1906,24,20-24,1930,117
STAT,1864,20,na,1884,2211.4340447110058
STAT,1883,15,40-44,1898,0.18393025436108734
SIM,1920,35,30-34,1955,3
STAT,1868,25,15-19,1893,0.4450721094404568
SIM,1946,19,15-19,1965,70
SIM,1888,21,25-29,1909,2
SIM,1915,49,na,1964,4091
STAT,1889,32,25-29,1921,12.90715259174285
STAT,1898,21,40-44,1919,2.883402573676266
SIM,1838,32,na,1870,1766
STAT,1848,33,na,1881,1948.1877030731237
SIM,1889,22,25-29,1911,99
STAT,1788,67,na,1855,800.5854000000002
STAT,1888,31,25-29,1919,12.403269042869693
STAT,1931,41,50-100,1972,0.16029154372309665
STAT,1878,15,30-34,1893,1.7003316215608841
SIM,1934,17,30-34,1951,23
SIM,1831,53,na,1884,1387
STAT,1856,23,30-34,1879,16.44751565768407
STAT,1925,34,30-34,1959,19.063353378705873
STAT,1958,9,na,1967,5263.493145956693
SIM,1897,32,25-29,1929,23
SIM,1926,36,40-44,1962,3
STAT,1929,38,50-100,1967,0.5492172387288063
STAT,1943,24,na,1967,3961.246882462087
STAT,1818,106,na,1924,0.006187609141314869
STAT,1925,16,30-34,1941,15.05903586941267
STAT,1877,78,na,1955,826.7171684470683
STAT,1899,22,40-44,1921,2.911017804312407
STAT,1923,36,15-19,1959,0.02272314428418213
STAT,1911,34,30-34,1945,15.515190526206736
SIM,1864,23,30-34,1887,30
SIM,1911,24,30-34,1935,33
SIM,1868,15,15-19,1883,7
STAT,1858,44,50-100,1902,0.8431411356994205
STAT,1861,7,na,1868,2398.1368141875305
STAT,1901,21,50-100,1922,0.5835016438196862
STAT,1921,41,35-39,1962,0.23177258835379103
STAT,1862,48,na,1910,1929.2127166866858
STAT,1808,92,na,1900,13.865491817369556
STAT,1915,26,15-19,1941,0.7373003598766923
STAT,1781,97,na,1878,0.8921484311658476
SIM,1940,16,na,1956,4100
STAT,1867,29,15-19,1896,0.4314196752750587
STAT,1898,24,45-49,1922,0.9559694303302129
SIM,1866,47,30-34,1913,1
SIM,1900,24,20-24,1924,143
STAT,1820,100,na,1920,0.5847058007393044
SIM,1911,26,25-29,1937,91
STAT,1944,16,35-39,1960,4.608468619874121
STAT,1814,109,na,1923,3.3153114402453116E-4
SIM,1936,27,40-44,1963,3
SIM,1952,16,35-39,1968,9
STAT,1779,109,na,1888,0.0026127907939148395
SIM,1843,44,25-29,1887,1
STAT,1857,25,40-44,1882,2.4939426424562194
SIM,1898,31,30-34,1929,39
SIM,1850,7,na,1857,2381
SIM,1879,25,na,1904,2949
SIM,1950,19,35-39,1969,5
STAT,1905,21,30-34,1926,26.32286230063832
STAT,1905,40,35-39,1945,0.18713752645436046
SIM,1839,96,na,1935,9
STAT,1901,33,30-34,1934,24.802558823128244
STAT,1935,19,25-29,1954,60.09090130380082
STAT,1955,16,45-49,1971,0.6765593244286535
SIM,1925,27,30-34,1952,58
STAT,1848,50,35-39,1898,0.006788275161226343
SIM,1839,73,na,1912,858
STAT,1814,52,40-44,1866,0.03003206998572798
STAT,1928,27,40-44,1955,5.857309166614436
SIM,1948,18,50-100,1966,5
STAT,1811,56,na,1867,1116.8690491014963
STAT,1949,18,na,1967,4366.065387044302
STAT,1888,53,na,1941,2555.1399305163245
SIM,1877,22,25-29,1899,3
SIM,1920,15,40-44,1935,3
STAT,1907,34,50-100,1941,0.7813036782336436
STAT,1918,40,50-100,1958,0.12781826213371836
STAT,1912,38,35-39,1950,2.3962997443704332
STAT,1942,19,35-39,1961,4.470904622529601
SIM,1828,33,na,1861,1845
SIM,1955,1,na,1956,5103
SIM,1821,86,na,1907,60
STAT,1762,107,na,1869,0.007486958547234564
SIM,1906,3,na,1909,3920
STAT,1869,22,25-29,1891,56.38168557551048
SIM,1920,38,35-39,1958,3
STAT,1822,96,na,1918,4.992660552073469
STAT,1829,43,na,1872,1713.000735050301
STAT,1881,43,40-44,1924,2.2023846361996195
STAT,1953,19,45-49,1972,0.6160034585772499
SIM,1845,44,25-29,1889,1
SIM,1856,32,35-39,1888,14
STAT,1925,45,15-19,1970,4.5755755746909946E-4
STAT,1903,26,25-29,1929,61.55454194573693
SIM,1879,35,40-44,1914,3
STAT,1864,46,45-49,1910,0.21467921417644512
STAT,1837,44,25-29,1881,0.44811996833803186
STAT,1848,32,35-39,1880,9.180272931858264
STAT,1912,15,40-44,1927,0.2898688044776165
STAT,1893,16,50-100,1909,0.06355838462190332
STAT,1811,47,40-44,1858,0.4755870440493599
STAT,1803,51,25-29,1854,0.014598719504584693
STAT,1857,61,na,1918,1488.7772615677825
SIM,1896,17,na,1913,3485
STAT,1929,26,45-49,1955,2.20626262315726
STAT,1893,49,40-44,1942,0.12236766598371081
STAT,1928,24,na,1952,4621.609914762143
STAT,1919,34,35-39,1953,9.974927900303623
SIM,1934,7,na,1941,5686
SIM,1904,54,na,1958,3236
STAT,1892,30,50-100,1922,1.1808931384850845
STAT,1889,33,35-39,1922,12.707703943269955
STAT,1860,36,30-34,1896,4.432599661778822
STAT,1924,34,na,1958,4495.9892565825985
SIM,1897,33,35-39,1930,30
STAT,1927,29,45-49,1956,2.1338145032799996
STAT,1873,24,40-44,1897,2.1416866295861574
SIM,1889,5,na,1894,3409
STAT,1802,96,na,1898,2.724593668195358
SIM,1894,2,na,1896,3615
SIM,1951,5,na,1956,5318
STAT,1841,15,35-39,1856,0.5287354725010217
STAT,1863,34,25-29,1897,9.083077849622828
SIM,1907,22,15-19,1929,5
STAT,1924,35,20-24,1959,0.3176872814281446
STAT,1890,36,45-49,1926,2.4985173466359702
STAT,1961,8,na,1969,5177.959597303539
STAT,1942,30,45-49,1972,1.7120891623778047
STAT,1823,45,45-49,1868,0.3649896047718352
STAT,1857,23,45-49,1880,0.6367677235628794
STAT,1934,36,25-29,1970,1.3868946189170783
STAT,1812,97,na,1909,2.450313066319758
STAT,1869,24,20-24,1893,67.44760267890456
SIM,1857,39,na,1896,1972
STAT,1858,47,30-34,1905,0.07794684821521898
SIM,1855,44,50-100,1899,1
SIM,1875,35,na,1910,2354
STAT,1912,36,40-44,1948,1.4976608197468897
SIM,1943,4,na,1947,3966
STAT,1905,15,50-100,1920,0.07251728578426588
STAT,1858,106,na,1964,0.05345811758572236
SIM,1943,19,25-29,1962,55
STAT,1944,26,40-44,1970,5.1420481944421
STAT,1835,44,25-29,1879,0.5590123863919025
STAT,1870,42,25-29,1912,0.6396108192910587
STAT,1908,15,20-24,1923,26.941642481242823
SIM,1915,17,25-29,1932,16
SIM,1913,14,na,1927,4235
STAT,1896,40,15-19,1936,0.0013051265580474023
SIM,1901,23,25-29,1924,111
STAT,1875,91,na,1966,172.9676111244047
SIM,1847,91,na,1938,17
SIM,1865,25,40-44,1890,2
STAT,1918,17,na,1935,4304.04069689932
STAT,1859,73,na,1932,967.6798630876209
STAT,1902,46,25-29,1948,0.04687602677489937
SIM,1879,37,35-39,1916,11
STAT,1905,50,na,1955,3218.0342165464904
STAT,1868,26,25-29,1894,41.35856966196454
SIM,1860,81,na,1941,666
STAT,1922,43,45-49,1965,0.19460894318001945
STAT,1858,24,45-49,1882,0.5805872304855979
STAT,1935,37,25-29,1972,1.4040568033719762
SIM,1927,34,35-39,1961,4
STAT,1823,36,50-100,1859,2.3768551456701315
STAT,1900,30,40-44,1930,6.181188241236233
STAT,1907,17,25-29,1924,8.488118644823237
SIM,1880,24,25-29,1904,80
SIM,1843,47,na,1890,1694
STAT,1866,30,30-34,1896,16.56113270821307
SIM,1920,21,50-100,1941,1
STAT,1913,35,45-49,1948,0.6928426686427421
STAT,1785,70,na,1855,657.0387999999999
STAT,1847,34,40-44,1881,3.539068248637155
SIM,1866,24,45-49,1890,1
STAT,1930,31,50-100,1961,1.0888872461109864
STAT,1844,27,50-100,1871,0.6068264981690057
SIM,1854,73,na,1927,978
STAT,1826,89,na,1915,61.27148772948686
STAT,1775,100,na,1875,0.1985587300097384
STAT,1895,12,na,1907,3437.347913194206
SIM,1896,15,25-29,1911,7
STAT,1945,24,35-39,1969,10.521665594072259
STAT,1833,21,35-39,1854,7.655255952730501
SIM,1910,16,30-34,1926,3
STAT,1867,17,na,1884,2472.7935132359726
SIM,1928,32,30-34,1960,30
STAT,1802,53,30-34,1855,0.015459628586124907
SIM,1899,45,na,1944,3203
STAT,1822,33,25-29,1855,27.313657081232858
STAT,1851,45,20-24,1896,0.009998909778074085
SIM,1841,21,35-39,1862,9
STAT,1817,49,35-39,1866,0.30323693346051594
SIM,1908,23,15-19,1931,7
STAT,1887,17,na,1904,2887.104692066382
STAT,1897,25,40-44,1922,4.1137799268207065
STAT,1916,47,35-39,1963,0.13494916990467198
STAT,1800,61,na,1861,1137.761626996048
STAT,1840,42,40-44,1882,1.6884089472627122
STAT,1925,30,15-19,1955,0.15586435029575813
STAT,1888,15,25-29,1903,6.865941623923747
STAT,1897,27,35-39,1924,13.161491432234433
SIM,1879,43,50-100,1922,4
STAT,1926,12,na,1938,4955.863804168637
STAT,1902,16,30-34,1918,2.2986447860370536
SIM,1885,15,15-19,1900,9
STAT,1793,74,na,1867,489.3327563712172
STAT,1789,69,na,1858,544.4320030729799
STAT,1884,2,na,1886,3165.112640902324
SIM,1835,22,20-24,1857,74
STAT,1935,35,30-34,1970,2.603500891765787
SIM,1851,39,35-39,1890,7
STAT,1846,106,na,1952,0.008682786691865303
STAT,1954,17,40-44,1971,1.763718202817271
STAT,1808,81,na,1889,191.93104411606674
STAT,1911,37,35-39,1948,2.3830006804695145
SIM,1857,30,30-34,1887,6
STAT,1936,15,50-100,1951,0.3675466462866095
SIM,1924,47,35-39,1971,1
STAT,1904,41,30-34,1945,0.11725264504169527
STAT,1916,22,15-19,1938,5.692218919771362
STAT,1854,10,na,1864,2213.0117496625617
SIM,1838,36,35-39,1874,9
SIM,1919,39,na,1958,4188
SIM,1912,20,30-34,1932,42
STAT,1951,20,15-19,1971,6.492455247736194
STAT,1901,15,30-34,1916,2.284345270202318
STAT,1877,19,30-34,1896,1.6774067973341773
SIM,1849,24,45-49,1873,4
STAT,1861,34,25-29,1895,8.560267664643295
STAT,1849,30,30-34,1879,16.025671658369184
STAT,1941,26,50-100,1967,1.0509392704247789
SIM,1844,40,na,1884,1930
SIM,1904,35,45-49,1939,1
STAT,1843,39,35-39,1882,5.941080295024409
STAT,1800,72,na,1872,672.9508029237304
SIM,1855,34,40-44,1889,5
STAT,1844,43,na,1887,1810.9384735367353
STAT,1947,22,45-49,1969,1.2974342279729518
SIM,1923,13,na,1936,4560
STAT,1854,36,50-100,1890,0.9441812211519287
STAT,1898,26,40-44,1924,4.146719217409417
SIM,1830,60,na,1890,1250
STAT,1820,46,50-100,1866,0.4545675047485151
STAT,1900,18,20-24,1918,25.00157616007326
SIM,1838,18,35-39,1856,2
SIM,1870,80,na,1950,508
STAT,1921,21,15-19,1942,6.153854943106503
STAT,1881,24,50-100,1905,0.3996766582820945
SIM,1884,42,20-24,1926,1
STAT,1813,90,na,1903,33.90360005841318
STAT,1901,48,30-34,1949,0.07691711116378355
SIM,1826,55,na,1881,1359
SIM,1824,32,50-100,1856,4
STAT,1899,25,45-49,1924,1.561582716947083
STAT,1878,45,25-29,1923,0.06177297719371596
STAT,1921,41,30-34,1962,0.14715018464034854
STAT,1853,88,na,1941,115.11211014542165
STAT,1875,20,30-34,1895,18.76092466079091
STAT,1904,20,30-34,1924,26.198116274280732
SIM,1905,18,15-19,1923,6
SIM,1834,33,na,1867,1777
SIM,1839,35,40-44,1874,3
SIM,1865,25,na,1890,2278
STAT,1939,25,20-24,1964,18.736399009726977
SIM,1913,21,30-34,1934,30
STAT,1915,41,40-44,1956,0.25733794064954985
SIM,1779,82,na,1861,84
SIM,1864,26,35-39,1890,15
STAT,1831,23,25-29,1854,131.7159347586322
STAT,1876,42,20-24,1918,0.16709234272486237
STAT,1942,30,15-19,1972,0.13981622446530623
SIM,1897,67,na,1964,2318
STAT,1836,25,na,1861,1767.5641300216644
STAT,1888,35,40-44,1923,5.329495516290224
STAT,1896,8,na,1904,3502.5075833385204
STAT,1930,31,30-34,1961,20.749528915497805
STAT,1916,40,45-49,1956,0.17452954692527858
STAT,1922,39,na,1961,4358.755447225499
STAT,1892,19,50-100,1911,0.06230322794540343
STAT,1840,30,na,1870,1939.382382047758
SIM,1838,34,40-44,1872,7
STAT,1898,63,na,1961,2605.1469905648655
SIM,1895,35,25-29,1930,8
SIM,1869,18,35-39,1887,2
SIM,1871,65,na,1936,1583
SIM,1905,28,na,1933,3425
STAT,1931,30,35-39,1961,12.225867358625635
SIM,1903,38,35-39,1941,1
STAT,1833,88,na,1921,90.15354387068146
STAT,1895,35,na,1930,3165.6127714534246
SIM,1885,65,na,1950,1761
SIM,1894,39,na,1933,3087
STAT,1946,25,35-39,1971,17.077978219553685
STAT,1827,27,50-100,1854,2.1340226401479865
STAT,1916,29,35-39,1945,15.728225815740197
SIM,1881,72,na,1953,1137
STAT,1933,27,15-19,1960,0.9559394844073348
STAT,1886,21,15-19,1907,3.5730810414440204
STAT,1870,54,20-24,1924,7.156627271944016E-4
STAT,1938,16,45-49,1954,0.5039035533287028
SIM,1869,15,30-34,1884,4
STAT,1920,24,30-34,1944,32.40304117760798
SIM,1860,0,na,1860,3365
STAT,1918,19,25-29,1937,47.875543972174455
STAT,1878,18,35-39,1896,0.5811264144629917
STAT,1881,46,45-49,1927,0.23342232017465617
SIM,1855,38,50-100,1893,4
STAT,1893,19,15-19,1912,7.638990679498836
STAT,1853,15,25-29,1868,5.7837303002123255
STAT,1849,43,na,1892,1781.3933233667458
STAT,1929,29,15-19,1958,0.9002462529021251
SIM,1870,48,35-39,1918,1
STAT,1864,43,40-44,1907,2.0255398141010565
SIM,1872,43,40-44,1915,7
STAT,1944,27,25-29,1971,72.58001158833048
STAT,1833,99,na,1932,1.2436943386322519
STAT,1807,48,50-100,1855,1.0540349536685554
STAT,1820,37,40-44,1857,10.649152454553445
STAT,1916,43,15-19,1959,0.0016034274802598
STAT,1899,48,30-34,1947,0.07532065216884276
STAT,1916,26,30-34,1942,41.48509633919685
STAT,1924,17,25-29,1941,52.65008644600906
SIM,1853,37,50-100,1890,3
SIM,1890,32,na,1922,3123
SIM,1908,39,30-34,1947,1
STAT,1839,19,50-100,1858,0.04371084413406714
SIM,1918,46,na,1964,4129
STAT,1877,29,40-44,1906,3.146910649274519
STAT,1855,91,na,1946,44.92104777565362
STAT,1897,21,25-29,1918,78.3208545427501
SIM,1932,17,25-29,1949,78
STAT,1936,36,30-34,1972,1.8266018514236682
SIM,1859,29,30-34,1888,36
STAT,1847,38,50-100,1885,0.9830938879931655
STAT,1839,23,30-34,1862,15.681709097481008
STAT,1874,40,35-39,1914,1.9051057302951797
STAT,1908,24,na,1932,3555.092878214989
SIM,1894,21,15-19,1915,3
SIM,1902,22,na,1924,3414
STAT,1761,97,na,1858,0.4213449594893741
STAT,1927,26,40-44,1953,5.800086664152983
SIM,1903,17,35-39,1920,1
STAT,1912,18,45-49,1930,0.10277580217202577
SIM,1950,16,30-34,1966,20
STAT,1889,30,30-34,1919,22.1786048566285
SIM,1878,4,na,1882,3009
STAT,1845,37,50-100,1882,1.0079204327432627
SIM,1818,38,40-44,1856,7
SIM,1831,45,na,1876,1550
STAT,1856,26,35-39,1882,8.064737826499663
SIM,1882,22,35-39,1904,6
SIM,1929,32,45-49,1961,6
SIM,1833,43,50-100,1876,1
STAT,1821,43,50-100,1864,1.7746515898746118
STAT,1826,28,15-19,1854,1.3036926849239239
STAT,1901,36,35-39,1937,2.1883377903149075
SIM,1941,27,15-19,1968,1
SIM,1924,26,30-34,1950,73
SIM,1912,41,35-39,1953,2
STAT,1942,16,30-34,1958,12.999259063494573
SIM,1888,50,na,1938,2533
SIM,1922,30,35-39,1952,15
SIM,1897,30,30-34,1927,36
STAT,1798,66,na,1864,950.6351970973277
STAT,1874,25,40-44,1899,3.141232634395255
STAT,1874,47,15-19,1921,4.146820664065328E-4
SIM,1841,52,na,1893,1644
STAT,1901,18,35-39,1919,0.7807261592003703
SIM,1900,39,25-29,1939,1
SIM,1882,40,35-39,1922,4
SIM,1859,73,na,1932,932
STAT,1817,41,na,1858,1507.5349493974782
STAT,1851,49,40-44,1900,0.13829392985967848
STAT,1860,39,35-39,1899,5.795436422750793
STAT,1835,41,20-24,1876,0.14366748949596292
STAT,1865,21,50-100,1886,0.3849278102569967
STAT,1836,28,40-44,1864,2.3955038250850227
STAT,1777,109,na,1886,0.003817760339171009
SIM,1847,42,35-39,1889,2
STAT,1851,25,na,1876,2120.0116313102453
SIM,1901,69,na,1970,2497
SIM,1923,29,20-24,1952,24
STAT,1820,51,25-29,1871,0.006335908047429341
SIM,1871,73,na,1944,1200
SIM,1831,42,40-44,1873,2
SIM,1909,26,35-39,1935,14
STAT,1872,21,20-24,1893,70.67089654608131
SIM,1885,29,40-44,1914,3
SIM,1910,25,25-29,1935,77
STAT,1918,37,25-29,1955,1.0590501604247706
SIM,1864,20,25-29,1884,60
SIM,1875,24,na,1899,2360
STAT,1902,25,25-29,1927,61.26962100059911
STAT,1864,43,na,1907,2081.340168495068
SIM,1880,21,20-24,1901,100
STAT,1953,16,40-44,1969,1.726449713484597
STAT,1864,40,na,1904,2117.6389935896295
STAT,1892,46,20-24,1938,0.008679156881832828
SIM,1878,21,30-34,1899,35
SIM,1912,21,na,1933,3705
STAT,1919,31,30-34,1950,17.41681682399093
SIM,1844,28,40-44,1872,3
STAT,1852,18,15-19,1870,5.748240063140019
SIM,1927,31,30-34,1958,23
STAT,1915,29,20-24,1944,18.863488646271577
SIM,1867,91,na,1958,38
SIM,1860,18,15-19,1878,9
SIM,1917,18,40-44,1935,2
SIM,1917,45,30-34,1962,1
STAT,1961,5,na,1966,5180.18675956177
STAT,1861,52,25-29,1913,0.0029699094042940316
STAT,1848,35,40-44,1883,3.580214731424514
SIM,1921,35,45-49,1956,2
SIM,1836,23,20-24,1859,71
STAT,1877,61,na,1938,1977.1770704177654
SIM,1928,35,35-39,1963,6
STAT,1922,37,45-49,1959,0.7915005742572608
SIM,1938,21,35-39,1959,18
STAT,1874,50,na,1924,2274.885260736318
SIM,1926,19,25-29,1945,69
STAT,1806,89,na,1895,37.32908356922667
STAT,1909,45,30-34,1954,0.08434605035133945
SIM,1900,8,na,1908,3741
STAT,1909,18,40-44,1927,0.2790098271667695
STAT,1882,16,35-39,1898,0.5466886893685949
STAT,1920,35,50-100,1955,0.4699275668907333
STAT,1839,42,35-39,1881,1.317154056040894
STAT,1798,107,na,1905,0.001623364551068183
STAT,1856,20,25-29,1876,54.0146251803527
STAT,1816,49,20-24,1865,0.023891270683266654
STAT,1823,42,40-44,1865,3.638556391457023
STAT,1911,18,30-34,1929,2.4814432886589435
SIM,1854,70,na,1924,1165
STAT,1857,21,25-29,1878,53.03335545675542
STAT,1894,16,25-29,1910,7.454247167041055
SIM,1899,49,50-100,1948,2
STAT,1883,46,50-100,1929,0.24653508810178534
STAT,1933,37,20-24,1970,0.3661709661973841
SIM,1817,41,na,1858,1445
STAT,1934,24,25-29,1958,126.50544296790535
SIM,1873,21,50-100,1894,1
SIM,1844,63,na,1907,1405
STAT,1848,17,40-44,1865,0.17624895479824484
STAT,1890,33,40-44,1923,5.386518900414141
STAT,1840,92,na,1932,29.970832734815552
STAT,1898,23,na,1921,3252.6267660747008
SIM,1857,47,na,1904,1863
STAT,1861,31,20-24,1892,2.2879044458930413
SIM,1858,32,na,1890,1961
SIM,1918,46,30-34,1964,1
STAT,1902,43,20-24,1945,0.01575120699896481
STAT,1817,46,30-34,1863,0.21966544893074605
SIM,1835,25,25-29,1860,35
SIM,1912,23,35-39,1935,10
SIM,1930,37,45-49,1967,2
STAT,1902,19,35-39,1921,0.7851645610679356
SIM,1876,23,20-24,1899,82
STAT,1912,32,na,1944,3796.409402318368
SIM,1765,90,na,1855,46
SIM,1868,37,50-100,1905,1
STAT,1871,76,na,1947,957.3747280000135
STAT,1836,18,30-34,1854,1.8521183531504293
SIM,1935,16,50-100,1951,1
SIM,1854,21,15-19,1875,2
SIM,1942,24,25-29,1966,5
SIM,1864,40,na,1904,2125
STAT,1913,16,40-44,1929,0.29246110416267485
STAT,1863,58,na,1921,1768.8654736610795
SIM,1875,32,na,1907,2433
STAT,1862,18,40-44,1880,0.18084010681415794
STAT,1906,36,15-19,1942,0.018083647198213152
SIM,1915,37,50-100,1952,2
SIM,1879,31,25-29,1910,18
STAT,1945,26,50-100,1971,1.1146249329242461
SIM,1793,63,na,1856,744
SIM,1898,60,na,1958,2978
STAT,1847,37,45-49,1884,1.6129115472931523
STAT,1839,73,na,1912,819.7213642868871
STAT,1881,83,na,1964,638.2744638152577
STAT,1874,47,50-100,1921,0.25461500266058046
SIM,1891,31,50-100,1922,2
STAT,1846,31,20-24,1877,2.308186578725921
STAT,1910,34,15-19,1944,0.1252915349515778
STAT,1891,50,na,1941,2758.601542829791
SIM,1848,25,na,1873,2074
STAT,1863,52,50-100,1915,0.013436766668210262
STAT,1855,33,50-100,1888,0.7157327134706876
STAT,1952,19,30-34,1971,14.890413747584255
SIM,1837,20,30-34,1857,27
STAT,1904,65,na,1969,2792.9672320430454
STAT,1889,9,na,1898,3269.610364966062
SIM,1909,36,40-44,1945,3
STAT,1882,68,na,1950,1518.8401284399229
STAT,1881,43,na,1924,2263.056780166536
STAT,1874,20,50-100,1894,0.4272731685199053
STAT,1923,24,na,1947,4308.16082807667
SIM,1849,21,40-44,1870,3
STAT,1901,15,50-100,1916,0.0702155165708459
SIM,1904,32,40-44,1936,6
STAT,1922,40,40-44,1962,0.293750538583141
STAT,1907,47,20-24,1954,0.01009192678796092
STAT,1927,16,50-100,1943,0.476358899128317
SIM,1902,34,30-34,1936,2
SIM,1924,21,50-100,1945,5
STAT,1916,21,50-100,1937,0.705736079576957
SIM,1951,17,30-34,1968,19
SIM,1882,32,50-100,1914,1
STAT,1823,89,na,1912,58.467838370393125
STAT,1921,46,na,1967,4236.669443944661
SIM,1889,24,na,1913,3033
STAT,1884,37,30-34,1921,5.379050193666223
STAT,1868,23,20-24,1891,66.93860267031843
STAT,1810,44,20-24,1854,0.5301312993569264
STAT,1936,32,15-19,1968,0.12730733267187183
STAT,1916,44,30-34,1960,0.13325172894583145
SIM,1806,78,na,1884,444
SIM,1859,17,na,1876,2563
STAT,1930,31,35-39,1961,12.035237696648036
STAT,1897,67,na,1964,2389.3155352760805
SIM,1854,31,20-24,1885,2
SIM,1926,37,25-29,1963,2
SIM,1892,37,30-34,1929,12
STAT,1906,21,45-49,1927,1.0385409768894132
STAT,1839,84,na,1923,229.58578447147076
STAT,1879,40,15-19,1919,0.014874773347508167
SIM,1816,45,na,1861,1591
STAT,1933,1,na,1934,5701.088454994192
STAT,1945,21,30-34,1966,32.148906506222815
STAT,1828,81,na,1909,297.78102638531584
STAT,1943,17,30-34,1960,13.187087556630143
STAT,1840,45,45-49,1885,0.1756999232340678
SIM,1921,16,40-44,1937,2
STAT,1861,21,45-49,1882,0.6082575931597284
SIM,1914,21,45-49,1935,1
SIM,1844,18,30-34,1862,4
STAT,1917,36,25-29,1953,1.0486599344474996
SIM,1807,71,na,1878,565
SIM,1911,36,na,1947,3779
STAT,1939,28,25-29,1967,67.46878821477512
STAT,1907,37,50-100,1944,0.3969362836432396
STAT,1894,26,50-100,1920,0.8422966559099438
STAT,1950,7,na,1957,4741.456231712879
SIM,1883,20,30-34,1903,26
SIM,1842,42,50-100,1884,2
SIM,1853,20,15-19,1873,4
STAT,1885,27,50-100,1912,0.6510653481044624
STAT,1921,44,35-39,1965,0.23066878443164024
SIM,1935,26,40-44,1961,6
STAT,1907,37,15-19,1944,0.01815509219100856
SIM,1873,48,50-100,1921,2
STAT,1834,42,50-100,1876,0.8570765832320556
SIM,1854,34,50-100,1888,4
SIM,1847,23,30-34,1870,21
SIM,1925,36,25-29,1961,2
STAT,1876,45,25-29,1921,0.06128246095978244
STAT,1971,1,na,1972,5087.0754923241475
SIM,1922,28,na,1950,4238
SIM,1889,28,50-100,1917,1
STAT,1887,22,15-19,1909,3.7712245143530883
STAT,1928,16,na,1944,4742.318780979498
STAT,1810,71,na,1881,618.9156316308755
STAT,1855,43,30-34,1898,0.8847828540180634
SIM,1884,45,25-29,1929,1
STAT,1932,26,15-19,1958,0.9434038183916005
STAT,1898,22,25-29,1920,78.97332223437161
SIM,1851,36,30-34,1887,6
STAT,1917,27,30-34,1944,41.9335071233604
SIM,1895,24,na,1919,3250
STAT,1920,42,30-34,1962,0.14409159439078342
SIM,1878,83,na,1961,520
SIM,1937,29,15-19,1966,3
STAT,1904,41,35-39,1945,0.18468171887832197
STAT,1775,103,na,1878,0.04886587730898209
STAT,1843,36,30-34,1879,5.075125421959663
SIM,1884,9,na,1893,2838
STAT,1939,19,na,1958,3755.9970044187517
SIM,1876,26,25-29,1902,48
STAT,1842,39,20-24,1881,0.6320432390924192
STAT,1908,34,25-29,1942,8.820181673633659
STAT,1800,64,na,1864,1017.3519181883371
STAT,1929,39,20-24,1968,0.3444445716270527
SIM,1862,14,na,1876,2488
STAT,1844,51,na,1895,1676.4973657292687
STAT,1939,31,50-100,1970,0.8610732585157412
SIM,1850,39,20-24,1889,3
SIM,1893,27,50-100,1920,1
STAT,1833,46,15-19,1879,3.139321548488226E-4
STAT,1946,22,30-34,1968,32.63173927311656
STAT,1845,36,na,1881,1954.3373777923773
STAT,1904,23,35-39,1927,8.505492573055108
SIM,1848,20,40-44,1868,3
STAT,1874,50,45-49,1924,0.01533279406079307
SIM,1851,22,na,1873,2182
STAT,1845,20,15-19,1865,3.2464783580561756
STAT,1809,54,25-29,1863,0.014453523780476187
STAT,1846,21,15-19,1867,2.931983328148149
STAT,1940,18,20-24,1958,140.386522006016
STAT,1843,107,na,1950,0.0038070621942261984
SIM,1929,38,na,1967,5124
STAT,1854,53,25-29,1907,0.0026673695767972286
STAT,1941,19,20-24,1960,142.37162299908255
SIM,1839,31,25-29,1870,14
STAT,1905,24,35-39,1929,8.543849899290993
STAT,1886,75,na,1961,1307.3505139505955
STAT,1870,91,na,1961,112.83007725046203
STAT,1810,48,40-44,1858,0.52883666518042
STAT,1865,32,35-39,1897,9.376679075308164
SIM,1916,34,25-29,1950,15
STAT,1927,40,20-24,1967,0.022656082919655648
SIM,1934,29,30-34,1963,6
STAT,1901,32,15-19,1933,0.20315582145010413
STAT,1815,63,na,1878,1110.0361715476186
STAT,1887,32,20-24,1919,3.0899566995012626
STAT,1926,29,30-34,1955,47.57512438040296
STAT,1927,16,35-39,1943,5.335220658726527
SIM,1895,32,20-24,1927,3
STAT,1866,33,35-39,1899,9.489053652456326
SIM,1838,30,25-29,1868,3
STAT,1883,31,50-100,1914,0.9208781040838482
SIM,1844,38,50-100,1882,4
SIM,1829,47,45-49,1876,1
SIM,1871,52,50-100,1923,1
SIM,1813,71,na,1884,728
STAT,1843,54,30-34,1897,0.0046731890772826
SIM,1913,24,35-39,1937,14
STAT,1967,3,na,1970,5011.619116433683
SIM,1935,16,35-39,1951,12
SIM,1853,77,na,1930,633
STAT,1867,30,45-49,1897,1.6835384211511033
STAT,1862,93,na,1955,25.37933282315652
STAT,1826,29,25-29,1855,71.27328947793809
SIM,1848,43,35-39,1891,3
SIM,1944,16,40-44,1960,1
SIM,1848,41,40-44,1889,6
STAT,1853,54,20-24,1907,6.017293720063286E-4
STAT,1813,52,25-29,1865,0.00850094382741014
SIM,1851,76,na,1927,619
SIM,1877,81,na,1958,574
STAT,1834,100,na,1934,0.7134440883364033
STAT,1948,15,20-24,1963,158.38107768108918
SIM,1860,26,30-34,1886,29
SIM,1839,42,na,1881,1770
STAT,1944,24,20-24,1968,122.40688775687985
STAT,1835,29,35-39,1864,9.239329517723773
SIM,1845,17,35-39,1862,2
SIM,1876,35,25-29,1911,5
SIM,1896,38,45-49,1934,4
STAT,1843,28,15-19,1871,0.44751417805531174
SIM,1860,9,na,1869,2387
STAT,1831,52,45-49,1883,0.010440730366341357
STAT,1927,25,30-34,1952,48.920737877228085
SIM,1804,74,na,1878,651
SIM,1815,41,45-49,1856,3
STAT,1836,38,50-100,1874,0.9283780432898654
SIM,1893,32,20-24,1925,4
STAT,1878,19,45-49,1897,0.06899145350600215
STAT,1815,40,25-29,1855,2.2556292917142358
STAT,1845,23,20-24,1868,66.36461087129051
STAT,1846,55,na,1901,1478.6669750711294
STAT,1911,15,25-29,1926,8.886617302445325
STAT,1852,26,30-34,1878,23.799495153174544
SIM,1811,54,50-100,1865,1
STAT,1857,47,15-19,1904,3.172015518846638E-4
STAT,1816,59,na,1875,1065.449818988822
STAT,1792,104,na,1896,0.011063864659567187
STAT,1868,35,25-29,1903,2.832038907170856
STAT,1888,38,45-49,1926,2.3922604803679244
STAT,1820,48,30-34,1868,0.17399603928248275
STAT,1831,36,40-44,1867,3.897188886741412
STAT,1877,47,na,1924,2369.426815068467
SIM,1884,20,45-49,1904,1
SIM,1800,84,na,1884,80
STAT,1882,31,25-29,1913,10.22148854666013
SIM,1904,28,50-100,1932,1
STAT,1942,27,20-24,1969,19.546330422241017
STAT,1871,54,40-44,1925,0.01034589878372817
SIM,1834,29,25-29,1863,55
SIM,1926,40,50-100,1966,1
STAT,1865,107,na,1972,0.07934540906559985
STAT,1843,35,20-24,1878,0.7417077531290924
STAT,1859,42,20-24,1901,0.12922805636007811
SIM,1869,49,40-44,1918,1
STAT,1902,24,15-19,1926,4.716414503605619
SIM,1830,29,na,1859,1875
SIM,1869,32,15-19,1901,1
SIM,1890,31,25-29,1921,13
STAT,1931,27,45-49,1958,2.2747146064084873
STAT,1939,30,na,1969,3941.02860356698
SIM,1882,32,45-49,1914,1
STAT,1833,24,40-44,1857,1.891029751023487
STAT,1850,36,50-100,1886,0.9479305174947883
STAT,1916,37,20-24,1953,0.27548016382686
SIM,1939,18,25-29,1957,56
SIM,1851,26,20-24,1877,14
SIM,1884,69,na,1953,1348
SIM,1797,87,na,1884,33
SIM,1935,25,30-34,1960,93
SIM,1864,36,45-49,1900,4
STAT,1942,28,na,1970,4009.457648434741
STAT,1801,71,na,1872,590.6391620241646
STAT,1843,26,20-24,1869,11.739410682397043
STAT,1900,36,15-19,1936,0.017220218578041804
SIM,1867,42,20-24,1909,4
STAT,1850,48,50-100,1898,0.1824202227261307
STAT,1835,91,na,1926,43.17494131482977
SIM,1871,26,50-100,1897,4
SIM,1895,22,15-19,1917,3
STAT,1820,64,na,1884,966.4933189864907
STAT,1851,20,40-44,1871,2.0828366154886235
SIM,1915,34,50-100,1949,1
SIM,1857,67,na,1924,1242
SIM,1857,34,45-49,1891,6
SIM,1918,28,35-39,1946,28
SIM,1841,24,40-44,1865,4
STAT,1874,32,45-49,1906,1.816298674687897
SIM,1843,29,35-39,1872,14
STAT,1837,17,35-39,1854,0.6686127595821267
SIM,1791,82,na,1873,145
SIM,1922,18,15-19,1940,72
STAT,1915,26,na,1941,3912.4957880229435
STAT,1834,23,45-49,1857,0.6230967114006905
SIM,1881,33,40-44,1914,8
SIM,1887,47,35-39,1934,1
SIM,1837,37,50-100,1874,3
STAT,1839,30,50-100,1869,0.7944995448667848
SIM,1836,85,na,1921,124
STAT,1816,47,50-100,1863,0.5050428716398967
STAT,1937,15,45-49,1952,0.4980053920217533
STAT,1927,31,na,1958,4748.531821803059
SIM,1851,35,20-24,1886,3
SIM,1905,50,na,1955,3139
SIM,1799,88,na,1887,95
SIM,1860,43,50-100,1903,2
SIM,1880,28,40-44,1908,5
STAT,1876,54,50-100,1930,0.015472174397285132
SIM,1907,51,na,1958,3396
STAT,1914,18,15-19,1932,9.553254872756757
SIM,1872,33,30-34,1905,21
SIM,1909,32,na,1941,3517
STAT,1893,29,25-29,1922,54.35296693727528
SIM,1879,17,na,1896,3081
SIM,1938,19,20-24,1957,159
STAT,1857,40,30-34,1897,0.9252047915161048
STAT,1872,37,40-44,1909,4.47568867620279
STAT,1770,104,na,1874,0.020181097501602387
STAT,1833,31,45-49,1864,1.5058444150158614
STAT,1851,22,35-39,1873,5.749299760723542
STAT,1861,19,35-39,1880,0.5253969840540634
STAT,1796,85,na,1881,89.16762972420248
STAT,1841,46,na,1887,1690.2232445512975
SIM,1941,24,45-49,1965,1
STAT,1826,38,25-29,1864,2.505035705483542
STAT,1864,29,na,1893,2149.3009798597095
STAT,1801,53,45-49,1854,0.040065919841002245
STAT,1861,24,15-19,1885,2.816122021919754
STAT,1933,24,45-49,1957,1.5210311266079946
SIM,1839,18,20-24,1857,11
STAT,1950,21,40-44,1971,4.070711311960375
SIM,1942,20,45-49,1962,1
STAT,1847,46,45-49,1893,0.18455838326099194
SIM,1834,38,25-29,1872,2
STAT,1914,49,20-24,1963,0.011116878528874777
SIM,1855,37,45-49,1892,4
STAT,1943,26,25-29,1969,71.55102114209537
SIM,1783,87,na,1870,36
STAT,1898,41,30-34,1939,0.11063535397063522
SIM,1862,39,45-49,1901,3
STAT,1945,23,25-29,1968,103.25287048816236
SIM,1820,84,na,1904,213
SIM,1889,42,40-44,1931,3
SIM,1835,34,25-29,1869,13
SIM,1917,36,35-39,1953,6
STAT,1872,28,40-44,1900,3.0519724640429082
STAT,1862,6,na,1868,2481.2368675571693
STAT,1879,47,35-39,1926,0.14859370416024387
STAT,1833,82,na,1915,306.4026772276577
STAT,1905,37,45-49,1942,0.6339456768733063
STAT,1919,19,45-49,1938,0.5603128461686301
STAT,1936,16,40-44,1952,1.369183139449194
STAT,1884,27,20-24,1911,11.840349820743265
SIM,1853,23,20-24,1876,86
SIM,1852,31,20-24,1883,1
SIM,1872,9,na,1881,2805
STAT,1920,15,35-39,1935,0.9683656988752162
SIM,1893,0,na,1893,3563
SIM,1874,30,30-34,1904,31
STAT,1880,43,25-29,1923,0.6834384260925411
STAT,1845,16,50-100,1861,0.04866880106978712
STAT,1813,110,na,1923,1.1883293499553968E-4
STAT,1910,41,25-29,1951,0.0692283246816992
SIM,1826,75,na,1901,596
STAT,1898,0,na,1898,4050.8301331939415
SIM,1841,31,45-49,1872,1
SIM,1942,28,40-44,1970,1
STAT,1865,50,35-39,1915,0.00808570107317162
STAT,1934,28,40-44,1962,6.391330529995741
SIM,1844,49,na,1893,1751
SIM,1888,53,na,1941,2464
STAT,1866,83,na,1949,373.5529255150434
SIM,1919,24,35-39,1943,16
STAT,1842,52,20-24,1894,5.75599171931308E-4
SIM,1900,20,40-44,1920,2
STAT,1862,47,25-29,1909,0.04978664636285173
SIM,1880,37,40-44,1917,6
STAT,1812,53,20-24,1865,0.0016326059111760286
STAT,1892,46,25-29,1938,0.04165995108947656
STAT,1894,25,25-29,1919,55.88528399626749
STAT,1899,70,na,1969,2319.7607585049013
SIM,1932,38,25-29,1970,1
STAT,1934,35,15-19,1969,0.027071565138957837
STAT,1874,19,na,1893,2616.467767608492
STAT,1825,30,40-44,1855,10.531479093072534
STAT,1902,17,40-44,1919,0.26313266203363384
SIM,1894,24,20-24,1918,4
STAT,1813,82,na,1895,200.6432057404116
STAT,1833,37,na,1870,1758.065968206522
SIM,1799,82,na,1881,254
STAT,1871,38,35-39,1909,7.111910441394086
STAT,1943,21,50-100,1964,0.7144748301287557
SIM,1915,31,40-44,1946,5
SIM,1913,37,45-49,1950,2
STAT,1868,23,50-100,1891,0.396109886766837
STAT,1917,35,15-19,1952,0.02054793229060684
SIM,1802,93,na,1895,21
STAT,1839,45,40-44,1884,0.12350688972711384
STAT,1825,32,35-39,1857,20.077153945236436
STAT,1926,33,30-34,1959,19.42268004288758
STAT,1861,30,50-100,1891,0.7785742890763384
STAT,1934,20,45-49,1954,1.5470814357200995
SIM,1837,61,na,1898,1135
STAT,1809,77,na,1886,453.0260395265224
STAT,1837,72,na,1909,842.0055666483278
SIM,1877,24,20-24,1901,70
SIM,1827,33,20-24,1860,4
STAT,1875,66,na,1941,1716.0610853211572
STAT,1889,43,45-49,1932,1.8723576759428933
STAT,1947,2,na,1949,4631.7557057556005
STAT,1876,42,50-100,1918,1.1115273021549827
SIM,1919,2,na,1921,4647
SIM,1934,33,30-34,1967,28
SIM,1806,55,na,1861,1278
STAT,1892,21,40-44,1913,2.6723222490618586
STAT,1850,24,50-100,1874,0.36289983517346347
STAT,1910,19,25-29,1929,8.710768857976374
SIM,1860,59,na,1919,1816
STAT,1867,39,25-29,1906,2.7297454390173796
SIM,1837,22,25-29,1859,59
STAT,1844,74,na,1918,859.9878014153222
STAT,1890,23,30-34,1913,22.149263949037724
SIM,1965,6,na,1971,4973
SIM,1926,34,20-24,1960,4
STAT,1892,23,35-39,1915,7.437967846253261
SIM,1864,37,50-100,1901,1
SIM,1874,39,na,1913,2384
STAT,1810,44,25-29,1854,2.1435743569683208
STAT,1844,34,25-29,1878,9.296377775967954
STAT,1902,53,na,1955,3047.9925304915246
SIM,1942,2,na,1944,4797
SIM,1842,23,45-49,1865,1
SIM,1833,30,40-44,1863,7
SIM,1861,52,na,1913,2303
STAT,1865,39,20-24,1904,0.7065477793350998
STAT,1928,23,25-29,1951,117.27300348978677
STAT,1907,31,40-44,1938,3.7451953135042153
STAT,1920,48,35-39,1968,0.14503725866769954
STAT,1849,49,15-19,1898,3.04060033246646E-4
SIM,1936,24,35-39,1960,12
STAT,1835,110,na,1945,2.0589008089850992E-4
STAT,1851,49,50-100,1900,0.19839362820521034
SIM,1875,39,25-29,1914,4
STAT,1849,34,45-49,1883,1.3972825669169529
STAT,1879,54,40-44,1933,0.010917498277736809
SIM,1852,24,15-19,1876,2
STAT,1924,31,40-44,1955,4.6607546849104
SIM,1856,35,40-44,1891,11
SIM,1944,27,50-100,1971,1
SIM,1949,15,na,1964,4773
STAT,1879,28,na,1907,2535.923011542387
STAT,1903,22,50-100,1925,0.5913632378344972
STAT,1768,110,na,1878,0.0026660057853613267
SIM,1863,37,40-44,1900,5
STAT,1818,109,na,1927,3.6257184834683886E-4
SIM,1898,17,15-19,1915,11
STAT,1816,109,na,1925,3.1568423803418356E-4
SIM,1883,21,40-44,1904,2
STAT,1851,22,na,1873,2106.551197146547
STAT,1821,47,35-39,1868,0.2205882031520682
STAT,1854,5,na,1859,2302.1881262484894
SIM,1889,44,35-39,1933,6
STAT,1886,24,20-24,1910,73.94670936345777
SIM,1886,15,30-34,1901,4
STAT,1948,13,na,1961,4585.703451572419
STAT,1824,74,na,1898,611.0665821715479
SIM,1861,24,25-29,1885,77
SIM,1936,23,25-29,1959,95
STAT,1928,24,35-39,1952,11.916512730051023
SIM,1837,23,35-39,1860,8
STAT,1915,20,na,1935,3885.795566855324
SIM,1821,38,45-49,1859,2
STAT,1864,74,na,1938,1006.6695853335442
STAT,1844,24,15-19,1868,3.1462249562180813
STAT,1865,36,50-100,1901,1.14224183732238
STAT,1872,53,45-49,1925,0.014599683674806923
STAT,1911,16,na,1927,3952.0452086779324
SIM,1932,31,40-44,1963,8
STAT,1861,46,na,1907,1901.928961884141
SIM,1836,24,30-34,1860,27
STAT,1953,15,30-34,1968,15.048537609297536
STAT,1870,24,25-29,1894,56.73152655799589
SIM,1902,25,35-39,1927,3
SIM,1837,47,na,1884,1485
STAT,1834,21,50-100,1855,0.36967350968124696
STAT,1838,46,35-39,1884,0.10719191410427752
STAT,1855,53,45-49,1908,0.011069367582349518
STAT,1895,15,30-34,1910,2.131314279191821
STAT,1827,53,50-100,1880,0.016042480291409013
STAT,1853,24,25-29,1877,55.90296240667834
SIM,1919,28,50-100,1947,2
STAT,1918,34,20-24,1952,2.622377315136701
STAT,1808,51,50-100,1859,0.0368078451747488
STAT,1904,68,na,1972,2635.5818715386654
STAT,1880,29,45-49,1909,1.181770687569748
STAT,1908,38,40-44,1946,1.4221307751612406
STAT,1871,16,25-29,1887,5.7974989372930565
STAT,1908,30,45-49,1938,1.5267944213671385
SIM,1916,38,40-44,1954,4
SIM,1955,15,na,1970,5085
SIM,1892,44,na,1936,3334
STAT,1840,50,30-34,1890,0.004344997270124288
STAT,1943,25,15-19,1968,0.7677406454118734
STAT,1885,32,20-24,1917,2.751115869718108
STAT,1923,32,35-39,1955,10.688972563895256
SIM,1861,15,25-29,1876,11
SIM,1901,19,25-29,1920,16
STAT,1919,33,25-29,1952,10.13290998246998
SIM,1871,96,na,1967,44
STAT,1891,40,35-39,1931,2.3101312726007297
SIM,1882,68,na,1950,1343
SIM,1931,32,35-39,1963,12
STAT,1885,25,15-19,1910,0.4649016153571043
SIM,1854,47,40-44,1901,1
SIM,1901,26,30-34,1927,42
STAT,1794,84,na,1878,115.08849757086858
SIM,1847,8,na,1855,2206
STAT,1818,41,20-24,1859,0.42376283921846
SIM,1856,42,45-49,1898,5
SIM,1868,34,20-24,1902,5
SIM,1828,32,25-29,1860,10
SIM,1780,90,na,1870,20
SIM,1912,38,na,1950,3807
STAT,1899,47,20-24,1946,0.009412002576042083
SIM,1787,77,na,1864,259
SIM,1939,15,20-24,1954,192
STAT,1850,24,40-44,1874,1.8544180228204512
SIM,1776,85,na,1861,98
SIM,1901,66,na,1967,2706
STAT,1903,48,35-39,1951,0.1130829371889003
SIM,1817,39,35-39,1856,6
STAT,1889,36,40-44,1925,5.542832448810689
SIM,1911,20,15-19,1931,4
STAT,1810,54,na,1864,1112.421574593322
STAT,1870,20,50-100,1890,0.4091006129261436
STAT,1868,29,30-34,1897,24.361054527131163
STAT,1849,16,15-19,1865,5.704884809496107
STAT,1823,32,30-34,1855,44.48384258779976
STAT,1925,36,na,1961,4611.091346437467
STAT,1862,48,35-39,1910,0.12004839799443816
STAT,1892,38,na,1930,2997.321791077787
STAT,1895,66,na,1961,2335.090582911219
STAT,1847,17,na,1864,2234.115996393291
STAT,1861,49,30-34,1910,0.07989559414184894
SIM,1843,34,15-19,1877,1
SIM,1878,23,25-29,1901,70
STAT,1774,84,na,1858,72.49780641087354
STAT,1835,34,15-19,1869,0.1323621286282425
SIM,1916,30,45-49,1946,2
STAT,1858,39,15-19,1897,0.044972243748879225
SIM,1857,16,15-19,1873,5
SIM,1831,32,30-34,1863,20
STAT,1911,36,na,1947,3724.438035074824
SIM,1811,56,na,1867,983
SIM,1833,32,35-39,1865,22
STAT,1899,38,20-24,1937,0.23127631111067118
SIM,1927,33,25-29,1960,3
STAT,1838,53,40-44,1891,0.007611015991121766
SIM,1874,31,40-44,1905,8
STAT,1856,22,50-100,1878,0.3792688795262161
STAT,1903,20,15-19,1923,4.812672875793611
SIM,1862,68,na,1930,1396
STAT,1869,28,35-39,1897,9.469859326410928
STAT,1824,54,na,1878,1271.0863408481116
STAT,1888,7,na,1895,3142.112187635878
STAT,1948,17,15-19,1965,52.989299208051
SIM,1897,36,40-44,1933,8
SIM,1893,35,25-29,1928,5
STAT,1831,56,na,1887,1389.711267686978
STAT,1895,32,na,1927,3176.2061302736283
STAT,1905,28,15-19,1933,0.6661071899714515
STAT,1831,39,45-49,1870,1.7119719213802302
SIM,1911,23,20-24,1934,116
STAT,1881,43,45-49,1924,1.4654393541194437
STAT,1916,45,50-100,1961,0.23785363009661734
SIM,1879,38,45-49,1917,8
STAT,1837,18,45-49,1855,0.06679637165447981
STAT,1856,41,25-29,1897,0.5165684215200885
SIM,1933,30,45-49,1963,3
SIM,1826,44,25-29,1870,1
STAT,1952,16,25-29,1968,52.99062811945543
STAT,1839,15,45-49,1854,0.0596746884330604
STAT,1849,97,na,1946,4.170796913124974
SIM,1820,39,na,1859,1723
SIM,1859,38,50-100,1897,3
SIM,1860,25,20-24,1885,2
STAT,1824,38,20-24,1862,1.029068862119998
STAT,1888,44,40-44,1932,2.6760561220228047
STAT,1929,16,35-39,1945,5.4753531811527525
STAT,1848,42,45-49,1890,1.16195564659378
STAT,1843,29,25-29,1872,41.424861122125925
STAT,1893,17,20-24,1910,22.943316225980173
SIM,1822,37,50-100,1859,1
STAT,1891,29,20-24,1920,14.710900363906527
SIM,1811,48,30-34,1859,1
STAT,1851,56,na,1907,1682.7335130665608
STAT,1860,35,20-24,1895,0.6441021812575762
STAT,1889,19,20-24,1908,22.220688408452304
SIM,1855,80,na,1935,386
SIM,1872,36,35-39,1908,9
SIM,1937,16,35-39,1953,7
STAT,1894,19,30-34,1913,2.0802882001463705
SIM,1851,29,25-29,1880,42
SIM,1819,42,na,1861,1517
STAT,1953,18,35-39,1971,5.176241695340965
STAT,1863,43,25-29,1906,0.5702292830827687
STAT,1879,44,30-34,1923,1.2094063865794145
STAT,1842,93,na,1935,22.918688343283392
STAT,1887,37,na,1924,2693.1961628428476
SIM,1820,39,40-44,1859,3
STAT,1839,22,na,1861,1895.9939278091902
SIM,1874,33,35-39,1907,22
SIM,1887,44,30-34,1931,3
SIM,1853,26,25-29,1879,61
SIM,1911,15,35-39,1926,1
SIM,1908,13,na,1921,4156
STAT,1866,55,na,1921,1945.6568132176462
STAT,1885,35,25-29,1920,2.958216061557191
SIM,1901,29,35-39,1930,19
SIM,1935,15,na,1950,5159
STAT,1903,15,35-39,1918,0.7994156301648352
SIM,1900,27,25-29,1927,75
STAT,1847,31,na,1878,2005.0482620659204
STAT,1911,25,35-39,1936,15.036112260926568
STAT,1897,37,45-49,1934,2.7191888047590353
STAT,1925,30,45-49,1955,1.9086029962756008
SIM,1811,76,na,1887,290
SIM,1897,19,20-24,1916,24
STAT,1881,51,30-34,1932,0.005898954914402692
STAT,1908,37,30-34,1945,1.7400645786331455
STAT,1818,44,25-29,1862,1.517769611326833
STAT,1901,26,20-24,1927,16.7932770777659
SIM,1876,29,30-34,1905,38
STAT,1845,26,25-29,1871,40.52122825897653
STAT,1870,39,30-34,1909,5.2614961156645865
SIM,1880,4,na,1884,2764
STAT,1848,18,20-24,1866,16.98293652429379
STAT,1883,22,45-49,1905,0.6979947926321561
SIM,1941,21,40-44,1962,4
STAT,1898,44,35-39,1942,0.17113248549926688
STAT,1935,34,20-24,1969,3.4369456081254195
SIM,1914,32,35-39,1946,12
SIM,1918,43,na,1961,4158
SIM,1854,38,40-44,1892,7
SIM,1918,23,na,1941,4098
STAT,1876,7,na,1883,2837.2216589239447
SIM,1920,39,45-49,1959,1
SIM,1835,38,na,1873,1767
STAT,1803,52,na,1855,1319.3665887055329
SIM,1836,49,45-49,1885,1
STAT,1868,103,na,1971,1.4843647957625001
SIM,1916,42,na,1958,3848
STAT,1926,26,25-29,1952,80.76986542894295
SIM,1849,9,na,1858,2338
STAT,1825,52,20-24,1877,9.150714342722339E-4
STAT,1921,20,50-100,1941,0.7629096951915265
STAT,1934,0,na,1934,6214.310364980953
STAT,1908,45,15-19,1953,3.4470638394554947E-4
STAT,1912,39,45-49,1951,0.6719268320738462
SIM,1893,20,na,1913,3324
STAT,1916,33,50-100,1949,0.8674115471387218
SIM,1839,20,35-39,1859,12
STAT,1893,26,20-24,1919,15.234317571863162
STAT,1918,31,15-19,1949,0.13991959448563004
STAT,1910,47,50-100,1957,0.21522862164962683
SIM,1875,37,30-34,1912,5
STAT,1858,37,20-24,1895,0.6236226621333758
SIM,1824,31,45-49,1855,3
STAT,1838,43,30-34,1881,0.8875276232791218
STAT,1832,32,40-44,1864,3.8036915255563466
SIM,1900,23,45-49,1923,2
STAT,1805,49,45-49,1854,0.8423031965829081
STAT,1892,43,20-24,1935,0.20158548519474725
SIM,1918,25,30-34,1943,65
STAT,1763,98,na,1861,0.19333265258268514
STAT,1822,42,25-29,1864,0.9998782999833122
SIM,1943,10,na,1953,3914
SIM,1846,43,30-34,1889,3
SIM,1914,33,na,1947,3836
STAT,1918,35,30-34,1953,1.9789873229284083
STAT,1903,23,20-24,1926,99.62566547963675
STAT,1842,73,na,1915,931.4411055411255
SIM,1883,28,25-29,1911,48
SIM,1848,40,30-34,1888,4
SIM,1891,22,45-49,1913,1
STAT,1826,35,20-24,1861,0.7224157469641925
STAT,1807,110,na,1917,1.1678138796218983E-4
STAT,1819,36,25-29,1855,8.848658411305056
SIM,1877,25,30-34,1902,30
SIM,1840,32,40-44,1872,6
SIM,1917,33,30-34,1950,22
STAT,1814,52,45-49,1866,0.0413993488498588
STAT,1948,18,25-29,1966,50.581736058644076
SIM,1929,32,na,1961,5070
SIM,1830,42,25-29,1872,2
STAT,1855,46,na,1901,1749.024440323348
SIM,1852,34,25-29,1886,16
STAT,1857,92,na,1949,33.18287482072988
STAT,1898,48,15-19,1946,3.073615673642559E-4
SIM,1840,47,50-100,1887,1
SIM,1854,22,50-100,1876,1
STAT,1909,44,50-100,1953,0.11068991646167564
SIM,1871,7,na,1878,2628
STAT,1846,47,40-44,1893,0.12185807650819735
STAT,1878,32,15-19,1910,0.15121718762120184
STAT,1817,39,25-29,1856,8.415038799184863
SIM,1825,39,25-29,1864,6
STAT,1868,64,na,1932,1693.7996803241529
STAT,1876,20,45-49,1896,0.7389619517825039
STAT,1887,49,50-100,1936,0.15506177741688362
SIM,1834,26,20-24,1860,10
STAT,1941,31,40-44,1972,4.1941479770305765
SIM,1926,31,15-19,1957,2
STAT,1842,54,45-49,1896,0.011067740139194846
SIM,1861,18,30-34,1879,3
SIM,1901,12,na,1913,3828
STAT,1863,8,na,1871,2506.365443442707
STAT,1834,45,20-24,1879,0.009655518479528832
STAT,1817,48,25-29,1865,0.12671256765034739
STAT,1844,31,20-24,1875,2.5309737138892636
STAT,1848,50,30-34,1898,0.004693607395063755
STAT,1882,14,na,1896,2558.3866025607667
STAT,1846,38,40-44,1884,3.235297132842476
STAT,1846,22,50-100,1868,0.3598185442481591
STAT,1931,18,15-19,1949,60.42316084188751
STAT,1933,21,40-44,1954,4.5621277729663
STAT,1878,16,40-44,1894,0.19469466825950676
STAT,1924,38,25-29,1962,1.1833452496243797
SIM,1909,38,35-39,1947,3
SIM,1936,21,30-34,1957,33
STAT,1822,73,na,1895,690.6116637153496
STAT,1887,39,40-44,1926,4.953705885235864
STAT,1932,15,50-100,1947,0.5082840848340622
STAT,1853,18,30-34,1871,1.5982021268506348
STAT,1892,20,30-34,1912,22.90998961045614
SIM,1831,35,35-39,1866,7
SIM,1909,18,na,1927,3716
SIM,1871,21,15-19,1892,5
STAT,1907,34,45-49,1941,1.486997332269029
SIM,1922,42,na,1964,4297
STAT,1830,53,40-44,1883,0.007532365904096694
SIM,1827,36,25-29,1863,4
STAT,1811,81,na,1892,234.23669399951348
STAT,1779,93,na,1872,5.440020501295336
STAT,1863,22,25-29,1885,52.2238651450543
STAT,1876,19,50-100,1895,0.05133271352757049
SIM,1899,31,45-49,1930,2
STAT,1867,36,20-24,1903,0.7418197390609195
STAT,1886,27,25-29,1913,45.6775861418206
STAT,1930,34,35-39,1964,12.012745803458209
SIM,1817,92,na,1909,22
SIM,1812,44,30-34,1856,4
SIM,1802,65,na,1867,739
STAT,1926,36,35-39,1962,3.0183610668020613
SIM,1820,50,na,1870,1531
STAT,1867,37,30-34,1904,5.104305640303628
STAT,1951,20,45-49,1971,1.3723237736360236
SIM,1885,16,25-29,1901,12
STAT,1839,48,45-49,1887,0.1638352126607035
STAT,1866,31,40-44,1897,4.097397326432486
STAT,1917,21,na,1938,3972.673968053219
SIM,1871,22,25-29,1893,59
SIM,1875,36,20-24,1911,4
SIM,1934,26,25-29,1960,10
SIM,1890,26,45-49,1916,3
STAT,1928,21,30-34,1949,36.71374466948055
SIM,1936,20,20-24,1956,93
SIM,1894,27,25-29,1921,63
STAT,1823,35,35-39,1858,14.077309971973959
STAT,1837,41,na,1878,1675.4037926992544
STAT,1936,30,20-24,1966,2.419170076736137
STAT,1873,33,40-44,1906,4.466319486172813
SIM,1864,63,na,1927,1628
STAT,1840,42,45-49,1882,1.1234463210911618
SIM,1895,39,40-44,1934,15
SIM,1899,30,35-39,1929,24
STAT,1821,46,25-29,1867,0.09212311934271843
SIM,1871,11,na,1882,2572
STAT,1891,76,na,1967,1574.2194366658305
STAT,1839,20,25-29,1859,51.49967063214418
SIM,1926,26,35-39,1952,27
SIM,1859,48,na,1907,2092
SIM,1899,17,na,1916,3563
STAT,1854,39,45-49,1893,1.5103685190933818
SIM,1902,28,na,1930,3438
SIM,1928,15,45-49,1943,3
STAT,1882,26,45-49,1908,1.1072914807940384
STAT,1841,30,25-29,1871,9.368306486615756
STAT,1842,36,15-19,1878,0.05219753224239731
STAT,1875,24,45-49,1899,0.7255325441480677
STAT,1877,25,25-29,1902,45.0621963051534
STAT,1897,28,45-49,1925,1.5091630634078035
STAT,1958,0,na,1958,5305.440383539663
STAT,1874,64,na,1938,1810.6078105851311
STAT,1899,40,35-39,1939,0.1774367386144465
SIM,1875,27,20-24,1902,17
STAT,1916,47,30-34,1963,0.09330771172037412
STAT,1947,21,35-39,1968,10.861059200215706
SIM,1847,48,45-49,1895,1
SIM,1857,61,na,1918,1544
SIM,1897,32,50-100,1929,2
SIM,1813,57,na,1870,1175
SIM,1838,37,45-49,1875,4
SIM,1885,25,25-29,1910,69
STAT,1890,35,50-100,1925,1.545952778843167
SIM,1864,94,na,1958,41
STAT,1889,32,50-100,1921,1.1546009965587183
SIM,1901,16,20-24,1917,34
SIM,1934,36,35-39,1970,2
STAT,1839,49,20-24,1888,0.008224555756371628
STAT,1857,17,50-100,1874,0.04587694033894862
STAT,1863,107,na,1970,0.05958994275146111
STAT,1863,21,15-19,1884,3.0313897157991128
STAT,1890,26,35-39,1916,12.076766650056156
STAT,1852,111,na,1963,3.156297135389364E-4
STAT,1910,22,15-19,1932,5.098528682101896
SIM,1915,34,45-49,1949,8
SIM,1828,56,na,1884,1335
STAT,1831,27,40-44,1858,2.964221405067446
STAT,1883,37,15-19,1920,0.05620877545323299
STAT,1887,20,20-24,1907,79.24619613017254
SIM,1890,16,35-39,1906,1
STAT,1853,28,40-44,1881,2.628888566165255
SIM,1848,43,50-100,1891,2
SIM,1935,28,35-39,1963,31
STAT,1872,50,40-44,1922,0.010918461069235642
STAT,1898,31,50-100,1929,1.2691743123051125
SIM,1929,21,25-29,1950,139
STAT,1904,44,35-39,1948,0.1813682142027986
STAT,1817,38,15-19,1855,0.1839554216226981
SIM,1851,38,25-29,1889,8
STAT,1850,28,20-24,1878,10.310057409090525
SIM,1839,28,na,1867,1970
SIM,1925,25,na,1950,4602
SIM,1884,49,na,1933,2325
STAT,1924,37,15-19,1961,0.023102765253610866
STAT,1943,29,30-34,1972,42.53278658248622
STAT,1847,21,30-34,1868,17.151238311877794
STAT,1870,21,20-24,1891,68.93134290892675
STAT,1928,20,20-24,1948,142.4562183087815
STAT,1843,38,25-29,1881,2.4436983080213532
STAT,1835,19,25-29,1854,11.626601852185603
SIM,1918,26,40-44,1944,5
STAT,1814,44,na,1858,1463.3304394430997
STAT,1884,29,15-19,1913,0.45464128744878224
SIM,1809,66,na,1875,587
SIM,1855,21,30-34,1876,27
SIM,1902,22,30-34,1924,39
STAT,1933,17,na,1950,5024.882287118012
STAT,1859,45,25-29,1904,0.047395429315605
SIM,1875,86,na,1961,337
SIM,1834,36,30-34,1870,7
STAT,1796,65,na,1861,798.4818208635392
SIM,1879,47,45-49,1926,2
STAT,1875,46,20-24,1921,0.01259980023028923
STAT,1874,6,na,1880,2845.589999337847
SIM,1861,28,40-44,1889,6
SIM,1827,71,na,1898,719
STAT,1864,36,35-39,1900,6.446601178499526
STAT,1918,26,35-39,1944,16.360882959367558
SIM,1886,18,35-39,1904,1
STAT,1827,28,30-34,1855,57.71214950761996
STAT,1844,49,30-34,1893,0.07344524092887816
SIM,1873,77,na,1950,734
SIM,1843,19,25-29,1862,10
STAT,1887,48,40-44,1935,0.19324540280332037
STAT,1935,26,na,1961,5209.954470737995
SIM,1872,92,na,1964,90
STAT,1897,42,25-29,1939,0.060751189985724596
STAT,1927,28,35-39,1955,18.553067897066928
SIM,1868,37,25-29,1905,4
SIM,1886,10,na,1896,2916
SIM,1895,20,20-24,1915,95
SIM,1932,37,15-19,1969,1
STAT,1837,31,15-19,1868,0.12028845877411129
SIM,1867,77,na,1944,683
STAT,1816,46,15-19,1862,8.359860567476321E-4
STAT,1934,27,30-34,1961,53.75386440511291
SIM,1858,30,45-49,1888,2
STAT,1838,26,na,1864,2036.4995048677627
STAT,1764,94,na,1858,6.460622712170402
STAT,1853,3,na,1856,2849.79139912
SIM,1835,28,30-34,1863,30
SIM,1942,27,30-34,1969,57
STAT,1853,19,40-44,1872,0.1823200238954277
STAT,1841,16,45-49,1857,0.06257394323605855
STAT,1875,12,na,1887,2727.013721420243
STAT,1920,45,30-34,1965,0.10103577219535603
STAT,1944,21,15-19,1965,5.865865206780959
SIM,1892,29,15-19,1921,1
STAT,1893,46,50-100,1939,0.17979860327787817
SIM,1873,20,na,1893,2394
STAT,1907,16,15-19,1923,8.911118456807795
STAT,1920,27,na,1947,4193.6656185873735
SIM,1900,19,na,1919,3648
STAT,1826,36,30-34,1862,4.885949707420408
STAT,1841,25,45-49,1866,1.0330059644476095
STAT,1864,33,30-34,1897,15.77056699333715
STAT,1871,35,30-34,1906,5.436817976708009
SIM,1915,16,15-19,1931,13
SIM,1893,17,30-34,1910,3
STAT,1893,27,30-34,1920,32.58906650171188
SIM,1844,43,na,1887,1839
SIM,1860,87,na,1947,168
SIM,1865,11,na,1876,2640
STAT,1866,53,20-24,1919,6.832114430873617E-4
STAT,1894,19,na,1913,3296.373268727334
STAT,1828,98,na,1926,1.7888635800770192
SIM,1877,49,35-39,1926,1
SIM,1908,28,40-44,1936,5
STAT,1917,39,30-34,1956,1.9201035953208248
SIM,1855,35,na,1890,1818
SIM,1893,74,na,1967,1730
SIM,1929,31,35-39,1960,15
STAT,1884,40,na,1924,2356.2318320372597
STAT,1841,22,40-44,1863,1.949081875863375
SIM,1867,32,45-49,1899,4
SIM,1782,88,na,1870,16
SIM,1830,28,45-49,1858,2
SIM,1851,45,na,1896,1818
SIM,1932,16,15-19,1948,55
STAT,1892,45,45-49,1937,0.17190371912197672
STAT,1897,20,15-19,1917,4.526838980095781
STAT,1938,29,20-24,1967,18.42935801837547
STAT,1924,16,15-19,1940,55.27386888821312
STAT,1903,24,30-34,1927,25.66903848395757
STAT,1818,38,30-34,1856,17.831570219694886
STAT,1906,39,20-24,1945,0.24456361137931446
STAT,1878,23,na,1901,2503.5933379849407
SIM,1869,1,na,1870,3449
STAT,1866,34,45-49,1900,1.6268360882761481
SIM,1857,4,na,1861,2552
SIM,1833,22,50-100,1855,1
STAT,1839,41,25-29,1880,0.519908185479564
SIM,1845,90,na,1935,38
SIM,1891,33,35-39,1924,23
SIM,1927,37,na,1964,4661
SIM,1943,16,25-29,1959,51
STAT,1825,54,45-49,1879,0.017295547637019425
STAT,1921,29,45-49,1950,1.9507367872550123
STAT,1820,95,na,1915,7.322577801153457
STAT,1935,16,25-29,1951,60.56327401658467
SIM,1824,42,35-39,1866,3
STAT,1837,53,25-29,1890,0.0023236969811179756
STAT,1927,42,15-19,1969,0.001964640885320495
STAT,1829,38,40-44,1867,3.776496604713976
SIM,1925,39,30-34,1964,4
STAT,1901,29,25-29,1930,59.91501945988914
STAT,1830,34,30-34,1864,16.128490862636863
SIM,1840,22,30-34,1862,17
STAT,1949,17,30-34,1966,14.46281796563553
SIM,1780,76,na,1856,316
STAT,1863,26,50-100,1889,0.5763118781861593
STAT,1803,54,50-100,1857,0.05859031229407096
STAT,1860,17,25-29,1877,5.40957138986868
STAT,1829,49,50-100,1878,0.1937052293368493
SIM,1941,28,25-29,1969,86
STAT,1855,28,40-44,1883,2.403081423567097
STAT,1833,49,20-24,1882,0.00824697153307162
STAT,1859,32,45-49,1891,1.4207180329733382
SIM,1859,44,20-24,1903,2
STAT,1933,28,25-29,1961,89.08521521816851
STAT,1785,76,na,1861,372.05554637442316
SIM,1865,32,45-49,1897,4
STAT,1827,110,na,1937,1.786026472923388E-4
SIM,1879,44,40-44,1923,2
STAT,1800,95,na,1895,6.408021043471287
SIM,1862,82,na,1944,333
STAT,1881,40,40-44,1921,2.2407944914988436
STAT,1888,30,na,1918,2901.0726210233966
STAT,1923,17,45-49,1940,0.5984912589640764
STAT,1828,41,15-19,1869,0.011476688859360415
STAT,1856,15,45-49,1871,0.06258886491701597
SIM,1852,28,30-34,1880,3
STAT,1920,41,na,1961,4191.907410011863
STAT,1844,28,30-34,1872,23.71659630686561
SIM,1847,20,25-29,1867,71
STAT,1920,23,20-24,1943,125.76141264117803
STAT,1824,37,45-49,1861,2.7570816519758505
STAT,1832,22,30-34,1854,29.366046758463796
STAT,1841,34,40-44,1875,3.8051637342015283
STAT,1922,28,15-19,1950,0.8122227082298651
SIM,1845,28,na,1873,2045
SIM,1798,86,na,1884,64
STAT,1895,32,15-19,1927,0.18954617272860966
SIM,1930,28,15-19,1958,1
STAT,1857,32,45-49,1889,1.3979135326396226
SIM,1847,30,50-100,1877,1
STAT,1887,25,50-100,1912,0.7362147927764956
STAT,1852,4,na,1856,2597.0303880799993
SIM,1848,7,na,1855,2409
STAT,1909,26,25-29,1935,64.92032203025006
SIM,1821,37,35-39,1858,12
STAT,1946,23,40-44,1969,3.816235502162657
SIM,1903,39,45-49,1942,1
SIM,1866,75,na,1941,1099
STAT,1869,50,50-100,1919,0.015088582822170316
STAT,1877,92,na,1969,159.68060003849678
SIM,1919,49,50-100,1968,1
STAT,1851,38,15-19,1889,0.046340915478772914
SIM,1837,38,40-44,1875,9
SIM,1906,0,na,1906,4097
SIM,1829,43,30-34,1872,1
SIM,1874,70,na,1944,1416
SIM,1884,15,na,1899,2761
STAT,1820,92,na,1912,22.93860280114697
STAT,1921,22,25-29,1943,106.46203867070835
SIM,1896,22,30-34,1918,27
STAT,1801,54,25-29,1855,0.009584507219286786
SIM,1905,27,45-49,1932,1
STAT,1853,21,20-24,1874,68.7668352551528
SIM,1920,17,35-39,1937,7
SIM,1813,42,25-29,1855,1
STAT,1912,17,35-39,1929,0.8655847301901832
STAT,1880,28,35-39,1908,10.307526362798006
STAT,1869,42,15-19,1911,0.01358467204529894
SIM,1902,33,20-24,1935,2
STAT,1813,68,na,1881,777.5721751425151
SIM,1882,21,25-29,1903,62
STAT,1896,29,40-44,1925,4.007236703874902
SIM,1876,82,na,1958,669
SIM,1861,21,20-24,1882,97
STAT,1856,27,45-49,1883,0.9213470429712979
STAT,1867,15,20-24,1882,17.56410828072632
STAT,1873,26,35-39,1899,10.013646887038812
SIM,1857,1,na,1858,2898
STAT,1878,38,50-100,1916,1.297226125572194
SIM,1819,39,50-100,1858,4
SIM,1848,56,na,1904,1653
SIM,1864,27,45-49,1891,2
STAT,1869,49,35-39,1918,0.13500820151174409
SIM,1835,38,40-44,1873,3
STAT,1888,33,na,1921,2865.7944316579815
STAT,1886,46,30-34,1932,0.10482257967121916
STAT,1894,29,40-44,1923,3.9027390976385345
STAT,1869,27,50-100,1896,0.6300384273070512
STAT,1906,15,na,1921,3767.5591867681987
STAT,1871,17,35-39,1888,0.5580651667379792
STAT,1888,22,30-34,1910,21.481973294838483
SIM,1868,53,na,1921,2088
STAT,1808,61,na,1869,855.8834531809085
STAT,1874,29,20-24,1903,12.131700442082881
SIM,1863,21,20-24,1884,61
STAT,1916,22,na,1938,3904.961988498701
STAT,1906,18,20-24,1924,26.25516514956073
SIM,1880,33,25-29,1913,12
SIM,1921,12,na,1933,5226
SIM,1896,34,30-34,1930,4
STAT,1926,18,40-44,1944,1.7448777081991544
STAT,1826,86,na,1912,129.40721680222248
SIM,1892,39,25-29,1931,7
STAT,1836,36,25-29,1872,2.2228393389106063
STAT,1970,2,na,1972,5024.719338900336
SIM,1823,32,40-44,1855,5
SIM,1922,24,40-44,1946,5
STAT,1886,52,na,1938,2312.702652176804
STAT,1892,24,45-49,1916,0.8859874099499377
STAT,1907,62,na,1969,3038.078005488004
STAT,1851,26,15-19,1877,0.44143742628276933
STAT,1825,33,45-49,1858,3.198911528720586
STAT,1910,29,35-39,1939,14.680891111584783
SIM,1869,100,na,1969,17
SIM,1922,26,50-100,1948,1
STAT,1867,27,20-24,1894,11.235582899812238
SIM,1858,63,na,1921,1429
STAT,1882,23,40-44,1905,2.0646497734134113
SIM,1883,30,na,1913,2512
SIM,1890,23,40-44,1913,4
STAT,1875,21,40-44,1896,2.1883570109138373
SIM,1858,46,na,1904,1891
SIM,1897,21,35-39,1918,9
STAT,1832,26,50-100,1858,0.5910727549081517
STAT,1857,43,35-39,1900,1.4322877360146897
STAT,1888,34,30-34,1922,20.876492224302215
SIM,1934,18,40-44,1952,2
STAT,1855,21,20-24,1876,62.8601403977382
SIM,1882,29,20-24,1911,15
STAT,1909,33,30-34,1942,15.26868728541299
SIM,1833,33,45-49,1866,3
STAT,1872,33,25-29,1905,10.428149091823483
SIM,1914,18,20-24,1932,30
STAT,1783,98,na,1881,0.6139404866266267
STAT,1901,36,50-100,1937,0.3798594255609697
STAT,1838,24,25-29,1862,53.789455124800384
SIM,1865,43,35-39,1908,5
STAT,1889,21,35-39,1910,7.375744022597001
STAT,1914,24,40-44,1938,3.4829147117820507
STAT,1827,38,40-44,1865,5.542507737094773
STAT,1865,31,25-29,1896,9.522412549616222
STAT,1900,19,30-34,1919,2.241565416037753
SIM,1829,31,30-34,1860,19
SIM,1889,27,15-19,1916,1
STAT,1884,39,25-29,1923,2.8766768228895634
STAT,1845,45,30-34,1890,0.0763884265422852
SIM,1876,39,40-44,1915,13
SIM,1899,28,20-24,1927,22
STAT,1842,32,35-39,1874,9.593760429585389
STAT,1880,67,na,1947,1699.4004584526378
STAT,1870,18,30-34,1888,1.5951968123820632
STAT,1878,54,25-29,1932,0.0036576976698701985
STAT,1917,20,45-49,1937,1.2276361857317137
SIM,1824,40,na,1864,1535
SIM,1850,21,45-49,1871,6
STAT,1912,31,15-19,1943,0.12951950655762262
SIM,1915,38,25-29,1953,2
SIM,1846,24,25-29,1870,58
STAT,1953,14,na,1967,4845.405400517957
SIM,1940,22,35-39,1962,16
SIM,1926,35,30-34,1961,5
STAT,1851,53,na,1904,1747.8787494488042
STAT,1882,50,35-39,1932,0.008679302695667405
SIM,1849,37,20-24,1886,1
SIM,1871,29,45-49,1900,1
STAT,1827,31,20-24,1858,4.392983165263817
SIM,1844,33,20-24,1877,3
STAT,1826,106,na,1932,0.007081527483908643
SIM,1809,83,na,1892,75
STAT,1871,22,na,1893,2389.939868684999
SIM,1838,22,40-44,1860,4
SIM,1866,41,na,1907,2310
STAT,1951,17,20-24,1968,164.6971525965861
SIM,1864,33,40-44,1897,7
SIM,1928,26,35-39,1954,26
STAT,1911,19,40-44,1930,0.28397272012879593
STAT,1881,18,40-44,1899,0.17992052330664324
STAT,1906,20,35-39,1926,8.716486795264707
SIM,1878,20,20-24,1898,74
SIM,1923,22,35-39,1945,22
SIM,1865,40,50-100,1905,1
STAT,1865,38,45-49,1903,1.8366199379753145
STAT,1898,43,50-100,1941,0.10047588537435331
STAT,1894,22,20-24,1916,90.42822941889433
STAT,1926,44,20-24,1970,0.022136549447572186
STAT,1935,29,na,1964,5202.455732157778
SIM,1857,16,na,1873,2303
STAT,1879,70,na,1949,1496.175195909545
SIM,1885,22,20-24,1907,61
STAT,1868,39,40-44,1907,4.22236750988489
SIM,1905,20,25-29,1925,92
STAT,1933,14,na,1947,5391.68571814589
STAT,1925,33,15-19,1958,0.1555917465712053
STAT,1851,44,45-49,1895,1.2180872965432858
SIM,1858,37,30-34,1895,6
SIM,1925,20,45-49,1945,2
STAT,1907,38,25-29,1945,0.9262439058041823
STAT,1922,22,na,1944,4273.034127686051
SIM,1830,49,45-49,1879,1
SIM,1817,61,na,1878,976
STAT,1881,36,50-100,1917,1.2167230479280515
STAT,1840,16,na,1856,2151.2966287273757
STAT,1863,47,40-44,1910,0.15241623421080006
SIM,1850,32,35-39,1882,12
SIM,1918,3,na,1921,4643
STAT,1799,90,na,1889,30.715513237031583
STAT,1821,43,20-24,1864,0.266777695066643
STAT,1861,42,50-100,1903,0.8894589697727446
SIM,1835,31,20-24,1866,5
SIM,1912,52,na,1964,3589
STAT,1831,32,25-29,1863,9.380486292339278
STAT,1939,27,15-19,1966,0.723981846613602
STAT,1822,49,45-49,1871,0.3267803762301054
STAT,1936,33,25-29,1969,9.150842414924629
SIM,1914,20,35-39,1934,9
STAT,1847,43,40-44,1890,1.7413439617587263
SIM,1928,27,50-100,1955,1
STAT,1891,22,na,1913,2987.0515139941494
STAT,1906,12,na,1918,3834.6276790640463
STAT,1842,21,45-49,1863,0.6947179403136174
SIM,1910,28,30-34,1938,42
STAT,1833,68,na,1901,1003.5607625046957
STAT,1906,32,35-39,1938,8.634321043168773
STAT,1932,36,50-100,1968,0.5758232283515575
STAT,1836,54,20-24,1890,4.4671768076500607E-4
SIM,1827,34,50-100,1861,3
SIM,1859,26,25-29,1885,50
STAT,1902,28,30-34,1930,36.100304830392695
SIM,1849,25,20-24,1874,15
STAT,1880,81,na,1961,789.2875390453676
STAT,1816,42,35-39,1858,4.29603066524576
SIM,1843,16,20-24,1859,23
SIM,1877,67,na,1944,1595
SIM,1907,29,35-39,1936,20
STAT,1897,34,40-44,1931,5.864794341940709
SIM,1860,16,20-24,1876,26
SIM,1835,80,na,1915,356
STAT,1839,53,na,1892,1462.1382801880784
SIM,1913,37,na,1950,3858
SIM,1943,23,30-34,1966,49
STAT,1833,42,35-39,1875,1.4518238771680088
SIM,1879,23,40-44,1902,4
SIM,1874,16,15-19,1890,5
STAT,1802,76,na,1878,345.84013777141575
STAT,1877,34,20-24,1911,2.83558175182277
STAT,1841,25,50-100,1866,0.5951582407130314
SIM,1869,33,25-29,1902,2
SIM,1889,33,45-49,1922,3
SIM,1885,34,20-24,1919,4
STAT,1834,98,na,1932,2.183076659533521
STAT,1931,36,na,1967,5086.117202579793
SIM,1784,83,na,1867,191
STAT,1884,74,na,1958,1218.9617505875137
SIM,1839,42,45-49,1881,3
STAT,1866,52,40-44,1918,0.009853468467345649
SIM,1887,25,25-29,1912,66
STAT,1880,21,15-19,1901,3.547328911535702
SIM,1819,49,45-49,1868,1
STAT,1858,49,25-29,1907,0.04562589312021758
STAT,1835,60,na,1895,1420.9745084936635
STAT,1879,25,25-29,1904,45.41436144311151
SIM,1942,22,50-100,1964,1
SIM,1923,44,na,1967,4229
STAT,1872,37,50-100,1909,1.2552806062837065
STAT,1851,23,45-49,1874,0.6820904688155297
STAT,1872,25,50-100,1897,0.6584776914399335
STAT,1935,23,30-34,1958,39.90021485237559
SIM,1870,26,25-29,1896,51
STAT,1859,39,30-34,1898,4.298385594750491
STAT,1790,104,na,1894,0.015022857989127586
STAT,1929,23,40-44,1952,4.323365751470506
SIM,1928,33,40-44,1961,6
SIM,1853,23,na,1876,2002
STAT,1826,39,35-39,1865,5.997978545525376
STAT,1894,15,15-19,1909,7.823607111722499
STAT,1909,23,20-24,1932,105.07316082568818
SIM,1913,28,15-19,1941,1
SIM,1819,76,na,1895,562
SIM,1869,30,20-24,1899,2
STAT,1932,22,35-39,1954,12.599387148198472
STAT,1789,83,na,1872,107.75568370282008
SIM,1835,24,15-19,1859,2
STAT,1852,16,20-24,1868,17.376044629024538
SIM,1855,36,35-39,1891,5
SIM,1917,23,20-24,1940,109
STAT,1868,32,20-24,1900,2.6337721853472664
STAT,1915,22,35-39,1937,9.932128477406364
STAT,1883,33,35-39,1916,10.094065574838092
STAT,1929,35,40-44,1964,1.9636031748501146
SIM,1937,23,40-44,1960,4
STAT,1887,37,50-100,1924,1.4034737447378112
SIM,1870,8,na,1878,2931
SIM,1862,38,35-39,1900,9
SIM,1933,37,na,1970,5129
STAT,1862,26,25-29,1888,37.136616955285206
SIM,1822,62,na,1884,1060
STAT,1872,38,na,1910,2396.8731647905306
SIM,1834,39,35-39,1873,8
STAT,1875,8,na,1883,2805.160813448473
SIM,1848,44,45-49,1892,2
STAT,1887,44,25-29,1931,0.7241625631607227
STAT,1823,48,50-100,1871,0.364027302510725
STAT,1905,27,50-100,1932,0.9424873020325564
STAT,1909,44,20-24,1953,0.01663966096176181
STAT,1946,16,35-39,1962,4.74978561420006
STAT,1826,80,na,1906,360.79052249258234
STAT,1882,17,45-49,1899,0.06492252393326182
STAT,1872,16,40-44,1888,0.1887322744619223
STAT,1901,17,25-29,1918,8.084036775359706
STAT,1897,46,40-44,1943,0.13210045140659404
STAT,1898,33,45-49,1931,2.3955421016947933
SIM,1841,42,35-39,1883,7
STAT,1847,36,35-39,1883,5.782366806885424
STAT,1860,67,na,1927,1312.1073983562635
SIM,1838,43,40-44,1881,5
SIM,1938,22,45-49,1960,5
STAT,1944,25,30-34,1969,43.24426171443274
SIM,1908,21,20-24,1929,2
SIM,1954,16,35-39,1970,7
SIM,1815,83,na,1898,117
STAT,1814,100,na,1914,0.49471300020914233
SIM,1888,46,40-44,1934,1
SIM,1933,27,20-24,1960,25
STAT,1852,37,20-24,1889,0.6243666888461246
SIM,1843,26,30-34,1869,28
STAT,1946,0,na,1946,5032.5092394083185
STAT,1852,29,35-39,1881,8.121033093427371
SIM,1913,39,50-100,1952,2
STAT,1897,49,45-49,1946,0.17779416723109176
SIM,1925,28,40-44,1953,12
STAT,1865,17,45-49,1882,0.0623258998773391
STAT,1873,85,na,1958,361.9444670972456
STAT,1923,39,20-24,1962,0.310979459353846
STAT,1860,28,15-19,1888,0.37683457068407766
SIM,1828,38,50-100,1866,2
STAT,1850,49,20-24,1899,0.008837992749794328
SIM,1896,37,35-39,1933,17
STAT,1903,27,35-39,1930,13.992534989518115
SIM,1784,80,na,1864,283
STAT,1832,25,35-39,1857,9.065644339166541
SIM,1846,75,na,1921,726
STAT,1844,38,40-44,1882,3.547569366929382
STAT,1863,29,45-49,1892,0.9860145789488893
SIM,1875,89,na,1964,278
STAT,1861,54,50-100,1915,0.012381040279327862
STAT,1846,26,40-44,1872,2.610265607524537
SIM,1933,19,35-39,1952,4
STAT,1804,54,na,1858,1123.9290910400753
STAT,1854,17,35-39,1871,0.502368856393708
STAT,1905,15,35-39,1920,0.8121937512639447
STAT,1879,32,30-34,1911,18.618256971631507
STAT,1917,28,40-44,1945,4.970726530007345
SIM,1897,36,na,1933,3227
SIM,1862,17,35-39,1879,1
SIM,1887,32,30-34,1919,5
SIM,1929,29,20-24,1958,28
STAT,1882,48,na,1930,2207.9683805339046
STAT,1898,23,35-39,1921,8.025475085700084
STAT,1936,19,45-49,1955,0.4851798754992286
SIM,1919,22,na,1941,4130
SIM,1877,46,30-34,1923,1
STAT,1838,48,50-100,1886,0.1832880844185333
SIM,1916,16,30-34,1932,2
SIM,1880,30,20-24,1910,2
STAT,1809,46,na,1855,1634.2537287242926
STAT,1866,16,15-19,1882,5.765724120790486
STAT,1873,23,30-34,1896,18.365421343340376
SIM,1905,24,40-44,1929,6
SIM,1911,27,35-39,1938,18
STAT,1837,51,35-39,1888,0.005876074654997517
STAT,1887,23,25-29,1910,65.23716230612
STAT,1925,19,35-39,1944,5.143822725606242
STAT,1835,26,30-34,1861,24.639864168428915
SIM,1891,30,30-34,1921,23
SIM,1831,76,na,1907,597
SIM,1895,23,25-29,1918,124
STAT,1838,106,na,1944,0.008921132773930928
STAT,1875,49,25-29,1924,0.05904863207078962
SIM,1885,37,25-29,1922,2
SIM,1846,48,50-100,1894,1
SIM,1889,20,30-34,1909,47
STAT,1884,15,20-24,1899,17.97623245478828
STAT,1919,16,40-44,1935,0.31723673366015587
SIM,1870,97,na,1967,13
SIM,1927,16,40-44,1943,2
STAT,1862,23,20-24,1885,60.8213830069627
SIM,1789,72,na,1861,564
STAT,1925,9,na,1934,4906.244364861887
SIM,1898,32,40-44,1930,12
SIM,1870,23,20-24,1893,72
STAT,1892,42,40-44,1934,2.872297733301331
STAT,1918,23,30-34,1941,31.535207837464583
STAT,1831,87,na,1918,118.71434513301396
STAT,1880,25,30-34,1905,27.178890205903738
STAT,1819,53,na,1872,1442.8274270585657
SIM,1873,17,45-49,1890,2
STAT,1825,39,na,1864,1675.6769437195885
STAT,1812,53,50-100,1865,0.03341399965912169
STAT,1825,51,40-44,1876,0.013316902194227646
STAT,1877,37,25-29,1914,3.046438120926692
STAT,1886,49,35-39,1935,0.14801730294847937
STAT,1883,30,30-34,1913,17.617052835087037
STAT,1921,26,40-44,1947,5.319106225502643
SIM,1822,49,50-100,1871,1
STAT,1838,21,20-24,1859,66.1669872183678
STAT,1846,86,na,1932,158.66848818067228
STAT,1885,1,na,1886,3367.2629372481983
SIM,1832,34,40-44,1866,8
SIM,1859,93,na,1952,66
STAT,1814,49,50-100,1863,0.7089891029667091
STAT,1910,26,30-34,1936,38.72262448698133
SIM,1899,38,30-34,1937,1
STAT,1856,45,na,1901,1819.6423467850725
SIM,1920,9,na,1929,4408
STAT,1839,27,45-49,1866,0.9653280868955204
SIM,1868,56,na,1924,1998
STAT,1872,30,20-24,1902,2.785902322543937
SIM,1848,53,na,1901,1711
STAT,1879,73,na,1952,1266.5659876072643
SIM,1899,14,na,1913,3585
SIM,1860,31,50-100,1891,1
STAT,1875,5,na,1880,2872.4469548278894
STAT,1891,21,25-29,1912,72.51937278492674
STAT,1822,46,40-44,1868,0.24771269299697427
STAT,1866,52,na,1918,2015.28080524583
STAT,1889,80,na,1969,1226.438883062456
SIM,1926,23,30-34,1949,50
STAT,1826,47,20-24,1873,0.009376864670216159
STAT,1946,26,45-49,1972,1.9643392240394102
STAT,1818,48,40-44,1866,0.3827601372083254
SIM,1903,36,40-44,1939,3
SIM,1922,27,45-49,1949,3
SIM,1881,36,45-49,1917,2
SIM,1840,25,35-39,1865,9
SIM,1865,40,30-34,1905,1
STAT,1834,20,40-44,1854,3.3826156495676196
STAT,1945,20,20-24,1965,124.42308269209514
STAT,1861,19,50-100,1880,0.0469104363134384
SIM,1897,33,na,1930,3170
STAT,1888,37,35-39,1925,8.530086177154862
STAT,1908,49,30-34,1957,0.08172863850553118
SIM,1817,95,na,1912,4
SIM,1892,18,25-29,1910,12
STAT,1877,16,25-29,1893,6.010611830670349
SIM,1866,25,20-24,1891,16
STAT,1938,31,35-39,1969,9.378727552044433
SIM,1907,2,na,1909,4016
STAT,1891,25,40-44,1916,3.809058798067915
STAT,1884,18,25-29,1902,5.70434585112825
STAT,1923,37,50-100,1960,0.4963584033195126
SIM,1852,38,40-44,1890,9
SIM,1883,24,45-49,1907,3
SIM,1833,57,na,1890,1344
STAT,1929,40,na,1969,4919.1881078345805
SIM,1876,22,45-49,1898,1
STAT,1862,44,20-24,1906,0.13605167217557612
STAT,1815,110,na,1925,1.4288763803963178E-4
SIM,1914,30,na,1944,3903
STAT,1824,34,40-44,1858,6.90458497486516
STAT,1893,38,20-24,1931,0.9926433085017524
STAT,1854,19,na,1873,2076.9009110888996
STAT,1914,27,45-49,1941,1.776942986707891
SIM,1964,4,na,1968,5234
STAT,1848,39,20-24,1887,0.6048024111286794
STAT,1824,30,25-29,1854,28.957015916775344
STAT,1861,16,30-34,1877,1.5534411172423666
STAT,1896,11,na,1907,3484.744840639578
STAT,1858,25,20-24,1883,9.856759150655229
STAT,1836,33,20-24,1869,2.1048582579984028
STAT,1869,46,30-34,1915,0.09560982180683751
STAT,1904,34,na,1938,3488.496675792989
SIM,1790,69,na,1859,528
SIM,1856,82,na,1938,337
SIM,1854,22,25-29,1876,5
STAT,1837,39,45-49,1876,1.5849852847716552
SIM,1845,39,45-49,1884,3
SIM,1936,11,na,1947,3465
SIM,1839,32,35-39,1871,10
SIM,1858,3,na,1861,2684
SIM,1860,29,35-39,1889,8
STAT,1873,36,45-49,1909,2.0716861702579488
STAT,1852,31,50-100,1883,0.7722214053222958
SIM,1904,23,na,1927,3622
SIM,1854,26,40-44,1880,5
STAT,1904,22,25-29,1926,83.6968526549654
STAT,1925,6,na,1931,4939.7594222782445
STAT,1947,19,20-24,1966,155.71252375311698
STAT,1830,37,35-39,1867,6.390270805306757
SIM,1912,22,25-29,1934,101
STAT,1896,36,50-100,1932,1.6621652159049405
STAT,1919,33,na,1952,4146.352545258598
SIM,1832,30,25-29,1862,13
STAT,1914,41,na,1955,3760.1552839830565
SIM,1880,1,na,1881,3419
STAT,1925,27,20-24,1952,21.996523000503192
SIM,1844,36,25-29,1880,5
SIM,1928,23,30-34,1951,68
STAT,1905,39,50-100,1944,0.3865030793043747
STAT,1838,31,30-34,1869,16.10719857743246
STAT,1857,22,35-39,1879,5.367277052080662
SIM,1855,33,30-34,1888,16
SIM,1882,34,na,1916,2275
SIM,1895,55,na,1950,2855
STAT,1844,20,na,1864,2098.7266611480886
STAT,1808,48,15-19,1856,0.001021320244825376
STAT,1840,61,na,1901,1344.6663234244534
SIM,1908,24,25-29,1932,120
STAT,1857,41,na,1898,1849.740317271517
STAT,1959,8,na,1967,5242.609195453193
STAT,1884,36,20-24,1920,0.7817489571066722
STAT,1909,36,35-39,1945,2.3461531528512345
SIM,1926,38,35-39,1964,9
STAT,1815,47,45-49,1862,0.6348728604894518
SIM,1871,42,na,1913,2119
SIM,1838,25,45-49,1863,1
STAT,1876,23,15-19,1899,3.4645502081876
STAT,1924,34,45-49,1958,1.8706176510579646
STAT,1929,38,45-49,1967,0.8917643797297009
STAT,1785,79,na,1864,279.973009947063
STAT,1845,48,35-39,1893,0.10801410101551807
STAT,1846,22,25-29,1868,50.51132196521032
STAT,1878,52,35-39,1930,0.009092960603781714
STAT,1910,16,20-24,1926,27.4661303058837
STAT,1827,34,25-29,1861,14.34246351462389
STAT,1792,72,na,1864,483.78412008378496
STAT,1816,79,na,1895,310.20237509318
STAT,1851,41,40-44,1892,1.8640882269858907
SIM,1844,94,na,1938,2
STAT,1897,16,45-49,1913,0.08932112352059601
SIM,1864,49,na,1913,2033
SIM,1949,22,20-24,1971,204
STAT,1840,17,40-44,1857,0.17040774356981434
SIM,1911,45,30-34,1956,1
STAT,1847,33,30-34,1880,15.820977851041691
STAT,1869,18,na,1887,2507.0821453868925
SIM,1909,35,30-34,1944,1
SIM,1918,47,40-44,1965,1
STAT,1878,26,50-100,1904,0.6815956030486817
STAT,1806,80,na,1886,275.5518308946924
SIM,1932,34,45-49,1966,2
STAT,1807,65,na,1872,983.9795154707623
STAT,1849,31,40-44,1880,3.939403518114028
STAT,1868,22,45-49,1890,0.6794473729447973
STAT,1915,47,15-19,1962,3.7878201019743337E-4
STAT,1795,86,na,1881,64.48866785077348
SIM,1813,88,na,1901,29
STAT,1837,27,na,1864,1851.1893628934745
STAT,1848,20,35-39,1868,5.603355925809174
STAT,1912,42,50-100,1954,0.1155858413401296
SIM,1863,24,25-29,1887,77
STAT,1834,48,25-29,1882,0.040585068238332085
SIM,1859,103,na,1962,3
SIM,1877,27,50-100,1904,1
STAT,1877,22,50-100,1899,0.43147730794174455
SIM,1846,31,30-34,1877,23
STAT,1870,35,15-19,1905,0.05653269661029978
STAT,1943,18,40-44,1961,1.512788155721419
STAT,1861,107,na,1968,0.04285195070322199
SIM,1884,27,30-34,1911,29
SIM,1917,26,25-29,1943,7
STAT,1938,21,25-29,1959,93.28573662764872
SIM,1877,28,35-39,1905,13
STAT,1892,27,15-19,1919,0.5800867752325328
SIM,1892,36,20-24,1928,1
STAT,1843,27,na,1870,2149.1953472150253
STAT,1832,35,45-49,1867,1.729935075330971
STAT,1855,24,25-29,1879,51.10120383604489
STAT,1859,20,45-49,1879,0.6571411519559562
STAT,1817,72,na,1889,637.2922782324176
STAT,1899,25,na,1924,3356.518927312238
STAT,1817,45,20-24,1862,0.02765744117690385
SIM,1846,21,20-24,1867,71
SIM,1851,42,na,1893,1828
SIM,1828,36,40-44,1864,2
STAT,1859,35,15-19,1894,0.04618445464943934
STAT,1954,16,50-100,1970,0.47255671961143253
SIM,1831,23,35-39,1854,11
STAT,1903,43,50-100,1946,0.10561873201824351
STAT,1858,26,na,1884,1990.7585425282148
STAT,1853,34,na,1887,2018.1811118886217
SIM,1894,70,na,1964,2125
STAT,1855,60,na,1915,1478.4423983016468
STAT,1887,27,40-44,1914,3.4243291101872897
SIM,1853,57,na,1910,1653
STAT,1927,21,15-19,1948,6.710317575067987
STAT,1836,19,40-44,1855,0.17434092536533108
SIM,1895,27,40-44,1922,8
SIM,1930,2,na,1932,5901
SIM,1951,18,40-44,1969,3
STAT,1865,35,40-44,1900,4.091635423857877
SIM,1935,21,15-19,1956,6
STAT,1918,38,35-39,1956,2.598992938337597
SIM,1879,30,15-19,1909,1
SIM,1873,35,40-44,1908,5
STAT,1850,111,na,1961,1.9413711108862296E-4
STAT,1871,50,25-29,1921,0.0036307271845766004
STAT,1889,18,na,1907,3174.2879939338245
STAT,1899,29,25-29,1928,58.67144868218383
SIM,1840,35,45-49,1875,3
STAT,1836,79,na,1915,435.14728489152094
STAT,1889,44,50-100,1933,1.313311320070138
STAT,1834,38,15-19,1872,0.046519677239833905
STAT,1935,26,35-39,1961,20.880089991739627
SIM,1933,37,30-34,1970,1
STAT,1829,37,50-100,1866,1.0734920451350942
SIM,1910,24,15-19,1934,5
STAT,1864,21,30-34,1885,16.535754943165674
STAT,1833,28,20-24,1861,10.236479648733688
STAT,1852,19,25-29,1871,5.456496630091158
STAT,1876,27,30-34,1903,26.527353137126187
SIM,1893,29,30-34,1922,47
SIM,1920,19,na,1939,4308
STAT,1866,37,15-19,1903,0.05283976828366829
STAT,1841,37,45-49,1878,1.7341831222539614
SIM,1927,30,20-24,1957,2
STAT,1855,50,40-44,1905,0.008278292989148653
STAT,1895,18,35-39,1913,0.7284243905453766
SIM,1879,48,na,1927,2759
STAT,1870,28,40-44,1898,2.976848614483991
SIM,1856,20,35-39,1876,11
STAT,1848,103,na,1951,0.11155897767246079
STAT,1822,40,35-39,1862,2.9892308448953404
SIM,1841,28,20-24,1869,17
SIM,1834,50,na,1884,1532
STAT,1842,42,na,1884,1875.2122320878825
STAT,1903,45,30-34,1948,0.07997314757449248
SIM,1946,21,25-29,1967,101
SIM,1907,37,20-24,1944,1
STAT,1867,48,20-24,1915,0.011348373757172407
SIM,1883,39,15-19,1922,1
STAT,1869,25,30-34,1894,24.97012938301227
SIM,1888,28,45-49,1916,1
SIM,1857,31,40-44,1888,8
STAT,1815,91,na,1906,29.963392894176007
STAT,1908,16,30-34,1924,2.4168865076256307
STAT,1952,20,50-100,1972,0.8075923748241415
STAT,1888,84,na,1972,832.191766838843
SIM,1821,34,30-34,1855,20
SIM,1869,37,40-44,1906,6
STAT,1786,72,na,1858,447.6659824907102
SIM,1826,38,30-34,1864,11
STAT,1770,107,na,1877,0.004966626420432585
STAT,1825,36,15-19,1861,0.08890415207352169
STAT,1944,28,35-39,1972,16.54751000212792
SIM,1824,43,na,1867,1491
STAT,1850,20,25-29,1870,52.433626305027374
STAT,1925,37,30-34,1962,2.231777982057959
STAT,1843,32,50-100,1875,0.8892137179520101
STAT,1843,17,25-29,1860,5.846020126985752
STAT,1887,41,20-24,1928,0.1823659249078562
STAT,1914,38,50-100,1952,0.42558386872533466
STAT,1885,29,30-34,1914,25.446423986675196
SIM,1901,22,15-19,1923,6
STAT,1913,48,na,1961,3647.9096537695996
SIM,1835,35,na,1870,1815
SIM,1945,25,na,1970,4436
STAT,1875,39,15-19,1914,0.05820268476780173
STAT,1888,47,45-49,1935,0.2832938509787216
SIM,1872,21,30-34,1893,29
STAT,1802,73,na,1875,459.5862345483909
SIM,1865,22,35-39,1887,14
STAT,1854,31,15-19,1885,0.1127797830697703
STAT,1860,38,25-29,1898,2.3713321128214906
SIM,1880,56,na,1936,1912
SIM,1881,26,35-39,1907,12
STAT,1828,27,35-39,1855,14.161845265774742
STAT,1870,18,50-100,1888,0.04903267893633834
STAT,1913,34,35-39,1947,9.19590362064138
SIM,1840,50,na,1890,1539
SIM,1921,34,35-39,1955,23
SIM,1930,26,na,1956,5224
SIM,1928,36,45-49,1964,1
STAT,1919,30,20-24,1949,2.7070285633359275
SIM,1878,39,40-44,1917,8
STAT,1890,26,na,1916,2987.0139924224422
STAT,1879,22,20-24,1901,73.48518253507604
SIM,1922,38,50-100,1960,3
SIM,1830,40,35-39,1870,3
STAT,1940,17,45-49,1957,0.5174334260784208
SIM,1879,26,45-49,1905,2
SIM,1836,27,35-39,1863,13
SIM,1943,26,35-39,1969,22
SIM,1887,22,20-24,1909,82
STAT,1897,47,na,1944,3055.1258511674373
STAT,1858,46,20-24,1904,0.009735655484009953
STAT,1815,41,30-34,1856,3.8415713130409825
STAT,1925,16,15-19,1941,56.07022161600142
STAT,1857,44,15-19,1901,0.010854038337184823
STAT,1921,43,na,1964,4261.823388987511
SIM,1867,98,na,1965,2
SIM,1878,24,30-34,1902,31
STAT,1843,45,25-29,1888,0.04748337660799198
SIM,1883,28,30-34,1911,29
STAT,1927,24,25-29,1951,115.36213716005373
SIM,1863,84,na,1947,177
STAT,1924,23,45-49,1947,1.3503901956581466
STAT,1847,26,na,1873,2042.2871612549172
STAT,1856,51,45-49,1907,0.011677196857929372
STAT,1922,15,35-39,1937,4.9781439438525705
SIM,1871,28,na,1899,2216
STAT,1833,32,35-39,1865,8.651095957006472
STAT,1944,21,20-24,1965,122.53060202144015
SIM,1822,86,na,1908,143
STAT,1863,49,45-49,1912,0.20668319570677113
STAT,1878,43,20-24,1921,0.16741920227815837
SIM,1781,87,na,1868,44
STAT,1870,27,40-44,1897,2.9873641362435692
STAT,1904,42,50-100,1946,0.10712829087601546
STAT,1814,47,na,1861,1431.0732826912654
SIM,1928,34,35-39,1962,3
STAT,1851,31,na,1882,2070.502193350872
STAT,1889,29,50-100,1918,0.8003429100069469
SIM,1841,32,35-39,1873,12
SIM,1789,67,na,1856,808
SIM,1933,16,15-19,1949,1
STAT,1880,46,40-44,1926,0.184052549457781
SIM,1888,44,na,1932,2635
STAT,1799,100,na,1899,0.344492022998391
STAT,1823,83,na,1906,220.94424883767627
SIM,1926,35,na,1961,4943
SIM,1896,15,35-39,1911,5
STAT,1861,29,40-44,1890,2.5071174035704025
SIM,1932,23,45-49,1955,1
STAT,1868,95,na,1963,35.61895360098295
SIM,1804,73,na,1877,731
STAT,1888,28,40-44,1916,3.599993838454014
STAT,1864,81,na,1945,490.51791763417333
STAT,1845,53,35-39,1898,0.006618658307144743
STAT,1911,36,40-44,1947,1.4819618806951953
SIM,1827,29,30-34,1856,25
STAT,1820,45,30-34,1865,0.18180271936824047
STAT,1843,54,50-100,1897,0.01185676895057561
SIM,1834,42,45-49,1876,10
SIM,1883,13,na,1896,2645
SIM,1887,22,30-34,1909,30
STAT,1820,41,50-100,1861,2.1614212149529335
STAT,1887,35,50-100,1922,1.4168027049553407
STAT,1894,26,15-19,1920,0.5973998423015418
SIM,1922,21,na,1943,4240
STAT,1882,32,30-34,1914,17.352808526193442
STAT,1906,36,50-100,1942,0.39537423649818726
SIM,1884,30,na,1914,2632
STAT,1877,17,25-29,1894,5.99588583168521
SIM,1896,28,40-44,1924,7
STAT,1879,22,30-34,1901,18.994217203427503
SIM,1895,36,25-29,1931,7
STAT,1871,40,30-34,1911,1.1734907254451212
STAT,1847,53,45-49,1900,0.011135263248088213
STAT,1941,20,40-44,1961,3.5473964974122536
SIM,1842,90,na,1932,66
SIM,1829,37,40-44,1866,7
SIM,1853,19,30-34,1872,4
STAT,1918,31,20-24,1949,2.6558321826882048
STAT,1829,43,25-29,1872,0.5315874467413714
STAT,1909,33,20-24,1942,2.363850326595246
STAT,1860,101,na,1961,1.248103915643159
STAT,1832,48,50-100,1880,0.1924950938337059
SIM,1949,19,30-34,1968,16
STAT,1896,34,25-29,1930,13.682254661030594
SIM,1930,15,35-39,1945,10
SIM,1938,20,na,1958,3587
STAT,1876,29,50-100,1905,0.6690544785316173
STAT,1917,42,50-100,1959,0.12511268730910932
STAT,1864,50,40-44,1914,0.009686674181020335
SIM,1889,25,45-49,1914,1
STAT,1802,100,na,1902,0.3368658108077705
SIM,1875,43,45-49,1918,1
SIM,1919,36,35-39,1955,4
STAT,1877,22,20-24,1899,72.91534254122826
STAT,1934,18,na,1952,5063.871796652025
STAT,1874,49,20-24,1923,0.012237778503359519
SIM,1872,45,na,1917,2389
SIM,1927,18,40-44,1945,2
SIM,1821,42,35-39,1863,3
STAT,1871,53,50-100,1924,0.015016657390332467
STAT,1909,20,15-19,1929,5.075828087522787
STAT,1805,86,na,1891,89.1780029979324
STAT,1847,47,50-100,1894,0.19062919010095472
STAT,1826,32,na,1858,1720.1349942638267
STAT,1889,44,35-39,1933,2.2510842796864656
STAT,1860,47,50-100,1907,0.20233888826517923
SIM,1939,6,na,1945,4023
STAT,1852,48,30-34,1900,0.07700238915069682
STAT,1827,35,15-19,1862,0.07675013636753998
STAT,1847,27,40-44,1874,2.807728384018303
STAT,1915,38,50-100,1953,0.4306640578978686
SIM,1880,64,na,1944,1617
SIM,1906,49,30-34,1955,1
STAT,1766,105,na,1871,0.02807735703709665
STAT,1861,27,15-19,1888,0.3852354628202856
STAT,1880,33,35-39,1913,10.810700160635191
STAT,1893,62,na,1955,2365.351790570916
SIM,1968,2,na,1970,5237
STAT,1901,29,35-39,1930,13.666579598512905
SIM,1917,33,20-24,1950,4
STAT,1933,21,45-49,1954,1.5266612058889515
SIM,1818,81,na,1899,219
SIM,1941,21,45-49,1962,5
STAT,1792,105,na,1897,0.0048635642656991405
STAT,1836,18,50-100,1854,0.056929855837985405
STAT,1871,48,40-44,1919,0.17082804275120664
STAT,1919,18,40-44,1937,1.5732026580934122
SIM,1873,35,35-39,1908,9
SIM,1890,32,30-34,1922,29
SIM,1887,17,35-39,1904,4
SIM,1855,27,40-44,1882,1
STAT,1865,35,35-39,1900,6.611033110511934
SIM,1884,44,25-29,1928,3
SIM,1837,23,30-34,1860,20
SIM,1952,16,25-29,1968,68
STAT,1847,52,30-34,1899,0.0046171644734359415
SIM,1823,41,30-34,1864,1
STAT,1815,50,45-49,1865,0.038823826643786134
SIM,1869,41,na,1910,2256
STAT,1909,18,50-100,1927,0.07473475696032796
STAT,1870,39,35-39,1909,6.9825697926265855
SIM,1918,16,na,1934,4450
STAT,1898,22,40-44,1920,2.8747235319295013
STAT,1922,20,30-34,1942,33.83130921147288
SIM,1851,45,25-29,1896,1
STAT,1834,101,na,1935,0.3834690630399335
STAT,1884,40,40-44,1924,2.293061681740685
SIM,1842,47,na,1889,1627
STAT,1826,64,na,1890,1013.8813467885611
SIM,1851,67,na,1918,1253
STAT,1822,40,50-100,1862,1.7439554539693507
STAT,1880,28,na,1908,2549.4179332178855
SIM,1839,43,na,1882,1747
SIM,1956,4,na,1960,5513
STAT,1843,50,20-24,1893,6.042628986958209E-4
SIM,1863,33,25-29,1896,15
SIM,1793,72,na,1865,470
STAT,1845,53,50-100,1898,0.011611017680706496
STAT,1831,24,25-29,1855,71.72089719969568
STAT,1910,44,25-29,1954,0.06798625059388658
SIM,1890,41,45-49,1931,6
SIM,1797,86,na,1883,47
STAT,1882,41,45-49,1923,1.4942064677507707
SIM,1843,39,40-44,1882,9
STAT,1868,38,40-44,1906,4.244139947817191
STAT,1913,44,50-100,1957,0.11648544440004406
STAT,1920,29,45-49,1949,1.9201695707528132
STAT,1835,39,40-44,1874,3.950998729026314
STAT,1801,72,na,1873,537.2276626023194
STAT,1858,30,50-100,1888,0.7568045030870505
STAT,1889,57,na,1946,2532.4237012739954
SIM,1876,38,40-44,1914,7
STAT,1858,17,15-19,1875,5.608319308881375
SIM,1866,17,15-19,1883,1
STAT,1867,43,45-49,1910,1.4230253406720708
SIM,1917,20,15-19,1937,4
SIM,1876,59,na,1935,2229
SIM,1834,28,na,1862,1837
SIM,1840,19,20-24,1859,12
SIM,1935,24,25-29,1959,151
STAT,1928,33,30-34,1961,20.082011697889595
SIM,1892,40,40-44,1932,3
STAT,1885,43,na,1928,2335.338104943687
SIM,1839,31,40-44,1870,7
STAT,1866,102,na,1968,1.9221820859968344
STAT,1874,36,15-19,1910,0.05876995753500763
SIM,1936,33,30-34,1969,18
STAT,1856,62,na,1918,1463.6534933375667
STAT,1916,49,50-100,1965,0.23535177355926368
SIM,1821,69,na,1890,766
STAT,1903,15,25-29,1918,8.255869888651517
STAT,1838,22,50-100,1860,0.3887325593965315
STAT,1903,6,na,1909,3788.348222244299
STAT,1848,31,40-44,1879,3.972304926809415
STAT,1818,100,na,1918,0.5410321477181242
STAT,1850,24,35-39,1874,5.193096033515059
SIM,1912,59,na,1971,3460
STAT,1870,25,15-19,1895,0.4555302601763348
STAT,1890,40,40-44,1930,2.8339142280205984
SIM,1822,32,25-29,1854,10
STAT,1838,29,40-44,1867,2.759711152378577
STAT,1776,88,na,1864,42.17240297177651
STAT,1921,11,na,1932,4615.647299037629
SIM,1835,37,40-44,1872,7
STAT,1814,79,na,1893,325.7740992524071
SIM,1943,18,50-100,1961,3
SIM,1945,26,35-39,1971,2
SIM,1859,63,na,1922,1576
STAT,1891,36,15-19,1927,0.07126445248264633
STAT,1837,42,20-24,1879,0.12494701283107515
STAT,1853,25,15-19,1878,0.4471074014566097
STAT,1809,49,40-44,1858,0.736389434491007
STAT,1881,23,25-29,1904,56.28559161013863
STAT,1880,12,na,1892,2768.526256498224
STAT,1829,26,35-39,1855,18.70692715581939
STAT,1831,70,na,1901,945.4211287680062
STAT,1824,45,15-19,1869,4.7893724281322013E-4
STAT,1913,56,na,1969,3521.76682028351
SIM,1817,49,40-44,1866,1
SIM,1877,60,na,1937,1955
STAT,1798,99,na,1897,0.6519225483579572
STAT,1794,85,na,1879,93.14112108410394
STAT,1862,15,na,1877,2310.132237694168
STAT,1876,44,25-29,1920,0.6673360528642094
STAT,1866,29,na,1895,2229.597149246768
SIM,1880,25,25-29,1905,3
SIM,1913,23,35-39,1936,12
STAT,1944,16,25-29,1960,47.59341183230195
STAT,1905,23,35-39,1928,8.571106016423215
SIM,1892,65,na,1957,2420
STAT,1834,27,30-34,1861,22.221349321664373
STAT,1858,53,20-24,1911,5.873972495404803E-4
STAT,1897,46,35-39,1943,0.1080260703246063
STAT,1818,37,15-19,1855,0.21113601053267966
STAT,1835,84,na,1919,247.85599530973974
SIM,1861,25,15-19,1886,3
STAT,1813,42,35-39,1855,6.590833997783221
SIM,1857,22,45-49,1879,1
SIM,1842,27,30-34,1869,28
STAT,1809,53,25-29,1862,0.0147463738858528
STAT,1839,98,na,1937,2.241963926415494
SIM,1868,25,25-29,1893,55
STAT,1894,28,40-44,1922,3.916996966596949
STAT,1849,22,45-49,1871,0.6545361607614133
STAT,1855,29,40-44,1884,2.385827298945885
STAT,1896,37,50-100,1933,1.6542034445207556
STAT,1933,37,30-34,1970,2.531672132290901
STAT,1855,109,na,1964,0.003210967723477872
STAT,1830,42,35-39,1872,1.5620880631512968
SIM,1863,16,35-39,1879,1
SIM,1856,31,40-44,1887,9
STAT,1869,54,35-39,1923,0.00824596436493729
STAT,1818,47,40-44,1865,0.38879585850524273
STAT,1896,17,35-39,1913,0.7393051554332989
SIM,1867,41,45-49,1908,3
SIM,1852,27,15-19,1879,1
STAT,1871,51,na,1922,2186.239500969758
STAT,1822,34,na,1856,1656.7076608559132
STAT,1826,48,na,1874,1471.2334023530584
STAT,1928,36,35-39,1964,3.120823805887186
SIM,1906,33,45-49,1939,2
STAT,1875,53,20-24,1928,7.602043860515716E-4
SIM,1863,29,40-44,1892,5
STAT,1839,53,35-39,1892,0.0058461006280640234
STAT,1844,27,15-19,1871,0.43039237039226724
STAT,1847,10,na,1857,2352.5699537251417
STAT,1875,65,na,1940,1769.408759417598
STAT,1823,51,50-100,1874,0.022298085336259103
SIM,1873,40,30-34,1913,2
STAT,1865,40,30-34,1905,1.0752220683985376
STAT,1900,42,15-19,1942,0.001354284219061094
SIM,1864,42,30-34,1906,1
SIM,1867,82,na,1949,315
STAT,1850,48,20-24,1898,0.008913040551235731
SIM,1904,22,30-34,1926,41
STAT,1893,78,na,1971,1493.1364181576134
STAT,1926,44,50-100,1970,0.14725617395284232
SIM,1837,26,35-39,1863,14
SIM,1843,37,15-19,1880,2
STAT,1874,30,30-34,1904,18.33155224767679
STAT,1937,31,30-34,1968,15.90874679391664
STAT,1824,34,35-39,1858,16.123532129362935
STAT,1874,21,40-44,1895,2.1769684706929704
STAT,1796,92,na,1888,11.601474727568908
STAT,1862,51,50-100,1913,0.013177979539809767
SIM,1902,39,45-49,1941,1
STAT,1867,30,na,1897,2303.8165000921663
STAT,1929,15,45-49,1944,0.6532517276591726
SIM,1783,94,na,1877,2
SIM,1854,32,na,1886,2107
STAT,1864,27,40-44,1891,2.717223028673217
STAT,1900,39,50-100,1939,0.37092201133428226
STAT,1857,21,40-44,1878,1.9304776675883966
STAT,1858,1,na,1859,3000.0030279961097
STAT,1913,22,30-34,1935,28.411974135961756
SIM,1872,27,40-44,1899,5
STAT,1821,52,50-100,1873,0.022854552152832226
STAT,1885,28,15-19,1913,0.46014339777138796
STAT,1918,26,25-29,1944,71.7269901971771
STAT,1770,103,na,1873,0.032203707695601165
SIM,1921,22,30-34,1943,52
STAT,1859,41,45-49,1900,1.2248523501561845
SIM,1846,13,na,1859,2365
SIM,1865,21,40-44,1886,2
SIM,1926,31,20-24,1957,2
STAT,1838,21,30-34,1859,17.102633259735015
STAT,1855,16,35-39,1871,0.5089189000961076
STAT,1841,34,35-39,1875,8.885788204392849
SIM,1846,21,30-34,1867,22
SIM,1902,22,20-24,1924,98
STAT,1827,37,40-44,1864,5.690322149774821
STAT,1891,30,30-34,1921,22.228840871792904
STAT,1834,52,20-24,1886,5.091779277574865E-4
STAT,1863,32,20-24,1895,2.4177555496607606
STAT,1869,26,50-100,1895,0.6322005531989917
STAT,1881,50,40-44,1931,0.010532393509933916
STAT,1937,26,35-39,1963,14.934874097271516
STAT,1833,35,15-19,1868,0.0475001881734086
STAT,1891,49,20-24,1940,0.008370731096562362
STAT,1850,7,na,1857,2275.0928224150766
SIM,1852,5,na,1857,2614
STAT,1834,47,50-100,1881,0.17528155695708628
SIM,1882,30,30-34,1912,4
SIM,1900,28,30-34,1928,55
STAT,1835,37,15-19,1872,0.05174694166437041
SIM,1832,34,35-39,1866,17
STAT,1873,58,na,1931,2045.329369641776
SIM,1840,83,na,1923,220
STAT,1875,28,30-34,1903,26.27291001596787
SIM,1909,55,na,1964,3200
SIM,1833,54,na,1887,1400
SIM,1909,31,20-24,1940,8
SIM,1937,15,45-49,1952,3
STAT,1907,47,30-34,1954,0.0814082064100186
STAT,1849,19,15-19,1868,5.604672072499193
STAT,1794,109,na,1903,1.410230772605179E-4
STAT,1833,48,20-24,1881,0.008353383704270224
STAT,1788,73,na,1861,538.6863549905509
STAT,1859,11,na,1870,2267.9387292455704
SIM,1834,71,na,1905,1024
STAT,1897,30,50-100,1927,1.259838467432876
STAT,1924,47,30-34,1971,0.10827868257789898
SIM,1909,23,na,1932,3686
STAT,1784,91,na,1875,15.500121589331062
STAT,1867,46,na,1913,2160.8615686764806
SIM,1838,85,na,1923,125
STAT,1861,46,30-34,1907,0.08183100145405113
SIM,1926,26,25-29,1952,100
SIM,1915,23,45-49,1938,6
STAT,1854,42,20-24,1896,0.12139864139126096
SIM,1852,37,40-44,1889,2
STAT,1868,24,20-24,1892,66.7257379138268
SIM,1829,49,na,1878,1249
STAT,1817,52,20-24,1869,0.001580576606511115
STAT,1838,33,na,1871,1958.2725831018006
STAT,1849,18,50-100,1867,0.046542746615437364
STAT,1829,39,40-44,1868,3.7273564539946418
SIM,1837,39,40-44,1876,2
STAT,1873,17,40-44,1890,0.18916741171936133
STAT,1881,77,na,1958,960.2756758062401
STAT,1848,43,35-39,1891,1.397437283561273
SIM,1857,19,15-19,1876,5
STAT,1939,20,25-29,1959,94.69772864717594
STAT,1884,43,20-24,1927,0.15912935266073266
STAT,1902,38,50-100,1940,0.3793465082244178
SIM,1825,35,na,1860,1663
STAT,1850,35,15-19,1885,0.04380904225200932
STAT,1891,25,35-39,1916,12.269254469768725
SIM,1856,43,35-39,1899,5
STAT,1838,16,35-39,1854,0.535691300477219
STAT,1867,27,50-100,1894,0.6126536847921834
STAT,1840,22,25-29,1862,52.38628843138383
SIM,1898,23,45-49,1921,3
STAT,1844,37,40-44,1881,3.5845982670277796
STAT,1859,48,40-44,1907,0.13772664054503722
SIM,1848,63,na,1911,1379
STAT,1941,23,45-49,1964,1.1858831611021268
STAT,1861,9,na,1870,2360.5386738922653
STAT,1873,51,45-49,1924,0.015081272717801297
SIM,1857,38,30-34,1895,6
STAT,1826,45,25-29,1871,0.0462164670889726
SIM,1818,97,na,1915,1
STAT,1947,20,na,1967,4213.787786589197
STAT,1885,31,45-49,1916,1.7820783073454087
STAT,1855,20,50-100,1875,0.37466564259983953
STAT,1870,17,15-19,1887,5.974683932072924
SIM,1887,34,25-29,1921,20
STAT,1944,24,25-29,1968,101.68340688512961
STAT,1908,16,15-19,1924,8.99894012328813
SIM,1862,40,30-34,1902,3
STAT,1869,40,15-19,1909,0.013738660831928436
STAT,1836,29,30-34,1865,19.992968797020648
SIM,1904,24,na,1928,3633
STAT,1876,38,15-19,1914,0.05886145729355154
SIM,1908,38,na,1946,3853
STAT,1928,41,30-34,1969,0.16648213010316082
STAT,1855,29,na,1884,1900.7547439206844
SIM,1901,59,na,1960,3058
STAT,1942,16,15-19,1958,48.40092970456435
SIM,1878,27,35-39,1905,11
STAT,1874,44,15-19,1918,0.01418963753416978
STAT,1827,105,na,1932,0.018950516464500734
STAT,1865,33,50-100,1898,0.8447742948699919
STAT,1851,15,na,1866,2329.85442944164
SIM,1868,17,25-29,1885,10
STAT,1926,33,20-24,1959,3.006958470267271
STAT,1856,42,30-34,1898,0.9195248635860008
STAT,1893,36,25-29,1929,3.744036781826457
STAT,1840,39,50-100,1879,1.0234650772684368
SIM,1880,31,35-39,1911,17
SIM,1848,32,45-49,1880,2
SIM,1881,81,na,1962,737
STAT,1906,22,na,1928,3511.7323541357982
SIM,1889,61,na,1950,2474
SIM,1888,60,na,1948,2157
STAT,1926,21,50-100,1947,0.8179619700271454
SIM,1836,78,na,1914,514
SIM,1893,31,45-49,1924,3
SIM,1931,27,20-24,1958,1
SIM,1913,44,na,1957,3791
STAT,1856,46,na,1902,1806.7956718167707
SIM,1867,48,40-44,1915,1
SIM,1838,26,na,1864,1844
SIM,1879,28,40-44,1907,7
STAT,1809,47,15-19,1856,0.0017791647801303474
STAT,1866,19,15-19,1885,5.664442672661726
STAT,1867,54,25-29,1921,0.003299012098030511
SIM,1861,27,40-44,1888,5
SIM,1928,31,30-34,1959,31
STAT,1921,40,50-100,1961,0.13539916918672193
SIM,1943,26,25-29,1969,71
STAT,1863,46,40-44,1909,0.1535648996602588
STAT,1853,27,40-44,1880,2.9097807851089095
STAT,1882,35,35-39,1917,7.096373830538571
SIM,1918,24,25-29,1942,4
SIM,1934,21,50-100,1955,1
STAT,1919,43,30-34,1962,0.14115669051701096
STAT,1811,50,na,1861,1257.6299803886052
SIM,1862,67,na,1929,1396
STAT,1812,72,na,1884,629.3398352418686
SIM,1831,29,20-24,1860,11
SIM,1882,25,35-39,1907,1
SIM,1863,21,30-34,1884,19
STAT,1896,43,na,1939,3102.2384691877437
STAT,1818,40,45-49,1858,4.163731367830477
SIM,1831,47,na,1878,1533
STAT,1844,49,35-39,1893,0.10622245593701077
STAT,1815,44,35-39,1859,5.136974067598593
STAT,1935,26,25-29,1961,91.53943670846832
STAT,1935,35,na,1970,5374.215534293419
SIM,1876,75,na,1951,1118
STAT,1884,51,20-24,1935,7.483326440465884E-4
SIM,1823,44,35-39,1867,3
SIM,1859,24,20-24,1883,73
STAT,1928,15,50-100,1943,0.48376403320202893
STAT,1815,64,na,1879,1069.408847668975
SIM,1950,16,15-19,1966,52
STAT,1819,78,na,1897,460.6401877348969
STAT,1885,27,na,1912,2428.952745781529
STAT,1897,18,40-44,1915,0.2488328090845036
SIM,1924,21,45-49,1945,1
SIM,1840,42,45-49,1882,1
SIM,1844,21,20-24,1865,75
STAT,1878,89,na,1967,292.72097913623867
STAT,1871,52,25-29,1923,0.003560236859546767
STAT,1837,32,na,1869,1811.6696121302846
STAT,1966,4,na,1970,5009.561962360836
SIM,1826,47,40-44,1873,2
STAT,1859,106,na,1965,0.06272733512122229
STAT,1916,26,15-19,1942,0.7474373961996543
SIM,1772,94,na,1866,4
STAT,1885,38,40-44,1923,4.433231100511809
SIM,1836,19,30-34,1855,2
STAT,1798,106,na,1904,0.004179512759888218
STAT,1857,49,20-24,1906,0.009361008462519003
SIM,1824,39,30-34,1863,4
STAT,1855,21,30-34,1876,16.247889968602536
STAT,1904,2,na,1906,3897.3703099184304
SIM,1843,32,na,1875,1982
STAT,1875,17,15-19,1892,6.213537893349174
STAT,1761,114,na,1875,1.3925791180769965E-4
STAT,1800,87,na,1887,71.68678775997041
SIM,1813,66,na,1879,791
SIM,1906,30,40-44,1936,7
STAT,1895,30,15-19,1925,0.19106977180173831
STAT,1918,34,25-29,1952,9.93688106030618
STAT,1865,41,45-49,1906,1.3920135365094946
SIM,1873,41,45-49,1914,4
SIM,1860,35,25-29,1895,4
STAT,1884,30,50-100,1914,0.9321839839167596
STAT,1773,101,na,1874,0.13178000077204893
STAT,1846,43,25-29,1889,0.45886318555156874
STAT,1852,35,25-29,1887,2.3810091880974387
STAT,1825,45,50-100,1870,0.32465870867852725
STAT,1923,27,20-24,1950,21.38306336595841
SIM,1897,37,na,1934,3206
SIM,1901,44,25-29,1945,2
STAT,1872,16,35-39,1888,0.5661967906036462
SIM,1928,22,40-44,1950,8
SIM,1769,90,na,1859,31
SIM,1898,39,30-34,1937,2
SIM,1893,38,40-44,1931,2
SIM,1820,38,35-39,1858,3
STAT,1910,41,20-24,1951,0.01712098374218176
SIM,1847,78,na,1925,513
STAT,1832,42,45-49,1874,1.2297437472450006
SIM,1873,30,na,1903,2407
SIM,1890,58,na,1948,2532
SIM,1916,16,15-19,1932,11
STAT,1889,41,30-34,1930,1.4553023371001725
STAT,1839,45,35-39,1884,0.10099862500975985
STAT,1765,111,na,1876,4.2025230831700254E-4
STAT,1844,30,45-49,1874,1.6498480405361207
SIM,1843,64,na,1907,1311
SIM,1822,70,na,1892,719
SIM,1846,37,40-44,1883,9
STAT,1830,53,na,1883,1385.8303355150745
SIM,1874,22,45-49,1896,1
SIM,1892,30,50-100,1922,1
STAT,1924,31,45-49,1955,1.8741200753242369
STAT,1820,48,35-39,1868,0.2516471643655649
STAT,1881,20,20-24,1901,68.37236437583981
SIM,1838,27,40-44,1865,2
SIM,1844,29,30-34,1873,31
STAT,1842,43,50-100,1885,0.8462352087717209
STAT,1872,25,25-29,1897,43.54365074987724
SIM,1852,30,45-49,1882,2
SIM,1859,49,50-100,1908,1
STAT,1836,21,20-24,1857,57.022350819111125
STAT,1838,37,40-44,1875,3.8810545620241608
STAT,1880,30,30-34,1910,18.867786671501666
STAT,1916,21,45-49,1937,1.206808650093732
STAT,1821,49,na,1870,1334.1037612943646
STAT,1873,43,45-49,1916,1.5367177992849634
STAT,1852,32,45-49,1884,1.4545295939501781
SIM,1913,20,30-34,1933,40
STAT,1888,40,25-29,1928,0.7822688793136204
STAT,1831,30,35-39,1861,9.516568973698288
SIM,1838,52,30-34,1890,1
STAT,1897,43,30-34,1940,0.10811164142677365
STAT,1876,82,na,1958,596.0110493272564
SIM,1895,20,15-19,1915,4
STAT,1906,40,40-44,1946,0.23426468590826088
SIM,1911,15,25-29,1926,14
STAT,1929,24,35-39,1953,12.06861505968046
STAT,1861,49,35-39,1910,0.1155514791831384
SIM,1850,43,50-100,1893,1
SIM,1863,52,na,1915,1813
STAT,1866,22,45-49,1888,0.6615164128459785
STAT,1922,23,35-39,1945,10.983688530209541
STAT,1876,41,20-24,1917,0.16805529959152185
STAT,1856,45,35-39,1901,0.11323020357731992
SIM,1901,43,na,1944,3492
STAT,1817,71,na,1888,700.6522623134204
STAT,1851,22,50-100,1873,0.40176802471283557
SIM,1863,30,20-24,1893,6
STAT,1826,53,25-29,1879,0.0026199772035542875
STAT,1898,49,30-34,1947,0.0737552692259832
STAT,1845,25,50-100,1870,0.6172034028719147
SIM,1850,29,30-34,1879,25
STAT,1780,77,na,1857,297.2387860005097
STAT,1862,31,na,1893,2080.7412111268104
SIM,1932,31,45-49,1963,4
STAT,1831,103,na,1934,0.09670346182690556
STAT,1918,23,na,1941,4006.7920454396635
STAT,1939,33,na,1972,3934.1358210040457
SIM,1854,35,25-29,1889,6
STAT,1880,38,40-44,1918,4.66953629361835
SIM,1832,40,45-49,1872,8
STAT,1820,37,30-34,1857,12.965265532748294
STAT,1848,34,45-49,1882,1.40895249729745
STAT,1893,44,25-29,1937,0.05693051764005586
STAT,1876,23,na,1899,2483.7132345604577
SIM,1887,38,40-44,1925,4
STAT,1825,47,na,1872,1545.638010803552
STAT,1840,52,45-49,1892,0.01038750936688486
STAT,1821,33,na,1854,1461.5674930299188
STAT,1905,20,30-34,1925,26.400214930384337
STAT,1809,50,20-24,1859,0.0032627099577552097
SIM,1848,24,45-49,1872,1
STAT,1832,50,45-49,1882,0.01054573953850472
STAT,1884,58,na,1942,1995.9547542916757
STAT,1819,48,50-100,1867,0.47955192842403255
STAT,1858,50,40-44,1908,0.00863934132966879
STAT,1866,16,50-100,1882,0.04759815317057581
STAT,1823,99,na,1922,1.0540371163906823
SIM,1900,36,30-34,1936,2
STAT,1931,29,20-24,1960,24.010822598268476
STAT,1794,69,na,1863,718.4984565917697
STAT,1908,40,50-100,1948,0.11209098306488559
SIM,1856,40,30-34,1896,4
STAT,1879,38,40-44,1917,4.644818876469037
STAT,1849,27,15-19,1876,0.4175436174111193
SIM,1909,22,30-34,1931,33
STAT,1892,24,15-19,1916,4.191600932422026
SIM,1860,32,45-49,1892,2
SIM,1849,17,15-19,1866,7
SIM,1871,32,20-24,1903,3
SIM,1945,23,30-34,1968,2
SIM,1872,23,25-29,1895,64
STAT,1824,40,45-49,1864,1.9195743776922332
STAT,1859,38,15-19,1897,0.045523041909182584
SIM,1825,29,20-24,1854,9
STAT,1848,11,na,1859,2310.879890974891
STAT,1924,39,30-34,1963,2.187994300440428
STAT,1937,23,30-34,1960,28.539373417933433
SIM,1932,39,30-34,1971,3
STAT,1869,51,30-34,1920,0.005890767055786051
SIM,1782,72,na,1854,499
SIM,1786,86,na,1872,44
SIM,1825,51,na,1876,1370
SIM,1829,65,na,1894,900
SIM,1833,86,na,1919,126
SIM,1926,34,25-29,1960,21
STAT,1913,30,30-34,1943,16.119783694171208
SIM,1950,17,na,1967,4310
STAT,1887,36,25-29,1923,3.3071476610168773
STAT,1925,41,na,1966,4594.07394650157
STAT,1864,97,na,1961,11.306134610834519
STAT,1874,24,45-49,1898,0.7217567632679968
STAT,1891,31,45-49,1922,2.2114444127457475
STAT,1905,53,na,1958,3178.231007929317
STAT,1816,39,30-34,1855,14.671308333391613
SIM,1865,59,na,1924,1840
STAT,1848,40,30-34,1888,0.9157413001259089
SIM,1861,45,na,1906,2419
STAT,1826,42,45-49,1868,1.2265234874075939
SIM,1861,39,35-39,1900,13
SIM,1883,29,na,1912,2414
STAT,1918,23,20-24,1941,122.00400150207165
STAT,1862,5,na,1867,2500.9191008811035
STAT,1847,24,50-100,1871,0.38425935606656125
SIM,1831,79,na,1910,597
SIM,1872,61,na,1933,1979
STAT,1860,17,30-34,1877,1.521539390298683
SIM,1870,19,30-34,1889,5
SIM,1851,19,20-24,1870,21
STAT,1862,19,30-34,1881,1.4256153567622978
SIM,1810,85,na,1895,253
SIM,1960,8,na,1968,5241
SIM,1856,34,45-49,1890,6
STAT,1866,34,15-19,1900,0.13285410870236303
STAT,1795,103,na,1898,0.02567489542894137
STAT,1888,15,35-39,1903,0.6648289185745009
SIM,1830,31,20-24,1861,3
STAT,1825,33,15-19,1858,0.2612362382593931
STAT,1833,34,na,1867,1794.0928024114676
STAT,1852,43,25-29,1895,0.5135857343689091
SIM,1921,30,30-34,1951,25
STAT,1837,48,na,1885,1537.2841821506236
STAT,1878,33,50-100,1911,0.9688198830251474
STAT,1943,20,15-19,1963,5.782182295944894
SIM,1926,23,20-24,1949,158
SIM,1898,20,40-44,1918,3
STAT,1829,40,20-24,1869,0.1369505560343765
SIM,1934,33,20-24,1967,2
STAT,1843,19,20-24,1862,18.07463561858299
STAT,1846,35,25-29,1881,2.1952699373037805
SIM,1937,24,35-39,1961,14
SIM,1904,25,35-39,1929,26
STAT,1896,31,20-24,1927,3.6568589318891487
SIM,1831,26,40-44,1857,5
STAT,1833,43,15-19,1876,0.010930101318985475
STAT,1874,33,35-39,1907,10.503453228458572
SIM,1948,15,20-24,1963,173
STAT,1868,27,25-29,1895,41.217123353720645
STAT,1937,34,35-39,1971,9.210220244767253
SIM,1881,43,45-49,1924,2
STAT,1854,45,25-29,1899,0.04452392838779446
STAT,1870,20,45-49,1890,0.6995620214483899
SIM,1949,20,na,1969,4313
STAT,1830,51,25-29,1881,0.0026366999912961803
STAT,1901,27,50-100,1928,0.9125718379829004
STAT,1842,29,30-34,1871,24.0716328510444
STAT,1879,17,35-39,1896,0.5851187391419898
STAT,1830,69,na,1899,928.3564179264224
STAT,1867,46,25-29,1913,0.05532197064253621
STAT,1900,34,15-19,1934,0.19963335259592174
SIM,1815,42,35-39,1857,2
STAT,1898,41,50-100,1939,0.1016649196418145
SIM,1842,19,30-34,1861,2
STAT,1924,20,40-44,1944,4.072036355923692
STAT,1893,33,45-49,1926,2.2472377908367784
SIM,1871,23,30-34,1894,26
SIM,1940,30,40-44,1970,10
STAT,1872,31,35-39,1903,10.396526437386807
SIM,1882,33,35-39,1915,2
STAT,1806,52,45-49,1858,0.04717847673440376
SIM,1906,41,45-49,1947,1
STAT,1862,18,50-100,1880,0.04843930254599111
STAT,1867,14,na,1881,2545.212641249003
STAT,1872,39,45-49,1911,2.017686342971938
STAT,1948,24,45-49,1972,1.3171902206722317
STAT,1890,17,40-44,1907,0.22814172647597689
STAT,1881,53,45-49,1934,0.014083451194133297
SIM,1859,32,20-24,1891,3
STAT,1868,36,15-19,1904,0.05497851865186104
SIM,1932,20,40-44,1952,7
STAT,1880,49,45-49,1929,0.24771656273062562
STAT,1895,26,50-100,1921,0.8543594808161363
STAT,1852,96,na,1948,6.917425375596791
STAT,1841,31,30-34,1872,15.804410802749429
SIM,1873,46,na,1919,2286
STAT,1883,8,na,1891,2602.05593484623
SIM,1880,39,45-49,1919,1
SIM,1813,50,na,1863,1323
STAT,1849,38,30-34,1887,4.190198073131046
STAT,1906,38,na,1944,3508.3782344600704
STAT,1863,23,30-34,1886,16.133066295528206
STAT,1932,30,40-44,1962,5.311322333539619
SIM,1888,76,na,1964,1331
STAT,1905,39,20-24,1944,0.24266929317482494
SIM,1792,71,na,1863,533
SIM,1796,85,na,1881,56
SIM,1885,31,na,1916,2430
SIM,1918,21,20-24,1939,184
STAT,1901,38,25-29,1939,0.8821495210885744
STAT,1855,37,40-44,1892,3.3934326417317497
STAT,1844,23,20-24,1867,66.19599929103839
STAT,1893,38,15-19,1931,0.07231177329345255
STAT,1872,22,20-24,1894,70.45817714747764
STAT,1886,40,15-19,1926,0.0150624887947201
STAT,1895,41,30-34,1936,0.10674249466170102
SIM,1852,33,25-29,1885,10
SIM,1863,47,50-100,1910,1
SIM,1939,25,20-24,1964,23
SIM,1788,66,na,1854,893
STAT,1762,108,na,1870,0.004691852312795485
SIM,1852,52,na,1904,1774
SIM,1902,48,35-39,1950,1
SIM,1951,20,15-19,1971,11
SIM,1948,19,na,1967,4169
SIM,1904,40,na,1944,3666
STAT,1883,20,30-34,1903,17.935860594709318
STAT,1850,30,45-49,1880,1.5395344668392723
SIM,1828,36,35-39,1864,3
SIM,1908,54,na,1962,3491
STAT,1910,11,na,1921,3997.1351618305594
SIM,1854,41,35-39,1895,3
STAT,1854,44,na,1898,1745.0409508848122
STAT,1808,52,50-100,1860,0.036042215443681386
STAT,1893,33,20-24,1926,3.483391705272306
SIM,1895,27,35-39,1922,23
STAT,1918,17,35-39,1935,0.9350889889877838
STAT,1887,27,35-39,1914,11.03001225983581
STAT,1830,104,na,1934,0.04219392198645294
STAT,1829,34,35-39,1863,9.068888957822278
STAT,1949,17,15-19,1966,53.850287332949875
SIM,1812,49,na,1861,1353
STAT,1860,24,50-100,1884,0.3429706516493575
STAT,1791,93,na,1884,6.348438637408646
STAT,1834,52,45-49,1886,0.010013832199202807
SIM,1850,37,30-34,1887,4
STAT,1853,17,15-19,1870,5.9859401005449415
STAT,1867,6,na,1873,2684.1681598379564
SIM,1901,19,35-39,1920,1
STAT,1835,40,20-24,1875,0.14551995856854041
STAT,1839,42,30-34,1881,0.8362484274902445
STAT,1901,15,15-19,1916,8.505441295074364
SIM,1833,70,na,1903,907
SIM,1891,20,30-34,1911,34
SIM,1861,17,15-19,1878,7
SIM,1828,59,na,1887,1252
STAT,1850,30,na,1880,1913.360241524084
STAT,1899,29,30-34,1928,34.92692463122978
SIM,1881,65,na,1946,1602
SIM,1889,45,na,1934,2969
SIM,1865,33,35-39,1898,15
SIM,1928,24,50-100,1952,5
SIM,1954,15,45-49,1969,1
STAT,1894,17,25-29,1911,7.435984261481805
STAT,1835,45,15-19,1880,3.5431730398019344E-4
STAT,1842,38,20-24,1880,0.7018026277289927
SIM,1840,67,na,1907,1072
SIM,1882,22,30-34,1904,30
SIM,1803,72,na,1875,415
SIM,1840,48,50-100,1888,1
STAT,1826,42,20-24,1868,0.13015012995291153
SIM,1852,23,20-24,1875,71
STAT,1774,100,na,1874,0.15058214487826288
STAT,1863,80,na,1943,553.3045175836097
STAT,1826,47,15-19,1873,3.1256188073379237E-4
STAT,1835,48,30-34,1883,0.07508575614774778
STAT,1891,28,na,1919,3003.564039590936
STAT,1806,71,na,1877,646.6632063679426
STAT,1870,52,30-34,1922,0.0059046538298153685
STAT,1864,23,25-29,1887,52.38267495532248
STAT,1795,70,na,1865,592.1952041149173
STAT,1857,33,35-39,1890,8.034376053650712
STAT,1865,32,30-34,1897,16.166001744912595
SIM,1836,36,50-100,1872,2
STAT,1799,84,na,1883,109.3202293485277
SIM,1847,42,50-100,1889,2
SIM,1850,38,20-24,1888,4
STAT,1882,33,45-49,1915,1.725830597474277
STAT,1910,16,30-34,1926,2.469320489939855
STAT,1862,105,na,1967,0.19747531715134778
SIM,1893,50,na,1943,2884
STAT,1945,1,na,1946,4601.526953320548
SIM,1897,64,na,1961,2446
STAT,1815,42,45-49,1857,4.728117605493933
SIM,1902,25,25-29,1927,8
SIM,1835,30,45-49,1865,5
SIM,1860,32,20-24,1892,4
STAT,1927,15,35-39,1942,5.346876850260094
SIM,1824,34,na,1858,1652
SIM,1871,30,30-34,1901,21
STAT,1843,17,30-34,1860,1.6442984589031657
STAT,1874,43,na,1917,2389.909377399691
STAT,1855,24,35-39,1879,5.209133905764248
STAT,1940,19,20-24,1959,140.33738672331395
STAT,1829,47,40-44,1876,0.13855074382498647
STAT,1894,21,45-49,1915,0.917800646119723
STAT,1887,42,35-39,1929,2.067453180234189
SIM,1907,21,45-49,1928,5
STAT,1797,107,na,1904,0.0011875501714267672
STAT,1853,16,25-29,1869,5.749664128744076
STAT,1878,57,na,1935,2133.949243294085
STAT,1862,17,40-44,1879,0.18191156593753002
STAT,1920,49,15-19,1969,4.131113475390195E-4
STAT,1861,22,45-49,1883,0.6038903036408413
STAT,1854,52,25-29,1906,0.0026964644279750807
STAT,1939,31,40-44,1970,4.07557842445422
STAT,1842,37,30-34,1879,4.902844727815848
SIM,1844,24,25-29,1868,68
SIM,1875,27,50-100,1902,1
SIM,1906,31,50-100,1937,1
SIM,1879,24,na,1903,2859
STAT,1847,19,40-44,1866,0.17592566034039844
STAT,1879,50,25-29,1929,0.0038313208560371596
SIM,1855,19,40-44,1874,1
SIM,1894,16,15-19,1910,6
STAT,1909,24,30-34,1933,27.072612221766686
SIM,1893,34,25-29,1927,5
STAT,1946,20,40-44,1966,3.8201307119633334
SIM,1855,33,na,1888,1819
STAT,1870,66,na,1936,1634.5236785273785
SIM,1824,66,na,1890,806
STAT,1885,34,25-29,1919,10.335453318053007
STAT,1823,51,30-34,1874,0.008788496197580249
STAT,1861,35,15-19,1896,0.04778607275580058
SIM,1845,43,35-39,1888,5
STAT,1933,26,15-19,1959,0.9563698508402131
SIM,1888,18,40-44,1906,1
STAT,1924,9,na,1933,4836.562081279853
STAT,1876,49,30-34,1925,0.09984286766285423
SIM,1862,6,na,1868,2605
STAT,1910,48,40-44,1958,0.1496119910585414
STAT,1837,43,35-39,1880,1.4065315297411678
STAT,1831,38,45-49,1869,1.7326467788079014
STAT,1868,31,na,1899,2334.6455830972113
STAT,1836,24,25-29,1860,46.35546077340139
STAT,1876,30,40-44,1906,4.6051462373465615
STAT,1853,39,35-39,1892,5.870946154732792
SIM,1914,27,20-24,1941,19
STAT,1887,20,15-19,1907,3.7937257875251515
STAT,1827,30,45-49,1857,2.9869946292260203
STAT,1842,51,40-44,1893,0.008295332242783093
STAT,1858,10,na,1868,2284.2734435924385
STAT,1815,48,na,1863,1550.0505038044532
SIM,1870,81,na,1951,427
STAT,1854,40,30-34,1894,0.888782438515696
SIM,1863,24,35-39,1887,8
STAT,1816,70,na,1886,719.4461494073965
STAT,1841,32,45-49,1873,1.5621894685635354
STAT,1853,65,na,1918,1417.0313489060254
SIM,1903,27,45-49,1930,1
STAT,1856,50,30-34,1906,0.004835323711236994
SIM,1874,95,na,1969,36
SIM,1866,76,na,1942,1004
STAT,1827,29,40-44,1856,5.788068975698414
STAT,1818,43,25-29,1861,1.579096008885243
SIM,1884,30,40-44,1914,3
STAT,1924,35,na,1959,4533.991822525016
SIM,1891,64,na,1955,2184
STAT,1899,19,na,1918,3509.274246608439
STAT,1821,53,25-29,1874,0.005254200302550371
SIM,1933,21,na,1954,4839
SIM,1917,24,30-34,1941,44
STAT,1855,30,20-24,1885,2.1783279051492497
STAT,1949,16,25-29,1965,51.43446134833682
STAT,1920,42,na,1962,4185.871063341451
SIM,1867,33,45-49,1900,5
STAT,1875,53,45-49,1928,0.01495068569163149
STAT,1919,46,35-39,1965,0.14305944612256358
STAT,1867,48,15-19,1915,3.7827879249216555E-4
SIM,1835,29,40-44,1864,5
STAT,1876,48,40-44,1924,0.17808104271236724
SIM,1846,22,50-100,1868,1
SIM,1830,40,50-100,1870,2
STAT,1816,86,na,1902,98.4494381448123
STAT,1852,32,20-24,1884,2.254632929055771
STAT,1882,46,15-19,1928,3.9867911556191164E-4
STAT,1906,27,20-24,1933,17.419395508273738
STAT,1917,30,15-19,1947,0.13842584843043704
STAT,1843,49,40-44,1892,0.13531952150406398
STAT,1838,33,25-29,1871,9.25494858560119
STAT,1853,16,50-100,1869,0.049708901743223094
STAT,1936,20,na,1956,3563.377436371628
STAT,1912,19,45-49,1931,0.1024931687160527
STAT,1836,26,na,1862,1754.8730195681076
STAT,1862,51,20-24,1913,6.438752473075144E-4
STAT,1841,45,15-19,1886,3.0437990142118804E-4
STAT,1864,22,50-100,1886,0.3758477564822808
STAT,1883,39,20-24,1922,0.7638273519551868
STAT,1916,21,na,1937,3916.7514102435384
SIM,1873,8,na,1881,2650
STAT,1926,41,20-24,1967,0.022242477998604016
STAT,1946,21,30-34,1967,32.642511301846156
SIM,1885,28,40-44,1913,4
SIM,1876,27,25-29,1903,47
STAT,1857,48,30-34,1905,0.07615334328680536
STAT,1806,48,50-100,1854,0.862471856264303
SIM,1864,17,40-44,1881,2
SIM,1818,37,40-44,1855,5
SIM,1838,58,na,1896,1236
STAT,1836,85,na,1921,170.63074951325146
STAT,1863,38,40-44,1901,3.8960442248800558
SIM,1918,38,45-49,1956,3
STAT,1937,20,15-19,1957,5.291190268131829
SIM,1846,33,25-29,1879,21
STAT,1920,15,25-29,1935,10.000681639034772
STAT,1863,26,35-39,1889,8.692915801808915
STAT,1880,27,50-100,1907,0.6857691835961515
STAT,1898,34,35-39,1932,13.851205883232582
SIM,1923,43,na,1966,4234
STAT,1916,49,25-29,1965,0.05519650676457453
SIM,1948,15,45-49,1963,3
STAT,1935,18,50-100,1953,0.5209503874192345
SIM,1903,39,na,1942,3315
STAT,1920,38,35-39,1958,2.6998016652353214
STAT,1856,17,40-44,1873,0.1731905125124727
SIM,1852,84,na,1936,193
STAT,1941,31,45-49,1972,1.68649445294387
SIM,1885,18,15-19,1903,6
SIM,1871,38,40-44,1909,2
STAT,1897,12,na,1909,3522.6369350902273
SIM,1881,52,35-39,1933,1
STAT,1845,62,na,1907,1428.092138851081
STAT,1859,34,20-24,1893,2.1833678555632132
STAT,1849,76,na,1925,735.5268116614624
SIM,1868,83,na,1951,376
SIM,1935,15,35-39,1950,5
STAT,1885,0,na,1885,3569.284436345345
SIM,1867,44,25-29,1911,2
SIM,1830,34,25-29,1864,2
SIM,1938,30,25-29,1968,4
STAT,1839,17,40-44,1856,0.16512665451668965
STAT,1853,81,na,1934,453.4303273312232
STAT,1897,44,45-49,1941,0.13985045334389154
STAT,1921,42,35-39,1963,0.23143883582656158
STAT,1953,18,50-100,1971,0.46216435145594703
SIM,1918,15,35-39,1933,1
STAT,1845,99,na,1944,1.479767212054691
SIM,1880,16,35-39,1896,1
STAT,1861,37,40-44,1898,3.6900958458416073
STAT,1852,37,15-19,1889,0.045483671797445904
STAT,1835,47,40-44,1882,0.1345085901027883
SIM,1891,80,na,1971,1266
SIM,1839,43,35-39,1882,4
STAT,1891,33,50-100,1924,1.1523327920595647
STAT,1822,32,35-39,1854,31.903315776140467
SIM,1919,33,30-34,1952,25
STAT,1866,39,20-24,1905,0.7180455357833027
SIM,1921,36,na,1957,4914
STAT,1867,43,20-24,1910,0.15100153801882218
STAT,1925,27,30-34,1952,47.21617326181399
SIM,1864,40,40-44,1904,8
STAT,1801,56,na,1857,1020.5262980274528
SIM,1892,18,30-34,1910,5
STAT,1864,52,30-34,1916,0.005370708300358894
SIM,1945,20,15-19,1965,6
STAT,1817,54,50-100,1871,0.031082047464074707
STAT,1877,28,40-44,1905,3.158407251670599
STAT,1884,18,30-34,1902,1.6044500169890896
STAT,1865,50,na,1915,2022.2732746831148
STAT,1907,36,15-19,1943,0.018242473639742924
SIM,1935,1,na,1936,5729
STAT,1901,18,30-34,1919,2.2678236461943713
SIM,1933,27,30-34,1960,63
SIM,1848,21,40-44,1869,1
STAT,1859,44,25-29,1903,0.5161130644547266
STAT,1937,17,50-100,1954,0.3717767151776185
STAT,1804,85,na,1889,92.50639268977098
STAT,1846,32,20-24,1878,2.284343011367682
STAT,1873,52,35-39,1925,0.008856515758094381
SIM,1815,45,50-100,1860,1
SIM,1890,35,35-39,1925,9
SIM,1835,49,35-39,1884,1
SIM,1958,1,na,1959,5150
STAT,1862,50,30-34,1912,0.005243477666673406
SIM,1934,36,25-29,1970,2
SIM,1865,46,50-100,1911,1
SIM,1869,34,30-34,1903,17
SIM,1859,35,25-29,1894,5
SIM,1890,30,40-44,1920,10
STAT,1883,38,30-34,1921,5.308262926919373
STAT,1883,52,40-44,1935,0.010481715088968849
SIM,1871,44,na,1915,2084
STAT,1856,43,45-49,1899,1.1898568902711713
SIM,1936,15,50-100,1951,2
STAT,1930,20,na,1950,4799.8241501106795
STAT,1946,15,45-49,1961,0.5655919615829981
SIM,1917,36,25-29,1953,1
STAT,1846,49,45-49,1895,0.16524497410532266
SIM,1871,26,35-39,1897,14
SIM,1907,37,30-34,1944,3
STAT,1892,29,20-24,1921,14.892183073286237
STAT,1900,22,na,1922,3344.059860434299
SIM,1854,26,35-39,1880,10
STAT,1920,47,50-100,1967,0.2551460962950289
STAT,1904,36,na,1940,3488.4839277945257
STAT,1882,30,40-44,1912,4.344807728395698
STAT,1893,32,50-100,1925,1.1857559423803024
SIM,1835,26,25-29,1861,43
SIM,1894,18,40-44,1912,1
STAT,1808,67,na,1875,684.3125141627509
STAT,1827,49,35-39,1876,0.15304443502095375
STAT,1846,41,35-39,1887,1.327528587111094
STAT,1902,42,25-29,1944,0.06407410691048586
SIM,1890,40,30-34,1930,2
STAT,1867,20,35-39,1887,5.693310334618055
SIM,1819,66,na,1885,883
STAT,1825,63,na,1888,1091.8699485842617
SIM,1854,48,na,1902,1903
STAT,1816,47,30-34,1863,0.19905598575338895
SIM,1843,48,na,1891,1684
SIM,1902,44,na,1946,3336
STAT,1816,48,20-24,1864,0.024280369828879926
SIM,1876,31,45-49,1907,3
STAT,1886,18,40-44,1904,0.1969834832219644
STAT,1926,36,25-29,1962,1.2286940696073818
STAT,1879,34,25-29,1913,10.828740388249766
SIM,1815,52,na,1867,1325
SIM,1823,71,na,1894,738
SIM,1899,23,na,1922,3235
SIM,1928,30,40-44,1958,7
STAT,1825,38,20-24,1863,1.142475234329544
SIM,1918,16,25-29,1934,16
STAT,1894,18,15-19,1912,7.767022541617505
STAT,1882,40,30-34,1922,1.1541581505723364
STAT,1861,38,30-34,1899,4.470381191956586
STAT,1924,48,20-24,1972,0.013385661797915387
SIM,1854,32,20-24,1886,4
SIM,1919,38,na,1957,4203
STAT,1878,44,35-39,1922,1.896878311797324
STAT,1911,32,25-29,1943,9.180462561601388
SIM,1867,39,na,1906,2135
STAT,1817,44,na,1861,1452.3670697519447
SIM,1915,24,na,1939,4141
STAT,1902,49,45-49,1951,0.18751900138750668
STAT,1827,27,15-19,1854,1.513557936799684
STAT,1861,30,20-24,1891,2.2969083265330505
STAT,1836,27,40-44,1863,2.412827929619692
SIM,1891,38,30-34,1929,4
STAT,1843,47,15-19,1890,3.2140351462534483E-4
SIM,1860,42,50-100,1902,3
STAT,1846,26,35-39,1872,8.407854714305982
SIM,1871,35,25-29,1906,1
STAT,1852,47,40-44,1899,0.137276014928078
STAT,1884,42,na,1926,2329.8221779034316
STAT,1935,19,na,1954,5103.937804156613
SIM,1829,29,40-44,1858,5
SIM,1919,17,na,1936,4245
SIM,1844,27,40-44,1871,4
SIM,1939,32,45-49,1971,3
STAT,1800,71,na,1871,739.85597911511
STAT,1863,104,na,1967,0.42658652199879765
STAT,1921,17,45-49,1938,0.5810478161215807
STAT,1929,21,30-34,1950,37.18235878672697
SIM,1832,38,50-100,1870,3
SIM,1835,27,15-19,1862,1
STAT,1907,23,45-49,1930,1.0412813579594946
SIM,1836,51,na,1887,1707
SIM,1886,44,35-39,1930,5
SIM,1937,21,30-34,1958,56
STAT,1828,53,35-39,1881,0.005801371517401591
SIM,1873,51,na,1924,2188
SIM,1901,16,30-34,1917,6
STAT,1846,84,na,1930,237.8946892338935
STAT,1883,23,35-39,1906,5.823064814374338
STAT,1904,40,30-34,1944,0.11790228664108766
SIM,1822,36,40-44,1858,6
STAT,1851,45,50-100,1896,0.2046443453555111
STAT,1878,46,25-29,1924,0.06133685997472832
STAT,1948,21,40-44,1969,3.940142997372734
STAT,1833,30,45-49,1863,1.5221848916208625
STAT,1950,17,50-100,1967,0.4519420384407696
STAT,1878,41,30-34,1919,1.2263119001203129
SIM,1939,28,25-29,1967,77
STAT,1885,39,30-34,1924,5.3697377698261475
STAT,1951,17,30-34,1968,14.80696585257157
SIM,1863,25,na,1888,2123
STAT,1840,28,45-49,1868,0.9890485337706686
STAT,1844,26,25-29,1870,40.41827657673503
STAT,1905,21,na,1926,3495.051607761301
SIM,1912,43,na,1955,3712
STAT,1927,21,20-24,1948,140.17015789548702
SIM,1864,49,50-100,1913,1
SIM,1828,33,30-34,1861,25
SIM,1847,62,na,1909,1265
STAT,1857,30,30-34,1887,14.290074979830663
STAT,1818,45,15-19,1863,9.373011882854317E-4
STAT,1866,24,na,1890,2211.5085778641114
SIM,1935,21,20-24,1956,154
STAT,1836,47,na,1883,1465.496717183822
STAT,1864,65,na,1929,1532.9351051103897
STAT,1909,36,25-29,1945,0.9550562048407233
STAT,1850,14,na,1864,2174.427287447243
STAT,1910,19,35-39,1929,0.8434634835259982
STAT,1827,70,na,1897,906.8339807690843
SIM,1846,24,35-39,1870,7
SIM,1900,37,20-24,1937,1
SIM,1923,41,45-49,1964,1
STAT,1829,41,35-39,1870,1.5403540263757098
SIM,1891,23,35-39,1914,10
STAT,1844,29,40-44,1873,2.800999145495989
SIM,1827,27,40-44,1854,7
STAT,1832,33,na,1865,1851.3365765444016
STAT,1934,30,15-19,1964,0.17912874252273212
SIM,1877,76,na,1953,805
SIM,1909,39,na,1948,3412
STAT,1821,50,20-24,1871,0.0011621068302996684
STAT,1864,20,20-24,1884,64.43649180292006
STAT,1930,32,35-39,1962,12.028257258783979
SIM,1841,30,45-49,1871,4
SIM,1875,10,na,1885,2666
STAT,1833,47,30-34,1880,0.07500378943737097
STAT,1912,33,50-100,1945,0.826429635351946
SIM,1830,37,40-44,1867,3
SIM,1832,48,na,1880,1545
STAT,1795,108,na,1903,3.276960954646011E-4
STAT,1923,42,45-49,1965,0.19847217429276112
SIM,1890,26,50-100,1916,3
SIM,1875,20,35-39,1895,7
STAT,1843,42,20-24,1885,0.13200202983983544
STAT,1865,46,15-19,1911,3.714123433163863E-4
STAT,1941,28,15-19,1969,0.744686807009239
SIM,1852,26,25-29,1878,47
SIM,1900,58,na,1958,2793
STAT,1856,49,50-100,1905,0.19257086648086044
SIM,1884,33,45-49,1917,1
STAT,1851,19,30-34,1870,1.5799848450139693
STAT,1903,29,45-49,1932,1.5986144986822828
SIM,1911,29,45-49,1940,3
SIM,1829,81,na,1910,188
STAT,1876,33,45-49,1909,1.8292414254176645
SIM,1905,25,na,1930,3447
STAT,1856,41,40-44,1897,1.809378095027028
SIM,1832,31,30-34,1863,21
SIM,1837,49,45-49,1886,1
SIM,1869,43,20-24,1912,1
STAT,1881,27,40-44,1908,2.954456984659953
STAT,1835,43,25-29,1878,0.5662203717239482
SIM,1824,32,35-39,1856,14
STAT,1822,37,40-44,1859,8.298381391216935
STAT,1882,26,50-100,1908,0.6379572551822671
STAT,1895,44,35-39,1939,0.16511095020039954
SIM,1861,66,na,1927,1627
SIM,1852,30,20-24,1882,2
SIM,1952,19,na,1971,4416
STAT,1857,47,na,1904,1784.133964530328
STAT,1934,34,na,1968,5259.240234499963
STAT,1896,32,35-39,1928,13.644737296802536
SIM,1858,43,45-49,1901,2
STAT,1838,24,35-39,1862,5.483167781373126
STAT,1939,21,50-100,1960,0.6743385621406326
STAT,1861,31,50-100,1892,0.775522277863159
STAT,1915,41,45-49,1956,0.17122946616020773
SIM,1872,29,na,1901,2473
STAT,1948,17,45-49,1965,0.5832612931794795
SIM,1843,43,25-29,1886,4
SIM,1891,43,na,1934,2956
STAT,1870,16,25-29,1886,5.738852261768531
SIM,1850,22,35-39,1872,13
SIM,1906,10,na,1916,3857
STAT,1848,32,na,1880,1964.6332127381274
STAT,1822,34,25-29,1856,23.441202668233906
SIM,1872,20,20-24,1892,68
STAT,1860,50,20-24,1910,6.195636528488916E-4
SIM,1871,33,35-39,1904,15
SIM,1890,79,na,1969,1169
STAT,1864,19,40-44,1883,0.16961245310512285
STAT,1818,51,50-100,1869,0.033532691324578874
SIM,1826,39,40-44,1865,6
SIM,1895,57,na,1952,2753
SIM,1893,31,20-24,1924,6
STAT,1854,43,35-39,1897,1.3759031495991805
STAT,1911,30,20-24,1941,2.442230310327881
STAT,1897,42,40-44,1939,0.2127924740028281
SIM,1882,28,na,1910,2282
SIM,1889,22,40-44,1911,3
STAT,1908,15,25-29,1923,8.611597225632174
STAT,1868,31,45-49,1899,1.7060671015932176
SIM,1895,33,20-24,1928,2
STAT,1930,30,30-34,1960,20.760947436587927
STAT,1818,39,40-44,1857,13.122072516035113
STAT,1842,22,35-39,1864,5.771949471456753
SIM,1811,86,na,1897,27
STAT,1785,92,na,1877,11.502863655800384
STAT,1887,33,20-24,1920,3.076917082229367
SIM,1947,21,50-100,1968,1
SIM,1808,82,na,1890,139
STAT,1834,99,na,1933,1.2727118617414472
STAT,1904,42,35-39,1946,0.1836234926291492
STAT,1874,31,45-49,1905,1.8237212200535147
SIM,1894,15,25-29,1909,15
STAT,1860,51,na,1911,1790.7347801306953
SIM,1858,40,40-44,1898,3
STAT,1866,27,15-19,1893,0.4269205620676673
SIM,1819,82,na,1901,206
SIM,1911,38,35-39,1949,5
SIM,1849,30,35-39,1879,1
STAT,1818,48,30-34,1866,0.21642045181319794
STAT,1910,34,50-100,1944,0.8061209667454273
STAT,1898,45,15-19,1943,3.1437597533844216E-4
STAT,1832,51,35-39,1883,0.0061332617318412596
SIM,1843,44,50-100,1887,1
SIM,1877,26,50-100,1903,2
SIM,1893,4,na,1897,3439
STAT,1936,28,45-49,1964,1.685517569666281
SIM,1868,24,na,1892,2320
SIM,1873,32,30-34,1905,21
STAT,1886,24,50-100,1910,0.4375804319818517
SIM,1864,10,na,1874,2546
SIM,1950,7,na,1957,4744
SIM,1887,75,na,1962,1401
STAT,1840,20,35-39,1860,5.41765050935325
SIM,1911,58,na,1969,3355
STAT,1818,40,20-24,1858,0.4418261730621591
STAT,1844,35,15-19,1879,0.05159135013086075
SIM,1815,40,45-49,1855,4
STAT,1885,31,20-24,1916,2.762358669502984
SIM,1895,24,30-34,1919,34
STAT,1886,15,25-29,1901,6.147431725910777
STAT,1887,24,30-34,1911,20.234347056365653
SIM,1893,39,30-34,1932,9
STAT,1846,23,30-34,1869,15.604025165048151
STAT,1942,3,na,1945,4293.231073350542
STAT,1855,33,25-29,1888,8.001094209343615
SIM,1856,41,45-49,1897,6
SIM,1912,42,35-39,1954,1
STAT,1861,14,na,1875,2292.026978602897
SIM,1799,66,na,1865,972
STAT,1897,41,40-44,1938,0.2140188017367799
SIM,1899,60,na,1959,2767
SIM,1859,38,40-44,1897,5
SIM,1882,31,45-49,1913,2
STAT,1840,15,na,1855,2164.0428410612267
STAT,1810,49,na,1859,1216.9312731824355
STAT,1835,32,45-49,1867,1.6548237270811286
SIM,1915,39,30-34,1954,3
SIM,1859,47,na,1906,2117
SIM,1917,27,35-39,1944,19
STAT,1954,15,50-100,1969,0.47267488833351595
STAT,1820,41,15-19,1861,0.028253874155498192
STAT,1946,24,35-39,1970,10.683212133584382
SIM,1878,61,na,1939,2099
SIM,1904,48,45-49,1952,1
STAT,1923,40,40-44,1963,0.2991085151294125
SIM,1920,16,40-44,1936,2
SIM,1861,20,45-49,1881,2
STAT,1763,107,na,1870,0.0027500197700676336
STAT,1881,21,35-39,1902,5.772778190567561
STAT,1850,21,30-34,1871,16.197865993725063
SIM,1940,17,20-24,1957,133
STAT,1837,48,40-44,1885,0.11698155645669006
STAT,1903,38,35-39,1941,2.202881155810261
STAT,1909,3,na,1912,4043.341773562031
STAT,1932,17,20-24,1949,183.08048584262497
STAT,1780,93,na,1873,6.1850993092039985
STAT,1915,38,15-19,1953,0.019697734867485734
STAT,1892,17,15-19,1909,7.58769043395348
STAT,1957,15,20-24,1972,182.3955427964076
STAT,1859,41,20-24,1900,0.12997280050698315
SIM,1876,24,20-24,1900,78
STAT,1910,43,na,1953,3558.3857736045543
STAT,1914,57,na,1971,3554.2211537826233
SIM,1844,70,na,1914,1023
SIM,1933,37,50-100,1970,1
STAT,1841,30,40-44,1871,3.9665389788857444
STAT,1907,39,30-34,1946,1.7057410282435228
STAT,1912,16,40-44,1928,0.28923689048385526
STAT,1875,50,40-44,1925,0.011180960034369756
SIM,1822,38,45-49,1860,2
SIM,1833,29,30-34,1862,40
SIM,1909,34,25-29,1943,13
STAT,1870,19,40-44,1889,0.18197718302660537
SIM,1837,63,na,1900,1100
SIM,1848,84,na,1932,273
SIM,1859,26,50-100,1885,1
SIM,1864,43,45-49,1907,4
STAT,1862,54,25-29,1916,0.002991299322087184
SIM,1867,49,30-34,1916,1
STAT,1896,38,40-44,1934,5.868789207576816
SIM,1827,85,na,1912,94
STAT,1946,19,na,1965,4162.442260338959
STAT,1968,1,na,1969,5016.134823955529
SIM,1854,23,30-34,1877,27
STAT,1909,27,35-39,1936,14.63342669733797
SIM,1868,22,20-24,1890,3
SIM,1839,40,30-34,1879,1
SIM,1929,16,na,1945,5349
STAT,1900,30,45-49,1930,2.4854963960587937
SIM,1878,42,35-39,1920,3
STAT,1852,19,50-100,1871,0.04717431292924529
STAT,1914,29,20-24,1943,18.640971607713126
SIM,1908,2,na,1910,4296
STAT,1829,77,na,1906,574.8932500830485
STAT,1838,30,20-24,1868,2.5196944614392343
STAT,1842,33,15-19,1875,0.13351468230830935
STAT,1881,29,45-49,1910,1.087240231998281
STAT,1915,4,na,1919,4296.606991825382
STAT,1858,28,30-34,1886,20.705343759802005
SIM,1768,89,na,1857,17
SIM,1908,17,na,1925,4065
STAT,1898,31,30-34,1929,24.185028510562393
STAT,1830,37,na,1867,1703.2111887332112
STAT,1832,52,35-39,1884,0.006012982257576041
STAT,1859,46,15-19,1905,3.268109609974244E-4
STAT,1863,35,25-29,1898,2.5997608383751376
STAT,1883,57,na,1940,2011.571171161243
SIM,1890,33,45-49,1923,4
STAT,1916,17,25-29,1933,9.382511554158611
SIM,1924,17,25-29,1941,3
SIM,1899,44,45-49,1943,1
STAT,1845,19,30-34,1864,1.5555451692756794
SIM,1858,62,na,1920,1463
STAT,1880,42,25-29,1922,0.687563808946218
STAT,1898,25,45-49,1923,1.542113063277032
SIM,1931,40,40-44,1971,1
STAT,1820,36,40-44,1856,11.25991933711789
STAT,1860,41,45-49,1901,1.2443956446775464
SIM,1829,44,na,1873,1335
SIM,1837,47,40-44,1884,1
STAT,1926,42,na,1968,4670.796318146952
SIM,1957,0,na,1957,5615
STAT,1944,28,40-44,1972,5.137267200303678
STAT,1837,40,30-34,1877,0.9279837929672825
STAT,1853,20,45-49,1873,0.7008799794663747
SIM,1869,37,35-39,1906,7
SIM,1894,13,na,1907,3490
STAT,1840,51,30-34,1891,0.004303937045921614
STAT,1813,51,25-29,1864,0.00867316935120231
STAT,1935,23,20-24,1958,154.3666969906229
SIM,1941,29,30-34,1970,52
STAT,1815,40,40-44,1855,7.9007660184089605
STAT,1859,49,30-34,1908,0.07721777981611445
STAT,1895,42,na,1937,3083.1090347780223
STAT,1903,49,15-19,1952,3.203733837796383E-4
SIM,1865,32,na,1897,2306
SIM,1902,33,50-100,1935,1
STAT,1811,71,na,1882,646.3984323844322
STAT,1899,56,na,1955,2849.306916140893
SIM,1887,25,35-39,1912,19
STAT,1889,42,45-49,1931,1.8836596337453657
STAT,1913,25,35-39,1938,15.364782842077867
STAT,1922,30,35-39,1952,10.620135964724343
SIM,1898,38,na,1936,3637
STAT,1851,16,15-19,1867,5.988040081735618
SIM,1863,39,45-49,1902,6
SIM,1956,9,na,1965,5511
STAT,1896,27,na,1923,3215.490313264067
SIM,1845,40,30-34,1885,1
STAT,1857,24,45-49,1881,0.575298113006347
SIM,1823,42,45-49,1865,1
SIM,1885,37,30-34,1922,8
STAT,1827,33,na,1860,1851.7772179373117
STAT,1892,13,na,1905,3296.7797966330445
SIM,1880,80,na,1960,565
STAT,1885,36,15-19,1921,0.05742800231478072
SIM,1839,70,na,1909,1051
SIM,1846,77,na,1923,565
SIM,1809,45,na,1854,1139
STAT,1824,31,30-34,1855,41.109129794053075
SIM,1842,63,na,1905,1327
STAT,1922,49,25-29,1971,0.06181530053807834
STAT,1877,37,30-34,1914,5.639151446287731
STAT,1844,77,na,1921,669.827315891582
SIM,1866,28,30-34,1894,31
SIM,1897,42,45-49,1939,1
SIM,1922,29,20-24,1951,23
SIM,1844,33,na,1877,2016
STAT,1891,22,30-34,1913,22.49687687391401
SIM,1848,47,na,1895,1794
SIM,1865,24,45-49,1889,6
SIM,1921,25,35-39,1946,28
STAT,1861,33,25-29,1894,8.597753871523134
STAT,1884,46,25-29,1930,0.05829973317997274
SIM,1880,22,20-24,1902,77
STAT,1840,26,40-44,1866,2.707157953467995
SIM,1885,79,na,1964,1023
SIM,1943,23,20-24,1966,149
STAT,1933,29,30-34,1962,53.00509560455746
STAT,1879,25,35-39,1904,10.358988299977556
STAT,1907,20,40-44,1927,3.1399335984442023
SIM,1904,3,na,1907,4104
SIM,1930,30,35-39,1960,23
STAT,1816,43,15-19,1859,0.03120306398420026
STAT,1836,51,50-100,1887,0.00970249935932782
STAT,1809,52,na,1861,1496.0293459057898
STAT,1837,45,25-29,1882,0.04090046955890619
SIM,1819,38,50-100,1857,4
STAT,1856,40,40-44,1896,1.8194030055878165
STAT,1920,20,50-100,1940,0.750955224461848
STAT,1935,17,35-39,1952,5.849972347667207
SIM,1887,31,20-24,1918,3
STAT,1765,106,na,1871,0.004348260801788545
STAT,1859,37,25-29,1896,2.3457250220058095
STAT,1825,29,30-34,1854,85.33066082170606
SIM,1829,25,25-29,1854,9
STAT,1902,46,40-44,1948,0.1393259695544809
SIM,1817,39,50-100,1856,1
STAT,1879,31,20-24,1910,2.8941996031301147
STAT,1883,34,15-19,1917,0.14132474472638065
STAT,1876,50,na,1926,2300.8052487404466
STAT,1821,51,20-24,1872,0.0011391628973506029
STAT,1888,16,25-29,1904,6.850973871183593
SIM,1865,30,30-34,1895,26
SIM,1888,43,30-34,1931,3
STAT,1846,25,na,1871,1898.6565680841418
STAT,1907,47,50-100,1954,0.2065480934158206
SIM,1843,32,45-49,1875,6
SIM,1896,16,25-29,1912,9
STAT,1924,43,15-19,1967,0.0018606930978227088
SIM,1943,17,35-39,1960,6
STAT,1881,13,na,1894,2543.1224337086123
STAT,1861,42,15-19,1903,0.011626915487171909
STAT,1911,37,30-34,1948,1.7956353028016105
SIM,1835,23,20-24,1858,71
STAT,1878,49,40-44,1927,0.1779949923574718
STAT,1868,28,15-19,1896,0.4405168446960556
SIM,1885,24,25-29,1909,99
SIM,1889,26,35-39,1915,16
STAT,1934,17,30-34,1951,16.81302020202344
STAT,1790,92,na,1882,12.121955890281576
SIM,1887,32,35-39,1919,2
SIM,1875,80,na,1955,681
SIM,1946,15,35-39,1961,6
STAT,1929,34,na,1963,4893.5268804667285
STAT,1810,51,45-49,1861,0.04434209449897556
STAT,1882,42,35-39,1924,1.7975100966416406
STAT,1866,53,50-100,1919,0.01398306031489539
STAT,1858,30,35-39,1888,8.364798207598692
STAT,1913,21,40-44,1934,3.3338717905760684
SIM,1821,43,25-29,1864,1
STAT,1912,39,15-19,1951,0.01892751864739095
STAT,1916,22,20-24,1938,118.90334784221395
STAT,1918,16,20-24,1934,30.28648231234196
STAT,1927,18,50-100,1945,0.47394681725751003
SIM,1935,27,40-44,1962,10
STAT,1828,36,50-100,1864,1.1003415983409481
SIM,1928,37,na,1965,4999
SIM,1924,22,20-24,1946,4
STAT,1866,26,15-19,1892,0.4283856409597496
STAT,1873,53,35-39,1926,0.008760953953064546
STAT,1784,86,na,1870,59.022527930395924
STAT,1904,43,35-39,1947,0.1825217516733744
STAT,1877,24,25-29,1901,60.19159456322462
SIM,1914,39,na,1953,3788
SIM,1928,24,30-34,1952,53
STAT,1840,25,40-44,1865,2.7267359173546004
SIM,1926,38,40-44,1964,6
STAT,1900,27,15-19,1927,0.6415125879820672
STAT,1865,33,45-49,1898,1.6077962485484123
STAT,1919,28,45-49,1947,1.8981756422523968
STAT,1915,40,45-49,1955,0.17145750464138076
SIM,1841,68,na,1909,1057
STAT,1825,85,na,1910,164.38822650911138
SIM,1902,16,35-39,1918,1
STAT,1889,5,na,1894,3302.38093176205
SIM,1890,42,35-39,1932,2
STAT,1804,50,20-24,1854,0.0022547227773944576
SIM,1848,30,30-34,1878,22
SIM,1839,32,30-34,1871,20
STAT,1933,38,20-24,1971,0.3658011335215246
SIM,1913,49,25-29,1962,1
STAT,1963,6,na,1969,5093.174040428967
SIM,1854,11,na,1865,2479
SIM,1917,32,30-34,1949,6
SIM,1823,40,40-44,1863,3
SIM,1851,49,40-44,1900,2
SIM,1907,25,25-29,1932,84
STAT,1836,63,na,1899,1110.6126685875581
STAT,1883,33,50-100,1916,0.913259841050782
STAT,1922,38,45-49,1960,0.790701158677261
SIM,1822,39,45-49,1861,4
SIM,1823,55,na,1878,1290
STAT,1907,48,20-24,1955,0.01001179688926451
SIM,1857,23,35-39,1880,4
SIM,1927,28,45-49,1955,3
SIM,1867,33,20-24,1900,3
SIM,1910,35,25-29,1945,2
STAT,1875,24,15-19,1899,3.432489959112855
STAT,1891,20,40-44,1911,2.647549360372315
STAT,1894,21,20-24,1915,90.7012401517511
STAT,1929,22,30-34,1951,37.07043988677891
SIM,1869,41,30-34,1910,1
STAT,1796,71,na,1867,602.7460466821109
SIM,1926,16,20-24,1942,247
SIM,1938,28,20-24,1966,19
STAT,1878,53,25-29,1931,0.0037007372440181286
SIM,1849,58,na,1907,1542
SIM,1933,15,25-29,1948,62
SIM,1890,31,40-44,1921,4
STAT,1912,42,30-34,1954,0.12578459232263337
STAT,1952,17,35-39,1969,5.129644206115059
STAT,1882,31,40-44,1913,4.327776082100389
STAT,1883,21,45-49,1904,0.700102099953015
SIM,1891,21,45-49,1912,1
SIM,1930,0,na,1930,6152
STAT,1885,43,15-19,1928,0.013953819001533124
STAT,1876,45,15-19,1921,4.255722910579393E-4
SIM,1878,39,na,1917,2591
STAT,1935,0,na,1935,6280.750855836871
STAT,1890,27,na,1917,2976.798404568357
STAT,1902,35,25-29,1937,0.9025362642131712
STAT,1865,20,25-29,1885,54.42694583039318
STAT,1911,12,na,1923,4031.1858280727142
SIM,1874,20,30-34,1894,34
STAT,1918,2,na,1920,4542.71500350399
STAT,1945,18,45-49,1963,0.5565659943640568
STAT,1853,53,50-100,1906,0.012460307367481325
SIM,1859,39,40-44,1898,8
STAT,1825,39,20-24,1864,1.1053070226448554
STAT,1905,49,25-29,1954,0.04687122354390884
SIM,1853,53,na,1906,1756
SIM,1876,31,20-24,1907,3
STAT,1902,48,45-49,1950,0.18911131869088393
STAT,1883,15,35-39,1898,0.5517907311352351
STAT,1859,36,25-29,1895,2.3570151244519346
STAT,1862,95,na,1957,15.27888590450402
STAT,1911,33,25-29,1944,9.141721009591432
STAT,1827,30,20-24,1857,4.63007179639165
SIM,1918,17,25-29,1935,67
STAT,1868,52,50-100,1920,0.014637287180128277
STAT,1886,19,40-44,1905,0.19644177864310405
SIM,1893,28,na,1921,3124
SIM,1835,50,na,1885,1526
STAT,1822,109,na,1931,4.136740151813741E-4
STAT,1908,44,50-100,1952,0.10947333972332002
SIM,1908,34,30-34,1942,21
SIM,1855,20,20-24,1875,65
STAT,1929,17,35-39,1946,5.461938565858929
STAT,1881,52,30-34,1933,0.005839611427963804
STAT,1817,40,50-100,1857,2.868270262217961
STAT,1879,23,20-24,1902,73.25811332104266
SIM,1838,23,25-29,1861,87
SIM,1939,25,45-49,1964,2
SIM,1919,4,na,1923,4596
STAT,1836,20,45-49,1856,0.6096261757619407
STAT,1896,37,40-44,1933,5.898043503353451
STAT,1907,16,45-49,1923,0.09808603911492289
STAT,1918,38,40-44,1956,1.6085430817083164
SIM,1864,41,40-44,1905,2
STAT,1791,106,na,1897,0.002142256165244546
STAT,1863,30,30-34,1893,15.7424049574763
STAT,1828,34,na,1862,1555.1195597229587
SIM,1789,88,na,1877,7
SIM,1830,38,40-44,1868,4
STAT,1862,52,20-24,1914,6.373978623196006E-4
SIM,1862,30,na,1892,2209
STAT,1877,45,na,1922,2404.257756886566
STAT,1840,68,na,1908,1099.6878189242814
SIM,1910,48,45-49,1958,1
STAT,1822,38,40-44,1860,7.884381796400969
SIM,1907,29,30-34,1936,51
STAT,1813,42,50-100,1855,3.8451767337638
SIM,1866,30,35-39,1896,3
STAT,1847,51,40-44,1898,0.008248877889122022
STAT,1848,41,45-49,1889,1.1769380682019912
STAT,1900,49,35-39,1949,0.10933054047695927
STAT,1924,36,15-19,1960,0.02312380791881698
STAT,1843,33,na,1876,2081.5852851418063
STAT,1846,33,35-39,1879,8.469931138009752
SIM,1898,43,na,1941,3547
STAT,1813,43,25-29,1856,2.230048603815059
STAT,1815,51,35-39,1866,0.022574000398728485
SIM,1835,30,20-24,1865,3
SIM,1888,41,40-44,1929,5
STAT,1885,64,na,1949,1769.264329917293
STAT,1925,39,25-29,1964,1.2031064361375663
STAT,1898,23,30-34,1921,24.497047851489775
SIM,1826,79,na,1905,341
SIM,1827,28,40-44,1855,6
SIM,1880,20,30-34,1900,26
STAT,1948,22,40-44,1970,3.9388427501836007
STAT,1879,32,35-39,1911,10.799047489868457
SIM,1878,20,15-19,1898,2
SIM,1906,17,20-24,1923,32
STAT,1920,43,50-100,1963,0.13219928643519813
STAT,1880,34,25-29,1914,10.886365561694943
SIM,1942,17,30-34,1959,20
SIM,1889,31,30-34,1920,4
SIM,1909,37,40-44,1946,1
STAT,1905,22,45-49,1927,1.027394947037757
SIM,1913,22,45-49,1935,1
STAT,1830,40,20-24,1870,0.140953417475399
STAT,1916,22,50-100,1938,0.7036118139774304
STAT,1930,33,35-39,1963,12.02079973928353
SIM,1815,41,50-100,1856,5
SIM,1937,17,35-39,1954,4
STAT,1847,20,20-24,1867,66.83490597748687
SIM,1837,33,35-39,1870,10
STAT,1839,30,25-29,1869,8.881619615979881
STAT,1853,20,20-24,1873,69.26415186554742
STAT,1874,22,30-34,1896,18.552594631554605
SIM,1919,35,45-49,1954,2
STAT,1861,30,na,1891,2027.7538311145113
SIM,1936,35,45-49,1971,1
SIM,1906,23,40-44,1929,8
SIM,1810,48,40-44,1858,1
SIM,1902,21,30-34,1923,33
SIM,1911,27,40-44,1938,5
STAT,1870,20,20-24,1890,69.13390525131308
STAT,1896,24,35-39,1920,7.813233856038037
STAT,1899,25,15-19,1924,0.638108666625112
STAT,1838,31,35-39,1869,9.342571790230929
STAT,1913,48,20-24,1961,0.010973269359155787
STAT,1815,85,na,1900,141.74818129639633
STAT,1857,22,30-34,1879,16.383135125707444
SIM,1883,9,na,1892,2672
STAT,1918,25,35-39,1943,16.41554672997839
STAT,1885,20,40-44,1905,2.1335106844886194
STAT,1855,31,35-39,1886,8.076846279566666
SIM,1869,78,na,1947,643
SIM,1887,23,20-24,1910,78
STAT,1859,33,45-49,1892,1.4147226028741906
STAT,1957,15,45-49,1972,0.6720541861585537
SIM,1855,3,na,1858,2483
STAT,1917,46,25-29,1963,0.05668223255338408
SIM,1838,64,na,1902,1069
STAT,1939,27,45-49,1966,1.771731992036141
STAT,1854,66,na,1920,1254.4239824457127
STAT,1935,25,35-39,1960,20.888863314331644
SIM,1878,45,na,1923,2564
SIM,1941,2,na,1943,4072
STAT,1844,42,15-19,1886,0.010960013138884523
SIM,1852,25,25-29,1877,58
STAT,1833,22,45-49,1855,0.7180237831063792
SIM,1949,19,50-100,1968,3
STAT,1906,43,na,1949,3418.810108156278
SIM,1783,73,na,1856,445
STAT,1828,50,na,1878,1321.8552733635288
SIM,1847,30,25-29,1877,8
SIM,1872,21,35-39,1893,9
STAT,1851,52,45-49,1903,0.011909255425886563
SIM,1846,83,na,1929,176
STAT,1839,28,na,1867,1867.30267365829
STAT,1835,32,20-24,1867,2.5651042662716077
STAT,1928,35,45-49,1963,0.8803188986533671
SIM,1873,20,25-29,1893,61
STAT,1842,97,na,1939,4.212937144014489
STAT,1821,109,na,1930,3.748960747267597E-4
SIM,1943,25,35-39,1968,1
STAT,1844,25,25-29,1869,40.71057853058461
STAT,1866,51,na,1917,2035.7605564436524
SIM,1823,49,na,1872,1447
STAT,1834,51,45-49,1885,0.010214131314275754
STAT,1818,49,30-34,1867,0.21306263665311012
STAT,1892,35,50-100,1927,1.5846531633767522
STAT,1850,22,45-49,1872,0.6295668183323672
STAT,1903,27,40-44,1930,4.3440608914277234
STAT,1904,17,45-49,1921,0.09550580237712915
STAT,1886,28,na,1914,2567.925645201775
STAT,1953,17,40-44,1970,1.7259663075648208
SIM,1841,78,na,1919,535
STAT,1828,51,30-34,1879,0.00458624579019322
STAT,1840,29,45-49,1869,0.9819471652981958
SIM,1865,22,30-34,1887,30
SIM,1934,24,30-34,1958,54
SIM,1832,85,na,1917,76
STAT,1809,54,15-19,1863,1.0037160931174679E-4
STAT,1885,23,20-24,1908,69.9209495519775
STAT,1926,24,30-34,1950,35.3980381142073
SIM,1814,48,50-100,1862,2
STAT,1848,44,50-100,1892,0.8101301725390774
STAT,1851,15,15-19,1866,6.023518606326885
STAT,1864,21,35-39,1885,5.417276813277221
STAT,1865,103,na,1968,0.9972960728854747
STAT,1883,3,na,1886,2976.8522399777858
STAT,1895,42,30-34,1937,0.10613086016728944
SIM,1778,94,na,1872,4
STAT,1849,23,35-39,1872,5.438105780672209
STAT,1929,28,15-19,1957,0.9007056127646349
SIM,1873,30,40-44,1903,5
SIM,1833,33,na,1866,1899
STAT,1845,54,25-29,1899,0.002691435392236929
STAT,1828,54,25-29,1882,0.0023399972771420583
SIM,1886,74,na,1960,1316
STAT,1868,23,45-49,1891,0.6773478805623978
STAT,1861,20,na,1881,2077.8968829368487
STAT,1899,72,na,1971,2191.7142619922356
STAT,1949,18,15-19,1967,53.833055241003336
SIM,1945,25,45-49,1970,7
STAT,1856,52,35-39,1908,0.006857463552167579
SIM,1893,23,20-24,1916,92
STAT,1848,39,15-19,1887,0.04405845933407944
SIM,1901,28,25-29,1929,4
STAT,1844,30,20-24,1874,2.5573915687949156
STAT,1907,24,20-24,1931,102.57693126325258
STAT,1854,41,30-34,1895,0.8838852472794745
SIM,1826,32,20-24,1858,3
STAT,1871,41,20-24,1912,0.16121063458482096
STAT,1943,24,30-34,1967,31.1767474621317
SIM,1828,43,35-39,1871,1
STAT,1886,12,na,1898,2788.624603617962
STAT,1833,98,na,1931,2.133303038872454
SIM,1928,15,na,1943,4864
SIM,1931,19,na,1950,4706
SIM,1896,58,na,1954,2651
STAT,1879,58,na,1937,2108.8209650002814
STAT,1881,26,40-44,1907,2.9645959026470052
STAT,1873,79,na,1952,723.0493142768374
STAT,1889,34,45-49,1923,2.178652596056215
STAT,1924,24,20-24,1948,133.02733331367705
SIM,1930,27,50-100,1957,2
STAT,1944,17,na,1961,4041.307298488366
SIM,1853,63,na,1916,1433
STAT,1908,27,30-34,1935,38.091377266572465
STAT,1894,47,na,1941,2939.0646934055662
SIM,1846,31,35-39,1877,13
SIM,1926,25,35-39,1951,27
SIM,1936,8,na,1944,3482
STAT,1875,52,45-49,1927,0.015113763196521964
SIM,1878,23,na,1901,2587
SIM,1898,24,35-39,1922,11
STAT,1859,27,50-100,1886,0.5301628172501697
SIM,1861,20,20-24,1881,87
SIM,1915,24,20-24,1939,115
STAT,1824,38,50-100,1862,1.6390136503141666
STAT,1837,49,40-44,1886,0.11549238124299642
STAT,1890,36,50-100,1926,1.5387795579493342
SIM,1916,27,30-34,1943,65
SIM,1878,34,35-39,1912,20
STAT,1938,15,35-39,1953,4.242038275637329
SIM,1879,24,25-29,1903,86
STAT,1849,34,15-19,1883,0.11410782645583348
STAT,1923,43,45-49,1966,0.1981585882573786
SIM,1932,24,20-24,1956,149
SIM,1847,43,45-49,1890,4
STAT,1870,15,25-29,1885,5.77285437403158
STAT,1895,45,25-29,1940,0.0436772837701122
STAT,1806,49,na,1855,1271.2968711650326
SIM,1910,32,20-24,1942,1
SIM,1850,47,50-100,1897,1
STAT,1874,80,na,1954,644.3062988379367
STAT,1892,16,15-19,1908,7.606325932488078
STAT,1927,27,40-44,1954,5.780250367761579
SIM,1863,31,35-39,1894,12
SIM,1921,21,40-44,1942,7
STAT,1910,28,25-29,1938,64.59694853928616
SIM,1878,55,na,1933,2350
STAT,1876,33,20-24,1909,2.835465136009361
STAT,1918,49,35-39,1967,0.13919023678882872
STAT,1945,27,50-100,1972,1.1141233517044307
SIM,1876,23,45-49,1899,1
STAT,1839,43,45-49,1882,1.0747714541781597
STAT,1825,79,na,1904,419.2274290397857
STAT,1894,57,na,1951,2637.0743934798916
STAT,1820,48,na,1868,1401.4496256997923
SIM,1846,22,20-24,1868,72
STAT,1937,25,45-49,1962,1.7192794934719906
SIM,1861,82,na,1943,291
STAT,1841,16,na,1857,2198.857443838736
SIM,1822,35,40-44,1857,6
STAT,1838,22,20-24,1860,65.69190825013993
STAT,1909,35,35-39,1944,2.35709005068642
SIM,1873,24,na,1897,2378
STAT,1913,24,45-49,1937,1.151852917495355
SIM,1856,33,45-49,1889,2
STAT,1848,31,50-100,1879,0.8392540127856732
STAT,1887,47,40-44,1934,0.19479205169376881
SIM,1900,38,35-39,1938,5
SIM,1920,45,35-39,1965,1
STAT,1868,25,na,1893,2341.1262649929445
STAT,1870,29,30-34,1899,24.933482174080265
STAT,1920,27,30-34,1947,43.86333432406843
SIM,1878,37,50-100,1915,1
STAT,1931,10,na,1941,5305.221082157891
STAT,1838,25,25-29,1863,40.11048620678669
STAT,1792,89,na,1881,33.754097016917825
SIM,1871,50,na,1921,1997
STAT,1935,16,20-24,1951,189.47403522214628
SIM,1924,38,20-24,1962,2
STAT,1901,44,na,1945,3263.8941733662223
STAT,1845,83,na,1928,310.1845751329906
STAT,1824,49,30-34,1873,0.10980793059408417
STAT,1872,20,30-34,1892,18.32046844832986
SIM,1943,16,20-24,1959,124
SIM,1871,34,25-29,1905,16
STAT,1764,106,na,1870,0.020595987981617155
SIM,1929,15,35-39,1944,7
STAT,1806,50,40-44,1856,0.035710114344126576
STAT,1911,16,35-39,1927,0.8586150129293512
STAT,1904,58,na,1962,3039.436715405493
SIM,1917,35,35-39,1952,5
STAT,1854,44,25-29,1898,0.4848438225713343
STAT,1842,18,15-19,1860,5.9410218751222015
SIM,1945,24,30-34,1969,43
SIM,1832,32,45-49,1864,1
STAT,1859,81,na,1940,440.56893387957393
STAT,1822,39,50-100,1861,2.092245501611229
STAT,1882,1,na,1883,3339.9570153029676
SIM,1830,39,50-100,1869,3
STAT,1914,17,15-19,1931,9.578350150150147
SIM,1904,21,40-44,1925,7
SIM,1841,84,na,1925,162
SIM,1889,43,50-100,1932,2
STAT,1830,43,25-29,1873,0.5460917017724638
SIM,1922,17,15-19,1939,63
STAT,1869,52,30-34,1921,0.005831505939204843
STAT,1861,52,na,1913,1805.389528564263
STAT,1898,26,35-39,1924,13.356883154148989
STAT,1937,24,30-34,1961,28.52938463723716
STAT,1873,50,30-34,1923,0.006244892199320777
SIM,1898,26,50-100,1924,1
SIM,1921,24,45-49,1945,4
SIM,1942,4,na,1946,4745
STAT,1912,45,35-39,1957,0.12699591618701056
SIM,1840,40,40-44,1880,2
STAT,1916,29,30-34,1945,41.047729596153985
STAT,1916,35,50-100,1951,0.4429284234128429
SIM,1954,17,35-39,1971,8
SIM,1869,44,35-39,1913,2
STAT,1835,31,50-100,1866,0.8785591640090342
SIM,1916,19,30-34,1935,17
STAT,1804,53,25-29,1857,0.010179148918679985
STAT,1819,51,na,1870,1501.1242352730064
SIM,1892,20,35-39,1912,10
SIM,1893,26,25-29,1919,91
SIM,1950,19,30-34,1969,22
STAT,1877,36,50-100,1913,1.3053098195389823
STAT,1942,19,30-34,1961,12.986913661554613
SIM,1928,27,35-39,1955,26
STAT,1944,16,50-100,1960,0.41147033625308904
SIM,1885,21,45-49,1906,1
SIM,1863,23,35-39,1886,6
STAT,1855,23,35-39,1878,5.246805972647859
SIM,1858,2,na,1860,2851
STAT,1868,101,na,1969,4.039666755627713
STAT,1900,46,30-34,1946,0.07742547027513749
STAT,1845,15,15-19,1860,5.930345028107605
STAT,1857,31,45-49,1888,1.4125047062552396
STAT,1848,33,45-49,1881,1.4236588936690515
STAT,1909,48,40-44,1957,0.14734274324509328
STAT,1844,22,45-49,1866,0.6746777054915097
SIM,1918,27,40-44,1945,9
STAT,1889,33,30-34,1922,21.908904258193697
SIM,1869,46,na,1915,2220
STAT,1844,82,na,1926,361.5600376212015
SIM,1880,29,40-44,1909,3
SIM,1833,49,na,1882,1576
STAT,1865,30,40-44,1895,4.047654257956723
SIM,1880,0,na,1880,3709
SIM,1889,23,30-34,1912,1
STAT,1932,40,45-49,1972,0.23067571300138365
STAT,1831,39,20-24,1870,0.6619916987117945
STAT,1884,20,35-39,1904,5.924789572336383
SIM,1826,35,25-29,1861,6
STAT,1872,29,40-44,1901,3.040863284273793
SIM,1881,41,40-44,1922,2
SIM,1901,25,20-24,1926,3
STAT,1871,44,25-29,1915,0.6401563582050598
STAT,1911,25,25-29,1936,65.91912425641024
STAT,1933,20,50-100,1953,0.895407910123512
STAT,1944,15,35-39,1959,4.609621025130405
STAT,1946,23,45-49,1969,1.2770573257968472
STAT,1953,16,na,1969,4543.201747603534
STAT,1931,28,45-49,1959,2.273622743397411
SIM,1805,68,na,1873,686
STAT,1832,97,na,1929,3.589882442716574
STAT,1885,26,25-29,1911,43.20123736551277
STAT,1861,106,na,1967,0.08674835155921694
STAT,1946,17,35-39,1963,4.748455674228083
SIM,1835,34,na,1869,1780
STAT,1858,52,45-49,1910,0.011678152737257268
SIM,1803,67,na,1870,653
SIM,1853,15,15-19,1868,8
STAT,1767,104,na,1871,0.021755952941856775
STAT,1774,92,na,1866,7.633793057748765
STAT,1845,30,na,1875,2055.6827141892054
STAT,1916,43,na,1959,3877.7582783346706
SIM,1888,44,45-49,1932,5
STAT,1864,44,na,1908,2068.1860986301795
STAT,1820,39,45-49,1859,4.3249389690813045
STAT,1872,95,na,1967,53.9951377011427
SIM,1883,17,15-19,1900,7
SIM,1787,71,na,1858,470
SIM,1865,31,45-49,1896,3
STAT,1879,74,na,1953,1183.4285961807236
STAT,1848,32,30-34,1880,15.82738483883935
STAT,1894,41,na,1935,3046.573834812192
STAT,1928,32,40-44,1960,4.991147266270529
STAT,1941,2,na,1943,4272.987393648777
SIM,1845,34,na,1879,2027
STAT,1807,66,na,1873,947.9658652045325
SIM,1920,28,35-39,1948,23
STAT,1923,19,20-24,1942,161.55947854476204
STAT,1822,54,50-100,1876,0.019891824708379295
STAT,1853,36,30-34,1889,4.515488971958682
SIM,1830,33,25-29,1863,7
STAT,1857,36,15-19,1893,0.04495473338368253
STAT,1912,28,35-39,1940,15.039871822734495
STAT,1873,41,40-44,1914,2.336838612272667
SIM,1830,35,na,1865,1879
STAT,1829,33,35-39,1862,9.251012123377437
SIM,1821,48,na,1869,1414
STAT,1903,45,50-100,1948,0.2029070763797179
SIM,1856,32,30-34,1888,24
SIM,1850,18,15-19,1868,7
SIM,1952,15,35-39,1967,7
STAT,1774,86,na,1860,47.48363379762934
STAT,1917,34,30-34,1951,16.692054024432117
SIM,1876,6,na,1882,3184
STAT,1874,23,45-49,1897,0.7240592717521688
SIM,1868,29,40-44,1897,5
STAT,1837,52,25-29,1889,0.0023701761351278333
SIM,1848,22,30-34,1870,1
SIM,1941,17,25-29,1958,74
STAT,1909,48,30-34,1957,0.08331061666210915
STAT,1824,32,45-49,1856,3.4944836382290165
STAT,1933,17,25-29,1950,59.16014598228831
STAT,1940,19,na,1959,3810.041279523535
STAT,1847,96,na,1943,6.695987286146164
SIM,1872,15,25-29,1887,14
STAT,1844,22,20-24,1866,66.67472380797966
STAT,1846,30,30-34,1876,15.064760502611108
SIM,1852,39,30-34,1891,11
STAT,1864,15,25-29,1879,5.912756711061169
STAT,1877,21,45-49,1898,0.7400537301949807
STAT,1844,39,30-34,1883,4.274523144912062
SIM,1839,35,35-39,1874,7
SIM,1908,60,na,1968,3370
SIM,1908,37,35-39,1945,3
STAT,1891,23,45-49,1914,0.8779942972677053
SIM,1888,31,25-29,1919,18
STAT,1811,54,30-34,1865,0.01513229739416005
SIM,1925,34,30-34,1959,9
SIM,1859,34,25-29,1893,3
STAT,1897,34,50-100,1931,1.2390922339363009
SIM,1852,22,20-24,1874,1
STAT,1874,27,na,1901,2485.7115687511923
STAT,1830,40,50-100,1870,0.9376466288101364
STAT,1879,30,50-100,1909,0.9848966387110181
SIM,1887,30,50-100,1917,1
SIM,1839,41,45-49,1880,1
SIM,1934,27,35-39,1961,27
STAT,1935,22,30-34,1957,39.91338626984463
SIM,1921,1,na,1922,5339
SIM,1887,26,25-29,1913,65
STAT,1931,39,25-29,1970,1.3270481718175893
STAT,1898,32,45-49,1930,2.4056941309273054
SIM,1841,21,30-34,1862,19
STAT,1885,23,45-49,1908,0.7075260775788919
STAT,1797,87,na,1884,60.5169129643195
SIM,1829,30,20-24,1859,1
STAT,1851,29,20-24,1880,11.170207334480223
STAT,1888,21,20-24,1909,83.36077573481575
SIM,1891,19,15-19,1910,1
STAT,1915,17,20-24,1932,28.955368103131093
STAT,1875,38,na,1913,2454.4982019936224
STAT,1932,38,15-19,1970,0.026286489588139256
STAT,1857,25,35-39,1882,8.033170012713786
SIM,1921,42,na,1963,4907
STAT,1886,16,15-19,1902,6.423938389595529
STAT,1899,31,35-39,1930,14.205018777651262
SIM,1854,30,30-34,1884,17
STAT,1905,16,50-100,1921,0.07235919810125618
STAT,1868,47,30-34,1915,0.09387904067390006
STAT,1883,19,15-19,1902,5.9084237034673865
STAT,1845,18,40-44,1863,0.17956281545862066
STAT,1927,37,na,1964,4771.4544272494495
STAT,1919,4,na,1923,4551.625027152645
STAT,1901,27,20-24,1928,16.73584407015993
STAT,1904,35,35-39,1939,2.2532284411241754
STAT,1805,49,20-24,1854,0.042828977722807776
SIM,1896,21,20-24,1917,94
STAT,1835,44,15-19,1879,0.012021772553269187
SIM,1878,29,na,1907,2620
SIM,1912,22,na,1934,3807
SIM,1923,17,20-24,1940,189
SIM,1936,32,40-44,1968,10
STAT,1837,38,50-100,1875,0.9863450471315709
STAT,1926,27,35-39,1953,18.360548748936402
SIM,1826,32,45-49,1858,4
STAT,1863,42,25-29,1905,0.5736713109484592
SIM,1902,24,35-39,1926,12
STAT,1786,71,na,1857,492.1732054605036
SIM,1845,12,na,1857,2356
STAT,1843,98,na,1941,2.622459625273365
STAT,1926,44,25-29,1970,0.08950865531829127
SIM,1791,86,na,1877,53
STAT,1879,26,25-29,1905,45.26313161950595
SIM,1908,44,50-100,1952,1
STAT,1846,46,40-44,1892,0.1227764443116485
STAT,1795,91,na,1886,16.935604554243447
STAT,1866,20,30-34,1886,17.142970511855737
SIM,1931,19,20-24,1950,199
SIM,1838,80,na,1918,329
STAT,1907,24,45-49,1931,1.0379700832411833
SIM,1902,37,30-34,1939,1
SIM,1943,22,30-34,1965,30
STAT,1879,35,50-100,1914,1.3216433589704168
STAT,1870,32,15-19,1902,0.1420178609969958
STAT,1870,23,25-29,1893,56.91250833449963
STAT,1904,42,na,1946,3386.680163559803
SIM,1888,23,na,1911,2723
SIM,1842,16,15-19,1858,7
SIM,1798,65,na,1863,786
STAT,1925,5,na,1930,4955.418544880065
STAT,1924,19,na,1943,4447.955608844627
STAT,1887,23,na,1910,2695.212006568294
SIM,1903,61,na,1964,2841
STAT,1906,48,15-19,1954,3.3082071193415075E-4
STAT,1841,41,35-39,1882,1.4072444818930476
STAT,1859,30,40-44,1889,3.5846561612059604
SIM,1862,41,30-34,1903,3
SIM,1828,86,na,1914,149
STAT,1855,83,na,1938,307.74363493917207
STAT,1841,32,na,1873,1941.5162721323861
STAT,1863,33,35-39,1896,9.019946152964863
STAT,1870,50,na,1920,2178.13104840568
STAT,1925,15,25-29,1940,53.6567816091334
STAT,1930,25,35-39,1955,19.487506785252382
SIM,1886,58,na,1944,2218
SIM,1891,27,na,1918,3039
SIM,1905,38,50-100,1943,1
STAT,1832,40,40-44,1872,1.8967449538607584
SIM,1924,29,30-34,1953,2
STAT,1902,23,30-34,1925,25.546378012571047
SIM,1847,40,40-44,1887,2
SIM,1897,33,30-34,1930,47
STAT,1859,50,50-100,1909,0.012481255921310821
SIM,1895,31,30-34,1926,33
SIM,1916,17,15-19,1933,12
SIM,1828,40,30-34,1868,5
SIM,1873,33,45-49,1906,3
STAT,1917,46,50-100,1963,0.2416867432867951
STAT,1940,18,50-100,1958,0.38795088553655677
STAT,1907,60,na,1967,3107.9839821392916
SIM,1921,40,35-39,1961,1
STAT,1880,31,30-34,1911,18.793824947749386
STAT,1927,17,25-29,1944,54.96386491973762
SIM,1935,17,25-29,1952,68
SIM,1830,41,25-29,1871,3
STAT,1895,49,40-44,1944,0.12585337705962335
SIM,1912,35,35-39,1947,6
SIM,1894,45,na,1939,3046
STAT,1845,51,20-24,1896,5.793297300584354E-4
SIM,1896,74,na,1970,1845
SIM,1805,52,na,1857,1143
STAT,1909,32,30-34,1941,15.333394208974868
STAT,1786,93,na,1879,5.799304749390078
STAT,1908,19,30-34,1927,2.398035623907138
STAT,1842,20,45-49,1862,0.6997420885091126
STAT,1840,84,na,1924,239.38375058003174
STAT,1859,33,20-24,1892,2.1929290261170844
STAT,1887,31,30-34,1918,20.040350125854935
SIM,1865,25,35-39,1890,13
STAT,1911,22,na,1933,3691.7392985156657
STAT,1908,17,15-19,1925,8.976892719986077
SIM,1808,66,na,1874,981
STAT,1839,40,40-44,1879,1.8445574632192208
SIM,1910,23,30-34,1933,40
SIM,1827,48,50-100,1875,2
SIM,1846,25,25-29,1871,40
SIM,1859,31,45-49,1890,5
SIM,1919,34,30-34,1953,24
STAT,1844,33,25-29,1877,9.393411719025485
STAT,1850,39,30-34,1889,3.9887162630783193
SIM,1938,15,na,1953,3645
SIM,1821,40,30-34,1861,3
STAT,1907,27,25-29,1934,63.36274668979721
STAT,1841,36,50-100,1877,1.079191680761116
STAT,1894,63,na,1957,2391.429072069671
STAT,1905,38,45-49,1943,0.6308013063160148
SIM,1867,36,25-29,1903,7
STAT,1854,110,na,1964,0.0011112378656822075
SIM,1898,28,15-19,1926,3
SIM,1928,33,45-49,1961,2
STAT,1822,41,25-29,1863,1.0297455945437366
STAT,1950,6,na,1956,4742.120128530873
SIM,1913,38,45-49,1951,1
STAT,1894,37,30-34,1931,6.993569020463206
STAT,1855,61,na,1916,1448.563077431971
STAT,1913,40,35-39,1953,0.20259950560213713
SIM,1833,27,na,1860,1923
SIM,1915,27,25-29,1942,81
SIM,1941,19,na,1960,3690
STAT,1833,21,30-34,1854,23.36698692437373
STAT,1827,46,30-34,1873,0.11019143352144718
STAT,1836,23,25-29,1859,46.690699999397076
SIM,1829,47,50-100,1876,2
SIM,1869,25,na,1894,2318
STAT,1861,34,15-19,1895,0.1190173677304123
SIM,1923,16,na,1939,4204
STAT,1873,38,50-100,1911,1.2634942703000043
STAT,1816,49,na,1865,1287.8444481041934
SIM,1798,87,na,1885,47
STAT,1884,80,na,1964,898.273914865971
SIM,1842,69,na,1911,1152
STAT,1933,39,35-39,1972,3.3526479398813667
STAT,1824,84,na,1908,183.16944750629398
STAT,1853,29,30-34,1882,21.940806991748723
SIM,1925,23,na,1948,4535
STAT,1855,20,30-34,1875,16.365393493888647
STAT,1931,17,15-19,1948,60.58188538158728
SIM,1871,31,20-24,1902,6
STAT,1908,36,20-24,1944,0.25288733524860096
SIM,1911,23,25-29,1934,106
STAT,1901,60,na,1961,2856.333268709077
STAT,1855,25,25-29,1880,38.105872737700096
SIM,1870,9,na,1879,2901
STAT,1869,96,na,1965,29.89100081611773
SIM,1823,87,na,1910,69
SIM,1856,35,35-39,1891,10
SIM,1854,39,40-44,1893,7
STAT,1826,52,50-100,1878,0.011395045154681111
STAT,1876,36,25-29,1912,3.0476290526665673
STAT,1921,18,35-39,1939,4.868014857011338
STAT,1952,16,20-24,1968,165.78278340764564
STAT,1879,4,na,1883,3065.3769838083294
STAT,1839,52,35-39,1891,0.00590986810491607
STAT,1900,22,45-49,1922,0.9859776560533338
STAT,1809,45,25-29,1854,0.26492098628188837
SIM,1838,40,25-29,1878,1
SIM,1927,36,na,1963,4655
SIM,1876,81,na,1957,743
SIM,1891,30,35-39,1921,22
SIM,1908,17,30-34,1925,3
STAT,1843,41,45-49,1884,1.26001562958919
STAT,1937,22,40-44,1959,3.3398430678974615
SIM,1861,29,30-34,1890,31
SIM,1945,22,40-44,1967,5
STAT,1924,27,25-29,1951,78.1888529361903
STAT,1920,20,20-24,1940,126.90390993204554
STAT,1830,91,na,1921,36.65733369405501
STAT,1844,46,30-34,1890,0.0752243935575929
STAT,1854,41,20-24,1895,0.1220982644465396
SIM,1863,25,25-29,1888,47
STAT,1897,31,25-29,1928,14.028382578229186
STAT,1887,7,na,1894,2978.2696383349808
SIM,1913,38,na,1951,3866
STAT,1940,29,25-29,1969,68.40467866526254
SIM,1922,28,45-49,1950,3
SIM,1851,46,na,1897,1819
STAT,1860,19,20-24,1879,16.725230088286054
SIM,1884,29,50-100,1913,1
STAT,1829,34,50-100,1863,0.8205070619685182
STAT,1894,73,na,1967,1906.7256950874985
SIM,1828,49,40-44,1877,1
SIM,1932,27,25-29,1959,12
SIM,1946,18,na,1964,4057
STAT,1823,50,40-44,1873,0.015855564314855013
STAT,1889,31,40-44,1920,5.487218648908312
STAT,1903,23,25-29,1926,82.75904456690463
SIM,1864,96,na,1960,20
STAT,1914,28,45-49,1942,1.7706881473946783
STAT,1837,30,15-19,1867,0.12154400838068374
STAT,1815,46,50-100,1861,0.6718113412040089
STAT,1926,21,na,1947,4539.591771402488
STAT,1883,26,15-19,1909,0.4556990517223407
SIM,1939,21,na,1960,3960
STAT,1846,42,25-29,1888,0.46477983282341095
STAT,1848,35,35-39,1883,5.784708479689856
STAT,1941,16,45-49,1957,0.5250808152889809
STAT,1890,41,40-44,1931,2.8182993606242053
SIM,1940,18,na,1958,3804
STAT,1830,40,30-34,1870,1.020380157120742
STAT,1934,26,20-24,1960,25.053500775861046
SIM,1848,57,na,1905,1622
STAT,1922,38,20-24,1960,0.30575127820095144
STAT,1926,26,20-24,1952,22.399903426519383
STAT,1929,23,45-49,1952,1.4467623661814764
STAT,1906,16,na,1922,3759.345907741045
SIM,1882,32,35-39,1914,13
STAT,1869,74,na,1943,1093.0401238319255
SIM,1907,25,15-19,1932,1
STAT,1875,9,na,1884,2783.0841978466337
SIM,1807,65,na,1872,851
STAT,1863,53,40-44,1916,0.009265282633978592
STAT,1829,30,30-34,1859,17.044993545857746
STAT,1889,36,35-39,1925,8.95579518923929
SIM,1843,35,25-29,1878,8
SIM,1908,44,na,1952,3698
SIM,1851,41,45-49,1892,1
SIM,1878,33,20-24,1911,1
SIM,1821,42,50-100,1863,1
SIM,1833,22,35-39,1855,5
SIM,1884,40,45-49,1924,3
STAT,1881,15,25-29,1896,5.6149333691668595
STAT,1945,18,na,1963,4100.935081686875
SIM,1820,35,30-34,1855,4
SIM,1825,40,50-100,1865,1
STAT,1860,8,na,1868,2344.209920656189
STAT,1933,33,50-100,1966,1.1355898851813233
SIM,1902,37,40-44,1939,3
STAT,1863,20,15-19,1883,3.0533124995458527
STAT,1874,59,na,1933,2024.2381208719273
STAT,1895,26,na,1921,3187.389426967129
SIM,1884,14,na,1898,2819
STAT,1875,18,50-100,1893,0.05116062605957928
STAT,1917,29,25-29,1946,69.93788932617264
STAT,1910,17,20-24,1927,27.39883828663429
SIM,1902,30,20-24,1932,4
STAT,1827,39,30-34,1866,6.568608151923121
STAT,1907,49,35-39,1956,0.11644336750683537
STAT,1947,21,50-100,1968,0.7589839602676545
STAT,1926,36,na,1962,4694.858509867545
SIM,1897,36,35-39,1933,10
STAT,1876,40,45-49,1916,1.5925132522140264
SIM,1942,26,20-24,1968,23
SIM,1925,37,35-39,1962,2
SIM,1815,41,35-39,1856,8
SIM,1868,77,na,1945,834
SIM,1914,4,na,1918,4215
STAT,1787,72,na,1859,635.4557960027474
STAT,1813,47,40-44,1860,0.4302742405823886
SIM,1903,28,35-39,1931,19
SIM,1943,0,na,1943,4140
SIM,1830,30,20-24,1860,4
SIM,1895,35,50-100,1930,3
STAT,1874,32,35-39,1906,10.547965643474027
SIM,1863,20,30-34,1883,19
SIM,1891,70,na,1961,1904
SIM,1925,29,25-29,1954,122
STAT,1905,27,15-19,1932,0.6684601697690387
SIM,1877,8,na,1885,2771
STAT,1875,30,35-39,1905,10.68837561041037
SIM,1862,83,na,1945,265
SIM,1899,20,45-49,1919,3
STAT,1874,20,40-44,1894,2.183365732288575
STAT,1928,15,40-44,1943,1.8060528298077871
STAT,1840,29,20-24,1869,10.375243581696495
STAT,1845,67,na,1912,1238.605107529582
SIM,1926,24,20-24,1950,177
SIM,1958,13,na,1971,5136
STAT,1807,49,30-34,1856,0.40683791046436996
SIM,1909,27,25-29,1936,6
STAT,1935,34,25-29,1969,13.023495711906605
STAT,1941,10,na,1951,4152.228946695346
SIM,1871,20,15-19,1891,4
STAT,1949,20,50-100,1969,0.7838759467894136
SIM,1930,38,20-24,1968,4
STAT,1835,35,25-29,1870,2.708882961505468
STAT,1882,78,na,1960,946.9417312966756
SIM,1900,16,25-29,1916,14
SIM,1865,40,35-39,1905,1
STAT,1894,19,50-100,1913,0.06394327184023971
STAT,1937,27,35-39,1964,14.928153403927741
STAT,1851,23,15-19,1874,3.2269657705913697
STAT,1910,26,35-39,1936,14.837317145219595
SIM,1832,64,na,1896,1081
STAT,1870,34,na,1904,2359.4042786377436
SIM,1883,30,35-39,1913,4
SIM,1930,23,35-39,1953,18
SIM,1848,31,45-49,1879,4
STAT,1816,102,na,1918,0.13008567418975842
SIM,1910,18,25-29,1928,18
STAT,1855,67,na,1922,1228.8581335224394
SIM,1889,34,35-39,1923,5
STAT,1836,25,15-19,1861,0.37074725054719687
STAT,1919,17,40-44,1936,1.577335276517889
STAT,1826,49,40-44,1875,0.13028277546336262
STAT,1840,31,na,1871,1919.3485620412055
STAT,1948,0,na,1948,5172.400494612039
STAT,1856,30,25-29,1886,8.476966595021237
STAT,1848,46,15-19,1894,3.118157797192143E-4
STAT,1761,109,na,1870,0.00144087184595685
STAT,1869,19,40-44,1888,0.1804921635415387
STAT,1833,24,35-39,1857,5.2956231973862025
SIM,1926,38,30-34,1964,7
SIM,1899,44,na,1943,3202
STAT,1884,42,45-49,1926,1.5086731970325145
SIM,1919,32,40-44,1951,9
STAT,1950,17,25-29,1967,52.27463966348098
SIM,1921,26,na,1947,4808
SIM,1875,42,45-49,1917,3
SIM,1888,81,na,1969,977
STAT,1863,86,na,1949,198.4575347764668
STAT,1820,91,na,1911,31.915021845377982
STAT,1918,24,20-24,1942,121.61602877729504
STAT,1925,28,20-24,1953,21.91909523954143
STAT,1864,51,40-44,1915,0.009595135110009695
SIM,1951,3,na,1954,5345
STAT,1886,28,50-100,1914,0.688316150655179
STAT,1900,49,25-29,1949,0.04498170762803711
STAT,1867,42,45-49,1909,1.431615030857214
STAT,1921,32,30-34,1953,17.89136982252046
STAT,1940,18,45-49,1958,0.5172678473820753
STAT,1872,36,40-44,1908,4.497230409866046
STAT,1836,20,20-24,1856,60.24603535021324
SIM,1877,44,na,1921,2301
STAT,1831,28,40-44,1859,2.8819497544236556
STAT,1845,51,30-34,1896,0.004673259649517003
STAT,1911,38,45-49,1949,0.6683119295845767
SIM,1928,20,15-19,1948,10
SIM,1919,37,35-39,1956,6
STAT,1842,47,50-100,1889,0.1926328330570392
STAT,1936,17,40-44,1953,1.3658286407575435
STAT,1900,35,15-19,1935,0.0801537968243558
SIM,1880,23,35-39,1903,6
SIM,1841,24,35-39,1865,13
SIM,1912,32,30-34,1944,28
SIM,1818,39,30-34,1857,10
STAT,1927,39,35-39,1966,3.0610746491272467
SIM,1847,94,na,1941,9
SIM,1879,15,35-39,1894,1
SIM,1915,49,35-39,1964,1
SIM,1934,26,20-24,1960,1
STAT,1861,25,25-29,1886,36.43921138197092
STAT,1857,107,na,1964,0.022195365756776643
SIM,1767,88,na,1855,60
STAT,1811,43,15-19,1854,0.04265390655670693
STAT,1864,59,na,1923,1762.8819533541277
SIM,1910,39,40-44,1949,1
STAT,1898,37,15-19,1935,0.07746816176321407
STAT,1942,28,20-24,1970,19.536948183638344
SIM,1829,33,25-29,1862,13
SIM,1831,84,na,1915,311
SIM,1835,39,30-34,1874,7
STAT,1914,36,20-24,1950,0.2698309449723785
SIM,1856,45,na,1901,2208
SIM,1867,12,na,1879,2450
STAT,1806,50,na,1856,1258.107602614314
STAT,1922,27,50-100,1949,1.1492288335184464
STAT,1906,43,45-49,1949,0.1532048973311988
STAT,1863,96,na,1959,13.453540774653044
SIM,1937,25,35-39,1962,21
STAT,1888,24,25-29,1912,68.60716566545234
STAT,1911,22,20-24,1933,107.5694432833106
STAT,1850,46,na,1896,1697.1459699278696
STAT,1853,32,15-19,1885,0.12296617557997168
SIM,1887,59,na,1946,2277
SIM,1896,24,25-29,1920,103
STAT,1902,39,40-44,1941,1.3456170354359722
STAT,1887,40,20-24,1927,0.18337632847776866
STAT,1840,16,50-100,1856,0.045915361694015146
SIM,1837,32,20-24,1869,3
SIM,1890,26,na,1916,3124
SIM,1942,25,na,1967,4397
SIM,1896,22,35-39,1918,12
STAT,1905,16,35-39,1921,0.810423168886189
SIM,1914,43,45-49,1957,2
STAT,1913,7,na,1920,4155.7453303813
STAT,1888,22,35-39,1910,7.0377068500078925
STAT,1904,32,30-34,1936,14.657751374653477
SIM,1913,16,35-39,1929,1
SIM,1828,64,na,1892,1048
SIM,1930,16,35-39,1946,7
STAT,1846,31,na,1877,1850.6528346193388
STAT,1831,54,na,1885,1445.8211605737126
STAT,1854,48,40-44,1902,0.1293823300952722
STAT,1874,21,50-100,1895,0.4260212581361422
STAT,1829,32,20-24,1861,2.5218634294423157
STAT,1847,21,35-39,1868,5.618915250333279
STAT,1876,44,na,1920,2401.8636229577687
STAT,1923,18,na,1941,4398.298432533366
STAT,1930,22,30-34,1952,37.55265720419802
SIM,1874,19,15-19,1893,7
STAT,1831,35,40-44,1866,3.943887375534121
SIM,1880,36,40-44,1916,1
STAT,1855,45,na,1900,1761.4603503971514
SIM,1863,31,na,1894,2098
STAT,1911,37,40-44,1948,1.4748632832866657
SIM,1834,41,45-49,1875,2
STAT,1824,107,na,1931,0.002596676354019623
SIM,1863,46,na,1909,1968
STAT,1950,21,45-49,1971,1.3622145958227914
STAT,1862,15,15-19,1877,5.972529588537941
STAT,1866,38,30-34,1904,4.990099513564012
STAT,1846,39,40-44,1885,3.2018765134602143
SIM,1933,28,20-24,1961,25
SIM,1874,38,30-34,1912,11
STAT,1929,25,35-39,1954,19.237265818439518
STAT,1890,49,50-100,1939,0.16919658951212127
STAT,1763,113,na,1876,1.6655943681742816E-4
STAT,1847,40,25-29,1887,0.5166248218626545
STAT,1932,33,45-49,1965,2.131982271774841
SIM,1904,33,35-39,1937,10
STAT,1866,21,45-49,1887,0.6663004500775352
STAT,1956,3,na,1959,5308.784636251185
SIM,1822,39,50-100,1861,3
SIM,1948,23,20-24,1971,1
SIM,1821,91,na,1912,8
STAT,1909,26,20-24,1935,18.004350213700384
STAT,1794,103,na,1897,0.02844704771001357
STAT,1902,26,35-39,1928,13.929024762258491
STAT,1896,23,20-24,1919,92.56258128902745
STAT,1929,39,45-49,1968,0.8907656036244036
SIM,1868,93,na,1961,35
SIM,1937,20,40-44,1957,3
STAT,1892,48,50-100,1940,0.17490484658938943
SIM,1816,79,na,1895,314
STAT,1922,16,35-39,1938,4.967291590054973
SIM,1923,33,45-49,1956,2
STAT,1916,38,20-24,1954,0.27411378221427884
STAT,1944,28,30-34,1972,43.1859081891643
STAT,1817,51,45-49,1868,0.031711940836500384
STAT,1842,25,15-19,1867,0.44638151473713183
SIM,1830,45,40-44,1875,1
SIM,1881,49,na,1930,2035
SIM,1910,26,35-39,1936,29
SIM,1933,15,15-19,1948,54
STAT,1878,31,15-19,1909,0.15183515670900746
SIM,1947,20,25-29,1967,131
SIM,1917,26,20-24,1943,2
SIM,1944,17,40-44,1961,3
STAT,1883,30,35-39,1913,10.21832443754027
STAT,1925,37,35-39,1962,2.9618088047183986
SIM,1855,21,35-39,1876,6
SIM,1788,87,na,1875,112
SIM,1928,15,40-44,1943,2
STAT,1827,42,15-19,1869,0.016365442641151626
STAT,1909,41,20-24,1950,0.016943659072115765
STAT,1902,18,25-29,1920,8.131054065352783
STAT,1925,15,15-19,1940,56.19272174941515
SIM,1884,33,20-24,1917,4
STAT,1901,28,35-39,1929,13.716507686491738
STAT,1857,29,15-19,1886,0.36699584922536976
SIM,1881,59,na,1940,1769
SIM,1892,42,45-49,1934,7
STAT,1962,4,na,1966,5138.464341682832
SIM,1848,79,na,1927,439
SIM,1885,17,25-29,1902,15
SIM,1918,39,35-39,1957,4
STAT,1813,51,na,1864,1252.1247687228372
STAT,1822,45,40-44,1867,0.2513737573901615
SIM,1864,30,25-29,1894,13
SIM,1895,1,na,1896,3709
STAT,1894,33,15-19,1927,0.18608135178018378
SIM,1848,33,35-39,1881,16
STAT,1812,99,na,1911,0.8638045113084167
STAT,1915,33,45-49,1948,1.6284901749461673
STAT,1872,50,50-100,1922,0.015663399746763375
STAT,1920,27,40-44,1947,5.21785179859967
SIM,1910,38,50-100,1948,1
SIM,1850,25,15-19,1875,1
SIM,1891,15,35-39,1906,3
STAT,1862,100,na,1962,2.699070811250636
SIM,1824,33,50-100,1857,1
STAT,1869,15,25-29,1884,5.7257451645839526
STAT,1790,76,na,1866,392.07983827671956
STAT,1902,32,20-24,1934,3.888743302007248
STAT,1854,30,15-19,1884,0.11395695845056461
STAT,1917,17,30-34,1934,2.67667946748908
STAT,1868,43,15-19,1911,0.013358645039321366
STAT,1801,66,na,1867,753.8059195558144
STAT,1831,32,na,1863,1889.4158245783328
STAT,1916,25,25-29,1941,69.92092765729973
SIM,1806,51,35-39,1857,1
SIM,1911,20,20-24,1931,95
STAT,1855,22,20-24,1877,62.408804589682454
STAT,1920,23,25-29,1943,104.47001084971916
SIM,1863,22,20-24,1885,89
STAT,1906,26,45-49,1932,1.6542865239835334
STAT,1872,0,na,1872,3793.142844270485
SIM,1934,20,15-19,1954,7
SIM,1833,37,30-34,1870,11
STAT,1894,24,25-29,1918,74.64847770789429
STAT,1837,64,na,1901,1159.00971224817
STAT,1861,44,50-100,1905,0.8785345635492781
STAT,1880,31,20-24,1911,2.909601094728925
STAT,1889,47,15-19,1936,2.8300457925314117E-4
SIM,1882,20,40-44,1902,3
STAT,1834,23,15-19,1857,2.947866670750782
STAT,1823,53,45-49,1876,0.02059082565209404
STAT,1912,5,na,1917,4134.038427736289
STAT,1840,18,40-44,1858,0.16940404196018818
STAT,1920,28,45-49,1948,1.9271845224144026
STAT,1921,15,30-34,1936,14.243440651813096
STAT,1872,32,25-29,1904,10.47234237665296
STAT,1905,29,50-100,1934,0.9357511688513064
SIM,1811,45,30-34,1856,1
SIM,1913,29,50-100,1942,4
SIM,1918,22,na,1940,4106
STAT,1827,33,25-29,1860,15.05153827354097
SIM,1901,26,35-39,1927,19
STAT,1872,27,50-100,1899,0.6540404661617505
STAT,1903,16,25-29,1919,8.237872092294257
SIM,1839,27,na,1866,2026
STAT,1929,20,40-44,1949,4.362641977418903
STAT,1955,15,35-39,1970,5.684520508270778
STAT,1888,42,50-100,1930,1.2725336898084565
STAT,1940,26,20-24,1966,18.998010717846775
SIM,1921,33,35-39,1954,22
STAT,1877,26,15-19,1903,0.48170371592381517
SIM,1842,23,15-19,1865,5
STAT,1915,46,15-19,1961,3.797237250355216E-4
STAT,1818,50,na,1868,1376.7065595681781
STAT,1926,20,15-19,1946,6.636757274528366
SIM,1835,33,25-29,1868,11
STAT,1865,42,35-39,1907,1.6745733876417717
SIM,1874,30,35-39,1904,17
STAT,1920,26,na,1946,4208.057174122875
STAT,1825,37,30-34,1862,8.165308577311986
STAT,1952,19,25-29,1971,52.94030289707235
SIM,1873,42,35-39,1915,2
SIM,1933,17,15-19,1950,66
SIM,1942,29,25-29,1971,63
SIM,1838,20,20-24,1858,61
STAT,1934,29,25-29,1963,90.20821682149888
SIM,1868,3,na,1871,2946
SIM,1895,34,35-39,1929,22
SIM,1939,22,40-44,1961,6
SIM,1903,23,na,1926,3345
SIM,1909,15,30-34,1924,5
STAT,1905,59,na,1964,3053.58517262141
SIM,1907,22,20-24,1929,107
SIM,1828,80,na,1908,352
STAT,1800,55,na,1855,1303.9179874025483
STAT,1892,28,30-34,1920,32.0832851463995
SIM,1898,21,30-34,1919,1
STAT,1887,34,35-39,1921,11.477473158406784
STAT,1870,36,30-34,1906,5.340570449473216
SIM,1952,5,na,1957,4887
STAT,1816,65,na,1881,866.8921746303373
STAT,1913,33,35-39,1946,9.236173336388026
STAT,1880,53,40-44,1933,0.011104743948671883
STAT,1871,30,50-100,1901,0.9333311237902568
STAT,1928,18,45-49,1946,0.640353585764645
SIM,1860,39,40-44,1899,4
SIM,1913,7,na,1920,4287
STAT,1809,79,na,1888,374.7964089178943
STAT,1868,34,25-29,1902,9.894613953440045
SIM,1843,32,20-24,1875,3
SIM,1878,36,25-29,1914,4
STAT,1852,39,40-44,1891,3.491030548412769
SIM,1903,25,30-34,1928,35
STAT,1866,23,35-39,1889,5.496100054307858
STAT,1911,45,50-100,1956,0.2194425672098551
SIM,1856,44,50-100,1900,7
SIM,1933,11,na,1944,5285
STAT,1926,29,25-29,1955,79.91832942936779
SIM,1829,31,35-39,1860,10
STAT,1797,101,na,1898,0.14369185504485724
SIM,1832,32,na,1864,1854
SIM,1900,20,45-49,1920,1
SIM,1855,23,25-29,1878,67
SIM,1876,34,25-29,1910,17
STAT,1891,32,35-39,1923,12.790463493872306
STAT,1847,23,25-29,1870,54.332429614511966
STAT,1868,31,20-24,1899,2.644535444606816
STAT,1903,20,20-24,1923,100.53072888915898
SIM,1874,23,35-39,1897,8
STAT,1812,52,30-34,1864,0.0134368544574734
SIM,1893,44,na,1937,3040
SIM,1916,39,25-29,1955,2
STAT,1935,31,20-24,1966,3.4433807241914662
STAT,1905,37,na,1942,3498.5562015358337
SIM,1877,15,25-29,1892,9
STAT,1897,8,na,1905,3545.876180157657
STAT,1918,38,30-34,1956,1.9583894835026179
SIM,1816,39,20-24,1855,2
STAT,1831,52,40-44,1883,0.007573953546980689
SIM,1924,25,25-29,1949,96
STAT,1860,20,50-100,1880,0.3879122540105894
STAT,1880,34,na,1914,2536.2938582906622
SIM,1925,26,20-24,1951,40
SIM,1776,87,na,1863,98
SIM,1947,18,20-24,1965,217
STAT,1813,104,na,1917,0.028682841825866102
STAT,1856,31,50-100,1887,0.7504683150777404
STAT,1895,58,na,1953,2632.203894609366
STAT,1908,39,25-29,1947,0.9305738491860719
STAT,1893,49,30-34,1942,0.06918919444609589
STAT,1924,16,45-49,1940,0.6084078998703554
SIM,1814,51,na,1865,1253
SIM,1832,69,na,1901,834
SIM,1914,26,45-49,1940,4
SIM,1902,33,25-29,1935,7
SIM,1885,21,20-24,1906,90
SIM,1832,41,35-39,1873,5
SIM,1903,45,na,1948,3191
STAT,1834,46,na,1880,1624.022545020448
STAT,1898,41,35-39,1939,0.17425898863725173
STAT,1872,63,na,1935,1824.3255703838186
STAT,1888,9,na,1897,3129.1799284830554
STAT,1893,45,15-19,1938,2.9491344435645723E-4
STAT,1917,26,20-24,1943,19.602536463746247
STAT,1849,40,35-39,1889,1.4304146530547857
SIM,1864,31,50-100,1895,4
SIM,1918,37,na,1955,4167
STAT,1921,29,15-19,1950,0.797128475323688
STAT,1939,18,20-24,1957,138.395181949657
STAT,1918,22,30-34,1940,31.63295366428722
SIM,1872,67,na,1939,1594
STAT,1939,24,40-44,1963,3.4423906444584804
SIM,1855,27,na,1882,1938
STAT,1918,27,25-29,1945,71.48168389070277
SIM,1771,88,na,1859,26
SIM,1868,21,45-49,1889,1
SIM,1920,41,na,1961,3993
SIM,1934,22,na,1956,5126
STAT,1851,27,30-34,1878,24.325229613964094
SIM,1899,1,na,1900,3711
STAT,1854,82,na,1936,357.101017501354
STAT,1766,111,na,1877,0.0017005509656047519
STAT,1804,50,30-34,1854,0.018188096397852033
STAT,1881,19,40-44,1900,0.17942574186754998
STAT,1914,39,25-29,1953,0.9929228794538871
STAT,1838,27,na,1865,2021.8774384228127
SIM,1854,33,35-39,1887,3
STAT,1884,44,50-100,1928,1.0518660337852996
STAT,1885,47,30-34,1932,0.09806167749388114
SIM,1857,40,35-39,1897,3
SIM,1792,87,na,1879,50
SIM,1913,23,na,1936,3825
STAT,1834,29,20-24,1863,10.204100150915389
SIM,1934,29,25-29,1963,9
SIM,1834,98,na,1932,1
SIM,1837,35,25-29,1872,5
STAT,1796,86,na,1882,72.16336273579708
STAT,1831,37,50-100,1868,1.0799993021938104
STAT,1875,81,na,1956,603.822703842441
STAT,1869,52,20-24,1921,7.229139861601463E-4
SIM,1828,31,50-100,1859,1
SIM,1889,32,45-49,1921,1
SIM,1910,15,20-24,1925,40
STAT,1917,22,na,1939,3960.7162194093785
STAT,1824,41,35-39,1865,2.276264103159834
STAT,1853,23,25-29,1876,56.30724845055331
STAT,1928,29,50-100,1957,1.2495702731765987
SIM,1895,43,25-29,1938,1
STAT,1901,25,30-34,1926,36.16769371215037
SIM,1909,24,20-24,1933,98
STAT,1930,40,35-39,1970,0.2709733590875344
STAT,1882,20,25-29,1902,57.23455532636522
STAT,1909,44,25-29,1953,0.06728210650747618
SIM,1922,39,25-29,1961,1
STAT,1887,43,25-29,1930,0.7287683793180125
SIM,1841,46,na,1887,1718
STAT,1874,25,35-39,1899,10.118137992431746
STAT,1896,21,30-34,1917,24.07189748642961
STAT,1830,47,40-44,1877,0.1420813884774981
SIM,1922,37,na,1959,4316
STAT,1822,48,45-49,1870,0.3316047669048204
STAT,1849,20,30-34,1869,16.962079677815506
SIM,1902,60,na,1962,2866
STAT,1917,43,20-24,1960,0.018778073645886177
SIM,1865,36,15-19,1901,1
SIM,1944,26,30-34,1970,56
STAT,1895,1,na,1896,3622.8340809881
STAT,1886,22,na,1908,2553.8081043775715
SIM,1901,38,na,1939,3531
STAT,1861,22,20-24,1883,59.67919034205702
STAT,1899,18,15-19,1917,8.268666791078784
STAT,1930,42,50-100,1972,0.157651713977987
SIM,1926,27,25-29,1953,115
SIM,1923,30,40-44,1953,7
STAT,1793,68,na,1861,770.2762259209661
SIM,1802,66,na,1868,714
STAT,1806,65,na,1871,856.6606406602485
SIM,1914,19,20-24,1933,38
STAT,1907,31,45-49,1938,1.5059676377675377
SIM,1878,20,25-29,1898,62
STAT,1917,37,35-39,1954,2.5637568569633693
STAT,1867,101,na,1968,3.5530259560936104
SIM,1879,41,25-29,1920,3
STAT,1852,44,15-19,1896,0.010975051755098712
STAT,1925,17,15-19,1942,55.93284957304223
STAT,1930,19,50-100,1949,0.49136740210002683
SIM,1897,31,40-44,1928,6
STAT,1836,53,na,1889,1329.4211968957384
SIM,1837,30,30-34,1867,24
STAT,1841,23,50-100,1864,0.3786864205048203
SIM,1819,50,na,1869,1387
STAT,1906,19,20-24,1925,26.182963445399444
STAT,1938,21,na,1959,3688.024015854029
SIM,1853,31,na,1884,2050
SIM,1857,20,30-34,1877,2
STAT,1923,48,15-19,1971,4.3845727873207085E-4
SIM,1880,32,25-29,1912,16
STAT,1831,31,25-29,1862,9.502476736229367
SIM,1867,40,45-49,1907,2
STAT,1858,107,na,1965,0.02640724092499513
SIM,1788,72,na,1860,639
STAT,1872,53,40-44,1925,0.010590956961217693
STAT,1895,42,20-24,1937,0.014660719669809275
SIM,1841,39,30-34,1880,10
SIM,1859,27,25-29,1886,46
SIM,1929,5,na,1934,5474
STAT,1954,17,na,1971,4641.274842084234
STAT,1944,17,25-29,1961,47.58008567698891
SIM,1878,31,30-34,1909,30
SIM,1872,35,50-100,1907,2
STAT,1850,31,35-39,1881,8.051979299536702
STAT,1942,15,25-29,1957,46.22818500063209
SIM,1952,17,25-29,1969,1
STAT,1821,54,na,1875,1218.0577847874165
STAT,1811,47,30-34,1858,0.2689066936289805
STAT,1857,40,35-39,1897,1.4572670079288408
SIM,1861,23,25-29,1884,59
SIM,1884,36,25-29,1920,7
STAT,1902,15,20-24,1917,25.623572237002996
SIM,1855,37,50-100,1892,3
STAT,1848,30,40-44,1878,4.01376714137987
SIM,1918,36,30-34,1954,4
STAT,1856,21,35-39,1877,5.466587126353822
STAT,1915,30,40-44,1945,4.099751567782729
SIM,1950,15,25-29,1965,70
STAT,1833,39,30-34,1872,4.320161994070084
STAT,1865,45,na,1910,2103.901890964576
STAT,1824,68,na,1892,841.448969421253
SIM,1791,76,na,1867,347
SIM,1830,48,45-49,1878,1
STAT,1912,26,45-49,1938,1.7427129427806924
SIM,1876,20,40-44,1896,4
STAT,1800,101,na,1901,0.2750221833938398
SIM,1947,24,40-44,1971,6
STAT,1871,41,30-34,1912,1.167024791547918
STAT,1932,16,45-49,1948,0.6762347007054984
SIM,1823,65,na,1888,944
STAT,1806,87,na,1893,62.60301497965238
STAT,1862,32,15-19,1894,0.12366682860239887
SIM,1920,26,45-49,1946,6
SIM,1935,6,na,1941,5610
STAT,1872,23,35-39,1895,5.947931778405629
STAT,1868,20,40-44,1888,2.0598688206626936
STAT,1921,35,35-39,1956,2.7606967574022896
SIM,1838,79,na,1917,390
SIM,1879,21,20-24,1900,131
STAT,1915,15,50-100,1930,0.08038842976407935
STAT,1928,44,35-39,1972,0.2609730369985305
SIM,1890,20,25-29,1910,4
STAT,1871,45,na,1916,2296.18553120904
SIM,1837,47,50-100,1884,1
STAT,1828,51,20-24,1879,5.685428875942891E-4
SIM,1871,82,na,1953,652
STAT,1936,14,na,1950,3856.5856575778384
STAT,1886,44,na,1930,2462.017335005623
STAT,1829,35,25-29,1864,2.588675453555518
SIM,1856,30,40-44,1886,5
SIM,1926,22,30-34,1948,52
SIM,1933,19,30-34,1952,21
SIM,1936,29,50-100,1965,1
STAT,1943,27,35-39,1970,16.313400189597928
STAT,1925,19,30-34,1944,14.941580567646854
SIM,1911,27,30-34,1938,52
STAT,1811,48,50-100,1859,0.670403030773469
STAT,1896,26,25-29,1922,57.190556922560376
SIM,1908,39,25-29,1947,1
STAT,1775,87,na,1862,50.67211070653407
STAT,1877,49,50-100,1926,0.25444011033540853
STAT,1861,100,na,1961,2.283158195100644
STAT,1903,27,30-34,1930,36.51790095992034
SIM,1883,24,15-19,1907,3
SIM,1854,16,na,1870,2387
SIM,1904,30,30-34,1934,34
STAT,1829,47,50-100,1876,0.198762048239285
SIM,1854,10,na,1864,2479
STAT,1900,39,30-34,1939,1.6101562717840474
SIM,1820,85,na,1905,167
STAT,1925,47,35-39,1972,0.15939507648945586
SIM,1865,97,na,1962,4
STAT,1842,21,35-39,1863,5.813691778425851
STAT,1875,39,25-29,1914,2.98421001629216
STAT,1880,20,15-19,1900,3.557753128201331
STAT,1845,22,15-19,1867,3.200026292585394
STAT,1872,38,45-49,1910,2.028090446964869
SIM,1937,23,35-39,1960,16
STAT,1921,17,50-100,1938,0.4357858620911856
SIM,1872,35,na,1907,2471
STAT,1874,25,45-49,1899,1.1642951101058336
STAT,1932,23,50-100,1955,0.8777397981850392
SIM,1830,44,40-44,1874,6
STAT,1856,34,40-44,1890,3.4431245294436352
STAT,1859,35,20-24,1894,0.633986524967707
STAT,1796,70,na,1866,662.6714235101321
SIM,1860,8,na,1868,2410
STAT,1831,42,40-44,1873,1.906268813722479
STAT,1915,34,45-49,1949,1.621389957783402
SIM,1912,20,25-29,1932,107
STAT,1889,40,30-34,1929,1.4633654808999306
SIM,1924,22,na,1946,4746
STAT,1849,27,na,1876,1990.863384861589
SIM,1923,34,45-49,1957,5
STAT,1839,37,45-49,1876,1.644091689177435
STAT,1941,31,35-39,1972,9.79414112638619
STAT,1871,51,25-29,1922,0.0035964168126823514
STAT,1911,18,25-29,1929,8.82234446607129
STAT,1841,47,na,1888,1668.7067026481607
STAT,1920,25,40-44,1945,5.253251418495412
STAT,1857,48,20-24,1905,0.009440497451056904
STAT,1918,44,40-44,1962,0.2704796922028875
SIM,1940,31,40-44,1971,7
SIM,1914,36,45-49,1950,3
SIM,1848,40,35-39,1888,1
STAT,1869,21,45-49,1890,0.6888713995622443
SIM,1924,36,30-34,1960,4
SIM,1907,39,35-39,1946,6
SIM,1816,48,25-29,1864,1
SIM,1783,88,na,1871,36
STAT,1784,85,na,1869,72.93034465636467
STAT,1934,27,35-39,1961,20.596825357948923
STAT,1822,44,40-44,1866,3.3005314982754905
STAT,1858,63,na,1921,1443.515821418949
SIM,1853,38,50-100,1891,1
SIM,1891,38,20-24,1929,1
STAT,1935,34,15-19,1969,0.18107169530241854
SIM,1864,21,35-39,1885,10
SIM,1883,39,25-29,1922,3
SIM,1885,18,25-29,1903,7
SIM,1877,82,na,1959,574
STAT,1825,45,20-24,1870,0.01586280398367825
SIM,1799,87,na,1886,116
SIM,1853,22,15-19,1875,4
STAT,1930,29,15-19,1959,0.914619439328626
STAT,1932,31,40-44,1963,5.308401106256173
SIM,1888,46,50-100,1934,1
SIM,1910,34,35-39,1944,2
SIM,1880,38,45-49,1918,2
SIM,1844,24,15-19,1868,4
SIM,1917,46,40-44,1963,2
SIM,1876,25,20-24,1901,16
SIM,1838,95,na,1933,4
STAT,1814,45,45-49,1859,0.7268357920793663
STAT,1833,21,40-44,1854,2.7336379909843664
STAT,1920,16,25-29,1936,49.737926980842396
STAT,1808,48,25-29,1856,0.14707023776232048
SIM,1928,23,40-44,1951,8
STAT,1861,16,20-24,1877,17.278849109511754
STAT,1902,41,25-29,1943,0.06444336740572064
SIM,1841,21,40-44,1862,3
SIM,1912,37,na,1949,3832
STAT,1948,18,20-24,1966,158.24649170961868
SIM,1781,77,na,1858,248
SIM,1908,26,20-24,1934,21
STAT,1904,20,25-29,1924,84.19623574341941
SIM,1942,27,35-39,1969,20
STAT,1936,19,na,1955,3574.942041934695
SIM,1933,29,35-39,1962,1
STAT,1862,28,50-100,1890,0.5535534997098903
STAT,1868,28,25-29,1896,41.072039079515555
SIM,1795,73,na,1868,508
STAT,1892,36,20-24,1928,0.9903216482933856
STAT,1836,42,15-19,1878,0.010226430077431214
STAT,1853,32,na,1885,2060.5318222521837
STAT,1883,38,20-24,1921,0.7677659914915387
STAT,1885,65,na,1950,1720.0080109723958
STAT,1844,19,25-29,1863,5.516421892642525
SIM,1832,23,40-44,1855,3
SIM,1835,24,20-24,1859,59
SIM,1901,65,na,1966,2778
STAT,1848,35,45-49,1883,1.6304068271815289
SIM,1907,15,20-24,1922,24
STAT,1926,34,20-24,1960,3.0049438080921913
STAT,1909,37,25-29,1946,0.9504814856195365
STAT,1946,20,30-34,1966,32.65426683790783
STAT,1853,53,30-34,1906,0.0049110657829315955
STAT,1954,15,40-44,1969,1.7646533455646858
SIM,1910,25,20-24,1935,20
SIM,1882,22,40-44,1904,4
SIM,1874,40,35-39,1914,6
STAT,1912,21,15-19,1933,5.219898592260649
STAT,1909,44,15-19,1953,0.0014469271183029876
STAT,1906,41,40-44,1947,0.23297388748890635
SIM,1920,21,15-19,1941,2
STAT,1865,27,45-49,1892,1.028032802630143
STAT,1883,22,35-39,1905,5.841113856189966
STAT,1902,34,35-39,1936,8.2940448987057
SIM,1896,73,na,1969,1931
STAT,1937,18,45-49,1955,0.4944035469118043
STAT,1944,18,na,1962,4040.014080152851
SIM,1845,16,30-34,1861,2
STAT,1866,46,20-24,1912,0.011323701699038074
SIM,1936,28,50-100,1964,3
STAT,1850,54,45-49,1904,0.010616116679691966
STAT,1866,40,35-39,1906,1.7211149604962757
STAT,1934,18,20-24,1952,186.52042917837048
SIM,1868,30,na,1898,2435
STAT,1907,29,15-19,1936,0.6690586565697879
SIM,1843,30,50-100,1873,3
STAT,1923,7,na,1930,4789.125439094846
SIM,1824,31,35-39,1855,10
STAT,1897,22,35-39,1919,7.95980832344283
STAT,1841,46,15-19,1887,3.005051452760963E-4
SIM,1922,43,na,1965,4288
SIM,1856,35,45-49,1891,9
SIM,1886,59,na,1945,2157
SIM,1924,38,na,1962,4549
SIM,1851,77,na,1928,560
STAT,1822,108,na,1930,0.0010650447083787084
STAT,1854,6,na,1860,2284.069905694914
STAT,1943,29,25-29,1972,71.4480370554386
STAT,1805,92,na,1897,16.740019086970058
SIM,1847,68,na,1915,1050
STAT,1826,54,na,1880,1325.41935259227
SIM,1793,62,na,1855,788
SIM,1915,29,15-19,1944,1
SIM,1839,33,na,1872,1988
STAT,1905,27,na,1932,3516.171036903186
SIM,1768,95,na,1863,2
STAT,1916,36,30-34,1952,1.9138114847752057
STAT,1851,21,na,1872,2121.7856178829484
STAT,1877,25,15-19,1902,0.48331314870901626
SIM,1859,41,na,1900,2199
SIM,1882,48,50-100,1930,1
STAT,1913,19,15-19,1932,9.415304521747643
SIM,1910,16,35-39,1926,2
STAT,1805,52,40-44,1857,0.03709954881859182
STAT,1822,40,na,1862,1644.9921576545698
SIM,1885,25,15-19,1910,1
STAT,1915,41,35-39,1956,0.20717382936897596
SIM,1917,37,25-29,1954,1
STAT,1900,46,20-24,1946,0.009598199149661786
SIM,1829,43,na,1872,1359
SIM,1934,34,20-24,1968,5
STAT,1876,13,na,1889,2724.0509233536154
STAT,1835,90,na,1925,58.741416754870436
STAT,1902,25,20-24,1927,16.991901448693856
SIM,1838,31,35-39,1869,9
STAT,1929,23,35-39,1952,12.107115687566925
STAT,1883,2,na,1885,3155.4507525734425
STAT,1872,43,40-44,1915,2.283113604438343
STAT,1891,38,50-100,1929,1.542945421955607
SIM,1783,72,na,1855,504
STAT,1881,54,45-49,1935,0.013919660656745525
STAT,1903,23,15-19,1926,4.769345087663444
SIM,1902,26,25-29,1928,73
STAT,1933,19,15-19,1952,61.623929164035616
SIM,1931,15,40-44,1946,1
STAT,1882,47,15-19,1929,3.956969957775084E-4
SIM,1861,51,na,1912,2335
SIM,1898,44,na,1942,3521
STAT,1865,47,15-19,1912,3.6863417898837963E-4
STAT,1928,25,40-44,1953,5.897047075262135
STAT,1919,35,na,1954,4147.503779763736
STAT,1932,26,45-49,1958,2.3087025376004084
SIM,1888,38,45-49,1926,7
SIM,1874,40,50-100,1914,3
SIM,1850,37,20-24,1887,1
SIM,1872,39,na,1911,2483
STAT,1904,39,15-19,1943,0.017542570090848374
SIM,1880,43,40-44,1923,7
SIM,1951,16,20-24,1967,211
STAT,1941,25,50-100,1966,1.0513808503819395
SIM,1879,32,35-39,1911,22
STAT,1917,36,20-24,1953,0.28075824400359684
SIM,1930,27,15-19,1957,1
STAT,1869,27,30-34,1896,24.80186538449244
STAT,1926,16,20-24,1942,169.98925079145874
STAT,1804,53,35-39,1857,0.02474098720478705
SIM,1843,26,20-24,1869,10
SIM,1897,20,35-39,1917,12
STAT,1858,43,50-100,1901,0.8485036789503873
STAT,1896,47,45-49,1943,0.1785284069079731
SIM,1836,29,na,1865,2001
STAT,1850,16,45-49,1866,0.06039904136749937
STAT,1892,20,35-39,1912,7.505539114223592
STAT,1842,37,20-24,1879,0.709127919133643
STAT,1923,40,na,1963,4441.255819501261
SIM,1836,23,50-100,1859,2
SIM,1934,16,20-24,1950,180
STAT,1877,43,15-19,1920,0.014506433136323608
STAT,1943,16,20-24,1959,146.72040773163246
STAT,1920,23,15-19,1943,6.020532688139635
STAT,1835,26,20-24,1861,11.478934048822117
STAT,1916,29,40-44,1945,4.8829158339702605
STAT,1839,20,20-24,1859,61.99550738604382
SIM,1919,25,40-44,1944,7
STAT,1942,26,30-34,1968,41.97565302097006
STAT,1923,15,40-44,1938,1.6835618319845536
STAT,1851,38,25-29,1889,2.376024829225856
SIM,1925,18,20-24,1943,191
STAT,1815,86,na,1901,114.72672549586434
SIM,1893,17,20-24,1910,34
SIM,1942,18,20-24,1960,180
STAT,1869,41,15-19,1910,0.013662960810744505
STAT,1918,42,15-19,1960,0.0016662020870512526
SIM,1878,19,45-49,1897,1
STAT,1946,13,na,1959,4444.427557023156
SIM,1906,41,35-39,1947,2
SIM,1852,15,na,1867,2393
STAT,1845,40,15-19,1885,0.01127311671973865
SIM,1840,34,na,1874,1761
STAT,1903,33,40-44,1936,3.5958781042770425
STAT,1937,20,na,1957,3629.849301684796
SIM,1844,48,na,1892,1765
STAT,1910,18,35-39,1928,0.8457894043880652
SIM,1889,41,35-39,1930,3
STAT,1878,20,50-100,1898,0.4356004498765825
SIM,1877,23,15-19,1900,4
SIM,1911,33,40-44,1944,10
SIM,1876,29,50-100,1905,2
STAT,1934,36,20-24,1970,0.37131398371803676
STAT,1830,50,25-29,1880,0.0029554560004531423
SIM,1902,35,40-44,1937,7
SIM,1918,38,na,1956,4161
STAT,1794,75,na,1869,430.93634144552686
SIM,1917,52,na,1969,3648
STAT,1894,15,20-24,1909,23.37178830353438
STAT,1885,17,20-24,1902,18.043723321132052
STAT,1846,78,na,1924,558.7480232008069
SIM,1897,28,45-49,1925,2
STAT,1917,16,na,1933,4251.817083317407
STAT,1942,19,40-44,1961,1.4903016271298868
SIM,1904,18,na,1922,3913
SIM,1847,20,20-24,1867,71
SIM,1916,37,35-39,1953,1
STAT,1917,18,20-24,1935,29.694569866091655
STAT,1912,23,40-44,1935,3.277036039547882
STAT,1828,40,15-19,1868,0.011665649767990094
STAT,1923,33,40-44,1956,4.574503958539718
STAT,1921,21,na,1942,4221.652395008547
STAT,1810,55,na,1865,1090.77340394454
STAT,1850,83,na,1933,298.615535476115
SIM,1823,50,na,1873,1451
SIM,1852,24,20-24,1876,62
STAT,1925,35,na,1960,4614.875544383864
STAT,1814,69,na,1883,809.2554551503698
STAT,1840,35,45-49,1875,1.732277108782623
SIM,1892,43,na,1935,3365
STAT,1889,20,35-39,1909,7.397418458680935
STAT,1881,36,45-49,1917,1.9755939865430154
SIM,1905,25,40-44,1930,5
STAT,1887,60,na,1947,2180.1607609665803
STAT,1914,48,15-19,1962,3.7171087828383865E-4
STAT,1898,49,20-24,1947,0.009143215531688304
SIM,1871,97,na,1968,28
STAT,1870,47,25-29,1917,0.05717453178490346
STAT,1886,41,15-19,1927,0.014979494481461192
SIM,1911,16,25-29,1927,14
STAT,1871,44,35-39,1915,1.805172090558571
STAT,1906,44,na,1950,3397.20322827273
SIM,1901,36,35-39,1937,3
STAT,1908,46,20-24,1954,0.010268191738490187
SIM,1890,39,50-100,1929,5
SIM,1868,38,50-100,1906,4
SIM,1878,24,na,1902,2556
STAT,1844,24,20-24,1868,65.72071201612874
SIM,1883,20,35-39,1903,5
SIM,1941,19,15-19,1960,43
SIM,1901,18,35-39,1919,1
SIM,1946,21,35-39,1967,9
STAT,1889,28,45-49,1917,1.394216428306861
STAT,1895,31,15-19,1926,0.19032077829627544
STAT,1910,36,35-39,1946,2.3707069302840167
SIM,1911,23,15-19,1934,3
SIM,1920,23,40-44,1943,4
SIM,1873,46,50-100,1919,2
SIM,1936,25,40-44,1961,6
STAT,1840,53,45-49,1893,0.010275428140816167
STAT,1908,37,35-39,1945,2.30925236793577
SIM,1836,18,30-34,1854,3
STAT,1821,86,na,1907,116.91526998426977
SIM,1854,48,45-49,1902,1
STAT,1835,47,na,1882,1766.8414889476403
SIM,1916,28,20-24,1944,23
STAT,1900,43,na,1943,3255.574314958271
SIM,1884,24,na,1908,2550
STAT,1876,27,20-24,1903,12.358255511044963
STAT,1899,41,na,1940,3254.5421995004467
STAT,1858,59,na,1917,1572.2774023700372
STAT,1938,29,45-49,1967,1.74421503667968
STAT,1889,33,40-44,1922,5.441823851484043
STAT,1900,23,45-49,1923,0.9829309850961292
SIM,1928,37,50-100,1965,1
STAT,1770,113,na,1883,3.008118372361612E-4
SIM,1897,33,40-44,1930,13
SIM,1886,43,na,1929,2568
SIM,1847,37,45-49,1884,2
STAT,1917,45,35-39,1962,0.13807446118336938
STAT,1927,32,15-19,1959,0.1612494880097663
SIM,1950,19,40-44,1969,1
SIM,1918,25,50-100,1943,1
STAT,1886,23,15-19,1909,3.55131847996067
SIM,1894,23,15-19,1917,7
SIM,1881,12,na,1893,2377
STAT,1834,38,25-29,1872,2.3851904311223406
STAT,1882,36,50-100,1918,1.22609809193546
STAT,1908,28,20-24,1936,17.534265847036515
STAT,1810,52,20-24,1862,0.002209800401945743
STAT,1844,83,na,1927,307.6297424096231
STAT,1915,21,na,1936,3863.6309060842163
STAT,1937,27,50-100,1964,0.9896877321966516
STAT,1820,69,na,1889,802.1065561807775
STAT,1938,21,35-39,1959,9.50932379500062
SIM,1884,27,20-24,1911,12
SIM,1902,23,na,1925,3437
STAT,1846,48,45-49,1894,0.1666481515413004
SIM,1906,37,na,1943,3530
SIM,1907,36,30-34,1943,3
SIM,1841,24,45-49,1865,1
SIM,1964,3,na,1967,5239
STAT,1916,39,35-39,1955,2.5022275033730392
STAT,1875,36,20-24,1911,0.8109715521260146
STAT,1814,42,40-44,1856,7.710129082323332
STAT,1907,17,20-24,1924,26.555336005094162
SIM,1894,15,15-19,1909,10
SIM,1836,20,45-49,1856,1
STAT,1910,41,30-34,1951,0.12394103239077672
SIM,1810,102,na,1912,5
STAT,1882,24,40-44,1906,2.0580841871339564
SIM,1814,41,na,1855,1417
STAT,1869,19,30-34,1888,1.5728602195888657
STAT,1839,46,50-100,1885,0.17492493742090695
STAT,1827,71,na,1898,862.7074392648613
STAT,1840,50,40-44,1890,0.007684540612261823
STAT,1892,49,50-100,1941,0.17343214778110674
SIM,1825,29,na,1854,1681
SIM,1883,42,50-100,1925,4
STAT,1921,20,25-29,1941,107.09725182374841
STAT,1820,53,20-24,1873,0.0012684246532881725
SIM,1823,33,40-44,1856,8
SIM,1861,29,50-100,1890,1
STAT,1902,4,na,1906,3784.6270884952946
STAT,1853,28,na,1881,2094.3982054297
STAT,1804,79,na,1883,292.9462319026351
SIM,1873,52,na,1925,2147
STAT,1842,45,20-24,1887,0.009656312940390552
SIM,1795,69,na,1864,697
SIM,1938,27,45-49,1965,3
SIM,1890,24,40-44,1914,7
STAT,1827,34,15-19,1861,0.199409915805611
STAT,1881,33,40-44,1914,4.259155679822033
STAT,1922,45,45-49,1967,0.25596336853866763
STAT,1911,15,20-24,1926,27.802051112827414
STAT,1809,54,50-100,1863,0.06162821988762653
STAT,1950,18,na,1968,4438.62757434078
STAT,1886,15,15-19,1901,6.4379731711085455
SIM,1832,25,50-100,1857,4
STAT,1829,33,50-100,1862,0.8369846419875315
STAT,1850,36,15-19,1886,0.04335649484554607
SIM,1910,31,30-34,1941,16
STAT,1824,46,15-19,1870,4.725102246616706E-4
STAT,1900,15,45-49,1915,0.09279186959480937
STAT,1875,75,na,1950,1077.8577632632482
SIM,1931,36,45-49,1967,2
SIM,1802,56,na,1858,1014
SIM,1806,48,50-100,1854,1
SIM,1847,46,50-100,1893,2
SIM,1833,21,35-39,1854,7
STAT,1969,3,na,1972,5012.200802921847
STAT,1847,31,35-39,1878,9.369123034247885
SIM,1935,7,na,1942,5590
SIM,1835,27,25-29,1862,42
STAT,1894,25,15-19,1919,0.5993958304168298
SIM,1915,17,20-24,1932,26
STAT,1874,22,40-44,1896,2.1704157955961842
SIM,1903,21,15-19,1924,5
STAT,1854,51,25-29,1905,0.0027238665252187814
STAT,1937,15,40-44,1952,1.394415436747869
SIM,1895,2,na,1897,3667
SIM,1888,21,20-24,1909,3
STAT,1903,31,15-19,1934,0.20735852448745906
STAT,1951,18,20-24,1969,164.6444495077552
SIM,1856,42,35-39,1898,4
STAT,1868,25,20-24,1893,11.508293023258133
STAT,1883,46,20-24,1929,0.012045688820655763
STAT,1943,26,20-24,1969,19.843241723137258
SIM,1901,17,20-24,1918,32
SIM,1859,20,40-44,1879,6
SIM,1863,15,na,1878,2353
STAT,1931,29,50-100,1960,1.309261750893801
SIM,1916,29,35-39,1945,20
STAT,1835,78,na,1913,582.1443423717028
SIM,1901,37,na,1938,3567
SIM,1870,96,na,1966,13
SIM,1855,31,35-39,1886,14
STAT,1830,43,35-39,1873,1.5399198747152196
STAT,1891,37,15-19,1928,0.07092309575525445
STAT,1922,27,15-19,1949,0.8150918314766631
SIM,1834,34,na,1868,1800
SIM,1882,29,na,1911,2257
STAT,1848,42,35-39,1890,1.4058725186733128
STAT,1876,52,50-100,1928,0.01582498471363049
SIM,1849,16,15-19,1865,5
STAT,1851,53,20-24,1904,5.990214410300448E-4
STAT,1863,15,50-100,1878,0.05059802419118676
STAT,1848,32,40-44,1880,3.9312710169154736
STAT,1908,29,35-39,1937,14.369154507106744
SIM,1910,28,25-29,1938,71
STAT,1923,36,45-49,1959,0.8066715261554931
SIM,1822,42,40-44,1864,4
STAT,1822,52,40-44,1874,0.014429611536097427
SIM,1856,32,40-44,1888,7
SIM,1933,26,30-34,1959,97
SIM,1846,35,50-100,1881,1
STAT,1902,28,25-29,1930,60.64253307815495
STAT,1876,29,na,1905,2496.0654371150076
STAT,1899,57,na,1956,2829.6466984195213
SIM,1907,29,40-44,1936,6
SIM,1882,25,45-49,1907,1
SIM,1924,39,35-39,1963,6
STAT,1911,35,40-44,1946,1.4888702386023103
SIM,1883,82,na,1965,730
SIM,1948,16,20-24,1964,158
SIM,1846,20,30-34,1866,25
SIM,1826,34,20-24,1860,6
STAT,1866,23,na,1889,2227.502042529472
SIM,1838,48,na,1886,1515
SIM,1856,4,na,1860,2988
STAT,1867,102,na,1969,2.1971557209887274
SIM,1876,28,25-29,1904,80
SIM,1912,53,na,1965,3589
SIM,1931,18,45-49,1949,3
STAT,1893,56,na,1949,2639.5851489207075
SIM,1789,73,na,1862,475
STAT,1885,25,20-24,1910,12.021027386420334
STAT,1867,40,na,1907,2235.8831014985362
SIM,1883,36,20-24,1919,1
STAT,1902,16,35-39,1918,0.7913367153483032
STAT,1861,54,20-24,1915,6.049368454165625E-4
STAT,1925,44,30-34,1969,0.15739014580583743
SIM,1835,19,25-29,1854,7
SIM,1885,15,20-24,1900,31
STAT,1841,23,40-44,1864,1.9350874679946763
STAT,1868,89,na,1957,128.46947552616487
STAT,1816,64,na,1880,899.8257988689405
SIM,1907,38,na,1945,3577
STAT,1864,75,na,1939,933.8068407471022
SIM,1861,67,na,1928,1545
STAT,1918,47,45-49,1965,0.23601837065049083
STAT,1908,47,35-39,1955,0.11889949507016065
SIM,1927,27,50-100,1954,1
STAT,1838,20,30-34,1858,17.226318224587548
SIM,1828,65,na,1893,1011
SIM,1893,25,20-24,1918,22
STAT,1943,19,25-29,1962,46.8530125193709
SIM,1942,19,35-39,1961,9
STAT,1894,43,15-19,1937,0.0012493044600161369
STAT,1855,46,45-49,1901,0.18346621352403236
STAT,1923,18,45-49,1941,0.5969232118655908
SIM,1848,32,35-39,1880,6
STAT,1866,30,35-39,1896,9.605864763522742
STAT,1819,38,50-100,1857,3.15924350856971
SIM,1861,17,25-29,1878,11
STAT,1829,78,na,1907,519.6517576825684
STAT,1922,28,50-100,1950,1.1451835480244617
STAT,1882,84,na,1966,602.7461900852329
STAT,1909,19,25-29,1928,8.620550081005268
STAT,1881,51,40-44,1932,0.010432862391265037
STAT,1853,17,25-29,1870,5.715798607025771
STAT,1929,16,45-49,1945,0.6518276388928756
SIM,1870,43,30-34,1913,3
SIM,1838,44,40-44,1882,6
STAT,1910,33,30-34,1943,15.428482458563197
SIM,1867,35,20-24,1902,1
SIM,1923,26,45-49,1949,2
STAT,1834,35,20-24,1869,0.6587940732597396
STAT,1765,105,na,1870,0.006938677137550137
STAT,1927,36,30-34,1963,2.313602894335364
SIM,1904,19,15-19,1923,5
SIM,1865,81,na,1946,403
SIM,1887,21,30-34,1908,29
SIM,1827,38,50-100,1865,1
STAT,1791,105,na,1896,0.005173282215031504
SIM,1877,21,50-100,1898,1
SIM,1901,49,50-100,1950,2
STAT,1879,21,30-34,1900,19.051562406270378
SIM,1813,87,na,1900,38
STAT,1915,26,45-49,1941,1.8043251242326837
SIM,1917,19,25-29,1936,64
STAT,1935,27,25-29,1962,91.49824396194948
STAT,1837,26,na,1863,1864.5770259397198
STAT,1889,36,45-49,1925,2.524170348538996
SIM,1890,64,na,1954,2181
STAT,1904,29,15-19,1933,0.6586019438364621
SIM,1771,87,na,1858,37
SIM,1943,27,25-29,1970,107
STAT,1900,59,na,1959,2838.3107286246836
STAT,1831,37,45-49,1868,1.753595553662032
SIM,1841,47,na,1888,1719
SIM,1841,31,35-39,1872,14
STAT,1917,39,25-29,1956,1.0372973389045061
STAT,1892,30,35-39,1922,13.052159134720988
STAT,1873,49,15-19,1922,4.0506175523052164E-4
STAT,1920,36,na,1956,4207.435101930003
STAT,1812,105,na,1917,0.013373340130501324
SIM,1889,26,45-49,1915,3
SIM,1871,81,na,1952,776
STAT,1828,65,na,1893,930.6061462209307
STAT,1829,53,40-44,1882,0.0073473064755386576
STAT,1860,25,20-24,1885,9.956798483799846
SIM,1914,41,40-44,1955,2
SIM,1804,83,na,1887,179
SIM,1895,48,50-100,1943,1
STAT,1816,47,20-24,1863,0.024676362783511343
SIM,1888,54,na,1942,2402
STAT,1897,35,40-44,1932,6.027782014005115
STAT,1915,16,45-49,1931,0.10695091064959159
STAT,1896,44,40-44,1940,0.20760830134877983
STAT,1824,90,na,1914,43.41082344722193
SIM,1923,16,45-49,1939,1
STAT,1886,43,na,1929,2477.6762488986624
SIM,1925,39,25-29,1964,3
SIM,1859,57,na,1916,1847
STAT,1926,46,40-44,1972,0.19895176521325758
STAT,1805,96,na,1901,3.4512084979248265
SIM,1897,36,45-49,1933,1
STAT,1833,31,35-39,1864,8.745034820186671
STAT,1795,109,na,1904,1.2728044043940572E-4
STAT,1827,27,25-29,1854,141.11812403505155
STAT,1863,45,40-44,1908,0.15465677650236548
STAT,1938,26,40-44,1964,4.7126218008064855
STAT,1910,15,30-34,1925,2.474715369445245
STAT,1833,23,50-100,1856,0.38505485660320965
STAT,1802,72,na,1874,505.2785761935759
SIM,1899,7,na,1906,3646
STAT,1942,29,35-39,1971,16.06062795571985
SIM,1877,19,30-34,1896,3
STAT,1768,90,na,1858,38.6082992720628
STAT,1894,18,25-29,1912,7.416501982716726
SIM,1910,41,25-29,1951,1
SIM,1928,30,30-34,1958,24
STAT,1820,54,50-100,1874,0.02544838901181761
STAT,1887,48,50-100,1935,0.27722588138921794
SIM,1777,88,na,1865,10
SIM,1907,22,na,1929,3551
STAT,1934,37,35-39,1971,3.4038898938418876
STAT,1871,36,35-39,1907,7.181761993658101
SIM,1881,44,na,1925,2079
SIM,1919,23,na,1942,3993
STAT,1912,20,50-100,1932,0.6471246528833444
STAT,1876,60,na,1936,2009.079108539837
SIM,1908,44,20-24,1952,1
SIM,1848,85,na,1933,209
SIM,1911,36,45-49,1947,3
SIM,1832,70,na,1902,834
STAT,1887,49,45-49,1936,0.149000730987317
STAT,1920,37,35-39,1957,2.702531221769308
SIM,1836,84,na,1920,183
SIM,1864,34,40-44,1898,5
SIM,1905,28,45-49,1933,2
SIM,1936,21,25-29,1957,89
STAT,1870,99,na,1969,11.815346859813157
STAT,1934,19,35-39,1953,5.7570484838546365
SIM,1878,16,40-44,1894,2
SIM,1951,19,25-29,1970,84
STAT,1852,5,na,1857,2450.0384681146716
STAT,1853,42,15-19,1895,0.011565267692777008
SIM,1897,43,35-39,1940,1
STAT,1833,24,45-49,1857,0.632810369138849
STAT,1911,23,20-24,1934,107.23705370356515
STAT,1903,36,45-49,1939,0.6269751165008386
STAT,1847,63,na,1910,1391.4236725208473
SIM,1842,84,na,1926,300
SIM,1913,22,na,1935,3876
SIM,1935,36,30-34,1971,4
STAT,1853,24,15-19,1877,3.2216481054778514
STAT,1873,21,35-39,1894,6.053564053559707
SIM,1861,24,15-19,1885,4
SIM,1889,33,35-39,1922,17
STAT,1846,46,na,1892,1613.478100488201
STAT,1932,21,na,1953,4901.20337188911
STAT,1936,31,25-29,1967,9.161833320313745
SIM,1919,28,45-49,1947,6
STAT,1845,54,35-39,1899,0.00654168331103265
STAT,1889,43,35-39,1932,2.2654016179116665
STAT,1849,11,na,1860,2291.7395668709255
STAT,1941,24,45-49,1965,1.1854681019957414
STAT,1832,48,15-19,1880,3.1350966144949415E-4
STAT,1840,32,40-44,1872,3.800981538420145
SIM,1894,14,na,1908,3486
SIM,1905,20,35-39,1925,8
STAT,1857,46,na,1903,1797.5798618973176
STAT,1928,21,25-29,1949,117.99165515766306
STAT,1924,17,20-24,1941,164.71738847850898
SIM,1868,25,15-19,1893,5
SIM,1824,44,na,1868,1478
SIM,1853,20,45-49,1873,1
SIM,1818,36,50-100,1854,4
STAT,1818,37,25-29,1855,10.82551775653058
STAT,1907,31,35-39,1938,8.745750423500864
SIM,1868,62,na,1930,1738
STAT,1897,21,20-24,1918,94.28295475846555
SIM,1881,26,45-49,1907,1
STAT,1859,112,na,1971,3.937260331623769E-4
STAT,1883,23,50-100,1906,0.4069228159276857
STAT,1900,28,na,1928,3362.5459406990353
SIM,1879,40,35-39,1919,5
STAT,1826,85,na,1911,159.8863521037627
SIM,1856,21,25-29,1877,83
SIM,1906,31,40-44,1937,9
STAT,1821,42,30-34,1863,1.9948348356642644
SIM,1865,22,40-44,1887,2
SIM,1908,27,35-39,1935,31
STAT,1835,62,na,1897,1361.7801164036175
SIM,1898,17,20-24,1915,35
STAT,1896,39,45-49,1935,2.6588984819799877
STAT,1874,58,na,1932,2059.790097962765
STAT,1908,44,30-34,1952,0.11913275231327324
STAT,1882,27,45-49,1909,1.103504543929724
SIM,1935,18,50-100,1953,3
SIM,1823,86,na,1909,91
STAT,1864,31,35-39,1895,9.223622594313127
STAT,1838,23,35-39,1861,5.522821640753737
STAT,1853,87,na,1940,147.72735574731354
SIM,1934,35,35-39,1969,7
STAT,1829,48,45-49,1877,0.1885475817766123
STAT,1906,38,15-19,1944,0.01790776127655417
SIM,1828,58,na,1886,1296
STAT,1896,23,50-100,1919,0.5477400502938883
STAT,1848,21,25-29,1869,54.573817828102534
SIM,1891,33,50-100,1924,5
STAT,1926,35,35-39,1961,3.0208381540884144
STAT,1893,27,20-24,1920,15.182216205767395
STAT,1923,38,50-100,1961,0.49585708133216
SIM,1929,26,40-44,1955,5
SIM,1856,77,na,1933,743
STAT,1903,37,35-39,1940,2.2138619108882667
STAT,1844,34,15-19,1878,0.1292518476838207
STAT,1867,32,15-19,1899,0.1363883449148486
STAT,1863,39,50-100,1902,1.0871041717141021
STAT,1914,36,na,1950,3850.9923735983
STAT,1885,28,25-29,1913,42.90194085197201
STAT,1889,25,40-44,1914,3.8004505248500053
STAT,1851,27,20-24,1878,11.332355752955952
SIM,1941,21,35-39,1962,13
STAT,1779,108,na,1887,0.004169324834306476
STAT,1870,24,15-19,1894,3.269397670320951
SIM,1913,22,35-39,1935,10
SIM,1850,88,na,1938,86
STAT,1800,93,na,1893,14.085697988505636
STAT,1888,78,na,1966,1307.4111880321946
STAT,1871,14,na,1885,2643.8971731060547
SIM,1946,24,50-100,1970,2
STAT,1922,42,40-44,1964,0.29293741218229724
STAT,1904,47,15-19,1951,3.283525110224541E-4
SIM,1890,27,45-49,1917,1
STAT,1843,66,na,1909,1323.1286549374736
SIM,1829,42,50-100,1871,2
SIM,1919,16,na,1935,4510
SIM,1823,36,45-49,1859,3
STAT,1861,46,20-24,1907,0.010144339398665042
SIM,1864,20,20-24,1884,69
STAT,1847,34,50-100,1881,0.7477213567229253
STAT,1875,20,35-39,1895,6.1462644136818785
SIM,1812,45,35-39,1857,1
SIM,1832,63,na,1895,1117
SIM,1897,25,40-44,1922,7
SIM,1892,26,20-24,1918,20
STAT,1848,45,50-100,1893,0.19281633288782266
STAT,1868,24,50-100,1892,0.39485025732691836
STAT,1961,9,na,1970,5177.338242151863
STAT,1905,22,35-39,1927,8.597672825453872
STAT,1880,65,na,1945,1811.6898601615114
SIM,1912,29,15-19,1941,1
STAT,1884,79,na,1963,957.5664280935215
SIM,1856,76,na,1932,833
SIM,1892,28,na,1920,3466
SIM,1915,24,45-49,1939,1
STAT,1855,38,45-49,1893,1.5376825380432457
STAT,1913,17,45-49,1930,0.10419446554017585
SIM,1879,22,35-39,1901,1
SIM,1920,25,30-34,1945,5
SIM,1916,26,30-34,1942,6
STAT,1795,92,na,1887,10.367638396016753
SIM,1942,19,na,1961,4228
STAT,1764,93,na,1857,10.553469097602669
STAT,1858,31,na,1889,1950.6946185826287
STAT,1939,17,45-49,1956,0.510093790527047
STAT,1853,47,25-29,1900,0.04807235838669085
SIM,1788,88,na,1876,112
SIM,1877,7,na,1884,2771
STAT,1830,54,40-44,1884,0.007384585348431087
SIM,1958,2,na,1960,5147
STAT,1858,32,na,1890,1930.5439431726693
STAT,1821,55,na,1876,1194.2557942991018
STAT,1826,105,na,1931,0.017101008171718536
STAT,1852,42,50-100,1894,0.8500315534552056
SIM,1825,35,20-24,1860,1
STAT,1841,26,45-49,1867,1.0255889816228754
STAT,1873,37,50-100,1910,1.2697924408064036
STAT,1806,81,na,1887,223.0040967430746
STAT,1895,27,na,1922,3176.488555126899
SIM,1846,23,35-39,1869,11
STAT,1874,45,50-100,1919,0.25835788270536003
STAT,1880,48,45-49,1928,0.2498200475308352
SIM,1893,28,25-29,1921,66
STAT,1870,39,25-29,1909,2.842417426192755
SIM,1881,43,na,1924,2111
STAT,1855,98,na,1953,2.518263533561904
STAT,1889,22,25-29,1911,72.13769280056107
STAT,1857,18,20-24,1875,16.503556929612408
STAT,1791,71,na,1862,538.7768928976075
STAT,1795,85,na,1880,79.68450247222722
STAT,1913,30,50-100,1943,0.8459289339114022
SIM,1897,22,25-29,1919,97
STAT,1845,40,50-100,1885,0.8623933660418795
STAT,1914,35,na,1949,3868.9442750344606
STAT,1923,44,45-49,1967,0.1978118107279282
STAT,1845,20,45-49,1865,0.6862148850250126
STAT,1838,41,35-39,1879,1.576049401483599
STAT,1857,22,40-44,1879,1.9166168379351125
STAT,1881,25,40-44,1906,2.974500990946858
SIM,1826,37,25-29,1863,4
STAT,1932,28,15-19,1960,0.9425266566157211
STAT,1820,45,20-24,1865,0.02253752802850957
STAT,1930,37,15-19,1967,0.025546992707237762
STAT,1785,71,na,1856,597.622781316
STAT,1789,85,na,1874,70.57636193238628
SIM,1915,31,35-39,1946,15
STAT,1861,39,30-34,1900,4.447448136441848
STAT,1825,37,20-24,1862,1.1809976864376075
STAT,1818,44,15-19,1862,0.0326402088751629
STAT,1928,28,50-100,1956,1.2502078791949882
SIM,1822,64,na,1886,978
SIM,1879,31,20-24,1910,2
STAT,1866,39,na,1905,2194.5921131128557
SIM,1932,17,20-24,1949,215
SIM,1940,28,15-19,1968,1
STAT,1909,16,20-24,1925,27.18165935679442
SIM,1860,26,20-24,1886,13
STAT,1908,26,30-34,1934,38.22209683775758
SIM,1801,71,na,1872,672
STAT,1849,46,20-24,1895,0.009342777599925262
STAT,1852,112,na,1964,1.1688083922060355E-4
STAT,1912,25,30-34,1937,39.6571408690538
SIM,1939,29,25-29,1968,79
STAT,1824,99,na,1923,1.04279218420744
STAT,1862,43,30-34,1905,0.9911599147973205
SIM,1853,32,na,1885,1988
SIM,1829,41,35-39,1870,1
SIM,1830,40,25-29,1870,1
STAT,1832,25,45-49,1857,1.0431845643877677
STAT,1885,35,15-19,1920,0.05769571041108817
STAT,1878,79,na,1957,821.8656200671849
SIM,1846,41,35-39,1887,4
SIM,1831,85,na,1916,249
STAT,1911,24,35-39,1935,9.051910253045067
STAT,1866,16,20-24,1882,17.224188490470926
STAT,1921,39,15-19,1960,0.02183371888905331
SIM,1936,19,na,1955,3123
STAT,1888,32,35-39,1920,12.213446192727808
STAT,1896,47,50-100,1943,0.18579057908723498
STAT,1916,19,15-19,1935,9.773255589452345
STAT,1868,35,15-19,1903,0.0552348081617315
STAT,1849,16,20-24,1865,17.042440674687274
STAT,1876,5,na,1881,2882.4123008569973
SIM,1869,22,25-29,1891,64
SIM,1923,23,40-44,1946,5
STAT,1874,65,na,1939,1760.2004891384415
STAT,1836,84,na,1920,207.06107505916006
STAT,1825,35,50-100,1860,2.0060924688844204
STAT,1911,21,30-34,1932,27.888152291675247
STAT,1920,33,40-44,1953,4.355838042346421
SIM,1907,19,15-19,1926,11
STAT,1860,7,na,1867,2362.8051975609937
SIM,1896,32,35-39,1928,17
SIM,1857,16,20-24,1873,18
STAT,1932,23,40-44,1955,4.485250042406591
SIM,1794,88,na,1882,16
STAT,1846,15,40-44,1861,0.1662614431811247
SIM,1878,46,40-44,1924,1
SIM,1940,23,40-44,1963,3
SIM,1871,34,35-39,1905,16
STAT,1897,38,45-49,1935,2.70570162828743
SIM,1950,15,15-19,1965,50
STAT,1872,46,45-49,1918,0.24197847460919936
SIM,1914,15,40-44,1929,3
SIM,1853,25,na,1878,2061
STAT,1866,40,50-100,1906,1.004120450379874
STAT,1911,26,25-29,1937,65.69961357263634
SIM,1840,89,na,1929,48
STAT,1897,30,35-39,1927,13.924724960356437
STAT,1916,25,15-19,1941,0.7499346786796572
STAT,1934,34,30-34,1968,21.908759203206923
STAT,1925,26,30-34,1951,47.3782067288266
STAT,1886,19,30-34,1905,1.7118497170760103
SIM,1859,23,45-49,1882,1
SIM,1869,17,30-34,1886,4
STAT,1843,28,25-29,1871,41.72444262013852
STAT,1887,21,50-100,1908,0.4675662059868503
STAT,1822,40,25-29,1862,1.0600513610368982
SIM,1821,43,35-39,1864,1
STAT,1906,15,40-44,1921,0.2728446408838103
STAT,1852,10,na,1862,2355.1350366394017
STAT,1856,20,20-24,1876,65.02301962748541
SIM,1865,18,20-24,1883,25
STAT,1924,21,40-44,1945,4.060105289400833
SIM,1860,29,25-29,1889,33
SIM,1827,28,30-34,1855,45
SIM,1874,16,20-24,1890,26
STAT,1934,16,30-34,1950,16.8543132695338
STAT,1851,52,na,1903,1766.9440760291582
STAT,1852,29,25-29,1881,35.60304554038156
STAT,1880,34,35-39,1914,10.763565507934823
SIM,1843,70,na,1913,984
SIM,1862,77,na,1939,671
SIM,1942,16,30-34,1958,21
STAT,1838,35,50-100,1873,1.1113475241908872
STAT,1930,19,15-19,1949,59.520983352136426
STAT,1879,24,35-39,1903,6.183738215361252
SIM,1851,28,25-29,1879,45
STAT,1838,32,50-100,1870,0.8365368725523117
SIM,1887,24,35-39,1911,22
SIM,1934,17,35-39,1951,7
STAT,1935,24,20-24,1959,154.31266864667612
STAT,1877,33,15-19,1910,0.1500436931340814
STAT,1902,45,40-44,1947,0.14031660478425775
STAT,1873,80,na,1953,639.7829552447168
STAT,1926,17,35-39,1943,5.248383586515117
STAT,1877,94,na,1971,100.42168725677551
SIM,1943,24,20-24,1967,107
STAT,1818,99,na,1917,0.9651464539988306
STAT,1863,105,na,1968,0.2322934246892253
STAT,1824,48,50-100,1872,0.2823903635963857
SIM,1868,18,25-29,1886,11
STAT,1813,43,35-39,1856,6.288497253207844
STAT,1898,23,40-44,1921,2.865840636215838
STAT,1947,19,45-49,1966,0.5737379972185189
SIM,1924,19,15-19,1943,59
SIM,1894,19,30-34,1913,5
SIM,1908,45,35-39,1953,1
STAT,1840,24,40-44,1864,1.8796385355771246
STAT,1804,86,na,1890,74.8654236038316
SIM,1928,33,35-39,1961,20
STAT,1915,23,40-44,1938,3.5357338535981353
SIM,1825,38,25-29,1863,4
SIM,1862,44,35-39,1906,4
SIM,1889,30,30-34,1919,29
STAT,1820,38,na,1858,1532.743569134141
STAT,1879,42,35-39,1921,1.9285929904579862
STAT,1863,41,25-29,1904,0.5769773914011881
STAT,1884,29,25-29,1913,42.38894596219478
STAT,1912,30,25-29,1942,9.35228999014326
STAT,1878,50,20-24,1928,7.948281876834467E-4
STAT,1916,18,25-29,1934,9.357929373886718
STAT,1925,19,40-44,1944,1.7146076744758203
STAT,1796,108,na,1904,3.984775343850094E-4
SIM,1875,37,20-24,1912,1
STAT,1826,36,20-24,1862,0.7066842907256768
STAT,1813,50,25-29,1863,0.008848884567436011
STAT,1882,39,50-100,1921,1.20794405938012
STAT,1942,15,15-19,1957,48.41303296280505
SIM,1809,82,na,1891,99
SIM,1839,32,40-44,1871,5
SIM,1849,24,15-19,1873,3
SIM,1900,20,35-39,1920,8
STAT,1912,49,15-19,1961,3.59028592485507E-4
SIM,1887,42,35-39,1929,7
STAT,1836,32,15-19,1868,0.11204961237903828
STAT,1859,45,15-19,1904,3.2913465163798866E-4
STAT,1883,15,45-49,1898,0.06568936058351774
SIM,1892,29,25-29,1921,76
SIM,1924,18,25-29,1942,79
STAT,1867,37,20-24,1904,0.7382664225108178
SIM,1939,31,na,1970,3943
SIM,1888,82,na,1970,894
SIM,1902,54,na,1956,3037
STAT,1898,30,30-34,1928,24.28020692169544
SIM,1857,0,na,1857,3185
STAT,1880,41,25-29,1921,0.6915262543838375
STAT,1817,38,25-29,1855,9.431895005321026
STAT,1886,50,na,1936,2358.4926285409197
SIM,1853,18,30-34,1871,4
SIM,1889,23,40-44,1912,1
STAT,1905,15,45-49,1920,0.09668971437902119
STAT,1869,75,na,1944,1013.9258796689709
SIM,1920,30,25-29,1950,3
SIM,1837,33,50-100,1870,1
STAT,1927,41,50-100,1968,0.1505117536697149
SIM,1858,52,50-100,1910,1
STAT,1831,45,45-49,1876,0.19804551965561012
STAT,1907,54,na,1961,3250.4645484663156
STAT,1917,27,35-39,1944,16.067628484474305
STAT,1939,28,20-24,1967,18.711116234863713
SIM,1868,31,45-49,1899,2
STAT,1898,19,20-24,1917,24.326278230187896
SIM,1840,20,35-39,1860,7
STAT,1867,42,50-100,1909,1.010551783591579
STAT,1812,46,25-29,1858,0.13867737621079654
STAT,1881,1,na,1882,3334.396339692695
SIM,1903,30,25-29,1933,18
STAT,1911,33,15-19,1944,0.1271015830008766
SIM,1903,35,35-39,1938,4
SIM,1868,61,na,1929,1779
SIM,1874,62,na,1936,1858
STAT,1877,54,30-34,1931,0.006125109723371027
STAT,1865,46,50-100,1911,0.22804737036533762
STAT,1906,33,40-44,1939,3.6818745200754024
SIM,1839,28,20-24,1867,13
STAT,1951,16,30-34,1967,14.811112964201548
STAT,1887,16,40-44,1903,0.20959610314756694
STAT,1894,78,na,1972,1529.5120381443353
STAT,1871,13,na,1884,2655.9552097583573
STAT,1834,34,50-100,1868,0.7735775007439208
SIM,1817,86,na,1903,101
STAT,1880,50,50-100,1930,0.01642326035224496
SIM,1869,47,na,1916,2203
STAT,1896,36,40-44,1932,5.926431108362505
SIM,1822,49,na,1871,1349
STAT,1931,36,20-24,1967,0.35637354683464023
STAT,1833,67,na,1900,1041.005738934157
STAT,1926,42,25-29,1968,0.0898074658619685
SIM,1914,33,40-44,1947,10
SIM,1890,57,na,1947,2595
SIM,1872,36,50-100,1908,5
STAT,1845,18,30-34,1863,1.564761615189143
STAT,1770,93,na,1863,4.061020697361106
STAT,1826,31,15-19,1857,0.16748763021379873
STAT,1939,32,40-44,1971,4.073214588968037
SIM,1873,21,25-29,1894,79
SIM,1925,27,35-39,1952,26
STAT,1767,89,na,1856,23.57879364
SIM,1887,28,na,1915,2931
STAT,1839,34,40-44,1873,3.6074841180722466
STAT,1924,31,35-39,1955,10.883757413775497
STAT,1867,50,45-49,1917,0.014098733566526533
SIM,1869,26,40-44,1895,1
STAT,1833,45,50-100,1878,0.19524182936909323
STAT,1861,49,25-29,1910,0.047541179527037396
SIM,1906,34,45-49,1940,2
SIM,1929,29,45-49,1958,3
STAT,1857,50,35-39,1907,0.006957566809252316
STAT,1847,30,20-24,1877,2.526855340049105
SIM,1890,36,50-100,1926,7
STAT,1941,1,na,1942,4363.085100984098
STAT,1790,106,na,1896,0.002734674221198751
STAT,1865,21,25-29,1886,54.036160359330935
STAT,1867,79,na,1946,669.5552672392157
STAT,1899,37,20-24,1936,0.23242915974299636
SIM,1863,38,45-49,1901,3
STAT,1849,49,25-29,1898,0.043784681259548645
STAT,1858,24,15-19,1882,2.7467545806246423
STAT,1893,42,50-100,1935,1.3655202228864884
SIM,1870,37,25-29,1907,4
SIM,1934,37,25-29,1971,4
SIM,1937,20,30-34,1957,41
STAT,1887,19,45-49,1906,0.07427188394327539
SIM,1908,24,30-34,1932,40
STAT,1847,36,45-49,1883,1.629746832068418
STAT,1826,39,25-29,1865,2.4416166606361243
STAT,1879,64,na,1943,1853.707187995331
STAT,1946,23,35-39,1969,10.686952566982827
SIM,1917,34,20-24,1951,3
STAT,1893,22,15-19,1915,4.269420280412309
SIM,1865,25,45-49,1890,1
STAT,1916,15,20-24,1931,29.489851792069583
STAT,1921,43,35-39,1964,0.23107316246595558
STAT,1871,33,30-34,1904,17.569019009416913
SIM,1815,67,na,1882,773
STAT,1964,6,na,1970,5049.396226207218
STAT,1835,99,na,1934,1.4110557095449618
STAT,1863,7,na,1870,2526.2470073908735
STAT,1923,38,15-19,1961,0.022679536731998413
STAT,1831,85,na,1916,184.71758764967544
STAT,1857,25,45-49,1882,0.9243776445278175
SIM,1834,39,25-29,1873,1
SIM,1841,74,na,1915,744
STAT,1856,37,45-49,1893,1.5963911312116397
STAT,1860,66,na,1926,1356.6320626525194
SIM,1929,21,35-39,1950,18
SIM,1873,24,40-44,1897,2
STAT,1865,13,na,1878,2491.6311709661672
SIM,1919,21,25-29,1940,3
STAT,1837,33,na,1870,1792.9550650369795
STAT,1879,17,45-49,1896,0.06965697984921632
STAT,1852,21,15-19,1873,3.1800550470086497
STAT,1921,25,35-39,1946,17.190470950279902
STAT,1784,92,na,1876,9.48886443455669
STAT,1888,37,45-49,1925,2.40418523915413
STAT,1929,20,30-34,1949,37.29162324282845
SIM,1863,35,40-44,1898,8
STAT,1818,66,na,1884,903.0506809829602
STAT,1946,2,na,1948,4568.6038616737305
STAT,1935,34,na,1969,5329.1704640274975
STAT,1891,17,45-49,1908,0.08250218907646016
STAT,1840,47,15-19,1887,2.902625961493623E-4
STAT,1924,35,50-100,1959,0.5059853717847795
SIM,1767,89,na,1856,28
SIM,1891,40,35-39,1931,2
STAT,1837,19,35-39,1856,0.520185981751793
SIM,1832,26,45-49,1858,1
STAT,1865,24,40-44,1889,1.9249156769703764
STAT,1926,37,25-29,1963,1.2275759580040397
STAT,1894,48,25-29,1942,0.04209982281735752
STAT,1872,94,na,1966,70.38498540180764
STAT,1881,28,45-49,1909,1.0912122445685102
STAT,1908,19,40-44,1927,0.27518442682835526
SIM,1916,19,40-44,1935,3
STAT,1898,26,45-49,1924,1.536977826776319
STAT,1905,46,20-24,1951,0.010001384155597138
SIM,1888,30,35-39,1918,13
SIM,1812,42,30-34,1854,1
SIM,1845,33,na,1878,1983
STAT,1825,48,na,1873,1525.9631196951311
SIM,1871,29,na,1900,2169
STAT,1909,34,20-24,1943,2.3535439391712893
SIM,1932,31,35-39,1963,13
STAT,1918,48,35-39,1966,0.13962166774215193
STAT,1878,17,30-34,1895,1.6924681676242486
SIM,1860,11,na,1871,2368
SIM,1870,22,15-19,1892,4
STAT,1850,51,40-44,1901,0.007956837970411785
SIM,1908,29,25-29,1937,86
STAT,1911,31,25-29,1942,9.21797973913969
SIM,1896,37,45-49,1933,4
SIM,1901,38,25-29,1939,2
STAT,1859,38,25-29,1897,2.3340902258966594
STAT,1881,48,15-19,1929,3.89553589456808E-4
STAT,1913,37,15-19,1950,0.019333088527950206
STAT,1849,98,na,1947,2.522039185397541
SIM,1951,17,35-39,1968,5
STAT,1836,53,30-34,1889,0.0036756010276253657
STAT,1857,32,35-39,1889,8.118237446472774
STAT,1860,28,25-29,1888,35.134557054969946
STAT,1846,53,40-44,1899,0.0074076723252452055
STAT,1943,17,35-39,1960,4.539816945821031
SIM,1864,47,na,1911,2053
SIM,1899,6,na,1905,3646
SIM,1928,26,45-49,1954,2
STAT,1873,20,20-24,1893,71.69797168350529
SIM,1860,21,15-19,1881,1
STAT,1761,108,na,1869,0.0022992513539133036
STAT,1907,21,40-44,1928,3.1307335930007594
STAT,1874,18,20-24,1892,18.416982780686904
STAT,1847,32,na,1879,1984.3361135187802
SIM,1813,56,na,1869,1201
SIM,1865,32,35-39,1897,14
STAT,1893,40,45-49,1933,1.956415327717945
STAT,1864,36,50-100,1900,1.119023868857609
STAT,1923,41,40-44,1964,0.2987107008042904
STAT,1954,18,45-49,1972,0.6296976372276638
SIM,1880,58,na,1938,1839
STAT,1870,36,20-24,1906,0.7724388227788502
SIM,1897,27,na,1924,3232
STAT,1839,31,25-29,1870,8.78987248534681
STAT,1883,40,35-39,1923,1.830851411466845
SIM,1845,19,35-39,1864,1
SIM,1898,31,35-39,1929,23
SIM,1866,39,25-29,1905,4
STAT,1911,29,40-44,1940,4.603450588794851
STAT,1862,22,15-19,1884,2.9327381298318507
SIM,1822,37,45-49,1859,2
SIM,1847,31,25-29,1878,11
SIM,1915,21,40-44,1936,4
STAT,1926,44,15-19,1970,0.0019249174472336045
STAT,1831,48,na,1879,1604.9069375889158
STAT,1892,28,20-24,1920,14.946588655994052
SIM,1940,24,na,1964,3767
STAT,1846,18,45-49,1864,0.058336012022236323
STAT,1849,30,35-39,1879,9.295284169697574
SIM,1888,35,40-44,1923,6
STAT,1947,16,40-44,1963,1.607993895360444
SIM,1868,29,30-34,1897,36
SIM,1837,17,30-34,1854,1
SIM,1917,16,20-24,1933,37
SIM,1835,44,na,1879,1652
STAT,1946,16,45-49,1962,0.5654505635926023
STAT,1836,41,50-100,1877,0.792409213038449
STAT,1913,57,na,1970,3497.4666292235534
STAT,1926,19,25-29,1945,53.91138305594422
STAT,1852,26,20-24,1878,11.08743268189743
STAT,1958,1,na,1959,5274.0852308729445
SIM,1814,45,na,1859,1342
STAT,1906,18,45-49,1924,0.09673971949381424
STAT,1860,14,na,1874,2258.2586722966894
SIM,1879,46,na,1925,2817
STAT,1822,49,20-24,1871,0.016615951964314205
SIM,1828,96,na,1924,19
SIM,1809,67,na,1876,558
STAT,1830,63,na,1893,1128.736850592403
SIM,1844,11,na,1855,2474
SIM,1903,30,50-100,1933,3
STAT,1873,26,45-49,1899,1.152271308577376
SIM,1891,22,35-39,1913,12
STAT,1864,28,na,1892,2157.1530168410113
STAT,1828,104,na,1932,0.03672949403645684
SIM,1918,46,35-39,1964,1
STAT,1862,46,35-39,1908,0.12192118156895264
STAT,1951,19,35-39,1970,5.09406521502582
SIM,1833,37,20-24,1870,2
SIM,1931,2,na,1933,5300
STAT,1852,47,na,1899,1804.0255608520747
STAT,1870,17,25-29,1887,5.705050421946717
SIM,1914,3,na,1917,4215
STAT,1927,41,25-29,1968,0.09148753711941757
SIM,1896,42,na,1938,3147
SIM,1812,71,na,1883,519
SIM,1857,30,35-39,1887,3
STAT,1827,29,50-100,1856,1.2360222620618813
SIM,1835,29,50-100,1864,1
STAT,1833,28,15-19,1861,0.39588595644016367
STAT,1854,44,35-39,1898,1.3672074416937134
STAT,1892,46,na,1938,2885.264103118181
SIM,1828,32,50-100,1860,1
SIM,1939,26,20-24,1965,22
SIM,1901,33,30-34,1934,33
SIM,1954,16,45-49,1970,5
SIM,1938,22,35-39,1960,15
SIM,1839,35,45-49,1874,4
SIM,1879,61,na,1940,2266
STAT,1918,40,25-29,1958,0.07769345394220166
STAT,1928,28,45-49,1956,2.1699644021740605
SIM,1841,28,15-19,1869,1
STAT,1846,47,na,1893,1601.4092842965501
STAT,1838,16,45-49,1854,0.06377276205075881
SIM,1827,48,na,1875,1437
STAT,1835,54,50-100,1889,0.011026884208483316
SIM,1858,47,na,1905,1866
STAT,1925,29,35-39,1954,17.962478092927405
STAT,1871,30,15-19,1901,0.14506320259834085
STAT,1820,48,25-29,1868,0.10353483229420203
SIM,1934,19,25-29,1953,73
STAT,1882,13,na,1895,2562.717595296818
STAT,1933,34,50-100,1967,1.1348290399582524
SIM,1865,10,na,1875,2659
STAT,1884,26,20-24,1910,11.880982781857213
SIM,1902,23,20-24,1925,98
SIM,1910,58,na,1968,3291
STAT,1880,45,40-44,1925,0.18536119952643768
STAT,1844,27,25-29,1871,40.12807335091407
STAT,1898,33,35-39,1931,13.911861599807743
SIM,1827,30,45-49,1857,5
STAT,1884,43,50-100,1927,1.058556108390327
STAT,1866,38,20-24,1904,0.7217481035545379
SIM,1924,15,20-24,1939,183
STAT,1906,36,45-49,1942,0.6419693991907052
STAT,1883,79,na,1962,925.5899178455466
STAT,1910,24,50-100,1934,0.6262807898284004
SIM,1867,76,na,1943,750
SIM,1859,10,na,1869,2634
SIM,1927,42,na,1969,4645
STAT,1817,81,na,1898,263.91067083416675
STAT,1836,36,30-34,1872,4.114617522272215
STAT,1908,23,15-19,1931,4.974845713285996
SIM,1863,62,na,1925,1494
STAT,1886,21,45-49,1907,0.7552495737281406
STAT,1919,43,40-44,1962,0.27616691888824935
STAT,1836,28,50-100,1864,0.5115516192172197
STAT,1878,24,na,1902,2495.631911170149
SIM,1901,15,30-34,1916,3
STAT,1890,49,15-19,1939,2.7556424654738923E-4
STAT,1828,54,35-39,1882,0.005687493439335179
STAT,1919,3,na,1922,4574.037812433569
STAT,1840,27,45-49,1867,0.9962012588089165
STAT,1813,54,40-44,1867,0.02427320573453155
SIM,1882,29,15-19,1911,3
STAT,1894,42,na,1936,3039.5781730174663
SIM,1873,27,45-49,1900,2
STAT,1874,29,15-19,1903,0.4691817888148362
SIM,1871,39,50-100,1910,3
STAT,1843,25,20-24,1868,11.824309222615419
STAT,1930,22,40-44,1952,4.393179605400055
STAT,1861,51,na,1912,1823.7363159022395
STAT,1924,24,45-49,1948,1.3460959548359535
STAT,1895,45,35-39,1940,0.10616006579028732
STAT,1918,46,30-34,1964,0.09704821474402374
SIM,1936,28,45-49,1964,2
STAT,1874,47,45-49,1921,0.24466262510823872
SIM,1916,23,15-19,1939,5
STAT,1920,36,45-49,1956,0.7623960113668065
SIM,1882,47,45-49,1929,1
SIM,1906,27,20-24,1933,16
STAT,1821,45,35-39,1866,0.22728371343607429
SIM,1874,38,20-24,1912,1
STAT,1936,36,35-39,1972,2.4240966125460446
SIM,1909,61,na,1970,3013
SIM,1871,31,30-34,1902,22
SIM,1874,19,25-29,1893,6
STAT,1870,28,na,1898,2371.6130368757667
SIM,1828,28,45-49,1856,1
SIM,1849,95,na,1944,4
SIM,1850,21,35-39,1871,9
STAT,1855,51,na,1906,1677.1180486459127
SIM,1909,17,na,1926,3683
SIM,1955,16,40-44,1971,1
STAT,1885,17,50-100,1902,0.049862895246523896
SIM,1851,25,20-24,1876,1
STAT,1829,99,na,1928,1.2595803588259809
STAT,1925,42,na,1967,4587.4584800186085
SIM,1826,30,na,1856,1859
SIM,1942,20,na,1962,4351
STAT,1819,35,50-100,1854,4.085230246128822
STAT,1926,32,30-34,1958,19.43472957522422
SIM,1852,27,25-29,1879,47
SIM,1857,62,na,1919,1501
STAT,1908,49,25-29,1957,0.04863191665855082
SIM,1934,32,30-34,1966,5
STAT,1950,21,35-39,1971,11.399584401997084
STAT,1866,19,25-29,1885,5.408810144129198
STAT,1926,20,na,1946,4552.931861757436
SIM,1833,48,na,1881,1592
STAT,1896,40,25-29,1936,0.06068838089597081
SIM,1802,97,na,1899,2
SIM,1909,54,na,1963,3222
SIM,1862,36,35-39,1898,16
SIM,1844,27,na,1871,2069
STAT,1921,40,30-34,1961,0.14734615502653384
SIM,1882,66,na,1948,1491
STAT,1843,31,15-19,1874,0.1396488170225005
SIM,1859,41,45-49,1900,5
STAT,1884,50,45-49,1934,0.0148576125462898
STAT,1809,85,na,1894,139.86095723036757
STAT,1840,30,35-39,1870,9.062281687492273
SIM,1895,45,50-100,1940,2
STAT,1936,30,50-100,1966,0.8200168900482614
STAT,1927,38,35-39,1965,3.0645068968517197
SIM,1884,39,50-100,1923,5
STAT,1914,18,50-100,1932,0.07886559939130135
STAT,1938,24,50-100,1962,0.6638521119289625
SIM,1881,20,20-24,1901,84
STAT,1863,34,35-39,1897,8.980619187737936
SIM,1876,39,30-34,1915,14
STAT,1823,84,na,1907,185.1446521985076
STAT,1946,8,na,1954,4455.293342161644
SIM,1880,65,na,1945,1557
STAT,1868,39,30-34,1907,5.14070168270517
STAT,1940,25,na,1965,3900.492759970064
SIM,1926,36,na,1962,4934
SIM,1869,20,20-24,1889,74
STAT,1811,53,30-34,1864,0.015439627489134893
STAT,1868,96,na,1964,26.662567718015787
STAT,1911,46,45-49,1957,0.21039899625829722
SIM,1852,46,na,1898,1903
SIM,1855,33,40-44,1888,7
STAT,1877,7,na,1884,2841.6277404635653
SIM,1827,39,35-39,1866,13
SIM,1844,36,30-34,1880,6
STAT,1921,42,na,1963,4268.567725994579
STAT,1824,53,40-44,1877,0.011604168070585895
STAT,1883,63,na,1946,1786.0268803743727
SIM,1863,83,na,1946,229
STAT,1853,44,20-24,1897,0.13136704762691
STAT,1884,11,na,1895,2610.371011300517
STAT,1875,44,na,1919,2387.228648376749
SIM,1880,24,35-39,1904,10
STAT,1857,37,15-19,1894,0.044739400210774695
STAT,1927,45,40-44,1972,0.2028300554943879
STAT,1820,51,30-34,1871,0.010647845571218928
STAT,1913,32,35-39,1945,9.275315166390193
STAT,1819,39,35-39,1858,16.85872396312765
STAT,1847,25,na,1872,2057.056829289212
STAT,1888,34,40-44,1922,5.185389099459025
STAT,1856,31,25-29,1887,8.389399530094666
STAT,1887,42,25-29,1929,0.7331673836197309
STAT,1854,76,na,1930,725.0997616554633
STAT,1859,10,na,1869,2285.9289904000184
STAT,1920,19,40-44,1939,1.5928527126312249
SIM,1855,15,25-29,1870,6
SIM,1931,38,50-100,1969,1
SIM,1870,34,20-24,1904,2
SIM,1874,43,50-100,1917,1
STAT,1910,48,50-100,1958,0.21463028608144089
STAT,1900,16,20-24,1916,25.12881796527468
STAT,1901,45,20-24,1946,0.009752785153881827
STAT,1899,15,50-100,1914,0.06875815303602396
SIM,1830,30,30-34,1860,24
STAT,1786,87,na,1873,47.68808675870966
STAT,1864,30,20-24,1894,2.471605469626879
STAT,1855,34,50-100,1889,0.7083391945405356
SIM,1855,34,50-100,1889,4
SIM,1912,25,35-39,1937,19
STAT,1856,61,na,1917,1496.4099061839327
SIM,1852,6,na,1858,2591
SIM,1858,20,45-49,1878,1
SIM,1800,86,na,1886,29
SIM,1922,36,na,1958,4327
SIM,1886,42,30-34,1928,2
STAT,1950,18,25-29,1968,52.25791177878868
STAT,1871,78,na,1949,789.5559430568277
SIM,1909,26,50-100,1935,4
STAT,1895,37,35-39,1932,9.414135896467942
SIM,1846,32,50-100,1878,4
STAT,1896,42,35-39,1938,0.16921655696571916
STAT,1901,38,na,1939,3370.7065806720097
STAT,1904,25,35-39,1929,14.20307758886822
STAT,1941,18,15-19,1959,47.67498383531675
STAT,1879,50,35-39,1929,0.009312238285727081
STAT,1894,45,20-24,1939,0.0089709583126744
SIM,1835,38,30-34,1873,6
STAT,1837,70,na,1907,935.4668280481084
SIM,1929,34,50-100,1963,3
SIM,1853,43,30-34,1896,2
STAT,1803,54,35-39,1857,0.033398386588260005
SIM,1843,79,na,1922,494
SIM,1844,17,na,1861,2347
STAT,1831,23,35-39,1854,13.426805831855088
STAT,1942,23,15-19,1965,5.6924183967577955
SIM,1864,31,25-29,1895,12
SIM,1921,32,35-39,1953,23
STAT,1828,46,35-39,1874,0.11094218606448668
STAT,1917,16,30-34,1933,2.6832534384131934
STAT,1833,51,40-44,1884,0.007320193561117554
STAT,1899,43,15-19,1942,0.0013299925737476704
STAT,1853,30,45-49,1883,1.5373532224589987
STAT,1843,17,50-100,1860,0.050541950551243095
STAT,1867,18,30-34,1885,1.5513486685638895
SIM,1899,0,na,1899,3823
STAT,1847,15,25-29,1862,5.580882179344325
STAT,1870,45,35-39,1915,0.14100869722596943
STAT,1860,53,25-29,1913,0.0028847017766448087
STAT,1856,77,na,1933,692.2082562297167
STAT,1847,33,40-44,1880,3.9296796229049593
SIM,1821,54,na,1875,1264
STAT,1900,40,50-100,1940,0.10477712198392707
STAT,1845,43,30-34,1888,0.9031004032083431
STAT,1850,43,40-44,1893,1.6796941281844893
STAT,1798,72,na,1870,677.5053255419248
SIM,1785,74,na,1859,422
SIM,1856,12,na,1868,2807
STAT,1838,49,50-100,1887,0.18095482710388533
SIM,1814,72,na,1886,592
SIM,1940,27,20-24,1967,20
SIM,1814,82,na,1896,224
SIM,1776,93,na,1869,7
STAT,1816,54,45-49,1870,0.02743234124031735
STAT,1907,35,15-19,1942,0.018327513301461706
STAT,1863,59,na,1922,1738.334855585689
STAT,1868,29,50-100,1897,0.6188405687989801
STAT,1834,52,na,1886,1483.6294497383924
STAT,1878,42,30-34,1920,1.2192851329326235
SIM,1921,30,50-100,1951,3
STAT,1925,40,15-19,1965,0.0019021491444124886
SIM,1836,46,35-39,1882,1
STAT,1863,49,na,1912,1970.3571232635907
SIM,1853,29,35-39,1882,11
SIM,1864,31,na,1895,2188
STAT,1827,54,20-24,1881,6.992720853580153E-4
STAT,1859,51,50-100,1910,0.012363308052854441
STAT,1960,7,na,1967,5220.610491446066
STAT,1852,54,30-34,1906,0.004663513738307058
STAT,1845,29,35-39,1874,9.045202275463039
STAT,1831,30,25-29,1861,9.62514221373854
STAT,1864,96,na,1960,15.50931372286934
STAT,1895,64,na,1959,2414.1002764756727
STAT,1932,27,20-24,1959,24.382749931337543
SIM,1870,26,30-34,1896,33
STAT,1881,16,50-100,1897,0.04843825663089711
STAT,1811,44,15-19,1855,0.04072709757934142
STAT,1912,24,30-34,1936,29.098398284903784
SIM,1869,35,50-100,1904,1
SIM,1882,50,na,1932,2105
SIM,1807,54,45-49,1861,1
STAT,1869,44,30-34,1913,1.1170337701963144
SIM,1861,29,na,1890,2476
SIM,1872,31,35-39,1903,9
STAT,1920,35,30-34,1955,2.0399350698856686
STAT,1918,16,50-100,1934,0.08369512589219077
STAT,1903,35,30-34,1938,1.6840290618329077
SIM,1917,53,na,1970,3629
STAT,1866,45,45-49,1911,0.224282895538745
STAT,1862,26,30-34,1888,22.107308590284816
STAT,1865,54,40-44,1919,0.009479528426151464
SIM,1773,89,na,1862,2
SIM,1831,54,35-39,1885,1
SIM,1898,20,30-34,1918,32
SIM,1872,1,na,1873,3422
SIM,1880,31,25-29,1911,11
STAT,1897,32,25-29,1929,13.971287061135794
STAT,1850,52,na,1902,1611.0010541705292
SIM,1846,12,na,1858,2375
STAT,1788,72,na,1860,592.2428784926404
SIM,1822,40,35-39,1862,1
STAT,1872,31,25-29,1903,10.515138992351837
STAT,1924,28,25-29,1952,77.91362817385495
SIM,1874,31,na,1905,2412
SIM,1912,27,45-49,1939,4
STAT,1840,54,35-39,1894,0.0060247012271082544
SIM,1845,41,30-34,1886,3
STAT,1881,44,na,1925,2248.7542613158844
STAT,1909,17,35-39,1926,0.8392282109499887
STAT,1904,27,45-49,1931,1.6233362554289268
SIM,1925,16,30-34,1941,29
STAT,1848,54,40-44,1902,0.007958449956664284
STAT,1823,54,35-39,1877,0.011974325893789838
STAT,1890,11,na,1901,3226.065660702806
STAT,1907,33,50-100,1940,0.7847250795806153
SIM,1869,19,na,1888,2511
SIM,1806,53,na,1859,1355
SIM,1920,24,30-34,1944,58
SIM,1870,65,na,1935,1789
STAT,1818,101,na,1919,0.29079936907701476
STAT,1849,15,45-49,1864,0.06316658785717584
STAT,1889,21,25-29,1910,72.3554828038005
STAT,1827,38,30-34,1865,6.7479627919139356
SIM,1902,29,40-44,1931,5
STAT,1761,95,na,1856,1.1242930572
STAT,1835,49,30-34,1884,0.07412991447198695
SIM,1823,59,na,1882,1196
STAT,1908,40,15-19,1948,0.0014652417157616903
SIM,1838,41,25-29,1879,1
SIM,1901,44,na,1945,3463
STAT,1915,28,15-19,1943,0.7321923712958002
SIM,1915,28,25-29,1943,84
STAT,1855,35,40-44,1890,3.425660482724216
STAT,1866,61,na,1927,1758.3303566123882
STAT,1814,40,35-39,1854,6.855875037865487
STAT,1870,42,15-19,1912,0.013755072301272087
STAT,1888,31,20-24,1919,3.273265642827024
SIM,1897,21,25-29,1918,85
STAT,1870,28,30-34,1898,25.024571614757978
STAT,1922,46,20-24,1968,0.012986323687454823
STAT,1819,53,30-34,1872,0.011117586109242074
STAT,1829,51,35-39,1880,0.006869365671249648
SIM,1862,46,na,1908,2042
SIM,1873,83,na,1956,270
SIM,1896,31,20-24,1927,4
STAT,1881,78,na,1959,911.1863832590252
STAT,1890,45,35-39,1935,0.17636811853884116
SIM,1851,40,50-100,1891,4
SIM,1869,40,na,1909,2281
SIM,1911,35,30-34,1946,2
STAT,1881,31,35-39,1912,10.028914045727769
STAT,1899,20,40-44,1919,2.9283865943630296
STAT,1928,43,35-39,1971,0.26143054044430786
SIM,1808,72,na,1880,700
STAT,1886,44,30-34,1930,1.224668754308585
STAT,1907,28,25-29,1935,63.13970982144913
STAT,1919,46,45-49,1965,0.24115735169898314
STAT,1803,51,15-19,1854,1.013799121114862E-4
STAT,1894,29,30-34,1923,32.80797470431686
STAT,1857,25,na,1882,1986.8887034736965
SIM,1852,38,30-34,1890,8
STAT,1799,105,na,1904,0.009514232070158146
STAT,1838,40,20-24,1878,0.14000586593733708
SIM,1918,28,50-100,1946,1
STAT,1933,18,25-29,1951,59.005146399814734
STAT,1822,67,na,1889,922.3181475967745
SIM,1882,60,na,1942,1844
STAT,1857,46,50-100,1903,0.19622971473131365
STAT,1891,44,40-44,1935,2.8024848675934213
STAT,1869,22,20-24,1891,67.87249630199491
SIM,1921,25,45-49,1946,2
SIM,1880,31,na,1911,2354
STAT,1837,41,30-34,1878,0.9161705592828089
SIM,1842,91,na,1933,45
STAT,1875,0,na,1875,3843.9051065327562
SIM,1909,24,na,1933,3458
SIM,1900,29,50-100,1929,1
STAT,1870,42,30-34,1912,1.1451096879165235
STAT,1854,23,50-100,1877,0.36407856190929694
SIM,1888,32,25-29,1920,13
STAT,1880,23,30-34,1903,19.036290523969004
SIM,1842,34,50-100,1876,1
STAT,1772,102,na,1874,0.04541135162456789
STAT,1848,20,25-29,1868,54.96849159777458
STAT,1944,1,na,1945,4539.57102622961
SIM,1941,18,25-29,1959,66
SIM,1932,28,25-29,1960,89
STAT,1811,49,45-49,1860,0.6330019241652499
STAT,1841,20,25-29,1861,54.32170249372498
SIM,1812,87,na,1899,80
SIM,1900,25,na,1925,3567
STAT,1938,15,na,1953,3721.015189456633
STAT,1913,25,45-49,1938,1.7680270366197965
SIM,1873,14,na,1887,2622
STAT,1844,38,30-34,1882,4.3191398596623785
STAT,1851,33,15-19,1884,0.12102158770549894
STAT,1803,53,50-100,1856,0.05978478800305755
STAT,1915,42,na,1957,3815.5311117517426
SIM,1870,0,na,1870,3597
STAT,1810,86,na,1896,94.59321306054491
STAT,1933,25,15-19,1958,0.9567716949520931
SIM,1842,15,15-19,1857,3
SIM,1932,20,na,1952,5019
SIM,1899,21,45-49,1920,3
STAT,1912,17,40-44,1929,0.2885282601021699
SIM,1861,28,30-34,1889,34
STAT,1913,23,na,1936,3750.3161292287036
STAT,1875,34,na,1909,2477.101996318769
SIM,1867,83,na,1950,254
SIM,1877,44,30-34,1921,2
STAT,1854,36,35-39,1890,5.439347579966284
SIM,1877,22,20-24,1899,4
STAT,1807,53,40-44,1860,0.04262403973446928
STAT,1853,28,30-34,1881,22.09948126724757
SIM,1902,45,30-34,1947,1
STAT,1890,21,35-39,1911,7.300784749124262
STAT,1912,18,50-100,1930,0.07708185162901932
STAT,1829,45,40-44,1874,0.142167921241181
STAT,1874,44,40-44,1918,2.3111370525308343
STAT,1930,25,45-49,1955,2.2424292765323885
SIM,1855,30,20-24,1885,4
SIM,1856,20,25-29,1876,77
STAT,1873,23,40-44,1896,2.1485189197509658
STAT,1807,50,na,1857,1445.066437998137
SIM,1920,17,40-44,1937,1
STAT,1830,32,30-34,1862,16.697327962006163
SIM,1938,21,na,1959,3503
STAT,1861,52,30-34,1913,0.004991097796986507
SIM,1845,36,35-39,1881,10
SIM,1905,24,na,1929,3346
STAT,1858,22,45-49,1880,0.6472693681806533
STAT,1817,101,na,1918,0.27848287656150666
SIM,1897,9,na,1906,3515
SIM,1935,35,30-34,1970,6
STAT,1863,31,30-34,1894,15.680694730042992
STAT,1848,42,na,1890,1794.3912840097773
SIM,1870,20,45-49,1890,2
SIM,1891,27,15-19,1918,4
STAT,1905,58,na,1963,3080.4777433205995
SIM,1891,33,na,1924,3017
STAT,1822,33,35-39,1855,27.005554387183818
STAT,1875,42,50-100,1917,1.1047545721558027
SIM,1849,7,na,1856,2384
STAT,1941,17,20-24,1958,142.46705997295365
SIM,1927,38,45-49,1965,1
STAT,1877,26,50-100,1903,0.6791723069408248
STAT,1893,48,40-44,1941,0.1234067508256629
STAT,1805,55,na,1860,1312.6256204276838
STAT,1903,57,na,1960,3020.363634199165
SIM,1866,22,45-49,1888,1
SIM,1845,98,na,1943,1
STAT,1864,33,25-29,1897,9.251677679029251
STAT,1882,50,25-29,1932,0.003570913073040392
STAT,1850,46,45-49,1896,0.17802435330330416
STAT,1883,27,15-19,1910,0.45414056096545025
STAT,1931,20,35-39,1951,12.529063466471259
SIM,1880,21,30-34,1901,31
STAT,1848,21,50-100,1869,0.3887578253940147
STAT,1900,19,25-29,1919,7.96949998168405
STAT,1839,49,15-19,1888,2.741516173926174E-4
STAT,1907,23,na,1930,3531.628907808138
STAT,1919,36,35-39,1955,2.654090066061329
SIM,1880,40,50-100,1920,1
SIM,1909,38,40-44,1947,2
STAT,1837,36,35-39,1873,5.8014894918246975
SIM,1879,40,na,1919,2866
SIM,1810,52,na,1862,1525
SIM,1898,37,na,1935,3649
STAT,1803,51,30-34,1854,0.024533959403881804
STAT,1840,52,na,1892,1541.1667215247637
SIM,1831,30,35-39,1861,10
STAT,1933,33,15-19,1966,0.17649931667735164
SIM,1913,8,na,1921,4279
SIM,1815,85,na,1900,61
STAT,1836,39,35-39,1875,5.293058809144606
SIM,1933,23,15-19,1956,5
STAT,1849,26,15-19,1875,0.42056326162962
SIM,1819,44,na,1863,1443
STAT,1836,30,45-49,1866,1.4008716775465324
SIM,1908,24,15-19,1932,6
STAT,1900,17,15-19,1917,8.391156521610155
STAT,1820,38,30-34,1858,12.251748353449045
STAT,1930,17,45-49,1947,0.6586889499406662
STAT,1845,46,35-39,1891,0.10969914669357184
SIM,1944,21,na,1965,3966
SIM,1851,4,na,1855,2449
SIM,1844,39,35-39,1883,11
STAT,1925,23,15-19,1948,6.480732003440852
STAT,1945,26,35-39,1971,16.812668728957814
STAT,1798,68,na,1866,882.322133554427
STAT,1856,53,35-39,1909,0.006783471520439693
STAT,1825,43,15-19,1868,0.018466528315652618
SIM,1915,5,na,1920,4642
STAT,1836,57,na,1893,1250.8638313376885
SIM,1854,17,na,1871,2379
STAT,1813,84,na,1897,143.0542707563247
SIM,1911,35,50-100,1946,4
SIM,1933,9,na,1942,5310
SIM,1799,56,na,1855,1287
STAT,1917,6,na,1923,4387.0865131994215
STAT,1878,37,35-39,1915,7.510461085310072
STAT,1860,49,40-44,1909,0.13874599487370753
STAT,1820,70,na,1890,772.7494562245615
STAT,1878,45,35-39,1923,0.15014265441648725
SIM,1924,25,50-100,1949,6
SIM,1846,46,na,1892,1845
SIM,1868,37,30-34,1905,8
STAT,1846,105,na,1951,0.020967850016578856
STAT,1893,45,50-100,1938,0.18107700694692333
STAT,1820,34,15-19,1854,0.42703768686302934
STAT,1840,20,25-29,1860,53.14673571446532
STAT,1850,25,50-100,1875,0.5744721419493332
SIM,1887,38,na,1925,2832
SIM,1921,22,40-44,1943,8
STAT,1891,47,45-49,1938,0.16735104689122232
STAT,1915,35,20-24,1950,0.2743247804767963
STAT,1822,71,na,1893,776.111816286972
SIM,1829,71,na,1900,602
STAT,1868,58,na,1926,1926.9064173188856
SIM,1874,8,na,1882,2752
STAT,1884,48,15-19,1932,3.9864004144817824E-4
STAT,1869,10,na,1879,2652.3468535257143
SIM,1819,46,35-39,1865,1
SIM,1869,42,30-34,1911,2
STAT,1881,21,25-29,1902,56.63051101259558
STAT,1808,66,na,1874,710.3098548502705
STAT,1863,25,50-100,1888,0.5804797225943872
STAT,1810,50,45-49,1860,0.045242715220427845
STAT,1903,35,50-100,1938,0.38793964145377247
STAT,1868,17,20-24,1885,17.586864270588862
SIM,1778,88,na,1866,71
STAT,1938,9,na,1947,4005.8007451433737
STAT,1923,19,na,1942,4386.203111843899
SIM,1872,66,na,1938,1650
SIM,1935,28,40-44,1963,16
STAT,1878,52,25-29,1930,0.0037411037535185934
SIM,1886,37,35-39,1923,3
STAT,1927,35,30-34,1962,2.3155016056519977
SIM,1828,27,na,1855,2013
SIM,1780,92,na,1872,13
STAT,1862,20,45-49,1882,0.6288975072592569
STAT,1930,25,na,1955,4862.48014924881
SIM,1853,24,50-100,1877,1
STAT,1850,28,15-19,1878,0.3987315052060614
SIM,1830,33,35-39,1863,11
SIM,1915,25,20-24,1940,25
SIM,1932,36,na,1968,5308
STAT,1919,27,50-100,1946,1.0974820652088022
SIM,1878,42,25-29,1920,1
STAT,1924,18,15-19,1942,54.99398517591431
SIM,1932,18,15-19,1950,60
SIM,1893,38,na,1931,3131
SIM,1885,26,50-100,1911,4
STAT,1853,59,na,1912,1629.592136024308
STAT,1828,37,50-100,1865,1.0763519378473627
STAT,1800,56,na,1856,1278.348155669583
STAT,1828,28,na,1856,1572.3892393975643
STAT,1866,17,50-100,1883,0.04731780004840113
SIM,1889,39,na,1928,3043
STAT,1923,24,50-100,1947,0.7762618084574321
STAT,1845,26,30-34,1871,24.122156809737973
STAT,1896,32,25-29,1928,13.80040824732119
STAT,1834,20,50-100,1854,0.6619600578602236
STAT,1849,19,25-29,1868,5.351736951378906
STAT,1844,40,45-49,1884,1.2186199228782537
STAT,1842,26,15-19,1868,0.4431764954613192
STAT,1927,28,40-44,1955,5.7599038864670575
STAT,1816,71,na,1887,654.3866341164858
SIM,1886,80,na,1966,950
STAT,1876,46,15-19,1922,4.2256775068307044E-4
STAT,1929,22,50-100,1951,0.8486823238821195
STAT,1911,23,50-100,1934,0.6345763954610252
SIM,1878,35,35-39,1913,12
STAT,1921,24,40-44,1945,3.8510854012423024
STAT,1793,69,na,1862,742.0841160522587
STAT,1815,52,35-39,1867,0.022125990970913157
STAT,1941,25,20-24,1966,19.28149131715151
STAT,1859,44,na,1903,1857.5846300024593
SIM,1916,40,na,1956,3850
STAT,1883,45,45-49,1928,0.23858293332513905
STAT,1893,63,na,1956,2334.554910257683
SIM,1887,65,na,1952,2005
STAT,1893,17,50-100,1910,0.06340266657957967
SIM,1879,5,na,1884,3322
SIM,1901,38,40-44,1939,1
STAT,1847,50,40-44,1897,0.008327573458302987
SIM,1912,6,na,1918,4272
SIM,1875,18,30-34,1893,1
SIM,1916,36,na,1952,3923
STAT,1833,102,na,1935,0.19252675562261062
STAT,1866,44,15-19,1910,0.012819234678536766
STAT,1886,47,35-39,1933,0.15046891482582295
STAT,1930,15,35-39,1945,5.558695274763279
SIM,1873,79,na,1952,528
STAT,1877,31,45-49,1908,1.8526540874837623
STAT,1907,25,20-24,1932,17.691604758701374
STAT,1884,32,15-19,1916,0.1437295892579802
STAT,1829,41,25-29,1870,0.546245662132998
SIM,1868,15,20-24,1883,23
SIM,1853,26,30-34,1879,36
SIM,1908,19,35-39,1927,1
STAT,1910,38,25-29,1948,0.9556650680014366
STAT,1941,15,50-100,1956,0.39390908873892017
SIM,1837,41,25-29,1878,1
STAT,1890,42,30-34,1932,1.432258046145836
SIM,1857,19,25-29,1876,8
STAT,1913,22,40-44,1935,3.3238368364864344
SIM,1904,55,na,1959,3209
SIM,1871,13,na,1884,2556
SIM,1934,21,na,1955,4956
STAT,1899,21,35-39,1920,8.176600399836934
STAT,1940,28,50-100,1968,1.034960039954039
SIM,1830,25,35-39,1855,10
STAT,1844,76,na,1920,734.1538787474319
STAT,1855,41,35-39,1896,1.4100913137965976
STAT,1901,48,40-44,1949,0.13603522114503985
STAT,1928,40,30-34,1968,0.16670384621863157
STAT,1899,23,45-49,1922,0.9711270235522159
SIM,1866,66,na,1932,1777
SIM,1870,29,35-39,1899,18
SIM,1828,101,na,1929,2
SIM,1928,23,50-100,1951,1
STAT,1810,70,na,1880,680.4485983826154
STAT,1907,43,15-19,1950,0.0014260713991896801
STAT,1862,29,35-39,1891,8.319242563302241
STAT,1866,42,40-44,1908,2.1138957395385223
STAT,1933,39,na,1972,5214.819354868838
SIM,1885,31,45-49,1916,3
STAT,1902,47,30-34,1949,0.07818851027370007
SIM,1858,31,na,1889,1961
STAT,1911,41,15-19,1952,0.0015037043768693595
SIM,1896,34,40-44,1930,2
STAT,1830,50,50-100,1880,0.012601736090832424
SIM,1835,26,50-100,1861,1
STAT,1915,27,20-24,1942,18.999280057507818
STAT,1858,42,15-19,1900,0.011158503188458149
STAT,1839,51,45-49,1890,0.01006358878038649
SIM,1850,82,na,1932,279
SIM,1818,40,45-49,1858,1
STAT,1874,52,40-44,1926,0.01090682474517
STAT,1902,24,50-100,1926,0.5829932072402982
SIM,1834,27,na,1861,1849
STAT,1940,6,na,1946,4134.618438164726
SIM,1874,42,40-44,1916,7
SIM,1923,27,20-24,1950,1
SIM,1865,41,50-100,1906,3
STAT,1856,4,na,1860,2523.8733426906933
STAT,1870,35,na,1905,2371.8419004443936
STAT,1923,37,20-24,1960,0.31164290621362567
SIM,1890,43,35-39,1933,6
SIM,1827,86,na,1913,78
STAT,1861,24,na,1885,2018.859336906025
STAT,1891,29,15-19,1920,0.5689298528895652
STAT,1905,30,35-39,1935,15.040592000310081
STAT,1844,28,50-100,1872,0.6024694839121519
STAT,1837,51,25-29,1888,0.002417584976517337
STAT,1818,50,45-49,1868,0.03287240288321822
SIM,1863,31,25-29,1894,14
SIM,1889,23,na,1912,3251
SIM,1829,43,40-44,1872,4
SIM,1802,87,na,1889,113
SIM,1832,38,15-19,1870,2
STAT,1898,38,15-19,1936,0.01663788685347551
STAT,1819,36,30-34,1855,16.379431617221996
STAT,1900,50,na,1950,3088.3058584999335
STAT,1953,18,40-44,1971,1.7254139983464007
SIM,1878,51,na,1929,2449
SIM,1927,36,35-39,1963,4
SIM,1883,14,na,1897,2645
SIM,1941,15,20-24,1956,207
STAT,1851,51,45-49,1902,0.012030280043120354
STAT,1817,41,15-19,1858,0.03614767539231796
STAT,1830,35,35-39,1865,6.568088268557228
STAT,1771,102,na,1873,0.07525594500985948
STAT,1858,20,35-39,1878,5.495250686309832
SIM,1837,69,na,1906,908
SIM,1872,7,na,1879,2864
STAT,1812,43,20-24,1855,0.42408084085021347
SIM,1836,21,20-24,1857,5
STAT,1848,24,40-44,1872,1.9440685050691238
STAT,1865,44,na,1909,2111.0976762592554
STAT,1844,52,30-34,1896,0.004588142614578266
SIM,1804,52,na,1856,1346
SIM,1900,17,25-29,1917,12
SIM,1844,30,45-49,1874,3
STAT,1939,29,15-19,1968,0.7232652818162109
STAT,1837,44,35-39,1881,1.2636501218764467
SIM,1917,3,na,1920,4356
STAT,1882,43,35-39,1925,1.7867250360617903
STAT,1919,38,45-49,1957,0.7466136353448035
SIM,1888,32,50-100,1920,3
SIM,1913,30,35-39,1943,15
SIM,1827,36,30-34,1863,10
SIM,1864,41,na,1905,2122
STAT,1896,25,35-39,1921,13.088716773072226
SIM,1852,40,45-49,1892,4
STAT,1862,40,15-19,1902,0.012113464690203527
STAT,1817,40,na,1857,1526.4267527838151
STAT,1860,35,na,1895,1968.595996470693
SIM,1856,24,40-44,1880,4
STAT,1859,3,na,1862,2671.9484900648918
SIM,1792,86,na,1878,73
SIM,1854,3,na,1857,2788
SIM,1907,17,25-29,1924,12
STAT,1886,27,30-34,1913,27.191720067350715
STAT,1842,44,45-49,1886,1.183572069024092
SIM,1900,24,15-19,1924,9
SIM,1920,27,35-39,1947,25
SIM,1928,21,na,1949,5127
SIM,1849,28,30-34,1877,37
STAT,1832,22,40-44,1854,3.4354511056034007
SIM,1821,85,na,1906,99
STAT,1811,46,40-44,1857,0.48400782539151316
STAT,1830,38,na,1868,1685.6994511278192
STAT,1915,5,na,1920,4280.193953116608
STAT,1925,24,50-100,1949,0.7985320172286172
SIM,1837,34,35-39,1871,15
STAT,1844,51,50-100,1895,0.011759288350198578
SIM,1845,44,35-39,1889,7
STAT,1868,62,na,1930,1780.8815467561121
STAT,1859,75,na,1934,838.7181578639696
STAT,1933,15,20-24,1948,185.94423539415877
SIM,1912,17,35-39,1929,1
STAT,1824,38,15-19,1862,0.07496529077830491
SIM,1903,34,40-44,1937,7
STAT,1838,43,25-29,1881,0.4957361519679915
SIM,1907,53,na,1960,3350
SIM,1857,83,na,1940,248
STAT,1875,16,15-19,1891,6.228798449550576
STAT,1904,17,35-39,1921,0.8022488886055053
SIM,1846,43,25-29,1889,4
SIM,1933,24,50-100,1957,1
SIM,1894,27,30-34,1921,42
STAT,1851,52,20-24,1903,6.055553836192968E-4
STAT,1912,27,35-39,1939,15.092999179847556
SIM,1840,22,40-44,1862,3
SIM,1883,16,15-19,1899,8
SIM,1803,73,na,1876,355
STAT,1875,22,45-49,1897,0.7301031165495897
SIM,1918,35,30-34,1953,3
STAT,1865,82,na,1947,432.0099925762062
STAT,1865,39,15-19,1904,0.05147037450681798
STAT,1920,31,15-19,1951,0.14422876005747096
STAT,1830,90,na,1920,49.873923393272115
SIM,1840,68,na,1908,1014
STAT,1949,17,na,1966,4367.462975196363
SIM,1929,37,na,1966,5136
STAT,1812,53,30-34,1865,0.013169687196084854
STAT,1928,22,na,1950,4650.724256906247
SIM,1942,29,na,1971,4491
STAT,1899,17,15-19,1916,8.290387606608096
STAT,1874,50,35-39,1924,0.009095725302981252
STAT,1928,33,40-44,1961,4.98805275496544
STAT,1827,43,na,1870,1709.7379909807312
STAT,1823,32,25-29,1855,26.096092405610523
SIM,1817,39,25-29,1856,2
SIM,1831,32,25-29,1863,11
SIM,1866,97,na,1963,10
SIM,1878,82,na,1960,580
SIM,1850,8,na,1858,2356
STAT,1869,23,15-19,1892,3.239196441390343
SIM,1877,27,30-34,1904,41
STAT,1917,42,30-34,1959,0.13615204237044987
STAT,1923,40,50-100,1963,0.1404868845914937
STAT,1929,39,50-100,1968,0.5486021154214301
STAT,1804,70,na,1874,687.484271109642
STAT,1901,46,35-39,1947,0.11297918492802468
SIM,1845,33,30-34,1878,26
STAT,1846,45,40-44,1891,0.12364940914017813
STAT,1846,31,30-34,1877,14.909141526619138
SIM,1911,27,na,1938,3775
STAT,1887,45,50-100,1932,0.2835525521234376
SIM,1923,22,na,1945,4025
STAT,1914,46,45-49,1960,0.22046774311260423
SIM,1796,86,na,1882,40
SIM,1839,71,na,1910,998
STAT,1888,42,25-29,1930,0.7735008751378737
STAT,1910,44,35-39,1954,0.1917139157344623
SIM,1936,33,40-44,1969,6
STAT,1915,38,25-29,1953,1.0099564637667207
STAT,1916,37,na,1953,3931.6172949824054
SIM,1909,23,20-24,1932,6
SIM,1834,65,na,1899,1191
STAT,1854,45,na,1899,1739.0928888153978
SIM,1831,32,40-44,1863,2
SIM,1858,78,na,1936,684
STAT,1810,51,20-24,1861,0.002254682856700199
SIM,1878,92,na,1970,117
STAT,1858,40,50-100,1898,0.8633016860712425
SIM,1833,80,na,1913,412
SIM,1847,90,na,1937,26
STAT,1845,68,na,1913,1194.0524818117428
STAT,1803,53,20-24,1856,0.002921080962708165
STAT,1871,16,30-34,1887,1.6306510003411334
STAT,1878,34,30-34,1912,18.381066637792962
STAT,1914,20,35-39,1934,9.47464611629174
SIM,1896,30,25-29,1926,19
STAT,1898,62,na,1960,2639.513455758845
STAT,1911,45,30-34,1956,0.08649039316281551
STAT,1866,22,35-39,1888,5.535847438919298
STAT,1817,49,na,1866,1378.8631279286562
SIM,1860,82,na,1942,582
SIM,1927,35,40-44,1962,5
SIM,1874,22,35-39,1896,12
SIM,1919,36,45-49,1955,1
STAT,1862,18,30-34,1880,1.5758922965579603
STAT,1870,44,20-24,1914,0.15624050269422865
SIM,1877,38,na,1915,2399
STAT,1853,50,na,1903,1831.3730450134428
STAT,1865,50,25-29,1915,0.0033266884079637474
SIM,1870,18,30-34,1888,3
STAT,1891,48,20-24,1939,0.008441811146415176
STAT,1854,19,35-39,1873,0.49646837949599304
STAT,1915,45,15-19,1960,3.8056477318425876E-4
STAT,1811,55,na,1866,1139.2089363431862
STAT,1937,26,45-49,1963,1.7185573960847325
STAT,1841,42,35-39,1883,1.3893302596385486
SIM,1822,33,na,1855,1563
SIM,1910,33,20-24,1943,6
STAT,1860,45,25-29,1905,0.048151653389439816
SIM,1859,39,30-34,1898,9
SIM,1917,18,30-34,1935,14
STAT,1872,21,30-34,1893,18.266789475776253
STAT,1916,4,na,1920,4355.6804217487215
STAT,1866,30,na,1896,2263.496773939173
STAT,1822,98,na,1920,1.888844801011817
STAT,1850,47,20-24,1897,0.008984376500650901
SIM,1883,45,na,1928,2370
STAT,1879,44,25-29,1923,0.6755242907632169
SIM,1846,50,na,1896,1788
STAT,1795,102,na,1897,0.05244912450756123
SIM,1859,26,na,1885,2279
SIM,1887,44,25-29,1931,6
SIM,1894,47,35-39,1941,1
STAT,1796,102,na,1898,0.06377798851949712
STAT,1830,27,50-100,1857,0.7236150638007904
STAT,1838,46,45-49,1884,0.1806949406667339
STAT,1897,31,50-100,1928,1.254899900640539
SIM,1963,7,na,1970,5152
SIM,1944,25,30-34,1969,50
SIM,1798,71,na,1869,527
SIM,1954,14,na,1968,4714
STAT,1893,25,na,1918,3109.464081392957
STAT,1909,18,30-34,1927,2.4313712540986883
STAT,1856,30,na,1886,1974.9546522246353
STAT,1837,33,30-34,1870,14.444702082145868
STAT,1851,41,15-19,1892,0.011444901652923542
STAT,1869,30,20-24,1899,2.683665015755401
SIM,1849,26,na,1875,1963
STAT,1855,43,40-44,1898,1.7310391295258785
STAT,1793,90,na,1883,33.397692304052825
SIM,1945,26,45-49,1971,1
SIM,1807,66,na,1873,809
SIM,1859,25,20-24,1884,3
STAT,1886,77,na,1963,1193.979894328953
SIM,1891,74,na,1965,1682
STAT,1878,58,na,1936,2099.9340923559776
STAT,1806,54,35-39,1860,0.026823904301790606
SIM,1848,25,45-49,1873,4
SIM,1898,30,40-44,1928,10
STAT,1833,36,15-19,1869,0.04699724628274533
SIM,1955,2,na,1957,5099
STAT,1783,73,na,1856,501.35445644940006
SIM,1846,46,45-49,1892,1
STAT,1853,97,na,1950,4.504618098456363
STAT,1876,39,50-100,1915,1.280323408473018
STAT,1872,41,35-39,1913,1.8598069836301876
SIM,1897,29,50-100,1926,1
STAT,1835,29,25-29,1864,40.50571716649451
STAT,1937,33,35-39,1970,9.216395229571068
SIM,1841,13,na,1854,2217
SIM,1904,22,40-44,1926,7
SIM,1843,29,25-29,1872,51
SIM,1816,46,na,1862,1565
STAT,1766,94,na,1860,5.519336583918951
SIM,1942,26,na,1968,4432
STAT,1890,23,25-29,1913,71.18392137327822
STAT,1855,39,50-100,1894,0.9421651952771052
STAT,1942,27,30-34,1969,41.956763977110626
SIM,1872,33,40-44,1905,3
SIM,1911,37,na,1948,3795
STAT,1805,50,35-39,1855,0.0315807158919446
STAT,1913,15,35-39,1928,0.8793001359850245
STAT,1874,48,50-100,1922,0.2525933595394554
SIM,1897,65,na,1962,2410
STAT,1917,47,25-29,1964,0.056541660616651675
SIM,1890,27,na,1917,3121
STAT,1811,48,30-34,1859,0.264230511182866
SIM,1881,42,30-34,1923,1
STAT,1873,31,25-29,1904,10.63670062269673
SIM,1839,64,na,1903,1257
STAT,1877,18,25-29,1895,5.980176610806195
SIM,1926,16,50-100,1942,1
SIM,1949,17,30-34,1966,21
STAT,1946,24,50-100,1970,0.7465557920323553
STAT,1900,17,50-100,1917,0.06927205412997067
STAT,1857,17,45-49,1874,0.061169253785264825
STAT,1811,65,na,1876,856.3098839632379
SIM,1878,32,30-34,1910,19
SIM,1921,15,35-39,1936,6
STAT,1785,105,na,1890,0.021929745492388564
STAT,1829,50,20-24,1879,6.005829776501841E-4
STAT,1873,40,40-44,1913,2.349785932762186
SIM,1859,16,na,1875,2538
STAT,1945,25,40-44,1970,5.2217803605550195
SIM,1844,28,30-34,1872,28
STAT,1862,30,na,1892,2088.929816005552
SIM,1860,43,25-29,1903,4
STAT,1945,24,na,1969,4080.6429809577216
STAT,1941,28,25-29,1969,69.43163696858512
STAT,1883,44,15-19,1927,0.013636575385037774
STAT,1916,37,30-34,1953,1.9046443277631329
SIM,1918,28,40-44,1946,7
SIM,1903,24,30-34,1927,34
SIM,1877,45,na,1922,2303
STAT,1828,29,35-39,1857,10.94138244141499
SIM,1881,40,40-44,1921,6
STAT,1873,45,35-39,1918,0.14623848521335356
SIM,1828,41,30-34,1869,2
STAT,1860,45,na,1905,1880.7908696851332
STAT,1941,21,40-44,1962,3.546119434673184
STAT,1896,41,20-24,1937,0.014926255267014434
SIM,1935,16,25-29,1951,67
SIM,1948,14,na,1962,4532
STAT,1802,52,25-29,1854,0.009386562430828277
SIM,1765,91,na,1856,22
SIM,1827,79,na,1906,366
STAT,1883,49,25-29,1932,0.05645180353734852
STAT,1887,32,30-34,1919,19.95878590084271
STAT,1843,40,50-100,1883,0.9008911390078901
SIM,1887,47,45-49,1934,1
SIM,1836,29,35-39,1865,19
SIM,1848,18,20-24,1866,13
STAT,1924,25,na,1949,4480.298821255423
SIM,1889,30,na,1919,3094
SIM,1886,34,30-34,1920,25
STAT,1817,43,na,1860,1470.5560419756823
STAT,1887,46,40-44,1933,0.19626007707025436
STAT,1888,30,25-29,1918,12.45208120117831
SIM,1873,9,na,1882,2650
SIM,1890,21,25-29,1911,84
STAT,1842,16,na,1858,2325.256125951868
SIM,1848,78,na,1926,489
STAT,1929,31,35-39,1960,11.846104700275083
SIM,1895,32,30-34,1927,31
STAT,1962,5,na,1967,5137.385264171078
STAT,1936,28,35-39,1964,14.647746271992323
STAT,1902,31,30-34,1933,25.22099333442994
STAT,1916,32,50-100,1948,0.8710875365429326
SIM,1937,31,35-39,1968,19
STAT,1902,48,50-100,1950,0.19680398217882067
STAT,1927,16,25-29,1943,55.09885711968081
SIM,1886,20,20-24,1906,81
STAT,1879,47,45-49,1926,0.2504865295209242
STAT,1844,45,na,1889,1770.9209695860088
SIM,1836,50,na,1886,1749
STAT,1936,10,na,1946,3880.8226809022676
SIM,1923,12,na,1935,4570
SIM,1899,15,15-19,1914,8
STAT,1827,49,na,1876,1591.421725778445
SIM,1847,93,na,1940,17
STAT,1857,18,50-100,1875,0.045606725160352225
SIM,1903,17,40-44,1920,2
SIM,1948,18,25-29,1966,92
SIM,1815,51,na,1866,1325
SIM,1840,30,25-29,1870,3
STAT,1857,108,na,1965,0.010402524022886077
SIM,1924,37,30-34,1961,5
SIM,1819,43,30-34,1862,6
STAT,1874,37,15-19,1911,0.05848844943841495
STAT,1902,36,25-29,1938,0.8983484959472223
STAT,1855,40,20-24,1895,0.12435382918561709
STAT,1872,30,na,1902,2459.446919318747
SIM,1830,68,na,1898,1070
STAT,1855,2,na,1857,2761.2994614667523
STAT,1863,48,45-49,1911,0.20843824573586714
SIM,1840,44,35-39,1884,5
STAT,1836,28,30-34,1864,20.137556452348502
STAT,1873,70,na,1943,1451.1289109471286
STAT,1842,43,15-19,1885,0.011061898962210649
STAT,1849,41,50-100,1890,0.8238987108080619
SIM,1860,72,na,1932,1274
SIM,1882,37,15-19,1919,1
STAT,1771,88,na,1859,39.577882361115215
STAT,1919,35,40-44,1954,1.6503006477125115
STAT,1922,22,35-39,1944,11.017733326187464
STAT,1898,18,45-49,1916,0.08987971652728845
STAT,1831,40,35-39,1871,1.5762527367915218
STAT,1886,25,50-100,1911,0.6954338405502043
STAT,1939,5,na,1944,4096.799831454428
SIM,1889,19,20-24,1908,20
SIM,1915,33,50-100,1948,2
SIM,1828,31,na,1859,1880
SIM,1839,20,25-29,1859,78
STAT,1861,19,25-29,1880,5.425974895369352
STAT,1922,15,45-49,1937,0.5926360739905965
STAT,1890,26,45-49,1916,1.3896746977622774
SIM,1938,19,45-49,1957,1
STAT,1915,52,na,1967,3714.062368759609
STAT,1832,30,25-29,1862,9.183639542786349
SIM,1852,53,na,1905,1750
SIM,1879,16,25-29,1895,10
STAT,1853,54,30-34,1907,0.0048539500878761
STAT,1925,46,20-24,1971,0.013696402705824671
SIM,1831,35,45-49,1866,3
SIM,1892,12,na,1904,3790
SIM,1872,33,25-29,1905,11
STAT,1832,44,35-39,1876,1.4497710260120347
STAT,1866,15,45-49,1881,0.06384022314173926
STAT,1867,18,na,1885,2458.2287594430118
SIM,1839,27,45-49,1866,1
SIM,1854,31,30-34,1885,21
STAT,1900,12,na,1912,3651.538103741415
SIM,1895,30,na,1925,3284
STAT,1912,34,50-100,1946,0.8228264021418119
STAT,1850,45,na,1895,1709.2130138053344
STAT,1900,38,30-34,1938,1.6184589662810693
STAT,1936,35,40-44,1971,1.5015292263015771
SIM,1809,51,na,1860,1014
STAT,1823,35,45-49,1858,3.9676575521896513
STAT,1840,90,na,1930,56.73351027717923
STAT,1914,43,40-44,1957,0.25247373509745946
STAT,1842,48,25-29,1890,0.044602619980590605
STAT,1896,22,30-34,1918,23.999441074995453
STAT,1897,22,na,1919,3226.0128315376683
STAT,1829,31,30-34,1860,16.653814309252663
SIM,1923,31,40-44,1954,7
STAT,1885,37,na,1922,2397.863602767241
STAT,1850,32,35-39,1882,7.968802353372491
SIM,1845,22,25-29,1867,78
STAT,1840,32,25-29,1872,8.977287300449321
SIM,1878,3,na,1881,3230
STAT,1765,112,na,1877,2.63359514053016E-4
STAT,1842,41,40-44,1883,1.848469142664681
STAT,1879,40,25-29,1919,0.6916769144636651
STAT,1886,81,na,1967,934.9968624988342
STAT,1832,41,30-34,1873,0.9569844145085226
STAT,1932,34,45-49,1966,2.1305538436527516
SIM,1860,49,30-34,1909,1
SIM,1830,47,45-49,1877,1
SIM,1880,35,40-44,1915,4
STAT,1928,18,na,1946,4718.305665704191
SIM,1896,32,50-100,1928,1
STAT,1890,20,20-24,1910,86.46996274901413
STAT,1857,41,50-100,1898,0.8455036480339492
STAT,1921,47,15-19,1968,4.237566452901498E-4
SIM,1903,37,45-49,1940,1
STAT,1878,20,20-24,1898,73.61211222295022
SIM,1865,26,na,1891,2268
SIM,1876,41,45-49,1917,2
STAT,1860,31,15-19,1891,0.11835456489746703
SIM,1836,22,15-19,1858,3
SIM,1867,45,na,1912,2050
SIM,1849,64,na,1913,1359
STAT,1842,20,50-100,1862,0.4092059153048476
SIM,1837,31,30-34,1868,21
STAT,1815,48,15-19,1863,0.0010582829841065714
STAT,1888,40,35-39,1928,2.205914117933566
SIM,1938,33,50-100,1971,1
SIM,1813,44,40-44,1857,4
STAT,1825,48,25-29,1873,0.07307504732367698
STAT,1849,22,35-39,1871,5.477433755033349
STAT,1937,30,30-34,1967,15.91750141969748
SIM,1910,42,na,1952,3557
STAT,1917,44,20-24,1961,0.01874521201700587
STAT,1832,102,na,1934,0.19590772165555012
SIM,1827,31,20-24,1858,4
SIM,1822,39,na,1861,1484
SIM,1909,26,25-29,1935,72
STAT,1834,21,45-49,1855,0.6321416774685246
STAT,1945,21,25-29,1966,103.32105113024589
SIM,1918,38,35-39,1956,5
STAT,1931,11,na,1942,5297.10409390219
STAT,1882,39,15-19,1921,0.055249007619917787
STAT,1846,35,50-100,1881,0.9361035780239519
STAT,1892,39,25-29,1931,3.6441818143195044
SIM,1866,40,50-100,1906,2
STAT,1901,49,50-100,1950,0.19351014007821277
STAT,1900,30,35-39,1930,14.434261808351346
SIM,1854,35,50-100,1889,1
STAT,1852,40,20-24,1892,0.12923099986207282
SIM,1879,30,na,1909,2931
STAT,1902,43,15-19,1945,0.001369670247800103
STAT,1911,43,40-44,1954,0.24205139081861374
STAT,1901,43,30-34,1944,0.11306867955971137
SIM,1856,27,45-49,1883,1
STAT,1852,49,30-34,1901,0.07635402903404795
SIM,1930,22,35-39,1952,20
STAT,1852,16,na,1868,2249.803266375509
SIM,1854,34,35-39,1888,15
STAT,1841,53,40-44,1894,0.007648312330129745
STAT,1867,20,45-49,1887,0.6803327352010106
SIM,1842,53,na,1895,1565
STAT,1862,64,na,1926,1509.590502198781
SIM,1892,59,na,1951,2782
STAT,1854,33,30-34,1887,13.543031342608595
SIM,1933,15,na,1948,4937
STAT,1864,33,40-44,1897,3.9171583664971794
SIM,1859,19,na,1878,2537
SIM,1862,33,30-34,1895,16
STAT,1872,35,40-44,1907,4.518194833895322
STAT,1936,18,40-44,1954,1.3622501697187581
STAT,1846,34,35-39,1880,8.38243674935411
SIM,1837,79,na,1916,465
STAT,1882,21,25-29,1903,57.06685807925897
STAT,1837,22,25-29,1859,49.96476801293573
STAT,1914,41,50-100,1955,0.1189421467476611
STAT,1924,35,15-19,1959,0.023142785002519057
SIM,1850,41,40-44,1891,1
STAT,1848,27,45-49,1875,1.0303488970372656
SIM,1840,41,30-34,1881,3
SIM,1881,71,na,1952,1228
STAT,1814,42,25-29,1856,2.201203397299003
SIM,1853,21,20-24,1874,93
STAT,1824,42,35-39,1866,2.2311652766477565
STAT,1843,97,na,1940,4.336866204622806
STAT,1871,82,na,1953,471.4930380315497
SIM,1897,58,na,1955,2633
STAT,1915,49,30-34,1964,0.09112803568047995
STAT,1820,54,35-39,1874,0.01450641071853651
SIM,1898,33,45-49,1931,2
SIM,1838,27,na,1865,1858
SIM,1908,48,na,1956,3584
STAT,1810,54,25-29,1864,0.010188953186364178
STAT,1878,46,50-100,1924,0.26153355757059377
SIM,1862,16,30-34,1878,2
SIM,1885,29,30-34,1914,33
STAT,1901,22,15-19,1923,4.706318966516607
SIM,1852,16,20-24,1868,21
SIM,1863,41,35-39,1904,1
STAT,1776,94,na,1870,3.879394775898305
STAT,1835,31,na,1866,2077.1309868228664
STAT,1806,51,30-34,1857,0.019766640116952706
STAT,1854,16,30-34,1870,1.4679079201573844
STAT,1913,19,na,1932,4006.9335862291146
STAT,1816,51,40-44,1867,0.02113170492079257
STAT,1874,96,na,1970,47.605529115896516
SIM,1904,25,45-49,1929,1
STAT,1844,16,20-24,1860,17.566874772812444
STAT,1906,44,45-49,1950,0.1522366423800656
SIM,1818,65,na,1883,905
SIM,1880,27,na,1907,2357
STAT,1823,108,na,1931,0.0010194510150866663
STAT,1864,36,45-49,1900,1.8169597673668147
SIM,1884,15,50-100,1899,2
STAT,1845,31,na,1876,2034.4475117516317
STAT,1868,41,45-49,1909,1.4648756838388721
SIM,1894,44,na,1938,3070
STAT,1877,29,30-34,1906,26.454180613972973
STAT,1878,23,25-29,1901,60.599064021907004
SIM,1846,43,40-44,1889,4
SIM,1787,72,na,1859,417
STAT,1844,54,20-24,1898,5.560974023109847E-4
SIM,1836,43,30-34,1879,3
STAT,1832,98,na,1930,2.1707660142862855
SIM,1875,20,45-49,1895,1
SIM,1872,36,45-49,1908,4
STAT,1872,24,35-39,1896,5.9290173553503
STAT,1857,15,na,1872,2175.0430024989464
STAT,1955,17,na,1972,4983.683928296813
STAT,1966,3,na,1969,5010.965032569956
STAT,1833,47,20-24,1880,0.009297990770233109
SIM,1803,66,na,1869,689
STAT,1921,0,na,1921,5240.21363388883
SIM,1857,22,35-39,1879,6
SIM,1877,11,na,1888,2722
SIM,1886,23,25-29,1909,83
STAT,1838,43,40-44,1881,1.7364091510750466
STAT,1915,31,40-44,1946,4.083680541637022
STAT,1828,43,30-34,1871,0.9249307533396585
STAT,1852,45,15-19,1897,3.2545298255303817E-4
SIM,1879,77,na,1956,1142
STAT,1883,42,40-44,1925,2.248675473317536
STAT,1879,41,20-24,1920,0.17011734429499353
STAT,1873,42,30-34,1915,1.1875799823587594
STAT,1911,48,35-39,1959,0.1241573083756061
STAT,1884,48,na,1932,2242.1934361408107
SIM,1932,26,na,1958,5029
SIM,1859,28,25-29,1887,3
STAT,1826,50,20-24,1876,5.792876597335686E-4
STAT,1901,48,25-29,1949,0.04576885909436085
STAT,1832,34,50-100,1866,0.786041297743583
SIM,1907,59,na,1966,3226
STAT,1856,49,15-19,1905,3.136330695659475E-4
STAT,1805,65,na,1870,986.6621098704185
STAT,1903,19,40-44,1922,0.2638171251804297
STAT,1843,105,na,1948,0.02366978638448339
SIM,1874,49,25-29,1923,1
SIM,1818,38,30-34,1856,7
STAT,1831,34,40-44,1865,3.8698871431812205
STAT,1866,49,25-29,1915,0.05306822989927086
STAT,1928,36,45-49,1964,0.8795970371564711
STAT,1901,26,30-34,1927,36.047255292088884
STAT,1846,51,35-39,1897,0.006185982238255031
STAT,1937,23,40-44,1960,3.3387409196850535
SIM,1962,5,na,1967,5406
SIM,1824,72,na,1896,699
STAT,1830,32,na,1862,1770.9460489933408
STAT,1841,31,na,1872,1961.7814747667262
STAT,1822,47,45-49,1869,0.33650189364833716
SIM,1904,32,35-39,1936,13
STAT,1895,34,30-34,1929,23.04011129072669
STAT,1967,5,na,1972,5009.163717749834
SIM,1906,38,25-29,1944,1
STAT,1847,41,25-29,1888,0.5100481878803428
STAT,1874,17,45-49,1891,0.06803742931652261
SIM,1891,42,40-44,1933,7
STAT,1879,44,40-44,1923,2.3661509365378453
STAT,1837,97,na,1934,3.581816578615684
STAT,1921,27,45-49,1948,1.9647794336741922
STAT,1910,35,20-24,1945,0.25957812974539357
SIM,1828,44,35-39,1872,2
STAT,1858,96,na,1954,6.946671799869998
STAT,1900,20,40-44,1920,2.9639808697845234
STAT,1853,50,50-100,1903,0.012845617388564377
SIM,1898,23,35-39,1921,11
SIM,1868,32,20-24,1900,2
STAT,1893,41,20-24,1934,0.20645728603387292
STAT,1835,68,na,1903,1138.6078554999908
STAT,1834,83,na,1917,266.78222418027025
STAT,1812,45,50-100,1857,0.6015109555195457
STAT,1887,35,35-39,1922,8.162079685387496
STAT,1803,91,na,1894,22.485778883920595
STAT,1846,41,25-29,1887,0.4707727701879028
SIM,1895,35,35-39,1930,15
STAT,1859,27,20-24,1886,9.72276578346678
SIM,1894,0,na,1894,3725
STAT,1875,37,na,1912,2466.733198658972
STAT,1877,15,20-24,1892,18.84546408687295
STAT,1954,16,35-39,1970,5.292636240247543
STAT,1918,22,na,1940,4019.211408692526
STAT,1906,37,20-24,1943,0.24705006034885885
STAT,1899,0,na,1899,4101.973114631305
STAT,1876,81,na,1957,644.0786380877447
STAT,1893,46,15-19,1939,2.9283135543930073E-4
SIM,1824,65,na,1889,831
STAT,1936,25,30-34,1961,38.279534094929524
STAT,1858,16,15-19,1874,5.6415480267589855
STAT,1823,50,na,1873,1396.1513623777735
STAT,1841,38,15-19,1879,0.04834561168189961
STAT,1849,82,na,1931,362.2361869822798
SIM,1836,26,30-34,1862,38
SIM,1877,47,35-39,1924,1
STAT,1764,112,na,1876,0.0012474296353266958
STAT,1776,87,na,1863,52.10972812526444
STAT,1909,17,50-100,1926,0.07493107638044465
STAT,1917,19,35-39,1936,4.568318692611166
SIM,1826,29,25-29,1855,49
STAT,1855,43,25-29,1898,0.4942030375996864
SIM,1882,31,50-100,1913,1
SIM,1832,42,35-39,1874,2
STAT,1876,15,50-100,1891,0.05184926980586003
SIM,1842,94,na,1936,10
SIM,1858,18,30-34,1876,2
SIM,1939,5,na,1944,4023
STAT,1829,53,25-29,1882,0.002471990944488389
SIM,1944,18,40-44,1962,1
STAT,1845,21,20-24,1866,67.32796959627316
STAT,1895,17,30-34,1912,2.121457677428729
STAT,1940,18,na,1958,3811.375260864839
STAT,1889,48,15-19,1937,2.807575228938713E-4
STAT,1867,15,na,1882,2502.182416135449
STAT,1823,52,45-49,1875,0.021004506680159584
SIM,1932,25,20-24,1957,25
STAT,1839,50,30-34,1889,0.00421034190154528
STAT,1924,25,20-24,1949,21.831223470399927
STAT,1904,24,40-44,1928,3.0275930408060883
SIM,1861,30,45-49,1891,1
SIM,1912,24,40-44,1936,5
STAT,1891,33,35-39,1924,12.736487737928172
STAT,1828,83,na,1911,218.6075338050676
STAT,1890,43,45-49,1933,1.8533290097310784
STAT,1834,41,15-19,1875,0.011348077309928817
STAT,1843,53,25-29,1896,0.002813461134159711
STAT,1902,33,20-24,1935,3.8723328052727783
STAT,1828,26,30-34,1854,51.63543877422024
SIM,1918,48,45-49,1966,1
SIM,1925,19,35-39,1944,10
STAT,1878,30,15-19,1908,0.15243269286503844
STAT,1919,31,25-29,1950,10.217437047021532
SIM,1838,44,50-100,1882,4
STAT,1906,37,na,1943,3525.866532461076
STAT,1892,77,na,1969,1537.7111569359513
STAT,1869,47,35-39,1916,0.13724434352873646
STAT,1874,31,50-100,1905,0.9582263978418276
SIM,1873,45,na,1918,2309
SIM,1903,27,35-39,1930,18
STAT,1833,54,45-49,1887,0.009508821182081585
SIM,1927,31,25-29,1958,15
STAT,1867,51,20-24,1918,7.101102236093668E-4
STAT,1921,17,35-39,1938,4.880802559717798
STAT,1823,32,40-44,1855,11.04907998807916
STAT,1905,19,50-100,1924,0.07179482123661385
STAT,1896,44,25-29,1940,0.05927113455002013
STAT,1891,40,25-29,1931,0.8192267264591415
SIM,1863,34,50-100,1897,3
SIM,1938,14,na,1952,3930
SIM,1847,43,50-100,1890,2
STAT,1872,17,50-100,1889,0.05025551671625733
STAT,1860,42,20-24,1902,0.13128997179465776
STAT,1930,32,50-100,1962,1.088255691508242
STAT,1928,26,35-39,1954,18.931563310895204
SIM,1901,44,35-39,1945,1
STAT,1950,15,20-24,1965,163.6295040425645
SIM,1922,46,45-49,1968,1
STAT,1864,53,45-49,1917,0.012952592678312013
STAT,1890,23,40-44,1913,2.591180009617465
STAT,1875,42,15-19,1917,0.014441237292602854
SIM,1839,24,40-44,1863,3
STAT,1836,24,15-19,1860,2.671432352596411
STAT,1848,47,15-19,1895,3.094833976869144E-4
STAT,1841,40,45-49,1881,1.1780866188138226
STAT,1857,52,40-44,1909,0.008342925859519337
STAT,1871,19,35-39,1890,0.551510519526377
SIM,1857,93,na,1950,10
SIM,1832,91,na,1923,15
SIM,1849,20,35-39,1869,7
STAT,1839,43,50-100,1882,0.7586622007752452
SIM,1867,27,20-24,1894,15
STAT,1860,47,15-19,1907,3.2954188646950255E-4
SIM,1899,19,30-34,1918,5
SIM,1873,43,35-39,1916,6
SIM,1872,30,20-24,1902,3
STAT,1910,12,na,1922,3991.179430439432
STAT,1880,26,35-39,1906,10.379434687744407
STAT,1934,30,50-100,1964,1.1525075109832803
SIM,1885,30,na,1915,2414
SIM,1857,32,45-49,1889,1
SIM,1919,33,40-44,1952,6
STAT,1817,50,na,1867,1363.2306679424973
STAT,1883,47,50-100,1930,0.24469100564278407
STAT,1816,43,50-100,1859,2.3870342203623043
SIM,1855,64,na,1919,1358
STAT,1856,108,na,1964,0.008871058632439461
STAT,1851,35,20-24,1886,0.6562625168152417
STAT,1874,48,20-24,1922,0.012341695580144342
STAT,1887,22,na,1909,2703.566025587359
SIM,1872,60,na,1932,2033
SIM,1949,19,20-24,1968,167
STAT,1890,22,50-100,1912,0.5086520083134465
SIM,1821,35,35-39,1856,3
STAT,1916,33,15-19,1949,0.13481763737582358
SIM,1887,44,40-44,1931,8
SIM,1894,22,20-24,1916,90
SIM,1835,40,45-49,1875,4
STAT,1865,43,35-39,1908,1.6645259473159213
SIM,1936,26,35-39,1962,15
STAT,1888,32,50-100,1920,1.1050106466969118
STAT,1894,31,45-49,1925,2.297626576493238
STAT,1855,82,na,1937,361.69389654831946
STAT,1870,33,50-100,1903,0.9098815395459711
SIM,1844,17,25-29,1861,5
STAT,1910,38,40-44,1948,1.452983684339245
SIM,1850,20,50-100,1870,1
SIM,1903,60,na,1963,2877
STAT,1849,32,45-49,1881,1.4266039736722556
STAT,1827,40,45-49,1867,1.8414481019343338
STAT,1898,15,40-44,1913,0.2534966930537229
STAT,1905,52,na,1957,3192.6618394436023
STAT,1841,33,50-100,1874,0.8123324287473853
STAT,1886,22,20-24,1908,74.4125448269749
SIM,1882,48,20-24,1930,1
STAT,1818,38,50-100,1856,4.107751531352478
STAT,1842,66,na,1908,1285.319305159617
STAT,1845,37,30-34,1882,4.375338633592867
STAT,1887,78,na,1965,1220.313044112654
STAT,1847,45,40-44,1892,0.13483496530191785
SIM,1887,46,45-49,1933,2
STAT,1829,44,50-100,1873,0.8627794213308109
STAT,1846,56,na,1902,1458.586677549663
SIM,1864,27,35-39,1891,17
STAT,1920,46,50-100,1966,0.2557804317658081
STAT,1884,39,35-39,1923,7.066730066302212
SIM,1945,18,na,1963,4376
STAT,1947,21,45-49,1968,1.297862522605412
SIM,1901,23,15-19,1924,4
STAT,1913,15,50-100,1928,0.0785089261671109
SIM,1842,34,20-24,1876,4
STAT,1850,50,40-44,1900,0.00803274743365987
SIM,1901,3,na,1904,3876
STAT,1924,21,50-100,1945,0.7945412103305083
STAT,1886,36,35-39,1922,7.674185540578658
SIM,1889,43,45-49,1932,3
SIM,1848,19,20-24,1867,29
SIM,1840,37,20-24,1877,2
SIM,1825,37,25-29,1862,3
STAT,1840,31,40-44,1871,3.8406555098367594
SIM,1903,31,25-29,1934,23
STAT,1819,45,35-39,1864,0.28554887177048865
STAT,1863,17,25-29,1880,5.783766494601284
SIM,1844,42,30-34,1886,2
STAT,1895,73,na,1968,1952.6861775081063
STAT,1936,28,50-100,1964,0.971097656720611
STAT,1836,31,20-24,1867,2.1490278530440254
SIM,1862,39,na,1901,2118
SIM,1875,25,45-49,1900,2
STAT,1892,47,15-19,1939,2.8714097369957325E-4
STAT,1852,32,50-100,1884,0.7642443582053166
STAT,1920,47,45-49,1967,0.24517295938322117
STAT,1854,51,na,1905,1655.8215865866355
STAT,1899,63,na,1962,2658.948446860403
STAT,1817,48,35-39,1865,0.3079819383691166
SIM,1919,23,30-34,1942,55
STAT,1823,34,45-49,1857,3.6472772108658575
SIM,1875,81,na,1956,630
SIM,1892,22,40-44,1914,5
STAT,1856,27,35-39,1883,8.006833008905398
STAT,1836,42,30-34,1878,0.8513502436031843
STAT,1883,88,na,1971,383.60243479087063
SIM,1855,32,35-39,1887,18
SIM,1892,28,25-29,1920,70
STAT,1834,45,30-34,1879,0.07788784618561939
STAT,1841,26,50-100,1867,0.5908850045447119
SIM,1890,25,40-44,1915,5
STAT,1844,104,na,1948,0.05168662119095313
SIM,1808,51,na,1859,1475
STAT,1825,31,45-49,1856,3.774587423493288
STAT,1911,37,na,1948,3706.597976886815
STAT,1817,37,25-29,1854,10.183407312365675
STAT,1852,27,20-24,1879,11.007824915241407
SIM,1766,94,na,1860,1
SIM,1878,20,50-100,1898,2
STAT,1939,29,20-24,1968,18.701573565583935
STAT,1877,49,45-49,1926,0.24449456896488228
SIM,1892,39,35-39,1931,15
STAT,1884,28,25-29,1912,42.54380541390139
STAT,1892,43,50-100,1935,1.3409816802980314
STAT,1894,44,15-19,1938,0.0012414088558288343
STAT,1824,53,na,1877,1296.510917134507
STAT,1834,34,20-24,1868,2.282167068200119
SIM,1832,27,15-19,1859,1
SIM,1901,34,25-29,1935,9
SIM,1853,78,na,1931,547
STAT,1858,35,45-49,1893,1.6280624792241702
STAT,1847,32,35-39,1879,9.272339993304108
STAT,1812,68,na,1880,819.5957215793659
STAT,1894,46,40-44,1940,0.12708208814497718
SIM,1908,20,20-24,1928,141
SIM,1831,34,45-49,1865,2
STAT,1884,22,40-44,1906,2.103152030051299
STAT,1831,42,25-29,1873,0.5442302384471407
SIM,1886,25,20-24,1911,12
STAT,1919,23,35-39,1942,10.489121765975176
SIM,1906,19,na,1925,3735
SIM,1848,42,45-49,1890,5
STAT,1763,93,na,1856,2.2485861144
STAT,1893,15,15-19,1908,7.715861125733302
SIM,1898,50,na,1948,3347
STAT,1833,50,35-39,1883,0.006105879329265867
STAT,1862,21,20-24,1883,61.70427539819372
STAT,1899,36,45-49,1935,2.7982441117653423
STAT,1819,47,30-34,1866,0.19177465497469265
STAT,1851,46,15-19,1897,3.309436247254076E-4
SIM,1851,27,25-29,1878,55
SIM,1853,35,35-39,1888,9
STAT,1927,42,25-29,1969,0.09135579506596558
STAT,1829,52,40-44,1881,0.007494300948381151
SIM,1838,37,35-39,1875,13
STAT,1825,94,na,1919,11.98490780451897
STAT,1843,27,25-29,1870,42.02619066914297
STAT,1832,37,20-24,1869,0.654643598157653
SIM,1834,24,15-19,1858,3
SIM,1865,63,na,1928,1662
SIM,1857,42,40-44,1899,1
STAT,1896,43,40-44,1939,0.20892873092824638
STAT,1936,20,30-34,1956,28.045340707713333
SIM,1910,24,na,1934,3564
SIM,1894,60,na,1954,2569
STAT,1874,12,na,1886,2722.94613127178
STAT,1881,37,50-100,1918,1.2108949445284765
SIM,1914,38,na,1952,3811
SIM,1851,38,35-39,1889,15
SIM,1870,21,20-24,1891,4
SIM,1907,44,na,1951,3478
STAT,1873,30,na,1903,2487.8796749367734
STAT,1949,20,40-44,1969,4.005605796670884
SIM,1825,31,40-44,1856,9
STAT,1769,90,na,1859,13.886976267057968
STAT,1890,25,45-49,1915,1.3943177759562102
STAT,1923,22,na,1945,4335.300563076764
STAT,1770,87,na,1857,33.394055962490995
SIM,1861,73,na,1934,1142
STAT,1841,25,na,1866,2012.667752986628
STAT,1923,37,15-19,1960,0.022702466222883518
STAT,1816,58,na,1874,1086.7612062432518
STAT,1927,31,15-19,1958,0.16134306698861964
STAT,1897,20,25-29,1917,78.55100899911751
STAT,1860,24,20-24,1884,57.958604279550165
STAT,1897,39,45-49,1936,0.5810059960351375
STAT,1821,39,40-44,1860,8.437542826388036
SIM,1853,37,30-34,1890,7
STAT,1878,25,20-24,1903,12.541686844339798
STAT,1843,38,35-39,1881,6.003092237841306
SIM,1836,21,15-19,1857,1
SIM,1880,9,na,1889,2643
STAT,1849,42,40-44,1891,1.744099084278742
STAT,1879,46,45-49,1925,0.25237428920417143
STAT,1817,99,na,1916,0.9242687206159308
STAT,1855,40,15-19,1895,0.010813377034963085
STAT,1865,32,50-100,1897,0.8483543502279538
SIM,1869,27,40-44,1896,5
STAT,1853,43,15-19,1896,0.011495876086620347
STAT,1831,53,35-39,1884,0.006072175690446816
STAT,1851,21,45-49,1872,0.6919917971851833
SIM,1902,29,na,1931,3441
STAT,1850,61,na,1911,1405.5967042950429
STAT,1863,28,50-100,1891,0.5701599065654523
STAT,1885,9,na,1894,2640.7625433096223
SIM,1815,44,50-100,1859,4
SIM,1855,34,30-34,1889,25
STAT,1939,16,15-19,1955,46.35500964966557
STAT,1948,14,na,1962,4584.786310882105
STAT,1772,111,na,1883,6.768845010772568E-4
STAT,1897,28,35-39,1925,13.115162982392969
STAT,1845,35,35-39,1880,6.514716131251937
STAT,1821,37,45-49,1858,4.364860396178684
SIM,1857,68,na,1925,1162
STAT,1847,34,30-34,1881,14.248367741903197
STAT,1925,34,15-19,1959,0.15548750010100262
SIM,1838,48,45-49,1886,1
SIM,1947,16,15-19,1963,71
STAT,1820,63,na,1883,1003.2108355682903
SIM,1852,37,na,1889,2028
STAT,1898,40,40-44,1938,0.21765251824133197
STAT,1915,27,na,1942,3899.1150524279083
STAT,1862,32,30-34,1894,15.162019154851528
STAT,1902,60,na,1962,2900.0191756961976
STAT,1919,36,40-44,1955,1.642643252707125
SIM,1869,16,30-34,1885,5
STAT,1880,51,35-39,1931,0.0092733244413022
SIM,1841,37,50-100,1878,1
SIM,1870,38,45-49,1908,5
SIM,1920,34,35-39,1954,5
STAT,1917,28,30-34,1945,41.785901178286174
STAT,1838,45,45-49,1883,0.18302484696864474
STAT,1855,54,35-39,1909,0.006490204743079088
STAT,1873,22,35-39,1895,6.035342825758491
SIM,1819,35,na,1854,1624
STAT,1851,49,25-29,1900,0.046528798469070855
SIM,1925,39,40-44,1964,3
STAT,1805,52,25-29,1857,0.01248209109412988
SIM,1860,32,na,1892,2074
STAT,1861,51,25-29,1912,0.0030000903128412147
STAT,1936,29,na,1965,3653.009686245493
SIM,1872,32,40-44,1904,4
SIM,1822,41,40-44,1863,2
STAT,1870,43,20-24,1913,0.15723422298348427
STAT,1879,27,na,1906,2544.880992636469
SIM,1823,40,na,1863,1637
STAT,1860,21,40-44,1881,1.790879129404216
STAT,1888,49,20-24,1937,0.007993101570606655
STAT,1933,23,50-100,1956,0.889803351970637
SIM,1843,19,15-19,1862,4
STAT,1843,30,50-100,1873,0.9078735064112583
SIM,1922,31,35-39,1953,3
SIM,1887,40,30-34,1927,2
STAT,1899,39,25-29,1938,0.8594084999088383
SIM,1879,38,35-39,1917,14
STAT,1917,39,40-44,1956,1.5770965788136333
SIM,1877,38,30-34,1915,9
STAT,1872,54,35-39,1926,0.008560103865804965
SIM,1891,12,na,1903,3336
SIM,1911,32,50-100,1943,4
SIM,1786,90,na,1876,13
STAT,1862,38,45-49,1900,1.7225574461246913
STAT,1839,38,15-19,1877,0.0458340398741181
STAT,1841,27,45-49,1868,1.0182252527348234
SIM,1799,81,na,1880,322
SIM,1846,45,45-49,1891,1
SIM,1927,23,35-39,1950,13
SIM,1936,29,45-49,1965,2
SIM,1890,70,na,1960,1862
STAT,1895,25,20-24,1920,15.720625269531569
SIM,1895,26,na,1921,3328
STAT,1938,27,50-100,1965,1.0059113454701198
SIM,1886,65,na,1951,1841
STAT,1869,38,30-34,1907,5.223110331988336
SIM,1802,94,na,1896,7
STAT,1878,16,30-34,1894,1.6966248986258818
STAT,1831,23,na,1854,1716.1311547471457
STAT,1860,38,35-39,1898,5.825320315971729
STAT,1879,40,30-34,1919,1.2383247934086719
SIM,1822,42,25-29,1864,1
STAT,1820,52,20-24,1872,0.0012939460190146699
STAT,1886,38,30-34,1924,5.7263980683129025
STAT,1912,47,40-44,1959,0.15457036704452895
STAT,1890,20,15-19,1910,4.139546672857568
STAT,1904,67,na,1971,2692.1713125280044
STAT,1947,23,40-44,1970,3.875848428039273
SIM,1934,18,30-34,1952,24
SIM,1811,55,na,1866,1000
STAT,1828,34,20-24,1862,2.4982889586209405
STAT,1891,18,45-49,1909,0.08228603334107983
STAT,1841,16,35-39,1857,0.5256212205679905
STAT,1840,99,na,1939,1.362822826238763
STAT,1881,33,25-29,1914,10.059418549818938
SIM,1856,27,na,1883,2492
SIM,1888,20,25-29,1908,1
STAT,1883,36,50-100,1919,1.234842969452722
STAT,1892,22,45-49,1914,0.8915687855018337
STAT,1810,45,15-19,1855,0.0013026575955594802
STAT,1832,64,na,1896,1161.6196769477644
SIM,1894,38,30-34,1932,11
STAT,1860,27,25-29,1887,35.38864754433829
STAT,1903,41,30-34,1944,0.11629821184686664
SIM,1880,43,25-29,1923,2
STAT,1837,24,20-24,1861,59.28716409899691
STAT,1896,41,15-19,1937,0.0012979353107125608
STAT,1928,29,45-49,1957,2.168857720328953
STAT,1829,84,na,1913,221.24891412691915
STAT,1854,24,20-24,1878,61.08387563539788
STAT,1882,28,45-49,1910,1.0996202079350903
SIM,1934,29,40-44,1963,2
STAT,1879,41,15-19,1920,0.014792813346363396
STAT,1875,46,30-34,1921,0.10163838476276092
STAT,1943,18,30-34,1961,13.182867688612015
SIM,1902,13,na,1915,3771
SIM,1879,30,25-29,1909,18
SIM,1915,18,20-24,1933,33
SIM,1951,18,30-34,1969,15
STAT,1880,19,50-100,1899,0.05223908676507946
SIM,1903,54,na,1957,2959
SIM,1898,30,35-39,1928,21
SIM,1874,32,45-49,1906,3
STAT,1820,79,na,1899,385.0353750214309
SIM,1831,31,40-44,1862,10
SIM,1896,30,30-34,1926,34
STAT,1875,35,20-24,1910,0.8147520014125685
STAT,1835,19,15-19,1854,12.176101196868856
STAT,1924,18,20-24,1942,164.2858289206953
STAT,1834,31,40-44,1865,3.7773024950158427
STAT,1830,24,35-39,1854,13.732459943328276
SIM,1833,31,45-49,1864,3
STAT,1870,41,25-29,1911,0.6432969105887325
STAT,1891,18,15-19,1909,7.475687641786314
SIM,1932,18,20-24,1950,188
STAT,1850,17,15-19,1867,5.454934092445687
SIM,1894,36,35-39,1930,9
STAT,1844,73,na,1917,920.4030581524491
SIM,1847,9,na,1856,2183
STAT,1873,24,30-34,1897,18.307019303468557
STAT,1913,15,40-44,1928,0.29310006229848545
STAT,1927,31,50-100,1958,1.0380751515958697
SIM,1845,24,20-24,1869,4
SIM,1823,37,45-49,1860,4
SIM,1864,7,na,1871,2597
STAT,1861,53,20-24,1914,6.120550455968541E-4
STAT,1872,43,25-29,1915,0.6518175466129634
STAT,1820,50,25-29,1870,0.0064633899876248525
SIM,1888,40,50-100,1928,2
STAT,1807,81,na,1888,256.1474785302667
STAT,1862,86,na,1948,192.6772851866589
STAT,1853,10,na,1863,2438.078727963362
SIM,1862,24,20-24,1886,51
SIM,1920,26,na,1946,4012
STAT,1782,72,na,1854,504.0
SIM,1883,22,45-49,1905,3
SIM,1900,26,50-100,1926,1
STAT,1853,45,40-44,1898,0.14498211662804697
STAT,1803,52,20-24,1855,0.0029806332294358404
SIM,1890,28,45-49,1918,4
SIM,1917,18,25-29,1935,49
STAT,1922,41,40-44,1963,0.2933598503668252
SIM,1921,15,40-44,1936,2
SIM,1892,25,20-24,1917,21
STAT,1830,26,30-34,1856,30.99061598221053
SIM,1877,36,35-39,1913,2
STAT,1959,3,na,1962,5247.435099674423
SIM,1891,20,50-100,1911,1
SIM,1849,57,na,1906,1574
STAT,1922,17,50-100,1939,0.44242150067796837
STAT,1854,26,50-100,1880,0.5680915688014982
STAT,1819,106,na,1925,0.007158218598950605
STAT,1847,48,20-24,1895,0.00924017598464826
STAT,1861,40,45-49,1901,1.274350341118502
STAT,1843,21,40-44,1864,2.1267788587177585
STAT,1881,32,40-44,1913,4.2772054869770795
STAT,1869,36,35-39,1905,6.999708596646876
STAT,1849,48,25-29,1897,0.04415647881113842
STAT,1909,18,25-29,1927,8.644321966412903
SIM,1851,21,40-44,1872,3
SIM,1930,41,40-44,1971,1
STAT,1861,45,na,1906,1915.452053381011
SIM,1841,53,na,1894,1619
STAT,1943,29,40-44,1972,5.059573796402107
STAT,1814,41,40-44,1855,8.110331024120986
SIM,1852,43,50-100,1895,2
STAT,1907,18,20-24,1925,26.485761024760812
SIM,1849,33,na,1882,1885
STAT,1936,32,25-29,1968,9.15651945698796
STAT,1862,37,30-34,1899,4.628205519670944
STAT,1821,34,40-44,1855,11.742857525852125
STAT,1835,41,50-100,1876,0.9557011075592876
SIM,1890,28,20-24,1918,23
STAT,1880,17,25-29,1897,6.074900702451408
STAT,1934,24,15-19,1958,7.290419024761749
SIM,1826,29,na,1855,1783
SIM,1843,41,50-100,1884,2
SIM,1870,32,30-34,1902,37
STAT,1892,1,na,1893,3480.074743585804
STAT,1919,37,50-100,1956,0.46028711267185707
STAT,1891,43,na,1934,2898.004191377524
STAT,1857,19,20-24,1876,16.406350979296995
SIM,1919,15,25-29,1934,13
SIM,1875,39,35-39,1914,8
SIM,1847,27,35-39,1874,10
STAT,1910,23,15-19,1933,5.0827742284741975
STAT,1867,39,35-39,1906,6.705784262508383
STAT,1897,36,40-44,1933,5.999813105460129
STAT,1858,38,25-29,1896,2.317739308158874
STAT,1859,16,20-24,1875,16.8654465829058
STAT,1847,48,50-100,1895,0.18911559433155314
SIM,1890,17,35-39,1907,1
STAT,1819,82,na,1901,275.0769511197485
SIM,1842,48,35-39,1890,1
STAT,1915,15,45-49,1930,0.10718457301877249
SIM,1919,26,35-39,1945,24
STAT,1811,86,na,1897,96.10753528628186
STAT,1815,92,na,1907,21.535889008760066
STAT,1834,37,25-29,1871,2.4100866259685962
SIM,1864,24,30-34,1888,30
SIM,1837,48,na,1885,1466
STAT,1838,40,15-19,1878,0.012174423782537004
STAT,1863,50,20-24,1913,6.695182214545064E-4
SIM,1838,45,40-44,1883,1
SIM,1942,24,15-19,1966,1
STAT,1926,29,40-44,1955,5.6593953045807535
STAT,1927,6,na,1933,5083.602267213688
STAT,1832,88,na,1920,91.73673197661611
STAT,1847,37,35-39,1884,5.722634957770297
STAT,1823,47,20-24,1870,0.018040131866968
STAT,1872,40,50-100,1912,1.0910468160349573
SIM,1902,30,50-100,1932,2
STAT,1882,47,na,1929,2225.6399618308415
STAT,1919,20,30-34,1939,32.30797385099616
STAT,1873,86,na,1959,322.23192016733566
SIM,1847,38,45-49,1885,3
STAT,1956,16,15-19,1972,61.26442308690494
STAT,1814,51,na,1865,1352.6357635003292
STAT,1863,16,40-44,1879,0.18778671915884937
STAT,1839,27,35-39,1866,8.389043899953489
SIM,1854,17,25-29,1871,7
STAT,1864,34,30-34,1898,15.701807321246202
STAT,1870,2,na,1872,3313.281827125232
SIM,1838,34,30-34,1872,29
STAT,1940,21,35-39,1961,9.788632464927007
STAT,1874,54,45-49,1928,0.014699908471288822
STAT,1926,18,30-34,1944,15.205362279577457
STAT,1858,46,30-34,1904,0.07853428466450951
STAT,1916,52,na,1968,3780.6080511182067
STAT,1847,48,45-49,1895,0.1817234541349594
STAT,1833,89,na,1922,68.98819637616157
STAT,1890,38,20-24,1928,0.9567391500147462
STAT,1906,22,40-44,1928,3.094134681841067
STAT,1930,15,40-44,1945,1.8528985322017077
SIM,1864,35,40-44,1899,3
STAT,1874,34,50-100,1908,0.9461558545924776
STAT,1899,49,20-24,1948,0.009258651451447854
SIM,1845,43,na,1888,1798
STAT,1890,42,na,1932,2879.3452314402784
STAT,1882,28,20-24,1910,11.618575731839611
STAT,1934,35,25-29,1969,1.3880328058178488
SIM,1927,37,50-100,1964,2
STAT,1869,25,na,1894,2366.453471767026
STAT,1898,22,na,1920,3262.7085354492383
STAT,1791,89,na,1880,34.19164334175205
STAT,1896,46,45-49,1942,0.17987386340625186
STAT,1846,17,25-29,1863,5.09063389797015
SIM,1820,91,na,1911,45
STAT,1936,23,35-39,1959,9.17856240215033
STAT,1874,71,na,1945,1390.2774016984804
STAT,1938,31,45-49,1969,1.6149626381819286
STAT,1839,38,45-49,1877,1.627108222028232
SIM,1855,37,35-39,1892,3
STAT,1877,46,40-44,1923,0.18165861923210205
STAT,1865,28,15-19,1893,0.41860576814981726
STAT,1916,25,50-100,1941,1.0573612968647805
STAT,1830,27,45-49,1857,1.2559662720536486
STAT,1864,35,45-49,1899,1.8254297614599888
SIM,1888,28,35-39,1916,17
SIM,1900,7,na,1907,3749
STAT,1856,24,30-34,1880,16.32942249526191
SIM,1929,33,40-44,1962,6
STAT,1836,47,30-34,1883,0.06305928544518823
STAT,1818,84,na,1902,169.53075159072847
STAT,1893,18,25-29,1911,7.314362610518274
STAT,1848,63,na,1911,1386.998773934717
SIM,1869,93,na,1962,57
STAT,1867,25,15-19,1892,0.43747327137531605
STAT,1908,34,15-19,1942,0.12263107262822298
SIM,1828,71,na,1899,858
SIM,1882,18,15-19,1900,6
SIM,1834,38,35-39,1872,1
SIM,1836,47,na,1883,1749
STAT,1938,20,35-39,1958,9.512748384419009
STAT,1871,17,50-100,1888,0.04982723779837405
STAT,1903,44,35-39,1947,0.17989188209907178
STAT,1858,81,na,1939,437.48263228087706
STAT,1812,45,25-29,1857,0.14107097228625706
STAT,1897,25,30-34,1922,34.58206772262192
SIM,1888,39,45-49,1927,7
STAT,1841,84,na,1925,245.6227550372574
SIM,1834,27,25-29,1861,39
STAT,1832,49,15-19,1881,2.816571816704416E-4
SIM,1908,25,20-24,1933,22
STAT,1812,42,15-19,1854,0.039847153421972065
STAT,1918,19,50-100,1937,0.41390951852626146
SIM,1872,97,na,1969,23
STAT,1908,45,25-29,1953,0.04963776063572462
SIM,1881,22,35-39,1903,8
SIM,1944,23,35-39,1967,14
SIM,1882,35,na,1917,2308
STAT,1903,42,na,1945,3359.112683378702
SIM,1889,14,na,1903,3355
SIM,1886,49,na,1935,2502
STAT,1834,48,35-39,1882,0.09864426407470178
STAT,1849,45,45-49,1894,0.1850477227480979
SIM,1836,37,30-34,1873,8
SIM,1897,42,50-100,1939,2
STAT,1826,38,35-39,1864,6.153771253080634
STAT,1901,47,35-39,1948,0.11213410062476303
STAT,1971,0,na,1971,5117.318846708193
STAT,1861,17,20-24,1878,17.177076688256726
STAT,1936,21,15-19,1957,5.192425035765879
SIM,1858,29,30-34,1887,25
SIM,1927,36,40-44,1963,3
STAT,1931,19,50-100,1950,0.4974434641404715
STAT,1788,69,na,1857,743.0549808984241
SIM,1944,2,na,1946,4400
SIM,1864,38,45-49,1902,1
SIM,1881,20,15-19,1901,4
STAT,1832,24,45-49,1856,0.671820337635012
STAT,1895,28,30-34,1923,33.39940300784222
SIM,1944,21,15-19,1965,5
STAT,1893,29,35-39,1922,12.397878791659284
STAT,1850,17,45-49,1867,0.06004329101384479
STAT,1877,76,na,1953,1002.4345092137281
SIM,1849,35,45-49,1884,1
STAT,1914,31,35-39,1945,9.423688003856746
STAT,1810,48,25-29,1858,0.1779263532549993
SIM,1795,91,na,1886,23
SIM,1906,15,15-19,1921,10
STAT,1951,18,na,1969,4469.957462623632
SIM,1878,14,na,1892,2828
SIM,1877,34,50-100,1911,3
STAT,1828,37,30-34,1865,4.672396812304418
SIM,1870,50,na,1920,2409
STAT,1881,30,15-19,1911,0.14158245572132275
STAT,1840,34,45-49,1874,1.4969860024399408
STAT,1881,35,45-49,1916,1.9848034746654644
SIM,1837,91,na,1928,39
STAT,1888,45,50-100,1933,0.29915153362688957
STAT,1927,30,30-34,1957,19.79215362700027
STAT,1876,19,30-34,1895,1.6700246196300759
SIM,1840,21,35-39,1861,8
SIM,1913,26,50-100,1939,1
SIM,1919,48,50-100,1967,1
STAT,1860,24,45-49,1884,0.5864797919738421
STAT,1864,48,20-24,1912,0.010748217903660054
STAT,1900,16,15-19,1916,8.411765346709595
STAT,1821,51,50-100,1872,0.023314866376012447
STAT,1876,28,20-24,1904,12.314754451646083
SIM,1823,33,50-100,1856,1
STAT,1855,51,30-34,1906,0.004636484296294606
STAT,1865,28,45-49,1893,1.0244141271648848
SIM,1918,31,15-19,1949,6
STAT,1886,39,45-49,1925,2.1309261965280553
STAT,1879,43,na,1922,2446.798343431179
STAT,1893,15,45-49,1908,0.08492965948688583
STAT,1905,26,50-100,1931,0.9457216701444501
SIM,1879,33,50-100,1912,1
STAT,1890,58,na,1948,2466.7302330824073
SIM,1817,37,20-24,1854,2
SIM,1939,19,15-19,1958,69
SIM,1938,26,45-49,1964,1
STAT,1860,35,30-34,1895,4.453262801176282
STAT,1814,44,45-49,1858,4.6744364126336855
STAT,1932,39,na,1971,5144.119178666629
STAT,1888,63,na,1951,2151.90696839246
SIM,1822,44,45-49,1866,1
STAT,1864,30,15-19,1894,0.1302138129407773
SIM,1903,34,35-39,1937,7
STAT,1828,37,25-29,1865,2.5241683789980374
SIM,1965,5,na,1970,4973
SIM,1908,28,30-34,1936,53
SIM,1877,29,na,1906,2414
SIM,1895,18,25-29,1913,18
STAT,1894,42,50-100,1936,0.09614867626505719
SIM,1869,5,na,1874,2832
STAT,1908,41,50-100,1949,0.11147336174819807
SIM,1894,39,45-49,1933,3
SIM,1845,15,30-34,1860,2
STAT,1889,17,45-49,1906,0.08231573845380082
SIM,1945,16,35-39,1961,4
STAT,1789,67,na,1856,586.58420192
STAT,1865,35,na,1900,2202.123003826234
STAT,1871,25,35-39,1896,9.816630305492392
SIM,1884,28,20-24,1912,1
SIM,1828,27,25-29,1855,8
SIM,1839,29,20-24,1868,13
SIM,1885,43,30-34,1928,3
STAT,1804,92,na,1896,14.053338020041748
STAT,1857,40,na,1897,1859.9888558673442
SIM,1881,48,50-100,1929,1
STAT,1880,17,30-34,1897,1.7086752433370394
SIM,1851,12,na,1863,2315
SIM,1916,41,50-100,1957,2
STAT,1854,27,25-29,1881,33.94017065054925
STAT,1877,32,20-24,1909,2.8600685167236057
STAT,1918,41,15-19,1959,0.0016686048780756818
STAT,1838,44,30-34,1882,0.8762293966347788
STAT,1944,24,na,1968,4020.0234265510057
STAT,1837,26,40-44,1863,2.582021425254636
SIM,1862,27,25-29,1889,48
SIM,1922,6,na,1928,4733
STAT,1877,43,30-34,1920,1.2076604730010174
STAT,1873,48,50-100,1921,0.2508200313000395
SIM,1946,20,35-39,1966,12
SIM,1818,52,30-34,1870,1
SIM,1837,32,na,1869,1674
STAT,1858,54,50-100,1912,0.011882246635897134
STAT,1911,18,40-44,1929,0.28475579857487693
STAT,1919,17,na,1936,4150.802846362033
SIM,1885,32,20-24,1917,4
SIM,1823,34,40-44,1857,7
STAT,1937,16,35-39,1953,4.17412659161031
SIM,1845,26,40-44,1871,5
SIM,1924,16,na,1940,4562
STAT,1861,61,na,1922,1575.2004412096994
SIM,1846,44,30-34,1890,4
STAT,1865,75,na,1940,953.1818499707999
SIM,1914,22,40-44,1936,4
STAT,1876,78,na,1954,823.0788303538837
SIM,1886,25,na,1911,2686
SIM,1853,38,45-49,1891,5
STAT,1879,45,30-34,1924,0.10425225489391637
STAT,1877,60,na,1937,2017.9600428844606
STAT,1834,34,45-49,1868,1.472292671794592
STAT,1808,47,25-29,1855,0.15273138107764142
STAT,1926,15,20-24,1941,170.3606369800753
SIM,1862,15,na,1877,2389
STAT,1845,15,na,1860,2293.8155478329572
SIM,1866,29,na,1895,2337
STAT,1875,49,35-39,1924,0.14352098217588843
STAT,1922,44,45-49,1966,0.19426837752945444
STAT,1854,27,30-34,1881,20.20447438930851
SIM,1836,37,25-29,1873,1
STAT,1849,45,20-24,1894,0.00940920659851074
SIM,1862,27,30-34,1889,36
STAT,1891,5,na,1896,3309.8610442235445
STAT,1894,49,45-49,1943,0.17103994567119674
STAT,1895,28,25-29,1923,56.10546534744221
STAT,1844,51,25-29,1895,0.002757878681568023
STAT,1882,25,40-44,1907,2.9974199927177976
SIM,1829,42,35-39,1871,3
STAT,1841,24,40-44,1865,1.9211935399744748
STAT,1881,41,30-34,1922,1.1390223910368062
SIM,1881,25,45-49,1906,1
STAT,1870,81,na,1951,539.2842692197854
STAT,1866,32,45-49,1898,1.6408846879330632
SIM,1798,56,na,1854,1058
SIM,1850,73,na,1923,704
STAT,1945,26,40-44,1971,5.219587212803585
STAT,1837,28,50-100,1865,0.5434923947350404
SIM,1824,81,na,1905,191
STAT,1855,92,na,1947,32.28655387827328
SIM,1927,20,30-34,1947,60
SIM,1833,58,na,1891,1316
STAT,1881,30,20-24,1911,2.687395169997684
STAT,1846,53,25-29,1899,0.0024923009498390215
SIM,1842,34,45-49,1876,3
STAT,1887,18,25-29,1905,6.460854582578201
STAT,1874,51,35-39,1925,0.009009770698868082
SIM,1935,30,30-34,1965,29
SIM,1875,28,25-29,1903,45
STAT,1819,48,45-49,1867,0.46080722839552757
STAT,1929,42,35-39,1971,0.2659767401312648
SIM,1883,31,50-100,1914,2
STAT,1910,39,30-34,1949,1.7599220956103225
SIM,1809,52,50-100,1861,1
STAT,1875,38,25-29,1913,2.999597953795129
STAT,1900,37,na,1937,3357.519182965561
SIM,1882,75,na,1957,888
SIM,1953,13,na,1966,4766
STAT,1803,54,40-44,1857,0.040841455505172854
STAT,1788,103,na,1891,0.04752519340025359
SIM,1844,31,20-24,1875,4
STAT,1956,16,45-49,1972,0.6743468430345607
STAT,1855,42,40-44,1897,1.7414880578731171
STAT,1903,44,40-44,1947,0.22345006905529086
STAT,1894,32,na,1926,3131.3608171756027
SIM,1870,35,40-44,1905,10
STAT,1810,61,na,1871,951.7777457983786
SIM,1834,24,45-49,1858,3
STAT,1835,27,20-24,1862,11.396515302351572
STAT,1865,17,35-39,1882,0.5235376559687124
SIM,1874,41,35-39,1915,2
STAT,1821,64,na,1885,931.7905227751385
STAT,1947,20,30-34,1967,33.16435495680411
SIM,1879,35,30-34,1914,2
STAT,1866,41,35-39,1907,1.7116316170639412
SIM,1896,33,35-39,1929,6
SIM,1883,38,25-29,1921,5
STAT,1870,45,40-44,1915,0.17243349221010545
SIM,1843,27,20-24,1870,11
STAT,1921,21,25-29,1942,106.7834568759048
STAT,1828,43,na,1871,1439.03010290251
STAT,1848,16,45-49,1864,0.06331898882234471
STAT,1888,33,35-39,1921,12.161905449794492
STAT,1836,78,na,1914,486.32849578827955
STAT,1906,3,na,1909,3925.399956806417
SIM,1934,15,20-24,1949,261
STAT,1843,37,20-24,1880,0.7264632177679036
STAT,1907,16,na,1923,3792.3637788851497
SIM,1865,19,20-24,1884,22
SIM,1849,17,na,1866,2166
SIM,1826,38,50-100,1864,5
STAT,1917,24,15-19,1941,5.737348172965487
SIM,1899,26,45-49,1925,2
STAT,1823,33,30-34,1856,39.62136245987847
STAT,1825,41,40-44,1866,3.1360351190326696
STAT,1858,35,20-24,1893,0.6295452821221659
STAT,1853,45,35-39,1898,0.11856014237578819
SIM,1945,16,40-44,1961,6
STAT,1874,19,20-24,1893,18.366336078040014
STAT,1876,15,15-19,1891,6.2806761534148094
SIM,1805,86,na,1891,29
SIM,1826,45,na,1871,1589
STAT,1915,28,20-24,1943,18.932402591705383
SIM,1820,41,30-34,1861,1
SIM,1917,17,40-44,1934,1
STAT,1901,47,40-44,1948,0.13712398559062944
STAT,1891,27,na,1918,3014.173931830977
SIM,1875,36,30-34,1911,9
STAT,1886,53,na,1939,2287.7485905598164
STAT,1891,25,50-100,1916,0.8134114316332098
STAT,1853,34,25-29,1887,8.662504654935619
SIM,1860,32,50-100,1892,1
SIM,1934,18,25-29,1952,78
STAT,1855,42,35-39,1897,1.402011490568543
STAT,1946,16,50-100,1962,0.42408792269445184
SIM,1775,90,na,1865,12
STAT,1908,30,20-24,1938,2.3666489789075498
SIM,1923,28,20-24,1951,22
SIM,1853,22,na,1875,2071
SIM,1875,25,20-24,1900,13
SIM,1865,42,45-49,1907,3
STAT,1791,92,na,1883,10.370215683963288
STAT,1937,16,40-44,1953,1.3913756110957587
STAT,1863,53,25-29,1916,0.0031172913292202703
STAT,1874,51,40-44,1925,0.01101766242920783
SIM,1938,23,35-39,1961,12
STAT,1810,45,20-24,1855,0.03907976224264457
SIM,1780,74,na,1854,347
SIM,1784,88,na,1872,66
SIM,1866,28,50-100,1894,2
SIM,1869,101,na,1970,17
SIM,1880,42,40-44,1922,4
SIM,1893,75,na,1968,1654
SIM,1916,38,30-34,1954,6
STAT,1828,99,na,1927,1.0428895785491017
STAT,1820,101,na,1921,0.31427352083936877
STAT,1817,59,na,1876,1140.7779241454637
STAT,1885,41,45-49,1926,1.5301409755156636
SIM,1920,37,45-49,1957,1
STAT,1892,32,40-44,1924,5.544760428600627
STAT,1919,22,20-24,1941,124.25233291876233
SIM,1831,33,30-34,1864,22
SIM,1872,32,35-39,1904,18
SIM,1817,71,na,1888,552
STAT,1842,47,na,1889,1764.6303054442792
STAT,1862,47,35-39,1909,0.12100921113081684
STAT,1855,45,45-49,1900,0.18477069462810675
STAT,1862,35,40-44,1897,3.837526164484379
STAT,1901,5,na,1906,3738.548324970328
STAT,1921,24,35-39,1945,10.784545919965696
STAT,1819,43,15-19,1862,0.02895068297071168
STAT,1918,16,na,1934,4314.611495062226
STAT,1861,0,na,1861,3260.2990127870207
SIM,1834,40,na,1874,1727
SIM,1888,36,40-44,1924,6
STAT,1868,37,50-100,1905,1.1962724630905806
SIM,1916,30,20-24,1946,6
STAT,1910,36,na,1946,3687.4758717445975
SIM,1884,15,15-19,1899,9
SIM,1893,41,45-49,1934,1
STAT,1890,24,30-34,1914,22.0788292896798
STAT,1909,17,40-44,1926,0.2797427531801012
SIM,1852,77,na,1929,607
SIM,1908,28,25-29,1936,74
STAT,1886,34,15-19,1920,0.15245698194449145
SIM,1841,37,na,1878,1866
SIM,1868,27,50-100,1895,1
SIM,1849,39,30-34,1888,9
STAT,1877,17,na,1894,2672.3083969418876
STAT,1917,23,25-29,1940,99.87371027880192
SIM,1862,98,na,1960,8
STAT,1908,17,na,1925,3820.3557682711275
STAT,1910,34,30-34,1944,15.361214275043864
STAT,1839,24,30-34,1863,15.569114426161102
STAT,1853,46,25-29,1899,0.04843464956544036
STAT,1890,22,35-39,1912,7.278809387029399
STAT,1901,33,15-19,1934,0.20229850388358464
SIM,1927,22,20-24,1949,147
SIM,1894,22,15-19,1916,4
STAT,1810,110,na,1920,1.178121377593762E-4
SIM,1854,63,na,1917,1519
STAT,1919,20,25-29,1939,103.83226619316876
SIM,1913,13,na,1926,4248
STAT,1908,49,40-44,1957,0.1445448645270736
STAT,1863,19,45-49,1882,0.0599585960058575
STAT,1920,44,35-39,1964,0.2261999461994185
SIM,1918,2,na,1920,4644
STAT,1823,31,35-39,1854,29.487881901752594
SIM,1900,65,na,1965,2539
STAT,1839,35,40-44,1874,3.6860253077948237
SIM,1861,34,25-29,1895,12
SIM,1916,49,40-44,1965,1
STAT,1812,49,40-44,1861,0.39151761152068026
STAT,1864,6,na,1870,2572.499942082152
SIM,1927,39,45-49,1966,3
STAT,1941,18,20-24,1959,142.42147051376233
STAT,1867,29,30-34,1896,23.945131568758278
STAT,1821,46,35-39,1867,0.22391036177303839
STAT,1875,35,45-49,1910,2.107024230093736
STAT,1908,38,30-34,1946,1.7314338583231241
STAT,1817,46,15-19,1863,9.07707701799068E-4
STAT,1886,22,15-19,1908,3.5623260675092725
STAT,1808,82,na,1890,155.32979400313292
STAT,1828,26,50-100,1854,1.311688057905529
STAT,1949,23,15-19,1972,6.335089489774002
SIM,1883,35,45-49,1918,4
SIM,1798,96,na,1894,1
STAT,1907,18,15-19,1925,8.865996286701156
STAT,1884,37,15-19,1921,0.056675822863317224
STAT,1912,37,45-49,1949,0.678758231764898
SIM,1925,23,25-29,1948,142
SIM,1942,20,20-24,1962,114
SIM,1875,25,na,1900,2398
SIM,1901,37,35-39,1938,1
SIM,1828,55,na,1883,1380
STAT,1855,44,30-34,1899,0.8791910263806693
SIM,1833,41,40-44,1874,5
SIM,1824,41,na,1865,1535
STAT,1865,91,na,1956,60.71229222960074
STAT,1933,39,50-100,1972,0.5819645057485571
SIM,1847,24,30-34,1871,25
STAT,1821,35,25-29,1856,7.027801208541845
SIM,1884,19,30-34,1903,5
STAT,1848,101,na,1949,0.4435646127155468
SIM,1838,30,na,1868,1878
SIM,1879,36,45-49,1915,4
STAT,1870,43,15-19,1913,0.01367254186746446
STAT,1917,35,25-29,1952,1.0535483990189478
STAT,1859,51,45-49,1910,0.01188005173153727
STAT,1868,42,20-24,1910,0.15455171997465592
STAT,1930,18,45-49,1948,0.6569631848918215
SIM,1816,44,45-49,1860,2
SIM,1847,35,40-44,1882,8
STAT,1854,11,na,1865,2195.5953471927173
STAT,1858,25,na,1883,2005.1555594450315
SIM,1831,31,35-39,1862,13
SIM,1811,71,na,1882,464
SIM,1895,38,50-100,1933,5
STAT,1867,61,na,1928,1789.6515404026024
STAT,1829,44,na,1873,1691.1993888269653
STAT,1830,24,40-44,1854,4.903764739226449
SIM,1860,29,na,1889,2095
STAT,1873,25,45-49,1898,1.156121192147226
SIM,1903,22,35-39,1925,7
SIM,1927,20,25-29,1947,165
SIM,1919,26,40-44,1945,7
STAT,1873,21,50-100,1894,0.42303038169734064
STAT,1938,33,40-44,1971,4.011437236022406
SIM,1849,20,40-44,1869,5
SIM,1925,24,15-19,1949,7
SIM,1892,33,50-100,1925,2
STAT,1945,0,na,1945,4964.105196902292
STAT,1816,41,45-49,1857,3.7211672673447262
STAT,1856,23,40-44,1879,1.9241485350538161
SIM,1812,56,na,1868,1145
SIM,1873,25,40-44,1898,5
SIM,1897,68,na,1965,2265
SIM,1845,25,35-39,1870,10
STAT,1845,33,15-19,1878,0.130933616648035
STAT,1839,43,na,1882,1659.7539977823515
SIM,1860,18,30-34,1878,4
STAT,1853,66,na,1919,1374.3078537365088
STAT,1870,30,45-49,1900,1.753027545186592
STAT,1866,20,na,1886,2276.17976969826
STAT,1816,54,20-24,1870,0.0013948648617652082
STAT,1844,43,50-100,1887,0.8277675906415295
STAT,1826,35,30-34,1861,4.99471553823709
STAT,1837,29,45-49,1866,0.936557327960868
SIM,1865,3,na,1868,2955
SIM,1891,36,50-100,1927,1
SIM,1896,27,na,1923,3363
STAT,1903,32,50-100,1935,1.3287069166036494
STAT,1883,45,20-24,1928,0.012131336053191293
STAT,1846,50,20-24,1896,5.352855165073639E-4
STAT,1894,35,25-29,1929,3.8140163729211283
SIM,1843,18,30-34,1861,2
STAT,1931,38,na,1969,5076.356532201164
STAT,1837,18,35-39,1855,0.5610896258541803
SIM,1873,39,na,1912,2344
STAT,1919,39,45-49,1958,0.7457774280732172
STAT,1936,35,35-39,1971,2.4260860030685607
STAT,1882,28,15-19,1910,0.44933718660211464
SIM,1872,34,30-34,1906,29
STAT,1901,45,15-19,1946,3.250925525002418E-4
SIM,1844,45,40-44,1889,1
STAT,1833,37,50-100,1870,1.0166427408850371
SIM,1864,65,na,1929,1581
SIM,1853,21,15-19,1874,2
STAT,1893,26,30-34,1919,32.700903591996514
STAT,1916,44,15-19,1960,0.0016006214821693452
STAT,1831,63,na,1894,1202.3020091037567
SIM,1864,23,40-44,1887,4
STAT,1877,47,25-29,1924,0.06066161877419219
STAT,1831,41,40-44,1872,1.9319223603933917
STAT,1822,50,35-39,1872,0.012279581308150865
SIM,1834,35,30-34,1869,1
SIM,1874,24,na,1898,2339
STAT,1827,58,na,1885,1341.8327362026596
STAT,1861,41,50-100,1902,0.8945849414874679
STAT,1925,45,30-34,1970,0.11072902221044978
STAT,1805,51,40-44,1856,0.037851505005982444
SIM,1850,31,45-49,1881,1
STAT,1941,19,na,1960,3865.269072800485
STAT,1862,21,15-19,1883,2.9539474726857358
SIM,1829,45,45-49,1874,1
STAT,1893,15,20-24,1908,23.04991421922333
STAT,1828,35,35-39,1863,6.484303726294733
SIM,1942,28,30-34,1970,2
SIM,1860,51,na,1911,1890
SIM,1915,18,15-19,1933,12
STAT,1934,20,20-24,1954,152.88963396225392
STAT,1886,36,40-44,1922,4.749631242530268
STAT,1887,15,20-24,1902,20.360235312527294
SIM,1834,24,20-24,1858,69
SIM,1912,50,na,1962,3640
STAT,1822,52,25-29,1874,0.004854822535098202
SIM,1870,10,na,1880,2901
SIM,1896,36,45-49,1932,3
STAT,1852,19,15-19,1871,5.714382929168123
SIM,1885,64,na,1949,1815
SIM,1801,93,na,1894,9
STAT,1909,42,na,1951,3542.787749652743
STAT,1888,36,45-49,1924,2.415756713813296
SIM,1857,45,45-49,1902,1
SIM,1881,50,na,1931,2014
SIM,1894,36,40-44,1930,10
STAT,1949,23,45-49,1972,1.3390610459671546
SIM,1895,15,20-24,1910,33
STAT,1856,35,40-44,1891,3.538811917434152
STAT,1948,20,50-100,1968,0.7713429053702163
SIM,1935,33,35-39,1968,1
SIM,1823,96,na,1919,2
SIM,1858,25,45-49,1883,3
SIM,1885,24,na,1909,2257
SIM,1801,53,na,1854,1352
STAT,1927,33,35-39,1960,11.459858269281678
STAT,1819,45,40-44,1864,0.3491854766740788
STAT,1934,28,30-34,1962,53.728062550198416
SIM,1839,74,na,1913,787
STAT,1836,46,25-29,1882,0.03800670559608193
STAT,1872,42,40-44,1914,2.2968949742840477
SIM,1851,15,na,1866,2268
STAT,1876,15,45-49,1891,0.06913235974114672
SIM,1819,35,35-39,1854,8
SIM,1876,50,na,1926,2512
STAT,1922,21,na,1943,4285.934791408187
STAT,1871,23,15-19,1894,3.32344376506097
STAT,1907,32,na,1939,3604.8291868020574
SIM,1910,8,na,1918,4016
SIM,1870,33,20-24,1903,4
STAT,1785,77,na,1862,338.41056331578415
STAT,1842,44,20-24,1886,0.12559242458349368
SIM,1831,75,na,1906,651
STAT,1863,25,na,1888,2165.6164318545657
SIM,1794,66,na,1860,871
SIM,1872,14,na,1886,2721
SIM,1920,41,50-100,1961,1
STAT,1878,26,35-39,1904,10.280983981856194
SIM,1935,31,50-100,1966,3
SIM,1838,35,45-49,1873,7
STAT,1926,18,25-29,1944,54.06004818846249
SIM,1905,18,na,1923,3654
SIM,1845,18,35-39,1863,1
SIM,1870,44,30-34,1914,6
STAT,1842,26,na,1868,2113.081893852755
STAT,1846,19,45-49,1865,0.057992412911425366
SIM,1850,44,20-24,1894,1
STAT,1885,12,na,1897,2628.4230234306424
SIM,1886,26,35-39,1912,16
SIM,1867,16,20-24,1883,22
SIM,1839,95,na,1934,14
STAT,1817,45,30-34,1862,0.22310335057011074
STAT,1847,35,45-49,1882,1.6467578405614176
SIM,1844,46,25-29,1890,1
STAT,1855,76,na,1931,734.4256816026236
STAT,1836,45,40-44,1881,0.1144209545975778
SIM,1842,78,na,1920,611
STAT,1843,29,15-19,1872,0.4443010262568744
STAT,1894,46,35-39,1940,0.10392226858251187
SIM,1824,41,45-49,1865,5
STAT,1933,24,na,1957,4936.574501436884
STAT,1894,47,25-29,1941,0.042436770777329505
STAT,1899,20,35-39,1919,8.200628240581834
STAT,1841,27,15-19,1868,0.41607681187512346
STAT,1869,65,na,1934,1664.4583302484461
SIM,1835,81,na,1916,302
STAT,1827,44,25-29,1871,0.7326769289342054
SIM,1853,35,40-44,1888,6
STAT,1826,29,15-19,1855,0.7644393922382341
SIM,1855,35,45-49,1890,3
SIM,1910,24,25-29,1934,99
SIM,1954,3,na,1957,4724
STAT,1883,32,45-49,1915,1.7455057424463554
STAT,1865,25,40-44,1890,2.7924181125705854
STAT,1867,25,45-49,1892,1.070586775320112
STAT,1921,37,40-44,1958,1.7056685717164213
STAT,1852,18,30-34,1870,1.543831124650254
SIM,1861,42,30-34,1903,2
STAT,1862,34,20-24,1896,2.3272393444768524
SIM,1835,44,25-29,1879,1
SIM,1848,32,na,1880,2062
SIM,1918,33,35-39,1951,13
STAT,1858,47,15-19,1905,3.220941427080029E-4
SIM,1905,5,na,1910,3788
STAT,1902,24,25-29,1926,81.8405778834339
STAT,1892,47,20-24,1939,0.008614236788356716
SIM,1891,32,45-49,1923,6
STAT,1807,97,na,1904,2.2703273277768616
STAT,1867,36,30-34,1903,5.128872941694348
STAT,1876,75,na,1951,1084.4656015941255
STAT,1897,26,45-49,1923,1.5196914272597077
STAT,1865,51,na,1916,2003.162792237359
STAT,1851,31,40-44,1882,3.762787344328582
STAT,1839,32,50-100,1871,0.77816996444232
SIM,1862,26,50-100,1888,1
SIM,1892,36,30-34,1928,13
STAT,1825,48,50-100,1873,0.3115838845365572
SIM,1838,22,30-34,1860,18
SIM,1914,20,45-49,1934,5
STAT,1853,31,20-24,1884,2.3583993794618174
SIM,1889,40,40-44,1929,2
STAT,1898,43,45-49,1941,0.14234083802156317
SIM,1820,44,35-39,1864,1
STAT,1912,20,15-19,1932,5.235237839129298
SIM,1877,34,15-19,1911,4
STAT,1863,51,35-39,1914,0.007737231250210185
STAT,1809,45,na,1854,1655.3087614677509
STAT,1850,53,45-49,1903,0.010741034915762287
SIM,1884,39,na,1923,2450
SIM,1940,27,15-19,1967,1
SIM,1893,40,50-100,1933,2
STAT,1908,33,25-29,1941,8.858806068090534
SIM,1881,34,35-39,1915,12
STAT,1853,4,na,1857,2688.493205929808
STAT,1897,47,50-100,1944,0.18809106710203824
STAT,1806,56,na,1862,1117.3265345352086
STAT,1887,38,na,1925,2679.8379098751466
STAT,1833,33,na,1866,1812.8022920214707
STAT,1912,31,25-29,1943,9.315629013381898
STAT,1921,39,na,1960,4277.527656567799
STAT,1901,49,30-34,1950,0.07626946908778451
STAT,1947,23,35-39,1970,10.853892083912907
STAT,1904,24,35-39,1928,8.478445106672792
STAT,1892,68,na,1960,2088.772843017936
STAT,1888,30,30-34,1918,21.226029224384078
SIM,1838,33,40-44,1871,7
SIM,1907,0,na,1907,4180
STAT,1862,44,30-34,1906,0.9848957841358018
STAT,1939,16,45-49,1955,0.5102366567909482
STAT,1932,27,15-19,1959,0.9429792866733245
STAT,1942,25,50-100,1967,1.0667498636372017
STAT,1885,40,50-100,1925,1.0860838309420304
STAT,1840,33,30-34,1873,15.144758190107003
SIM,1848,88,na,1936,160
STAT,1884,36,30-34,1920,5.404939855574424
STAT,1838,42,35-39,1880,1.5559862926027124
STAT,1873,34,35-39,1907,10.38424032565423
STAT,1884,25,20-24,1909,11.920678641734186
SIM,1800,68,na,1868,624
STAT,1843,51,na,1894,1746.51076457048
STAT,1906,20,45-49,1926,1.0415928439221045
SIM,1818,96,na,1914,4
STAT,1836,44,20-24,1880,0.11462880129736974
STAT,1880,80,na,1960,846.6116112426041
SIM,1872,76,na,1948,817
SIM,1861,31,20-24,1892,4
STAT,1929,25,50-100,1954,1.2753677877202325
SIM,1937,25,50-100,1962,1
STAT,1864,10,na,1874,2492.46863401145
SIM,1862,36,na,1898,2158
STAT,1875,52,50-100,1927,0.015728560317667575
STAT,1831,50,30-34,1881,0.004455530333301355
STAT,1897,39,15-19,1936,0.016366368031858005
SIM,1831,78,na,1909,597
STAT,1910,35,15-19,1945,0.018909667459924416
STAT,1930,35,na,1965,5013.679304325646
STAT,1845,17,50-100,1862,0.048382141831486064
STAT,1903,47,45-49,1950,0.19215120297573848
SIM,1942,23,25-29,1965,110
STAT,1917,53,na,1970,3832.640571398131
SIM,1876,45,25-29,1921,1
SIM,1920,20,15-19,1940,8
STAT,1937,7,na,1944,3966.6083620604686
STAT,1864,46,50-100,1910,0.22341192760653594
STAT,1899,23,na,1922,3293.6921834954205
STAT,1910,7,na,1917,4026.488774744535
STAT,1849,52,50-100,1901,0.011662759593737203
STAT,1892,35,45-49,1927,2.5730023489360283
SIM,1872,46,50-100,1918,2
STAT,1853,42,30-34,1895,0.9628084671806603
STAT,1875,47,15-19,1922,4.168514241421731E-4
SIM,1906,28,20-24,1934,28
STAT,1825,44,45-49,1869,1.959957043221654
SIM,1938,20,30-34,1958,37
STAT,1928,26,40-44,1954,5.8774099085015115
SIM,1920,31,25-29,1951,12
STAT,1878,61,na,1939,1984.2316653273665
STAT,1799,69,na,1868,682.4871096506282
STAT,1821,48,na,1869,1351.3027196844387
SIM,1814,43,35-39,1857,3
SIM,1842,31,40-44,1873,8
STAT,1929,19,na,1948,4765.38914605041
SIM,1921,18,45-49,1939,1
SIM,1816,86,na,1902,85
SIM,1874,40,na,1914,2396
SIM,1899,23,40-44,1922,3
SIM,1833,44,45-49,1877,2
STAT,1913,18,45-49,1931,0.10392147604046058
SIM,1836,35,35-39,1871,7
SIM,1841,18,20-24,1859,23
STAT,1855,14,na,1869,2181.142585378607
STAT,1942,20,na,1962,3909.0847453047013
SIM,1887,50,na,1937,2592
STAT,1905,41,35-39,1946,0.186106398683597
STAT,1920,30,50-100,1950,0.9316142802232353
STAT,1877,45,20-24,1922,0.012823616011172625
SIM,1884,61,na,1945,1857
STAT,1821,43,30-34,1864,1.931238499101458
STAT,1868,45,25-29,1913,0.05668308667626817
STAT,1895,26,35-39,1921,12.886902582307757
SIM,1886,28,25-29,1914,64
STAT,1954,2,na,1956,4962.145811365785
STAT,1845,106,na,1951,0.009486872267303298
STAT,1929,16,na,1945,4802.849722436344
SIM,1906,19,30-34,1925,3
SIM,1840,33,35-39,1873,16
STAT,1845,21,15-19,1866,3.22316864344533
SIM,1861,14,na,1875,2948
SIM,1819,37,25-29,1856,6
SIM,1936,26,40-44,1962,5
STAT,1840,46,45-49,1886,0.17346326321129812
SIM,1916,22,15-19,1938,8
STAT,1789,102,na,1891,0.05831958688690314
STAT,1792,74,na,1866,400.2431098406885
STAT,1897,2,na,1899,3636.057688139858
SIM,1912,24,35-39,1936,21
STAT,1810,107,na,1917,0.002010568288413885
STAT,1823,49,50-100,1872,0.358907306649771
SIM,1851,24,20-24,1875,68
SIM,1914,54,na,1968,3616
STAT,1888,60,na,1948,2300.0972141220577
STAT,1842,31,45-49,1873,1.6692332352710886
STAT,1877,23,50-100,1900,0.43014404306020443
SIM,1901,34,30-34,1935,16
STAT,1876,51,45-49,1927,0.01536094971500598
STAT,1892,22,50-100,1914,0.5213852745457059
SIM,1863,42,40-44,1905,1
SIM,1903,14,na,1917,3687
SIM,1869,23,25-29,1892,69
STAT,1881,34,30-34,1915,17.072692900991793
SIM,1925,28,30-34,1953,92
SIM,1927,4,na,1931,4943
STAT,1920,41,30-34,1961,0.1442993855059119
STAT,1908,22,15-19,1930,4.99026563409535
STAT,1917,20,20-24,1937,121.32059938265395
SIM,1816,41,40-44,1857,3
STAT,1778,109,na,1887,0.002090784456782587
SIM,1896,24,na,1920,3132
SIM,1858,22,40-44,1880,1
STAT,1821,100,na,1921,0.5594224411115443
STAT,1843,24,20-24,1867,68.82939905807233
SIM,1905,32,40-44,1937,6
SIM,1851,35,30-34,1886,5
SIM,1879,33,40-44,1912,12
STAT,1834,74,na,1908,745.7973882251752
SIM,1916,33,25-29,1949,14
STAT,1875,32,40-44,1907,4.54058838226771
SIM,1883,32,40-44,1915,10
STAT,1816,108,na,1924,8.127603255173234E-4
SIM,1774,89,na,1863,45
STAT,1894,16,50-100,1910,0.06444592791841605
STAT,1895,24,15-19,1919,4.363548438110033
STAT,1814,43,30-34,1857,3.758257768258314
STAT,1867,38,20-24,1905,0.7346046210551646
SIM,1840,52,na,1892,1508
STAT,1832,48,na,1880,1587.793443978709
STAT,1906,37,15-19,1943,0.017997026528133703
STAT,1856,38,15-19,1894,0.04474572451011608
SIM,1935,16,na,1951,5173
STAT,1812,44,35-39,1856,4.548056728089983
STAT,1864,32,35-39,1896,9.186082450354272
SIM,1925,20,20-24,1945,159
SIM,1822,43,30-34,1865,4
SIM,1926,42,na,1968,4911
STAT,1834,46,15-19,1880,3.1775317813629206E-4
STAT,1843,35,30-34,1878,5.128098681337883
STAT,1879,22,50-100,1901,0.43484934211087617
STAT,1897,24,40-44,1921,2.82459763306713
STAT,1842,40,35-39,1882,1.5073265090749248
STAT,1828,33,15-19,1861,0.13590383178542242
STAT,1872,51,30-34,1923,0.006115182605106271
STAT,1880,83,na,1963,669.9365120982811
SIM,1862,25,35-39,1887,14
SIM,1838,33,na,1871,1744
SIM,1828,26,40-44,1854,3
STAT,1821,33,20-24,1854,8.518340805458285
STAT,1877,79,na,1956,780.131656005076
SIM,1899,16,na,1915,3530
STAT,1880,43,na,1923,2459.818987926321
SIM,1829,34,50-100,1863,1
STAT,1827,52,50-100,1879,0.016364082692859883
SIM,1815,45,na,1860,1476
STAT,1887,17,40-44,1904,0.20908259269485538
SIM,1859,32,na,1891,2235
STAT,1879,43,35-39,1922,1.9170214325152382
STAT,1877,44,20-24,1921,0.16576964455401094
SIM,1866,38,25-29,1904,7
SIM,1764,90,na,1854,6
STAT,1860,36,15-19,1896,0.046703641760173005
STAT,1826,37,20-24,1863,0.6887695068836347
STAT,1922,24,na,1946,4246.284191393404
SIM,1827,70,na,1897,779
STAT,1868,53,30-34,1921,0.005706845138605458
SIM,1835,41,20-24,1876,1
SIM,1929,31,45-49,1960,3
STAT,1931,31,35-39,1962,12.219143131578393
SIM,1929,20,35-39,1949,19
STAT,1893,28,20-24,1921,15.128774804723095
SIM,1891,41,35-39,1932,6
SIM,1856,29,20-24,1885,19
SIM,1827,30,na,1857,1737
STAT,1809,48,na,1857,1592.9436219661945
STAT,1854,25,35-39,1879,8.630892927731608
STAT,1908,22,45-49,1930,1.0548028296099177
STAT,1857,51,35-39,1908,0.006891817802904883
SIM,1906,48,50-100,1954,1
SIM,1845,22,30-34,1867,35
SIM,1870,36,25-29,1906,3
STAT,1866,76,na,1942,891.4785905816266
STAT,1948,19,15-19,1967,52.95380231238314
STAT,1863,28,na,1891,2127.11592564206
STAT,1843,29,na,1872,2118.4436982072352
STAT,1899,36,20-24,1935,1.0820354877458247
STAT,1832,33,35-39,1865,8.784700279701829
STAT,1883,41,35-39,1924,1.8207634201896625
STAT,1943,23,na,1966,3962.63380429359
SIM,1858,39,50-100,1897,4
STAT,1831,44,45-49,1875,1.2349596603734785
SIM,1855,48,50-100,1903,2
SIM,1887,43,35-39,1930,1
SIM,1944,20,30-34,1964,48
SIM,1885,7,na,1892,2648
SIM,1849,73,na,1922,1127
STAT,1851,34,15-19,1885,0.11977143470450118
STAT,1830,29,35-39,1859,9.751600535014608
STAT,1779,92,na,1871,8.886308767511743
STAT,1899,47,30-34,1946,0.0759234846368594
STAT,1910,37,35-39,1947,2.3593512440879567
STAT,1810,45,50-100,1855,0.7998324355653332
STAT,1878,28,25-29,1906,44.76012655853767
STAT,1882,17,35-39,1899,0.5453493020796418
STAT,1934,36,50-100,1970,0.5913974373033049
STAT,1869,23,20-24,1892,67.66277028842174
SIM,1888,75,na,1963,1422
SIM,1838,32,40-44,1870,7
SIM,1860,88,na,1948,113
SIM,1870,47,35-39,1917,1
SIM,1854,16,40-44,1870,3
STAT,1816,50,35-39,1866,0.017629993970057472
STAT,1852,25,na,1877,2059.2997047106705
STAT,1912,34,40-44,1946,3.894550781220382
STAT,1846,52,40-44,1898,0.007488472948357988
SIM,1888,25,30-34,1913,39
SIM,1864,62,na,1926,1680
STAT,1848,29,20-24,1877,10.7308846343713
STAT,1934,23,25-29,1957,126.54973537528673
SIM,1886,23,30-34,1909,35
STAT,1932,37,50-100,1969,0.5752992292137579
STAT,1827,41,20-24,1868,0.19177758730124655
STAT,1908,57,na,1965,3239.2297770226814
STAT,1805,54,45-49,1859,0.04913012596286804
STAT,1897,23,40-44,1920,2.833608508122962
STAT,1923,22,40-44,1945,3.9916862020047925
SIM,1860,27,20-24,1887,15
STAT,1788,66,na,1854,831.0
SIM,1843,63,na,1906,1352
STAT,1835,50,45-49,1885,0.011469406998464932
STAT,1875,13,na,1888,2714.633079124995
SIM,1929,31,na,1960,5097
STAT,1858,49,35-39,1907,0.11089626911958664
STAT,1831,26,na,1857,1934.9314636269742
STAT,1829,54,30-34,1883,0.004072834668621591
STAT,1881,47,45-49,1928,0.23167632121974968
SIM,1847,47,na,1894,1517
SIM,1931,22,40-44,1953,6
SIM,1827,35,50-100,1862,3
SIM,1879,34,40-44,1913,9
SIM,1947,16,45-49,1963,1
STAT,1818,81,na,1899,275.5826768196903
STAT,1819,85,na,1904,161.61788003339248
STAT,1896,45,30-34,1941,0.07430335283247272
SIM,1846,42,35-39,1888,4
STAT,1851,34,45-49,1885,1.4666350497177139
STAT,1856,38,45-49,1894,1.5884730312008297
STAT,1909,15,20-24,1924,27.241044834533707
STAT,1847,21,50-100,1868,0.3926565973438001
STAT,1878,19,35-39,1897,0.5795283168232184
STAT,1862,15,50-100,1877,0.04930540764965525
SIM,1806,71,na,1877,735
STAT,1836,54,30-34,1890,0.003603522491473631
SIM,1910,28,40-44,1938,9
STAT,1943,25,25-29,1968,71.58108519787847
STAT,1891,15,40-44,1906,0.23207947401724438
STAT,1894,32,20-24,1926,3.5470029073483733
STAT,1843,88,na,1931,110.82533731407142
SIM,1879,23,30-34,1902,23
STAT,1838,58,na,1896,1453.0440071849798
STAT,1869,34,15-19,1903,0.13905768129958812
STAT,1820,54,40-44,1874,0.017739267923473
SIM,1826,48,na,1874,1540
STAT,1822,89,na,1911,61.082740558588746
STAT,1880,15,35-39,1895,0.5909654639643429
SIM,1875,65,na,1940,1623
STAT,1859,19,25-29,1878,5.296156542490085
STAT,1932,3,na,1935,5477.293293460909
SIM,1918,30,30-34,1948,31
SIM,1880,45,45-49,1925,1
SIM,1928,16,35-39,1944,7
STAT,1888,45,35-39,1933,0.17052611903474657
STAT,1836,48,45-49,1884,0.151782475218623
STAT,1872,40,20-24,1912,0.16401357677884887
STAT,1914,47,20-24,1961,0.011182423294360089
SIM,1896,64,na,1960,2476
STAT,1878,23,30-34,1901,18.855728065997102
STAT,1837,27,25-29,1864,36.19984623946815
STAT,1954,16,40-44,1970,1.7642121822282955
STAT,1827,52,30-34,1879,0.006449687332088014
STAT,1871,27,30-34,1898,25.446929930125794
SIM,1910,17,30-34,1927,2
STAT,1902,28,40-44,1930,4.294384897818903
STAT,1836,43,20-24,1879,0.11610684138824201
STAT,1857,42,45-49,1899,1.1909334622646184
STAT,1873,38,20-24,1911,0.7932957793143064
SIM,1832,24,40-44,1856,2
STAT,1902,17,30-34,1919,2.2930131063112626
SIM,1867,19,25-29,1886,11
SIM,1844,43,20-24,1887,2
SIM,1881,38,20-24,1919,1
SIM,1902,69,na,1971,2438
SIM,1844,48,45-49,1892,1
STAT,1872,45,45-49,1917,0.24369898947489205
SIM,1845,27,25-29,1872,48
STAT,1863,108,na,1971,0.027928614368754795
STAT,1898,44,50-100,1942,0.09984087777878738
STAT,1894,43,30-34,1937,0.10400458892458865
STAT,1846,16,40-44,1862,0.16528216328078793
SIM,1846,28,na,1874,2040
SIM,1857,30,40-44,1887,2
SIM,1905,40,na,1945,3361
SIM,1953,4,na,1957,4775
STAT,1831,41,35-39,1872,1.555323526861176
STAT,1844,18,35-39,1862,0.5373197775382207
STAT,1939,28,15-19,1967,0.7236343353272274
SIM,1836,28,35-39,1864,14
SIM,1881,31,30-34,1912,25
STAT,1809,61,na,1870,1230.2984972853194
SIM,1908,32,20-24,1940,1
STAT,1871,1,na,1872,3547.9553002073126
SIM,1951,17,40-44,1968,2
STAT,1850,29,15-19,1879,0.3958686129986819
STAT,1948,17,na,1965,4297.633565850232
SIM,1827,33,na,1860,1704
STAT,1805,71,na,1876,744.7967763276863
STAT,1828,35,40-44,1863,4.013201323008752
STAT,1943,17,40-44,1960,1.5132724028903448
STAT,1852,15,20-24,1867,17.478995914963672
SIM,1855,22,30-34,1877,21
STAT,1876,52,20-24,1928,7.732077527776729E-4
STAT,1926,7,na,1933,4999.707561243554
SIM,1838,36,45-49,1874,3
SIM,1897,29,20-24,1926,20
STAT,1861,15,30-34,1876,1.562645096862889
SIM,1884,79,na,1963,780
SIM,1909,30,na,1939,3547
SIM,1876,37,50-100,1913,3
SIM,1928,40,35-39,1968,1
STAT,1897,27,45-49,1924,1.5144940825784792
SIM,1808,88,na,1896,49
STAT,1834,39,15-19,1873,0.04603912897394644
SIM,1814,40,30-34,1854,3
STAT,1819,35,30-34,1854,17.73380630290531
STAT,1863,49,50-100,1912,0.2150906473822704
STAT,1916,48,30-34,1964,0.09304831628179146
STAT,1827,98,na,1925,2.099594964608973
SIM,1829,34,na,1863,1532
STAT,1873,33,na,1906,2457.6260750596944
STAT,1889,29,20-24,1918,14.677654500209654
SIM,1880,89,na,1969,98
STAT,1873,31,30-34,1904,18.131500639991046
STAT,1864,48,15-19,1912,3.5827361497232306E-4
STAT,1879,24,na,1903,2506.193367856988
SIM,1934,31,na,1965,5357
STAT,1834,46,20-24,1880,0.009532603729284423
STAT,1841,22,na,1863,1999.888869426576
SIM,1862,25,40-44,1887,5
STAT,1828,28,35-39,1856,12.187416290018897
STAT,1877,23,na,1900,2494.692241844564
SIM,1853,25,30-34,1878,30
SIM,1838,70,na,1908,828
SIM,1843,18,25-29,1861,5
STAT,1874,15,40-44,1889,0.1921042254928625
STAT,1843,11,na,1854,2474.0
SIM,1965,2,na,1967,4976
SIM,1931,25,15-19,1956,1
STAT,1836,47,25-29,1883,0.037522880233843786
SIM,1880,55,na,1935,1950
STAT,1834,44,50-100,1878,0.8353943051688025
STAT,1895,19,35-39,1914,0.7264212234713767
STAT,1861,48,na,1909,1872.7141751352488
SIM,1899,37,30-34,1936,4
STAT,1780,86,na,1866,62.84505410460966
STAT,1837,28,45-49,1865,0.9433304405238291
SIM,1845,28,45-49,1873,1
STAT,1771,112,na,1883,7.029587802540994E-4
STAT,1854,23,15-19,1877,2.945395226763099
STAT,1766,114,na,1880,4.1851050738910954E-4
STAT,1896,48,35-39,1944,0.10506578315493463
STAT,1845,25,30-34,1870,24.29660644400594
STAT,1900,27,30-34,1927,35.605940578513255
STAT,1911,6,na,1917,4077.777546586673
SIM,1816,83,na,1899,150
SIM,1855,88,na,1943,132
STAT,1823,38,50-100,1861,2.2146819763097865
STAT,1918,45,30-34,1963,0.09726316634163874
SIM,1860,15,20-24,1875,22
STAT,1923,25,15-19,1948,0.8325797393998874
SIM,1892,74,na,1966,1960
SIM,1842,38,na,1880,1858
STAT,1835,93,na,1928,21.774843771879574
STAT,1820,40,20-24,1860,0.33377308169051917
STAT,1855,30,na,1885,1923.0688069110804
SIM,1842,16,na,1858,2196
STAT,1932,38,30-34,1970,2.494826537426468
STAT,1854,25,40-44,1879,2.6795090706255382
STAT,1910,30,15-19,1940,0.12738930246884508
SIM,1797,71,na,1868,510
SIM,1881,2,na,1883,2811
STAT,1840,52,50-100,1892,0.010810052103038316
STAT,1917,27,40-44,1944,4.988285294243079
SIM,1849,36,20-24,1885,2
STAT,1856,20,15-19,1876,3.1128245693754333
STAT,1823,47,15-19,1870,6.013371999422434E-4
SIM,1827,35,30-34,1862,9
STAT,1822,43,na,1865,1583.6262207720001
STAT,1947,22,35-39,1969,10.857475050679632
SIM,1917,25,25-29,1942,105
SIM,1921,7,na,1928,5263
STAT,1913,47,na,1960,3658.0791137057013
SIM,1834,80,na,1914,345
SIM,1838,30,50-100,1868,1
SIM,1922,12,na,1934,4676
STAT,1916,46,50-100,1962,0.2373279735741038
SIM,1935,30,25-29,1965,19
STAT,1886,26,30-34,1912,27.285034886663095
STAT,1792,71,na,1863,531.8822301568707
STAT,1866,41,40-44,1907,2.126078167437942
STAT,1919,24,40-44,1943,3.733680535262324
SIM,1874,41,40-44,1915,9
SIM,1914,17,na,1931,4053
STAT,1825,44,15-19,1869,0.01808495668582352
STAT,1890,38,15-19,1928,0.06969623824015797
SIM,1826,85,na,1911,118
SIM,1841,17,20-24,1858,26
SIM,1877,29,35-39,1906,14
STAT,1812,42,50-100,1854,3.0483070140303092
STAT,1841,15,45-49,1856,0.06294468744511025
SIM,1894,26,30-34,1920,6
STAT,1865,52,45-49,1917,0.013365552723827187
SIM,1917,28,50-100,1945,2
STAT,1859,20,na,1879,2014.9265508794006
SIM,1910,27,na,1937,3586
SIM,1916,18,na,1934,4186
SIM,1934,22,20-24,1956,146
SIM,1915,17,15-19,1932,11
SIM,1810,49,50-100,1859,1
STAT,1871,34,30-34,1905,17.492418086535867
STAT,1852,87,na,1939,141.93152805014077
SIM,1943,14,na,1957,3901
STAT,1847,22,30-34,1869,17.028092420798515
STAT,1849,30,40-44,1879,3.980522313613657
STAT,1943,15,15-19,1958,49.12631643413229
STAT,1956,12,na,1968,5301.250854411139
STAT,1858,28,50-100,1886,0.5259750432898531
SIM,1869,28,30-34,1897,3
STAT,1843,39,25-29,1882,2.4184549044994923
STAT,1845,47,35-39,1892,0.1088785970763039
STAT,1885,74,na,1959,1257.558693592744
STAT,1925,22,15-19,1947,6.500819535806495
SIM,1898,53,na,1951,3269
STAT,1851,33,45-49,1884,1.4819435263448555
STAT,1930,19,na,1949,4827.377975357129
SIM,1840,30,30-34,1870,10
SIM,1864,20,15-19,1884,3
STAT,1885,19,35-39,1904,0.5554695994408486
STAT,1892,35,15-19,1927,0.07247894802616708
STAT,1945,25,35-39,1970,16.819733016824888
SIM,1826,28,35-39,1854,14
SIM,1859,39,50-100,1898,3
STAT,1826,33,na,1859,1705.057577140507
SIM,1885,48,25-29,1933,1
STAT,1808,49,15-19,1857,9.853266749100889E-4
SIM,1927,24,40-44,1951,9
STAT,1860,36,20-24,1896,0.6411135471365411
SIM,1930,41,na,1971,5454
SIM,1843,25,30-34,1868,29
STAT,1784,76,na,1860,306.91354321074687
STAT,1839,83,na,1922,273.97852485348017
SIM,1817,49,na,1866,1327
STAT,1877,48,25-29,1925,0.06017996552112513
STAT,1899,24,45-49,1923,0.9680388396173203
SIM,1872,37,35-39,1909,13
STAT,1860,82,na,1942,386.1969292102087
STAT,1927,30,25-29,1957,11.610909487794443
STAT,1835,25,30-34,1860,24.818057823602384
SIM,1919,27,50-100,1946,5
SIM,1833,43,45-49,1876,5
SIM,1936,19,40-44,1955,1
STAT,1860,60,na,1920,1578.5998041081002
SIM,1856,25,40-44,1881,4
SIM,1884,19,25-29,1903,10
SIM,1951,15,15-19,1966,55
SIM,1880,42,35-39,1922,8
STAT,1820,60,na,1880,1121.9468623294406
STAT,1925,46,15-19,1971,4.565463552670927E-4
STAT,1832,30,30-34,1862,15.654588030067318
SIM,1833,55,na,1888,1400
SIM,1879,15,na,1894,3112
STAT,1892,34,45-49,1926,2.2104957786747224
STAT,1896,12,na,1908,3479.5525708270247
STAT,1880,18,45-49,1898,0.06984418720157697
SIM,1852,44,25-29,1896,3
STAT,1880,27,35-39,1907,10.34393702111232
STAT,1830,36,35-39,1866,6.480157029719812
SIM,1839,25,40-44,1864,1
STAT,1850,41,45-49,1891,1.1308738597617791
STAT,1875,47,20-24,1922,0.012505553724566666
STAT,1777,107,na,1884,0.009721445655616306
SIM,1927,35,35-39,1962,4
STAT,1849,31,50-100,1880,0.8323027238532589
STAT,1879,52,30-34,1931,0.006313739758298125
STAT,1912,35,40-44,1947,1.504642360298675
STAT,1858,47,20-24,1905,0.009662832780989561
STAT,1926,22,20-24,1948,137.81131425523884
SIM,1920,35,40-44,1955,1
STAT,1898,16,40-44,1914,0.2529440702628658
STAT,1914,35,45-49,1949,0.701060767909091
SIM,1867,29,35-39,1896,1
SIM,1919,19,40-44,1938,1
STAT,1885,58,na,1943,2012.7567804231655
STAT,1920,40,25-29,1960,0.08070699740539017
STAT,1816,55,na,1871,1153.287297834408
SIM,1875,42,50-100,1917,2
STAT,1863,18,45-49,1881,0.06031384455025854
SIM,1821,36,35-39,1857,11
SIM,1929,22,25-29,1951,145
STAT,1825,43,45-49,1868,2.001309865701088
STAT,1869,36,40-44,1905,4.332190623154369
SIM,1946,22,25-29,1968,153
STAT,1827,80,na,1907,399.8107402836481
STAT,1842,63,na,1905,1399.2596095106412
STAT,1872,42,35-39,1914,1.8491502896139858
SIM,1893,16,30-34,1909,3
STAT,1924,17,15-19,1941,55.13844790943704
SIM,1898,31,40-44,1929,13
STAT,1844,44,25-29,1888,0.4967477165654951
STAT,1860,29,15-19,1889,0.374128898466566
STAT,1860,37,50-100,1897,1.016220188061597
STAT,1865,28,20-24,1893,10.823949061087252
STAT,1814,46,35-39,1860,0.42424504148476544
STAT,1868,80,na,1948,602.7400283056622
STAT,1897,21,15-19,1918,4.513575341884099
SIM,1892,2,na,1894,3875
STAT,1848,25,40-44,1873,2.8202025646075835
STAT,1907,17,15-19,1924,8.889286216588618
SIM,1905,58,na,1963,3033
SIM,1925,27,40-44,1952,6
STAT,1876,26,30-34,1902,26.618388024168837
STAT,1848,28,20-24,1876,10.808489589624806
STAT,1864,44,40-44,1908,2.012738402475937
SIM,1889,70,na,1959,2004
STAT,1824,39,15-19,1863,0.07248888249603971
STAT,1870,53,25-29,1923,0.0034756021836877676
STAT,1858,36,20-24,1894,0.6266241920131187
SIM,1868,20,15-19,1888,3
STAT,1787,104,na,1891,0.03033937279591665
STAT,1855,36,na,1891,1835.1397636828158
STAT,1919,35,35-39,1954,2.666462451837857
SIM,1836,22,20-24,1858,75
STAT,1881,37,35-39,1918,6.975862618914062
SIM,1830,90,na,1920,59
STAT,1821,36,25-29,1857,6.676787358447898
STAT,1843,46,50-100,1889,0.1998864786281491
STAT,1906,38,20-24,1944,0.24582469204952856
STAT,1871,18,35-39,1889,0.5547781629058929
STAT,1940,25,45-49,1965,1.7987896894984188
SIM,1879,37,45-49,1916,3
STAT,1864,72,na,1936,1145.5496303502744
STAT,1908,46,15-19,1954,3.422727568748939E-4
STAT,1823,43,40-44,1866,3.5485730399205813
STAT,1901,22,na,1923,3373.929081926947
STAT,1885,45,25-29,1930,0.05920851475585287
SIM,1928,3,na,1931,5348
STAT,1919,22,15-19,1941,5.948289035599451
STAT,1844,107,na,1951,0.003654446264668383
STAT,1880,37,na,1917,2525.6772918911033
SIM,1884,45,na,1929,2405
STAT,1888,42,30-34,1930,1.3848160772421607
STAT,1805,51,35-39,1856,0.030953333604311514
STAT,1866,45,15-19,1911,3.801401809553111E-4
STAT,1869,48,35-39,1917,0.13615462344111834
STAT,1790,70,na,1860,692.4010916001206
SIM,1858,39,35-39,1897,12
SIM,1917,43,na,1960,3796
STAT,1886,48,35-39,1934,0.14927419164210592
SIM,1877,26,30-34,1903,35
STAT,1873,27,50-100,1900,0.6616015859373411
STAT,1814,48,na,1862,1412.8652116050946
STAT,1870,31,20-24,1901,2.7066758252764576
STAT,1901,35,50-100,1936,0.38163018964090345
STAT,1858,23,45-49,1881,0.5847859939219571
STAT,1815,95,na,1910,6.874796348789211
SIM,1922,35,45-49,1957,1
STAT,1818,54,25-29,1872,0.007406694453068826
STAT,1890,34,40-44,1924,5.363033678008333
STAT,1923,38,20-24,1961,0.3113281468783498
STAT,1938,22,25-29,1960,93.25495233456155
SIM,1932,17,15-19,1949,65
SIM,1915,23,50-100,1938,1
STAT,1918,19,40-44,1937,1.5452625782672549
SIM,1856,28,20-24,1884,14
SIM,1836,35,40-44,1871,5
STAT,1848,66,na,1914,1274.0568571077972
STAT,1841,51,45-49,1892,0.010766548144481138
SIM,1884,26,30-34,1910,3
STAT,1867,26,20-24,1893,11.27414046018607
STAT,1928,19,40-44,1947,1.78805975234203
STAT,1890,27,35-39,1917,12.035464108112963
STAT,1895,26,40-44,1921,4.00081111545393
STAT,1798,90,na,1888,38.255786869540024
STAT,1917,37,na,1954,3987.752104786568
STAT,1932,26,50-100,1958,1.3301407619100514
SIM,1904,39,na,1943,3668
STAT,1811,106,na,1917,0.005259275095767585
STAT,1861,41,20-24,1902,0.13448009180676235
STAT,1838,51,30-34,1889,0.0044373824498245675
SIM,1835,68,na,1903,939
STAT,1796,61,na,1857,926.9119154226329
STAT,1854,18,35-39,1872,0.4994099038295489
SIM,1873,43,50-100,1916,3
STAT,1903,40,25-29,1943,0.06531927102123161
STAT,1884,37,20-24,1921,0.7780043796021311
SIM,1847,32,50-100,1879,1
STAT,1853,7,na,1860,2496.5598350704513
SIM,1890,16,45-49,1906,2
SIM,1876,18,20-24,1894,25
STAT,1840,36,35-39,1876,6.08265611824091
STAT,1868,18,20-24,1886,17.483277640035094
STAT,1824,51,45-49,1875,0.016644189060037725
SIM,1927,22,15-19,1949,7
STAT,1879,40,na,1919,2489.4708034424084
STAT,1835,54,25-29,1889,0.00258610963325699
STAT,1857,15,40-44,1872,0.17330952599307486
STAT,1873,89,na,1962,212.37356253774217
STAT,1875,23,45-49,1898,0.7278470979194517
STAT,1897,43,na,1940,3140.6508712185123
STAT,1865,38,na,1903,2170.58615400526
STAT,1817,46,20-24,1863,0.027231255007490716
STAT,1913,27,40-44,1940,4.737939191141892
SIM,1862,18,35-39,1880,1
SIM,1766,91,na,1857,12
SIM,1868,36,30-34,1904,8
SIM,1863,42,35-39,1905,1
SIM,1892,37,20-24,1929,2
STAT,1839,38,20-24,1877,0.62917628638441
SIM,1921,27,40-44,1948,7
STAT,1891,42,45-49,1933,1.887926248103532
SIM,1853,28,35-39,1881,13
STAT,1867,55,na,1922,1980.3148479892704
SIM,1953,15,25-29,1968,61
SIM,1883,20,40-44,1903,2
STAT,1932,28,20-24,1960,24.37104621137049
STAT,1899,21,40-44,1920,2.919806421641548
STAT,1861,18,35-39,1879,0.5285099074087005
STAT,1810,104,na,1914,0.02843645082607923
STAT,1908,48,40-44,1956,0.14499289256509973
SIM,1872,20,na,1892,2480
STAT,1846,53,na,1899,1515.0543078399767
STAT,1906,25,15-19,1931,0.6782487394145212
SIM,1852,15,30-34,1867,2
STAT,1836,54,50-100,1890,0.009142821504335562
SIM,1949,0,na,1949,4959
STAT,1851,30,40-44,1881,3.8020626515187708
STAT,1849,42,na,1891,1792.146200570167
STAT,1869,29,35-39,1898,9.435389038462795
STAT,1850,39,na,1889,1763.2399472313784
STAT,1845,35,40-44,1880,4.032023868799629
SIM,1882,34,50-100,1916,2
SIM,1911,34,30-34,1945,23
STAT,1881,32,35-39,1913,9.98809636556166
STAT,1803,54,na,1857,1268.128569020678
STAT,1841,47,50-100,1888,0.18216149789598843
SIM,1825,60,na,1885,1147
SIM,1940,28,20-24,1968,17
SIM,1890,33,na,1923,3086
STAT,1859,52,20-24,1911,5.979935012254452E-4
STAT,1902,57,na,1959,2977.499297188841
STAT,1819,54,30-34,1873,0.010898393291944107
SIM,1894,23,na,1917,3157
SIM,1897,12,na,1909,3499
STAT,1814,41,35-39,1855,6.529345542581168
STAT,1823,36,35-39,1859,13.69286000918133
STAT,1925,41,15-19,1966,0.0018996192860504196
STAT,1859,15,15-19,1874,5.679086607287544
STAT,1856,23,50-100,1879,0.3765457289712177
STAT,1876,19,25-29,1895,5.937485063041159
STAT,1810,49,30-34,1859,0.29380577372653705
STAT,1845,28,35-39,1873,9.110616501947021
SIM,1859,94,na,1953,46
SIM,1785,92,na,1877,4
SIM,1814,66,na,1880,899
SIM,1949,17,25-29,1966,81
SIM,1874,77,na,1951,824
STAT,1873,22,40-44,1895,2.155178421072077
SIM,1899,13,na,1912,3596
SIM,1926,19,40-44,1945,2
STAT,1845,52,na,1897,1673.414870160547
SIM,1860,35,na,1895,2067
STAT,1929,43,40-44,1972,0.32985711680782026
SIM,1831,36,35-39,1867,15
STAT,1851,46,20-24,1897,0.009928317475040879
STAT,1866,30,40-44,1896,4.113522333981693
STAT,1945,15,25-29,1960,48.323172875569746
STAT,1909,19,30-34,1928,2.4246849831499167
SIM,1851,36,20-24,1887,2
SIM,1877,51,na,1928,2217
SIM,1934,37,na,1971,5416
SIM,1882,38,na,1920,2243
SIM,1930,25,na,1955,5279
SIM,1856,83,na,1939,281
STAT,1895,38,35-39,1933,9.367441782421462
STAT,1883,45,15-19,1928,4.0437751273547147E-4
STAT,1904,33,25-29,1937,8.562566087557567
STAT,1845,44,30-34,1889,0.891603935075501
STAT,1828,47,50-100,1875,0.19208077736920845
STAT,1829,28,na,1857,1902.7566026266295
STAT,1773,110,na,1883,0.0019642630506133407
SIM,1915,42,na,1957,4165
STAT,1822,49,na,1871,1477.131320993101
STAT,1866,44,45-49,1910,1.3892844607476764
SIM,1853,44,30-34,1897,1
STAT,1941,28,30-34,1969,41.3324300983396
STAT,1873,8,na,1881,2790.936843819896
STAT,1923,44,15-19,1967,0.0018252532836528735
STAT,1828,47,35-39,1875,0.10949230013575999
STAT,1844,15,30-34,1859,1.5886932374349216
SIM,1874,44,45-49,1918,5
SIM,1917,19,30-34,1936,17
STAT,1935,10,na,1945,5540.642997827749
STAT,1817,39,15-19,1856,0.1641231172953169
SIM,1849,37,50-100,1886,3
STAT,1914,42,na,1956,3754.74066037412
SIM,1914,21,35-39,1935,18
STAT,1887,18,30-34,1905,1.8172317239024594
STAT,1889,26,40-44,1915,3.787795024602256
SIM,1842,32,na,1874,1956
STAT,1901,22,50-100,1923,0.5817453038717888
SIM,1859,104,na,1963,3
STAT,1886,29,35-39,1915,10.344562938433198
SIM,1836,69,na,1905,1120
SIM,1875,26,20-24,1901,12
SIM,1827,38,35-39,1865,6
SIM,1828,27,30-34,1855,5
SIM,1845,23,15-19,1868,5
SIM,1933,36,na,1969,5124
STAT,1915,38,30-34,1953,1.8694938900007267
STAT,1825,49,15-19,1874,5.005619118873445E-4
STAT,1884,27,na,1911,2408.6764123945454
STAT,1921,30,50-100,1951,0.9464446659526371
STAT,1806,96,na,1902,3.051130995053664
STAT,1852,25,30-34,1877,23.971611322469876
STAT,1777,82,na,1859,188.2742069493441
STAT,1822,51,35-39,1873,0.01203735958838916
STAT,1903,34,30-34,1937,14.413965395669138
SIM,1832,79,na,1911,250
SIM,1838,41,50-100,1879,1
STAT,1837,23,15-19,1860,2.8587598335740174
STAT,1843,36,20-24,1879,0.7340459120392692
STAT,1882,16,45-49,1898,0.06508197477145186
SIM,1860,25,30-34,1885,8
SIM,1943,9,na,1952,3914
STAT,1842,47,25-29,1889,0.0451777325155131
STAT,1910,37,50-100,1947,0.40954454666107176
STAT,1923,25,na,1948,4418.09729231664
STAT,1924,0,na,1924,5473.519088383872
SIM,1936,22,25-29,1958,157
SIM,1865,66,na,1931,1474
SIM,1804,98,na,1902,7
SIM,1918,47,na,1965,4108
STAT,1804,52,na,1856,1169.3407539861814
STAT,1885,16,30-34,1901,1.6261906890195486
STAT,1927,15,na,1942,4690.15333742661
STAT,1928,22,25-29,1950,117.63650027563847
STAT,1928,38,40-44,1966,1.9278027736918086
SIM,1917,22,20-24,1939,4
STAT,1841,109,na,1950,5.253082137268818E-4
STAT,1926,15,15-19,1941,57.02750143570892
SIM,1812,46,35-39,1858,1
STAT,1911,40,15-19,1951,0.0015120356935407696
STAT,1840,29,50-100,1869,0.5657411162040411
SIM,1864,23,50-100,1887,1
SIM,1864,36,50-100,1900,5
SIM,1877,23,20-24,1900,75
SIM,1897,26,40-44,1923,10
STAT,1842,44,15-19,1886,0.010921080988421704
STAT,1850,35,50-100,1885,0.957824848176451
SIM,1862,37,35-39,1899,5
SIM,1859,72,na,1931,1017
STAT,1875,6,na,1881,2849.8407972933937
SIM,1867,15,15-19,1882,5
SIM,1810,76,na,1886,612
STAT,1854,22,30-34,1876,16.017958803689535
SIM,1885,80,na,1965,958
STAT,1838,25,50-100,1863,0.6065605410922658
STAT,1864,50,na,1914,1981.167201008902
SIM,1851,30,50-100,1881,1
STAT,1909,22,20-24,1931,105.3988432513348
STAT,1864,37,35-39,1901,6.415721958854512
STAT,1889,42,50-100,1931,1.329642090598233
STAT,1837,57,na,1894,1339.874348660854
STAT,1862,24,na,1886,2072.37770875807
STAT,1825,38,na,1863,1692.3790754644635
STAT,1871,37,35-39,1908,7.14736135370848
STAT,1819,38,35-39,1857,18.200132715939397
STAT,1871,25,40-44,1896,3.047627883556381
SIM,1852,93,na,1945,19
SIM,1894,29,35-39,1923,16
STAT,1906,21,35-39,1927,8.69094748895458
SIM,1862,22,30-34,1884,23
SIM,1895,18,30-34,1913,1
STAT,1827,53,20-24,1880,7.838345729595831E-4
STAT,1867,19,50-100,1886,0.04740402391471431
STAT,1813,66,na,1879,837.7750595422476
STAT,1877,20,15-19,1897,3.5114782313080504
STAT,1816,46,50-100,1862,0.5132958700324772
STAT,1948,9,na,1957,4588.226460914379
STAT,1871,15,30-34,1886,1.6403124406163638
STAT,1912,16,na,1928,3993.9106018899874
SIM,1877,69,na,1946,1412
STAT,1890,25,50-100,1915,0.8033251918121831
SIM,1901,27,30-34,1928,43
STAT,1867,22,40-44,1889,2.0039513661367088
STAT,1910,49,35-39,1959,0.12196820472557093
STAT,1923,48,30-34,1971,0.10610675086125225
SIM,1858,29,25-29,1887,40
STAT,1814,104,na,1918,0.031081365416303283
SIM,1854,17,30-34,1871,5
STAT,1898,19,45-49,1917,0.08963254730683837
STAT,1881,84,na,1965,579.9872397796483
STAT,1812,81,na,1893,246.6460488861581
SIM,1820,35,na,1855,1825
STAT,1852,65,na,1917,1361.4365709571136
STAT,1830,33,30-34,1863,16.410568762840715
STAT,1900,17,20-24,1917,25.067252361259758
SIM,1833,40,40-44,1873,7
STAT,1854,37,35-39,1891,5.413293105058243
STAT,1909,43,50-100,1952,0.11139392607446627
STAT,1939,18,na,1957,3757.312063641027
SIM,1900,43,na,1943,3252
SIM,1862,52,na,1914,1937
STAT,1899,48,20-24,1947,0.00933727127558831
STAT,1930,23,25-29,1953,120.31485040016116
STAT,1888,33,40-44,1921,5.2080963997619865
STAT,1894,44,20-24,1938,0.014276201070961577
SIM,1934,15,15-19,1949,86
STAT,1915,28,50-100,1943,1.0323457459400014
SIM,1896,33,40-44,1929,1
STAT,1846,17,30-34,1863,1.4318324760179084
SIM,1868,39,35-39,1907,12
SIM,1922,32,40-44,1954,9
STAT,1828,32,30-34,1860,17.22820072794138
STAT,1862,37,25-29,1899,2.5002949221891644
STAT,1890,37,45-49,1927,2.486549448545584
STAT,1926,25,25-29,1951,81.03972772225809
SIM,1811,43,25-29,1854,2
STAT,1840,62,na,1902,1315.2315776046921
STAT,1838,54,40-44,1892,0.0075224998751450165
STAT,1870,34,25-29,1904,10.12711417532205
STAT,1848,104,na,1952,0.05184815046305287
SIM,1887,10,na,1897,3060
SIM,1927,25,25-29,1952,87
SIM,1927,44,25-29,1971,1
STAT,1878,24,15-19,1902,3.481175659529905
SIM,1927,21,na,1948,4766
SIM,1886,24,15-19,1910,2
STAT,1818,51,20-24,1869,0.0016384051784475175
STAT,1823,46,45-49,1869,0.3598526166240475
STAT,1874,49,na,1923,2294.42100169929
SIM,1839,28,45-49,1867,2
STAT,1858,20,40-44,1878,1.9623153215042228
SIM,1875,22,40-44,1897,3
SIM,1889,76,na,1965,1586
STAT,1840,31,35-39,1871,8.96866831766048
SIM,1882,18,20-24,1900,17
SIM,1944,24,40-44,1968,5
SIM,1923,19,30-34,1942,20
SIM,1935,19,na,1954,5103
SIM,1896,23,30-34,1919,34
STAT,1895,23,30-34,1918,23.6350850398971
STAT,1936,24,40-44,1960,3.2764528366661225
STAT,1850,21,na,1871,1944.3384645805158
SIM,1867,26,30-34,1893,30
STAT,1888,23,30-34,1911,21.41559399735742
STAT,1914,32,40-44,1946,4.019084205315987
STAT,1885,42,20-24,1927,0.16143753506093123
SIM,1926,15,25-29,1941,91
SIM,1934,25,25-29,1959,107
STAT,1907,44,50-100,1951,0.10840497711639599
STAT,1940,22,40-44,1962,3.494298220788146
STAT,1797,65,na,1862,827.3999607523242
SIM,1826,51,na,1877,1418
SIM,1886,29,45-49,1915,2
SIM,1920,20,50-100,1940,1
SIM,1921,11,na,1932,5237
STAT,1858,39,25-29,1897,2.3058493055080214
STAT,1915,19,30-34,1934,2.589248746261853
STAT,1901,37,30-34,1938,1.6410547112828155
STAT,1838,54,35-39,1892,0.006151577014888943
STAT,1838,107,na,1945,0.0034650571807225135
SIM,1855,32,40-44,1887,8
STAT,1918,15,25-29,1933,9.701888298533904
SIM,1871,72,na,1943,1200
STAT,1853,43,20-24,1896,0.1322025678557584
STAT,1886,45,30-34,1931,0.10556788896732845
STAT,1844,41,20-24,1885,0.12766532386240273
SIM,1942,10,na,1952,4676
STAT,1902,29,30-34,1931,35.968899720810064
SIM,1819,38,45-49,1857,5
SIM,1829,32,30-34,1861,19
STAT,1794,100,na,1894,0.21043558322567202
STAT,1919,25,25-29,1944,73.06638996231092
STAT,1846,21,50-100,1867,0.3624207250540474
STAT,1871,20,na,1891,2404.1996110168093
STAT,1889,48,na,1937,2800.019608140885
SIM,1836,32,30-34,1868,23
SIM,1864,26,45-49,1890,3
SIM,1884,22,15-19,1906,5
STAT,1864,47,45-49,1911,0.21307341365440532
STAT,1904,64,na,1968,2837.458582618504
STAT,1952,15,25-29,1967,53.003879089227745
STAT,1902,16,40-44,1918,0.26377892038858586
SIM,1835,84,na,1919,175
SIM,1872,47,45-49,1919,1
STAT,1817,49,25-29,1866,0.12476033707908035
STAT,1934,38,40-44,1972,2.1045741996358944
STAT,1857,18,45-49,1875,0.060808966880469634
STAT,1847,32,40-44,1879,3.9706969221103585
SIM,1868,55,na,1923,2026
SIM,1910,29,30-34,1939,48
STAT,1857,77,na,1934,688.677552778521
SIM,1834,25,20-24,1859,12
SIM,1848,54,na,1902,1686
STAT,1833,50,40-44,1883,0.007466618133997669
SIM,1901,28,na,1929,3684
STAT,1829,52,35-39,1881,0.00612851714481859
SIM,1937,26,na,1963,4309
SIM,1811,52,na,1863,1094
SIM,1885,27,na,1912,2365
STAT,1904,28,45-49,1932,1.6176221118098175
SIM,1912,28,45-49,1940,3
STAT,1918,19,na,1937,4066.4026245631935
STAT,1955,1,na,1956,5331.37259643635
SIM,1904,19,20-24,1923,23
STAT,1800,96,na,1896,4.138492230505061
STAT,1825,40,40-44,1865,3.2018651829929228
STAT,1878,29,45-49,1907,1.1705613913133142
SIM,1891,49,na,1940,2812
SIM,1901,10,na,1911,3832
STAT,1823,90,na,1913,43.87894334021264
STAT,1856,26,45-49,1882,0.9280101558905925
SIM,1920,38,45-49,1958,3
SIM,1929,32,35-39,1961,22
STAT,1883,48,25-29,1931,0.056931163937703984
SIM,1889,54,na,1943,2781
STAT,1892,31,40-44,1923,5.567419827297728
STAT,1893,16,20-24,1909,22.99966540622543
STAT,1896,43,35-39,1939,0.16820125762392485
STAT,1912,38,45-49,1950,0.6753915909353445
SIM,1893,78,na,1971,1366
SIM,1807,87,na,1894,21
SIM,1873,28,20-24,1901,13
STAT,1825,54,na,1879,1375.103984110131
SIM,1894,35,20-24,1929,3
SIM,1936,15,25-29,1951,50
STAT,1784,106,na,1890,0.01133654629739006
SIM,1934,19,30-34,1953,17
SIM,1888,24,40-44,1912,3
STAT,1852,31,na,1883,2011.2080954645867
STAT,1869,33,30-34,1902,17.12365482223785
SIM,1827,44,20-24,1871,2
SIM,1943,3,na,1946,3983
STAT,1906,44,15-19,1950,0.0014047211355781377
SIM,1947,23,45-49,1970,5
STAT,1866,33,45-49,1899,1.6339601545499856
SIM,1887,44,na,1931,2683
SIM,1831,43,35-39,1874,3
STAT,1919,32,25-29,1951,10.175852078240155
STAT,1851,37,25-29,1888,2.4008253551445
STAT,1832,33,40-44,1865,3.7618748220474205
SIM,1872,25,35-39,1897,15
STAT,1888,31,15-19,1919,0.17244839654157879
STAT,1936,8,na,1944,3894.6364211650957
SIM,1870,35,35-39,1905,18
STAT,1864,25,35-39,1889,8.845921875073481
SIM,1820,54,na,1874,1440
SIM,1813,81,na,1894,237
STAT,1915,27,15-19,1942,0.7347787926459138
STAT,1856,38,20-24,1894,0.6142366864491106
STAT,1914,28,50-100,1942,1.0201680134716018
STAT,1851,86,na,1937,183.0517079572954
SIM,1849,32,40-44,1881,3
SIM,1923,27,15-19,1950,2
SIM,1857,12,na,1869,2388
STAT,1880,50,20-24,1930,8.024394626621245E-4
STAT,1878,28,30-34,1906,26.64555932925301
SIM,1782,87,na,1869,29
STAT,1895,35,30-34,1930,7.161096346490485
STAT,1879,43,50-100,1922,1.1184147883125894
SIM,1886,16,30-34,1902,2
STAT,1954,18,50-100,1972,0.4722732279207479
STAT,1840,46,na,1886,1653.6640781277188
STAT,1943,26,15-19,1969,0.7674181943407999
STAT,1845,38,50-100,1883,0.9975086146730251
STAT,1814,50,30-34,1864,0.01767440749952239
STAT,1844,17,20-24,1861,17.46340588040058
SIM,1840,21,40-44,1861,2
STAT,1873,27,35-39,1900,9.979400214685137
STAT,1874,34,na,1908,2464.2107836073283
SIM,1877,33,30-34,1910,25
SIM,1886,28,30-34,1914,42
SIM,1779,80,na,1859,111
STAT,1905,45,45-49,1950,0.19809241336719438
STAT,1920,34,30-34,1954,17.46024114022172
SIM,1944,22,15-19,1966,7
STAT,1870,43,50-100,1913,1.0459493764298178
SIM,1875,59,na,1934,1907
STAT,1909,29,40-44,1938,4.510559432252186
SIM,1875,29,25-29,1904,6
SIM,1889,27,50-100,1916,1
SIM,1906,1,na,1907,3986
SIM,1840,33,40-44,1873,8
SIM,1923,15,15-19,1938,52
STAT,1901,21,15-19,1922,4.720527755059338
STAT,1910,33,25-29,1943,9.050996507829359
STAT,1902,19,45-49,1921,0.09347195423757552
SIM,1819,37,30-34,1856,9
SIM,1837,94,na,1931,15
SIM,1852,17,20-24,1869,15
STAT,1847,37,50-100,1884,0.9933552477019256
STAT,1833,31,50-100,1864,0.7912063826666124
STAT,1925,34,50-100,1959,1.000400657128924
STAT,1928,22,30-34,1950,36.603236298025415
SIM,1862,61,na,1923,1676
STAT,1862,49,na,1911,1912.9687456121844
SIM,1794,72,na,1866,563
STAT,1812,42,20-24,1854,0.45824223960261734
STAT,1869,45,30-34,1914,0.09628962657042471
SIM,1832,39,20-24,1871,2
STAT,1783,97,na,1880,1.002875766321387
SIM,1936,22,30-34,1958,52
STAT,1836,94,na,1930,12.440025937130862
STAT,1845,38,45-49,1883,1.619655371884937
STAT,1849,67,na,1916,1230.7005699496592
SIM,1827,32,20-24,1859,3
STAT,1929,36,50-100,1965,0.5502732576272997
SIM,1857,48,25-29,1905,1
SIM,1884,29,35-39,1913,14
STAT,1838,35,35-39,1873,6.402378410824712
STAT,1835,21,15-19,1856,3.2923439720933874
SIM,1868,52,na,1920,2115
SIM,1881,27,35-39,1908,9
STAT,1932,34,15-19,1966,0.17398976699663252
SIM,1918,34,40-44,1952,5
STAT,1888,45,40-44,1933,0.20852908222445526
STAT,1855,32,30-34,1887,13.781160547129407
STAT,1824,39,20-24,1863,0.9950745345222897
STAT,1837,27,30-34,1864,21.54965199712112
STAT,1919,44,25-29,1963,0.07870630042232893
STAT,1871,27,25-29,1898,42.74662768847202
STAT,1871,28,45-49,1899,1.1180392521457898
STAT,1889,29,45-49,1918,1.389141480507824
STAT,1903,30,15-19,1933,0.20817456879714383
STAT,1926,11,na,1937,4963.259060168288
STAT,1870,50,20-24,1920,7.464746623755832E-4
STAT,1916,45,20-24,1961,0.011621513331296336
STAT,1847,48,15-19,1895,3.08005595222726E-4
SIM,1894,23,20-24,1917,97
SIM,1843,21,15-19,1864,4
STAT,1889,19,50-100,1908,0.0614057220173996
STAT,1923,21,35-39,1944,11.212031388810168
STAT,1886,23,20-24,1909,74.18261006345958
SIM,1931,21,35-39,1952,19
STAT,1937,15,35-39,1952,4.183246068038636
SIM,1917,29,40-44,1946,7
SIM,1845,27,30-34,1872,27
SIM,1937,32,25-29,1969,13
STAT,1815,49,15-19,1864,0.0010408324544464963
SIM,1847,23,40-44,1870,1
STAT,1823,43,35-39,1866,2.856832784237722
STAT,1869,26,30-34,1895,24.88697885216684
STAT,1805,50,50-100,1855,0.05540159856793138
STAT,1868,54,20-24,1922,6.992324055860165E-4
SIM,1862,34,30-34,1896,7
STAT,1926,19,30-34,1945,15.163547533308618
SIM,1846,35,35-39,1881,4
SIM,1906,4,na,1910,3898
SIM,1922,9,na,1931,4702
SIM,1871,28,50-100,1899,1
SIM,1927,32,25-29,1959,13
STAT,1862,46,na,1908,1959.3088941277442
STAT,1882,63,na,1945,1773.3786435557827
STAT,1870,59,na,1929,1938.144299642797
STAT,1857,54,45-49,1911,0.011244358407060057
SIM,1897,29,45-49,1926,2
SIM,1914,29,30-34,1943,53
STAT,1886,35,20-24,1921,0.8402770939315969
STAT,1899,25,50-100,1924,0.8996935686069188
STAT,1825,32,50-100,1857,1.8164790276858098
SIM,1911,30,15-19,1941,1
STAT,1917,36,15-19,1953,0.020452589884778417
SIM,1829,42,40-44,1871,3
SIM,1845,27,na,1872,2097
SIM,1863,32,30-34,1895,19
STAT,1838,47,35-39,1885,0.10582736103773004
STAT,1933,2,na,1935,5583.360978398561
SIM,1877,38,25-29,1915,6
STAT,1890,34,35-39,1924,12.523713754411647
STAT,1847,30,15-19,1877,0.13312459153411318
STAT,1903,21,50-100,1924,0.5931486151661469
STAT,1863,15,40-44,1878,0.18889933624935806
STAT,1869,38,25-29,1907,2.821680278803326
STAT,1871,43,50-100,1914,1.059858761022446
STAT,1787,87,na,1874,67.69259295178358
STAT,1891,18,20-24,1909,22.332433938992914
SIM,1846,46,50-100,1892,1
STAT,1840,40,30-34,1880,0.9729581177170223
STAT,1819,44,20-24,1863,0.32340302579603725
STAT,1910,46,30-34,1956,0.08504042235453883
STAT,1939,23,45-49,1962,1.1523579644257649
SIM,1807,72,na,1879,477
SIM,1834,21,40-44,1855,2
SIM,1966,4,na,1970,5192
STAT,1970,1,na,1971,5027.68567344767
SIM,1870,22,20-24,1892,78
SIM,1819,75,na,1894,614
STAT,1888,38,35-39,1926,8.48777694971617
SIM,1854,57,na,1911,1727
STAT,1841,27,20-24,1868,10.758557477937334
STAT,1857,96,na,1953,6.841152269415183
SIM,1857,31,50-100,1888,3
STAT,1839,23,40-44,1862,1.834558982344625
SIM,1821,33,30-34,1854,18
SIM,1929,20,50-100,1949,2
SIM,1858,26,20-24,1884,12
STAT,1833,41,45-49,1874,1.2155192007156879
SIM,1853,22,20-24,1875,62
SIM,1903,35,40-44,1938,2
STAT,1884,73,na,1957,1265.0080433660376
SIM,1857,15,na,1872,2290
STAT,1893,19,25-29,1912,7.29424811333935
STAT,1799,75,na,1874,409.3376894804911
STAT,1925,44,25-29,1969,0.0879116133323198
SIM,1843,28,35-39,1871,17
STAT,1882,44,na,1926,2266.0812694609067
STAT,1800,62,na,1862,1096.1195514479916
STAT,1916,32,15-19,1948,0.13538897886664072
SIM,1857,31,na,1888,2027
STAT,1935,28,na,1963,5205.1103384303715
STAT,1845,34,20-24,1879,2.459595338169781
SIM,1779,83,na,1862,65
SIM,1832,54,na,1886,1357
STAT,1929,32,25-29,1961,11.97430616825518
STAT,1815,79,na,1894,361.49015582122644
STAT,1920,11,na,1931,4543.322067253793
SIM,1914,33,35-39,1947,17
STAT,1862,22,20-24,1884,61.261238700834696
SIM,1792,62,na,1854,803
STAT,1861,20,50-100,1881,0.35827864908409884
STAT,1865,29,na,1894,2193.8955624780633
STAT,1896,40,30-34,1936,0.1086517782563028
STAT,1879,36,35-39,1915,7.57854642075126
SIM,1896,38,35-39,1934,11
SIM,1860,28,35-39,1888,7
SIM,1869,24,15-19,1893,2
STAT,1902,38,na,1940,3399.2167799754325
SIM,1867,28,20-24,1895,12
STAT,1841,39,15-19,1880,0.047846201513225585
STAT,1866,45,20-24,1911,0.011404215460186998
STAT,1900,23,15-19,1923,4.650240384192636
SIM,1853,34,20-24,1887,1
STAT,1821,34,35-39,1855,27.421827857554252
STAT,1850,29,20-24,1879,10.236031196893258
STAT,1871,22,30-34,1893,17.999750827855987
STAT,1886,59,na,1945,2098.5761057001164
SIM,1882,1,na,1883,3123
STAT,1870,75,na,1945,1026.6441277692763
SIM,1912,37,40-44,1949,5
STAT,1850,50,35-39,1900,0.0065688355333282916
SIM,1907,18,25-29,1925,10
STAT,1895,36,na,1931,3150.92432819388
STAT,1852,28,35-39,1880,8.988751503057468
STAT,1832,37,15-19,1869,0.047689274740023734
STAT,1842,43,45-49,1885,1.1988332158620154
SIM,1844,64,na,1908,1374
STAT,1836,32,20-24,1868,2.1268283953220797
SIM,1829,47,35-39,1876,1
SIM,1850,43,45-49,1893,2
SIM,1903,23,40-44,1926,2
SIM,1906,59,na,1965,3056
SIM,1905,31,35-39,1936,6
STAT,1871,24,20-24,1895,69.201827875342
STAT,1915,15,15-19,1930,9.737720429240282
STAT,1945,19,40-44,1964,1.5578397283725438
SIM,1864,16,na,1880,2444
SIM,1908,29,30-34,1937,49
STAT,1832,26,35-39,1858,8.91556444633974
STAT,1936,22,15-19,1958,5.190711535504074
STAT,1793,75,na,1868,445.08239521256803
SIM,1891,3,na,1894,3414
STAT,1830,84,na,1914,210.4401222433273
STAT,1877,14,na,1891,2723.6704603528024
SIM,1881,22,40-44,1903,2
STAT,1837,25,40-44,1862,2.6006944111265256
STAT,1883,44,45-49,1927,1.4778637535957573
STAT,1907,23,50-100,1930,0.6089364898452021
STAT,1897,39,20-24,1936,0.2246655692617601
STAT,1851,83,na,1934,327.52117079865354
SIM,1780,77,na,1857,294
STAT,1859,28,20-24,1887,9.652956325141487
STAT,1922,43,50-100,1965,0.13737101832165352
SIM,1887,36,35-39,1923,12
STAT,1850,17,20-24,1867,16.29575245762867
STAT,1892,35,20-24,1927,0.9949381613621059
SIM,1822,61,na,1883,1060
STAT,1856,15,na,1871,2199.3817938724874
STAT,1864,44,35-39,1908,1.620385712679654
STAT,1807,51,45-49,1858,0.061192524901869765
STAT,1945,22,25-29,1967,103.2869551833729
SIM,1919,25,35-39,1944,15
STAT,1825,44,20-24,1869,0.2079769906539525
STAT,1932,15,15-19,1947,61.570157935315045
SIM,1883,60,na,1943,1971
STAT,1904,37,40-44,1941,1.38142635505988
STAT,1871,23,na,1894,2382.554954490762
STAT,1769,102,na,1871,0.04031594767589034
STAT,1919,29,40-44,1948,5.10257864750692
SIM,1866,42,na,1908,2318
STAT,1833,53,45-49,1886,0.009699024495834766
STAT,1813,69,na,1882,749.1130335322991
SIM,1814,43,40-44,1857,4
STAT,1883,20,50-100,1903,0.4106195636424721
SIM,1927,29,40-44,1956,9
SIM,1940,15,15-19,1955,45
SIM,1912,25,40-44,1937,8
SIM,1841,41,45-49,1882,2
STAT,1879,48,35-39,1927,0.1474138701492116
STAT,1902,25,15-19,1927,0.6571453651632395
STAT,1934,1,na,1935,5760.417135922744
SIM,1845,25,40-44,1870,3
STAT,1921,25,40-44,1946,5.336878029340347
STAT,1926,14,na,1940,4939.819787328365
SIM,1877,66,na,1943,1661
SIM,1934,15,na,1949,5115
STAT,1845,22,20-24,1867,66.84455477457195
SIM,1856,67,na,1923,1533
SIM,1840,26,35-39,1866,10
STAT,1847,47,45-49,1894,0.1831778865541997
SIM,1913,16,na,1929,4160
SIM,1882,81,na,1963,613
SIM,1945,21,na,1966,4341
STAT,1826,28,25-29,1854,121.5511223862931
STAT,1877,46,35-39,1923,0.1485526095277096
STAT,1896,3,na,1899,3561.9196058595835
STAT,1941,17,15-19,1958,47.69024471362512
STAT,1876,16,20-24,1892,18.72162389906557
STAT,1816,53,45-49,1869,0.027986987429862224
STAT,1931,35,45-49,1966,0.9223713842566101
SIM,1881,34,40-44,1915,8
STAT,1904,25,40-44,1929,4.409425021122699
SIM,1817,41,50-100,1858,1
STAT,1888,49,15-19,1937,2.664364846536119E-4
STAT,1935,19,40-44,1954,1.9395334940336755
SIM,1943,19,40-44,1962,6
STAT,1880,53,25-29,1933,0.003736175505046779
SIM,1786,68,na,1854,731
SIM,1915,36,50-100,1951,1
STAT,1825,32,na,1857,1744.0574539264485
STAT,1901,34,20-24,1935,3.8231126817221983
SIM,1843,17,na,1860,2327
STAT,1947,13,na,1960,4513.85339051028
SIM,1834,28,25-29,1862,43
SIM,1860,45,50-100,1905,1
STAT,1890,15,35-39,1905,0.6876050788167248
STAT,1873,34,40-44,1907,4.446846333213098
STAT,1832,36,45-49,1868,1.7113875606303504
SIM,1882,42,45-49,1924,2
STAT,1836,45,35-39,1881,0.09356853785398596
STAT,1930,27,40-44,1957,6.044743313729941
SIM,1866,45,na,1911,2280
SIM,1906,27,15-19,1933,5
SIM,1827,42,30-34,1869,5
SIM,1831,24,35-39,1855,9
STAT,1857,51,40-44,1908,0.008427708608116995
SIM,1872,22,30-34,1894,4
STAT,1829,90,na,1919,52.435587265301045
STAT,1842,30,50-100,1872,0.8862092872590088
STAT,1886,33,30-34,1919,18.77365356346806
STAT,1885,28,50-100,1913,0.6487735980791351
SIM,1829,50,na,1879,1216
SIM,1877,35,20-24,1912,4
SIM,1788,94,na,1882,5
STAT,1901,40,15-19,1941,0.0013818692997633758
SIM,1888,27,45-49,1915,2
STAT,1851,39,15-19,1890,0.04586221382187716
STAT,1830,53,50-100,1883,0.010805777247050868
STAT,1886,38,25-29,1924,3.093571353256271
SIM,1887,43,40-44,1930,3
SIM,1944,20,25-29,1964,110
STAT,1854,37,50-100,1891,0.939658593102611
SIM,1871,75,na,1946,1094
STAT,1883,48,na,1931,2223.716233969737
STAT,1886,37,na,1923,2544.012656710463
STAT,1926,17,40-44,1943,1.7494612967967618
SIM,1934,17,40-44,1951,5
STAT,1852,18,25-29,1870,5.488825814136423
SIM,1888,29,na,1917,2746
SIM,1893,22,na,1915,3105
STAT,1851,34,20-24,1885,2.2733973181120235
STAT,1850,22,50-100,1872,0.3681677440471727
STAT,1869,35,20-24,1904,0.7664259310460918
STAT,1849,33,45-49,1882,1.411867154624221
STAT,1890,31,30-34,1921,21.867148374079374
SIM,1866,26,na,1892,2396
STAT,1840,43,35-39,1883,1.3419757179233593
SIM,1894,38,25-29,1932,3
STAT,1935,25,na,1960,5212.143571037833
SIM,1868,24,30-34,1892,25
SIM,1949,21,20-24,1970,127
SIM,1908,31,50-100,1939,1
SIM,1855,82,na,1937,273
STAT,1819,47,25-29,1866,0.11411384318264897
STAT,1874,42,45-49,1916,1.5569241264751064
STAT,1857,93,na,1950,23.284423261706152
SIM,1896,48,45-49,1944,1
STAT,1913,41,na,1954,3716.077322706145
STAT,1814,53,35-39,1867,0.02407218835530249
STAT,1954,15,35-39,1969,5.293959730180085
STAT,1852,50,45-49,1902,0.011859232342069823
STAT,1860,39,25-29,1899,2.359167179082717
STAT,1932,36,na,1968,5159.789104884265
STAT,1878,26,40-44,1904,3.191789084281893
STAT,1920,44,40-44,1964,0.28097095326806837
STAT,1952,19,40-44,1971,1.7087360719394844
SIM,1892,25,45-49,1917,3
STAT,1823,31,40-44,1854,12.627604465689988
SIM,1835,65,na,1900,1098
STAT,1872,85,na,1957,331.90587298039
STAT,1936,20,25-29,1956,90.13289707585965
SIM,1937,29,na,1966,4316
STAT,1830,110,na,1940,1.7480930303431083E-4
STAT,1932,23,35-39,1955,12.56045504191054
STAT,1834,49,25-29,1883,0.04006842031965813
STAT,1899,33,40-44,1932,6.032695677014516
STAT,1783,91,na,1874,19.05339253639179
STAT,1896,34,50-100,1930,1.223937251419986
SIM,1831,40,30-34,1871,1
SIM,1940,23,35-39,1963,15
STAT,1874,18,45-49,1892,0.06785917125171333
SIM,1817,65,na,1882,827
STAT,1890,22,40-44,1912,2.5992115733792085
SIM,1819,35,40-44,1854,4
STAT,1864,22,30-34,1886,16.417028222673753
SIM,1844,42,na,1886,1877
SIM,1850,30,50-100,1880,1
SIM,1886,26,40-44,1912,5
STAT,1921,28,45-49,1949,1.9578634100676597
STAT,1921,43,50-100,1964,0.1348110342955323
SIM,1891,41,40-44,1932,7
SIM,1931,26,na,1957,4749
STAT,1942,22,15-19,1964,5.694297514937726
STAT,1881,44,35-39,1925,1.7618575421124716
STAT,1837,79,na,1916,466.1120341868493
STAT,1888,48,45-49,1936,0.15853250192242213
STAT,1911,37,50-100,1948,0.41364969960340914
SIM,1852,90,na,1942,38
SIM,1866,35,45-49,1901,1
STAT,1842,72,na,1914,990.3680016386238
SIM,1936,25,35-39,1961,17
SIM,1901,39,30-34,1940,2
STAT,1875,96,na,1971,51.03564310734255
STAT,1934,20,50-100,1954,0.904726020273878
SIM,1853,32,30-34,1885,22
SIM,1918,30,25-29,1948,18
STAT,1830,26,25-29,1856,52.059102094655536
SIM,1856,52,45-49,1908,1
STAT,1905,42,40-44,1947,0.22984473957833937
STAT,1855,35,35-39,1890,5.534988465641151
STAT,1900,29,20-24,1929,16.469127227072146
SIM,1849,39,25-29,1888,5
STAT,1862,35,35-39,1897,6.20045774067072
STAT,1906,33,35-39,1939,8.597884208366601
STAT,1928,40,na,1968,4842.758586887603
SIM,1900,49,na,1949,3035
STAT,1814,91,na,1905,27.0029409472317
STAT,1823,40,30-34,1863,1.9535941371432455
STAT,1876,22,15-19,1898,3.475288850736375
SIM,1847,53,na,1900,1424
STAT,1820,43,25-29,1863,1.2403865466798312
STAT,1881,81,na,1962,751.984810026805
SIM,1836,34,20-24,1870,4
SIM,1890,30,na,1920,3129
STAT,1796,64,na,1860,828.8165049445081
SIM,1899,27,20-24,1926,19
STAT,1835,28,35-39,1863,9.306147657907543
STAT,1858,32,40-44,1890,3.5084369098320027
STAT,1934,36,15-19,1970,0.027049366455543882
STAT,1873,38,15-19,1911,0.05778976602885905
SIM,1830,29,45-49,1859,5
STAT,1849,45,na,1894,1764.1013214141824
SIM,1828,48,50-100,1876,1
SIM,1846,32,30-34,1878,27
SIM,1869,56,na,1925,2067
SIM,1942,20,50-100,1962,1
SIM,1943,11,na,1954,3914
STAT,1910,37,40-44,1947,1.46022640731955
STAT,1838,32,30-34,1870,15.940811216127587
SIM,1890,48,na,1938,2937
STAT,1895,33,na,1928,3162.8025404038726
SIM,1918,44,na,1962,4159
SIM,1866,32,40-44,1898,5
STAT,1895,16,30-34,1911,2.126668014063183
STAT,1774,109,na,1883,0.0022445207279829793
STAT,1927,34,40-44,1961,4.904170528954272
SIM,1840,36,45-49,1876,3
SIM,1860,18,25-29,1878,10
STAT,1928,25,35-39,1953,18.994816048336165
SIM,1857,33,45-49,1890,1
STAT,1869,22,15-19,1891,3.2492365824300533
STAT,1847,19,na,1866,2207.8756161313368
STAT,1928,34,25-29,1962,11.773059181272936
STAT,1905,12,na,1917,3804.925774602779
STAT,1919,48,40-44,1967,0.17402228020114702
SIM,1881,24,30-34,1905,20
STAT,1854,28,45-49,1882,0.8844456387864188
STAT,1879,43,40-44,1922,2.3812001213044898
STAT,1892,22,na,1914,3023.861007507017
SIM,1908,23,25-29,1931,88
SIM,1880,71,na,1951,1238
SIM,1893,59,na,1952,2522
STAT,1925,38,30-34,1963,2.2295238862960813
SIM,1908,27,40-44,1935,6
STAT,1848,52,45-49,1900,0.011220925526452676
STAT,1935,9,na,1944,5549.855758386671
STAT,1910,52,na,1962,3437.0918366502283
SIM,1935,34,40-44,1969,8
SIM,1836,25,30-34,1861,4
SIM,1936,34,25-29,1970,10
SIM,1839,21,25-29,1860,51
SIM,1930,9,na,1939,5766
STAT,1837,42,na,1879,1654.0759024181948
STAT,1913,23,25-29,1936,94.86136782128234
STAT,1833,83,na,1916,260.6996538923803
SIM,1900,18,15-19,1918,6
STAT,1854,15,30-34,1869,1.4766051243397456
STAT,1859,26,na,1885,1992.201361889003
STAT,1880,24,30-34,1904,18.97575512010278
SIM,1829,44,30-34,1873,3
STAT,1906,48,30-34,1954,0.08005867974742661
SIM,1881,37,45-49,1918,2
STAT,1854,34,30-34,1888,13.40313182883945
STAT,1936,36,40-44,1972,1.500297972336009
SIM,1841,29,20-24,1870,13
STAT,1834,68,na,1902,1026.9755572118006
STAT,1880,15,40-44,1895,0.19698849939351348
STAT,1838,46,50-100,1884,0.18804524302908995
STAT,1832,24,50-100,1856,0.3928774053995847
STAT,1859,19,30-34,1878,1.489639421651548
STAT,1858,41,na,1899,1878.2711439590648
STAT,1888,35,30-34,1923,6.488621964910327
STAT,1843,24,45-49,1867,0.6964807407466461
STAT,1848,28,45-49,1876,1.0229509919565378
STAT,1839,26,45-49,1865,0.9723092674357087
STAT,1812,65,na,1877,916.5997969745897
SIM,1820,51,na,1871,1531
STAT,1931,32,40-44,1963,5.229572397072081
STAT,1901,44,30-34,1945,0.11235408550489402
SIM,1899,69,na,1968,2365
STAT,1873,37,45-49,1910,2.061762793502412
STAT,1909,25,25-29,1934,65.13722900282949
SIM,1867,19,30-34,1886,2
STAT,1851,103,na,1954,0.11840238641813033
SIM,1851,24,45-49,1875,1
SIM,1855,44,40-44,1899,3
STAT,1906,29,30-34,1935,37.12399445700519
STAT,1875,20,40-44,1895,2.194787738989075
STAT,1904,45,50-100,1949,0.20457228899207885
SIM,1832,27,20-24,1859,1
SIM,1896,35,30-34,1931,9
SIM,1856,28,45-49,1884,2
STAT,1835,51,20-24,1886,5.717538485062719E-4
STAT,1892,38,25-29,1930,3.6629728651175575
STAT,1904,21,25-29,1925,83.94954077269117
STAT,1929,30,35-39,1959,11.852623643278884
SIM,1863,35,35-39,1898,6
STAT,1854,52,50-100,1906,0.011497424794836876
STAT,1793,72,na,1865,591.4690625491348
STAT,1811,80,na,1891,267.95018645989774
STAT,1845,32,30-34,1877,16.220512645638976
STAT,1866,48,25-29,1914,0.05351885868943591
STAT,1869,81,na,1950,532.603520801702
STAT,1816,50,40-44,1866,0.021558964005095705
STAT,1827,64,na,1891,1123.5346455855167
STAT,1876,29,35-39,1905,10.091817414909908
STAT,1856,36,50-100,1892,0.9879128044837073
STAT,1895,11,na,1906,3442.4772042285063
SIM,1903,38,45-49,1941,1
SIM,1822,95,na,1917,6
SIM,1864,19,na,1883,2393
SIM,1948,19,25-29,1967,71
STAT,1862,25,25-29,1887,37.40518619214482
SIM,1847,26,45-49,1873,3
STAT,1769,87,na,1856,26.1986596
STAT,1902,23,na,1925,3391.9529162734416
SIM,1877,39,45-49,1916,1
STAT,1869,39,45-49,1908,1.9436410988224242
SIM,1870,25,25-29,1895,59
STAT,1870,46,25-29,1916,0.05760542032896411
STAT,1938,32,35-39,1970,9.373287890064244
STAT,1920,30,15-19,1950,0.14479636179571012
SIM,1841,50,na,1891,1660
SIM,1886,22,25-29,1908,71
STAT,1838,42,40-44,1880,1.9327456051612246
STAT,1909,15,15-19,1924,9.118824341994399
STAT,1841,106,na,1947,0.00896484909152373
SIM,1820,69,na,1889,959
SIM,1817,38,35-39,1855,9
STAT,1878,22,25-29,1900,60.786895529091915
SIM,1846,42,40-44,1888,1
SIM,1853,37,25-29,1890,4
SIM,1937,30,35-39,1967,13
STAT,1836,35,25-29,1871,2.24604094183981
SIM,1909,48,na,1957,3298
STAT,1837,21,25-29,1858,50.3261094789949
SIM,1879,92,na,1971,227
STAT,1885,18,20-24,1903,17.996448766030696
STAT,1887,84,na,1971,776.7521630322698
SIM,1901,33,25-29,1934,20
STAT,1781,87,na,1868,52.234150458270044
STAT,1891,77,na,1968,1501.3173345538357
STAT,1932,19,30-34,1951,16.37143471098775
SIM,1836,38,45-49,1874,4
SIM,1831,91,na,1922,42
STAT,1911,0,na,1911,4583.4951641686985
STAT,1844,27,na,1871,2052.126713492743
STAT,1863,71,na,1934,1193.9147086433534
SIM,1858,36,30-34,1894,5
STAT,1825,47,25-29,1872,0.07408299705268799
SIM,1912,21,25-29,1933,140
STAT,1883,26,na,1909,2397.0251028777993
STAT,1913,19,20-24,1932,28.1267324589805
STAT,1832,23,30-34,1855,18.73543740219174
STAT,1888,19,50-100,1907,0.05876833364909257
STAT,1873,20,15-19,1893,3.4323722446205687
SIM,1858,93,na,1951,9
STAT,1883,41,40-44,1924,2.26163463980361
STAT,1884,25,45-49,1909,1.1282122206105956
STAT,1933,18,na,1951,5011.7170955257625
SIM,1810,92,na,1902,60
STAT,1828,44,30-34,1872,0.9101413759900877
STAT,1865,16,45-49,1881,0.06269517445487834
STAT,1874,7,na,1881,2823.195206043058
STAT,1847,44,40-44,1891,1.7303386679204114
STAT,1861,44,25-29,1905,0.5340112086513974
STAT,1864,32,40-44,1896,3.933758828754524
STAT,1839,53,50-100,1892,0.010255730784948689
SIM,1844,79,na,1923,452
SIM,1893,18,20-24,1911,35
STAT,1842,40,40-44,1882,1.872303567073527
SIM,1905,21,25-29,1926,1
SIM,1921,19,20-24,1940,3
STAT,1848,82,na,1930,362.6899727640222
STAT,1884,70,na,1954,1416.0984005242651
STAT,1846,52,35-39,1898,0.006123751256938186
STAT,1895,29,45-49,1924,1.4672633128392232
SIM,1840,23,30-34,1863,21
SIM,1844,35,25-29,1879,3
STAT,1845,37,25-29,1882,2.363688674138245
STAT,1914,26,na,1940,3866.3432977572947
SIM,1859,78,na,1937,605
SIM,1921,23,25-29,1944,148
STAT,1949,8,na,1957,4663.337122738755
SIM,1862,15,30-34,1877,3
STAT,1868,104,na,1972,0.8454199694265319
SIM,1839,49,na,1888,1612
STAT,1928,15,25-29,1943,55.95538446707824
SIM,1819,72,na,1891,614
STAT,1828,38,45-49,1866,1.7106004488665005
STAT,1803,51,na,1854,1345.7567893865476
STAT,1925,21,50-100,1946,0.8059884832085217
STAT,1865,5,na,1870,2636.4809390383425
SIM,1845,21,25-29,1866,55
STAT,1834,22,45-49,1856,0.6276029002243004
STAT,1878,36,50-100,1914,1.309967182880966
STAT,1879,33,30-34,1912,18.53968792721121
STAT,1830,87,na,1917,111.45057983015815
SIM,1919,22,30-34,1941,45
SIM,1887,33,30-34,1920,27
STAT,1824,50,na,1874,1375.8768290252576
STAT,1898,25,na,1923,3314.670192472559
SIM,1940,19,30-34,1959,23
SIM,1836,44,30-34,1880,1
STAT,1864,41,30-34,1905,1.0475623396005753
STAT,1867,29,25-29,1896,40.223855173563074
STAT,1935,15,25-29,1950,60.69559040366465
SIM,1878,30,na,1908,2649
SIM,1881,34,na,1915,2143
STAT,1863,17,30-34,1880,1.6267885034860805
STAT,1819,42,30-34,1861,2.481669778193756
STAT,1852,53,50-100,1905,0.011971448725218341
SIM,1872,35,45-49,1907,3
SIM,1894,33,30-34,1927,41
STAT,1910,27,30-34,1937,38.590193111235855
STAT,1949,20,35-39,1969,11.217263485650742
SIM,1886,36,50-100,1922,5
STAT,1844,53,20-24,1897,5.626409161659957E-4
SIM,1947,19,na,1966,4660
SIM,1846,90,na,1936,34
SIM,1806,62,na,1868,1084
STAT,1927,39,40-44,1966,1.894530137737049
STAT,1862,40,20-24,1902,0.13930483641336525
SIM,1919,34,25-29,1953,15
SIM,1825,69,na,1894,849
STAT,1844,67,na,1911,1228.4033466628798
SIM,1942,16,25-29,1958,68
STAT,1836,53,25-29,1889,0.002187134474697789
STAT,1901,38,50-100,1939,0.37616482101392623
SIM,1836,29,40-44,1865,5
SIM,1862,37,40-44,1899,5
STAT,1912,44,50-100,1956,0.1146912647210777
STAT,1934,16,25-29,1950,59.92260958873778
SIM,1839,28,50-100,1867,1
STAT,1889,79,na,1968,1307.3926350230856
STAT,1860,34,50-100,1894,0.7518964779897161
SIM,1881,30,25-29,1911,2
STAT,1871,69,na,1940,1482.988737749951
STAT,1897,74,na,1971,1962.792018538531
SIM,1940,19,25-29,1959,79
SIM,1829,59,na,1888,1036
STAT,1897,17,40-44,1914,0.24948646361918583
STAT,1829,103,na,1932,0.09544952137921744
SIM,1876,49,35-39,1925,1
STAT,1852,62,na,1914,1472.4232005564245
SIM,1873,92,na,1965,60
STAT,1860,43,20-24,1903,0.13050223196388983
SIM,1928,12,na,1940,5224
SIM,1955,14,na,1969,5087
STAT,1840,24,35-39,1864,5.2637233371478676
STAT,1932,20,30-34,1952,38.68797236838361
STAT,1945,19,35-39,1964,4.673518914526444
STAT,1859,40,15-19,1899,0.011364602221451242
SIM,1811,49,na,1860,1180
SIM,1937,18,40-44,1955,1
STAT,1838,50,25-29,1888,0.0026932403381396412
STAT,1868,17,15-19,1885,5.887128301580157
STAT,1911,29,35-39,1940,14.828048005344453
SIM,1891,18,na,1909,3256
STAT,1831,31,30-34,1862,16.198083328283147
SIM,1867,22,15-19,1889,2
STAT,1932,19,25-29,1951,58.20581799481201
SIM,1859,16,30-34,1875,2
SIM,1833,64,na,1897,1124
SIM,1838,26,40-44,1864,5
SIM,1879,18,na,1897,3129
STAT,1857,30,50-100,1887,0.7499100560247113
SIM,1841,31,50-100,1872,1
STAT,1859,22,15-19,1881,2.7886465171764443
STAT,1837,51,50-100,1888,0.01030831379203807
STAT,1913,26,35-39,1939,15.31361811521375
SIM,1830,25,50-100,1855,2
STAT,1839,106,na,1945,0.008379524572280073
SIM,1921,26,35-39,1947,26
STAT,1866,82,na,1948,439.0401550409518
STAT,1854,37,40-44,1891,3.350341990144223
STAT,1929,36,40-44,1965,1.9619930202467375
STAT,1930,23,30-34,1953,37.436619493437036
STAT,1932,37,25-29,1969,1.3491424800586376
STAT,1798,81,na,1879,256.8687520051847
SIM,1846,32,25-29,1878,13
STAT,1911,47,35-39,1958,0.12450342790518248
SIM,1869,35,30-34,1904,8
STAT,1839,80,na,1919,426.9210358276654
STAT,1846,24,50-100,1870,0.3546700994622761
STAT,1955,4,na,1959,5324.711023650656
SIM,1874,46,na,1920,2322
STAT,1927,20,20-24,1947,140.58206334107643
STAT,1838,32,25-29,1870,9.351550098114712
STAT,1865,106,na,1971,0.16062474000080942
STAT,1906,30,30-34,1936,15.005785255281983
STAT,1936,26,30-34,1962,38.26345669060963
SIM,1822,34,35-39,1856,1
STAT,1887,44,na,1931,2606.3925515463216
STAT,1855,26,50-100,1881,0.5206190396105916
STAT,1911,9,na,1920,4050.1108250073557
STAT,1929,34,45-49,1963,2.0360186014958512
STAT,1883,49,30-34,1932,0.094870392970169
STAT,1847,16,na,1863,2247.3529050037628
STAT,1932,0,na,1932,6083.720384511482
SIM,1871,24,30-34,1895,23
STAT,1793,101,na,1894,0.11430482180524988
STAT,1827,95,na,1922,8.593163441815001
STAT,1879,33,25-29,1912,10.876160447802182
STAT,1869,1,na,1870,3483.4045872192864
STAT,1894,20,15-19,1914,4.354868921045446
STAT,1809,70,na,1879,879.5697228325132
STAT,1863,24,30-34,1887,16.01723087952632
STAT,1898,16,na,1914,3492.763327036442
SIM,1899,18,25-29,1917,16
STAT,1926,4,na,1930,5048.319112036769
STAT,1904,33,30-34,1937,14.595895663852433
STAT,1772,88,na,1860,23.88230102247629
SIM,1810,46,50-100,1856,2
STAT,1856,52,na,1908,1715.0850802133891
SIM,1859,1,na,1860,3171
STAT,1896,36,35-39,1932,9.57559220846001
STAT,1924,42,15-19,1966,0.0018636376453022873
SIM,1912,33,30-34,1945,5
STAT,1886,35,50-100,1921,1.338322125657331
SIM,1905,41,45-49,1946,1
SIM,1926,15,30-34,1941,22
STAT,1846,27,35-39,1873,8.347486317457268
SIM,1887,33,25-29,1920,19
STAT,1896,30,20-24,1926,3.671250232801732
SIM,1854,27,35-39,1881,16
STAT,1901,13,na,1914,3678.443289871889
SIM,1905,43,na,1948,3361
SIM,1873,21,30-34,1894,22
STAT,1819,100,na,1919,0.625900294277976
SIM,1835,48,35-39,1883,1
SIM,1830,26,40-44,1856,4
STAT,1885,30,45-49,1915,1.7890915462065382
STAT,1902,36,30-34,1938,1.6629004165199288
STAT,1904,15,30-34,1919,2.3411691608144487
SIM,1849,24,20-24,1873,64
STAT,1914,39,30-34,1953,1.8379636380145283
STAT,1916,18,30-34,1934,2.6320861909075157
SIM,1940,20,30-34,1960,51
STAT,1918,15,30-34,1933,2.728830833833502
SIM,1914,26,50-100,1940,4
STAT,1894,39,35-39,1933,9.187805037748221
SIM,1879,20,50-100,1899,5
SIM,1811,44,30-34,1855,4
STAT,1848,57,na,1905,1562.152719391457
STAT,1815,39,50-100,1854,4.671783369800292
SIM,1924,18,30-34,1942,19
STAT,1865,21,30-34,1886,16.813644928539162
STAT,1848,24,35-39,1872,5.44415246094354
SIM,1893,30,45-49,1923,4
SIM,1879,27,40-44,1906,5
SIM,1922,39,30-34,1961,6
STAT,1900,26,25-29,1926,60.0173423237821
STAT,1899,30,45-49,1929,2.4556482131024464
SIM,1937,34,45-49,1971,4
SIM,1934,34,50-100,1968,1
STAT,1922,45,15-19,1967,4.338358527095575E-4
STAT,1940,15,40-44,1955,1.449582122389012
SIM,1910,36,30-34,1946,5
SIM,1912,15,30-34,1927,4
STAT,1844,48,35-39,1892,0.10712444375341451
SIM,1905,36,20-24,1941,1
SIM,1857,46,na,1903,1888
STAT,1950,19,15-19,1969,54.708583477316765
SIM,1858,21,35-39,1879,9
SIM,1816,44,50-100,1860,6
STAT,1872,32,30-34,1904,17.851332780704738
SIM,1859,36,50-100,1895,5
SIM,1936,35,na,1971,3358
SIM,1852,45,30-34,1897,1
STAT,1864,54,45-49,1918,0.012801954025463238
STAT,1840,26,50-100,1866,0.5781042885724363
STAT,1846,48,50-100,1894,0.17342705911578232
SIM,1932,24,15-19,1956,9
STAT,1890,46,40-44,1936,0.12079863819047956
SIM,1916,30,50-100,1946,1
STAT,1877,54,25-29,1931,0.003644693353986308
STAT,1829,45,35-39,1874,0.11625881436720281
STAT,1866,51,45-49,1917,0.01372108646874478
STAT,1912,41,40-44,1953,0.24751031217677516
STAT,1920,34,25-29,1954,10.242911576717852
STAT,1860,97,na,1957,6.005217585968167
STAT,1815,70,na,1885,855.034472855457
SIM,1853,84,na,1937,296
SIM,1884,76,na,1960,967
STAT,1870,35,30-34,1905,5.365466212700142
SIM,1813,41,30-34,1854,1
STAT,1864,22,25-29,1886,52.76150254358542
STAT,1923,44,20-24,1967,0.02099041162829768
STAT,1839,31,30-34,1870,14.98336601233582
STAT,1917,47,30-34,1964,0.09502140278545333
STAT,1786,96,na,1882,1.3304952926145344
STAT,1830,32,25-29,1862,9.795354629341382
SIM,1904,20,20-24,1924,97
STAT,1933,18,30-34,1951,16.596260222353408
SIM,1856,21,30-34,1877,28
STAT,1860,49,35-39,1909,0.11346051008828292
STAT,1919,47,35-39,1966,0.14270465869617963
STAT,1854,19,40-44,1873,0.1654894694136406
STAT,1801,100,na,1901,0.3787930228182969
SIM,1850,36,na,1886,1840
SIM,1889,30,25-29,1919,13
SIM,1828,37,35-39,1865,13
SIM,1916,26,25-29,1942,8
SIM,1826,82,na,1908,230
STAT,1792,96,na,1888,1.43784097874021
STAT,1906,44,20-24,1950,0.016154292186641234
SIM,1849,79,na,1928,703
SIM,1909,33,na,1942,3499
SIM,1935,20,20-24,1955,177
STAT,1821,42,25-29,1863,1.114232074929905
STAT,1887,28,35-39,1915,10.991186616681189
SIM,1886,38,40-44,1924,7
SIM,1950,4,na,1954,4770
STAT,1921,46,50-100,1967,0.2608336662680015
STAT,1940,31,45-49,1971,1.6623974585935068
STAT,1927,37,45-49,1964,0.8645974888798151
SIM,1879,44,50-100,1923,3
STAT,1915,49,50-100,1964,0.2312091477821284
SIM,1770,93,na,1863,3
SIM,1941,18,30-34,1959,19
SIM,1945,24,25-29,1969,132
STAT,1919,29,35-39,1948,16.435775659337693
SIM,1927,29,35-39,1956,26
SIM,1905,23,45-49,1928,2
STAT,1937,24,25-29,1961,91.68853093799227
SIM,1895,28,35-39,1923,21
STAT,1878,38,40-44,1916,4.6252449465356245
SIM,1841,99,na,1940,1
STAT,1803,85,na,1888,104.37832281881639
STAT,1877,54,na,1931,2215.586511359858
STAT,1881,25,35-39,1906,9.581083284148226
STAT,1894,26,na,1920,3142.3862152878623
STAT,1883,54,na,1937,2096.03602528548
STAT,1927,44,50-100,1971,0.14979494990439288
SIM,1870,56,na,1926,2186
STAT,1832,42,na,1874,1708.4255916279596
STAT,1860,107,na,1967,0.0364874527612947
SIM,1856,21,na,1877,2403
STAT,1839,19,45-49,1858,0.05828112551208952
SIM,1785,83,na,1868,90
STAT,1879,49,na,1928,2349.036979887393
SIM,1861,38,35-39,1899,10
STAT,1853,38,35-39,1891,5.90121941030767
STAT,1854,97,na,1951,4.111670437667498
SIM,1815,39,na,1854,1573
SIM,1949,14,na,1963,4776
SIM,1901,30,20-24,1931,4
STAT,1871,33,25-29,1904,10.306725248403257
STAT,1914,25,40-44,1939,4.826662892850861
STAT,1895,38,40-44,1933,5.797604699171448
STAT,1865,69,na,1934,1358.8025737573762
STAT,1890,44,45-49,1934,1.841615970389578
SIM,1926,17,na,1943,4892
SIM,1878,28,35-39,1906,20
SIM,1899,23,50-100,1922,1
SIM,1922,25,40-44,1947,8
STAT,1885,46,30-34,1931,0.09880070678060003
STAT,1914,41,45-49,1955,0.16850137504204893
SIM,1881,28,na,1909,2184
STAT,1895,37,50-100,1932,1.6341390573301824
STAT,1908,26,25-29,1934,64.20679223319848
SIM,1766,88,na,1854,19
STAT,1828,37,na,1865,1529.3473249396104
STAT,1828,47,40-44,1875,0.13389344100009862
SIM,1870,41,50-100,1911,1
SIM,1847,31,30-34,1878,23
STAT,1914,23,45-49,1937,1.1692336941691341
SIM,1872,22,25-29,1894,3
STAT,1932,34,20-24,1966,3.302522597687602
STAT,1824,75,na,1899,566.837582953971
STAT,1923,31,45-49,1954,1.8481010219640075
SIM,1948,1,na,1949,4669
STAT,1900,41,45-49,1941,0.14761638381555756
STAT,1884,49,20-24,1933,0.011858515200120382
SIM,1895,48,na,1943,3043
STAT,1855,32,25-29,1887,8.084608212175388
SIM,1802,72,na,1874,540
STAT,1875,29,50-100,1904,0.6649778127321788
SIM,1931,26,20-24,1957,25
STAT,1767,113,na,1880,3.242860391880953E-4
SIM,1827,64,na,1891,955
STAT,1903,34,25-29,1937,8.455838142899498
SIM,1925,32,50-100,1957,1
STAT,1851,49,na,1900,1817.4025849180964
STAT,1923,26,20-24,1949,21.456444405826325
SIM,1888,38,na,1926,2694
SIM,1911,34,25-29,1945,16
STAT,1872,53,50-100,1925,0.015193569087473269
SIM,1804,67,na,1871,891
STAT,1828,29,40-44,1857,3.3968134864418706
SIM,1862,21,na,1883,2236
STAT,1889,22,30-34,1911,22.446035111434917
SIM,1931,31,45-49,1962,5
SIM,1925,16,25-29,1941,99
STAT,1903,48,na,1951,3222.2433819573002
STAT,1840,77,na,1917,622.0148149928488
SIM,1791,83,na,1874,117
SIM,1897,22,30-34,1919,37
STAT,1880,54,30-34,1934,0.006205827530014944
STAT,1921,16,45-49,1937,0.5824748795765434
STAT,1831,24,50-100,1855,0.5109054330500518
STAT,1888,26,na,1914,2888.0724467109776
STAT,1898,18,50-100,1916,0.06740978739546634
STAT,1848,97,na,1945,4.1760218144620795
STAT,1908,23,na,1931,3566.4341387763
SIM,1902,29,35-39,1931,21
STAT,1811,45,50-100,1856,0.7066472878184534
SIM,1868,46,na,1914,2247
SIM,1886,35,30-34,1921,6
STAT,1928,19,35-39,1947,5.364178946446509
STAT,1945,16,30-34,1961,13.588364824856862
STAT,1948,20,na,1968,4280.861500238346
SIM,1844,23,30-34,1867,3
SIM,1847,44,na,1891,1558
SIM,1915,28,30-34,1943,54
SIM,1878,43,30-34,1921,2
STAT,1778,106,na,1884,0.008495570515144385
STAT,1930,10,na,1940,5240.420044940194
SIM,1856,31,50-100,1887,1
SIM,1919,31,20-24,1950,4
SIM,1863,32,25-29,1895,14
STAT,1904,18,35-39,1922,0.8001469965173589
SIM,1905,39,30-34,1944,5
STAT,1887,46,35-39,1933,0.16049305404906172
SIM,1912,18,35-39,1930,1
STAT,1851,40,45-49,1891,1.247213274697425
STAT,1854,101,na,1955,0.436729400929356
SIM,1821,39,na,1860,1568
SIM,1843,54,na,1897,1550
STAT,1819,53,25-29,1872,0.006615423075625216
STAT,1852,54,25-29,1906,0.002774983354727078
STAT,1930,26,35-39,1956,19.47932203240259
STAT,1906,26,20-24,1932,17.479174284326135
STAT,1836,23,30-34,1859,14.528065022281792
STAT,1862,43,25-29,1905,0.5536208555753521
STAT,1850,104,na,1954,0.05017209305898624
SIM,1896,23,25-29,1919,80
STAT,1871,29,na,1900,2394.404068545358
STAT,1836,50,20-24,1886,4.8354583928999936E-4
STAT,1800,65,na,1865,980.1168379826433
STAT,1907,28,30-34,1935,37.5868661112697
SIM,1923,19,25-29,1942,67
STAT,1766,88,na,1854,60.0
STAT,1933,36,30-34,1969,2.5339780523185094
SIM,1819,44,30-34,1863,2
SIM,1939,29,30-34,1968,48
STAT,1888,23,25-29,1911,68.82603244863901
STAT,1813,75,na,1888,449.29815372308684
STAT,1910,30,20-24,1940,2.4179930657368183
STAT,1931,39,30-34,1970,2.4564508847211606
STAT,1902,32,50-100,1934,1.3181525430449523
STAT,1918,41,na,1959,4035.3844865994142
STAT,1834,53,20-24,1887,4.991929485941621E-4
STAT,1859,29,na,1888,1949.5967154325524
SIM,1870,43,25-29,1913,2
STAT,1910,49,40-44,1959,0.14914969000617045
SIM,1827,35,25-29,1862,4
SIM,1891,58,na,1949,2535
SIM,1886,71,na,1957,1481
STAT,1915,19,25-29,1934,9.205628213333283
SIM,1855,40,25-29,1895,2
STAT,1906,47,50-100,1953,0.20474980118145342
STAT,1886,26,25-29,1912,45.834339583195124
SIM,1888,32,30-34,1920,27
SIM,1932,29,15-19,1961,3
STAT,1825,50,45-49,1875,0.018725661578321603
SIM,1894,26,25-29,1920,11
STAT,1849,21,45-49,1870,0.6592697173318559
SIM,1914,26,20-24,1940,25
STAT,1788,91,na,1879,20.472147885792168
STAT,1924,29,15-19,1953,0.8326183301692277
STAT,1907,46,30-34,1953,0.0820217289425086
STAT,1904,19,50-100,1923,0.07124521825325256
STAT,1894,20,45-49,1914,0.9204977043935963
STAT,1836,32,na,1868,1705.0809351246273
SIM,1903,48,na,1951,3126
STAT,1879,89,na,1968,307.2694389753192
STAT,1911,26,30-34,1937,39.1107685781278
STAT,1875,54,20-24,1929,7.513632090417915E-4
SIM,1913,30,40-44,1943,4
STAT,1854,26,na,1880,1921.1354276142258
STAT,1870,53,30-34,1923,0.005840942614991662
STAT,1904,36,35-39,1940,2.2427734611573604
STAT,1918,18,35-39,1936,4.648571036746236
SIM,1898,22,45-49,1920,1
SIM,1910,39,35-39,1949,3
STAT,1926,31,50-100,1957,1.0204814995237814
SIM,1796,67,na,1863,617
SIM,1792,77,na,1869,324
SIM,1860,26,na,1886,2107
SIM,1822,92,na,1914,20
SIM,1905,2,na,1907,3846
STAT,1861,47,50-100,1908,0.2060678011858132
STAT,1924,27,50-100,1951,1.1823908765367865
STAT,1915,34,15-19,1949,0.1324093553447846
STAT,1838,67,na,1905,1164.742215073731
SIM,1915,33,na,1948,4239
SIM,1921,21,35-39,1942,19
SIM,1907,18,30-34,1925,2
SIM,1885,18,na,1903,2550
STAT,1817,43,50-100,1860,2.5526393272080217
SIM,1868,36,25-29,1904,4
STAT,1902,39,35-39,1941,2.1741719028692037
STAT,1936,29,35-39,1965,14.64027592139361
STAT,1928,37,35-39,1965,3.1179838562238307
SIM,1928,28,40-44,1956,3
SIM,1840,48,45-49,1888,1
STAT,1762,114,na,1876,2.841696948347917E-4
STAT,1881,22,30-34,1903,17.567852349406973
SIM,1819,47,40-44,1866,1
STAT,1832,48,45-49,1880,0.18497085594203566
STAT,1872,70,na,1942,1434.5446709170076
SIM,1867,92,na,1959,28
STAT,1842,48,30-34,1890,0.07495718152314129
STAT,1905,49,30-34,1954,0.07876969588157333
STAT,1861,79,na,1940,589.3235239147323
STAT,1848,21,30-34,1869,16.980939971580497
STAT,1886,44,25-29,1930,0.684049216917093
STAT,1896,33,25-29,1929,13.742170524517494
SIM,1945,21,20-24,1966,143
SIM,1864,44,50-100,1908,1
SIM,1869,31,na,1900,2409
STAT,1829,42,25-29,1871,0.5388568287756594
STAT,1911,44,30-34,1955,0.12293737738266657
SIM,1886,9,na,1895,2922
SIM,1936,19,35-39,1955,7
SIM,1827,95,na,1922,5
STAT,1896,21,na,1917,3196.176884220179
SIM,1907,33,20-24,1940,2
SIM,1875,31,na,1906,2440
STAT,1941,27,25-29,1968,69.46498015906153
SIM,1899,15,20-24,1914,22
STAT,1856,44,50-100,1900,0.834590817414013
SIM,1911,45,50-100,1956,2
STAT,1829,50,na,1879,1572.5062327113417
STAT,1902,20,15-19,1922,4.774444168836345
STAT,1913,21,35-39,1934,9.33614544230765
SIM,1904,26,35-39,1930,20
SIM,1953,16,30-34,1969,25
SIM,1829,32,25-29,1861,12
STAT,1867,21,35-39,1888,5.652432366415497
STAT,1888,41,25-29,1929,0.7779585777886023
STAT,1859,40,45-49,1899,1.2316386792790122
STAT,1908,30,50-100,1938,0.8022140130544186
SIM,1912,36,35-39,1948,3
STAT,1812,50,na,1862,1346.2108553570572
STAT,1827,48,35-39,1875,0.15512374820568517
STAT,1846,45,35-39,1891,0.10111517125902979
SIM,1890,4,na,1894,3454
STAT,1943,21,15-19,1964,5.780100710318355
SIM,1780,83,na,1863,142
STAT,1909,21,15-19,1930,5.060955911226343
STAT,1847,54,45-49,1901,0.011005760136512943
SIM,1898,28,na,1926,3599
SIM,1889,15,35-39,1904,1
STAT,1837,34,30-34,1871,14.295488309637303
STAT,1866,4,na,1870,2828.9383790898473
STAT,1828,31,25-29,1859,10.463795029358838
STAT,1922,31,25-29,1953,10.699193755720016
SIM,1856,24,35-39,1880,5
STAT,1840,21,25-29,1861,52.76514215203545
SIM,1853,25,25-29,1878,38
SIM,1911,31,20-24,1942,8
STAT,1829,42,30-34,1871,0.964727544344729
STAT,1852,45,50-100,1897,0.19982829915147304
SIM,1876,30,45-49,1906,2
STAT,1822,41,30-34,1863,1.8435767826885439
STAT,1830,47,na,1877,1527.5396558486318
SIM,1859,34,30-34,1893,4
SIM,1884,8,na,1892,2843
STAT,1920,19,35-39,1939,4.778557861220859
SIM,1917,21,15-19,1938,4
STAT,1851,32,50-100,1883,0.7867756814864105
STAT,1920,51,na,1971,4091.4924230646643
STAT,1845,25,25-29,1870,40.814274751693695
SIM,1918,23,25-29,1941,123
STAT,1941,24,15-19,1965,5.608442226016155
STAT,1889,8,na,1897,3275.8016300468507
STAT,1916,20,45-49,1936,1.210354990215062
SIM,1880,86,na,1966,217
STAT,1882,69,na,1951,1458.5573637421426
SIM,1816,92,na,1908,10
SIM,1854,26,na,1880,2151
STAT,1819,60,na,1879,1256.144703215489
STAT,1937,21,20-24,1958,110.48657040951888
SIM,1905,20,40-44,1925,2
STAT,1905,30,40-44,1935,6.440837200261864
STAT,1867,64,na,1931,1664.880974315476
SIM,1849,27,25-29,1876,44
SIM,1900,17,30-34,1917,5
SIM,1862,21,25-29,1883,54
SIM,1922,27,na,1949,4189
SIM,1850,33,50-100,1883,4
SIM,1909,30,20-24,1939,5
STAT,1824,47,na,1871,1428.7416822366795
SIM,1866,11,na,1877,2719
SIM,1914,30,30-34,1944,17
STAT,1907,38,na,1945,3539.1918875031865
SIM,1948,20,na,1968,4192
STAT,1877,51,20-24,1928,7.845178907139776E-4
SIM,1837,42,30-34,1879,2
SIM,1928,6,na,1934,5288
STAT,1841,20,50-100,1861,0.38696187610840993
STAT,1921,34,45-49,1955,1.7716352738922587
SIM,1878,43,25-29,1921,4
STAT,1829,59,na,1888,1315.8170039001002
STAT,1877,21,20-24,1898,73.13548033704278
STAT,1765,94,na,1859,1.3639779028590011
SIM,1905,39,25-29,1944,2
SIM,1837,24,30-34,1861,1
STAT,1904,18,40-44,1922,0.26671568094830606
SIM,1813,72,na,1885,659
SIM,1924,20,45-49,1944,2
STAT,1923,29,30-34,1952,45.571313051281535
SIM,1931,29,30-34,1960,71
STAT,1910,21,50-100,1931,0.6321288225966173
STAT,1952,15,30-34,1967,14.908295696758783
STAT,1920,33,50-100,1953,0.9202854824692356
SIM,1920,28,40-44,1948,12
STAT,1819,35,25-29,1854,9.580332088060082
STAT,1811,53,25-29,1864,0.00918721626862611
SIM,1839,89,na,1928,76
SIM,1904,23,25-29,1927,103
STAT,1860,85,na,1945,226.90497593594662
SIM,1897,43,na,1940,3111
STAT,1892,41,45-49,1933,1.9222054368845178
SIM,1845,34,30-34,1879,4
STAT,1912,28,40-44,1940,4.6692124798093335
STAT,1854,21,25-29,1875,51.851254134794324
STAT,1896,33,30-34,1929,23.425137408538237
SIM,1808,57,na,1865,1285
STAT,1925,41,20-24,1966,0.021845620609678873
SIM,1774,83,na,1857,191
SIM,1863,5,na,1868,2526
SIM,1897,74,na,1971,1832
STAT,1867,17,25-29,1884,5.548232235344463
STAT,1845,43,25-29,1888,0.5044344615135962
STAT,1945,19,50-100,1964,0.4172783971995223
STAT,1825,60,na,1885,1221.0993137768291
SIM,1874,86,na,1960,331
STAT,1856,16,40-44,1872,0.17421664857256502
SIM,1931,29,25-29,1960,116
STAT,1861,39,na,1900,1966.0255832190862
STAT,1917,31,15-19,1948,0.1378832191045897
SIM,1933,23,20-24,1956,151
STAT,1914,21,25-29,1935,92.67322079568876
STAT,1850,67,na,1917,1192.4085111898883
STAT,1837,52,30-34,1889,0.003983212709923904
STAT,1878,53,30-34,1931,0.006219294595026687
SIM,1801,87,na,1888,47
SIM,1820,37,35-39,1857,5
SIM,1897,25,35-39,1922,17
STAT,1911,41,20-24,1952,0.017292599400009316
STAT,1825,106,na,1931,0.007280920033123177
STAT,1873,30,25-29,1903,10.678560580171
STAT,1889,25,35-39,1914,12.241526597804816
STAT,1901,37,25-29,1938,0.8865467931827611
SIM,1848,26,na,1874,2059
STAT,1798,100,na,1898,0.36544822293302004
STAT,1868,49,35-39,1917,0.13356326262886326
STAT,1849,29,50-100,1878,0.5802870207462794
SIM,1885,58,na,1943,2019
SIM,1836,31,25-29,1867,16
STAT,1923,29,25-29,1952,76.55225827347212
SIM,1856,52,na,1908,2079
STAT,1925,23,20-24,1948,135.37440188759425
STAT,1890,36,na,1926,2952.841274351278
STAT,1903,31,20-24,1934,3.9358993621518312
STAT,1919,26,30-34,1945,43.3513445588181
SIM,1837,54,na,1891,1315
SIM,1908,20,na,1928,3749
SIM,1903,26,45-49,1929,2
SIM,1875,17,25-29,1892,8
STAT,1878,35,30-34,1913,5.713018808093863
STAT,1880,42,50-100,1922,1.1311533559947573
STAT,1840,21,30-34,1861,16.41816070662063
SIM,1878,25,30-34,1903,42
STAT,1858,29,20-24,1887,9.576707297817823
STAT,1915,37,25-29,1952,1.0149908182251168
SIM,1923,28,50-100,1951,1
SIM,1905,48,50-100,1953,1
SIM,1872,11,na,1883,2756
STAT,1895,22,25-29,1917,76.19453569296337
SIM,1927,26,30-34,1953,58
STAT,1771,94,na,1865,3.640727567162395
SIM,1880,17,35-39,1897,1
STAT,1868,49,na,1917,2146.4005272082386
STAT,1881,22,25-29,1903,56.4600531744477
STAT,1919,44,30-34,1963,0.14090966630860616
STAT,1872,17,35-39,1889,0.5628618915069906
STAT,1865,97,na,1962,13.05891230620591
STAT,1873,49,45-49,1922,0.238986636737009
STAT,1936,35,na,1971,3773.6143109097156
STAT,1831,53,50-100,1884,0.010652331036038824
SIM,1922,21,25-29,1943,107
STAT,1873,64,na,1937,1797.896463117917
SIM,1881,49,45-49,1930,1
STAT,1868,5,na,1873,2741.1610956861214
SIM,1916,27,na,1943,3882
STAT,1842,32,na,1874,2053.1220057311516
SIM,1866,29,20-24,1895,15
SIM,1845,89,na,1934,64
STAT,1946,18,40-44,1964,1.5823121477514293
SIM,1923,37,25-29,1960,1
SIM,1930,31,25-29,1961,15
STAT,1807,75,na,1882,508.39340247443437
STAT,1931,20,40-44,1951,4.474040331882534
STAT,1794,91,na,1885,19.79558314954742
SIM,1839,80,na,1919,394
SIM,1936,32,35-39,1968,22
STAT,1860,46,25-29,1906,0.047811702716510356
STAT,1923,47,25-29,1970,0.06331391340969192
STAT,1908,1,na,1909,4117.228806661453
STAT,1793,81,na,1874,224.2490416221403
SIM,1949,20,45-49,1969,2
SIM,1877,32,25-29,1909,13
SIM,1886,38,35-39,1924,12
SIM,1838,41,30-34,1879,2
STAT,1816,54,50-100,1870,0.028548233040495363
STAT,1905,35,40-44,1940,1.4053037958325383
STAT,1868,30,45-49,1898,1.712781203912555
STAT,1928,16,30-34,1944,15.704149904381804
STAT,1907,42,45-49,1949,0.15548337730031891
STAT,1870,44,na,1914,2273.801198108548
SIM,1786,77,na,1863,284
STAT,1868,19,35-39,1887,0.5379311983308906
STAT,1884,44,20-24,1928,0.15812365515191676
SIM,1870,28,na,1898,2620
SIM,1904,23,30-34,1927,32
STAT,1808,85,na,1893,91.26199745423747
STAT,1909,28,35-39,1937,14.58191703536334
STAT,1851,38,30-34,1889,4.39817364419954
STAT,1878,38,35-39,1916,7.473209198326935
STAT,1910,27,25-29,1937,64.82513300747245
SIM,1906,65,na,1971,2723
SIM,1900,35,30-34,1935,3
STAT,1904,16,45-49,1920,0.09574036627450166
SIM,1926,5,na,1931,5335
STAT,1930,24,45-49,1954,1.4609214966469308
SIM,1854,66,na,1920,1419
STAT,1832,45,40-44,1877,0.13944737005503052
STAT,1872,9,na,1881,2746.331040306671
STAT,1912,25,na,1937,3791.5217973470667
SIM,1917,28,35-39,1945,23
STAT,1941,13,na,1954,4133.282148156932
STAT,1857,62,na,1919,1456.1879273120635
STAT,1937,28,40-44,1965,4.632304296844532
SIM,1883,54,na,1937,2231
SIM,1943,18,35-39,1961,5
SIM,1810,49,40-44,1859,1
SIM,1936,16,30-34,1952,12
STAT,1853,23,30-34,1876,17.52030632922569
SIM,1843,26,na,1869,2079
SIM,1848,15,40-44,1863,1
SIM,1861,23,30-34,1884,22
STAT,1875,90,na,1965,207.9712526595302
STAT,1911,31,50-100,1942,0.8245884223819829
SIM,1836,43,25-29,1879,5
STAT,1806,53,45-49,1859,0.04618731669139661
STAT,1941,24,20-24,1965,117.15335728509643
STAT,1841,20,30-34,1861,16.902492915293088
STAT,1852,51,20-24,1903,5.973133750294271E-4
SIM,1913,33,45-49,1946,5
STAT,1920,20,na,1940,4167.712292963424
STAT,1935,18,35-39,1953,5.834645420116321
STAT,1853,111,na,1964,3.987696840411602E-4
SIM,1882,10,na,1892,2532
STAT,1873,44,45-49,1917,1.5270057427934818
STAT,1884,64,na,1948,1754.4949222104487
STAT,1910,21,na,1931,3666.1367163403975
STAT,1924,46,30-34,1970,0.10854788132358145
SIM,1868,24,25-29,1892,76
STAT,1840,37,na,1877,1822.9085279397896
SIM,1852,62,na,1914,1505
STAT,1924,10,na,1934,4828.533388224929
STAT,1827,33,30-34,1860,25.6571079247286
STAT,1872,47,35-39,1919,0.14247282471843872
STAT,1909,21,45-49,1930,1.0697447805622335
STAT,1909,28,50-100,1937,0.9667333936969985
SIM,1948,19,30-34,1967,20
STAT,1931,25,40-44,1956,6.142453282241272
SIM,1866,51,na,1917,2242
SIM,1909,33,25-29,1942,8
SIM,1877,44,25-29,1921,2
STAT,1838,95,na,1933,9.768925425259454
SIM,1782,78,na,1860,286
SIM,1881,44,45-49,1925,5
SIM,1893,17,15-19,1910,10
SIM,1900,29,30-34,1929,46
STAT,1859,26,30-34,1885,21.021129870868254
SIM,1802,54,30-34,1856,1
STAT,1934,31,15-19,1965,0.17903022171434463
SIM,1946,9,na,1955,4332
STAT,1825,69,na,1894,880.0312108109348
STAT,1906,23,50-100,1929,0.6036348395476764
SIM,1835,33,30-34,1868,21
STAT,1845,77,na,1922,675.3901614481944
STAT,1940,30,30-34,1970,16.65362586190513
STAT,1836,38,35-39,1874,5.348306818580539
SIM,1876,19,35-39,1895,1
SIM,1823,39,50-100,1862,2
STAT,1773,104,na,1877,0.032431439046717705
SIM,1837,85,na,1922,222
STAT,1861,45,30-34,1906,0.08241283607675304
STAT,1871,21,25-29,1892,58.02274900809287
SIM,1903,17,na,1920,3590
STAT,1919,45,45-49,1964,0.24169148989164368
STAT,1848,29,na,1877,1978.766751151813
SIM,1900,40,na,1940,3343
SIM,1870,25,na,1895,2630
SIM,1844,38,35-39,1882,10
STAT,1938,30,na,1968,3883.663951650283
STAT,1860,46,30-34,1906,0.08035022339520599
STAT,1885,17,15-19,1902,6.040059933103792
SIM,1845,37,35-39,1882,2
STAT,1861,70,na,1931,1182.7469946627746
STAT,1781,96,na,1877,1.4573302479104966
SIM,1937,20,na,1957,4245
STAT,1830,36,40-44,1866,4.01063489045361
STAT,1869,44,25-29,1913,0.6239287750948869
STAT,1871,15,25-29,1886,5.83184852510593
STAT,1902,32,15-19,1934,0.20487415937735204
SIM,1880,47,35-39,1927,1
STAT,1817,53,20-24,1870,0.0015493125153205874
STAT,1844,36,na,1880,1947.4319882283366
STAT,1915,39,15-19,1954,0.019596685487615537
STAT,1835,109,na,1944,5.300843976687262E-4
SIM,1880,35,35-39,1915,8
STAT,1923,33,35-39,1956,10.682345400905639
SIM,1928,21,20-24,1949,5
SIM,1885,20,45-49,1905,1
SIM,1879,42,30-34,1921,6
SIM,1904,61,na,1965,2970
SIM,1877,26,25-29,1903,51
SIM,1883,51,na,1934,2286
STAT,1933,32,15-19,1965,0.1766088141421197
STAT,1811,49,na,1860,1271.4368592463657
STAT,1820,85,na,1905,150.98077572838548
STAT,1869,32,25-29,1901,10.088027366147214
STAT,1934,31,na,1965,5269.087297906556
STAT,1870,31,15-19,1901,0.14259823581677014
STAT,1888,20,20-24,1908,83.60574055464082
SIM,1824,59,na,1883,1116
SIM,1896,20,20-24,1916,136
SIM,1813,44,35-39,1857,2
SIM,1825,97,na,1922,6
STAT,1924,28,30-34,1952,46.38173217291358
SIM,1932,28,30-34,1960,65
SIM,1844,67,na,1911,1223
SIM,1931,33,35-39,1964,1
STAT,1825,48,30-34,1873,0.12280667793588348
STAT,1894,24,30-34,1918,23.22727947896788
SIM,1834,20,35-39,1854,6
SIM,1882,13,na,1895,2519
STAT,1926,34,50-100,1960,1.0185743863060777
SIM,1875,21,35-39,1896,6
STAT,1857,65,na,1922,1346.4250615446012
SIM,1898,24,40-44,1922,7
SIM,1910,20,15-19,1930,4
STAT,1850,38,50-100,1888,0.9284474256261445
STAT,1892,39,30-34,1931,6.745613182684363
SIM,1876,72,na,1948,1374
STAT,1912,43,30-34,1955,0.12502988476869756
STAT,1881,52,50-100,1933,0.014816204163254033
SIM,1915,24,15-19,1939,7
SIM,1944,27,45-49,1971,3
STAT,1777,88,na,1865,52.89907394273214
STAT,1873,46,40-44,1919,0.17756624463427134
STAT,1822,44,35-39,1866,2.6571431625072877
STAT,1781,93,na,1874,6.352147410855737
STAT,1896,9,na,1905,3495.8878440060107
SIM,1875,28,na,1903,2365
SIM,1919,38,40-44,1957,2
SIM,1858,87,na,1945,117
STAT,1878,39,na,1917,2476.5421053787577
STAT,1858,113,na,1971,1.1643416431173981E-4
SIM,1927,27,45-49,1954,3
STAT,1811,50,20-24,1861,0.002033006154014382
STAT,1877,36,30-34,1913,5.666292989708433
SIM,1810,67,na,1877,1079
STAT,1916,36,25-29,1952,1.0338981527663371
STAT,1819,50,50-100,1869,0.029943851869563033
SIM,1913,47,na,1960,3760
STAT,1837,37,35-39,1874,5.741560105374151
SIM,1929,37,20-24,1966,4
SIM,1862,92,na,1954,42
STAT,1832,70,na,1902,937.573398314988
STAT,1925,38,25-29,1963,1.2044554262149278
STAT,1856,31,30-34,1887,14.300713007233902
STAT,1872,35,35-39,1907,7.300243680670477
STAT,1833,52,na,1885,1457.0489498800289
STAT,1834,37,na,1871,1790.282041686443
SIM,1889,6,na,1895,3402
STAT,1931,23,45-49,1954,1.483704876643423
SIM,1885,36,30-34,1921,6
SIM,1880,29,35-39,1909,13
SIM,1881,46,40-44,1927,1
SIM,1931,32,na,1963,4912
STAT,1936,27,45-49,1963,1.6863270066294627
STAT,1819,69,na,1888,898.0477915584631
SIM,1839,21,30-34,1860,22
SIM,1848,33,40-44,1881,7
STAT,1872,29,35-39,1901,9.794841040903933
SIM,1803,82,na,1885,90
SIM,1885,24,30-34,1909,40
STAT,1846,22,na,1868,1886.6015673677678
STAT,1886,48,40-44,1934,0.18254101107281473
SIM,1949,6,na,1955,4780
STAT,1919,27,45-49,1946,1.904880822748472
SIM,1925,32,na,1957,4725
STAT,1820,44,30-34,1864,2.1568686747941452
STAT,1831,46,35-39,1877,0.11598234340568696
STAT,1856,24,na,1880,1960.1300735679474
STAT,1905,1,na,1906,4010.247178922147
STAT,1911,34,50-100,1945,0.8142012839795214
SIM,1847,84,na,1931,161
SIM,1830,44,35-39,1874,3
STAT,1853,53,25-29,1906,0.0029222870492823174
STAT,1804,50,50-100,1854,0.046146657683606304
SIM,1912,31,40-44,1943,7
SIM,1851,46,50-100,1897,1
STAT,1907,24,15-19,1931,4.91063001559554
SIM,1967,3,na,1970,5235
STAT,1805,49,na,1854,1464.5227744245058
SIM,1871,66,na,1937,1519
SIM,1883,0,na,1883,3577
STAT,1880,23,25-29,1903,61.179360678302004
STAT,1889,40,25-29,1929,0.817375317000104
STAT,1897,20,50-100,1917,0.5595598889047771
STAT,1928,31,na,1959,4826.516028508709
STAT,1907,42,15-19,1949,0.0014346794760459558
SIM,1898,29,50-100,1927,4
STAT,1905,33,45-49,1938,1.4690383648494802
SIM,1850,67,na,1917,1137
STAT,1877,24,30-34,1901,18.72894172973725
SIM,1864,31,30-34,1895,18
STAT,1846,9,na,1855,2188.6387799999998
SIM,1849,11,na,1860,2314
STAT,1888,57,na,1945,2423.6555833537677
STAT,1916,48,25-29,1964,0.05536759262578822
STAT,1858,54,20-24,1912,5.805658195283244E-4
SIM,1904,21,35-39,1925,8
STAT,1888,0,na,1888,3612.165031360542
SIM,1918,53,na,1971,4064
SIM,1927,27,na,1954,4466
SIM,1827,39,40-44,1866,7
SIM,1894,38,na,1932,3107
SIM,1924,36,25-29,1960,4
STAT,1922,17,40-44,1939,1.6517073375183307
STAT,1911,44,25-29,1955,0.06866772458478539
STAT,1842,49,15-19,1891,3.071321463876536E-4
STAT,1845,47,40-44,1892,0.1331429698319801
SIM,1885,86,na,1971,463
STAT,1872,79,na,1951,714.7859385759461
STAT,1890,3,na,1893,3297.5115975890694
SIM,1857,23,40-44,1880,1
SIM,1923,8,na,1931,4598
STAT,1942,26,25-29,1968,70.51214494616336
SIM,1930,17,40-44,1947,4
STAT,1882,52,45-49,1934,0.0143467680458654
STAT,1936,29,40-44,1965,4.545155693194891
STAT,1905,17,40-44,1922,0.2694792263099985
SIM,1830,26,35-39,1856,12
STAT,1819,39,40-44,1858,10.434035197750378
STAT,1821,70,na,1891,739.3348699844764
STAT,1910,42,20-24,1952,0.017022880505339063
STAT,1831,34,35-39,1865,9.036929796248824
SIM,1883,29,50-100,1912,1
STAT,1939,15,na,1954,3767.7812303462956
STAT,1887,16,na,1903,2894.1954709702586
SIM,1861,11,na,1872,2998
SIM,1900,31,45-49,1931,3
SIM,1821,79,na,1900,327
SIM,1864,87,na,1951,319
STAT,1952,18,35-39,1970,5.128002719969099
SIM,1923,34,20-24,1957,5
STAT,1843,46,25-29,1889,0.04687891322377224
STAT,1904,31,40-44,1935,6.36647656604406
SIM,1923,16,20-24,1939,159
SIM,1849,70,na,1919,1224
STAT,1823,34,na,1857,1589.4042403667142
STAT,1950,18,30-34,1968,14.698478954376213
STAT,1901,22,20-24,1923,98.30912848211582
SIM,1913,35,40-44,1948,3
SIM,1849,31,35-39,1880,16
STAT,1945,17,45-49,1962,0.5567441524928548
SIM,1838,29,45-49,1867,1
STAT,1866,23,40-44,1889,1.9626186248349105
STAT,1868,34,30-34,1902,16.866527092663258
STAT,1915,34,20-24,1949,2.5132793480886857
STAT,1941,29,15-19,1970,0.7443070167376642
SIM,1855,11,na,1866,2217
SIM,1818,56,na,1874,1159
STAT,1832,43,45-49,1875,1.2138887818840207
STAT,1865,43,50-100,1908,0.9711056973242004
SIM,1840,43,45-49,1883,3
SIM,1878,76,na,1954,1060
STAT,1799,66,na,1865,763.2635574744926
STAT,1910,58,na,1968,3316.3189329174747
SIM,1798,62,na,1860,896
STAT,1901,40,20-24,1941,0.015891496088965312
STAT,1881,90,na,1971,259.0018923220574
STAT,1893,3,na,1896,3421.259412247595
SIM,1889,79,na,1968,1386
STAT,1897,32,30-34,1929,23.81569335043086
STAT,1917,16,25-29,1933,9.53984571464652
SIM,1876,10,na,1886,3079
SIM,1819,47,35-39,1866,1
STAT,1890,64,na,1954,2168.3185248064174
STAT,1915,16,20-24,1931,29.02648298644789
SIM,1876,34,30-34,1910,22
STAT,1862,28,35-39,1890,8.349635235559678
STAT,1893,16,na,1909,3276.5317451160836
STAT,1926,45,na,1971,4646.160264288098
SIM,1953,17,45-49,1970,1
STAT,1812,52,25-29,1864,0.007995483567057085
SIM,1903,24,25-29,1927,108
STAT,1831,28,35-39,1859,9.28296904317854
SIM,1874,23,40-44,1897,2
STAT,1931,41,45-49,1972,0.22707968759177957
SIM,1870,28,35-39,1898,16
SIM,1893,53,na,1946,2796
STAT,1868,16,30-34,1884,1.5905010251232734
SIM,1921,23,30-34,1944,56
STAT,1922,35,40-44,1957,1.7410689873113616
STAT,1917,43,15-19,1960,0.001632876057400544
STAT,1910,24,20-24,1934,105.83517945628395
SIM,1843,85,na,1928,137
STAT,1930,21,40-44,1951,4.406442998826521
SIM,1869,38,35-39,1907,8
STAT,1863,65,na,1928,1511.58988240491
SIM,1859,18,20-24,1877,27
STAT,1870,84,na,1954,331.75259249588174
SIM,1872,51,na,1923,2262
STAT,1853,26,35-39,1879,9.440396859665707
STAT,1837,25,50-100,1862,0.5553693645443158
STAT,1892,31,na,1923,3063.51486514367
SIM,1803,57,na,1860,903
SIM,1894,32,25-29,1926,15
STAT,1866,79,na,1945,657.8371963692919
STAT,1823,37,na,1860,1592.8856726761526
SIM,1849,29,20-24,1878,1
STAT,1887,13,na,1900,2947.5765684640915
SIM,1870,25,30-34,1895,35
STAT,1839,77,na,1916,596.5557766848781
STAT,1880,27,40-44,1907,3.211333208061745
SIM,1844,17,30-34,1861,2
SIM,1853,29,40-44,1882,4
STAT,1826,70,na,1896,818.3299565779263
SIM,1827,41,25-29,1868,5
STAT,1845,29,40-44,1874,2.8081337291153177
STAT,1787,110,na,1897,1.2569593825990228E-4
STAT,1833,29,15-19,1862,0.3921376065712895
SIM,1918,39,40-44,1957,2
STAT,1830,39,45-49,1869,1.7500556589005811
SIM,1861,26,35-39,1887,15
SIM,1864,25,na,1889,2222
SIM,1823,43,45-49,1866,3
SIM,1911,43,na,1954,3628
STAT,1849,23,40-44,1872,1.9419092781260778
SIM,1845,25,50-100,1870,3
STAT,1815,49,20-24,1864,0.0312250010999456
STAT,1887,21,15-19,1908,3.7826101709677014
STAT,1847,41,30-34,1888,0.9131507842431716
STAT,1851,35,50-100,1886,1.0452393059817262
STAT,1864,40,25-29,1904,0.5883668139464087
STAT,1819,41,25-29,1860,1.4272068995543172
STAT,1820,40,15-19,1860,0.029023747801555942
SIM,1863,47,35-39,1910,1
STAT,1890,6,na,1896,3258.48955117925
SIM,1830,59,na,1889,1302
STAT,1838,36,na,1874,1918.7259607181559
STAT,1834,77,na,1911,580.8866845921291
STAT,1879,30,20-24,1909,2.905589514025094
STAT,1875,50,na,1925,2286.7860404850953
SIM,1940,16,20-24,1956,1
STAT,1854,15,25-29,1869,5.249815342075202
SIM,1878,79,na,1957,807
SIM,1917,25,30-34,1942,64
STAT,1866,26,45-49,1892,1.0483474807654616
SIM,1885,20,15-19,1905,3
SIM,1899,38,na,1937,3257
SIM,1835,59,na,1894,1316
SIM,1919,32,35-39,1951,14
STAT,1884,47,25-29,1931,0.05786365117578654
SIM,1866,31,35-39,1897,14
SIM,1922,41,45-49,1963,1
SIM,1887,30,20-24,1917,2
STAT,1924,42,45-49,1966,0.20197171562962524
STAT,1901,25,25-29,1926,60.75573523836633
STAT,1932,16,20-24,1948,183.53013467257264
STAT,1812,90,na,1902,35.95967221582478
SIM,1862,15,25-29,1877,15
SIM,1821,36,40-44,1857,8
SIM,1943,20,na,1963,3556
STAT,1909,25,30-34,1934,38.77598285313554
STAT,1886,32,25-29,1918,11.060088099000945
SIM,1911,40,na,1951,3692
STAT,1855,47,35-39,1902,0.10802179707670313
STAT,1817,96,na,1913,4.190568218012009
STAT,1841,39,20-24,1880,0.6567977745005759
SIM,1864,44,45-49,1908,5
SIM,1885,18,30-34,1903,6
SIM,1840,74,na,1914,717
SIM,1854,24,30-34,1878,35
SIM,1930,10,na,1940,5758
STAT,1923,30,30-34,1953,18.576611419876965
STAT,1861,41,15-19,1902,0.011693921658273817
STAT,1900,23,20-24,1923,97.13771689824206
STAT,1855,39,na,1894,1807.9680494189859
STAT,1827,36,35-39,1863,9.430729255681594
STAT,1868,30,15-19,1898,0.13987273941598058
SIM,1854,20,15-19,1874,3
STAT,1850,36,na,1886,1819.0314153939007
STAT,1905,4,na,1909,3875.909481542099
STAT,1905,43,na,1948,3392.3290049821467
SIM,1890,21,30-34,1911,30
STAT,1935,15,30-34,1950,17.071728046619302
STAT,1858,31,35-39,1889,8.278389842114198
STAT,1855,23,50-100,1878,0.36665315071638394
STAT,1916,38,50-100,1954,0.43658519592448636
SIM,1868,21,20-24,1889,72
STAT,1929,31,40-44,1960,5.072860950563359
SIM,1816,52,na,1868,1408
SIM,1937,31,40-44,1968,10
STAT,1856,19,45-49,1875,0.0611272482131123
STAT,1836,35,30-34,1871,4.157565170483306
SIM,1880,32,30-34,1912,29
STAT,1894,27,35-39,1921,12.661499612612884
STAT,1913,23,30-34,1936,29.516630074682457
SIM,1909,15,25-29,1924,16
STAT,1879,49,50-100,1928,0.25642858280025604
SIM,1900,4,na,1904,3783
SIM,1918,20,20-24,1938,127
STAT,1869,48,40-44,1917,0.16649765342403347
STAT,1878,64,na,1942,1845.8954012325114
STAT,1899,28,50-100,1927,0.8904853025598906
STAT,1859,29,35-39,1888,7.88239514569539
STAT,1863,62,na,1925,1634.8172658639842
SIM,1858,84,na,1942,277
STAT,1846,62,na,1908,1307.0503184394975
STAT,1919,42,40-44,1961,0.27660395313420144
STAT,1945,22,30-34,1967,32.13829736707575
STAT,1883,51,45-49,1934,0.014595928281813561
SIM,1876,16,30-34,1892,1
STAT,1846,20,15-19,1866,2.9531872123326974
STAT,1911,42,35-39,1953,0.19604342007493614
SIM,1854,39,35-39,1893,11
STAT,1856,44,45-49,1900,1.1823369947246571
STAT,1921,18,40-44,1939,1.622671712954536
STAT,1882,32,na,1914,2371.69925571239
STAT,1840,101,na,1941,0.41061956596533955
STAT,1859,27,15-19,1886,0.37601856922634513
STAT,1824,78,na,1902,430.21375144823645
STAT,1917,31,na,1948,4058.078638464026
STAT,1846,24,30-34,1870,15.491988264363105
SIM,1893,13,na,1906,3398
SIM,1898,20,25-29,1918,102
SIM,1928,24,25-29,1952,130
STAT,1835,44,50-100,1879,0.9196655331218865
STAT,1853,50,20-24,1903,6.276360536069699E-4
STAT,1871,19,40-44,1890,0.18383685048606002
STAT,1931,20,na,1951,4859.176946398462
STAT,1870,47,30-34,1917,0.09608497795346038
SIM,1844,35,30-34,1879,7
SIM,1835,36,35-39,1871,17
STAT,1924,24,15-19,1948,6.368371599929073
STAT,1830,78,na,1908,494.26493161429903
STAT,1905,31,25-29,1936,8.700598333862303
SIM,1839,58,na,1897,1486
STAT,1879,51,25-29,1930,0.0037951148739476083
STAT,1895,16,25-29,1911,7.561002046990513
STAT,1901,43,25-29,1944,0.06315547893139224
STAT,1851,77,na,1928,713.1385444571624
STAT,1940,29,30-34,1969,40.721085124503034
SIM,1927,32,30-34,1959,21
SIM,1918,13,na,1931,4554
STAT,1811,103,na,1914,0.06216473835532392
SIM,1776,78,na,1854,245
SIM,1834,74,na,1908,833
SIM,1818,59,na,1877,1125
SIM,1839,18,na,1857,2224
STAT,1916,33,20-24,1949,2.558991265326123
STAT,1916,46,na,1962,3854.8711453589776
STAT,1845,31,25-29,1876,9.614957224975251
STAT,1856,20,50-100,1876,0.38477440392256324
STAT,1854,33,25-29,1887,7.94491160855163
SIM,1907,20,45-49,1927,2
STAT,1911,43,na,1954,3594.053976117758
SIM,1797,77,na,1874,248
SIM,1924,33,20-24,1957,2
STAT,1807,49,25-29,1856,0.24208536587701987
STAT,1882,21,30-34,1903,17.756662992919527
SIM,1836,44,na,1880,1809
SIM,1935,23,25-29,1958,3
STAT,1893,40,15-19,1933,0.018052276494336866
STAT,1887,25,30-34,1912,28.9815658745777
STAT,1903,19,35-39,1922,0.7914513297171987
STAT,1898,15,35-39,1913,0.7604900351297004
SIM,1931,30,30-34,1961,27
STAT,1841,39,50-100,1880,1.046091819049599
STAT,1877,39,35-39,1916,7.4084382259225805
STAT,1881,28,na,1909,2345.488658948311
STAT,1906,47,25-29,1953,0.04801949700672884
STAT,1829,46,40-44,1875,0.14034765415729794
SIM,1936,34,30-34,1970,20
SIM,1836,25,25-29,1861,3
STAT,1846,42,30-34,1888,0.8321058263276787
SIM,1862,33,25-29,1895,7
STAT,1887,75,na,1962,1408.1696794738061
STAT,1937,22,35-39,1959,9.352867355161788
STAT,1925,35,20-24,1960,0.32335463388817104
SIM,1887,13,na,1900,3048
SIM,1913,31,25-29,1944,16
STAT,1900,28,50-100,1928,0.9013090712450504
STAT,1910,45,25-29,1955,0.05071464424406921
SIM,1922,0,na,1922,4965
SIM,1841,39,25-29,1880,7
STAT,1925,37,50-100,1962,0.5141212641672893
SIM,1885,39,35-39,1924,14
SIM,1854,42,30-34,1896,3
SIM,1839,24,35-39,1863,9
STAT,1890,49,45-49,1939,0.16258304230635046
SIM,1867,36,na,1903,2166
SIM,1875,19,20-24,1894,1
STAT,1867,19,20-24,1886,17.153939569625393
SIM,1848,36,45-49,1884,6
STAT,1863,27,35-39,1890,8.630500666351928
STAT,1833,39,25-29,1872,2.333880604674622
STAT,1873,24,na,1897,2430.7378323501457
SIM,1876,13,na,1889,3023
STAT,1868,37,35-39,1905,6.891623749044059
SIM,1806,93,na,1899,15
STAT,1828,43,25-29,1871,0.5166279904656621
SIM,1902,17,35-39,1919,1
SIM,1931,35,na,1966,4933
STAT,1860,48,20-24,1908,0.009807768343967668
STAT,1928,5,na,1933,5167.703719055241
STAT,1787,81,na,1868,240.92613167744935
SIM,1903,28,40-44,1931,8
STAT,1931,21,25-29,1952,122.54902723965083
STAT,1834,110,na,1944,1.8570404159233553E-4
SIM,1859,28,30-34,1887,1
STAT,1928,34,30-34,1962,20.06855675005201
STAT,1898,56,na,1954,2813.782048802837
SIM,1892,68,na,1960,2356
SIM,1823,34,na,1857,1677
SIM,1876,37,35-39,1913,9
SIM,1914,29,25-29,1943,82
SIM,1945,22,35-39,1967,16
STAT,1839,16,40-44,1855,0.16610501304351594
SIM,1906,38,30-34,1944,2
STAT,1922,46,na,1968,4317.121360637763
SIM,1874,49,30-34,1923,1
SIM,1895,25,30-34,1920,62
STAT,1866,49,30-34,1915,0.08918410944026266
STAT,1914,20,40-44,1934,3.3833294059082895
SIM,1911,19,35-39,1930,2
STAT,1862,25,30-34,1887,22.2671869928938
STAT,1867,50,50-100,1917,0.014672241348525804
STAT,1927,23,25-29,1950,115.73015906588329
STAT,1895,34,25-29,1929,13.516298015209154
STAT,1842,50,45-49,1892,0.0115442474083493
STAT,1826,45,50-100,1871,0.19706188189456322
STAT,1935,33,50-100,1968,1.1657894741583548
SIM,1866,5,na,1871,2862
STAT,1951,12,na,1963,4771.916178746083
STAT,1920,31,20-24,1951,2.737625019840848
STAT,1933,8,na,1941,5444.882451425973
STAT,1829,81,na,1910,359.65373495035385
STAT,1843,43,20-24,1886,0.13032164399997428
SIM,1828,34,30-34,1862,20
STAT,1869,50,na,1919,2151.147977720033
SIM,1852,16,15-19,1868,8
STAT,1890,30,25-29,1920,12.878673048890546
STAT,1858,87,na,1945,142.53160531324258
STAT,1835,22,na,1857,2117.4290978083036
SIM,1859,49,35-39,1908,1
STAT,1919,32,30-34,1951,17.345930379517288
STAT,1863,39,40-44,1902,3.8760575180064225
STAT,1844,16,15-19,1860,5.880436901892112
STAT,1867,24,na,1891,2250.9022369455442
STAT,1891,46,na,1937,2850.141751256448
STAT,1857,54,50-100,1911,0.011701756017959556
STAT,1942,23,20-24,1965,118.90751466746066
STAT,1890,28,50-100,1918,0.7951032456445121
SIM,1770,90,na,1860,9
STAT,1941,30,45-49,1971,1.6874225353383054
STAT,1900,28,15-19,1928,0.6392544636723703
STAT,1904,34,45-49,1938,1.451436621615849
SIM,1944,25,25-29,1969,70
STAT,1814,85,na,1899,127.74313584721105
STAT,1875,28,na,1903,2489.9197824344415
SIM,1863,36,40-44,1899,10
SIM,1912,34,45-49,1946,3
SIM,1860,66,na,1926,1696
STAT,1908,41,15-19,1949,0.0014571682339078443
STAT,1936,25,25-29,1961,64.30327731232268
STAT,1855,36,40-44,1891,3.4097654180843744
STAT,1864,104,na,1968,0.4917712229402061
STAT,1856,21,na,1877,2002.9649060909856
STAT,1887,43,30-34,1930,1.3047304802149182
SIM,1871,39,40-44,1910,3
SIM,1853,31,25-29,1884,5
STAT,1906,29,25-29,1935,62.362162104426965
STAT,1870,13,na,1883,2629.08794422211
SIM,1848,18,15-19,1866,3
STAT,1904,21,30-34,1925,26.12135579359709
SIM,1867,61,na,1928,1631
SIM,1867,44,30-34,1911,3
STAT,1841,49,30-34,1890,0.06998024611232577
STAT,1870,26,35-39,1896,9.655538348624054
STAT,1927,21,na,1948,4603.395517761958
STAT,1873,42,25-29,1915,0.6633329658333302
STAT,1925,20,na,1945,4486.285157350089
SIM,1868,35,50-100,1903,1
STAT,1872,14,na,1886,2666.622202032492
SIM,1843,57,na,1900,1489
SIM,1910,24,30-34,1934,39
SIM,1926,27,30-34,1953,72
STAT,1767,110,na,1877,0.0013176848068015938
SIM,1879,41,50-100,1920,4
STAT,1894,32,15-19,1926,0.186869942939388
STAT,1919,16,50-100,1935,0.08497410442395968
STAT,1890,19,45-49,1909,0.08104221213753472
STAT,1901,16,na,1917,3611.826075587104
SIM,1844,41,25-29,1885,1
STAT,1845,12,na,1857,2357.5265954273764
STAT,1928,17,45-49,1945,0.6420357193493399
SIM,1851,52,na,1903,1728
SIM,1894,63,na,1957,2453
STAT,1849,41,35-39,1890,1.4122054745213983
STAT,1900,38,25-29,1938,0.8743398965246881
STAT,1769,93,na,1862,3.1859951063812595
SIM,1875,31,45-49,1906,3
STAT,1801,81,na,1882,203.6840066532891
STAT,1902,24,30-34,1926,25.46514053049107
STAT,1859,44,30-34,1903,0.924008869678691
SIM,1831,28,45-49,1859,1
SIM,1850,33,na,1883,1872
STAT,1855,47,50-100,1902,0.1895010948677246
STAT,1889,42,na,1931,2908.9083036362995
SIM,1888,69,na,1957,1705
STAT,1918,27,30-34,1945,42.55281643526382
SIM,1878,15,20-24,1893,33
STAT,1860,29,na,1889,1967.9574884935244
STAT,1812,59,na,1871,1126.5427423983929
STAT,1919,17,35-39,1936,4.732005555576174
SIM,1858,25,na,1883,2009
SIM,1870,59,na,1929,2059
SIM,1850,22,40-44,1872,3
STAT,1871,52,30-34,1923,0.005983175891069971
STAT,1958,13,na,1971,5260.598815763596
SIM,1854,15,35-39,1869,1
STAT,1827,41,15-19,1868,0.01667631283994093
STAT,1939,17,20-24,1956,138.43948258408392
STAT,1943,28,35-39,1971,16.30556975750692
STAT,1892,16,45-49,1908,0.08372398891913532
STAT,1881,19,35-39,1900,0.5382771944370406
STAT,1806,51,25-29,1857,0.011761967559537335
STAT,1880,52,40-44,1932,0.011225871097817329
SIM,1833,25,45-49,1858,1
STAT,1846,15,35-39,1861,0.49878430066435625
STAT,1834,28,20-24,1862,10.277895440175847
SIM,1842,28,20-24,1870,10
SIM,1947,17,20-24,1964,171
STAT,1842,22,40-44,1864,2.0611225091159
STAT,1832,49,20-24,1881,0.008449722882770854
STAT,1858,41,45-49,1899,1.2162719363417858
SIM,1934,33,15-19,1967,1
STAT,1782,75,na,1857,379.2616408715364
SIM,1873,34,45-49,1907,2
SIM,1837,20,15-19,1857,4
SIM,1855,44,35-39,1899,2
STAT,1807,72,na,1879,675.6029274626939
STAT,1847,44,35-39,1891,1.3930355043389195
SIM,1890,24,35-39,1914,13
STAT,1821,49,45-49,1870,0.3609012453919713
SIM,1825,30,35-39,1855,14
SIM,1884,34,20-24,1918,3
SIM,1920,23,na,1943,3861
SIM,1927,17,35-39,1944,12
STAT,1833,27,na,1860,1870.591655168094
STAT,1830,51,30-34,1881,0.004431120861412581
SIM,1877,91,na,1968,143
STAT,1860,31,50-100,1891,0.7614887654681018
STAT,1877,42,25-29,1919,0.6786208207117801
SIM,1953,10,na,1963,4772
STAT,1884,21,35-39,1905,5.907429938889436
STAT,1911,22,15-19,1933,5.1496348198628805
SIM,1839,43,40-44,1882,4
SIM,1919,22,25-29,1941,120
SIM,1838,54,45-49,1892,2
STAT,1820,44,50-100,1864,1.9819874265426438
SIM,1906,21,50-100,1927,4
SIM,1910,17,25-29,1927,11
SIM,1841,34,50-100,1875,2
STAT,1902,17,25-29,1919,8.152413388430475
STAT,1876,34,20-24,1910,2.823102508016359
STAT,1837,22,30-34,1859,15.546809075994348
STAT,1851,15,45-49,1866,0.06630178742358382
STAT,1900,45,30-34,1945,0.07797598069887153
SIM,1892,21,35-39,1913,12
STAT,1934,35,30-34,1969,2.56933733551153
STAT,1881,29,50-100,1910,0.6264048863014505
STAT,1899,42,45-49,1941,0.1450079829580301
STAT,1914,43,35-39,1957,0.20325782658866023
SIM,1886,34,na,1920,2621
SIM,1905,17,15-19,1922,9
STAT,1891,2,na,1893,3366.7230074690447
SIM,1793,87,na,1880,21
SIM,1825,38,30-34,1863,8
STAT,1926,40,20-24,1966,0.022272099891459656
STAT,1877,18,30-34,1895,1.6820323863967686
SIM,1879,20,20-24,1899,107
STAT,1884,29,30-34,1913,25.234003149276653
STAT,1906,53,na,1959,3220.8159260328944
STAT,1847,47,na,1894,1746.275754844126
STAT,1919,26,na,1945,4144.715535136453
SIM,1864,4,na,1868,2663
STAT,1909,9,na,1918,3968.38528643491
STAT,1851,46,na,1897,1861.4277190928376
STAT,1826,36,15-19,1862,0.05148031904645555
SIM,1901,50,na,1951,3340
STAT,1869,4,na,1873,2924.76875897682
STAT,1839,109,na,1948,4.910102824939793E-4
STAT,1884,33,50-100,1917,0.9208482583407411
STAT,1941,28,50-100,1969,1.0499621239061663
SIM,1912,21,30-34,1933,49
STAT,1880,45,35-39,1925,0.15158042052305057
STAT,1882,24,35-39,1906,5.763440981117035
STAT,1864,19,na,1883,2342.083589461527
STAT,1861,26,25-29,1887,36.17757784424836
STAT,1923,49,15-19,1972,4.3710244574078877E-4
STAT,1957,15,15-19,1972,61.056135167571405
STAT,1912,46,35-39,1958,0.12671525521223723
SIM,1889,37,45-49,1926,1
STAT,1841,56,na,1897,1505.9692141683386
STAT,1909,43,25-29,1952,0.06771003392186235
STAT,1813,54,35-39,1867,0.019849584174481117
SIM,1848,94,na,1942,39
SIM,1866,100,na,1966,10
SIM,1892,29,30-34,1921,44
STAT,1879,15,30-34,1894,1.7075273857655302
SIM,1887,21,25-29,1908,80
STAT,1897,45,45-49,1942,0.18339586452544887
SIM,1823,33,35-39,1856,16
SIM,1869,62,na,1931,1815
STAT,1910,19,40-44,1929,0.2811545107871768
STAT,1898,34,40-44,1932,5.931506028444303
STAT,1881,50,na,1931,2154.1379610852305
SIM,1885,42,25-29,1927,1
STAT,1879,21,25-29,1900,61.22844187898954
STAT,1817,38,30-34,1855,17.459039786539606
SIM,1818,50,na,1868,1340
STAT,1856,83,na,1939,317.90857509942043
SIM,1865,33,40-44,1898,9
STAT,1876,26,50-100,1902,0.6761833059009398
SIM,1879,86,na,1965,602
STAT,1869,26,25-29,1895,41.806002618218145
STAT,1824,33,45-49,1857,3.0864812755020496
SIM,1846,39,45-49,1885,2
STAT,1832,79,na,1911,467.1616681480036
STAT,1952,4,na,1956,4807.5040150173445
SIM,1916,38,25-29,1954,2
SIM,1927,7,na,1934,4906
STAT,1856,55,na,1911,1655.8322606352913
STAT,1864,49,50-100,1913,0.21812795123279363
SIM,1862,30,20-24,1892,2
SIM,1837,39,35-39,1876,4
STAT,1903,16,30-34,1919,2.317049906050359
SIM,1826,36,25-29,1862,5
STAT,1876,27,15-19,1903,0.47794358713224067
STAT,1818,43,30-34,1861,2.827091230146872
STAT,1814,53,40-44,1867,0.029436847406599423
SIM,1893,27,25-29,1920,62
STAT,1818,44,na,1862,1466.57890296332
SIM,1851,20,35-39,1871,8
STAT,1887,16,35-39,1903,0.6287882730366078
SIM,1843,36,25-29,1879,4
SIM,1874,26,45-49,1900,1
SIM,1895,16,35-39,1911,2
SIM,1925,35,30-34,1960,3
STAT,1927,32,20-24,1959,3.0606976905033507
STAT,1855,100,na,1955,0.8229854059622383
STAT,1857,33,40-44,1890,3.440563254835965
STAT,1913,18,50-100,1931,0.07794110703034544
STAT,1805,53,30-34,1858,0.020560123543920405
STAT,1835,43,30-34,1878,1.0137171129710634
STAT,1829,39,35-39,1868,6.022451753241751
STAT,1891,24,45-49,1915,0.875202275402394
STAT,1855,39,45-49,1894,1.5297942266230844
STAT,1838,20,25-29,1858,55.362421291809305
SIM,1935,32,20-24,1967,3
SIM,1849,42,na,1891,1806
SIM,1787,87,na,1874,39
SIM,1774,80,na,1854,251
STAT,1853,31,15-19,1884,0.12424967471982747
STAT,1912,47,50-100,1959,0.22174347031782632
SIM,1906,28,na,1934,3503
STAT,1880,16,50-100,1896,0.05264973660712155
SIM,1843,43,30-34,1886,3
STAT,1809,46,25-29,1855,0.26052524835971813
SIM,1812,49,45-49,1861,1
STAT,1810,64,na,1874,851.0507758408655
SIM,1868,42,25-29,1910,1
STAT,1828,40,20-24,1868,0.13415496508605979
SIM,1819,46,50-100,1865,3
STAT,1835,100,na,1935,0.7909954990996193
STAT,1825,91,na,1916,34.74915143898586
STAT,1886,38,50-100,1924,1.319155864819216
STAT,1908,54,na,1962,3299.572078399304
STAT,1801,87,na,1888,57.228738357151904
SIM,1826,43,30-34,1869,2
SIM,1852,36,35-39,1888,10
STAT,1925,26,na,1951,4529.713932850334
STAT,1830,44,25-29,1874,0.5383309370498343
SIM,1863,8,na,1871,2479
STAT,1928,18,50-100,1946,0.48026518932348355
SIM,1901,6,na,1907,3853
STAT,1844,36,35-39,1880,6.4310382517226685
STAT,1917,35,30-34,1952,1.950185345059495
SIM,1910,33,na,1943,3632
STAT,1885,34,30-34,1919,17.617989365142517
SIM,1893,34,30-34,1927,7
STAT,1829,49,45-49,1878,0.18613368973361094
STAT,1908,38,25-29,1946,0.9353723091319187
STAT,1840,43,40-44,1883,1.6669155013640582
STAT,1841,33,45-49,1874,1.5460520513532738
SIM,1911,16,30-34,1927,2
STAT,1881,50,35-39,1931,0.008612938637799038
STAT,1849,49,30-34,1898,0.07358259004814208
STAT,1843,20,35-39,1863,5.998884933220668
STAT,1920,22,25-29,1942,104.79382376515349
SIM,1889,19,15-19,1908,6
STAT,1902,63,na,1965,2797.881847302775
STAT,1852,93,na,1945,23.54402503899117
STAT,1837,49,50-100,1886,0.16568299540049466
STAT,1845,17,40-44,1862,0.18062670676144563
STAT,1840,18,35-39,1858,0.5082120964556885
SIM,1799,72,na,1871,648
STAT,1924,48,50-100,1972,0.2739598672838803
STAT,1775,93,na,1868,6.162189180893325
STAT,1843,28,30-34,1871,24.83842644772085
STAT,1928,30,15-19,1958,0.16408301819103943
SIM,1883,29,20-24,1912,14
SIM,1895,17,na,1912,3568
SIM,1863,44,30-34,1907,4
STAT,1903,22,25-29,1925,83.01556265551018
STAT,1923,25,45-49,1948,2.0374932978163147
SIM,1925,28,25-29,1953,130
SIM,1863,20,25-29,1883,61
STAT,1864,13,na,1877,2450.450370931509
STAT,1873,27,na,1900,2468.260664547114
STAT,1878,16,25-29,1894,6.032057776134042
STAT,1860,28,30-34,1888,20.915488773046324
STAT,1876,37,25-29,1913,3.0330309095042933
SIM,1942,28,25-29,1970,3
SIM,1846,20,25-29,1866,68
SIM,1944,22,20-24,1966,156
STAT,1913,45,40-44,1958,0.1577272742974928
STAT,1815,43,45-49,1858,4.474591810504486
SIM,1840,43,na,1883,1622
STAT,1948,23,na,1971,4276.496504658787
SIM,1851,28,30-34,1879,31
SIM,1914,57,na,1971,3562
SIM,1857,77,na,1934,568
SIM,1902,32,25-29,1934,5
STAT,1902,35,50-100,1937,0.3848581041764651
STAT,1853,41,na,1894,1946.7403658560672
SIM,1912,28,na,1940,3803
STAT,1835,36,25-29,1871,2.680900200513118
STAT,1890,33,na,1923,2963.972762012004
STAT,1934,28,25-29,1962,90.25424648720738
STAT,1824,44,na,1868,1475.7267710845188
SIM,1930,35,40-44,1965,5
STAT,1882,34,45-49,1916,1.7183059760692896
STAT,1918,43,35-39,1961,0.21813553384075868
SIM,1825,66,na,1891,973
SIM,1905,27,50-100,1932,1
STAT,1860,20,35-39,1880,5.5510237051812865
STAT,1899,32,35-39,1931,14.147204351226225
SIM,1874,49,na,1923,2284
SIM,1931,25,45-49,1956,1
STAT,1881,44,40-44,1925,2.188465565298837
STAT,1821,54,25-29,1875,0.005150464804894904
STAT,1854,30,20-24,1884,2.1630319813809553
STAT,1855,20,25-29,1875,52.59555741410269
STAT,1931,1,na,1932,5574.627834385683
STAT,1838,39,45-49,1877,1.7310813187241605
SIM,1857,41,35-39,1898,1
STAT,1917,28,25-29,1945,70.19339327770346
SIM,1863,77,na,1940,615
STAT,1944,27,40-44,1971,5.139734272754598
STAT,1875,29,20-24,1904,12.195165926444348
STAT,1860,42,45-49,1902,1.2372652576335441
STAT,1804,54,25-29,1858,0.009973267382407046
SIM,1911,22,25-29,1933,3
STAT,1887,47,na,1934,2559.8779254372266
SIM,1870,87,na,1957,160
SIM,1832,33,45-49,1865,2
STAT,1806,59,na,1865,1052.874799470324
STAT,1850,47,15-19,1897,2.994789532564722E-4
SIM,1941,25,na,1966,3696
STAT,1844,17,50-100,1861,0.04825921804299265
STAT,1854,52,30-34,1906,0.004531558318465961
SIM,1945,1,na,1946,4762
STAT,1845,103,na,1948,0.11213502271099868
STAT,1876,44,30-34,1920,1.194746799433107
STAT,1818,36,25-29,1854,12.087129825974047
STAT,1809,53,30-34,1862,0.024782100797015608
SIM,1829,28,na,1857,1574
STAT,1833,54,20-24,1887,4.834994004886797E-4
STAT,1907,20,50-100,1927,0.6144684592732454
STAT,1871,45,25-29,1916,0.058786509227968735
STAT,1883,85,na,1968,561.8406278042696
STAT,1859,15,45-49,1874,0.0625105719107439
STAT,1885,27,25-29,1912,43.053489133722714
STAT,1908,45,30-34,1953,0.08341901520568429
SIM,1901,24,20-24,1925,99
SIM,1885,1,na,1886,3231
STAT,1821,39,35-39,1860,13.63290450350527
STAT,1891,46,50-100,1937,0.17547107042449536
STAT,1928,40,25-29,1968,0.09311386043102134
STAT,1890,16,40-44,1906,0.22870204648987713
SIM,1943,27,30-34,1970,71
STAT,1900,68,na,1968,2482.8551434393094
SIM,1889,17,na,1906,3330
STAT,1842,29,25-29,1871,40.4363563762955
SIM,1861,25,20-24,1886,17
SIM,1868,18,30-34,1886,2
SIM,1865,18,15-19,1883,6
STAT,1889,70,na,1959,1889.8745447634565
STAT,1867,44,20-24,1911,0.15004720829854318
STAT,1884,31,45-49,1915,1.7672019315310972
SIM,1861,42,50-100,1903,1
STAT,1877,32,15-19,1909,0.15067956088099915
SIM,1831,25,40-44,1856,7
STAT,1827,27,na,1854,1712.1717596119151
STAT,1870,23,30-34,1893,17.70863623110046
STAT,1813,48,40-44,1861,0.42311294147096185
STAT,1863,15,35-39,1878,0.5666979759369356
STAT,1869,41,20-24,1910,0.15712404083715587
SIM,1914,47,50-100,1961,1
STAT,1940,25,15-19,1965,0.7350384182970762
SIM,1789,82,na,1871,96
SIM,1873,31,40-44,1904,3
STAT,1954,5,na,1959,4957.829960124746
STAT,1926,43,25-29,1969,0.08966557006590659
STAT,1834,38,30-34,1872,4.415139758441485
STAT,1909,36,na,1945,3649.284115232236
STAT,1869,56,na,1925,2008.8527399518432
STAT,1921,21,30-34,1942,33.226252868712656
STAT,1855,54,40-44,1909,0.007936593210376874
SIM,1827,92,na,1919,10
STAT,1865,66,na,1931,1517.5641311123752
SIM,1813,41,na,1854,1505
STAT,1897,35,35-39,1932,9.73934926977509
SIM,1812,65,na,1877,805
STAT,1879,18,35-39,1897,0.5835857280454377
SIM,1821,70,na,1891,744
SIM,1889,34,40-44,1923,3
SIM,1901,27,25-29,1928,69
STAT,1881,22,na,1903,2332.5939974703683
STAT,1932,39,15-19,1971,0.02625704871980053
SIM,1853,17,40-44,1870,1
STAT,1817,40,45-49,1857,4.06338288311959
STAT,1936,22,20-24,1958,108.42748459847084
SIM,1906,16,20-24,1922,24
STAT,1871,42,20-24,1913,0.16028689764864987
SIM,1854,94,na,1948,26
STAT,1853,25,20-24,1878,11.56091985925384
SIM,1880,18,na,1898,2542
STAT,1895,16,50-100,1911,0.06536888058472703
STAT,1885,80,na,1965,926.7166671331822
STAT,1884,19,20-24,1903,17.797141490358474
STAT,1909,37,30-34,1946,1.7594019085707515
STAT,1898,37,45-49,1935,2.7501194155376445
SIM,1951,18,25-29,1969,84
STAT,1889,44,40-44,1933,2.7961513986951387
STAT,1943,18,25-29,1961,46.86941681525623
STAT,1912,53,na,1965,3525.124752316165
SIM,1878,21,15-19,1899,4
SIM,1892,34,na,1926,3432
STAT,1893,19,30-34,1912,2.051638665466821
SIM,1843,26,15-19,1869,3
STAT,1890,67,na,1957,2031.8782416702009
STAT,1900,48,35-39,1948,0.11025892058831284
STAT,1888,15,40-44,1903,0.22160965235576807
STAT,1819,109,na,1928,4.1944610414431006E-4
STAT,1847,72,na,1919,984.8218819587578
STAT,1875,35,15-19,1910,0.05935280227240697
STAT,1857,18,15-19,1875,5.524495759004764
SIM,1812,93,na,1905,11
STAT,1855,29,35-39,1884,7.68492265504958
STAT,1866,14,na,1880,2510.7431861223417
STAT,1918,37,40-44,1955,1.6101693527545975
SIM,1892,31,45-49,1923,1
STAT,1835,26,15-19,1861,0.4439366794807887
STAT,1880,39,40-44,1919,4.645581572432087
STAT,1900,35,20-24,1935,1.1002928907001364
STAT,1920,38,40-44,1958,1.6709346249230803
STAT,1933,21,na,1954,4954.847175370527
SIM,1864,34,35-39,1898,11
STAT,1895,31,20-24,1926,3.612503666063918
STAT,1861,48,35-39,1909,0.11653268438566575
STAT,1864,107,na,1971,0.06869560455054764
SIM,1875,62,na,1937,1795
SIM,1938,27,20-24,1965,28
SIM,1894,69,na,1963,2125
STAT,1844,33,30-34,1877,16.01216924652238
STAT,1851,28,20-24,1879,11.250989438649725
SIM,1934,31,50-100,1965,1
SIM,1826,46,35-39,1872,1
SIM,1887,37,40-44,1924,7
STAT,1826,28,30-34,1854,72.35899207848618
SIM,1880,44,30-34,1924,2
SIM,1926,37,40-44,1963,4
SIM,1867,34,20-24,1901,5
STAT,1812,46,30-34,1858,0.23305503726707266
STAT,1898,19,15-19,1917,8.14311857063404
SIM,1921,41,50-100,1962,1
STAT,1814,110,na,1924,1.2877001165056815E-4
STAT,1828,110,na,1938,1.521701930286868E-4
SIM,1863,29,35-39,1892,15
STAT,1808,48,30-34,1856,0.24715970751043367
STAT,1932,9,na,1941,5375.753852267176
STAT,1830,54,35-39,1884,0.006038796443717934
SIM,1859,33,50-100,1892,2
STAT,1912,22,35-39,1934,9.205427873695333
STAT,1885,37,35-39,1922,7.198669486146714
STAT,1832,73,na,1905,793.689522749524
SIM,1875,29,30-34,1904,4
SIM,1893,37,35-39,1930,17
STAT,1864,52,25-29,1916,0.003195793338008003
SIM,1926,33,25-29,1959,18
SIM,1853,47,na,1900,1882
SIM,1886,6,na,1892,2956
STAT,1929,4,na,1933,5253.733534576683
SIM,1842,38,30-34,1880,1
SIM,1834,28,30-34,1862,27
SIM,1946,18,15-19,1964,45
STAT,1909,40,20-24,1949,0.017037535894896646
STAT,1848,43,40-44,1891,1.7358062735717845
SIM,1939,15,na,1954,3610
STAT,1891,48,15-19,1939,2.81393457357233E-4
STAT,1903,11,na,1914,3750.6519258728017
SIM,1850,25,45-49,1875,2
STAT,1908,35,20-24,1943,0.25406620242786626
SIM,1856,43,40-44,1899,3
SIM,1920,22,35-39,1942,13
STAT,1872,44,30-34,1916,1.1595884570094053
SIM,1834,49,na,1883,1559
STAT,1837,25,35-39,1862,8.377025196986141
SIM,1877,16,15-19,1893,8
STAT,1888,23,na,1911,2843.482801253428
SIM,1866,41,45-49,1907,5
SIM,1859,30,45-49,1889,2
STAT,1854,29,na,1883,1887.4079013280193
STAT,1853,19,50-100,1872,0.04883570881064939
STAT,1863,45,35-39,1908,0.1264716633192935
STAT,1869,34,50-100,1903,0.8946918283499717
SIM,1852,33,30-34,1885,22
STAT,1858,39,30-34,1897,4.268274269796011
STAT,1938,18,15-19,1956,45.65287335251407
SIM,1904,33,na,1937,3736
STAT,1842,25,45-49,1867,1.0923870729806084
STAT,1856,34,35-39,1890,8.040357121821971
STAT,1844,41,15-19,1885,0.011101333109366764
SIM,1850,29,25-29,1879,38
SIM,1934,28,35-39,1962,37
STAT,1914,35,15-19,1949,0.01974819299386934
SIM,1851,18,20-24,1869,15
STAT,1926,28,35-39,1954,18.295919617340147
STAT,1791,86,na,1877,64.50469906829781
STAT,1869,28,na,1897,2342.23307727239
STAT,1843,82,na,1925,376.65940349942053
STAT,1874,40,na,1914,2431.5896869402554
SIM,1919,32,na,1951,4189
STAT,1836,31,15-19,1867,0.11321916636761578
STAT,1879,37,40-44,1916,4.667972017676713
SIM,1828,40,na,1868,1780
STAT,1935,27,30-34,1962,54.468610244480125
STAT,1869,16,15-19,1885,5.9610382134914355
STAT,1934,38,35-39,1972,3.400451965049107
SIM,1873,61,na,1934,1836
STAT,1913,41,50-100,1954,0.11754786195286325
STAT,1876,38,na,1914,2469.545574527359
SIM,1836,75,na,1911,733
SIM,1883,39,30-34,1922,4
STAT,1887,32,50-100,1919,1.0473908831277194
STAT,1904,46,45-49,1950,0.19518815193743538
STAT,1927,35,25-29,1962,1.2509031594051092
STAT,1830,41,20-24,1871,0.1389664883730254
STAT,1950,20,45-49,1970,1.3627051696838772
STAT,1870,46,50-100,1916,0.24562311341321844
STAT,1783,107,na,1890,0.008732867693656086
STAT,1863,31,na,1894,2143.162702692151
SIM,1862,49,40-44,1911,1
STAT,1846,27,50-100,1873,0.5534110334700341
SIM,1895,32,50-100,1927,1
SIM,1832,30,40-44,1862,6
STAT,1896,52,na,1948,2885.713067474148
SIM,1876,44,na,1920,2633
SIM,1831,38,na,1869,1671
SIM,1869,25,20-24,1894,17
SIM,1908,38,35-39,1946,7
SIM,1918,32,20-24,1950,2
STAT,1901,19,30-34,1920,2.261587131167336
SIM,1893,24,20-24,1917,105
STAT,1894,23,na,1917,3093.870158362091
STAT,1838,98,na,1936,2.3868726309461588
SIM,1845,52,na,1897,1688
STAT,1868,36,20-24,1904,0.7547050247217497
STAT,1897,37,na,1934,3213.639059283369
STAT,1820,47,35-39,1867,0.255355014353335
STAT,1854,49,40-44,1903,0.12829293087587001
SIM,1847,22,35-39,1869,7
STAT,1939,24,50-100,1963,0.6736577093748454
SIM,1861,76,na,1937,836
STAT,1818,46,35-39,1864,0.3229570510385798
STAT,1877,50,45-49,1927,0.01557604488938364
STAT,1906,49,15-19,1955,3.280352015396652E-4
STAT,1843,30,45-49,1873,1.7278882970618252
SIM,1860,33,20-24,1893,4
STAT,1839,22,35-39,1861,5.174636842556799
STAT,1834,34,15-19,1868,0.12023345933243702
STAT,1918,33,25-29,1951,9.980395585057032
STAT,1842,33,50-100,1875,0.8590283838303915
SIM,1935,35,25-29,1970,2
SIM,1945,15,na,1960,4693
STAT,1875,39,30-34,1914,5.52396325197022
SIM,1830,53,na,1883,1495
STAT,1908,48,35-39,1956,0.11856895447386559
STAT,1849,100,na,1949,0.8242193142952269
STAT,1935,30,50-100,1965,1.1678319896497187
SIM,1902,48,40-44,1950,1
STAT,1826,43,20-24,1869,0.12790903171638887
STAT,1853,47,30-34,1900,0.0807882697340367
SIM,1825,43,50-100,1868,4
STAT,1831,43,30-34,1874,0.9614125601989311
SIM,1826,33,20-24,1859,2
SIM,1853,47,40-44,1900,1
SIM,1861,47,30-34,1908,1
STAT,1874,33,40-44,1907,4.49789691015299
SIM,1846,36,40-44,1882,7
SIM,1928,43,na,1971,4966
STAT,1815,109,na,1924,3.678783708957849E-4
SIM,1845,80,na,1925,525
STAT,1862,31,25-29,1893,8.931027211048985
STAT,1897,44,50-100,1941,0.09871796678338729
STAT,1926,33,15-19,1959,0.1584182963582684
STAT,1843,36,15-19,1879,0.053473549988954074
STAT,1868,40,na,1908,2274.720019620318
STAT,1914,40,30-34,1954,0.13015419193049907
SIM,1948,15,15-19,1963,59
STAT,1795,76,na,1871,335.3371372090787
STAT,1845,46,na,1891,1762.8972343364549
SIM,1825,38,na,1863,1611
SIM,1886,16,25-29,1902,12
STAT,1859,97,na,1956,5.099779576582686
STAT,1936,32,30-34,1968,15.608358670940596
STAT,1862,53,35-39,1915,0.007356070357250435
STAT,1860,24,15-19,1884,2.774632252418956
STAT,1877,20,45-49,1897,0.7422284595815543
STAT,1882,38,na,1920,2329.937019332142
SIM,1845,15,25-29,1860,6
STAT,1816,39,25-29,1855,7.925879171082853
STAT,1822,54,45-49,1876,0.019114294132277714
SIM,1882,44,na,1926,2203
SIM,1868,28,40-44,1896,7
STAT,1857,31,na,1888,1932.9238987629806
STAT,1894,26,20-24,1920,15.447052941370865
STAT,1773,92,na,1865,10.66049829043591
STAT,1804,51,20-24,1855,0.0022091169328110195
STAT,1903,26,40-44,1929,4.358968563916316
STAT,1924,30,45-49,1954,1.8814955378325409
STAT,1913,49,20-24,1962,0.01093936195683599
STAT,1873,95,na,1968,58.881878665151454
SIM,1851,30,45-49,1881,3
STAT,1838,36,40-44,1874,3.9215643214648925
STAT,1861,16,15-19,1877,5.784021531425269
SIM,1888,42,40-44,1930,2
STAT,1852,33,20-24,1885,2.2313425708986236
SIM,1834,42,50-100,1876,4
SIM,1886,33,50-100,1919,5
STAT,1933,32,45-49,1965,2.162624815749827
SIM,1871,15,35-39,1886,1
SIM,1795,82,na,1877,165
SIM,1837,23,na,1860,1732
STAT,1871,37,40-44,1908,4.423574411606875
SIM,1816,55,na,1871,1354
STAT,1893,34,20-24,1927,3.4682041174373177
STAT,1885,24,20-24,1909,69.69860093240224
SIM,1824,30,50-100,1854,1
SIM,1903,21,20-24,1924,98
STAT,1793,104,na,1897,0.013361060440165547
STAT,1836,41,25-29,1877,0.48166050507064606
STAT,1915,36,na,1951,3896.9616200795144
STAT,1841,23,35-39,1864,5.419002043165984
SIM,1911,26,40-44,1937,11
STAT,1881,40,25-29,1921,0.6397356509431913
STAT,1844,98,na,1942,2.517331551966362
STAT,1846,50,50-100,1896,0.010955509804093419
STAT,1885,42,15-19,1927,0.014038047285244586
SIM,1824,39,25-29,1863,5
STAT,1921,36,na,1957,4290.557786789174
SIM,1918,17,50-100,1935,1
STAT,1850,98,na,1948,2.4435683736990965
STAT,1794,60,na,1854,1005.0
STAT,1880,20,20-24,1900,74.31702183306743
STAT,1839,46,na,1885,1602.4155428346737
STAT,1875,31,50-100,1906,0.9632392402506311
STAT,1913,48,45-49,1961,0.21580762254010355
SIM,1845,28,50-100,1873,1
STAT,1925,22,45-49,1947,1.3740917506078199
STAT,1891,80,na,1971,1261.0566976299042
SIM,1942,25,20-24,1967,29
STAT,1826,42,50-100,1868,0.8657812827478821
STAT,1833,32,40-44,1865,3.7046614030733354
SIM,1843,23,na,1866,2065
STAT,1827,35,20-24,1862,1.0535699212168799
STAT,1944,23,25-29,1967,101.71900853811799
SIM,1898,59,na,1957,3013
STAT,1955,15,50-100,1970,0.5075463799164691
STAT,1828,50,30-34,1878,0.004678083339170073
SIM,1805,83,na,1888,62
SIM,1833,22,40-44,1855,3
SIM,1888,23,35-39,1911,9
SIM,1838,44,35-39,1882,3
STAT,1824,30,40-44,1854,12.260394395742743
SIM,1841,32,40-44,1873,7
STAT,1859,47,35-39,1906,0.11352834096635636
STAT,1823,51,25-29,1874,0.0052295183481588054
STAT,1899,48,15-19,1947,3.1124210207378593E-4
STAT,1890,42,25-29,1932,0.7999999930123116
STAT,1891,21,40-44,1912,2.639792040746422
STAT,1876,40,15-19,1916,0.014694471640332538
STAT,1911,17,35-39,1928,0.8565114061476741
SIM,1801,56,na,1857,1283
SIM,1921,48,45-49,1969,1
STAT,1857,36,45-49,1893,1.5958928453300416
SIM,1872,29,45-49,1901,3
SIM,1928,22,35-39,1950,16
STAT,1930,41,25-29,1971,0.09596570363358616
STAT,1934,25,20-24,1959,25.0640276674814
SIM,1947,8,na,1955,4673
STAT,1837,17,na,1854,2029.2345215520977
SIM,1830,50,na,1880,1603
SIM,1904,64,na,1968,2823
STAT,1926,25,30-34,1951,48.242689176178345
SIM,1837,44,50-100,1881,3
SIM,1879,23,25-29,1902,80
SIM,1911,38,40-44,1949,3
STAT,1848,26,na,1874,2022.008852036198
STAT,1789,76,na,1865,297.00725273759406
STAT,1863,54,30-34,1917,0.005177854285437219
STAT,1953,6,na,1959,4850.932721876543
SIM,1847,16,na,1863,2042
STAT,1932,15,45-49,1947,0.6777121131120829
STAT,1864,26,40-44,1890,2.7265478222252253
SIM,1809,76,na,1885,254
SIM,1949,9,na,1958,4778
STAT,1889,35,45-49,1924,2.535937096667533
SIM,1822,55,na,1877,1222
STAT,1815,103,na,1918,0.07420809254517917
STAT,1876,47,35-39,1923,0.1467925541252331
STAT,1917,25,20-24,1942,19.668031006999552
STAT,1825,29,25-29,1854,143.34137746960516
SIM,1874,18,na,1892,2590
SIM,1869,48,50-100,1917,1
STAT,1874,18,15-19,1892,6.165006955743449
STAT,1943,14,na,1957,4248.297455913274
STAT,1906,26,50-100,1932,0.9531041360209395
SIM,1796,61,na,1857,807
STAT,1900,25,50-100,1925,0.91062926293689
STAT,1838,17,35-39,1855,0.5325360787174084
STAT,1847,29,45-49,1876,1.0257915087230698
STAT,1825,40,35-39,1865,2.577710342320644
SIM,1928,19,45-49,1947,1
STAT,1940,15,50-100,1955,0.3882808312197038
STAT,1797,71,na,1868,624.5753407748869
STAT,1854,20,na,1874,1950.65382631281
STAT,1840,51,25-29,1891,0.0025610203662788764
STAT,1867,95,na,1962,31.32809568929934
STAT,1867,47,25-29,1914,0.054908162302130054
SIM,1930,41,35-39,1971,1
STAT,1823,65,na,1888,950.5655846797436
SIM,1885,55,na,1940,2019
SIM,1842,40,45-49,1882,4
SIM,1934,25,30-34,1959,74
STAT,1892,31,35-39,1923,13.000994670912885
STAT,1821,36,30-34,1857,12.359159646247459
STAT,1830,48,40-44,1878,0.14024967166908703
SIM,1909,40,30-34,1949,3
STAT,1840,47,20-24,1887,0.008707885544226954
STAT,1853,35,30-34,1888,4.5626208452905335
SIM,1951,15,20-24,1966,174
SIM,1865,36,45-49,1901,5
SIM,1886,0,na,1886,3531
STAT,1872,45,na,1917,2323.2369627438557
STAT,1816,80,na,1896,274.4794695774494
STAT,1912,24,25-29,1936,93.5172428468403
SIM,1872,26,40-44,1898,5
STAT,1785,86,na,1871,71.5499832552654
SIM,1871,35,na,1906,2232
SIM,1871,42,30-34,1913,3
STAT,1916,12,na,1928,4275.910152589668
STAT,1869,103,na,1972,1.6640988891543722
STAT,1850,20,40-44,1870,1.9086468080464845
STAT,1849,45,15-19,1894,3.1363994406197686E-4
SIM,1879,30,30-34,1909,32
SIM,1833,40,35-39,1873,6
STAT,1872,40,15-19,1912,0.014262050924988225
SIM,1929,18,15-19,1947,56
STAT,1833,34,50-100,1867,0.7659760684469145
STAT,1842,35,na,1877,2011.6599327956285
SIM,1919,19,35-39,1938,4
SIM,1784,76,na,1860,409
STAT,1931,29,na,1960,4927.60565298838
SIM,1833,29,25-29,1862,58
SIM,1925,25,20-24,1950,31
SIM,1939,19,20-24,1958,226
STAT,1895,46,25-29,1941,0.043368922146695195
STAT,1863,42,30-34,1905,1.0270566976571411
STAT,1872,54,40-44,1926,0.010467784131758728
STAT,1845,52,20-24,1897,5.735016729740478E-4
SIM,1929,36,45-49,1965,2
STAT,1875,41,45-49,1916,1.5740885088614012
SIM,1846,29,35-39,1875,3
SIM,1865,6,na,1871,2716
STAT,1896,15,30-34,1911,2.1574831139251205
STAT,1907,30,45-49,1937,1.5118942632795938
SIM,1911,12,na,1923,4100
SIM,1874,15,na,1889,2614
STAT,1912,22,na,1934,3730.847180437002
STAT,1921,36,35-39,1957,2.758432986061222
SIM,1861,35,30-34,1896,1
STAT,1922,41,35-39,1963,0.23617381653944358
SIM,1803,51,na,1854,1066
STAT,1823,68,na,1891,850.5227203949368
STAT,1833,23,45-49,1856,0.6584437797028957
STAT,1848,28,15-19,1876,0.4180078880332162
SIM,1861,41,25-29,1902,1
STAT,1918,42,20-24,1960,0.019161322966169708
STAT,1879,46,50-100,1925,0.2626403615540149
STAT,1851,19,25-29,1870,5.617364143517744
STAT,1926,37,30-34,1963,2.272321466651283
SIM,1858,56,na,1914,1665
STAT,1891,22,50-100,1913,0.5150384458279017
STAT,1808,50,45-49,1858,0.036120684146602675
STAT,1897,23,50-100,1920,0.5545222532835089
SIM,1858,53,na,1911,1750
STAT,1891,12,na,1903,3261.7037004150898
SIM,1904,30,na,1934,3710
STAT,1916,15,na,1931,4201.123531533229
STAT,1859,66,na,1925,1335.3260896921176
SIM,1932,20,35-39,1952,18
SIM,1883,20,na,1903,2465
STAT,1865,60,na,1925,1765.8630560533043
STAT,1867,92,na,1959,64.93577234140518
STAT,1868,16,50-100,1884,0.04888834124256512
SIM,1841,28,na,1869,1890
STAT,1935,23,15-19,1958,7.389943589802588
SIM,1866,82,na,1948,555
SIM,1883,41,45-49,1924,2
SIM,1902,26,30-34,1928,54
STAT,1835,46,35-39,1881,0.11141363824226132
STAT,1815,100,na,1915,0.548950576312791
STAT,1870,25,20-24,1895,11.778710918689052
STAT,1808,51,na,1859,1061.596072859894
STAT,1889,47,45-49,1936,0.1669728422975644
SIM,1915,30,45-49,1945,2
STAT,1838,29,35-39,1867,8.889229646117883
SIM,1833,95,na,1928,1
STAT,1879,18,na,1897,2686.136563704099
SIM,1947,24,50-100,1971,1
STAT,1909,47,40-44,1956,0.14775349796944834
STAT,1900,41,15-19,1941,0.0013620889889678798
STAT,1821,52,35-39,1873,0.01302783921462531
STAT,1924,41,na,1965,4513.554808831647
SIM,1876,36,20-24,1912,2
SIM,1929,22,na,1951,4832
STAT,1910,15,25-29,1925,8.798424507426887
STAT,1912,31,30-34,1943,15.879579524654346
SIM,1830,41,30-34,1871,3
STAT,1878,33,na,1911,2523.2379967167594
STAT,1873,19,45-49,1892,0.06719746425554973
STAT,1873,24,50-100,1897,0.4191167877498993
SIM,1929,24,45-49,1953,1
STAT,1922,49,30-34,1971,0.10388404773882336
STAT,1855,50,25-29,1905,0.0027852200494327285
SIM,1841,90,na,1931,29
SIM,1897,40,na,1937,3181
STAT,1839,41,40-44,1880,1.821076246712439
STAT,1853,72,na,1925,1058.9357191458876
STAT,1819,50,20-24,1869,0.0014630547095334763
STAT,1930,2,na,1932,5392.826136736805
STAT,1886,41,20-24,1927,0.1722641772326659
STAT,1908,4,na,1912,3979.307373693233
SIM,1856,28,15-19,1884,1
STAT,1879,80,na,1959,809.2937915477451
STAT,1884,25,15-19,1909,0.4610207246475176
SIM,1847,41,40-44,1888,6
STAT,1822,53,30-34,1875,0.007997862347776082
STAT,1951,21,50-100,1972,0.8022396428936578
SIM,1897,35,45-49,1932,5
SIM,1870,37,30-34,1907,7
SIM,1823,36,50-100,1859,5
SIM,1926,30,20-24,1956,6
SIM,1869,23,30-34,1892,22
STAT,1920,16,30-34,1936,13.989687840128212
STAT,1847,22,25-29,1869,54.72535768267357
SIM,1841,35,45-49,1876,4
SIM,1946,21,40-44,1967,5
SIM,1869,28,25-29,1897,6
STAT,1894,36,30-34,1930,7.027229449526436
STAT,1843,18,20-24,1861,18.181725984632482
STAT,1882,23,50-100,1905,0.40404108094413227
STAT,1865,31,40-44,1896,4.031787453265531
SIM,1835,28,na,1863,1864
STAT,1878,30,na,1908,2554.2992853000737
STAT,1912,56,na,1968,3467.522425238661
STAT,1921,43,40-44,1964,0.28702414754550315
STAT,1859,17,50-100,1876,0.04633227449748534
STAT,1918,30,20-24,1948,2.6662840160310477
SIM,1814,91,na,1905,36
STAT,1856,22,35-39,1878,5.427337030786602
STAT,1868,52,25-29,1920,0.0034328490864315806
STAT,1810,95,na,1905,5.668331184021424
SIM,1920,31,30-34,1951,26
STAT,1883,26,45-49,1909,1.115188996041098
STAT,1768,106,na,1874,0.01728643625648009
STAT,1831,53,40-44,1884,0.00742540339862256
STAT,1922,40,50-100,1962,0.1379703215562545
STAT,1858,53,45-49,1911,0.011552145469222262
SIM,1926,8,na,1934,5298
SIM,1902,5,na,1907,3836
STAT,1813,44,25-29,1857,1.960973254237552
STAT,1910,27,na,1937,3689.5135438081934
SIM,1772,88,na,1860,34
SIM,1798,93,na,1891,2
STAT,1920,32,35-39,1952,10.214825047567496
STAT,1918,47,na,1965,3989.542550114983
STAT,1938,21,40-44,1959,3.3957125607685703
STAT,1898,40,35-39,1938,0.17522447549724157
SIM,1873,24,35-39,1897,10
STAT,1833,35,45-49,1868,1.686256479618871
STAT,1880,35,25-29,1915,3.1158983032062757
SIM,1838,22,25-29,1860,56
SIM,1847,13,na,1860,2125
STAT,1893,47,na,1940,2898.588169117618
STAT,1841,87,na,1928,130.08355144714446
SIM,1874,27,20-24,1901,8
SIM,1889,40,35-39,1929,1
STAT,1930,41,na,1971,4991.080094488603
STAT,1884,33,na,1917,2398.298543791859
SIM,1849,48,na,1897,1787
STAT,1931,35,15-19,1966,0.02598229560420071
STAT,1852,46,35-39,1898,0.11310444492944681
STAT,1837,19,40-44,1856,0.1733953372899809
STAT,1827,45,30-34,1872,0.11168871344610519
STAT,1852,36,25-29,1888,2.356413363184392
STAT,1865,24,35-39,1889,5.390517048428013
STAT,1953,3,na,1956,4854.0872126296545
SIM,1809,73,na,1882,339
SIM,1934,37,30-34,1971,4
STAT,1851,30,35-39,1881,8.878546580681466
STAT,1894,48,30-34,1942,0.07075109180550354
STAT,1935,30,20-24,1965,3.445275625785649
SIM,1900,71,na,1971,2283
STAT,1904,43,40-44,1947,0.2267167230650627
STAT,1812,47,45-49,1859,0.5585474922329502
STAT,1847,78,na,1925,609.2934114661766
SIM,1803,88,na,1891,4
STAT,1904,27,na,1931,3489.254080239672
STAT,1804,53,50-100,1857,0.043402760278894295
STAT,1849,51,45-49,1900,0.011320773251887763
SIM,1835,90,na,1925,51
SIM,1894,38,50-100,1932,3
SIM,1903,31,30-34,1934,41
SIM,1829,39,45-49,1868,4
SIM,1860,36,25-29,1896,6
STAT,1868,2,na,1870,3264.7275466524343
STAT,1862,33,15-19,1895,0.1231449545856967
STAT,1820,88,na,1908,75.60955747907462
SIM,1828,49,na,1877,1603
STAT,1889,29,15-19,1918,0.5676441012445702
SIM,1872,85,na,1957,154
STAT,1925,26,25-29,1951,79.58754038879057
STAT,1893,37,25-29,1930,3.7261028456415093
STAT,1942,22,50-100,1964,0.7038687478965475
SIM,1824,50,na,1874,1356
STAT,1842,19,15-19,1861,5.9060292562777335
STAT,1927,45,35-39,1972,0.16586569996903752
STAT,1943,17,na,1960,3982.219564064326
SIM,1920,24,25-29,1944,174
STAT,1921,31,40-44,1952,4.462092823593319
STAT,1944,20,20-24,1964,122.57472892385273
STAT,1906,25,45-49,1931,1.6598137036165774
STAT,1897,20,30-34,1917,24.4415732966042
SIM,1885,48,30-34,1933,1
STAT,1848,110,na,1958,3.1906451612840437E-4
STAT,1948,23,50-100,1971,0.7705564028468155
STAT,1853,48,45-49,1901,0.1953992494636068
STAT,1860,20,na,1880,2033.902582610668
STAT,1845,40,20-24,1885,0.12964083527498035
SIM,1850,19,15-19,1869,4
STAT,1861,36,35-39,1897,5.990944795476876
SIM,1861,48,45-49,1909,2
SIM,1790,73,na,1863,335
STAT,1901,21,45-49,1922,0.9977877729130926
STAT,1877,85,na,1962,473.54627673571673
SIM,1930,19,na,1949,5281
SIM,1917,37,30-34,1954,2
STAT,1813,52,50-100,1865,0.03624708018647152
STAT,1930,33,40-44,1963,5.1476706592452794
STAT,1874,36,45-49,1910,2.0863332443767244
SIM,1914,25,45-49,1939,1
SIM,1935,25,na,1960,5096
SIM,1889,48,na,1937,2875
SIM,1869,16,25-29,1885,8
STAT,1877,48,30-34,1925,0.10113577636440066
STAT,1870,48,45-49,1918,0.23239676550373442
SIM,1834,46,25-29,1880,1
STAT,1864,25,50-100,1889,0.5864556802736755
STAT,1935,37,40-44,1972,2.134714028473761
STAT,1892,62,na,1954,2336.867373380775
STAT,1859,40,50-100,1899,0.8693920064114776
SIM,1821,44,25-29,1865,2
STAT,1779,86,na,1865,55.27451794110154
STAT,1872,48,na,1920,2271.4005211714652
SIM,1855,22,25-29,1877,60
STAT,1826,46,25-29,1872,0.04560864891828626
STAT,1862,41,50-100,1903,0.9215739743890152
STAT,1822,51,40-44,1873,0.01471997111985565
SIM,1834,43,na,1877,1691
SIM,1841,17,15-19,1858,8
SIM,1784,73,na,1857,553
SIM,1891,26,45-49,1917,4
STAT,1937,19,45-49,1956,0.4942305056703851
STAT,1917,32,50-100,1949,0.8835247422824182
SIM,1855,42,na,1897,1772
STAT,1819,91,na,1910,34.16354265624327
STAT,1817,65,na,1882,928.1821046919894
STAT,1868,46,30-34,1914,0.094586548053339
SIM,1824,35,45-49,1859,3
SIM,1908,35,30-34,1943,1
STAT,1840,107,na,1947,0.003393590651335781
SIM,1820,40,25-29,1860,1
SIM,1933,26,25-29,1959,132
SIM,1884,44,30-34,1928,2
STAT,1943,25,30-34,1968,42.61198971361216
STAT,1861,23,20-24,1884,59.25069375540106
STAT,1846,54,30-34,1900,0.004139738571354865
SIM,1833,26,20-24,1859,16
STAT,1847,26,40-44,1873,2.828033665738306
STAT,1875,31,35-39,1906,10.646477178017562
STAT,1822,51,50-100,1873,0.02111696789951115
STAT,1871,60,na,1931,1927.2520343366361
STAT,1855,17,35-39,1872,0.5059213677745416
SIM,1807,47,na,1854,1310
STAT,1802,66,na,1868,708.9768607864812
STAT,1925,29,na,1954,4481.958319279423
STAT,1919,40,15-19,1959,0.0017029732060799923
STAT,1871,43,35-39,1914,1.8166533396652549
SIM,1928,16,40-44,1944,2
STAT,1899,36,15-19,1935,0.07882378717028171
SIM,1868,15,na,1883,2579
STAT,1951,16,25-29,1967,52.65836261230782
STAT,1849,103,na,1952,0.11141939874363711
STAT,1867,40,40-44,1907,2.1759394789539273
STAT,1847,41,na,1888,1835.7560380071411
SIM,1880,49,na,1929,2100
STAT,1922,39,20-24,1961,0.3054088367693665
STAT,1907,2,na,1909,3992.8572611468026
STAT,1889,32,40-44,1921,5.464885669007253
SIM,1870,31,25-29,1901,21
STAT,1863,52,40-44,1915,0.009366345501944573
SIM,1847,44,45-49,1891,2
SIM,1897,32,40-44,1929,12
STAT,1895,43,20-24,1938,0.014572755351790421
STAT,1824,35,50-100,1859,1.8337266420483909
SIM,1883,31,35-39,1914,14
SIM,1884,70,na,1954,1252
STAT,1896,58,na,1954,2664.5227831819566
STAT,1810,92,na,1902,17.75653343760186
STAT,1838,64,na,1902,1277.2625866757617
STAT,1884,43,45-49,1927,1.4996211578503205
STAT,1864,29,45-49,1893,0.999938131245382
SIM,1879,55,na,1934,2554
STAT,1827,51,25-29,1878,0.003914767151259057
STAT,1863,34,na,1897,2116.165807019581
STAT,1897,23,35-39,1920,7.935212515723392
STAT,1900,47,20-24,1947,0.009526404620022319
SIM,1820,34,30-34,1854,23
STAT,1885,30,15-19,1915,0.14610455501393804
STAT,1885,49,35-39,1934,0.1395139691556674
SIM,1875,37,15-19,1912,3
STAT,1839,44,45-49,1883,1.0610896135664722
STAT,1908,23,20-24,1931,103.91831702986426
STAT,1874,74,na,1948,1155.913443822722
STAT,1937,14,na,1951,3919.095314169707
STAT,1845,50,30-34,1895,0.004717843268403413
SIM,1925,6,na,1931,5052
STAT,1817,52,45-49,1869,0.03108467208171315
SIM,1864,56,na,1920,1934
SIM,1901,15,25-29,1916,14
STAT,1792,65,na,1857,704.6056858579524
SIM,1910,27,35-39,1937,26
STAT,1892,17,20-24,1909,22.667024558198936
STAT,1893,30,40-44,1923,5.657459159351843
STAT,1902,27,35-39,1929,13.881387497571568
SIM,1919,17,45-49,1936,2
STAT,1922,15,na,1937,4366.709592594125
SIM,1884,37,25-29,1921,5
STAT,1821,46,40-44,1867,0.27381038462244867
STAT,1867,37,15-19,1904,0.05378100443284885
STAT,1881,59,na,1940,1916.7947736558299
SIM,1827,61,na,1888,1074
SIM,1863,17,35-39,1880,1
STAT,1841,53,na,1894,1564.2712089165084
STAT,1869,53,20-24,1922,7.151137442494783E-4
SIM,1848,27,50-100,1875,1
SIM,1951,18,na,1969,4918
STAT,1911,39,45-49,1950,0.6648834893858081
SIM,1853,16,na,1869,2265
SIM,1916,23,20-24,1939,120
SIM,1818,87,na,1905,53
SIM,1932,11,na,1943,5537
STAT,1920,26,40-44,1946,5.235758091271822
STAT,1894,42,25-29,1936,0.05844331339122683
STAT,1898,30,25-29,1928,14.243790252726194
SIM,1892,43,45-49,1935,1
STAT,1903,48,50-100,1951,0.19837978063759099
SIM,1924,32,45-49,1956,1
STAT,1829,27,35-39,1856,13.727111561157333
STAT,1931,16,50-100,1947,0.5013538517950792
STAT,1850,23,45-49,1873,0.6250465285767407
STAT,1899,32,na,1931,3333.6042300803106
STAT,1921,33,30-34,1954,17.815868241869417
STAT,1826,79,na,1905,407.74662367499485
SIM,1875,40,40-44,1915,3
STAT,1918,45,25-29,1963,0.05787560255458337
STAT,1866,45,na,1911,2138.1389974147396
STAT,1802,69,na,1871,633.9455929592339
STAT,1858,19,na,1877,2143.779668994846
STAT,1909,33,na,1942,3665.2780631998417
STAT,1918,49,40-44,1967,0.17020977488067304
SIM,1908,23,na,1931,3830
STAT,1880,42,30-34,1922,1.2309610077543396
SIM,1790,76,na,1866,276
STAT,1836,43,15-19,1879,0.010096247622545516
STAT,1873,16,40-44,1889,0.19028820927197332
SIM,1946,0,na,1946,4569
SIM,1916,33,50-100,1949,2
STAT,1813,51,30-34,1864,0.014575743077916117
STAT,1912,34,35-39,1946,9.094524128391743
STAT,1858,35,15-19,1893,0.045860920361707434
SIM,1887,25,40-44,1912,5
SIM,1861,42,na,1903,2440
SIM,1876,41,na,1917,2699
STAT,1848,34,50-100,1882,0.74029707028137
SIM,1902,22,15-19,1924,4
STAT,1908,33,50-100,1941,0.7924587736788052
STAT,1834,30,35-39,1864,8.912796042505745
SIM,1845,83,na,1928,368
STAT,1804,52,35-39,1856,0.025251732368073335
STAT,1892,4,na,1896,3363.4970846771503
SIM,1837,27,35-39,1864,13
STAT,1773,98,na,1871,0.5611155793892738
STAT,1851,16,20-24,1867,17.888322246359706
STAT,1859,46,20-24,1905,0.009804337454144428
SIM,1911,32,35-39,1943,11
STAT,1828,52,20-24,1880,5.573815692110983E-4
SIM,1864,22,35-39,1886,7
STAT,1846,93,na,1939,20.899715117862705
STAT,1871,40,50-100,1911,1.0783428264210926
SIM,1842,30,35-39,1872,20
SIM,1947,10,na,1957,4673
STAT,1795,79,na,1874,252.34228750610868
STAT,1844,45,30-34,1889,0.07619434760257372
SIM,1898,22,na,1920,3654
STAT,1896,18,35-39,1914,0.7373681759260636
SIM,1938,23,40-44,1961,2
STAT,1921,46,45-49,1967,0.2506382139264867
SIM,1891,23,40-44,1914,3
STAT,1879,25,40-44,1904,3.216005961921815
STAT,1889,16,50-100,1905,0.061888430495063526
SIM,1914,23,na,1937,3784
STAT,1893,27,15-19,1920,0.5871575375275719
STAT,1903,32,35-39,1935,14.685913190386728
STAT,1907,20,35-39,1927,8.793042623033235
STAT,1926,21,15-19,1947,6.617311575713996
SIM,1943,23,15-19,1966,8
SIM,1948,7,na,1955,4542
STAT,1860,18,20-24,1878,16.824325364684043
STAT,1881,48,20-24,1929,0.01168661796364255
SIM,1865,33,50-100,1898,1
SIM,1885,39,50-100,1924,4
SIM,1925,38,35-39,1963,4
SIM,1831,69,na,1900,940
SIM,1854,97,na,1951,11
STAT,1914,47,15-19,1961,3.7274711526427327E-4
SIM,1917,37,na,1954,3865
STAT,1817,68,na,1885,829.9522696415944
STAT,1815,39,na,1854,1647.9045713421972
STAT,1862,47,40-44,1909,0.1479769778415755
STAT,1814,54,na,1868,1274.6105817429395
STAT,1872,50,25-29,1922,0.0036735008918925977
SIM,1830,84,na,1914,164
STAT,1928,39,50-100,1967,0.5400784737242615
SIM,1852,68,na,1920,1245
STAT,1857,33,50-100,1890,0.7269095829919802
SIM,1883,23,na,1906,2578
STAT,1870,8,na,1878,2716.7629146473264
SIM,1829,36,40-44,1865,7
SIM,1887,81,na,1968,1055
SIM,1935,22,na,1957,5099
SIM,1929,21,40-44,1950,3
STAT,1931,40,30-34,1971,0.1746672230174689
SIM,1824,32,40-44,1856,5
SIM,1866,39,30-34,1905,12
SIM,1882,21,40-44,1903,3
STAT,1888,27,40-44,1915,3.6127105796945385
SIM,1800,77,na,1877,396
SIM,1915,20,35-39,1935,3
SIM,1848,37,20-24,1885,1
SIM,1872,82,na,1954,258
STAT,1788,97,na,1885,1.0775519876575541
STAT,1935,33,25-29,1968,13.032227304200417
SIM,1832,23,35-39,1855,5
STAT,1822,80,na,1902,359.67910520975136
STAT,1869,59,na,1928,1914.1342270282398
STAT,1839,34,35-39,1873,8.424168330992302
STAT,1860,30,45-49,1890,1.45498863415415
STAT,1924,24,50-100,1948,0.787190646857347
STAT,1917,38,35-39,1955,2.5510406229528306
SIM,1932,24,50-100,1956,3
STAT,1767,98,na,1865,0.37641265694533665
STAT,1905,45,15-19,1950,3.35749570569776E-4
SIM,1821,76,na,1897,461
SIM,1851,83,na,1934,162
SIM,1867,67,na,1934,1304
STAT,1778,100,na,1878,0.14026816685421276
STAT,1881,52,25-29,1933,0.003474810072406098
SIM,1934,21,15-19,1955,14
STAT,1847,8,na,1855,2390.04117
SIM,1946,24,45-49,1970,1
STAT,1885,36,20-24,1921,0.7883297507731263
SIM,1846,68,na,1914,1069
STAT,1812,49,35-39,1861,0.3201662718417002
STAT,1866,32,50-100,1898,0.8621597459647765
STAT,1889,73,na,1962,1727.1514023674554
STAT,1818,45,20-24,1863,0.028119060383024808
SIM,1907,34,50-100,1941,2
STAT,1916,32,45-49,1948,1.6578762894608943
SIM,1851,24,15-19,1875,2
SIM,1893,36,20-24,1929,1
SIM,1869,26,35-39,1895,15
STAT,1861,33,30-34,1894,14.655877358376221
STAT,1877,39,50-100,1916,1.2859829507390244
STAT,1870,38,35-39,1908,7.018575082801356
STAT,1938,24,45-49,1962,1.135187068144649
STAT,1915,25,50-100,1940,1.043020952205401
SIM,1812,62,na,1874,917
SIM,1847,34,35-39,1881,10
SIM,1887,8,na,1895,3060
STAT,1943,15,20-24,1958,146.75709700588396
STAT,1929,18,40-44,1947,1.8158762007425258
STAT,1820,54,na,1874,1263.4116399375346
SIM,1841,20,40-44,1861,1
STAT,1820,35,35-39,1855,19.23414405820186
STAT,1843,24,15-19,1867,3.2950460577002816
STAT,1843,42,45-49,1885,1.2439756306245198
STAT,1848,46,45-49,1894,0.18397146488000005
STAT,1948,19,20-24,1967,158.19110543752032
SIM,1857,39,20-24,1896,1
SIM,1879,33,35-39,1912,12
STAT,1868,42,15-19,1910,0.01343928072366335
STAT,1918,40,30-34,1958,0.1390963443919265
STAT,1871,30,20-24,1901,2.7534636832017125
STAT,1850,54,20-24,1904,5.39802563520844E-4
SIM,1869,96,na,1965,43
SIM,1902,38,na,1940,3452
STAT,1913,41,25-29,1954,0.07145066163616588
SIM,1923,25,50-100,1948,1
STAT,1805,106,na,1911,0.004880071566295366
SIM,1815,76,na,1891,334
STAT,1779,83,na,1862,104.27887628267719
STAT,1768,103,na,1871,0.0702406877457222
STAT,1909,33,15-19,1942,0.1245368518680839
STAT,1829,53,na,1882,1481.8020379610164
STAT,1831,27,50-100,1858,0.6329993062844619
STAT,1844,35,20-24,1879,0.708208444510749
STAT,1812,44,40-44,1856,5.649302114696875
SIM,1870,47,40-44,1917,1
STAT,1849,39,20-24,1888,0.599793014399289
STAT,1942,22,45-49,1964,1.2036155130418995
SIM,1908,31,15-19,1939,1
SIM,1838,32,35-39,1870,17
STAT,1853,41,25-29,1894,0.5408841781374766
SIM,1888,35,35-39,1923,12
SIM,1902,36,40-44,1938,3
STAT,1880,74,na,1954,1189.7262148944276
STAT,1912,44,45-49,1956,0.16247929215379872
STAT,1883,23,40-44,1906,2.079375438108022
SIM,1855,26,40-44,1881,5
SIM,1820,44,40-44,1864,6
SIM,1843,33,20-24,1876,5
SIM,1837,17,25-29,1854,7
STAT,1838,24,40-44,1862,1.9580006012413884
STAT,1834,40,45-49,1874,1.2457056247212048
STAT,1864,19,35-39,1883,0.5088373298542922
SIM,1867,30,na,1897,2253
SIM,1941,20,45-49,1961,1
STAT,1875,59,na,1934,2034.8276712335926
STAT,1927,42,30-34,1969,0.16355634211020012
STAT,1912,21,20-24,1933,109.0371657809642
STAT,1852,26,15-19,1878,0.4287957425169971
STAT,1865,34,45-49,1899,1.600786256904741
SIM,1920,21,20-24,1941,124
STAT,1903,38,40-44,1941,1.3633854831751528
SIM,1906,19,25-29,1925,16
SIM,1875,96,na,1971,65
STAT,1869,18,40-44,1887,0.18156156113663344
SIM,1852,31,na,1883,2161
SIM,1969,1,na,1970,5106
STAT,1871,49,40-44,1920,0.1693896706312415
STAT,1877,44,15-19,1921,0.01441475247890204
STAT,1835,53,na,1888,1602.785488624108
SIM,1892,37,na,1929,3451
STAT,1869,100,na,1969,7.054110078837558
STAT,1898,15,50-100,1913,0.0679008834133037
STAT,1880,32,20-24,1912,2.8977590182733794
SIM,1851,42,45-49,1893,4
SIM,1923,37,na,1960,4267
STAT,1835,33,20-24,1868,2.5386067392010223
STAT,1813,41,20-24,1854,0.6025706828221076
STAT,1831,50,50-100,1881,0.011304527345372087
STAT,1933,20,45-49,1953,1.5311474679701031
STAT,1850,97,na,1947,4.041026598255463
STAT,1861,32,40-44,1893,3.6557142793923285
STAT,1864,33,20-24,1897,2.441549770516758
STAT,1882,29,30-34,1911,24.84882890558813
SIM,1848,46,35-39,1894,1
STAT,1910,46,20-24,1956,0.010542201508491446
STAT,1887,38,20-24,1925,0.8768124319372108
SIM,1816,40,30-34,1856,2
STAT,1879,23,na,1902,2514.188487246428
SIM,1924,21,15-19,1945,8
STAT,1842,27,35-39,1869,9.357398205443735
STAT,1861,49,na,1910,1856.9459217806107
STAT,1884,37,40-44,1921,4.418137478816796
SIM,1841,29,35-39,1870,9
STAT,1940,25,50-100,1965,1.0363584953617324
SIM,1834,31,35-39,1865,2
SIM,1859,44,45-49,1903,4
SIM,1965,1,na,1966,4976
SIM,1832,41,50-100,1873,2
SIM,1887,19,30-34,1906,3
STAT,1875,31,30-34,1906,18.35521587703988
SIM,1846,38,25-29,1884,2
SIM,1949,22,30-34,1971,62
STAT,1840,19,25-29,1859,5.217586346511309
SIM,1843,37,45-49,1880,6
SIM,1936,5,na,1941,3510
SIM,1883,39,40-44,1922,5
STAT,1849,44,35-39,1893,1.386868102360002
STAT,1861,44,35-39,1905,1.505854183196541
STAT,1883,50,20-24,1933,7.492462500665096E-4
SIM,1919,7,na,1926,4558
STAT,1880,16,15-19,1896,6.377639384895368
SIM,1860,34,40-44,1894,6
STAT,1866,53,25-29,1919,0.0032794147738437448
STAT,1887,42,na,1929,2638.8025353901867
SIM,1890,29,30-34,1919,36
SIM,1879,2,na,1881,3506
SIM,1844,14,na,1858,2440
SIM,1904,30,50-100,1934,1
SIM,1823,38,30-34,1861,7
SIM,1848,28,na,1876,2031
SIM,1881,23,20-24,1904,2
STAT,1833,21,25-29,1854,75.09747338702442
SIM,1916,17,na,1933,4196
SIM,1948,3,na,1951,4592
STAT,1811,50,30-34,1861,0.016399582368777848
STAT,1916,21,15-19,1937,5.709404226493106
SIM,1878,26,na,1904,2639
SIM,1832,23,25-29,1855,59
STAT,1889,46,30-34,1935,0.12232823271984247
STAT,1824,36,30-34,1860,7.65234483736614
SIM,1808,63,na,1871,1065
STAT,1828,31,na,1859,1601.07909412405
STAT,1893,22,35-39,1915,7.5519658955976805
SIM,1886,40,50-100,1926,4
STAT,1844,35,45-49,1879,1.8314927118362827
SIM,1860,46,35-39,1906,1
STAT,1888,17,30-34,1905,1.922238749118048
STAT,1838,38,25-29,1876,2.5263011984572223
SIM,1855,6,na,1861,2310
SIM,1894,32,45-49,1926,1
STAT,1871,51,40-44,1922,0.010689350054243799
STAT,1874,52,20-24,1926,7.644970912874548E-4
SIM,1835,53,na,1888,1448
SIM,1841,21,25-29,1862,68
STAT,1854,54,45-49,1908,0.010801703986200487
STAT,1895,61,na,1956,2511.163008367117
SIM,1799,85,na,1884,150
SIM,1852,35,45-49,1887,2
STAT,1863,52,45-49,1915,0.012911551054175853
SIM,1830,28,20-24,1858,13
SIM,1827,34,na,1861,1705
SIM,1895,25,15-19,1920,1
STAT,1891,27,30-34,1918,31.804687461073424
SIM,1910,12,na,1922,3980
STAT,1847,36,25-29,1883,2.3538468879875105
STAT,1895,30,45-49,1925,2.339703327069382
SIM,1836,70,na,1906,1059
STAT,1856,111,na,1967,6.494736207221719E-4
SIM,1889,27,40-44,1916,9
STAT,1845,28,15-19,1873,0.42839055869679854
STAT,1864,45,15-19,1909,3.6644990494687316E-4
STAT,1901,48,20-24,1949,0.009535179422781462
SIM,1863,35,20-24,1898,1
STAT,1871,23,50-100,1894,0.4108089181293218
STAT,1842,78,na,1920,612.7247062434859
STAT,1900,39,15-19,1939,0.0169652500639139
STAT,1855,35,20-24,1890,0.6032358366773009
STAT,1908,15,30-34,1923,2.422166831317904
STAT,1887,25,15-19,1912,0.5221611626008456
SIM,1827,41,45-49,1868,4
SIM,1795,71,na,1866,563
SIM,1829,26,30-34,1855,32
SIM,1939,15,25-29,1954,75
STAT,1882,11,na,1893,2570.5260578828515
SIM,1820,87,na,1907,116
STAT,1855,47,15-19,1902,3.086334457314154E-4
STAT,1853,30,na,1883,2103.7712450597055
STAT,1831,26,20-24,1857,12.025851442088287
STAT,1871,18,15-19,1889,6.0001901143860765
STAT,1873,26,25-29,1899,43.9003661286744
SIM,1842,30,30-34,1872,29
STAT,1886,32,45-49,1918,1.883000305257055
STAT,1919,37,na,1956,4124.502646206005
STAT,1819,70,na,1889,865.1792423874227
SIM,1825,33,35-39,1858,16
SIM,1883,48,50-100,1931,1
STAT,1870,42,35-39,1912,1.8036337294859266
STAT,1873,43,15-19,1916,0.014179634668278613
STAT,1884,24,35-39,1908,5.852778351074374
STAT,1802,52,30-34,1854,0.01577463979273123
STAT,1835,42,40-44,1877,2.0088662607356147
STAT,1812,48,na,1860,1379.0609053913543
STAT,1856,34,25-29,1890,8.132088461783844
STAT,1915,23,na,1938,3840.098692801798
STAT,1793,107,na,1900,9.446792282510022E-4
STAT,1853,33,45-49,1886,1.4902010992798629
STAT,1851,25,35-39,1876,9.45597921608541
STAT,1879,39,25-29,1918,3.0393456467868463
STAT,1898,44,30-34,1942,0.10865036723298513
STAT,1866,80,na,1946,582.0806648354044
STAT,1949,19,35-39,1968,4.9756674421721
STAT,1823,44,15-19,1867,0.021247486797355147
SIM,1840,22,20-24,1862,61
SIM,1869,97,na,1966,29
SIM,1912,9,na,1921,4236
SIM,1890,21,20-24,1911,98
STAT,1869,40,45-49,1909,1.4889272631257862
SIM,1894,64,na,1958,2402
STAT,1803,51,35-39,1854,0.035482999153925644
STAT,1890,35,15-19,1925,0.07070886784456744
SIM,1872,4,na,1876,2917
STAT,1919,21,40-44,1940,3.768544587410961
SIM,1865,83,na,1948,270
STAT,1896,36,20-24,1932,1.0436047723329651
STAT,1847,49,30-34,1896,0.07390981180102872
STAT,1852,34,40-44,1886,3.5429270089186953
SIM,1887,39,25-29,1926,3
STAT,1889,2,na,1891,3359.114389951243
STAT,1923,42,na,1965,4428.962046774387
STAT,1889,33,25-29,1922,12.852684407805697
SIM,1864,34,25-29,1898,12
STAT,1847,16,30-34,1863,1.56047796326612
SIM,1892,24,35-39,1916,12
SIM,1877,40,45-49,1917,1
STAT,1833,34,30-34,1867,14.596224391077671
STAT,1835,37,45-49,1872,1.837016210618996
STAT,1875,51,25-29,1926,0.00372626911709989
STAT,1882,21,20-24,1903,68.69730967449712
SIM,1890,50,na,1940,2865
STAT,1883,16,40-44,1899,0.18352928640658023
SIM,1927,21,40-44,1948,1
STAT,1834,30,30-34,1864,15.36623736591546
STAT,1832,22,20-24,1854,113.61191057612444
SIM,1886,45,na,1931,2557
STAT,1829,45,20-24,1874,0.009965041595758468
STAT,1821,84,na,1905,175.29329319589888
STAT,1833,29,35-39,1862,8.339622050333245
STAT,1912,49,35-39,1961,0.12566011331109633
SIM,1855,16,30-34,1871,1
STAT,1866,19,45-49,1885,0.062349383890242714
STAT,1919,16,45-49,1935,0.11329880589861292
STAT,1825,98,na,1923,1.948029380971957
SIM,1843,42,40-44,1885,3
SIM,1897,33,25-29,1930,28
SIM,1874,33,30-34,1907,27
STAT,1948,18,na,1966,4296.258323109159
SIM,1854,43,50-100,1897,1
SIM,1876,41,40-44,1917,4
SIM,1892,37,40-44,1929,13
SIM,1890,16,25-29,1906,10
SIM,1809,50,40-44,1859,1
STAT,1950,20,50-100,1970,0.7969036383665762
SIM,1841,34,30-34,1875,29
STAT,1817,46,40-44,1863,0.38849922300889206
SIM,1858,45,40-44,1903,1
SIM,1808,49,45-49,1857,1
STAT,1865,31,na,1896,2218.5215376821598
SIM,1831,30,50-100,1861,1
SIM,1778,91,na,1869,21
SIM,1824,37,35-39,1861,4
STAT,1852,51,30-34,1903,0.00481832771358079
STAT,1892,43,25-29,1935,0.8151065166773798
SIM,1881,14,na,1895,2367
STAT,1878,81,na,1959,718.7729361665392
SIM,1875,32,35-39,1907,1
SIM,1852,33,na,1885,2077
SIM,1827,66,na,1893,955
STAT,1791,69,na,1860,614.8457730259734
STAT,1818,45,45-49,1863,0.553008166546005
STAT,1868,41,40-44,1909,2.2015375054314146
STAT,1825,52,25-29,1877,0.004392342679616137
SIM,1857,64,na,1921,1400
SIM,1853,50,na,1903,1831
STAT,1850,26,30-34,1876,22.452091201129786
STAT,1885,36,45-49,1921,2.03869383972416
STAT,1877,19,20-24,1896,18.657713269401384
STAT,1836,50,na,1886,1410.801720786207
STAT,1820,67,na,1887,864.208994798991
SIM,1882,31,na,1913,2293
STAT,1841,40,15-19,1881,0.010870465527333898
STAT,1803,87,na,1890,68.36430372872704
SIM,1851,23,35-39,1874,5
SIM,1874,28,35-39,1902,1
STAT,1833,51,20-24,1884,5.13097699457744E-4
STAT,1890,15,20-24,1905,22.216193016298966
STAT,1963,3,na,1966,5096.486057176192
SIM,1856,32,25-29,1888,16
STAT,1798,91,na,1889,23.419427605795008
SIM,1953,17,na,1970,4470
STAT,1825,35,35-39,1860,11.556927813605846
STAT,1898,19,40-44,1917,0.25097119348906494
SIM,1876,45,50-100,1921,1
STAT,1854,39,20-24,1893,0.5840349418986628
STAT,1813,53,45-49,1866,0.034138624063541234
SIM,1894,29,15-19,1923,3
SIM,1823,52,na,1875,1393
STAT,1874,47,25-29,1921,0.059714267303696375
SIM,1949,17,35-39,1966,8
STAT,1865,37,30-34,1902,4.934671150502663
SIM,1865,39,50-100,1904,3
STAT,1834,38,40-44,1872,3.6264198582778393
STAT,1837,39,20-24,1876,0.6128880316291975
STAT,1882,41,15-19,1923,0.013787373219431328
SIM,1839,28,40-44,1867,3
STAT,1830,53,45-49,1883,0.01038340160623871
STAT,1827,40,40-44,1867,2.767481981877068
STAT,1862,98,na,1960,5.90717800153942
STAT,1814,46,15-19,1860,0.0012121276680384836
STAT,1892,26,35-39,1918,12.37908863535592
SIM,1842,38,40-44,1880,2
STAT,1840,24,20-24,1864,62.16049032719909
STAT,1940,22,na,1962,3795.096176781787
STAT,1875,26,35-39,1901,10.137200112529493
STAT,1865,32,25-29,1897,9.483656330539285
SIM,1893,33,40-44,1926,6
STAT,1899,40,30-34,1939,0.11265287683305106
STAT,1860,23,35-39,1883,4.943403084813247
STAT,1894,31,40-44,1925,5.713974238663883
STAT,1946,5,na,1951,4491.442840618709
STAT,1857,12,na,1869,2235.455126038276
STAT,1809,52,40-44,1861,0.044717551099763525
SIM,1843,37,50-100,1880,2
SIM,1816,50,na,1866,1463
STAT,1876,43,40-44,1919,2.35233686154464
STAT,1888,34,20-24,1922,3.2320331171970245
SIM,1867,42,na,1909,2080
STAT,1843,23,35-39,1866,5.870594502041335
STAT,1848,51,na,1899,1681.7366983248926
STAT,1881,37,15-19,1918,0.05538397535685975
STAT,1864,14,na,1878,2439.32532624748
STAT,1897,35,25-29,1932,3.964628626185629
SIM,1864,39,30-34,1903,13
SIM,1914,20,50-100,1934,1
STAT,1792,86,na,1878,63.679240235279224
STAT,1848,45,30-34,1893,0.07599601413581686
STAT,1870,6,na,1876,2760.0349162220596
SIM,1915,26,50-100,1941,1
STAT,1872,27,20-24,1899,11.99458366088969
SIM,1840,32,na,1872,1768
STAT,1855,18,30-34,1873,1.460925309490185
SIM,1826,42,40-44,1868,1
STAT,1853,8,na,1861,2476.9119091684465
STAT,1838,18,30-34,1856,1.5377793569723752
STAT,1899,48,40-44,1947,0.1332117316881449
STAT,1777,106,na,1883,0.01551286267990538
STAT,1880,44,45-49,1924,1.5827856278465717
STAT,1923,10,na,1933,4761.497199063923
SIM,1879,27,50-100,1906,1
SIM,1897,36,50-100,1933,6
SIM,1903,42,na,1945,3257
STAT,1831,46,15-19,1877,3.3137784463892737E-4
STAT,1845,102,na,1947,0.22907138157991233
STAT,1871,59,na,1930,1963.9183906908343
SIM,1844,46,na,1890,1800
SIM,1835,40,40-44,1875,6
STAT,1848,28,40-44,1876,2.7598905221106573
STAT,1936,17,na,1953,3594.217091381269
SIM,1842,25,35-39,1867,9
SIM,1846,19,50-100,1865,1
SIM,1856,28,40-44,1884,5
SIM,1907,56,na,1963,3294
STAT,1839,42,25-29,1881,0.4670937181669239
SIM,1863,18,30-34,1881,2
SIM,1889,10,na,1899,3373
STAT,1872,50,45-49,1922,0.015051149618514444
SIM,1873,37,30-34,1910,7
SIM,1926,32,50-100,1958,1
STAT,1868,28,na,1896,2317.1650917113334
SIM,1845,39,20-24,1884,1
STAT,1819,41,45-49,1860,3.3263128432295592
STAT,1865,54,20-24,1919,6.644529528888639E-4
STAT,1891,47,25-29,1938,0.04084500091991927
SIM,1766,90,na,1856,12
SIM,1838,44,25-29,1882,4
STAT,1854,26,15-19,1880,0.4029195785518302
SIM,1882,27,30-34,1909,33
SIM,1884,43,40-44,1927,7
SIM,1867,43,40-44,1910,6
STAT,1855,50,45-49,1905,0.01141166557956122
SIM,1817,47,45-49,1864,1
STAT,1870,25,45-49,1895,1.114775928526432
STAT,1820,43,35-39,1863,3.4977566759611993
STAT,1875,21,50-100,1896,0.4282499354452276
STAT,1876,38,45-49,1914,2.0895814854187393
STAT,1908,53,na,1961,3315.919561839172
STAT,1840,87,na,1927,126.77933047963934
STAT,1875,39,40-44,1914,4.5371632902540515
STAT,1877,64,na,1941,1839.3326371517142
SIM,1832,36,30-34,1868,9
STAT,1838,43,20-24,1881,0.12260141549401722
STAT,1863,29,20-24,1892,10.418219832216703
SIM,1836,27,na,1863,2060
STAT,1860,17,50-100,1877,0.04676861929162302
STAT,1881,25,20-24,1906,11.648963151766903
STAT,1849,25,na,1874,2019.7630587521592
STAT,1858,61,na,1919,1511.7405097759465
SIM,1871,41,50-100,1912,3
SIM,1847,35,50-100,1882,1
SIM,1862,11,na,1873,2508
STAT,1808,48,40-44,1856,0.43712543230765966
SIM,1883,26,35-39,1909,1
SIM,1851,36,40-44,1887,4
SIM,1866,25,na,1891,2401
SIM,1868,42,45-49,1910,1
SIM,1888,35,25-29,1923,6
SIM,1861,30,40-44,1891,1
STAT,1873,50,na,1923,2258.9144597554473
STAT,1874,18,40-44,1892,0.19000572570943783
STAT,1845,11,na,1856,2368.2785801814
STAT,1832,68,na,1900,1021.1843122240414
SIM,1895,38,na,1933,3247
STAT,1899,35,35-39,1934,9.974494768987421
STAT,1829,28,30-34,1857,29.21262550542784
STAT,1809,47,45-49,1856,1.0497081037984226
STAT,1860,36,40-44,1896,3.640760727117854
STAT,1857,18,40-44,1875,0.17026514866954084
SIM,1891,24,na,1915,2942
SIM,1879,75,na,1954,1382
STAT,1841,23,25-29,1864,53.15999415744359
STAT,1864,28,25-29,1892,38.23580517638237
STAT,1872,47,15-19,1919,4.070648702938773E-4
SIM,1875,61,na,1936,1852
SIM,1883,80,na,1963,906
STAT,1843,36,40-44,1879,4.168505782462909
SIM,1852,40,40-44,1892,4
STAT,1819,38,15-19,1857,0.1444976423558182
STAT,1834,50,25-29,1884,0.002542804906701684
STAT,1858,93,na,1951,23.64356764451294
STAT,1850,46,25-29,1896,0.04345001127580564
STAT,1908,21,na,1929,3588.2893293652023
STAT,1902,44,20-24,1946,0.015651659370731357
SIM,1816,82,na,1898,206
SIM,1831,24,20-24,1855,61
STAT,1886,29,15-19,1915,0.4864119893228454
SIM,1855,33,20-24,1888,3
STAT,1848,32,25-29,1880,9.285009416133269
STAT,1865,41,15-19,1906,0.012844416463574105
SIM,1884,38,45-49,1922,4
STAT,1849,53,25-29,1902,0.002705726775947656
SIM,1833,35,35-39,1868,4
SIM,1883,31,30-34,1914,25
STAT,1896,19,30-34,1915,2.1359888585195073
STAT,1844,40,40-44,1884,1.831443783715308
STAT,1859,43,40-44,1902,1.8192809769992435
STAT,1874,27,30-34,1901,26.228506168017454
STAT,1939,17,25-29,1956,44.25064525925128
STAT,1812,91,na,1903,26.430359078631206
SIM,1820,41,35-39,1861,3
SIM,1922,34,50-100,1956,5
STAT,1890,23,20-24,1913,85.69148635506326
STAT,1948,16,50-100,1964,0.4375684890615471
SIM,1839,36,40-44,1875,7
STAT,1922,21,50-100,1943,0.7722570314522015
SIM,1876,44,45-49,1920,5
SIM,1944,16,45-49,1960,1
SIM,1785,93,na,1878,1
SIM,1826,44,50-100,1870,3
STAT,1818,44,50-100,1862,2.4969757964871255
STAT,1847,33,20-24,1880,2.449354221562309
STAT,1856,39,30-34,1895,4.224989578786484
STAT,1811,53,35-39,1864,0.0223300397671327
SIM,1896,23,na,1919,3188
STAT,1843,52,na,1895,1728.9408662789015
SIM,1866,57,na,1923,2097
STAT,1893,47,35-39,1940,0.10172442767675473
STAT,1898,27,40-44,1925,4.132537437685877
STAT,1827,35,45-49,1862,2.724629517022586
STAT,1849,41,30-34,1890,0.8965956578468512
SIM,1893,28,45-49,1921,1
SIM,1896,29,25-29,1925,77
SIM,1925,16,50-100,1941,1
SIM,1947,17,25-29,1964,61
STAT,1842,24,30-34,1866,17.36627023641106
SIM,1816,43,35-39,1859,4
STAT,1833,46,25-29,1879,0.04520626795442405
STAT,1837,47,20-24,1884,0.008305369479847365
STAT,1888,29,25-29,1917,50.65174459483456
SIM,1893,41,40-44,1934,3
SIM,1834,79,na,1913,445
SIM,1893,47,na,1940,2989
STAT,1824,40,15-19,1864,0.017712336908526145
STAT,1865,24,25-29,1889,52.88055854516974
STAT,1803,55,na,1858,1243.485000703497
SIM,1873,24,25-29,1897,56
SIM,1826,37,45-49,1863,4
STAT,1840,16,20-24,1856,16.61524222571634
STAT,1855,38,25-29,1893,2.220878228241209
STAT,1807,69,na,1876,847.6423078964046
SIM,1800,67,na,1867,655
STAT,1936,16,45-49,1952,0.4889938594636063
SIM,1929,26,20-24,1955,24
STAT,1910,49,25-29,1959,0.05018120372356908
STAT,1925,15,30-34,1940,15.091936290526016
STAT,1868,44,45-49,1912,1.438593318389054
STAT,1911,15,50-100,1926,0.0768295288951727
STAT,1857,43,30-34,1900,0.9093456922996868
STAT,1894,26,45-49,1920,1.4619598786817172
STAT,1900,57,na,1957,2885.8458584004006
STAT,1892,18,35-39,1910,0.6997205136861946
SIM,1841,26,30-34,1867,32
STAT,1824,49,na,1873,1392.598954131626
SIM,1931,38,na,1969,4911
STAT,1860,28,40-44,1888,2.488044340330682
SIM,1833,27,35-39,1860,13
STAT,1843,44,40-44,1887,1.8222546700971125
STAT,1859,51,40-44,1910,0.00861807141772987
STAT,1927,23,40-44,1950,4.2127164238234505
STAT,1820,35,na,1855,1572.9952565765889
STAT,1841,36,30-34,1877,4.684724012424966
SIM,1858,81,na,1939,435
SIM,1883,34,35-39,1917,9
STAT,1826,47,45-49,1873,0.1844116648491098
SIM,1843,34,40-44,1877,8
STAT,1890,43,50-100,1933,1.3082322384142064
STAT,1853,30,40-44,1883,3.823248215671689
STAT,1916,40,na,1956,3894.6756245667902
STAT,1862,66,na,1928,1423.316463013647
STAT,1854,51,40-44,1905,0.008095936679648683
STAT,1883,33,30-34,1916,17.402822511629136
STAT,1850,30,15-19,1880,0.12572470016031548
STAT,1847,19,35-39,1866,0.5277769504635376
STAT,1867,32,35-39,1899,9.69901224046858
SIM,1859,41,40-44,1900,7
SIM,1891,33,30-34,1924,34
STAT,1823,32,20-24,1855,6.886849135343841
STAT,1818,37,45-49,1855,7.495327482532384
SIM,1831,32,20-24,1863,5
STAT,1875,34,35-39,1909,10.512366112490758
STAT,1882,24,25-29,1906,56.53891370447817
STAT,1861,103,na,1964,0.5386081268605301
STAT,1907,36,na,1943,3573.95301802353
STAT,1835,34,40-44,1869,4.030801230900257
STAT,1903,22,na,1925,3429.7098968108166
STAT,1851,38,50-100,1889,1.0131807967287298
STAT,1869,45,na,1914,2237.9785930657595
SIM,1850,24,30-34,1874,21
STAT,1861,41,30-34,1902,0.9735189090491226
SIM,1881,26,25-29,1907,46
STAT,1885,28,45-49,1913,1.1260652218962182
SIM,1878,38,20-24,1916,4
SIM,1823,33,25-29,1856,13
STAT,1896,39,25-29,1935,3.8402528504013493
STAT,1840,44,15-19,1884,0.010104041636631561
STAT,1856,27,na,1883,1980.3746255608162
STAT,1844,52,35-39,1896,0.006635743453843493
STAT,1852,13,na,1865,2315.431955843142
STAT,1833,26,30-34,1859,22.43722542474643
STAT,1853,50,35-39,1903,0.007322420357734855
STAT,1858,34,35-39,1892,8.122729957809952
STAT,1873,35,15-19,1908,0.05862940428467241
SIM,1840,25,25-29,1865,39
STAT,1774,108,na,1882,0.0035816629613400664
STAT,1842,15,40-44,1857,0.18637640972275926
SIM,1919,19,15-19,1938,43
STAT,1873,23,20-24,1896,71.05248535882889
SIM,1840,17,25-29,1857,8
SIM,1828,51,na,1879,1531
SIM,1868,34,45-49,1902,2
STAT,1885,41,40-44,1926,2.299623635889145
SIM,1933,15,30-34,1948,15
SIM,1865,43,30-34,1908,3
SIM,1857,96,na,1953,3
STAT,1848,48,35-39,1896,0.10745922542466463
SIM,1853,82,na,1935,357
STAT,1899,11,na,1910,3613.0704681256166
SIM,1896,25,50-100,1921,1
SIM,1902,57,na,1959,2983
SIM,1910,44,na,1954,3489
SIM,1829,29,35-39,1858,11
STAT,1835,45,45-49,1880,0.20904738529995492
SIM,1907,24,na,1931,3524
STAT,1818,50,40-44,1868,0.023846421052857263
STAT,1832,25,25-29,1857,39.74427200912075
STAT,1891,31,15-19,1922,0.18059562270436047
STAT,1937,20,50-100,1957,0.6540408995389626
SIM,1903,10,na,1913,3706
SIM,1915,2,na,1917,4704
STAT,1790,109,na,1899,1.602421653278161E-4
SIM,1824,34,30-34,1858,17
SIM,1900,32,50-100,1932,2
STAT,1881,45,15-19,1926,3.9844373088760186E-4
STAT,1897,48,30-34,1945,0.07354499207121974
SIM,1826,50,40-44,1876,1
STAT,1829,48,25-29,1877,0.046018392440174326
SIM,1847,34,25-29,1881,8
STAT,1882,19,50-100,1901,0.04843076830989383
SIM,1881,31,50-100,1912,1
STAT,1856,31,20-24,1887,2.2139915816463316
STAT,1895,27,15-19,1922,0.6038830467984425
STAT,1857,52,20-24,1909,5.847845455895797E-4
SIM,1838,16,30-34,1854,3
STAT,1844,27,45-49,1871,1.053258359058311
STAT,1852,37,45-49,1889,1.6146701567855604
STAT,1880,41,40-44,1921,2.4222008250838187
SIM,1897,30,20-24,1927,5
STAT,1836,18,20-24,1854,20.60102130800666
STAT,1889,30,20-24,1919,3.4336221152328186
SIM,1938,19,25-29,1957,70
STAT,1857,44,na,1901,1816.5528246111212
SIM,1944,24,na,1968,3948
STAT,1771,92,na,1863,9.714711508304053
SIM,1844,18,20-24,1862,13
STAT,1847,54,50-100,1901,0.011453452055459005
STAT,1820,51,35-39,1871,0.015399776659568164
STAT,1834,33,35-39,1867,8.639431892532098
STAT,1947,16,20-24,1963,155.86054457953617
SIM,1829,38,25-29,1867,4
STAT,1879,44,20-24,1923,0.16706514931255198
SIM,1940,10,na,1950,4133
SIM,1860,37,45-49,1897,2
SIM,1955,16,20-24,1971,199
SIM,1842,33,35-39,1875,15
STAT,1897,40,20-24,1937,0.015194797830798856
STAT,1839,34,25-29,1873,8.520278520795811
STAT,1883,25,30-34,1908,25.377218488464468
STAT,1886,25,na,1911,2594.4798650884236
STAT,1840,27,25-29,1867,37.95425580243982
STAT,1887,74,na,1961,1465.8966911721657
SIM,1871,79,na,1950,884
STAT,1883,60,na,1943,1909.0209345643937
SIM,1848,38,35-39,1886,11
SIM,1854,24,15-19,1878,9
STAT,1910,38,20-24,1948,0.2558606823183574
SIM,1882,22,25-29,1904,77
STAT,1889,38,30-34,1927,6.682721964525086
STAT,1828,36,15-19,1864,0.05032748071334411
SIM,1819,47,na,1866,1411
STAT,1880,48,50-100,1928,0.25998221852884057
STAT,1763,110,na,1873,6.767878132319305E-4
STAT,1854,79,na,1933,535.0634320721766
SIM,1822,35,na,1857,1563
STAT,1827,43,45-49,1870,1.740349414341484
STAT,1850,65,na,1915,1271.1979675820546
STAT,1891,47,na,1938,2828.8226909570494
SIM,1856,15,na,1871,2751
SIM,1859,29,20-24,1888,13
SIM,1863,27,20-24,1890,9
SIM,1896,37,25-29,1933,5
SIM,1826,49,na,1875,1497
STAT,1842,32,30-34,1874,16.540264052905496
SIM,1876,36,45-49,1912,4
STAT,1870,30,40-44,1900,4.359609318304668
SIM,1891,25,30-34,1916,8
STAT,1861,52,35-39,1913,0.007218529874945964
SIM,1812,68,na,1880,713
SIM,1838,41,20-24,1879,1
STAT,1833,54,25-29,1887,0.0023207970140869272
STAT,1824,44,30-34,1868,1.3617494750619041
STAT,1906,15,20-24,1921,26.44644014909409
STAT,1851,42,25-29,1893,0.5291384547001259
SIM,1871,29,20-24,1900,15
STAT,1884,45,40-44,1929,0.17451181728614995
STAT,1812,107,na,1919,0.0021509757965004488
SIM,1825,33,50-100,1858,4
SIM,1811,83,na,1894,45
STAT,1832,36,na,1868,1814.2860217510563
STAT,1891,9,na,1900,3277.016249914098
STAT,1868,36,45-49,1904,1.951737180031785
SIM,1868,31,50-100,1899,1
STAT,1888,37,25-29,1925,3.472369960766325
SIM,1881,46,na,1927,2065
STAT,1829,37,20-24,1866,0.6740012428635318
SIM,1909,33,40-44,1942,3
STAT,1876,52,30-34,1928,0.006237208974904743
STAT,1933,17,50-100,1950,0.5114708994994241
STAT,1845,31,45-49,1876,1.6369641206833914
STAT,1866,45,25-29,1911,0.05474023165541781
SIM,1849,42,35-39,1891,7
SIM,1861,42,35-39,1903,3
STAT,1917,16,35-39,1933,0.9237429703358734
SIM,1921,23,50-100,1944,1
STAT,1817,54,40-44,1871,0.021666313231823116
STAT,1929,15,na,1944,4813.3428097616215
STAT,1831,51,na,1882,1534.327108270789
STAT,1852,21,35-39,1873,5.625041734896461
STAT,1831,41,45-49,1872,1.2854771185241758
STAT,1894,12,na,1906,3388.8155015459865
SIM,1957,8,na,1965,5607
STAT,1860,39,45-49,1899,1.6334304733461678
STAT,1898,26,na,1924,3303.632340731626
SIM,1878,58,na,1936,2203
STAT,1878,48,20-24,1926,0.012582227350183467
STAT,1937,20,45-49,1957,1.118409895597007
SIM,1841,37,35-39,1878,6
SIM,1857,44,35-39,1901,1
SIM,1861,33,45-49,1894,2
SIM,1874,44,na,1918,2319
SIM,1925,16,35-39,1941,11
STAT,1841,53,20-24,1894,5.360966794879061E-4
STAT,1849,16,40-44,1865,0.17582474538933252
STAT,1886,17,50-100,1903,0.05290202347664483
SIM,1870,30,na,1900,2641
STAT,1852,29,45-49,1881,0.9344880576601723
STAT,1858,47,40-44,1905,0.1378564089846999
STAT,1833,37,35-39,1870,5.85679222212946
STAT,1897,32,20-24,1929,3.6870710266161235
STAT,1816,42,30-34,1858,2.727508503492851
STAT,1860,20,30-34,1880,16.944005417558134
STAT,1857,26,40-44,1883,2.476036134283384
SIM,1849,13,na,1862,2277
SIM,1883,23,30-34,1906,3
STAT,1828,63,na,1891,982.5570004104734
STAT,1892,35,25-29,1927,3.716192878952238
STAT,1811,45,35-39,1856,0.40281197310659206
SIM,1842,22,30-34,1864,26
SIM,1865,35,30-34,1900,4
SIM,1815,39,35-39,1854,7
SIM,1846,80,na,1926,330
SIM,1884,35,40-44,1919,8
STAT,1870,17,45-49,1887,0.0657642567205351
STAT,1921,47,35-39,1968,0.14831495089249705
STAT,1837,67,na,1904,1056.906820585194
SIM,1806,72,na,1878,655
SIM,1898,17,40-44,1915,4
SIM,1932,23,na,1955,4982
STAT,1825,44,25-29,1869,0.8409504297257038
STAT,1838,51,20-24,1889,5.50088753807762E-4
SIM,1851,44,40-44,1895,6
STAT,1851,17,35-39,1868,0.5503937431090348
STAT,1854,34,15-19,1888,0.1093207170947329
SIM,1865,26,40-44,1891,3
STAT,1829,80,na,1909,411.41839775601585
SIM,1817,44,40-44,1861,4
STAT,1902,47,25-29,1949,0.0465253940946231
SIM,1860,21,35-39,1881,9
SIM,1855,36,25-29,1891,1
STAT,1826,39,45-49,1865,1.6905165064492946
SIM,1834,39,45-49,1873,4
STAT,1876,35,40-44,1911,4.65518502222194
STAT,1896,28,20-24,1924,15.750772770012297
STAT,1850,51,20-24,1901,5.577223093200596E-4
STAT,1826,31,35-39,1857,11.910582070520114
SIM,1888,27,25-29,1915,82
SIM,1856,37,30-34,1893,7
STAT,1922,25,na,1947,4354.641675895282
STAT,1903,48,30-34,1951,0.07818877367803494
STAT,1790,95,na,1885,2.7810584106649836
STAT,1834,22,30-34,1856,16.031399270904473
STAT,1926,39,na,1965,4680.600546032896
STAT,1848,83,na,1931,308.59113642654063
SIM,1920,22,na,1942,3919
STAT,1914,49,45-49,1963,0.21863193610406023
SIM,1924,36,na,1960,4552
STAT,1869,37,15-19,1906,0.055307101373852634
STAT,1871,21,45-49,1892,0.7067880566148333
SIM,1822,37,25-29,1859,5
SIM,1893,7,na,1900,3439
STAT,1808,49,50-100,1857,0.6049910866119398
SIM,1872,33,20-24,1905,1
SIM,1816,49,50-100,1865,1
STAT,1912,26,50-100,1938,1.004050319929967
STAT,1832,42,15-19,1874,0.011347117264892527
STAT,1848,37,30-34,1885,4.269295913574858
STAT,1841,28,30-34,1869,22.927743284334156
STAT,1880,52,45-49,1932,0.015474915779796247
SIM,1835,43,45-49,1878,2
SIM,1827,33,45-49,1860,2
STAT,1820,40,30-34,1860,2.4162268332194787
SIM,1857,41,30-34,1898,2
STAT,1846,24,15-19,1870,2.8692807743292343
SIM,1880,42,45-49,1922,6
STAT,1796,105,na,1901,0.00637848892141578
STAT,1930,35,50-100,1965,0.5595176361381423
STAT,1841,20,20-24,1861,65.39268051299356
SIM,1897,49,35-39,1946,1
STAT,1849,49,40-44,1898,0.13013780364565933
STAT,1894,34,45-49,1928,2.268683937232954
STAT,1889,49,35-39,1938,0.09743782274048764
SIM,1850,32,30-34,1882,24
STAT,1860,40,25-29,1900,0.53688578554959
STAT,1805,51,45-49,1856,0.052178476574526386
STAT,1819,102,na,1921,0.17284337534131744
STAT,1872,42,45-49,1914,1.5283253580097746
STAT,1867,34,50-100,1901,0.8700044658147964
STAT,1876,58,na,1934,2083.2592968501567
SIM,1906,16,25-29,1922,10
STAT,1886,24,45-49,1910,0.7482625101780226
SIM,1861,26,na,1887,2530
SIM,1889,39,35-39,1928,15
STAT,1881,28,25-29,1909,41.5740778270306
SIM,1919,22,45-49,1941,1
SIM,1894,24,45-49,1918,1
STAT,1833,29,50-100,1862,0.5528896582882039
STAT,1855,41,50-100,1896,0.8226652824387275
STAT,1834,49,45-49,1883,0.16416922357081357
SIM,1900,29,15-19,1929,1
STAT,1908,37,50-100,1945,0.40084820626945383
SIM,1891,36,35-39,1927,12
SIM,1876,28,45-49,1904,5
STAT,1835,51,30-34,1886,0.004612147540591266
SIM,1879,29,25-29,1908,73
STAT,1872,44,na,1916,2331.1829199409863
SIM,1867,31,na,1898,2195
STAT,1839,39,30-34,1878,4.3051303595689
STAT,1856,43,15-19,1899,0.010979072422685362
STAT,1820,34,45-49,1854,5.2291971007020015
SIM,1886,13,na,1899,2900
STAT,1836,48,50-100,1884,0.15795667734097985
STAT,1917,41,25-29,1958,0.07615855716471312
SIM,1902,37,25-29,1939,1
SIM,1870,20,40-44,1890,2
STAT,1830,47,50-100,1877,0.20382703846138553
STAT,1827,32,40-44,1859,6.697239078931095
SIM,1873,21,20-24,1894,91
STAT,1768,93,na,1861,8.857641158232834
STAT,1810,53,50-100,1863,0.04432694250445707
STAT,1823,35,25-29,1858,5.7304964170224455
STAT,1865,45,30-34,1910,0.09052094066023843
SIM,1870,32,35-39,1902,27
SIM,1822,67,na,1889,851
STAT,1821,52,na,1873,1267.2728709965245
STAT,1859,38,45-49,1897,1.6160677955859988
STAT,1867,41,25-29,1908,0.6177969468635252
SIM,1908,24,35-39,1932,9
STAT,1868,39,na,1907,2272.483166488732
STAT,1825,66,na,1891,982.8534516924835
STAT,1938,26,20-24,1964,18.455921807688824
SIM,1880,19,20-24,1899,22
STAT,1842,40,30-34,1882,0.9569870867778966
STAT,1851,46,40-44,1897,0.14164399047263787
STAT,1863,37,20-24,1900,0.6894871151143401
STAT,1894,23,40-44,1917,2.7259625713865225
STAT,1857,76,na,1933,754.814389594819
SIM,1847,39,30-34,1886,2
STAT,1853,62,na,1915,1532.5501595554856
STAT,1881,17,20-24,1898,17.48524991516019
SIM,1831,35,25-29,1866,5
STAT,1864,52,50-100,1916,0.013626507801247094
SIM,1879,17,30-34,1896,3
STAT,1844,35,50-100,1879,1.1279743762041128
STAT,1818,54,35-39,1872,0.018002382532871553
STAT,1887,28,50-100,1915,0.7286797142606621
SIM,1863,42,45-49,1905,3
STAT,1797,104,na,1901,0.016796102996292556
STAT,1865,21,20-24,1886,65.04894376119378
STAT,1953,16,45-49,1969,0.6165890334482874
STAT,1872,33,na,1905,2429.539072984551
STAT,1872,19,20-24,1891,18.028969224947737
STAT,1914,38,na,1952,3813.5366913729267
STAT,1898,34,50-100,1932,1.253186834333157
STAT,1910,24,na,1934,3632.2200732709457
STAT,1866,28,35-39,1894,9.047394639326622
STAT,1874,31,15-19,1905,0.14893255624082782
STAT,1872,35,20-24,1907,0.7956238087927653
SIM,1845,18,15-19,1863,9
SIM,1948,22,15-19,1970,5
SIM,1835,96,na,1931,8
STAT,1854,21,45-49,1875,0.6316117000568444
STAT,1844,26,na,1870,2066.9675404330533
STAT,1857,22,25-29,1879,52.65257596457593
STAT,1879,52,20-24,1931,7.826950403263182E-4
STAT,1899,32,30-34,1931,24.390696150602974
SIM,1847,26,25-29,1873,42
STAT,1834,41,35-39,1875,1.4880165332979496
SIM,1871,47,na,1918,2046
STAT,1882,75,na,1957,1092.715218175863
STAT,1883,17,30-34,1900,1.5954082248205765
STAT,1819,59,na,1878,1281.2704160747141
SIM,1873,33,15-19,1906,4
STAT,1819,46,15-19,1865,8.040630793161506E-4
STAT,1846,48,25-29,1894,0.04067344680210828
STAT,1846,16,15-19,1862,5.362815686115761
STAT,1826,53,30-34,1879,0.004403017287297712
SIM,1862,21,45-49,1883,3
STAT,1815,105,na,1920,0.015160998889403447
STAT,1894,42,45-49,1936,0.1362106250991601
STAT,1842,41,20-24,1883,0.13051355623609454
STAT,1886,37,15-19,1923,0.06063637532823282
SIM,1884,46,45-49,1930,2
SIM,1860,84,na,1944,359
STAT,1893,44,30-34,1937,0.10192399084178821
SIM,1854,16,15-19,1870,6
STAT,1833,43,20-24,1876,0.12569615837937426
SIM,1864,98,na,1962,8
STAT,1824,41,50-100,1865,1.3280015506862697
STAT,1827,51,45-49,1878,0.016039671106460252
SIM,1843,29,na,1872,2005
STAT,1880,49,15-19,1929,4.198582275115147E-4
STAT,1889,37,40-44,1926,5.51628228138089
STAT,1837,18,15-19,1855,6.068451592796241
STAT,1856,47,30-34,1903,0.07715638700609818
SIM,1847,31,20-24,1878,3
STAT,1842,48,40-44,1890,0.13256889930768218
STAT,1890,39,30-34,1929,6.580871881484785
STAT,1833,30,15-19,1863,0.12430786267520114
STAT,1876,46,45-49,1922,0.24931518274737482
STAT,1879,47,25-29,1926,0.06113569480900669
SIM,1882,19,30-34,1901,3
STAT,1847,7,na,1854,2409.0
STAT,1873,45,50-100,1918,0.25654408470959156
SIM,1819,41,50-100,1860,2
STAT,1815,45,na,1860,1610.7558727733292
SIM,1854,99,na,1953,4
SIM,1863,38,25-29,1901,4
STAT,1921,39,35-39,1960,2.750055813954138
SIM,1945,20,45-49,1965,2
STAT,1876,27,40-44,1903,3.1556150350086782
STAT,1901,30,50-100,1931,1.3176034522392208
STAT,1839,31,20-24,1870,2.319677781048885
SIM,1884,27,40-44,1911,4
SIM,1899,63,na,1962,2665
STAT,1843,47,45-49,1890,0.18962823323582312
SIM,1842,66,na,1908,1254
SIM,1882,38,35-39,1920,12
STAT,1843,20,30-34,1863,18.311061924113933
STAT,1885,45,35-39,1930,0.14390958592822747
STAT,1924,43,50-100,1967,0.142343011581931
SIM,1851,48,na,1899,1784
STAT,1863,83,na,1946,355.0857015710921
STAT,1892,47,40-44,1939,0.12289644007118353
STAT,1836,21,50-100,1857,0.33743036193004405
STAT,1853,41,45-49,1894,1.2606090882829837
STAT,1874,38,35-39,1912,7.330345444055314
SIM,1883,18,35-39,1901,1
STAT,1900,25,na,1925,3397.317112697383
STAT,1843,28,40-44,1871,2.9547053390218614
SIM,1937,15,15-19,1952,48
STAT,1928,36,50-100,1964,0.5417236513612977
SIM,1880,35,20-24,1915,1
STAT,1850,33,na,1883,1858.3472645103748
SIM,1835,27,45-49,1862,1
STAT,1905,23,50-100,1928,0.5989592606299041
STAT,1938,31,50-100,1969,0.8485396860101214
SIM,1825,86,na,1911,124
SIM,1850,48,40-44,1898,1
SIM,1851,28,40-44,1879,4
STAT,1823,48,30-34,1871,0.14347655934066103
STAT,1824,81,na,1905,297.7532169339409
STAT,1867,97,na,1964,17.095286448115758
STAT,1807,53,20-24,1860,0.002987666452635823
STAT,1870,50,35-39,1920,0.00870887074268533
SIM,1935,26,45-49,1961,4
STAT,1862,20,40-44,1882,1.8793369302563048
STAT,1837,54,45-49,1891,0.009409977215756541
SIM,1889,42,na,1931,3009
STAT,1807,47,35-39,1854,0.6136204223487519
STAT,1897,44,15-19,1941,0.0012904310326412754
STAT,1942,0,na,1942,4768.56286435179
SIM,1864,47,30-34,1911,1
STAT,1920,27,25-29,1947,73.68313689213116
STAT,1855,27,20-24,1882,9.479187690800924
STAT,1876,51,40-44,1927,0.011143197410214366
SIM,1814,48,na,1862,1275
SIM,1894,41,35-39,1935,2
STAT,1949,20,15-19,1969,6.341555679466627
SIM,1914,15,20-24,1929,18
STAT,1823,40,20-24,1863,0.26986586133471774
STAT,1838,84,na,1922,244.42499674176304
STAT,1834,70,na,1904,942.8904769056514
STAT,1859,5,na,1864,2378.043668294378
STAT,1861,19,45-49,1880,0.06254724841791787
STAT,1891,35,30-34,1926,6.795173209764447
STAT,1942,15,30-34,1957,13.002509690917297
STAT,1828,29,50-100,1857,0.7253778603783084
STAT,1878,40,50-100,1918,1.1331247202517216
STAT,1874,44,20-24,1918,0.16318082282941446
STAT,1927,26,45-49,1953,2.1497970151336636
STAT,1894,18,45-49,1912,0.08549280098970798
SIM,1835,32,40-44,1867,1
SIM,1858,32,35-39,1890,12
STAT,1808,51,35-39,1859,0.020981670765927662
STAT,1895,22,45-49,1917,0.9281426462504869
STAT,1852,43,30-34,1895,0.9194841335758206
STAT,1861,81,na,1942,455.8473037760641
STAT,1912,58,na,1970,3416.702031679374
SIM,1850,85,na,1935,179
SIM,1946,15,na,1961,4055
STAT,1822,36,20-24,1858,1.5304998781387915
STAT,1861,1,na,1862,3075.766088663275
SIM,1830,36,20-24,1866,4
STAT,1857,46,35-39,1903,0.1118573295838807
SIM,1851,20,30-34,1871,24
SIM,1916,23,30-34,1939,34
STAT,1865,95,na,1960,23.931207913282996
SIM,1865,46,35-39,1911,1
STAT,1890,26,25-29,1916,52.945194050557404
SIM,1897,61,na,1958,2574
STAT,1853,42,35-39,1895,1.5164956202591084
STAT,1945,4,na,1949,4447.382206684892
STAT,1887,17,15-19,1904,6.78398313248637
SIM,1950,15,30-34,1965,17
STAT,1908,23,30-34,1931,26.860477404920683
STAT,1888,1,na,1889,3407.716490585535
STAT,1962,2,na,1964,5141.857420486724
STAT,1828,31,45-49,1859,1.7814803153520757
SIM,1892,33,25-29,1925,20
STAT,1800,90,na,1890,37.9986127337725
STAT,1841,105,na,1946,0.021648995632754714
STAT,1887,46,20-24,1933,0.01375654799280655
SIM,1924,25,30-34,1949,66
STAT,1877,31,40-44,1908,4.607370857101815
STAT,1943,19,na,1962,3979.551922964993
STAT,1842,35,35-39,1877,6.643139301124425
SIM,1945,17,15-19,1962,49
SIM,1825,42,25-29,1867,1
STAT,1873,50,50-100,1923,0.01584447851437122
STAT,1833,25,40-44,1858,2.700744961356921
SIM,1823,46,30-34,1869,1
SIM,1907,25,30-34,1932,69
STAT,1898,23,25-29,1921,78.72929466866741
STAT,1865,16,25-29,1881,5.4388074816656475
SIM,1927,24,45-49,1951,1
STAT,1929,15,15-19,1944,59.34793146723763
STAT,1860,54,50-100,1914,0.012156998382424017
STAT,1878,22,45-49,1900,0.7404587423574729
STAT,1911,29,25-29,1940,65.0069593776818
SIM,1873,16,25-29,1889,9
STAT,1845,36,15-19,1881,0.04658150361211037
STAT,1884,29,40-44,1913,3.001761966966458
SIM,1813,85,na,1898,77
SIM,1836,31,45-49,1867,6
SIM,1872,36,25-29,1908,4
STAT,1842,19,35-39,1861,0.5460720407859049
STAT,1883,42,20-24,1925,0.1587706421869081
STAT,1946,15,15-19,1961,51.38404010767705
STAT,1869,19,50-100,1888,0.04834610347777465
STAT,1909,48,50-100,1957,0.2113748698280774
SIM,1880,29,na,1909,2345
STAT,1827,27,45-49,1854,3.7039865446507907
STAT,1886,57,na,1943,2170.0238717257166
STAT,1838,19,50-100,1857,0.04698939116050194
STAT,1882,43,na,1925,2280.493991487103
STAT,1928,41,na,1969,4836.317717967048
STAT,1863,41,40-44,1904,2.0209718787205175
SIM,1881,27,15-19,1908,1
SIM,1845,95,na,1940,10
STAT,1867,48,45-49,1915,0.22318467542113588
STAT,1832,46,30-34,1878,0.07784131516116906
STAT,1866,33,30-34,1899,16.359742790721103
STAT,1780,110,na,1890,0.0018616141980470533
STAT,1816,51,20-24,1867,0.0014811943277116364
SIM,1818,40,40-44,1858,3
SIM,1834,20,30-34,1854,18
STAT,1928,41,50-100,1969,0.15298357867800813
SIM,1850,35,35-39,1885,17
SIM,1925,42,na,1967,4739
STAT,1840,42,50-100,1882,0.7930209302624344
STAT,1918,32,50-100,1950,0.8965733789867816
SIM,1892,29,40-44,1921,7
STAT,1937,17,15-19,1954,45.034561878189734
SIM,1881,18,25-29,1899,11
STAT,1887,20,45-49,1907,0.8018877127712399
STAT,1828,95,na,1923,7.321410737701503
STAT,1868,53,35-39,1921,0.00825370165048381
STAT,1906,20,50-100,1926,0.6091186453858327
SIM,1885,31,40-44,1916,7
SIM,1871,41,40-44,1912,4
SIM,1874,42,20-24,1916,2
STAT,1864,49,30-34,1913,0.08597225461677199
STAT,1868,33,40-44,1901,4.207723121489276
SIM,1847,11,na,1858,2142
SIM,1856,47,na,1903,2192
STAT,1878,38,na,1916,2489.312277361624
SIM,1830,43,45-49,1873,2
SIM,1875,48,45-49,1923,1
SIM,1954,15,15-19,1969,55
STAT,1857,51,30-34,1908,0.004765199735849045
STAT,1916,25,30-34,1941,41.62370327108958
STAT,1897,19,25-29,1916,7.688172543213083
STAT,1799,65,na,1864,792.2602838639115
STAT,1846,28,na,1874,1858.0524437356175
STAT,1842,14,na,1856,2382.2212302864004
STAT,1817,38,40-44,1855,14.340159553798477
STAT,1849,25,50-100,1874,0.597256366293107
STAT,1884,21,30-34,1905,18.031903700025506
STAT,1806,52,na,1858,1209.2489847624402
SIM,1864,77,na,1941,802
SIM,1860,63,na,1923,1696
STAT,1783,93,na,1876,7.140532314923864
STAT,1884,51,50-100,1935,0.015315874175091308
SIM,1838,28,25-29,1866,35
SIM,1860,30,25-29,1890,14
STAT,1873,18,25-29,1891,5.8454562052671815
SIM,1890,24,25-29,1914,126
STAT,1919,24,45-49,1943,1.2494312987339884
SIM,1872,49,30-34,1921,1
STAT,1850,34,30-34,1884,13.456354994078245
SIM,1825,38,40-44,1863,7
SIM,1839,32,25-29,1871,13
SIM,1938,27,25-29,1965,104
STAT,1853,38,15-19,1891,0.04685198207741951
STAT,1866,42,20-24,1908,0.14925434464206772
STAT,1862,36,15-19,1898,0.04899933005414469
STAT,1864,101,na,1965,2.349828407807172
STAT,1831,34,20-24,1865,2.4120857985144384
SIM,1919,27,15-19,1946,1
STAT,1864,41,20-24,1905,0.14470831361703274
SIM,1876,9,na,1885,3098
STAT,1893,38,45-49,1931,2.567067646630441
STAT,1892,32,20-24,1924,3.4560278869006034
SIM,1895,20,45-49,1915,1
SIM,1929,35,na,1964,5153
STAT,1822,43,45-49,1865,2.2622927567633218
STAT,1835,50,40-44,1885,0.00832017998451857
SIM,1844,30,40-44,1874,8
STAT,1870,34,35-39,1904,10.01287860624101
SIM,1918,26,45-49,1944,5
SIM,1891,49,40-44,1940,1
STAT,1867,54,30-34,1921,0.005544173162624107
STAT,1846,52,45-49,1898,0.010322894961590449
STAT,1847,66,na,1913,1278.1214406471706
SIM,1825,30,30-34,1855,22
SIM,1925,21,na,1946,4487
STAT,1909,48,25-29,1957,0.04957325902364039
SIM,1854,29,20-24,1883,11
STAT,1921,44,30-34,1965,0.14644939015854683
SIM,1827,30,40-44,1857,3
STAT,1865,29,30-34,1894,23.1493484665846
STAT,1871,26,15-19,1897,0.46005096569439097
STAT,1894,39,15-19,1933,0.07294541128355729
SIM,1834,40,25-29,1874,1
SIM,1864,66,na,1930,1495
SIM,1860,52,na,1912,1876
STAT,1834,50,50-100,1884,0.010842237664785167
STAT,1826,29,na,1855,1663.8896125205106
STAT,1819,81,na,1900,318.81151470729515
STAT,1858,43,25-29,1901,0.5157571414275246
SIM,1865,22,25-29,1887,73
STAT,1873,27,15-19,1900,0.46924166246206217
SIM,1894,21,40-44,1915,3
STAT,1849,52,35-39,1901,0.0066481528830661385
STAT,1816,45,35-39,1861,0.2973905572207747
STAT,1886,21,40-44,1907,2.2569153146325105
STAT,1894,43,35-39,1937,0.16381503587399676
STAT,1913,37,50-100,1950,0.4226915639365859
SIM,1834,47,45-49,1881,1
STAT,1912,15,45-49,1927,0.10352454785313317
SIM,1877,32,45-49,1909,1
SIM,1910,30,25-29,1940,13
SIM,1899,30,30-34,1929,39
STAT,1902,39,25-29,1941,0.885047237305083
STAT,1856,18,25-29,1874,5.334208339862032
STAT,1869,32,45-49,1901,1.717505180778135
SIM,1855,28,25-29,1883,46
STAT,1827,52,35-39,1879,0.009328060195263641
STAT,1848,28,50-100,1876,0.5893651476001529
STAT,1864,36,25-29,1900,2.6242389369070684
STAT,1868,52,45-49,1920,0.014065145684786453
STAT,1897,6,na,1903,3563.350937249008
STAT,1836,30,40-44,1866,3.483831863309881
STAT,1883,36,35-39,1919,7.113825150363001
STAT,1883,49,40-44,1932,0.16778730626444058
STAT,1827,48,15-19,1875,4.4321033549828343E-4
STAT,1813,106,na,1919,0.005221258710472073
STAT,1877,43,35-39,1920,1.9021559120983946
STAT,1893,27,na,1920,3088.5106112861945
STAT,1843,63,na,1906,1440.420662482957
SIM,1866,39,40-44,1905,9
STAT,1815,46,30-34,1861,0.2647855781618092
STAT,1814,71,na,1885,709.1341582142371
STAT,1879,12,na,1891,2753.8715211952335
STAT,1917,35,50-100,1952,0.4492524628448776
SIM,1864,18,25-29,1882,5
SIM,1885,43,35-39,1928,9
SIM,1879,43,na,1922,2819
STAT,1847,28,25-29,1875,39.364249571875426
SIM,1890,37,30-34,1927,10
STAT,1825,41,20-24,1866,0.22142381845564066
STAT,1902,30,25-29,1932,14.853922494411481
SIM,1843,26,40-44,1869,4
STAT,1764,90,na,1854,46.0
STAT,1843,84,na,1927,268.55001689334233
STAT,1847,98,na,1945,2.533254692796166
STAT,1834,48,na,1882,1583.0049787489095
STAT,1893,31,25-29,1924,13.30960024366024
STAT,1848,54,20-24,1902,5.578352990150465E-4
STAT,1835,26,40-44,1861,2.931084960815253
SIM,1886,19,15-19,1905,7
STAT,1861,35,45-49,1896,1.6964053810868338
STAT,1883,41,30-34,1924,1.1559851636049563
SIM,1909,36,45-49,1945,3
STAT,1830,34,na,1864,1735.163394869444
SIM,1891,41,30-34,1932,2
STAT,1847,77,na,1924,674.0642447435879
STAT,1846,29,20-24,1875,10.003901492448408
STAT,1816,50,30-34,1866,0.012189881539487005
STAT,1826,40,25-29,1866,0.5452998117683349
STAT,1811,74,na,1885,486.4169248470409
STAT,1924,16,na,1940,4482.920850032635
STAT,1882,37,30-34,1919,5.29694385572803
STAT,1884,48,45-49,1932,0.23519782241644555
SIM,1811,43,35-39,1854,2
SIM,1911,18,na,1929,4014
SIM,1836,59,na,1895,1524
STAT,1876,22,35-39,1898,6.14726617534533
SIM,1913,48,40-44,1961,1
SIM,1874,36,35-39,1910,11
STAT,1928,30,45-49,1958,2.009242906175222
STAT,1799,103,na,1902,0.04656903012189244
STAT,1818,51,30-34,1869,0.013216467950343539
STAT,1847,52,25-29,1899,0.002747403627135695
STAT,1868,49,15-19,1917,3.8160900007065646E-4
SIM,1870,62,na,1932,1962
SIM,1905,25,20-24,1930,18
STAT,1861,16,40-44,1877,0.17826374187195743
SIM,1882,26,40-44,1908,3
STAT,1844,51,45-49,1895,0.01129964191858574
STAT,1865,48,35-39,1913,0.1279976361744053
STAT,1930,29,35-39,1959,19.45128525310608
SIM,1874,76,na,1950,899
STAT,1844,32,40-44,1876,4.018681508949229
STAT,1882,33,15-19,1915,0.1409384064264696
STAT,1835,33,na,1868,2034.4391089978672
SIM,1842,46,40-44,1888,1
SIM,1884,22,35-39,1906,11
STAT,1794,66,na,1860,803.5370635775075
STAT,1900,46,50-100,1946,0.1964431348187135
SIM,1865,27,30-34,1892,34
STAT,1932,35,na,1967,5164.023604239742
SIM,1848,43,30-34,1891,2
STAT,1788,92,na,1880,12.532639492724249
SIM,1907,21,15-19,1928,5
STAT,1891,79,na,1970,1344.2954733390584
STAT,1852,49,50-100,1901,0.19372468473470705
STAT,1880,37,20-24,1917,0.826372834129659
STAT,1864,17,20-24,1881,16.63568330619802
STAT,1854,47,na,1901,1713.89831762057
STAT,1855,0,na,1855,3102.5712542843676
SIM,1856,45,30-34,1901,1
STAT,1934,28,50-100,1962,1.3648466962709727
STAT,1850,43,20-24,1893,0.11859697789827374
STAT,1874,26,40-44,1900,3.1307723297227192
STAT,1925,40,50-100,1965,0.14551439891430457
SIM,1885,39,na,1924,2397
STAT,1828,28,15-19,1856,0.5730648493914645
STAT,1869,13,na,1882,2607.633348870159
STAT,1908,49,20-24,1957,0.010131649776478057
SIM,1873,48,35-39,1921,1
STAT,1874,22,25-29,1896,59.62484534752506
STAT,1895,19,15-19,1914,7.856591580899256
STAT,1848,41,15-19,1889,0.010859867597068903
SIM,1872,17,20-24,1889,26
STAT,1866,36,35-39,1902,6.687441053905619
SIM,1899,38,40-44,1937,2
SIM,1852,32,40-44,1884,7
SIM,1852,41,30-34,1893,3
SIM,1923,16,25-29,1939,68
SIM,1883,43,25-29,1926,2
STAT,1813,46,20-24,1859,0.030670264067989065
STAT,1896,43,45-49,1939,0.13901857989565705
STAT,1923,39,45-49,1962,0.8042217199638488
SIM,1802,90,na,1892,47
STAT,1915,16,25-29,1931,9.277993371413157
STAT,1835,54,35-39,1889,0.0062856831998175456
STAT,1839,100,na,1939,0.7326888419513353
STAT,1873,61,na,1934,1932.6355603446714
SIM,1892,21,30-34,1913,29
STAT,1822,40,40-44,1862,3.7130293536326064
STAT,1872,38,25-29,1910,2.929175435847724
SIM,1849,77,na,1926,930
STAT,1829,52,45-49,1881,0.010330928886863353
SIM,1845,63,na,1908,1401
STAT,1877,75,na,1952,1089.2593739079289
SIM,1885,28,na,1913,2369
STAT,1834,46,40-44,1880,0.13599847458591022
SIM,1817,67,na,1884,761
SIM,1860,43,30-34,1903,2
SIM,1879,26,20-24,1905,15
STAT,1839,47,na,1886,1582.0167929743889
SIM,1813,53,na,1866,1253
STAT,1851,22,30-34,1873,17.549225416194457
SIM,1861,41,45-49,1902,2
STAT,1902,69,na,1971,2502.9697360035116
SIM,1906,39,na,1945,3484
SIM,1938,24,20-24,1962,3
STAT,1941,31,15-19,1972,0.13772605549632014
SIM,1902,25,na,1927,3627
STAT,1873,39,na,1912,2412.14442001972
STAT,1854,18,15-19,1872,5.401356016409873
SIM,1839,37,30-34,1876,10
SIM,1916,26,35-39,1942,2
SIM,1885,3,na,1888,2826
STAT,1833,85,na,1918,180.0229024224294
STAT,1856,38,40-44,1894,3.488132196187476
STAT,1867,65,na,1932,1618.5306879905334
STAT,1808,52,25-29,1860,0.00845289737341395
STAT,1886,40,45-49,1926,1.6323971085206168
STAT,1898,47,35-39,1945,0.10843763408755012
SIM,1820,40,45-49,1860,3
SIM,1868,19,20-24,1887,22
STAT,1818,42,40-44,1860,5.759190849028522
SIM,1909,34,50-100,1943,2
SIM,1950,18,35-39,1968,9
STAT,1939,30,20-24,1969,2.5416903140849305
SIM,1869,42,50-100,1911,2
STAT,1860,32,na,1892,1975.1836764139541
SIM,1927,0,na,1927,5190
SIM,1817,39,45-49,1856,4
STAT,1837,99,na,1936,1.2626914339295086
STAT,1942,18,35-39,1960,4.472469987025062
STAT,1863,51,na,1914,1935.1192723732006
STAT,1823,44,50-100,1867,1.62543262122157
STAT,1824,53,20-24,1877,8.133762982395295E-4
STAT,1895,33,50-100,1928,1.2143864317249657
SIM,1851,70,na,1921,1061
STAT,1912,3,na,1915,4170.325606873516
STAT,1891,38,35-39,1929,8.888777131888991
STAT,1875,47,40-44,1922,0.17841255953696109
SIM,1830,40,40-44,1870,6
SIM,1853,32,50-100,1885,3
STAT,1885,33,40-44,1918,4.395191778283077
STAT,1841,29,na,1870,1955.483507662693
STAT,1852,30,25-29,1882,8.722680125675065
SIM,1911,27,25-29,1938,71
STAT,1875,43,25-29,1918,0.6674883843214264
STAT,1843,53,30-34,1896,0.004728177784921234
STAT,1903,27,25-29,1930,61.34402541228251
STAT,1839,58,na,1897,1364.8286906333992
STAT,1842,44,25-29,1886,0.5078302320448296
STAT,1918,20,na,1938,4043.1923129052157
STAT,1905,48,40-44,1953,0.1404946583074297
SIM,1862,18,15-19,1880,4
STAT,1840,31,45-49,1871,1.5443528097913801
SIM,1936,30,45-49,1966,2
STAT,1846,45,20-24,1891,0.00866701499617845
STAT,1888,27,na,1915,2878.195238943227
STAT,1824,47,35-39,1871,0.1631600737658413
STAT,1891,44,20-24,1935,0.1978730712486709
SIM,1894,40,45-49,1934,5
SIM,1912,39,35-39,1951,4
STAT,1897,39,40-44,1936,1.2758326273981988
STAT,1849,28,35-39,1877,8.816175804157263
STAT,1778,105,na,1883,0.013556689350287046
STAT,1779,88,na,1867,36.202957002325306
SIM,1838,25,20-24,1863,3
STAT,1838,101,na,1939,0.41926691277078815
STAT,1849,19,45-49,1868,0.061691479783829946
STAT,1845,32,50-100,1877,0.8512149561152828
STAT,1878,35,15-19,1913,0.060194649673205695
STAT,1885,42,30-34,1927,1.1686673536624872
STAT,1948,15,25-29,1963,50.62475497181281
SIM,1868,80,na,1948,550
STAT,1862,23,45-49,1885,0.6154480856964095
SIM,1915,43,na,1958,4156
STAT,1816,104,na,1920,0.029595702652242244
SIM,1870,23,45-49,1893,4
STAT,1863,44,45-49,1907,1.3206028215312116
SIM,1873,29,30-34,1902,35
STAT,1904,39,35-39,1943,2.2095661813353744
SIM,1832,47,35-39,1879,1
SIM,1878,1,na,1879,3487
SIM,1857,28,35-39,1885,15
SIM,1935,4,na,1939,5643
STAT,1954,17,15-19,1971,57.22635435190846
STAT,1832,26,15-19,1858,0.41921901042026805
STAT,1873,30,45-49,1903,1.8180445446889584
SIM,1858,37,40-44,1895,4
SIM,1893,36,45-49,1929,3
STAT,1869,41,35-39,1910,1.7915556111343856
SIM,1843,29,45-49,1872,1
SIM,1822,41,45-49,1863,2
STAT,1892,23,30-34,1915,22.703734333705675
STAT,1832,49,35-39,1881,0.09858009669528052
STAT,1902,48,15-19,1950,3.2052738901541106E-4
STAT,1810,89,na,1899,44.78781814919903
STAT,1915,41,15-19,1956,0.0015799721170184
STAT,1916,28,35-39,1944,15.7856857117309
STAT,1837,51,40-44,1888,0.007185599847254717
STAT,1889,42,15-19,1931,0.01738094363084803
SIM,1871,24,15-19,1895,3
SIM,1838,29,na,1867,1784
STAT,1842,16,30-34,1858,1.6145710517553822
STAT,1867,45,40-44,1912,0.16559831591127272
STAT,1881,32,45-49,1913,1.7198924232985726
STAT,1848,16,25-29,1864,5.492923388965473
SIM,1856,16,25-29,1872,9
STAT,1825,32,30-34,1857,34.614313138460936
STAT,1931,38,40-44,1969,2.0198931497027957
STAT,1892,42,35-39,1934,2.3123870463634555
SIM,1883,47,40-44,1930,2
SIM,1917,30,35-39,1947,3
STAT,1841,29,50-100,1870,0.5782485074532856
SIM,1892,30,20-24,1922,5
STAT,1883,28,na,1911,2380.4186050108274
SIM,1857,32,na,1889,1985
STAT,1884,30,20-24,1914,2.7500794523529666
STAT,1897,16,20-24,1913,24.2417577976078
STAT,1892,64,na,1956,2248.7658207717127
STAT,1825,51,35-39,1876,0.010889990137215613
SIM,1833,32,30-34,1865,28
SIM,1833,30,na,1863,1919
SIM,1837,44,na,1881,1553
STAT,1887,49,25-29,1936,0.03636627978910371
SIM,1849,26,35-39,1875,9
STAT,1868,28,45-49,1896,1.0780350231562763
STAT,1866,23,50-100,1889,0.3840741228224778
SIM,1897,37,40-44,1934,7
STAT,1874,35,30-34,1909,5.603804239962758
SIM,1885,40,30-34,1925,4
STAT,1908,26,35-39,1934,14.645530365013602
SIM,1818,43,45-49,1861,3
STAT,1841,32,15-19,1873,0.12757480053823164
STAT,1859,52,30-34,1911,0.0048238140646922915
STAT,1916,20,25-29,1936,99.36235219409252
SIM,1792,74,na,1866,437
STAT,1827,42,50-100,1869,1.251956270563235
SIM,1815,44,30-34,1859,7
STAT,1814,41,45-49,1855,5.396513425643745
SIM,1904,16,15-19,1920,10
SIM,1950,20,na,1970,4416
STAT,1841,27,40-44,1868,2.7471406220758277
STAT,1839,49,50-100,1888,0.1683292344824778
STAT,1832,41,25-29,1873,0.5345318373179208
STAT,1877,34,45-49,1911,1.8293166576869802
STAT,1904,39,na,1943,3436.83222781186
SIM,1796,88,na,1884,20
STAT,1838,27,20-24,1865,10.964674600441983
SIM,1885,34,45-49,1919,3
STAT,1818,85,na,1903,139.70351115585572
STAT,1834,42,25-29,1876,0.5209681224942357
SIM,1867,10,na,1877,2475
STAT,1858,31,30-34,1889,14.272480006818036
SIM,1898,29,35-39,1927,27
SIM,1840,49,35-39,1889,1
STAT,1842,104,na,1946,0.05230647938135454
STAT,1923,15,20-24,1938,163.1852364138577
SIM,1846,27,20-24,1873,13
STAT,1850,18,30-34,1868,1.456427415233083
STAT,1840,40,20-24,1880,0.1344026251349552
STAT,1909,30,35-39,1939,8.965235398650877
SIM,1904,37,35-39,1941,7
SIM,1931,15,20-24,1946,178
STAT,1863,24,15-19,1887,2.966561285508875
SIM,1924,28,35-39,1952,27
STAT,1853,17,45-49,1870,0.06588815508260737
SIM,1899,33,35-39,1932,21
STAT,1898,20,20-24,1918,95.63563015244875
SIM,1855,84,na,1939,220
SIM,1865,51,na,1916,2064
SIM,1882,35,30-34,1917,2
SIM,1877,41,35-39,1918,1
SIM,1880,38,25-29,1918,8
STAT,1888,38,15-19,1926,0.06738762717932963
SIM,1859,98,na,1957,15
STAT,1858,39,40-44,1897,3.5057903983606695
STAT,1877,40,30-34,1917,1.2287222181912696
STAT,1774,89,na,1863,25.169382926039106
STAT,1854,9,na,1863,2230.566306494675
SIM,1832,28,30-34,1860,30
SIM,1930,27,35-39,1957,39
STAT,1789,66,na,1855,608.8687999999999
SIM,1924,20,25-29,1944,137
SIM,1905,49,45-49,1954,1
SIM,1918,23,40-44,1941,6
STAT,1840,48,30-34,1888,0.06934940633416391
SIM,1835,85,na,1920,175
STAT,1865,26,50-100,1891,0.5943255862524358
STAT,1898,28,30-34,1926,34.61746688506368
STAT,1851,50,25-29,1901,0.002964215756086709
STAT,1870,22,40-44,1892,2.0781048231012833
SIM,1887,28,20-24,1915,1
SIM,1831,71,na,1902,884
STAT,1882,28,40-44,1910,2.9667417243487533
SIM,1872,10,na,1882,2765
STAT,1870,31,30-34,1901,17.483081011587966
STAT,1836,33,45-49,1869,1.357905576501657
STAT,1848,62,na,1910,1420.7559349491078
STAT,1859,46,45-49,1905,0.19281862928065233
STAT,1899,31,50-100,1930,1.2851980299532828
STAT,1847,37,15-19,1884,0.04543413349599381
SIM,1867,46,45-49,1913,1
STAT,1895,48,20-24,1943,0.008896406477393084
STAT,1893,35,40-44,1928,5.7189322086809256
SIM,1935,20,na,1955,5010
STAT,1837,34,15-19,1871,0.11659909438973567
STAT,1879,19,30-34,1898,1.6905158831007654
STAT,1909,21,50-100,1930,0.6255817668553058
STAT,1938,19,na,1957,3701.325627366676
STAT,1831,37,25-29,1868,2.532721865479793
STAT,1891,19,30-34,1910,2.0022582277647736
SIM,1866,31,30-34,1897,32
SIM,1889,44,30-34,1933,4
STAT,1861,40,40-44,1901,1.9152001101414218
STAT,1889,17,25-29,1906,7.14089175210085
STAT,1870,39,50-100,1909,1.2120591995008356
SIM,1844,33,45-49,1877,1
STAT,1835,29,45-49,1864,1.0631705345577043
STAT,1903,54,na,1957,3076.6287667237725
STAT,1857,27,30-34,1884,20.66509460541826
STAT,1934,16,35-39,1950,5.802304463561078
STAT,1815,42,15-19,1857,0.04362738581264264
STAT,1937,34,na,1971,3811.7886443322514
SIM,1921,39,na,1960,4908
STAT,1826,44,40-44,1870,1.7808419995699536
STAT,1793,92,na,1885,12.51626452798282
STAT,1911,26,20-24,1937,18.2204711048007
STAT,1869,29,15-19,1898,0.4436616974103681
STAT,1848,36,40-44,1884,3.543231113248899
SIM,1901,62,na,1963,2944
STAT,1880,20,35-39,1900,6.293133147935883
SIM,1861,46,50-100,1907,1
STAT,1861,28,50-100,1889,0.539258189587476
SIM,1920,38,30-34,1958,2
STAT,1850,37,35-39,1887,5.404535374730104
STAT,1883,45,25-29,1928,0.0582304103390313
STAT,1877,43,50-100,1920,1.109742053835987
SIM,1776,89,na,1865,51
SIM,1897,17,25-29,1914,8
STAT,1912,38,30-34,1950,1.8056563946252187
SIM,1848,46,50-100,1894,2
STAT,1933,20,na,1953,4969.407539461151
STAT,1935,20,35-39,1955,13.085047105446423
STAT,1818,96,na,1914,4.375904935048797
SIM,1834,44,40-44,1878,7
STAT,1865,100,na,1965,4.227534989162494
STAT,1878,52,40-44,1930,0.011119391798410472
STAT,1821,48,20-24,1869,0.018627116349650332
STAT,1844,103,na,1947,0.11121142351095865
STAT,1851,41,35-39,1892,1.5007126243860671
SIM,1842,17,35-39,1859,1
STAT,1816,54,25-29,1870,0.00669535102415347
STAT,1801,53,na,1854,1082.8349073427003
STAT,1874,24,na,1898,2447.9234455500987
STAT,1902,17,50-100,1919,0.07048194590527271
STAT,1835,21,35-39,1856,5.823664048231089
SIM,1864,15,20-24,1879,23
SIM,1866,34,35-39,1900,17
SIM,1942,16,35-39,1958,7
STAT,1805,67,na,1872,915.760136523802
SIM,1888,32,20-24,1920,2
STAT,1857,39,50-100,1896,0.9683210494746287
STAT,1939,18,50-100,1957,0.38244792038555875
STAT,1860,32,25-29,1892,8.477949620327722
STAT,1856,15,20-24,1871,16.986621353857416
STAT,1830,25,15-19,1855,0.6273311887726025
STAT,1894,36,50-100,1930,1.6188205624524847
SIM,1843,21,35-39,1864,9
SIM,1856,36,40-44,1892,11
STAT,1838,46,25-29,1884,0.0441018156435842
STAT,1876,79,na,1955,736.4580142474409
SIM,1943,20,35-39,1963,14
STAT,1872,65,na,1937,1727.8677855818462
SIM,1837,33,na,1870,1670
STAT,1820,38,50-100,1858,2.8223615441919643
STAT,1879,28,20-24,1907,12.465856941441368
STAT,1871,34,15-19,1905,0.14267439232570447
STAT,1867,16,35-39,1883,0.5404182218915823
STAT,1855,32,na,1887,1883.5434139173083
SIM,1884,43,na,1927,2418
STAT,1847,48,40-44,1895,0.1318265055912333
STAT,1912,42,15-19,1954,0.0015109261409986274
STAT,1950,21,na,1971,4421.128352725052
SIM,1831,50,na,1881,1444
SIM,1797,73,na,1870,404
STAT,1932,34,40-44,1966,5.2984805717640375
STAT,1847,13,na,1860,2312.910115330107
SIM,1872,44,25-29,1916,1
STAT,1862,49,20-24,1911,0.010203222414418785
SIM,1848,27,30-34,1875,29
SIM,1892,62,na,1954,2589
STAT,1771,100,na,1871,0.19162978151589727
STAT,1844,16,40-44,1860,0.18123526689481725
STAT,1882,48,35-39,1930,0.13739442240495897
STAT,1810,48,45-49,1858,0.7290038148154467
STAT,1921,48,25-29,1969,0.060851369349884894
SIM,1846,16,na,1862,2340
SIM,1852,16,40-44,1868,1
STAT,1832,54,30-34,1886,0.00399607924657824
STAT,1915,37,45-49,1952,0.702755170280087
SIM,1871,15,na,1886,2470
SIM,1931,36,40-44,1967,3
STAT,1791,108,na,1899,3.2318575247537056E-4
SIM,1945,19,na,1964,4371
STAT,1903,44,15-19,1947,0.0013719114941312996
STAT,1875,27,25-29,1902,44.29003836652594
SIM,1939,9,na,1948,4016
STAT,1900,30,15-19,1930,0.2029758318990986
SIM,1867,47,50-100,1914,1
SIM,1875,16,35-39,1891,1
SIM,1890,17,15-19,1907,15
SIM,1806,51,na,1857,1430
SIM,1892,6,na,1898,3828
SIM,1895,28,50-100,1923,1
SIM,1937,19,30-34,1956,15
STAT,1810,68,na,1878,733.1317699491393
SIM,1859,44,na,1903,2150
SIM,1867,63,na,1930,1557
SIM,1900,24,45-49,1924,2
STAT,1891,26,40-44,1917,3.7963746322703487
STAT,1850,45,35-39,1895,0.10635855878608096
STAT,1868,82,na,1950,454.62268627585246
SIM,1890,28,40-44,1918,6
SIM,1832,35,40-44,1867,5
STAT,1925,22,na,1947,4459.676189410118
SIM,1829,46,na,1875,1294
STAT,1952,20,35-39,1972,11.556645531105291
STAT,1824,35,40-44,1859,6.538131415385255
SIM,1905,54,na,1959,3109
STAT,1924,19,50-100,1943,0.45274689558829073
STAT,1858,18,35-39,1876,0.5154915155596618
SIM,1883,27,25-29,1910,52
STAT,1885,49,15-19,1934,3.986110043846551E-4
STAT,1929,19,30-34,1948,15.780547229858007
SIM,1905,46,40-44,1951,1
STAT,1930,26,30-34,1956,50.837389599421655
STAT,1809,71,na,1880,800.0302327967696
STAT,1909,45,20-24,1954,0.01045612233135537
SIM,1846,26,na,1872,2174
SIM,1880,8,na,1888,2662
STAT,1906,44,40-44,1950,0.22879393903403
SIM,1823,37,40-44,1860,9
STAT,1855,42,na,1897,1789.4632445990242
STAT,1867,29,40-44,1896,2.8484416369412573
SIM,1884,33,na,1917,2555
STAT,1794,106,na,1900,0.0024066834917607876
STAT,1869,0,na,1869,3692.3940928760717
SIM,1839,29,30-34,1868,30
STAT,1833,53,35-39,1886,0.005753658607245143
STAT,1855,10,na,1865,2228.6611063584173
SIM,1797,83,na,1880,119
STAT,1919,40,45-49,1959,0.1845597082513695
SIM,1912,36,30-34,1948,5
STAT,1864,44,25-29,1908,0.5746267749993563
SIM,1889,28,30-34,1917,50
STAT,1856,52,50-100,1908,0.0120299503092745
STAT,1927,35,na,1962,4779.71977583475
SIM,1914,37,na,1951,3826
STAT,1862,25,50-100,1887,0.5656503354109284
SIM,1869,76,na,1945,726
STAT,1823,86,na,1909,123.48582540315168
STAT,1896,40,40-44,1936,0.21257247334766877
STAT,1831,45,25-29,1876,0.048336533190480854
SIM,1852,2,na,1854,3028
STAT,1904,36,30-34,1940,1.689971486809331
SIM,1855,62,na,1917,1395
STAT,1830,46,20-24,1876,0.010089044371295222
STAT,1881,49,30-34,1930,0.09347827743956352
SIM,1857,43,na,1900,1942
STAT,1868,60,na,1928,1858.2936041615417
STAT,1917,25,na,1942,4036.359036705006
SIM,1864,0,na,1864,3498
STAT,1918,41,40-44,1959,0.27177400060205537
STAT,1917,35,na,1952,4025.624269735404
SIM,1859,66,na,1925,1381
SIM,1906,18,na,1924,3723
SIM,1864,38,40-44,1902,8
STAT,1900,43,35-39,1943,0.17651502278208306
STAT,1813,54,20-24,1867,0.0017013929914376832
SIM,1855,17,20-24,1872,19
STAT,1899,19,35-39,1918,0.7624193027974782
STAT,1909,5,na,1914,4008.1595165678873
STAT,1853,46,15-19,1899,3.363514529170116E-4
SIM,1854,45,na,1899,1962
STAT,1938,1,na,1939,4202.233757915065
SIM,1856,26,na,1882,2409
SIM,1905,28,25-29,1933,62
STAT,1806,51,50-100,1857,0.050151723142383406
STAT,1948,19,40-44,1967,1.6320380024981052
SIM,1821,40,na,1861,1559
STAT,1891,40,50-100,1931,1.3477600898963866
SIM,1914,29,50-100,1943,1
STAT,1847,17,20-24,1864,17.25488616713035
SIM,1860,45,45-49,1905,1
SIM,1891,40,50-100,1931,1
STAT,1840,23,50-100,1863,0.3704955144134412
SIM,1893,17,40-44,1910,2
SIM,1865,19,30-34,1884,1
SIM,1870,44,50-100,1914,7
STAT,1871,48,na,1919,2244.9526655837826
STAT,1840,43,25-29,1883,0.47589606158802095
SIM,1904,34,30-34,1938,21
STAT,1903,30,40-44,1933,6.33950448550443
SIM,1895,27,na,1922,3227
STAT,1942,28,50-100,1970,1.0653103983149834
SIM,1839,46,na,1885,1705
STAT,1907,18,40-44,1925,0.2732503094781481
STAT,1954,9,na,1963,4955.103713830498
STAT,1823,43,25-29,1866,1.0130999037285984
STAT,1929,31,15-19,1960,0.1665809438838764
SIM,1921,34,30-34,1955,35
SIM,1880,61,na,1941,1724
STAT,1834,104,na,1938,0.044823597528891694
SIM,1831,43,25-29,1874,2
SIM,1884,32,50-100,1916,2
STAT,1820,42,45-49,1862,2.976017616866013
STAT,1845,32,na,1877,2013.4316689552384
SIM,1842,26,25-29,1868,50
SIM,1894,43,na,1937,3090
SIM,1789,86,na,1875,30
SIM,1804,70,na,1874,891
STAT,1865,53,30-34,1918,0.0054229896579920285
STAT,1877,43,na,1920,2427.82467411625
STAT,1834,26,25-29,1860,37.59814114970191
STAT,1913,34,30-34,1947,15.854333158187014
SIM,1854,48,25-29,1902,1
STAT,1880,45,20-24,1925,0.012992607948364569
SIM,1925,35,50-100,1960,1
STAT,1922,44,25-29,1966,0.08335390621468544
STAT,1857,19,30-34,1876,1.474999870281851
SIM,1871,25,na,1896,2242
STAT,1761,93,na,1854,3.0
SIM,1853,46,50-100,1899,1
STAT,1885,17,40-44,1902,0.18615485418856068
SIM,1854,13,na,1867,2459
SIM,1911,30,40-44,1941,7
SIM,1862,32,na,1894,2203
SIM,1867,95,na,1962,17
STAT,1884,13,na,1897,2602.4415120780136
STAT,1831,83,na,1914,267.4982489456074
STAT,1910,41,50-100,1951,0.11389175924430316
STAT,1892,10,na,1902,3311.892102155224
SIM,1906,45,45-49,1951,1
SIM,1872,32,na,1904,2477
SIM,1836,48,30-34,1884,1
STAT,1835,38,20-24,1873,0.7030064351237552
STAT,1895,39,30-34,1934,7.022331167005572
STAT,1903,24,20-24,1927,99.30885586341151
SIM,1911,24,20-24,1935,106
STAT,1810,53,40-44,1863,0.030898911084304655
STAT,1850,28,45-49,1878,0.9757777315973815
STAT,1881,36,25-29,1917,2.8533546840825497
STAT,1890,34,25-29,1924,12.666595099927157
STAT,1802,53,50-100,1855,0.039224016228760046
STAT,1851,49,45-49,1900,0.19063882871875087
STAT,1814,45,25-29,1859,0.17739720872740547
STAT,1830,33,15-19,1863,0.13385044391087741
STAT,1828,48,30-34,1876,0.07471676739649985
SIM,1884,65,na,1949,1649
SIM,1934,35,na,1969,5425
STAT,1839,18,25-29,1857,5.085844281412404
SIM,1875,82,na,1957,589
STAT,1854,47,20-24,1901,0.009141438285644643
STAT,1923,36,40-44,1959,1.7713721711746957
SIM,1912,18,15-19,1930,6
STAT,1935,25,50-100,1960,1.3848632983827278
SIM,1922,24,na,1946,4205
STAT,1854,38,30-34,1892,4.058785041109745
STAT,1871,47,20-24,1918,0.012069762610688085
STAT,1888,80,na,1968,1157.3454754816196
SIM,1875,50,na,1925,2180
STAT,1775,107,na,1882,0.007536354496645701
STAT,1894,22,50-100,1916,0.5351100006084635
STAT,1890,47,30-34,1937,0.06779113465642866
STAT,1865,36,40-44,1901,4.072650235491177
STAT,1872,12,na,1884,2691.001025507361
SIM,1932,35,45-49,1967,2
STAT,1858,82,na,1940,377.4687647845864
SIM,1839,24,na,1863,1927
STAT,1885,30,na,1915,2448.2593165339413
STAT,1891,46,35-39,1937,0.10002422611572492
SIM,1816,71,na,1887,806
STAT,1880,34,50-100,1914,0.9738327982948443
STAT,1800,68,na,1868,876.3907320402133
STAT,1913,46,25-29,1959,0.05294984157626307
SIM,1830,86,na,1916,134
STAT,1875,18,35-39,1893,0.5729991180303834
STAT,1784,88,na,1872,38.65777794949838
SIM,1880,83,na,1963,385
STAT,1851,54,40-44,1905,0.008446648460914778
SIM,1935,25,50-100,1960,8
STAT,1792,108,na,1900,3.0383702484955736E-4
SIM,1873,36,40-44,1909,7
STAT,1905,24,na,1929,3462.717729605203
STAT,1923,18,25-29,1941,51.78309908063185
STAT,1855,46,25-29,1901,0.0447781940977882
STAT,1935,22,na,1957,5071.304411147083
SIM,1931,18,25-29,1949,61
SIM,1921,37,50-100,1958,1
STAT,1849,50,20-24,1899,5.811241836121332E-4
STAT,1856,28,50-100,1884,0.5270154969187141
STAT,1924,35,45-49,1959,0.8215687698848073
SIM,1847,49,45-49,1896,1
STAT,1908,42,na,1950,3503.849485871044
SIM,1864,45,na,1909,2078
SIM,1847,18,25-29,1865,8
SIM,1880,34,50-100,1914,1
STAT,1920,44,15-19,1964,0.0017250712068928042
SIM,1872,64,na,1936,1804
STAT,1860,44,40-44,1904,1.8366274451664568
STAT,1898,20,50-100,1918,0.5659248493300133
STAT,1885,62,na,1947,1860.2259954852082
STAT,1904,18,15-19,1922,8.653970937521503
STAT,1922,24,30-34,1946,33.420115891698984
STAT,1872,46,25-29,1918,0.05905915261132324
STAT,1838,19,20-24,1857,17.0038977667999
STAT,1844,48,15-19,1892,3.060695812549853E-4
STAT,1907,35,45-49,1942,0.6506266448264711
STAT,1928,19,na,1947,4705.330325123504
STAT,1900,26,45-49,1926,1.575300337451854
STAT,1861,43,45-49,1904,1.2525064761908713
SIM,1929,17,30-34,1946,21
STAT,1809,48,20-24,1857,0.052488379112527024
STAT,1843,103,na,1946,0.11585580286349313
SIM,1902,34,20-24,1936,1
SIM,1930,24,30-34,1954,71
SIM,1846,19,20-24,1865,13
SIM,1866,14,na,1880,2668
STAT,1839,49,45-49,1888,0.16174959040353273
STAT,1874,19,30-34,1893,1.6512107638588818
STAT,1842,43,35-39,1885,1.4504914000752536
STAT,1891,29,45-49,1920,1.3922879783570536
SIM,1802,69,na,1871,659
SIM,1832,38,45-49,1870,4
STAT,1840,35,25-29,1875,2.501931589254841
STAT,1873,29,na,1902,2450.619543519201
SIM,1895,59,na,1954,2640
SIM,1923,34,40-44,1957,4
STAT,1900,31,40-44,1931,6.156957983330586
STAT,1921,45,20-24,1966,0.012772543767740828
STAT,1953,18,na,1971,4540.47623362585
STAT,1932,37,45-49,1969,0.9341137242636829
STAT,1813,86,na,1899,95.41282717067371
STAT,1821,43,15-19,1864,0.023198061693525052
STAT,1824,52,30-34,1876,0.0066927684458536925
SIM,1809,48,na,1857,1103
STAT,1907,30,25-29,1937,8.880340434126326
STAT,1872,97,na,1969,29.46436179718952
STAT,1917,47,20-24,1964,0.011779513177950647
STAT,1913,53,na,1966,3580.2702528196965
STAT,1875,62,na,1937,1913.6539771387568
SIM,1857,37,25-29,1894,3
SIM,1877,49,30-34,1926,1
STAT,1773,94,na,1867,3.9951747380765195
SIM,1855,94,na,1949,11
STAT,1824,38,45-49,1862,2.661267506140032
SIM,1864,42,25-29,1906,3
STAT,1873,38,40-44,1911,4.504974401516997
SIM,1898,33,50-100,1931,4
STAT,1856,59,na,1915,1556.3328924250147
STAT,1830,49,25-29,1879,0.04657847173751162
STAT,1914,20,15-19,1934,5.356386249334918
SIM,1934,25,na,1959,5231
SIM,1793,69,na,1862,582
STAT,1829,29,20-24,1858,12.053323484711049
STAT,1852,18,40-44,1870,0.17716095579283472
SIM,1821,72,na,1893,663
SIM,1942,6,na,1948,4712
SIM,1864,27,15-19,1891,2
SIM,1900,41,35-39,1941,2
STAT,1891,43,30-34,1934,1.441539477636239
STAT,1845,40,35-39,1885,1.4781873265960224
STAT,1851,28,na,1879,2074.6736711203685
STAT,1831,73,na,1904,800.3329081624602
STAT,1899,16,30-34,1915,2.232055854336749
STAT,1844,19,45-49,1863,0.06358986489075263
SIM,1904,59,na,1963,3070
SIM,1847,43,na,1890,1571
STAT,1803,66,na,1869,900.4814419534717
STAT,1878,19,15-19,1897,6.2678748193615
STAT,1880,28,30-34,1908,26.900717213885525
STAT,1947,6,na,1953,4539.138938594812
STAT,1910,45,45-49,1955,0.20778916919602455
STAT,1829,26,na,1855,1858.7151660275256
STAT,1838,50,45-49,1888,0.011034804259180062
SIM,1864,13,na,1877,2495
STAT,1849,37,25-29,1886,2.287297999322519
SIM,1917,34,50-100,1951,2
SIM,1885,60,na,1945,1966
STAT,1856,27,15-19,1883,0.37648952355133364
SIM,1800,56,na,1856,1027
SIM,1873,5,na,1878,2734
STAT,1831,42,20-24,1873,0.13459457681951376
STAT,1853,46,50-100,1899,0.206519965576225
STAT,1873,47,30-34,1920,0.09964861674563925
SIM,1834,28,40-44,1862,2
SIM,1909,36,na,1945,3464
SIM,1914,18,25-29,1932,9
STAT,1923,40,25-29,1963,0.08539398921003855
SIM,1853,40,35-39,1893,1
SIM,1849,5,na,1854,2426
SIM,1844,34,50-100,1878,2
STAT,1844,21,50-100,1865,0.39740172520490213
STAT,1881,45,50-100,1926,0.24464465627645982
SIM,1905,7,na,1912,3775
STAT,1808,97,na,1905,1.7884713030514998
STAT,1923,44,40-44,1967,0.2972881078847476
STAT,1876,54,45-49,1930,0.014867398875228685
STAT,1878,60,na,1938,2025.1601519992712
STAT,1906,47,45-49,1953,0.19674655194699578
STAT,1796,89,na,1885,38.251228153027704
STAT,1900,40,30-34,1940,0.11402216240918972
STAT,1921,36,30-34,1957,2.078530522789483
SIM,1860,42,40-44,1902,6
STAT,1848,29,30-34,1877,23.03415444965654
SIM,1817,77,na,1894,359
STAT,1904,40,15-19,1944,0.0014162437837585483
SIM,1804,92,na,1896,39
SIM,1856,29,30-34,1885,42
STAT,1882,17,15-19,1899,5.898212492874704
STAT,1836,46,15-19,1882,2.639352356737764E-4
STAT,1831,44,50-100,1875,0.8717362283537945
SIM,1888,19,25-29,1907,10
SIM,1941,20,25-29,1961,109
STAT,1864,25,na,1889,2187.911150589086
STAT,1858,15,30-34,1873,1.5241536212883187
STAT,1875,84,na,1959,465.713480708976
STAT,1769,99,na,1868,0.16769492769886385
STAT,1826,28,40-44,1854,8.60761049700723
SIM,1964,0,na,1964,5247
STAT,1892,32,na,1924,3051.0463596425334
STAT,1891,58,na,1949,2497.701542034539
SIM,1881,38,40-44,1919,6
SIM,1904,37,na,1941,3697
STAT,1888,37,na,1925,2841.3560605928246
STAT,1819,50,35-39,1869,0.017068970987247332
STAT,1854,15,na,1869,2126.561793146225
STAT,1869,49,30-34,1918,0.0933485278601026
STAT,1933,20,25-29,1953,125.69734929295879
SIM,1866,15,30-34,1881,4
STAT,1920,24,20-24,1944,125.36149134897903
SIM,1883,42,35-39,1925,3
SIM,1850,43,35-39,1893,1
STAT,1877,18,45-49,1895,0.06893573952550619
STAT,1934,32,35-39,1966,12.724028519033972
STAT,1881,58,na,1939,1950.4597082197017
STAT,1911,46,15-19,1957,3.566081680830991E-4
STAT,1903,9,na,1912,3762.6452077191275
SIM,1919,36,na,1955,4211
STAT,1846,101,na,1947,0.4080653503088234
STAT,1843,52,40-44,1895,0.00845344443485945
STAT,1893,19,40-44,1912,0.23543395460302036
STAT,1915,34,40-44,1949,4.032239418009684
STAT,1875,42,35-39,1917,1.8936071076878092
STAT,1860,16,25-29,1876,5.441622546668557
STAT,1938,29,25-29,1967,66.45282074402647
STAT,1869,16,45-49,1885,0.06561405621618512
SIM,1867,27,40-44,1894,6
STAT,1890,31,20-24,1921,3.3854033984412757
STAT,1805,52,20-24,1857,0.0026004357659134905
STAT,1863,48,25-29,1911,0.050873062923602184
SIM,1896,18,20-24,1914,29
SIM,1923,42,40-44,1965,1
STAT,1886,41,35-39,1927,1.9641860766455654
STAT,1919,29,15-19,1948,0.7728270766104802
STAT,1781,81,na,1862,185.90766378727244
SIM,1840,64,na,1904,1177
STAT,1847,101,na,1948,0.4449797029553849
STAT,1829,48,na,1877,1612.6025340506555
SIM,1846,48,na,1894,1828
STAT,1863,61,na,1924,1671.404306125062
SIM,1876,14,na,1890,3012
STAT,1864,46,na,1910,2046.584955408309
STAT,1923,31,20-24,1954,2.8646989636186118
STAT,1859,14,na,1873,2237.1894290648406
STAT,1880,31,na,1911,2568.650519786717
STAT,1817,90,na,1907,38.47676157924316
SIM,1834,90,na,1924,27
STAT,1802,54,45-49,1856,0.03693816693535483
SIM,1877,0,na,1877,3750
STAT,1898,37,na,1935,3250.1940122721694
STAT,1809,46,50-100,1855,1.110850719592634
STAT,1868,50,30-34,1918,0.00588331788167859
STAT,1900,23,40-44,1923,2.937296584676797
SIM,1826,29,45-49,1855,3
SIM,1918,19,20-24,1937,1
STAT,1913,23,50-100,1936,0.6757470988059274
SIM,1909,58,na,1967,3103
SIM,1838,37,15-19,1875,2
SIM,1829,27,20-24,1856,7
SIM,1821,50,na,1871,1347
STAT,1917,20,40-44,1937,3.6685501121146937
STAT,1804,50,na,1854,1216.5872466853798
STAT,1926,30,35-39,1956,11.285370573065343
SIM,1886,4,na,1890,2961
STAT,1850,25,40-44,1875,2.6901492669502445
SIM,1787,73,na,1860,376
STAT,1839,26,na,1865,1894.4087215840584
SIM,1862,38,30-34,1900,7
STAT,1870,38,15-19,1908,0.05572308553958477
STAT,1908,42,35-39,1950,0.18997633350951323
STAT,1841,16,15-19,1857,5.6848438933574
STAT,1855,17,50-100,1872,0.04517154232494255
SIM,1806,83,na,1889,257
STAT,1841,47,35-39,1888,0.10383798771528982
STAT,1915,42,40-44,1957,0.25696737401501446
STAT,1888,49,40-44,1937,0.11403491130899539
STAT,1763,94,na,1857,1.3765394475133919
SIM,1941,17,50-100,1958,1
STAT,1801,85,na,1886,87.37658984225574
STAT,1883,44,35-39,1927,1.7880958224303232
STAT,1888,18,20-24,1906,21.324948888459826
SIM,1843,23,50-100,1866,1
STAT,1866,17,30-34,1883,1.5394060745516769
SIM,1934,30,35-39,1964,20
SIM,1901,30,na,1931,3566
STAT,1922,48,50-100,1970,0.26439054176108895
STAT,1902,36,20-24,1938,0.2405152880741069
SIM,1847,15,20-24,1862,24
STAT,1821,35,15-19,1856,0.13706706167408422
SIM,1811,72,na,1883,413
SIM,1847,46,40-44,1893,1
STAT,1857,54,35-39,1911,0.006670382115182208
STAT,1848,94,na,1942,15.5358400012311
STAT,1940,8,na,1948,4114.342171766972
STAT,1942,24,na,1966,3903.7320486174785
STAT,1859,27,40-44,1886,2.4826567035092326
STAT,1938,29,na,1967,3782.1531678320166
STAT,1922,36,na,1958,4372.033012127576
SIM,1842,41,35-39,1883,1
SIM,1869,44,na,1913,2228
SIM,1931,31,20-24,1962,3
STAT,1918,52,na,1970,3922.4126294612524
STAT,1888,59,na,1947,2343.8570247746
STAT,1916,41,30-34,1957,0.1338893695412254
SIM,1840,86,na,1926,126
STAT,1896,47,25-29,1943,0.04357303452740068
SIM,1823,41,25-29,1864,1
SIM,1840,37,40-44,1877,4
STAT,1865,39,45-49,1904,1.8271980776935013
STAT,1786,69,na,1855,561.6622000000001
SIM,1826,71,na,1897,772
STAT,1875,40,20-24,1915,0.16795675099537852
STAT,1797,85,na,1882,92.39696059002884
STAT,1816,53,35-39,1869,0.016602450193402597
STAT,1850,42,30-34,1892,0.8637213055277418
SIM,1847,65,na,1912,1191
STAT,1863,29,na,1892,2119.3732236727246
STAT,1882,32,25-29,1914,10.179887088275224
SIM,1903,33,50-100,1936,1
STAT,1849,79,na,1928,542.7577294056363
STAT,1839,15,20-24,1854,16.195713697089698
SIM,1861,15,na,1876,2878
STAT,1851,19,50-100,1870,0.04856509806721913
SIM,1912,24,na,1936,3561
STAT,1839,46,40-44,1885,0.12193464702088772
SIM,1779,86,na,1865,18
STAT,1879,51,45-49,1930,0.015549429132656679
SIM,1839,78,na,1917,555
STAT,1789,87,na,1876,46.225152051824665
SIM,1821,37,30-34,1858,7
SIM,1873,39,45-49,1912,2
STAT,1815,41,25-29,1856,2.145742543991374
STAT,1927,42,45-49,1969,0.21291794099808697
STAT,1930,23,na,1953,4756.612037173588
STAT,1897,28,15-19,1925,0.6166884531059111
SIM,1780,94,na,1874,7
STAT,1832,37,40-44,1869,3.717595288816911
STAT,1840,34,na,1874,1860.4802691213074
SIM,1849,39,40-44,1888,8
SIM,1834,47,na,1881,1599
SIM,1841,18,30-34,1859,2
STAT,1776,107,na,1883,0.0077501682562668775
STAT,1872,43,20-24,1915,0.16120219100693448
STAT,1822,47,25-29,1869,0.08212927502362588
SIM,1870,83,na,1953,350
STAT,1810,45,40-44,1855,0.5575379196611873
SIM,1814,70,na,1884,718
SIM,1925,20,40-44,1945,6
STAT,1835,53,45-49,1888,0.010807807046823312
STAT,1930,30,15-19,1960,0.16933368188249545
SIM,1885,82,na,1967,807
SIM,1915,30,25-29,1945,14
STAT,1945,19,15-19,1964,50.54633340911563
SIM,1858,16,35-39,1874,3
STAT,1877,47,15-19,1924,4.212608905826801E-4
SIM,1921,37,35-39,1958,8
STAT,1935,35,20-24,1970,0.3765599916648635
STAT,1913,37,35-39,1950,2.4350900906137287
SIM,1890,32,25-29,1922,17
SIM,1877,31,na,1908,2443
STAT,1913,43,20-24,1956,0.017541581900829904
STAT,1894,40,30-34,1934,1.5238380670826277
STAT,1806,84,na,1890,118.20652835719035
STAT,1839,27,15-19,1866,0.3944614727735514
STAT,1901,30,30-34,1931,25.107880571695855
STAT,1828,44,15-19,1872,0.010932629915917307
SIM,1881,78,na,1959,849
STAT,1807,52,30-34,1859,0.0245948307241372
STAT,1849,57,na,1906,1560.1982052162589
STAT,1858,23,50-100,1881,0.3419801264350747
STAT,1880,63,na,1943,1912.826991206829
STAT,1825,43,35-39,1868,2.4214233562071312
SIM,1908,41,na,1949,3795
SIM,1862,96,na,1958,12
SIM,1859,12,na,1871,2622
STAT,1864,40,45-49,1904,1.3712742632978778
STAT,1890,38,40-44,1928,5.433137919214735
STAT,1840,32,20-24,1872,2.3691371996192245
STAT,1878,59,na,1937,2063.689229921914
STAT,1893,39,20-24,1932,0.9875510483291382
STAT,1931,18,na,1949,4900.547998744031
STAT,1787,75,na,1862,478.18255534390937
STAT,1884,6,na,1890,2636.6068020980456
SIM,1824,69,na,1893,730
STAT,1826,48,20-24,1874,0.009253595044977978
STAT,1888,45,25-29,1933,0.07015931683774439
SIM,1873,59,na,1932,1932
STAT,1895,47,50-100,1942,0.18353706297498487
STAT,1892,34,35-39,1926,12.83722432518533
SIM,1856,79,na,1935,569
STAT,1830,37,30-34,1867,4.815187820345267
STAT,1911,34,20-24,1945,2.4020131860058096
STAT,1885,44,45-49,1929,1.502687639541887
SIM,1841,42,30-34,1883,1
STAT,1871,30,35-39,1901,10.315909167468055
STAT,1910,42,40-44,1952,0.24109579296472466
STAT,1872,34,50-100,1906,0.9287761430461802
STAT,1859,47,50-100,1906,0.19916114611909838
STAT,1860,31,35-39,1891,8.416572357209475
SIM,1920,31,45-49,1951,6
SIM,1929,29,25-29,1958,90
STAT,1843,16,25-29,1859,5.880657197881272
STAT,1931,20,15-19,1951,7.083167270327278
STAT,1922,48,40-44,1970,0.18429829308857895
STAT,1900,34,45-49,1934,2.4445667928433874
SIM,1833,43,35-39,1876,2
STAT,1838,94,na,1932,14.684813639076802
STAT,1895,35,15-19,1930,0.0754521734187831
SIM,1932,30,25-29,1962,5
STAT,1913,30,15-19,1943,0.13147869731960746
STAT,1907,32,40-44,1939,3.729952368578254
STAT,1855,64,na,1919,1347.5724481928066
STAT,1927,25,50-100,1952,1.2427268786863488
SIM,1873,49,na,1922,2212
STAT,1815,48,45-49,1863,0.6243874861592407
SIM,1915,32,40-44,1947,9
STAT,1783,72,na,1855,551.19942
STAT,1891,26,na,1917,3024.517782647633
STAT,1817,47,na,1864,1414.6392749811928
STAT,1870,31,na,1901,2389.504278811886
STAT,1823,54,na,1877,1289.8167281518763
STAT,1902,41,50-100,1943,0.10601973280749857
STAT,1924,30,25-29,1954,11.051249619136035
STAT,1823,47,40-44,1870,0.25737253796665327
STAT,1847,17,50-100,1864,0.047682984610758
SIM,1872,40,45-49,1912,5
STAT,1818,53,45-49,1871,0.03095945473234174
STAT,1925,2,na,1927,5040.550465344462
STAT,1851,71,na,1922,1101.233706337554
STAT,1912,26,na,1938,3778.896029761899
SIM,1854,67,na,1921,1357
SIM,1851,16,25-29,1867,4
STAT,1773,109,na,1882,0.0031344456422253194
STAT,1836,82,na,1918,290.41704008049715
STAT,1916,8,na,1924,4304.118828576821
STAT,1912,31,45-49,1943,1.586002943090851
STAT,1865,17,15-19,1882,5.662309149657701
SIM,1823,84,na,1907,167
STAT,1910,18,50-100,1928,0.07551689711459142
STAT,1920,45,na,1965,4163.792741372655
STAT,1852,38,20-24,1890,0.6179169809503439
SIM,1790,72,na,1862,386
STAT,1917,40,35-39,1957,0.2150449512356808
STAT,1911,29,50-100,1940,0.9830510717722973
SIM,1862,86,na,1948,121
STAT,1851,33,35-39,1884,8.606232895115845
STAT,1914,48,50-100,1962,0.22823067098933333
STAT,1896,44,20-24,1940,0.014658452817937737
STAT,1947,19,25-29,1966,49.77178130405762
STAT,1904,44,30-34,1948,0.11514893282847337
STAT,1861,71,na,1932,1125.1945259024837
STAT,1859,54,45-49,1913,0.01149834294285671
STAT,1888,69,na,1957,1828.7023797880793
STAT,1923,47,45-49,1970,0.2594111752541266
STAT,1950,20,25-29,1970,111.86932106817781
SIM,1884,11,na,1895,2838
STAT,1890,30,45-49,1920,2.192617731910946
STAT,1947,19,50-100,1966,0.43030349791388894
SIM,1849,15,30-34,1864,1
SIM,1894,35,50-100,1929,1
STAT,1804,72,na,1876,568.767826831166
STAT,1823,64,na,1887,986.6779994599788
STAT,1893,43,40-44,1936,0.20067813602567483
SIM,1841,49,na,1890,1678
STAT,1841,31,25-29,1872,9.271531880609016
SIM,1912,25,50-100,1937,1
SIM,1841,27,na,1868,1954
STAT,1823,32,na,1855,1603.0990570480124
SIM,1855,44,25-29,1899,3
STAT,1886,49,30-34,1935,0.10234339227799764
SIM,1878,40,50-100,1918,3
STAT,1897,43,25-29,1940,0.060386682845810245
STAT,1841,38,45-49,1879,1.7162690106010778
STAT,1772,109,na,1881,0.001723601092723479
STAT,1899,28,25-29,1927,58.88579296858948
SIM,1873,17,15-19,1890,8
SIM,1901,31,35-39,1932,22
STAT,1883,40,50-100,1923,1.068142097452121
STAT,1833,64,na,1897,1141.572500461989
STAT,1864,48,40-44,1912,0.15334123613302283
STAT,1906,29,50-100,1935,0.9430558032813019
STAT,1874,43,30-34,1917,1.1888004598975759
STAT,1905,30,15-19,1935,0.21150209924497418
STAT,1866,15,15-19,1881,5.799885446067824
STAT,1902,26,na,1928,3445.143312880966
STAT,1876,3,na,1879,3238.652551970688
STAT,1814,46,50-100,1860,0.7442470133734231
STAT,1925,18,35-39,1943,5.158007245531453
STAT,1894,76,na,1970,1690.185523973725
SIM,1940,30,25-29,1970,16
STAT,1847,44,25-29,1891,0.4940030593050081
SIM,1870,31,45-49,1901,3
STAT,1922,41,20-24,1963,0.020713051922018708
SIM,1933,18,35-39,1951,6
SIM,1820,66,na,1886,1041
SIM,1841,17,na,1858,2124
STAT,1906,19,na,1925,3730.0243023032954
STAT,1892,28,50-100,1920,0.8150073473554129
STAT,1959,13,na,1972,5239.097581925926
SIM,1882,43,30-34,1925,3
STAT,1813,50,40-44,1863,0.026300851557962558
STAT,1862,44,50-100,1906,0.9050393672198531
STAT,1856,46,40-44,1902,0.137486804510218
SIM,1874,15,15-19,1889,7
STAT,1915,45,45-49,1960,0.22453340516467388
STAT,1870,33,45-49,1903,1.7317100375676122
STAT,1873,34,25-29,1907,10.502712710042873
STAT,1845,48,30-34,1893,0.07468403552545605
STAT,1868,45,50-100,1913,0.241690385171896
STAT,1888,39,50-100,1927,1.4657801639002281
STAT,1873,31,20-24,1904,2.8070621205564534
SIM,1910,43,45-49,1953,1
STAT,1876,32,50-100,1908,0.9651999886623268
STAT,1858,42,35-39,1900,1.463158628356909
STAT,1899,45,50-100,1944,0.19546403663428868
STAT,1866,59,na,1925,1828.7418162874014
STAT,1941,18,na,1959,3866.6223906372074
STAT,1969,0,na,1969,5046.893372170496
STAT,1911,41,45-49,1952,0.16296395040185996
STAT,1920,30,40-44,1950,4.409458803698124
STAT,1836,50,35-39,1886,0.005641367918823073
SIM,1906,60,na,1966,3015
SIM,1857,8,na,1865,2474
STAT,1826,52,40-44,1878,0.007943125944243162
STAT,1874,78,na,1952,813.8063404632667
STAT,1870,63,na,1933,1779.4200670378095
STAT,1820,99,na,1919,1.0430558195039052
STAT,1846,53,20-24,1899,5.192293887704038E-4
SIM,1928,17,15-19,1945,60
SIM,1869,12,na,1881,2670
SIM,1872,96,na,1968,23
STAT,1912,46,30-34,1958,0.08761454784989925
SIM,1881,31,20-24,1912,5
STAT,1822,33,50-100,1855,2.4433255484892515
STAT,1869,45,15-19,1914,3.9789068361354476E-4
STAT,1852,54,35-39,1906,0.00674475127746759
STAT,1906,18,25-29,1924,8.392172359865778
STAT,1843,40,25-29,1883,0.5476004997018571
SIM,1815,87,na,1902,44
STAT,1807,47,na,1854,1497.7469172680428
STAT,1842,27,50-100,1869,0.6203648876471216
STAT,1829,53,20-24,1882,5.149981374583127E-4
STAT,1855,96,na,1951,6.656362130443238
STAT,1902,42,40-44,1944,0.22443161577917808
SIM,1939,19,40-44,1958,4
STAT,1802,91,na,1893,18.387161025762445
STAT,1852,45,45-49,1897,0.19201742132410127
STAT,1848,53,30-34,1901,0.004552820548496336
SIM,1874,41,30-34,1915,2
SIM,1920,46,30-34,1966,1
STAT,1859,34,50-100,1893,0.7400879069923985
STAT,1898,40,15-19,1938,0.001336316398398694
SIM,1917,23,na,1940,3862
STAT,1867,49,20-24,1916,0.011252820450137022
STAT,1795,72,na,1867,489.9335060577157
SIM,1833,84,na,1917,214
STAT,1886,47,na,1933,2418.0792813367884
STAT,1906,40,25-29,1946,0.06688139938807094
STAT,1840,106,na,1946,0.008737135118394945
STAT,1845,46,50-100,1891,0.1924436453295251
SIM,1837,29,20-24,1866,9
STAT,1920,31,45-49,1951,1.766121907109989
STAT,1905,56,na,1961,3126.2971006466546
STAT,1925,40,35-39,1965,0.24941928913437098
SIM,1851,40,25-29,1891,4
SIM,1823,45,40-44,1868,1
SIM,1840,33,25-29,1873,18
STAT,1842,50,50-100,1892,0.012013843893364963
STAT,1842,46,na,1888,1787.3836999445734
STAT,1916,19,50-100,1935,0.08068178545770605
SIM,1824,47,na,1871,1413
STAT,1882,36,40-44,1918,4.3716387543305375
STAT,1837,45,na,1882,1597.5201229162583
STAT,1932,32,25-29,1964,12.530290250348148
SIM,1900,21,40-44,1921,3
SIM,1899,26,25-29,1925,71
SIM,1837,65,na,1902,1068
STAT,1832,33,25-29,1865,8.884923729433114
STAT,1839,79,na,1918,482.4838793766843
STAT,1867,21,50-100,1888,0.3949988139758876
STAT,1791,91,na,1882,16.93981457081788
STAT,1880,24,15-19,1904,3.514511398755492
STAT,1866,41,30-34,1907,1.0866984326151339
STAT,1880,21,50-100,1901,0.4384832286669102
STAT,1902,43,45-49,1945,0.14843800268381563
SIM,1892,17,25-29,1909,12
SIM,1805,87,na,1892,23
SIM,1885,42,45-49,1927,4
SIM,1899,4,na,1903,3677
SIM,1922,46,40-44,1968,1
STAT,1815,45,40-44,1860,0.476188200069012
STAT,1768,117,na,1885,1.0118902698262559E-4
STAT,1853,33,50-100,1886,0.7829870134323343
STAT,1850,54,25-29,1904,0.0025910521840346633
SIM,1774,87,na,1861,87
SIM,1890,36,40-44,1926,10
SIM,1938,31,30-34,1969,18
STAT,1920,23,na,1943,4130.19099037806
SIM,1837,97,na,1934,1
STAT,1855,43,20-24,1898,0.1222222581722801
STAT,1930,34,30-34,1964,20.710751435578445
STAT,1833,45,35-39,1878,0.11129420274702885
STAT,1856,42,25-29,1898,0.5136084844647784
STAT,1901,63,na,1964,2755.7345376689073
STAT,1914,46,40-44,1960,0.1599325321459932
STAT,1867,53,40-44,1920,0.009920775767658312
STAT,1901,31,35-39,1932,14.5061012742559
STAT,1834,27,na,1861,1906.1322918060362
STAT,1884,17,25-29,1901,5.719330497030465
STAT,1816,84,na,1900,147.60711948073163
STAT,1845,44,15-19,1889,0.010709957937196537
STAT,1843,48,20-24,1891,0.009565555535757756
STAT,1814,50,na,1864,1379.6914766237915
STAT,1910,40,25-29,1950,0.06961188617452083
SIM,1863,19,20-24,1882,22
STAT,1892,31,30-34,1923,22.414556459443475
SIM,1886,30,45-49,1916,7
STAT,1959,4,na,1963,5245.965817846515
STAT,1881,40,45-49,1921,1.4909967942760571
STAT,1884,41,25-29,1925,0.6510505092863067
STAT,1829,50,50-100,1879,0.012291931122570713
STAT,1894,44,na,1938,3002.245830730212
STAT,1767,107,na,1874,0.005354202895760966
SIM,1851,31,35-39,1882,15
STAT,1862,34,na,1896,2054.530623695513
STAT,1876,45,50-100,1921,0.26130160621356324
STAT,1906,42,25-29,1948,0.06613176405855495
SIM,1810,88,na,1898,107
SIM,1951,0,na,1951,5428
SIM,1877,41,na,1918,2379
SIM,1832,35,na,1867,1801
STAT,1878,30,45-49,1908,1.8665813816983428
SIM,1833,40,30-34,1873,2
SIM,1916,30,40-44,1946,10
STAT,1786,90,na,1876,25.277756158166294
STAT,1876,19,40-44,1895,0.19164217710551432
SIM,1845,31,na,1876,2042
STAT,1881,48,na,1929,2191.0857176616387
STAT,1911,37,25-29,1948,0.9700558479126643
STAT,1877,42,45-49,1919,1.5816243267332013
SIM,1894,11,na,1905,3503
SIM,1838,17,20-24,1855,24
STAT,1867,11,na,1878,2580.195600900421
STAT,1855,19,20-24,1874,16.15408900819824
SIM,1826,28,na,1854,1794
STAT,1817,41,35-39,1858,4.739863604647404
STAT,1817,50,25-29,1867,0.0078960491502769
STAT,1857,15,15-19,1872,5.623274926345208
STAT,1815,54,30-34,1869,0.014697335111117456
STAT,1870,85,na,1955,273.3840413721563
STAT,1899,21,na,1920,3313.8760050971755
STAT,1875,1,na,1876,3626.3400775030022
STAT,1825,40,30-34,1865,1.6365634759310594
SIM,1912,56,na,1968,3564
STAT,1795,106,na,1901,0.0021721532445620603
STAT,1950,22,40-44,1972,4.069367977227426
SIM,1815,65,na,1880,852
STAT,1882,45,30-34,1927,0.09716642220345918
STAT,1830,33,50-100,1863,0.8611886612007883
SIM,1849,17,30-34,1866,2
STAT,1903,41,45-49,1944,0.1513972218302008
SIM,1923,19,na,1942,4190
STAT,1865,39,50-100,1904,1.125329409485478
STAT,1822,44,20-24,1866,0.23303829821481736
STAT,1838,54,25-29,1892,0.0025309345177288527
STAT,1860,53,30-34,1913,0.004847901643584792
STAT,1877,51,35-39,1928,0.009152708390408252
SIM,1892,41,25-29,1933,3
STAT,1864,78,na,1942,708.7330765759383
STAT,1832,30,20-24,1862,2.4235942708016327
STAT,1842,52,25-29,1894,0.0027628758963897915
STAT,1858,51,25-29,1909,0.002879225995788484
STAT,1812,45,15-19,1857,9.79658713722886E-4
STAT,1892,40,20-24,1932,0.20510116051752608
STAT,1864,15,50-100,1879,0.051118923784148784
STAT,1921,32,15-19,1953,0.14592838478216752
STAT,1898,16,15-19,1914,8.207131373342452
STAT,1928,41,15-19,1969,0.0019997854883275585
SIM,1825,41,35-39,1866,6
SIM,1882,46,35-39,1928,1
SIM,1916,18,35-39,1934,1
STAT,1852,42,40-44,1894,1.809789408502044
STAT,1874,46,35-39,1920,0.14623266594681147
SIM,1840,30,20-24,1870,2
STAT,1884,32,35-39,1916,10.221071649494752
SIM,1851,27,na,1878,2016
STAT,1831,49,40-44,1880,0.13645840966322598
STAT,1846,82,na,1928,333.66325118536895
STAT,1911,41,na,1952,3636.586105302654
SIM,1844,41,45-49,1885,5
STAT,1879,77,na,1956,963.4830854798008
STAT,1770,100,na,1870,0.1308546506023347
SIM,1947,21,na,1968,4286
STAT,1767,87,na,1854,36.0
SIM,1900,24,na,1924,3233
STAT,1881,26,na,1907,2361.8514752739125
STAT,1812,49,30-34,1861,0.22137210785879782
SIM,1914,1,na,1915,4283
STAT,1908,18,35-39,1926,0.8278297645389979
SIM,1892,32,35-39,1924,26
SIM,1955,6,na,1961,5094
STAT,1869,77,na,1946,851.3471134162724
SIM,1904,27,na,1931,3841
SIM,1881,34,25-29,1915,12
STAT,1863,45,20-24,1908,0.010840428680795636
STAT,1849,15,15-19,1864,5.738685668081106
STAT,1851,30,30-34,1881,15.307189076519315
STAT,1932,5,na,1937,5429.633819917796
SIM,1923,20,30-34,1943,4
STAT,1841,44,30-34,1885,0.859757783160625
SIM,1865,2,na,1867,3142
SIM,1810,66,na,1876,1123
STAT,1892,0,na,1892,3754.2879343076333
STAT,1841,35,40-44,1876,3.8880087522228672
STAT,1899,43,na,1942,3216.478310661124
STAT,1822,46,50-100,1868,0.35536353595575987
STAT,1836,41,45-49,1877,1.1225797216880329
STAT,1850,21,25-29,1871,52.0571528681573
SIM,1942,22,na,1964,4174
STAT,1940,31,20-24,1971,2.5768441336037413
SIM,1828,61,na,1889,1155
SIM,1798,68,na,1866,674
SIM,1868,17,40-44,1885,1
STAT,1915,20,30-34,1935,29.26573713750702
SIM,1828,83,na,1911,289
STAT,1871,54,45-49,1925,0.014261869831697856
STAT,1856,49,na,1905,1764.0626550779623
STAT,1893,46,45-49,1939,0.17277064512731086
SIM,1903,20,na,1923,3625
STAT,1886,45,15-19,1931,4.3623057856733604E-4
SIM,1896,39,50-100,1935,1
STAT,1949,13,na,1962,4660.213518229644
SIM,1883,59,na,1942,2014
STAT,1796,90,na,1886,30.95671894424533
STAT,1934,20,40-44,1954,4.623149627247841
SIM,1800,88,na,1888,10
SIM,1830,54,na,1884,1465
STAT,1813,54,na,1867,1179.8974508285928
STAT,1830,50,40-44,1880,0.008784272069731671
STAT,1879,51,50-100,1930,0.016181948257239422
STAT,1930,37,35-39,1967,3.2177594747181173
STAT,1879,55,na,1934,2204.9167026615273
SIM,1873,27,na,1900,2382
SIM,1871,3,na,1874,2857
SIM,1884,15,25-29,1899,11
SIM,1860,20,na,1880,2106
STAT,1914,42,25-29,1956,0.07219405872334697
STAT,1876,15,25-29,1891,5.997233417955554
STAT,1862,40,35-39,1902,1.5883779465243024
SIM,1870,40,35-39,1910,3
STAT,1882,4,na,1886,2804.3259661897655
STAT,1932,30,25-29,1962,12.544461490148802
SIM,1910,40,40-44,1950,2
SIM,1832,31,25-29,1863,19
STAT,1858,27,25-29,1885,35.03308579354205
STAT,1849,17,30-34,1866,1.5231624244192692
SIM,1857,15,15-19,1872,10
STAT,1847,41,20-24,1888,0.1261409513025107
SIM,1839,21,50-100,1860,4
STAT,1897,18,50-100,1915,0.06665162908247887
STAT,1808,65,na,1873,737.2948462219953
STAT,1844,43,45-49,1887,1.1726707567692722
STAT,1925,42,35-39,1967,0.2487288753912913
STAT,1856,49,45-49,1905,0.18504366679202686
STAT,1868,92,na,1960,73.82971135594846
SIM,1927,33,na,1960,4657
STAT,1903,12,na,1915,3745.0634545032513
STAT,1944,23,50-100,1967,0.7245976575263703
STAT,1899,43,35-39,1942,0.1743952640478125
SIM,1942,20,40-44,1962,5
STAT,1845,64,na,1909,1358.2610323889558
SIM,1890,39,45-49,1929,2
SIM,1886,77,na,1963,1118
STAT,1936,36,50-100,1972,0.4207832770705501
STAT,1897,47,40-44,1944,0.13111234003007266
STAT,1862,31,45-49,1893,1.520523780111968
SIM,1864,49,45-49,1913,1
SIM,1892,30,na,1922,3504
STAT,1885,50,30-34,1935,0.006145440095741691
STAT,1860,40,50-100,1900,0.8832637061585127
SIM,1858,29,40-44,1887,6
STAT,1877,11,na,1888,2753.2237792431724
STAT,1820,47,15-19,1867,7.295851401981717E-4
STAT,1824,31,25-29,1855,24.116343989448243
STAT,1940,32,25-29,1972,9.758680476118846
STAT,1882,39,45-49,1921,1.9613395372558438
STAT,1880,48,25-29,1928,0.06097302801962
STAT,1891,22,25-29,1913,72.30108947284411
STAT,1825,29,50-100,1854,2.1676432200456146
STAT,1860,47,45-49,1907,0.194429876665338
SIM,1847,97,na,1944,1
STAT,1833,42,30-34,1875,0.9217490002071884
STAT,1910,31,35-39,1941,9.02354997514609
SIM,1784,87,na,1871,81
SIM,1932,32,40-44,1964,13
STAT,1908,30,40-44,1938,3.796989502420665
STAT,1904,47,35-39,1951,0.1149234757472142
STAT,1820,49,30-34,1869,0.17147007485858862
STAT,1781,91,na,1872,16.94971085210328
STAT,1926,45,20-24,1971,0.013976104921665329
STAT,1847,40,50-100,1887,0.8499311532056597
STAT,1894,47,15-19,1941,2.9469955158394854E-4
STAT,1897,41,50-100,1938,0.10052149363583325
STAT,1949,16,30-34,1965,14.46686868886841
SIM,1873,32,25-29,1905,11
SIM,1928,18,na,1946,4844
SIM,1823,48,45-49,1871,1
STAT,1928,19,15-19,1947,58.01615066764263
SIM,1897,18,na,1915,3400
SIM,1936,19,15-19,1955,44
STAT,1918,46,50-100,1964,0.24622976735083016
SIM,1857,17,30-34,1874,4
STAT,1814,42,20-24,1856,0.5443836428466128
SIM,1855,40,50-100,1895,3
STAT,1841,83,na,1924,293.1164063597233
SIM,1866,27,25-29,1893,48
STAT,1822,51,45-49,1873,0.020291548992139148
STAT,1862,12,na,1874,2374.29648363111
STAT,1914,41,20-24,1955,0.017880192335590454
STAT,1922,35,50-100,1957,0.4883114738508099
STAT,1828,53,na,1881,1245.6094616392338
STAT,1881,33,20-24,1914,2.654715382866593
SIM,1877,63,na,1940,1814
STAT,1890,43,15-19,1933,0.017101076261586325
STAT,1811,44,45-49,1855,4.413798890277571
SIM,1852,43,45-49,1895,3
STAT,1866,44,35-39,1910,1.6809220297785212
STAT,1847,45,na,1892,1771.9462793897744
SIM,1898,16,15-19,1914,12
STAT,1924,32,40-44,1956,4.658051447193154
STAT,1883,81,na,1964,809.4863280466755
SIM,1829,51,20-24,1880,1
STAT,1825,52,50-100,1877,0.0187284612799296
STAT,1868,17,40-44,1885,0.18144149606258075
SIM,1869,19,15-19,1888,11
STAT,1875,30,na,1905,2518.576339392656
SIM,1847,27,15-19,1874,3
STAT,1920,48,30-34,1968,0.10028290451907788
STAT,1817,79,na,1896,341.18610606304213
STAT,1861,48,15-19,1909,3.3295024611320977E-4
STAT,1902,40,40-44,1942,0.2269756560092175
SIM,1862,64,na,1926,1524
SIM,1868,26,na,1894,2474
SIM,1874,44,35-39,1918,1
STAT,1782,76,na,1858,344.9650106875233
STAT,1834,54,40-44,1888,0.0069821602501676456
SIM,1867,34,50-100,1901,1
STAT,1866,50,20-24,1916,7.043383870524191E-4
STAT,1871,38,30-34,1909,5.358956698415419
STAT,1888,42,20-24,1930,0.19129591780082136
STAT,1832,46,na,1878,1629.0038710916308
STAT,1843,31,35-39,1874,9.93087485967967
SIM,1871,22,35-39,1893,6
STAT,1831,30,50-100,1861,0.8610108785040174
STAT,1914,31,20-24,1945,2.5153170951011616
STAT,1846,19,50-100,1865,0.043494309683569016
STAT,1911,30,40-44,1941,3.918250206707469
STAT,1830,52,20-24,1882,5.385353374926211E-4
STAT,1811,51,50-100,1862,0.04078061606849646
SIM,1776,90,na,1866,33
STAT,1848,20,45-49,1868,0.6695834653752967
STAT,1894,49,50-100,1943,0.177997502490914
STAT,1932,22,25-29,1954,123.59902097292583
STAT,1925,45,40-44,1970,0.1958347992489999
STAT,1915,18,40-44,1933,0.29794626939446306
STAT,1918,19,20-24,1937,149.78008788592146
SIM,1806,50,na,1856,1431
SIM,1874,23,15-19,1897,3
STAT,1857,25,50-100,1882,0.5325728907730172
SIM,1848,15,15-19,1863,6
SIM,1910,32,40-44,1942,9
STAT,1874,14,na,1888,2698.2779046763117
STAT,1833,105,na,1938,0.01925475867649122
SIM,1914,25,35-39,1939,23
STAT,1929,38,35-39,1967,3.1639937243303793
SIM,1865,61,na,1926,1752
SIM,1847,22,45-49,1869,2
SIM,1896,22,40-44,1918,10
STAT,1920,41,45-49,1961,0.18784920017657866
STAT,1840,65,na,1905,1216.0935581237666
STAT,1921,29,20-24,1950,20.61146469667802
STAT,1844,79,na,1923,541.7446188850803
STAT,1911,43,45-49,1954,0.161057985964261
SIM,1931,22,30-34,1953,43
STAT,1868,31,50-100,1899,0.8964081325917487
STAT,1888,22,40-44,1910,2.5131155552977202
SIM,1795,61,na,1856,965
SIM,1923,18,40-44,1941,3
STAT,1866,23,15-19,1889,3.1071592959279464
STAT,1915,23,35-39,1938,9.90143820041118
STAT,1923,20,na,1943,4361.167435197877
STAT,1839,22,45-49,1861,0.61835287905569
STAT,1946,17,na,1963,4165.232499607658
STAT,1931,41,20-24,1972,0.024096114875226376
STAT,1885,24,50-100,1909,0.41244220557031064
STAT,1912,39,50-100,1951,0.4138243326687352
SIM,1842,13,na,1855,2263
STAT,1896,30,50-100,1926,1.244429743671714
SIM,1884,44,na,1928,2407
STAT,1912,36,15-19,1948,0.019211977838235333
SIM,1847,53,50-100,1900,1
SIM,1922,23,na,1945,4509
SIM,1879,25,45-49,1904,4
STAT,1847,12,na,1859,2323.458617453345
STAT,1941,20,25-29,1961,97.45274061021931
STAT,1875,21,15-19,1896,3.464541578903026
SIM,1876,25,na,1901,2782
SIM,1899,23,20-24,1922,103
SIM,1907,22,40-44,1929,2
SIM,1931,24,25-29,1955,139
STAT,1921,34,15-19,1955,0.14467900420627386
SIM,1894,74,na,1968,1811
STAT,1902,32,40-44,1934,6.238997682768312
SIM,1905,32,30-34,1937,20
SIM,1940,30,50-100,1970,2
SIM,1940,22,25-29,1962,124
STAT,1934,38,45-49,1972,0.95840959294394
SIM,1829,31,40-44,1860,2
STAT,1862,48,30-34,1910,0.08300489228996717
STAT,1927,17,20-24,1944,171.95611444149827
STAT,1923,42,25-29,1965,0.08515761140649487
SIM,1870,48,30-34,1918,1
STAT,1910,29,45-49,1939,1.6893315495400085
SIM,1888,58,na,1946,2262
SIM,1926,19,20-24,1945,196
SIM,1859,77,na,1936,689
STAT,1921,41,na,1962,4274.723327586304
SIM,1867,96,na,1963,14
STAT,1917,36,na,1953,4006.9453731238304
STAT,1897,15,45-49,1912,0.08951626898698761
STAT,1867,15,30-34,1882,1.5790871150068382
STAT,1917,46,45-49,1963,0.23223970484266782
SIM,1901,61,na,1962,2983
STAT,1927,40,45-49,1967,0.21350895188245672
SIM,1935,17,20-24,1952,169
STAT,1931,19,35-39,1950,5.571367830615104
SIM,1855,21,40-44,1876,4
SIM,1901,1,na,1902,3941
SIM,1922,26,25-29,1948,85
STAT,1859,20,20-24,1879,64.94168171394004
STAT,1904,25,50-100,1929,0.9416175777937577
SIM,1933,17,50-100,1950,1
STAT,1930,27,20-24,1957,23.67287566480675
SIM,1808,48,50-100,1856,1
SIM,1916,39,na,1955,3840
STAT,1814,49,na,1863,1394.8887463641902
SIM,1838,24,45-49,1862,5
SIM,1852,43,na,1895,1949
STAT,1914,20,50-100,1934,0.6620997362149394
STAT,1907,19,45-49,1926,0.09732100173649036
SIM,1892,63,na,1955,2519
SIM,1915,19,45-49,1934,1
STAT,1924,16,40-44,1940,1.7035425338959334
SIM,1922,24,30-34,1946,41
SIM,1818,43,50-100,1861,1
SIM,1856,20,45-49,1876,1
SIM,1808,85,na,1893,94
SIM,1905,27,35-39,1932,19
STAT,1846,30,35-39,1876,8.737932038378995
STAT,1923,45,50-100,1968,0.27123409513047775
STAT,1903,31,45-49,1934,2.5391637047796607
SIM,1932,16,40-44,1948,3
STAT,1857,25,15-19,1882,0.3777279165594757
SIM,1884,64,na,1948,1713
STAT,1855,31,na,1886,1903.2035061356892
STAT,1897,62,na,1959,2588.4419226532427
SIM,1833,52,na,1885,1474
SIM,1869,33,35-39,1902,2
STAT,1829,27,50-100,1856,0.9100625873122221
STAT,1942,23,na,1965,3905.098833209101
SIM,1797,72,na,1869,449
SIM,1939,28,45-49,1967,3
SIM,1905,34,25-29,1939,10
SIM,1911,31,45-49,1942,5
STAT,1950,22,na,1972,4419.66938036865
STAT,1944,14,na,1958,4311.3332247328935
SIM,1923,23,35-39,1946,14
STAT,1880,46,25-29,1926,0.06192422176540279
STAT,1915,30,25-29,1945,9.682932503731841
SIM,1867,20,20-24,1887,4
STAT,1932,15,35-39,1947,5.6927828048786235
SIM,1940,15,35-39,1955,6
STAT,1929,37,na,1966,4926.355975656384
STAT,1867,20,50-100,1887,0.3978554158617753
STAT,1900,37,35-39,1937,2.1585752076669555
STAT,1943,18,15-19,1961,49.08457083472827
SIM,1829,47,na,1876,1291
SIM,1825,33,na,1858,1628
STAT,1916,47,40-44,1963,0.16502355596000712
STAT,1852,98,na,1950,2.6170301026487546
STAT,1920,23,45-49,1943,1.2725725203524014
STAT,1909,26,15-19,1935,0.6963008425768888
STAT,1811,47,15-19,1858,0.00111118374810643
STAT,1928,39,30-34,1967,2.3444570965052938
STAT,1863,22,35-39,1885,5.323575301474097
STAT,1905,29,35-39,1934,14.11459043299663
STAT,1859,16,35-39,1875,0.5219961277078483
SIM,1910,27,45-49,1937,1
SIM,1951,18,15-19,1969,63
SIM,1927,18,25-29,1945,68
SIM,1906,30,25-29,1936,16
STAT,1890,48,35-39,1938,0.09726655197192932
STAT,1895,30,30-34,1925,23.42587396079526
STAT,1877,42,na,1919,2442.4795514247994
SIM,1862,33,na,1895,2186
STAT,1826,50,na,1876,1434.6891530356654
STAT,1889,75,na,1964,1598.743623185048
STAT,1849,47,na,1896,1738.5444482746827
STAT,1908,15,45-49,1923,0.09926911224862993
STAT,1899,22,15-19,1921,4.608636602560466
STAT,1878,30,30-34,1908,18.688822501270806
STAT,1908,43,na,1951,3482.82638895582
STAT,1800,69,na,1869,844.3148312475416
STAT,1852,48,15-19,1900,3.181914225894147E-4
SIM,1910,22,na,1932,3466
STAT,1925,15,45-49,1940,0.6185218533680633
STAT,1847,41,50-100,1888,0.8391115296253522
SIM,1876,45,na,1921,2629
STAT,1761,112,na,1873,3.546027255464452E-4
SIM,1837,30,35-39,1867,14
SIM,1849,67,na,1916,1280
SIM,1930,25,20-24,1955,29
STAT,1889,23,na,1912,2971.091804263208
STAT,1914,26,25-29,1940,67.93204999891887
SIM,1923,30,25-29,1953,16
SIM,1821,51,na,1872,1311
SIM,1886,30,30-34,1916,30
STAT,1899,18,30-34,1917,2.22075365872179
SIM,1898,24,15-19,1922,4
STAT,1918,42,45-49,1960,0.18057463850641317
STAT,1919,18,25-29,1937,48.74118748099687
SIM,1904,28,30-34,1932,46
STAT,1807,91,na,1898,24.488938709083794
STAT,1847,21,40-44,1868,2.0064750664481448
SIM,1913,29,35-39,1942,23
STAT,1874,1,na,1875,3620.9310599178066
STAT,1940,17,35-39,1957,4.3464415843508855
SIM,1934,28,50-100,1962,3
SIM,1888,23,45-49,1911,1
STAT,1897,42,na,1939,3159.6085223526297
STAT,1825,88,na,1913,82.32386541372756
STAT,1832,78,na,1910,522.1083510080956
SIM,1940,19,50-100,1959,1
STAT,1775,108,na,1883,0.004722807272412963
SIM,1929,36,35-39,1965,1
STAT,1832,41,50-100,1873,0.8793910816726901
SIM,1866,24,20-24,1890,73
STAT,1840,97,na,1937,3.8658545243686144
STAT,1822,68,na,1890,888.5613033947324
STAT,1903,8,na,1911,3769.770073157395
STAT,1885,61,na,1946,1901.857659655057
SIM,1853,72,na,1925,979
SIM,1817,46,na,1863,1376
STAT,1883,15,15-19,1898,5.967879616648004
STAT,1933,32,40-44,1965,5.378237965870823
STAT,1858,24,20-24,1882,57.37627451446031
STAT,1904,37,20-24,1941,0.24325991653438117
STAT,1913,35,20-24,1948,0.2679109916622013
STAT,1926,41,40-44,1967,0.3150211780486833
STAT,1839,22,50-100,1861,0.3616098845711725
SIM,1915,16,40-44,1931,4
SIM,1901,34,40-44,1935,2
STAT,1903,38,15-19,1941,0.017489495179662626
SIM,1828,40,35-39,1868,4
SIM,1872,21,40-44,1893,2
SIM,1899,19,35-39,1918,1
STAT,1886,41,50-100,1927,1.1459312440945408
SIM,1922,27,35-39,1949,33
SIM,1785,71,na,1856,477
STAT,1920,38,15-19,1958,0.021434732457371524
STAT,1844,49,50-100,1893,0.1863445364208203
SIM,1890,43,50-100,1933,9
STAT,1795,105,na,1900,0.005245479943400291
STAT,1908,23,50-100,1931,0.6149377362182693
STAT,1914,27,35-39,1941,15.442265614737432
STAT,1784,89,na,1873,31.285739694529045
STAT,1780,75,na,1855,359.28015
SIM,1858,25,25-29,1883,56
STAT,1909,17,na,1926,3862.811364964057
SIM,1878,31,35-39,1909,20
STAT,1923,22,30-34,1945,34.120713714130716
STAT,1870,36,15-19,1906,0.056270384898028
STAT,1913,28,30-34,1941,39.688800289403964
STAT,1935,21,na,1956,5072.978494050119
STAT,1864,21,40-44,1885,1.9344714005507888
SIM,1866,21,15-19,1887,3
SIM,1921,28,30-34,1949,11
STAT,1813,87,na,1900,75.76255541487346
STAT,1923,24,25-29,1947,108.97162128822202
SIM,1836,80,na,1916,370
STAT,1913,32,15-19,1945,0.1304302801917523
SIM,1918,18,na,1936,4138
STAT,1808,96,na,1904,2.858581160475505
STAT,1835,24,50-100,1859,0.3982614610513177
STAT,1871,53,20-24,1924,7.33712930857389E-4
SIM,1835,31,na,1866,1837
STAT,1860,45,45-49,1905,0.1972880260197569
STAT,1849,31,15-19,1880,0.12936084051624192
STAT,1858,17,30-34,1875,1.506251967719388
SIM,1883,70,na,1953,1563
STAT,1792,76,na,1868,331.1281630062639
STAT,1854,53,20-24,1907,5.557020210880439E-4
STAT,1922,25,20-24,1947,21.218931895562278
STAT,1858,83,na,1941,321.1655238293174
STAT,1911,28,50-100,1939,0.9866424502913576
STAT,1859,21,30-34,1880,16.66539726748612
SIM,1840,54,na,1894,1454
STAT,1908,48,45-49,1956,0.19987338012016018
STAT,1893,38,50-100,1931,1.5809981162734583
SIM,1930,22,na,1952,5073
STAT,1860,50,40-44,1910,0.008839107770469418
STAT,1810,54,45-49,1864,0.04174640577941919
SIM,1816,40,na,1856,1707
STAT,1923,17,35-39,1940,5.027327506742344
SIM,1901,29,45-49,1930,5
STAT,1940,24,25-29,1964,95.92877988875074
SIM,1906,26,40-44,1932,1
SIM,1931,17,35-39,1948,4
STAT,1892,43,na,1935,2933.7163530135103
STAT,1904,29,20-24,1933,17.029564411228055
SIM,1898,24,na,1922,3579
STAT,1939,2,na,1941,4167.181058438833
STAT,1813,52,20-24,1865,0.0017710300466574082
STAT,1896,57,na,1953,2707.6832542547786
SIM,1936,15,na,1951,3198
SIM,1867,21,30-34,1888,23
STAT,1922,18,30-34,1940,14.35573824513146
STAT,1926,17,na,1943,4603.757386555763
STAT,1867,12,na,1879,2568.481512872333
SIM,1783,92,na,1875,10
SIM,1872,63,na,1935,1866
STAT,1852,16,50-100,1868,0.048017799747641886
SIM,1847,32,na,1879,1779
STAT,1932,18,40-44,1950,1.8838699463757587
STAT,1910,17,50-100,1927,0.07571527112493874
SIM,1854,22,35-39,1876,3
STAT,1927,39,50-100,1966,0.531352181076851
SIM,1839,34,50-100,1873,1
SIM,1907,25,45-49,1932,2
STAT,1931,31,20-24,1962,3.2614640461110813
SIM,1913,34,30-34,1947,6
STAT,1848,35,15-19,1883,0.04592695834019082
STAT,1947,18,50-100,1965,0.43045415686879307
SIM,1870,20,na,1890,2576
SIM,1930,18,30-34,1948,26
STAT,1837,46,na,1883,1577.183691751534
STAT,1833,32,na,1865,1831.706901084984
STAT,1868,21,25-29,1889,56.18163907199801
STAT,1858,21,15-19,1879,3.084373159090402
SIM,1940,18,40-44,1958,3
STAT,1915,22,25-29,1937,97.43341811353679
STAT,1915,48,35-39,1963,0.1322052601324122
STAT,1845,96,na,1941,6.709158614347837
STAT,1841,82,na,1923,344.5023815990355
STAT,1896,4,na,1900,3544.4661997908715
SIM,1883,27,na,1910,2427
SIM,1923,22,25-29,1945,154
STAT,1881,47,na,1928,2208.6221777529977
SIM,1906,49,na,1955,3276
STAT,1941,30,25-29,1971,9.911332382143954
STAT,1834,20,15-19,1854,5.355256251575354
STAT,1846,22,35-39,1868,5.1490027655347745
STAT,1799,102,na,1901,0.09513202754104516
STAT,1902,35,45-49,1937,0.6248943484535114
SIM,1879,10,na,1889,3195
SIM,1875,51,na,1926,2160
SIM,1913,42,na,1955,3804
STAT,1830,99,na,1929,1.1980454038955346
STAT,1933,10,na,1943,5425.570201497614
SIM,1905,31,20-24,1936,1
STAT,1779,98,na,1877,0.46773107193195246
STAT,1923,25,35-39,1948,17.70654034962524
STAT,1919,49,30-34,1968,0.09809173249014294
STAT,1854,32,35-39,1886,7.937283796928676
STAT,1938,33,30-34,1971,16.150135825840913
STAT,1901,33,35-39,1934,14.386094842784143
STAT,1805,68,na,1873,882.2433155270305
STAT,1878,15,35-39,1893,0.5853600558825771
STAT,1883,38,na,1921,2346.554787511548
STAT,1880,43,20-24,1923,0.1690224086125535
STAT,1854,44,50-100,1898,0.7976462837324676
STAT,1876,20,20-24,1896,73.02758582160392
SIM,1931,25,35-39,1956,22
STAT,1911,40,40-44,1951,0.24627279644572617
SIM,1876,77,na,1953,905
STAT,1819,42,50-100,1861,2.2804533046873328
SIM,1895,31,35-39,1926,20
SIM,1939,25,40-44,1964,3
STAT,1917,43,40-44,1960,0.2659546693395973
SIM,1856,17,15-19,1873,6
STAT,1881,16,na,1897,2497.0660672599906
STAT,1826,39,50-100,1865,1.0411503630353265
SIM,1928,37,30-34,1965,5
STAT,1838,63,na,1901,1311.0213874013468
STAT,1863,3,na,1866,2883.6789299351967
STAT,1884,15,30-34,1899,1.61613880944203
SIM,1919,39,30-34,1958,6
STAT,1874,25,15-19,1899,0.47576525547122
STAT,1932,4,na,1936,5450.45455632295
STAT,1923,21,20-24,1944,132.4053952026333
SIM,1912,57,na,1969,3542
SIM,1865,1,na,1866,3142
STAT,1887,31,35-39,1918,11.62389653620375
STAT,1914,19,35-39,1933,0.8808658159247883
STAT,1898,68,na,1966,2385.2438326537426
SIM,1818,83,na,1901,219
STAT,1924,19,45-49,1943,0.6036625274510543
STAT,1801,53,40-44,1854,0.029064768942897303
SIM,1858,30,20-24,1888,3
SIM,1866,79,na,1945,787
SIM,1899,10,na,1909,3610
SIM,1901,42,40-44,1943,2
STAT,1848,17,15-19,1865,5.71864888921987
STAT,1905,41,20-24,1946,0.016322010438906808
STAT,1930,19,20-24,1949,177.80951965749344
SIM,1857,9,na,1866,2446
SIM,1934,2,na,1936,5788
STAT,1848,52,50-100,1900,0.011677369935469218
SIM,1904,38,25-29,1942,4
STAT,1961,0,na,1961,5218.598871028674
SIM,1931,21,20-24,1952,179
STAT,1885,47,15-19,1932,4.0521320192050275E-4
STAT,1862,13,na,1875,2363.5171775954245
SIM,1933,37,40-44,1970,2
STAT,1902,17,15-19,1919,8.53771477498199
SIM,1938,26,50-100,1964,1
STAT,1910,34,40-44,1944,3.8154816527817883
STAT,1875,95,na,1970,68.17933752901283
STAT,1902,27,45-49,1929,1.597332591925101
SIM,1788,91,na,1879,40
STAT,1907,24,40-44,1931,3.101770141270749
STAT,1781,92,na,1873,10.376273989440586
STAT,1931,16,30-34,1947,16.31071529453545
STAT,1860,65,na,1925,1398.8060655281947
STAT,1916,19,na,1935,4159.269195990818
STAT,1846,30,50-100,1876,0.7905637590045608
STAT,1911,1,na,1912,4248.716677377817
STAT,1921,26,15-19,1947,0.8056219410639156
SIM,1829,34,45-49,1863,6
STAT,1907,42,40-44,1949,0.2336734033981322
STAT,1838,31,40-44,1869,4.00077230546483
STAT,1953,15,20-24,1968,167.38414336003225
STAT,1867,18,35-39,1885,0.5340708434806953
STAT,1846,50,na,1896,1561.9043244631055
SIM,1898,32,15-19,1930,4
SIM,1910,17,15-19,1927,10
STAT,1899,25,20-24,1924,16.49966681901187
STAT,1836,34,50-100,1870,0.7061056018918788
SIM,1896,25,45-49,1921,2
SIM,1879,30,40-44,1909,7
STAT,1769,88,na,1857,21.20257521428
SIM,1896,45,na,1941,3099
SIM,1857,42,na,1899,1953
STAT,1835,98,na,1933,2.420377209806278
SIM,1817,66,na,1883,800
STAT,1888,25,45-49,1913,1.3481325366784411
SIM,1813,52,na,1865,1253
SIM,1846,31,40-44,1877,5
SIM,1909,47,50-100,1956,1
STAT,1905,34,30-34,1939,14.644362936565672
STAT,1864,79,na,1943,634.1460075970867
SIM,1922,19,35-39,1941,8
SIM,1859,97,na,1956,22
SIM,1905,24,30-34,1929,34
SIM,1915,24,40-44,1939,3
SIM,1824,79,na,1903,276
STAT,1828,42,35-39,1870,1.480610922778682
SIM,1917,18,15-19,1935,46
SIM,1930,28,25-29,1958,112
SIM,1897,21,45-49,1918,1
STAT,1893,49,15-19,1942,2.8590552126290316E-4
SIM,1854,30,35-39,1884,13
STAT,1951,20,40-44,1971,4.100920608355477
SIM,1913,26,30-34,1939,62
STAT,1915,15,35-39,1930,0.9003505801712172
STAT,1818,86,na,1904,113.07183082421493
STAT,1931,23,20-24,1954,146.6264737333872
SIM,1836,42,35-39,1878,8
SIM,1838,19,20-24,1857,19
SIM,1906,29,45-49,1935,2
STAT,1881,27,na,1908,2353.773943228475
STAT,1836,35,50-100,1871,0.9577532704824662
SIM,1893,25,na,1918,3131
STAT,1901,40,25-29,1941,0.06425691814742943
SIM,1931,16,na,1947,4777
STAT,1821,47,30-34,1868,0.15252098611031126
STAT,1938,18,na,1956,3702.6215449073934
SIM,1844,35,50-100,1879,4
STAT,1916,17,45-49,1933,0.10815573095680459
SIM,1847,96,na,1943,6
STAT,1809,82,na,1891,238.0462216660069
STAT,1909,18,15-19,1927,9.052872058362778
SIM,1858,15,30-34,1873,4
SIM,1818,51,na,1869,1294
STAT,1857,97,na,1954,4.28016691735961
STAT,1931,24,30-34,1955,37.77902590571518
SIM,1887,32,40-44,1919,2
SIM,1800,89,na,1889,4
STAT,1853,83,na,1936,332.87307392796066
STAT,1889,36,15-19,1925,0.071103398555622
STAT,1935,16,15-19,1951,63.42563051653912
STAT,1937,29,30-34,1966,38.92112958797725
STAT,1957,15,40-44,1972,1.8817521788390175
SIM,1871,2,na,1873,3050
SIM,1860,43,45-49,1903,3
SIM,1943,16,15-19,1959,40
SIM,1923,15,35-39,1938,6
STAT,1928,43,15-19,1971,0.001993750686064752
STAT,1860,53,45-49,1913,0.011819264326544466
STAT,1863,50,na,1913,1953.580609129473
SIM,1914,28,40-44,1942,6
STAT,1855,11,na,1866,2211.1215434513765
STAT,1779,104,na,1883,0.02703398783923878
STAT,1889,21,45-49,1910,0.8813782861131458
STAT,1905,26,30-34,1931,37.22893800998084
STAT,1844,46,15-19,1890,3.1084433955254614E-4
STAT,1858,25,30-34,1883,21.157818799210293
STAT,1844,102,na,1946,0.227184637013725
STAT,1909,44,45-49,1953,0.15681071543673508
STAT,1869,23,na,1892,2322.158602813558
STAT,1860,103,na,1963,0.4586124613504554
SIM,1841,16,na,1857,2162
SIM,1878,0,na,1878,3722
STAT,1857,66,na,1923,1305.8303459390315
STAT,1920,15,45-49,1935,0.11528160945953637
SIM,1900,31,40-44,1931,13
STAT,1906,28,40-44,1934,4.432293519688602
SIM,1862,32,35-39,1894,8
STAT,1778,93,na,1871,4.3531653338555145
STAT,1911,31,na,1942,3771.9661794732892
STAT,1940,16,25-29,1956,44.89993075245039
SIM,1889,43,na,1932,2984
SIM,1870,52,na,1922,2339
STAT,1887,23,35-39,1910,6.6501195387681316
STAT,1881,47,30-34,1928,0.09502655896259748
SIM,1922,18,25-29,1940,99
SIM,1935,25,20-24,1960,37
SIM,1824,40,50-100,1864,2
STAT,1915,40,25-29,1955,0.07356654203546222
SIM,1892,5,na,1897,3844
SIM,1905,55,na,1960,3109
STAT,1913,36,30-34,1949,1.843717046121608
STAT,1915,31,50-100,1946,0.8627850441120164
STAT,1917,28,15-19,1945,0.7528569999979646
STAT,1875,31,na,1906,2508.7035201422373
STAT,1843,30,na,1873,2147.449661312458
STAT,1879,32,40-44,1911,4.624479328919052
STAT,1903,46,15-19,1949,3.2813417454991787E-4
STAT,1781,110,na,1891,0.0011849910534432603
STAT,1925,30,40-44,1955,4.746510361662148
STAT,1933,22,40-44,1955,4.548395768369671
STAT,1919,15,20-24,1934,30.816482034261984
STAT,1936,23,50-100,1959,0.6414090479692349
SIM,1877,62,na,1939,1863
STAT,1791,109,na,1900,1.2552857811895868E-4
STAT,1847,24,45-49,1871,0.6570834738370583
SIM,1828,32,35-39,1860,8
SIM,1866,25,30-34,1891,36
SIM,1905,35,35-39,1940,4
STAT,1910,26,40-44,1936,4.606328245206569
SIM,1872,29,50-100,1901,2
STAT,1850,51,50-100,1901,0.011414716145478742
STAT,1919,48,20-24,1967,0.0121978238526206
SIM,1921,36,30-34,1957,3
SIM,1923,40,na,1963,4249
STAT,1839,57,na,1896,1386.936457770257
STAT,1833,52,50-100,1885,0.01029546083436665
STAT,1897,20,40-44,1917,2.8593508242747894
SIM,1899,16,30-34,1915,3
STAT,1923,32,25-29,1955,10.810921596910307
STAT,1949,16,45-49,1965,0.59290433391827
SIM,1925,28,15-19,1953,1
SIM,1931,32,25-29,1963,10
STAT,1935,34,45-49,1969,2.2172740561848925
SIM,1898,2,na,1900,4079
SIM,1912,29,20-24,1941,26
STAT,1914,18,25-29,1932,9.12212283736254
STAT,1927,25,20-24,1952,22.790625787293916
STAT,1903,44,na,1947,3317.8557926724297
STAT,1887,32,na,1919,2727.8718366827597
STAT,1821,54,20-24,1875,0.0010730135510728705
STAT,1817,69,na,1886,799.5760165727124
SIM,1897,18,15-19,1915,13
STAT,1912,39,20-24,1951,0.2598231778334215
STAT,1922,28,25-29,1950,75.72841587182486
STAT,1889,18,15-19,1907,7.458792979581338
STAT,1905,33,20-24,1938,2.277122641720093
SIM,1927,15,20-24,1942,189
SIM,1933,30,40-44,1963,6
STAT,1898,47,50-100,1945,0.19023059179310964
STAT,1872,20,35-39,1892,6.001966603558892
SIM,1895,23,35-39,1918,11
SIM,1923,48,35-39,1971,1
STAT,1929,37,25-29,1966,1.2892794019972822
SIM,1858,22,20-24,1880,49
STAT,1895,33,35-39,1928,13.422353336944587
STAT,1939,27,40-44,1966,4.780078782844109
STAT,1889,22,50-100,1911,0.5138744859379514
SIM,1913,33,20-24,1946,2
SIM,1935,10,na,1945,5564
SIM,1883,21,15-19,1904,5
STAT,1878,41,35-39,1919,1.931533310098247
STAT,1908,38,15-19,1946,0.018243079190712677
SIM,1784,77,na,1861,361
STAT,1858,32,20-24,1890,2.1867952557998827
STAT,1864,29,50-100,1893,0.5761064693678838
STAT,1911,48,15-19,1959,3.5473486771833614E-4
STAT,1851,20,15-19,1871,3.297484834711053
STAT,1838,34,45-49,1872,1.559395297206643
SIM,1877,43,35-39,1920,2
STAT,1882,64,na,1946,1727.7141434842213
STAT,1893,28,na,1921,3077.639053934466
SIM,1883,79,na,1962,983
SIM,1902,18,20-24,1920,27
STAT,1842,36,na,1878,1990.8794856898503
SIM,1930,36,25-29,1966,2
STAT,1922,22,15-19,1944,6.228753513627531
STAT,1915,45,30-34,1960,0.09209675271352155
STAT,1901,44,40-44,1945,0.2198158762772512
STAT,1823,49,35-39,1872,0.20458885620333622
STAT,1905,18,30-34,1923,2.342166283053123
SIM,1831,49,35-39,1880,1
STAT,1924,42,40-44,1966,0.30353996035328873
STAT,1933,19,na,1952,4997.934873513066
SIM,1834,25,50-100,1859,1
SIM,1924,25,45-49,1949,2
STAT,1953,7,na,1960,4850.25359129548
STAT,1931,15,20-24,1946,181.8196504851278
SIM,1837,22,35-39,1859,6
SIM,1868,45,50-100,1913,1
STAT,1819,48,na,1867,1569.1367206567518
SIM,1917,36,45-49,1953,2
STAT,1876,21,30-34,1897,18.820632553023966
SIM,1904,39,35-39,1943,4
STAT,1872,49,30-34,1921,0.09690474744230161
STAT,1785,74,na,1859,449.7130886192809
SIM,1903,47,50-100,1950,1
STAT,1927,43,20-24,1970,0.02255767143793999
SIM,1858,26,35-39,1884,15
STAT,1789,88,na,1877,37.4100155555417
STAT,1922,36,25-29,1958,1.1442072264453391
SIM,1913,18,30-34,1931,3
STAT,1876,23,25-29,1899,60.117869395805315
SIM,1857,11,na,1868,2408
SIM,1850,52,na,1902,1578
SIM,1842,16,30-34,1858,1
SIM,1900,32,30-34,1932,37
SIM,1930,17,20-24,1947,175
STAT,1905,37,35-39,1942,2.2492490043182554
SIM,1889,20,na,1909,2990
SIM,1906,40,na,1946,3473
SIM,1921,24,15-19,1945,7
SIM,1900,46,40-44,1946,1
STAT,1835,48,15-19,1883,3.10271458176406E-4
STAT,1773,108,na,1881,0.005001748355953404
STAT,1872,43,na,1915,2346.009701252905
STAT,1876,57,na,1933,2117.004346127428
SIM,1829,78,na,1907,337
STAT,1931,34,25-29,1965,12.335453561859287
SIM,1859,13,na,1872,2612
SIM,1928,36,20-24,1964,3
STAT,1837,102,na,1939,0.1954675498436863
STAT,1922,17,20-24,1939,160.0976259016932
STAT,1793,70,na,1863,714.9238374047461
STAT,1910,30,25-29,1940,9.162415095716058
SIM,1822,33,50-100,1855,4
STAT,1860,42,40-44,1902,1.8594655498064234
STAT,1925,17,50-100,1942,0.461746050534141
SIM,1906,20,30-34,1926,49
SIM,1923,31,50-100,1954,2
SIM,1930,22,15-19,1952,9
STAT,1911,17,45-49,1928,0.10196562469720251
STAT,1933,36,35-39,1969,3.362860717623672
STAT,1814,49,40-44,1863,0.4942139027546623
SIM,1906,34,40-44,1940,5
SIM,1816,49,na,1865,1503
STAT,1872,21,50-100,1893,0.4181957751112699
SIM,1803,86,na,1889,11
SIM,1812,46,na,1858,1353
SIM,1838,51,na,1889,1426
SIM,1876,22,35-39,1898,11
SIM,1852,66,na,1918,1329
SIM,1947,24,35-39,1971,14
STAT,1825,44,na,1869,1596.250826938183
SIM,1932,24,40-44,1956,5
STAT,1907,46,35-39,1953,0.11862646753259339
STAT,1923,16,25-29,1939,52.046641465470195
STAT,1910,25,na,1935,3713.312525750352
SIM,1901,45,45-49,1946,1
SIM,1915,20,25-29,1935,6
STAT,1877,15,40-44,1892,0.194426314168704
STAT,1905,0,na,1905,4326.235413526093
STAT,1934,28,15-19,1962,0.9680190410315903
STAT,1833,63,na,1896,1171.7449324731735
SIM,1884,46,50-100,1930,1
SIM,1899,27,35-39,1926,22
STAT,1829,58,na,1887,1342.1362966779554
STAT,1843,53,45-49,1896,0.0115273755804906
STAT,1857,29,30-34,1886,20.369409182107592
STAT,1924,43,30-34,1967,0.15490268941437274
STAT,1849,34,20-24,1883,2.1658956267853324
STAT,1880,22,35-39,1902,6.255807438066318
SIM,1858,33,25-29,1891,4
STAT,1953,8,na,1961,4849.6230583286115
STAT,1861,38,15-19,1899,0.04710172306351931
STAT,1941,18,50-100,1959,0.3935743603852864
STAT,1927,32,45-49,1959,1.9745455287200608
STAT,1932,30,50-100,1962,1.1221566983785476
STAT,1868,22,35-39,1890,5.685901251058828
STAT,1844,15,na,1859,2287.9876847708633
STAT,1850,32,na,1882,1877.7443637883064
STAT,1886,40,30-34,1926,1.253952103281415
STAT,1914,39,na,1953,3793.9732481461856
SIM,1845,40,35-39,1885,8
STAT,1867,25,25-29,1892,40.78826840450986
SIM,1865,29,30-34,1894,30
STAT,1910,46,na,1956,3504.6071864373725
SIM,1898,28,30-34,1926,62
SIM,1846,34,45-49,1880,1
STAT,1840,46,30-34,1886,0.07114933853666444
STAT,1884,76,na,1960,1121.3455024580694
STAT,1939,24,35-39,1963,9.640040692851663
STAT,1806,85,na,1891,97.40927175802624
SIM,1853,45,50-100,1898,1
SIM,1931,16,25-29,1947,76
STAT,1905,44,25-29,1949,0.06481358247900201
SIM,1900,0,na,1900,3945
SIM,1879,33,45-49,1912,2
STAT,1880,62,na,1942,1959.3819052761914
STAT,1869,43,35-39,1912,1.7706022574976903
SIM,1867,32,na,1899,2178
SIM,1916,37,40-44,1953,2
SIM,1894,40,30-34,1934,2
STAT,1837,40,35-39,1877,1.461644143852609
SIM,1875,39,na,1914,2334
STAT,1815,104,na,1919,0.03448895309129746
STAT,1870,46,15-19,1916,4.000373079475606E-4
STAT,1909,41,40-44,1950,0.23997377637906026
SIM,1913,37,35-39,1950,4
STAT,1802,71,na,1873,555.5136781045723
SIM,1855,41,50-100,1896,2
STAT,1909,36,45-49,1945,0.6612578890452936
SIM,1888,39,50-100,1927,7
STAT,1904,45,20-24,1949,0.009995389108711618
STAT,1779,105,na,1884,0.016941389159215767
STAT,1942,15,45-49,1957,0.5328896330890927
STAT,1826,82,na,1908,272.12985502145267
SIM,1857,34,20-24,1891,3
STAT,1922,29,35-39,1951,17.210729803915207
SIM,1929,33,30-34,1962,31
STAT,1907,20,25-29,1927,86.25907330226886
SIM,1860,85,na,1945,246
STAT,1778,92,na,1870,7.110923803220482
STAT,1840,105,na,1945,0.021099094707546354
SIM,1930,29,35-39,1959,28
STAT,1910,23,35-39,1933,8.990667375748036
SIM,1864,99,na,1963,3
SIM,1832,67,na,1899,961
STAT,1943,28,45-49,1971,1.87628347729148
SIM,1857,27,30-34,1884,24
SIM,1861,47,na,1908,2416
STAT,1823,33,na,1856,1598.5607970151652
SIM,1948,15,40-44,1963,4
STAT,1868,0,na,1868,3668.218525611778
STAT,1873,48,35-39,1921,0.14297558830875023
STAT,1911,15,15-19,1926,9.306618816750786
STAT,1855,95,na,1950,10.30667842999433
STAT,1908,37,40-44,1945,1.4292197048975321
STAT,1925,41,25-29,1966,0.08833229090183976
SIM,1887,35,45-49,1922,1
STAT,1926,28,45-49,1954,2.1053132267312504
STAT,1840,39,40-44,1879,3.6491530530218905
STAT,1875,24,20-24,1899,71.70043059231038
STAT,1831,52,na,1883,1504.2389538200828
STAT,1925,37,40-44,1962,1.8330935001385178
SIM,1826,31,50-100,1857,1
STAT,1848,43,15-19,1891,0.010657291753662868
STAT,1879,13,na,1892,2749.6030203373807
SIM,1820,34,na,1854,1797
STAT,1838,16,15-19,1854,5.793756604712045
STAT,1932,26,40-44,1958,6.22880890873305
SIM,1868,20,35-39,1888,7
STAT,1921,38,30-34,1959,2.0745416545631303
SIM,1906,61,na,1967,2958
SIM,1927,30,45-49,1957,4
SIM,1930,34,50-100,1964,1
STAT,1878,27,na,1905,2534.156500774986
SIM,1824,48,na,1872,1398
SIM,1935,32,45-49,1967,3
STAT,1866,27,30-34,1893,23.695416815658444
SIM,1848,19,30-34,1867,2
SIM,1914,16,25-29,1930,16
SIM,1840,41,50-100,1881,3
SIM,1880,20,35-39,1900,11
SIM,1926,9,na,1935,5292
STAT,1920,27,50-100,1947,1.114254341177855
STAT,1891,17,50-100,1908,0.061876641807345104
SIM,1943,8,na,1951,3920
STAT,1916,44,35-39,1960,0.2098814771852127
STAT,1936,30,45-49,1966,1.5606773165000623
STAT,1858,28,35-39,1886,7.933650056913405
STAT,1811,52,na,1863,1208.7894509555479
STAT,1937,34,50-100,1971,0.8332939997681513
STAT,1838,62,na,1900,1342.9293897006337
STAT,1866,31,15-19,1897,0.1345489893683358
SIM,1883,58,na,1941,2060
STAT,1941,24,40-44,1965,3.542539059235
STAT,1924,24,40-44,1948,4.0225439127857125
STAT,1879,35,45-49,1914,2.145953162293402
STAT,1932,19,50-100,1951,0.5032202269213321
STAT,1943,25,50-100,1968,1.0824666035150272
STAT,1829,47,na,1876,1633.3956034530445
SIM,1895,60,na,1955,2579
STAT,1912,57,na,1969,3443.5965205045145
STAT,1935,26,45-49,1961,2.402673959787488
STAT,1912,32,20-24,1944,2.448420952195092
STAT,1904,38,30-34,1942,1.6735344158315117
SIM,1858,31,30-34,1889,32
STAT,1924,38,na,1962,4521.579987022816
SIM,1913,25,20-24,1938,22
SIM,1873,28,na,1901,2398
SIM,1920,32,20-24,1952,3
STAT,1847,76,na,1923,738.7976991424493
SIM,1942,23,na,1965,4360
STAT,1919,30,45-49,1949,1.7463832388403575
SIM,1908,36,15-19,1944,1
SIM,1934,28,45-49,1962,5
SIM,1890,38,35-39,1928,5
SIM,1904,27,20-24,1931,2
SIM,1863,0,na,1863,3348
STAT,1862,44,15-19,1906,0.01183058082816045
STAT,1900,33,50-100,1933,1.2900580447760301
SIM,1821,82,na,1903,190
STAT,1868,47,15-19,1915,3.879295932610355E-4
SIM,1834,21,20-24,1855,56
STAT,1849,27,30-34,1876,23.174967271091766
STAT,1905,25,20-24,1930,17.40173348508319
STAT,1906,36,40-44,1942,1.4097023281480687
STAT,1909,29,20-24,1938,17.6645900539554
SIM,1889,36,50-100,1925,5
SIM,1933,34,35-39,1967,19
STAT,1930,28,30-34,1958,50.79012180797033
SIM,1943,26,45-49,1969,3
SIM,1899,3,na,1902,3699
SIM,1845,84,na,1929,286
STAT,1848,51,50-100,1899,0.011796038078539317
SIM,1945,20,na,1965,4353
STAT,1846,81,na,1927,386.71246747336517
SIM,1849,21,15-19,1870,5
STAT,1945,20,45-49,1965,1.2590300363694418
SIM,1905,26,25-29,1931,95
STAT,1930,35,20-24,1965,0.3512979754905539
SIM,1838,32,45-49,1870,2
STAT,1877,20,35-39,1897,6.211279776703337
STAT,1878,28,na,1906,2525.2362698922598
SIM,1825,85,na,1910,166
SIM,1849,28,35-39,1877,11
SIM,1840,47,35-39,1887,1
SIM,1837,66,na,1903,1032
SIM,1942,27,40-44,1969,8
STAT,1917,38,45-49,1955,0.7190049529173012
STAT,1853,29,na,1882,2079.360426314715
STAT,1916,25,45-49,1941,1.8352438923281837
STAT,1947,23,na,1970,4209.491182959146
STAT,1934,27,40-44,1961,6.394399841919862
SIM,1849,35,25-29,1884,4
SIM,1886,41,35-39,1927,2
SIM,1832,66,na,1898,1004
SIM,1846,42,50-100,1888,1
SIM,1917,29,20-24,1946,28
STAT,1889,44,15-19,1933,0.01716746949069846
STAT,1829,26,50-100,1855,1.2402080694280404
SIM,1914,36,40-44,1950,1
SIM,1914,22,30-34,1936,44
STAT,1875,17,30-34,1892,1.668798291055745
SIM,1925,38,45-49,1963,3
SIM,1839,39,30-34,1878,19
STAT,1925,34,35-39,1959,11.05721436579512
STAT,1931,33,50-100,1964,1.1041998430757316
SIM,1884,39,20-24,1923,2
SIM,1925,20,na,1945,4559
SIM,1929,34,na,1963,5043
STAT,1799,87,na,1886,57.94675963011245
SIM,1922,15,20-24,1937,152
SIM,1908,38,45-49,1946,1
SIM,1851,26,na,1877,2049
SIM,1887,17,15-19,1904,6
STAT,1832,47,35-39,1879,0.11114529643065509
STAT,1857,41,15-19,1898,0.011052336076050785
STAT,1931,27,35-39,1958,19.76807776762801
STAT,1935,31,40-44,1966,5.524469652710338
SIM,1860,62,na,1922,1735
STAT,1831,48,30-34,1879,0.07815575515511017
STAT,1921,24,50-100,1945,0.7536371196523243
SIM,1833,28,50-100,1861,3
STAT,1862,44,na,1906,1979.9888624457406
SIM,1786,89,na,1875,13
SIM,1860,40,40-44,1900,8
STAT,1916,43,45-49,1959,0.1737714409730277
STAT,1876,16,35-39,1892,0.5794459774115972
STAT,1876,39,20-24,1915,0.8038620989217383
STAT,1906,22,30-34,1928,26.448492774566866
STAT,1914,15,20-24,1929,28.746749388122815
SIM,1845,85,na,1930,225
SIM,1841,71,na,1912,942
SIM,1859,25,40-44,1884,2
STAT,1897,23,45-49,1920,0.9482330169844077
STAT,1809,47,50-100,1856,1.0924080926673099
STAT,1811,50,50-100,1861,0.04160885763809079
STAT,1870,32,na,1902,2379.77899639712
STAT,1943,20,na,1963,3966.6784420058666
SIM,1868,58,na,1926,1912
STAT,1929,35,30-34,1964,2.390672560236803
SIM,1864,44,na,1908,2083
SIM,1894,10,na,1904,3510
STAT,1853,36,15-19,1889,0.04757699666333934
STAT,1901,47,45-49,1948,0.18902605507536657
SIM,1821,71,na,1892,744
SIM,1924,18,50-100,1942,1
STAT,1810,51,40-44,1861,0.032166807505513206
STAT,1863,22,50-100,1885,0.3720178843160747
STAT,1899,29,35-39,1928,13.38292185838195
STAT,1935,19,20-24,1954,187.99620289763428
SIM,1900,35,35-39,1935,1
STAT,1837,77,na,1914,576.3131960713993
STAT,1858,35,25-29,1893,2.3514141735175724
STAT,1803,97,na,1900,2.084617830644356
SIM,1881,8,na,1889,2384
STAT,1867,43,na,1910,2197.557433205278
STAT,1822,37,na,1859,1666.7078865261647
STAT,1883,16,50-100,1899,0.04915961833308426
STAT,1901,32,na,1933,3404.261643491367
SIM,1921,17,na,1938,4849
STAT,1890,37,30-34,1927,6.6477788183595585
STAT,1914,34,25-29,1948,9.41113936561911
SIM,1850,18,30-34,1868,2
STAT,1918,42,na,1960,4029.5735329387117
STAT,1904,34,15-19,1938,0.11853026871752716
SIM,1834,78,na,1912,508
SIM,1843,20,30-34,1863,18
SIM,1938,25,25-29,1963,81
SIM,1930,33,20-24,1963,2
STAT,1918,35,20-24,1953,0.2862328383230804
STAT,1892,27,50-100,1919,0.8178863071566039
STAT,1811,85,na,1896,118.74363429121648
STAT,1933,33,30-34,1966,21.63948126206174
STAT,1946,19,30-34,1965,13.783893543148864
STAT,1864,24,na,1888,2148.6024190028875
STAT,1844,70,na,1914,1087.2581762980278
SIM,1857,23,15-19,1880,1
SIM,1867,23,25-29,1890,59
STAT,1840,49,35-39,1889,0.09902192540452517
STAT,1899,30,15-19,1929,0.2005383068333419
STAT,1916,40,40-44,1956,0.2622975776040093
STAT,1810,90,na,1900,33.61236176461088
STAT,1818,63,na,1881,1009.932151978165
STAT,1833,32,15-19,1865,0.1216524559431474
STAT,1872,98,na,1970,20.87579497692675
STAT,1896,56,na,1952,2748.1079217842257
STAT,1924,20,25-29,1944,111.8654492213356
SIM,1936,16,na,1952,3189
STAT,1926,26,15-19,1952,0.8662946146014096
SIM,1834,37,na,1871,1769
SIM,1869,41,35-39,1910,5
STAT,1842,18,30-34,1860,1.595607417626089
STAT,1856,22,45-49,1878,0.6485497592782269
STAT,1931,18,25-29,1949,57.696303800419535
STAT,1921,18,15-19,1939,52.64989968013344
SIM,1947,21,30-34,1968,45
STAT,1922,33,20-24,1955,2.8001955054607213
STAT,1932,24,na,1956,4869.646643857106
STAT,1859,23,25-29,1882,48.04195873965914
SIM,1891,46,na,1937,2908
STAT,1849,23,15-19,1872,3.0743728756195408
STAT,1886,43,35-39,1929,1.9412137026838276
STAT,1823,46,30-34,1869,0.14760056492365858
SIM,1874,65,na,1939,1683
STAT,1953,19,na,1972,4538.887066944081
SIM,1893,30,50-100,1923,4
STAT,1933,25,45-49,1958,2.341416471904972
STAT,1913,39,35-39,1952,2.4105819919797744
SIM,1908,35,40-44,1943,3
STAT,1911,33,45-49,1944,1.5563947861491643
STAT,1912,21,45-49,1933,1.1033408257417332
STAT,1902,21,35-39,1923,8.42053295399213
STAT,1939,21,30-34,1960,29.45510519981493
STAT,1854,14,na,1868,2165.826897306639
STAT,1882,38,35-39,1920,6.994745867260247
STAT,1819,52,35-39,1871,0.016402544316799
STAT,1843,38,50-100,1881,1.0420380158621532
STAT,1942,30,40-44,1972,4.257799534619542
STAT,1835,20,30-34,1855,23.964769260894556
STAT,1846,102,na,1948,0.20965581568166733
STAT,1841,51,na,1892,1597.403681662783
STAT,1888,38,na,1926,2827.262934532281
SIM,1851,38,50-100,1889,4
SIM,1941,25,45-49,1966,5
SIM,1910,21,35-39,1931,13
SIM,1915,21,na,1936,4198
STAT,1815,47,35-39,1862,0.37661949403573364
STAT,1824,70,na,1894,772.5541416228153
SIM,1843,38,20-24,1881,1
SIM,1791,67,na,1858,743
SIM,1870,51,na,1921,2370
SIM,1921,39,35-39,1960,3
SIM,1920,21,45-49,1941,1
STAT,1907,16,40-44,1923,0.2746409763076008
STAT,1907,43,30-34,1950,0.11872043556773976
SIM,1918,17,20-24,1935,164
SIM,1866,28,35-39,1894,9
STAT,1839,20,15-19,1859,2.9678895210919993
STAT,1869,40,30-34,1909,1.1437434331905036
STAT,1820,37,15-19,1857,0.13660721990940966
SIM,1932,20,25-29,1952,141
SIM,1926,26,45-49,1952,7
SIM,1834,24,25-29,1858,63
SIM,1942,7,na,1949,4702
STAT,1929,15,50-100,1944,0.48993879574437954
STAT,1873,83,na,1956,442.6257961708706
STAT,1924,46,35-39,1970,0.15699073752260514
SIM,1845,45,50-100,1890,1
SIM,1915,54,na,1969,3990
SIM,1921,27,20-24,1948,32
SIM,1904,58,na,1962,3105
STAT,1913,27,20-24,1940,18.5550716644257
STAT,1920,7,na,1927,4576.686692643297
SIM,1879,15,15-19,1894,7
SIM,1891,15,15-19,1906,7
SIM,1922,34,25-29,1956,15
STAT,1827,46,15-19,1873,4.553361184772918E-4
STAT,1901,32,45-49,1933,2.4877004189523904
SIM,1899,32,30-34,1931,33
STAT,1910,20,30-34,1930,27.692523069081442
STAT,1850,55,na,1905,1555.3441331791723
STAT,1920,20,40-44,1940,3.8373809178160228
SIM,1831,44,50-100,1875,4
SIM,1901,27,15-19,1928,1
STAT,1773,93,na,1866,6.526143843439055
SIM,1886,5,na,1891,2956
STAT,1802,52,45-49,1854,0.03845883251634003
STAT,1837,45,50-100,1882,0.17439505893284665
SIM,1812,67,na,1879,734
SIM,1881,47,na,1928,2050
SIM,1883,24,20-24,1907,60
SIM,1835,21,35-39,1856,7
STAT,1900,34,30-34,1934,24.47580123315203
STAT,1830,31,35-39,1861,9.853481159983597
STAT,1863,4,na,1867,2720.4627025008645
SIM,1877,40,30-34,1917,1
SIM,1839,20,45-49,1859,2
SIM,1847,20,15-19,1867,4
STAT,1902,58,na,1960,2954.2450276777963
SIM,1840,85,na,1925,171
SIM,1826,70,na,1896,811
SIM,1906,23,35-39,1929,9
SIM,1943,19,20-24,1962,146
STAT,1873,28,na,1901,2459.572387007911
SIM,1831,39,40-44,1870,3
STAT,1894,37,15-19,1931,0.07368703855057404
SIM,1796,66,na,1862,650
STAT,1867,76,na,1943,907.3585216057626
SIM,1842,33,na,1875,1934
STAT,1854,25,na,1879,1935.0289353701842
STAT,1851,52,40-44,1903,0.008639256470560547
SIM,1880,33,50-100,1913,1
SIM,1938,29,40-44,1967,12
STAT,1922,34,50-100,1956,0.9485356870453143
SIM,1900,55,na,1955,2844
STAT,1893,15,25-29,1908,7.367649447487082
STAT,1947,7,na,1954,4526.974046239378
SIM,1928,29,30-34,1957,71
STAT,1817,104,na,1921,0.032551789911618216
STAT,1820,89,na,1909,57.85870166971228
STAT,1869,24,na,1893,2314.7741384566084
STAT,1861,102,na,1963,0.9064424888262032
STAT,1883,19,30-34,1902,1.5868523775695498
SIM,1817,45,na,1862,1399
STAT,1865,10,na,1875,2534.3555677879804
SIM,1883,17,30-34,1900,2
SIM,1934,25,40-44,1959,7
STAT,1936,29,15-19,1965,0.6884008321611128
STAT,1876,49,15-19,1925,4.1257348567298036E-4
STAT,1823,39,40-44,1862,7.573667573016071
SIM,1803,53,na,1856,1012
SIM,1820,39,30-34,1859,4
SIM,1854,14,na,1868,2446
STAT,1901,29,15-19,1930,0.6426166295584964
STAT,1856,48,35-39,1904,0.11070379282969063
STAT,1867,47,50-100,1914,0.23412230480100055
STAT,1939,31,25-29,1970,9.62583955276077
STAT,1922,40,45-49,1962,0.19545795609813704
STAT,1801,86,na,1887,70.71387415933755
SIM,1842,23,20-24,1865,69
SIM,1846,70,na,1916,999
SIM,1882,36,35-39,1918,8
SIM,1875,20,50-100,1895,4
STAT,1922,26,30-34,1948,45.39537976805855
STAT,1956,15,25-29,1971,58.514228997368996
SIM,1938,18,35-39,1956,6
SIM,1930,26,30-34,1956,80
STAT,1905,28,25-29,1933,62.10518591299335
STAT,1858,36,50-100,1894,0.9980338946518673
SIM,1913,28,25-29,1941,79
SIM,1925,32,35-39,1957,18
STAT,1879,17,15-19,1896,6.3283378998775675
STAT,1845,42,35-39,1887,1.4407922218039058
STAT,1926,44,45-49,1970,0.20861291369766707
STAT,1830,34,50-100,1864,0.846385865956973
STAT,1850,11,na,1861,2204.31394635696
STAT,1892,21,15-19,1913,4.230740915640746
STAT,1887,19,15-19,1906,6.747602021663387
STAT,1863,30,35-39,1893,9.13098250816709
SIM,1839,77,na,1916,640
STAT,1884,51,40-44,1935,0.010676211973495785
STAT,1944,25,20-24,1969,20.14613493064674
SIM,1878,23,35-39,1901,6
SIM,1931,31,50-100,1962,1
STAT,1801,75,na,1876,404.2655651589994
STAT,1814,105,na,1919,0.013663057423352755
SIM,1835,42,50-100,1877,3
STAT,1914,24,30-34,1938,29.7717630488497
STAT,1880,47,15-19,1927,4.268123429889862E-4
STAT,1926,25,40-44,1951,5.738806827302296
STAT,1821,35,50-100,1856,2.9967840151070724
STAT,1861,28,20-24,1889,9.889567701805248
STAT,1946,26,20-24,1972,20.755187902905604
STAT,1919,45,15-19,1964,4.0964624824409065E-4
STAT,1908,5,na,1913,3964.1064195257245
STAT,1876,46,50-100,1922,0.2594568168736956
STAT,1824,59,na,1883,1151.3071500486271
STAT,1867,22,20-24,1889,66.27157145013062
STAT,1824,48,na,1872,1410.554563777319
STAT,1843,50,40-44,1893,0.008620817019702224
STAT,1864,47,30-34,1911,0.08739621381844621
STAT,1853,84,na,1937,278.93764975941315
STAT,1940,21,20-24,1961,115.59615782965864
SIM,1875,22,20-24,1897,68
STAT,1907,57,na,1964,3191.020321537128
STAT,1794,88,na,1882,49.370790633201864
STAT,1903,15,45-49,1918,0.09516850976811309
STAT,1906,32,25-29,1938,8.732828836659845
SIM,1901,26,40-44,1927,10
STAT,1903,43,na,1946,3338.958007278428
STAT,1891,57,na,1948,2538.1598093963157
STAT,1948,17,40-44,1965,1.633132018039405
SIM,1856,25,na,1881,2415
SIM,1826,59,na,1885,1303
STAT,1825,30,15-19,1855,0.3458292558999684
STAT,1932,40,25-29,1972,0.0989750467474192
SIM,1898,35,20-24,1933,1
STAT,1883,50,na,1933,2186.2182367688774
SIM,1859,21,25-29,1880,61
SIM,1818,52,na,1870,1259
SIM,1933,31,30-34,1964,8
STAT,1881,32,50-100,1913,0.9036722846293817
STAT,1938,27,25-29,1965,66.51865793161132
SIM,1839,17,15-19,1856,9
SIM,1884,21,30-34,1905,27
SIM,1869,6,na,1875,2804
SIM,1889,64,na,1953,2338
STAT,1937,33,15-19,1970,0.12960174296899082
STAT,1885,30,50-100,1915,0.9400311455938707
SIM,1885,50,na,1935,2184
STAT,1846,18,15-19,1864,5.299827764671381
STAT,1906,25,35-39,1931,14.42437054759695
SIM,1875,25,25-29,1900,44
SIM,1805,49,40-44,1854,1
STAT,1836,29,na,1865,1717.3438089145375
SIM,1904,36,30-34,1940,3
STAT,1874,36,35-39,1910,7.402342414787462
STAT,1872,48,50-100,1920,0.24795353227844164
STAT,1929,42,20-24,1971,0.02332684507161729
SIM,1853,42,35-39,1895,1
SIM,1880,48,50-100,1928,1
STAT,1947,23,30-34,1970,33.130538804896986
SIM,1914,32,25-29,1946,10
STAT,1898,26,15-19,1924,0.6280543842045054
SIM,1854,18,15-19,1872,5
SIM,1902,30,40-44,1932,10
STAT,1871,17,na,1888,2568.6701666353897
STAT,1941,27,45-49,1968,1.823276447252723
STAT,1925,31,30-34,1956,19.09904637638091
STAT,1864,24,45-49,1888,0.6335036049874598
STAT,1928,38,20-24,1966,0.3394731395599372
STAT,1800,54,35-39,1854,0.03505217100438995
STAT,1815,89,na,1904,54.32059607778645
STAT,1952,16,15-19,1968,55.49508434804137
STAT,1930,24,15-19,1954,6.911610524902006
STAT,1874,54,35-39,1928,0.008720284698514654
SIM,1873,80,na,1953,462
SIM,1885,61,na,1946,1915
STAT,1916,22,40-44,1938,3.5954561078415965
SIM,1869,43,na,1912,2228
SIM,1820,86,na,1906,146
STAT,1834,23,20-24,1857,61.57725503621854
STAT,1918,53,na,1971,3904.683324376087
SIM,1815,45,35-39,1860,1
SIM,1849,25,30-34,1874,40
SIM,1835,64,na,1899,1147
SIM,1842,31,20-24,1873,5
STAT,1877,19,50-100,1896,0.05155962468135828
STAT,1918,38,25-29,1956,1.0579805197627417
STAT,1919,22,45-49,1941,1.2573022292079583
STAT,1836,36,15-19,1872,0.04335325483989554
STAT,1869,24,45-49,1893,0.682498422451061
STAT,1881,24,45-49,1905,0.6834470596210918
STAT,1884,25,25-29,1909,42.983739321600936
STAT,1888,41,45-49,1929,1.8131453888058666
STAT,1942,30,20-24,1972,2.653870102768588
SIM,1822,33,45-49,1855,3
SIM,1839,21,20-24,1860,56
STAT,1884,23,30-34,1907,17.92207680038848
STAT,1946,16,na,1962,4166.399091353238
STAT,1837,31,50-100,1868,0.7739313650581385
STAT,1861,20,25-29,1881,50.29515150466042
SIM,1956,7,na,1963,5511
STAT,1833,35,35-39,1868,5.982863904860956
SIM,1825,34,25-29,1859,1
SIM,1910,20,25-29,1930,88
SIM,1878,20,30-34,1898,26
SIM,1814,46,30-34,1860,1
SIM,1883,25,30-34,1908,33
SIM,1924,33,30-34,1957,30
SIM,1843,23,35-39,1866,6
SIM,1894,75,na,1969,1719
SIM,1924,35,na,1959,4569
STAT,1841,34,15-19,1875,0.12495271852574494
STAT,1813,49,25-29,1862,0.1399882689994013
STAT,1898,38,30-34,1936,1.5790865307278914
SIM,1943,18,na,1961,3592
STAT,1939,20,20-24,1959,113.99750063883347
SIM,1907,36,35-39,1943,5
SIM,1846,24,15-19,1870,3
STAT,1897,73,na,1970,2036.936507408189
STAT,1849,38,35-39,1887,5.560842362585552
SIM,1914,39,45-49,1953,2
STAT,1811,108,na,1919,7.934264850658486E-4
STAT,1841,52,30-34,1893,0.004371683519665477
STAT,1873,37,30-34,1910,5.51211359787921
SIM,1927,22,45-49,1949,4
SIM,1881,37,30-34,1918,2
STAT,1925,33,25-29,1958,11.19086249727671
SIM,1841,35,35-39,1876,13
STAT,1840,66,na,1906,1179.428337346335
SIM,1916,16,na,1932,4210
STAT,1823,31,45-49,1854,5.077642706453353
SIM,1857,38,35-39,1895,7
STAT,1911,19,30-34,1930,2.4746193196151314
STAT,1835,23,35-39,1858,5.740336456356972
STAT,1946,23,15-19,1969,6.041750274836197
SIM,1889,15,25-29,1904,12
STAT,1858,36,35-39,1894,5.74958824427353
SIM,1948,2,na,1950,4622
SIM,1872,39,30-34,1911,5
STAT,1903,42,20-24,1945,0.015973165021022882
SIM,1808,62,na,1870,1126
STAT,1834,31,20-24,1865,2.3543781427773305
STAT,1919,38,na,1957,4120.33689853334
SIM,1892,25,25-29,1917,72
STAT,1900,41,40-44,1941,0.22185022863814222
STAT,1828,32,na,1860,1585.698469482739
STAT,1826,32,25-29,1858,11.165910106195733
STAT,1923,43,na,1966,4421.964286740483
STAT,1894,29,15-19,1923,0.5911016088061819
STAT,1847,22,15-19,1869,3.153783579793278
SIM,1858,37,na,1895,1941
SIM,1865,84,na,1949,192
STAT,1830,48,15-19,1878,3.276858732505293E-4
SIM,1899,19,na,1918,3481
SIM,1901,2,na,1903,3905
STAT,1780,96,na,1876,1.4190055309845215
STAT,1842,67,na,1909,1243.1351255642783
STAT,1920,19,25-29,1939,49.34998825266611
STAT,1827,38,15-19,1865,0.07109923315701656
STAT,1893,23,25-29,1916,73.85528565754883
STAT,1838,24,15-19,1862,3.099848178650318
STAT,1866,52,35-39,1918,0.008057742924121746
STAT,1934,24,35-39,1958,12.895660821262657
SIM,1947,20,20-24,1967,136
STAT,1889,54,na,1943,2638.758889198459
STAT,1896,17,15-19,1913,7.995937442653122
STAT,1901,17,35-39,1918,0.7827770350321548
SIM,1882,29,45-49,1911,1
STAT,1951,21,30-34,1972,35.041823801211926
SIM,1881,13,na,1894,2373
SIM,1816,81,na,1897,243
STAT,1822,105,na,1927,0.017048328417537145
SIM,1938,22,20-24,1960,121
SIM,1859,33,40-44,1892,7
STAT,1836,51,na,1887,1383.1358990415893
STAT,1874,29,45-49,1903,1.1481840176134221
STAT,1931,30,45-49,1961,2.1052236451035835
SIM,1858,41,25-29,1899,3
SIM,1778,92,na,1870,13
STAT,1921,40,15-19,1961,0.0017699239095531653
STAT,1943,22,35-39,1965,10.220759658380521
SIM,1838,18,30-34,1856,1
STAT,1897,63,na,1960,2554.740408820298
SIM,1833,33,20-24,1866,4
STAT,1819,101,na,1920,0.3364151491714694
STAT,1820,66,na,1886,897.0406838270615
SIM,1851,24,25-29,1875,65
SIM,1892,18,35-39,1910,1
SIM,1835,54,na,1889,1417
STAT,1864,39,30-34,1903,4.785709996751747
STAT,1872,31,40-44,1903,4.452107618506397
SIM,1823,39,35-39,1862,11
SIM,1799,84,na,1883,150
SIM,1921,3,na,1924,5303
STAT,1902,28,20-24,1930,16.81799118119387
STAT,1944,28,25-29,1972,72.54517318276811
STAT,1926,37,20-24,1963,0.32865951966767154
STAT,1913,16,15-19,1929,9.489317938789577
SIM,1831,31,45-49,1862,3
SIM,1834,32,25-29,1866,11
SIM,1905,20,15-19,1925,2
STAT,1916,40,20-24,1956,0.01851985995063068
SIM,1874,27,30-34,1901,26
STAT,1859,24,na,1883,1970.5574190265777
SIM,1880,51,na,1931,2060
STAT,1777,105,na,1882,0.02475443643369777
SIM,1873,38,35-39,1911,14
STAT,1945,20,50-100,1965,0.7362749031240293
SIM,1899,35,35-39,1934,17
SIM,1827,35,na,1862,1685
STAT,1889,47,35-39,1936,0.09905168624681181
STAT,1890,22,45-49,1912,0.8697949010743178
STAT,1863,39,na,1902,2086.098721011574
STAT,1849,24,na,1873,1978.222942174829
SIM,1922,38,40-44,1960,3
STAT,1828,53,50-100,1881,0.010177263145339135
STAT,1917,32,35-39,1949,9.76540989181057
STAT,1902,20,25-29,1922,82.84752528664332
SIM,1850,31,na,1881,1933
SIM,1848,27,na,1875,2059
STAT,1833,28,30-34,1861,21.972899838514746
STAT,1846,44,45-49,1890,1.0558331958295328
STAT,1937,25,15-19,1962,0.7025482116503763
SIM,1849,43,50-100,1892,1
STAT,1865,38,35-39,1903,6.5163557659651214
SIM,1855,40,45-49,1895,2
SIM,1836,81,na,1917,312
SIM,1890,51,na,1941,2822
STAT,1879,25,15-19,1904,0.4870902846599467
SIM,1841,28,30-34,1869,43
STAT,1812,47,na,1859,1396.8328876421956
STAT,1850,96,na,1946,6.458925274922822
STAT,1815,39,35-39,1854,26.91374600275063
STAT,1877,37,15-19,1914,0.059416353624205345
STAT,1843,24,25-29,1867,57.17658473583372
STAT,1860,21,20-24,1881,59.225176912183926
STAT,1916,33,30-34,1949,16.529150325962288
SIM,1880,31,40-44,1911,8
SIM,1921,16,15-19,1937,66
STAT,1879,43,45-49,1922,1.5844209546498629
SIM,1933,33,25-29,1966,16
STAT,1833,28,45-49,1861,0.9688140904411541
SIM,1892,23,30-34,1915,40
STAT,1926,3,na,1929,5073.1776826819105
STAT,1838,52,na,1890,1573.6225619928373
STAT,1877,42,50-100,1919,1.116440698024132
STAT,1851,19,35-39,1870,0.5439291991299858
SIM,1874,34,20-24,1908,5
SIM,1877,42,50-100,1919,2
STAT,1847,40,45-49,1887,1.2040691371584333
SIM,1852,12,na,1864,2495
STAT,1866,34,20-24,1900,2.521721269927851
STAT,1850,86,na,1936,166.89633729078602
STAT,1884,18,35-39,1902,0.5523516352318251
SIM,1825,54,na,1879,1300
SIM,1825,32,30-34,1857,21
STAT,1882,53,30-34,1935,0.005821111655160947
SIM,1827,45,na,1872,1486
STAT,1856,112,na,1968,2.4050657648962747E-4
SIM,1910,28,20-24,1938,20
STAT,1832,36,30-34,1868,4.575386981432037
SIM,1909,31,40-44,1940,7
SIM,1840,36,30-34,1876,6
SIM,1928,1,na,1929,5433
SIM,1926,23,40-44,1949,6
STAT,1898,27,na,1925,3292.3339181263227
STAT,1932,29,45-49,1961,2.3053795993892985
STAT,1918,23,40-44,1941,3.6892151511481863
SIM,1888,57,na,1945,2315
SIM,1940,29,45-49,1969,6
SIM,1842,12,na,1854,2263
STAT,1852,77,na,1929,696.3557295007081
SIM,1875,26,35-39,1901,14
SIM,1882,33,15-19,1915,1
STAT,1855,112,na,1967,1.9627033087554654E-4
SIM,1850,21,na,1871,1973
STAT,1867,33,25-29,1900,9.7682701563727
SIM,1933,18,na,1951,4882
STAT,1908,41,25-29,1949,0.06775831835129696
SIM,1833,29,35-39,1862,18
STAT,1838,42,45-49,1880,1.286024895357081
SIM,1891,13,na,1904,3336
STAT,1850,27,35-39,1877,8.541180700912705
STAT,1905,40,45-49,1945,0.15466943315631132
SIM,1879,74,na,1953,1382
STAT,1922,49,50-100,1971,0.2635735749870472
STAT,1851,26,25-29,1877,41.157870446376194
STAT,1834,24,30-34,1858,15.802014834482057
SIM,1886,76,na,1962,1183
STAT,1874,33,15-19,1907,0.1477004633258178
SIM,1941,25,30-34,1966,68
STAT,1766,108,na,1874,0.006909918713057636
STAT,1836,20,50-100,1856,0.3565065491172183
STAT,1845,15,45-49,1860,0.06527621164631292
SIM,1902,29,25-29,1931,63
STAT,1878,53,50-100,1931,0.01577953252678457
SIM,1851,24,50-100,1875,3
STAT,1858,40,20-24,1898,0.12977738011859855
SIM,1837,44,45-49,1881,1
SIM,1875,33,25-29,1908,13
SIM,1926,16,na,1942,4757
STAT,1810,108,na,1918,7.809248289028367E-4
STAT,1890,29,30-34,1919,31.18581637994447
SIM,1846,42,45-49,1888,2
STAT,1853,28,15-19,1881,0.3981665753093041
STAT,1899,34,30-34,1933,24.181872746927407
SIM,1842,24,30-34,1866,32
STAT,1798,92,na,1890,14.336905191715587
STAT,1870,28,15-19,1898,0.45086795739398783
STAT,1933,25,30-34,1958,53.10379991891901
STAT,1862,2,na,1864,2978.5989205249894
SIM,1884,75,na,1959,1015
STAT,1855,42,45-49,1897,1.158764501345256
SIM,1843,30,25-29,1873,16
STAT,1897,49,35-39,1946,0.10547111630107392
STAT,1856,45,15-19,1901,3.23514594615782E-4
SIM,1861,28,15-19,1889,3
STAT,1860,46,35-39,1906,0.1162090008308536
STAT,1899,36,25-29,1935,4.041510046041135
SIM,1913,40,45-49,1953,2
SIM,1858,27,na,1885,2000
SIM,1953,18,na,1971,4384
STAT,1840,38,30-34,1878,4.489190596287285
SIM,1847,16,30-34,1863,2
STAT,1947,15,30-34,1962,14.016021677812033
STAT,1826,51,na,1877,1406.5548999511827
SIM,1898,39,35-39,1937,4
STAT,1874,51,30-34,1925,0.006229612880394249
STAT,1942,23,30-34,1965,30.73483772916308
SIM,1862,30,50-100,1892,1
SIM,1830,96,na,1926,4
SIM,1930,21,na,1951,5200
STAT,1772,87,na,1859,29.509824567498196
STAT,1917,29,50-100,1946,1.0576177953523915
SIM,1856,39,30-34,1895,2
SIM,1862,19,50-100,1881,1
STAT,1882,35,15-19,1917,0.05634075881712178
STAT,1887,45,45-49,1932,0.27246906519150516
STAT,1888,48,30-34,1936,0.06502519576495638
SIM,1876,56,na,1932,2340
STAT,1857,37,30-34,1894,4.246175303862061
STAT,1868,25,40-44,1893,2.9385816193088345
STAT,1862,38,50-100,1900,1.0608836432770543
STAT,1913,43,na,1956,3688.9464406115962
STAT,1839,16,30-34,1855,1.4474864845326607
STAT,1860,24,25-29,1884,48.1462150492465
STAT,1829,26,15-19,1855,0.8796189559805467
STAT,1843,17,35-39,1860,0.5660699510532085
STAT,1840,23,45-49,1863,0.6335473055070184
STAT,1848,39,30-34,1887,4.181547831871111
SIM,1916,34,35-39,1950,13
SIM,1891,23,na,1914,3013
STAT,1833,50,30-34,1883,0.004221779420036335
STAT,1927,21,40-44,1948,4.238532047148336
STAT,1825,99,na,1924,1.1356816488128414
STAT,1860,17,35-39,1877,0.5238086331154475
STAT,1885,29,20-24,1914,11.854684779296592
SIM,1946,24,20-24,1970,140
SIM,1901,22,25-29,1923,110
STAT,1858,62,na,1920,1478.6485100169511
STAT,1910,15,35-39,1925,0.8519511773957034
SIM,1888,17,30-34,1905,2
STAT,1815,44,15-19,1859,0.039176163405259555
STAT,1813,49,50-100,1862,0.596894428972191
STAT,1825,36,25-29,1861,4.558357783085222
SIM,1863,28,na,1891,2175
STAT,1938,17,30-34,1955,12.265125840428105
STAT,1817,47,50-100,1864,0.5487441987050852
STAT,1835,30,25-29,1865,9.92382561052279
STAT,1924,35,30-34,1959,2.1964604281087223
STAT,1875,32,20-24,1907,2.8301313057838478
SIM,1884,31,25-29,1915,14
SIM,1911,19,25-29,1930,10
SIM,1947,16,35-39,1963,8
STAT,1830,66,na,1896,1036.8249427415844
STAT,1871,49,15-19,1920,3.9576992573204226E-4
STAT,1839,23,20-24,1862,60.669689261129875
SIM,1925,31,25-29,1956,13
STAT,1889,44,na,1933,2873.180859138373
SIM,1876,46,na,1922,2616
STAT,1814,48,30-34,1862,0.2839929720474016
STAT,1909,38,na,1947,3613.7902962604467
SIM,1839,48,50-100,1887,1
STAT,1843,22,30-34,1865,18.049059054072394
STAT,1928,27,15-19,1955,0.8871371580426509
SIM,1853,83,na,1936,357
STAT,1818,38,20-24,1856,2.5790872415432973
STAT,1876,31,25-29,1907,10.833954564455214
SIM,1936,27,15-19,1963,2
STAT,1881,39,30-34,1920,5.203538383584258
SIM,1851,22,30-34,1873,2
SIM,1878,27,15-19,1905,1
STAT,1934,31,25-29,1965,12.876663693374685
STAT,1944,21,40-44,1965,3.705138748659238
SIM,1936,20,45-49,1956,1
SIM,1848,82,na,1930,273
SIM,1893,29,20-24,1922,14
SIM,1883,32,20-24,1915,2
SIM,1901,20,30-34,1921,34
STAT,1841,37,35-39,1878,6.1529083694891735
SIM,1932,35,30-34,1967,6
STAT,1903,19,25-29,1922,8.173619522548144
STAT,1859,35,40-44,1894,3.6002877367568145
STAT,1939,16,35-39,1955,4.2859887111356425
SIM,1808,52,na,1860,1438
STAT,1875,25,30-34,1900,26.54459102469557
STAT,1825,29,35-39,1854,32.696081259896964
STAT,1866,36,50-100,1902,1.1608297075763063
STAT,1938,24,20-24,1962,112.18435650514783
STAT,1805,99,na,1904,0.7611960710352204
SIM,1901,15,35-39,1916,1
SIM,1826,30,25-29,1856,1
SIM,1833,36,25-29,1869,6
STAT,1908,34,35-39,1942,8.720688525295213
STAT,1928,20,45-49,1948,1.4415063012239062
STAT,1878,41,50-100,1919,1.1268812030431348
SIM,1915,35,30-34,1950,1
STAT,1904,60,na,1964,2983.6471502567374
SIM,1832,37,35-39,1869,10
STAT,1865,35,15-19,1900,0.05248745780675579
STAT,1917,39,20-24,1956,0.27771613066715606
SIM,1935,21,40-44,1956,2
STAT,1885,21,25-29,1906,58.43927179786242
SIM,1817,47,50-100,1864,1
STAT,1824,37,35-39,1861,9.782168073322397
STAT,1836,49,50-100,1885,0.15594588883842914
STAT,1839,49,30-34,1888,0.0663447473126874
SIM,1836,20,40-44,1856,5
STAT,1892,27,25-29,1919,54.08498446478153
STAT,1831,33,45-49,1864,1.5764573534045438
STAT,1917,31,25-29,1948,9.917185067237385
STAT,1849,45,25-29,1894,0.04516418956606755
STAT,1866,81,na,1947,508.84327558581367
SIM,1845,64,na,1909,1358
SIM,1903,43,na,1946,3226
STAT,1910,22,25-29,1932,88.47113275974549
STAT,1919,37,15-19,1956,0.02105263567288663
SIM,1847,23,20-24,1870,63
STAT,1899,41,20-24,1940,0.015475914183448857
STAT,1823,38,30-34,1861,9.613837855927496
STAT,1876,24,35-39,1900,6.108783220692808
STAT,1907,35,30-34,1942,1.7394474220762595
STAT,1891,28,35-39,1919,12.143679981633552
STAT,1848,46,35-39,1894,0.10913561491146714
SIM,1847,49,30-34,1896,1
STAT,1869,44,na,1913,2245.6329487745247
SIM,1831,38,30-34,1869,10
SIM,1884,24,35-39,1908,11
SIM,1893,21,25-29,1914,90
STAT,1848,47,30-34,1895,0.07489504534859334
STAT,1870,26,50-100,1896,0.6401306037539296
SIM,1843,73,na,1916,808
SIM,1917,33,40-44,1950,6
STAT,1822,46,15-19,1868,5.787674876806517E-4
STAT,1898,15,25-29,1913,7.853870433271658
STAT,1919,0,na,1919,5080.459560609981
STAT,1851,16,30-34,1867,1.608235312424793
STAT,1926,22,35-39,1948,11.66980226748487
SIM,1938,23,30-34,1961,42
STAT,1855,34,45-49,1889,1.348129443092661
SIM,1825,31,20-24,1856,4
STAT,1883,26,35-39,1909,9.691388421754668
STAT,1904,48,25-29,1952,0.046907375533423355
SIM,1853,20,40-44,1873,3
STAT,1908,31,30-34,1939,15.226840348342073
STAT,1918,31,40-44,1949,4.260947444142287
STAT,1916,41,na,1957,3889.495705986117
STAT,1848,39,45-49,1887,1.5640751203530368
SIM,1892,22,20-24,1914,112
STAT,1837,21,45-49,1858,0.6130335725851758
STAT,1900,44,45-49,1944,0.14496789439858943
STAT,1905,22,15-19,1927,4.860599111913424
STAT,1884,22,20-24,1906,69.55218194677663
STAT,1878,29,15-19,1907,0.47832584243379905
SIM,1935,24,45-49,1959,4
STAT,1920,16,20-24,1936,155.60660947860887
SIM,1947,22,na,1969,4317
SIM,1876,25,40-44,1901,9
STAT,1839,36,50-100,1875,1.0231272871936896
STAT,1786,91,na,1877,15.474536764906244
STAT,1816,51,na,1867,1248.2478003138015
SIM,1843,22,25-29,1865,69
SIM,1897,15,30-34,1912,3
SIM,1913,22,15-19,1935,5
STAT,1818,48,15-19,1866,8.942986340997472E-4
STAT,1870,18,20-24,1888,17.743295651948053
SIM,1885,29,15-19,1914,2
STAT,1899,44,25-29,1943,0.06145379235734032
STAT,1867,35,50-100,1902,1.187015348179029
STAT,1877,29,15-19,1906,0.4766252370497962
STAT,1891,78,na,1969,1424.569992411443
STAT,1909,33,40-44,1942,3.792499418109283
STAT,1884,26,35-39,1910,9.771915667296023
SIM,1863,34,45-49,1897,2
SIM,1879,41,45-49,1920,7
STAT,1892,25,30-34,1917,32.41504966226678
STAT,1898,28,50-100,1926,0.8793828228443067
SIM,1901,23,35-39,1924,14
STAT,1920,42,20-24,1962,0.019904544906253634
SIM,1889,38,30-34,1927,4
STAT,1894,45,na,1939,2982.2694004193513
STAT,1932,34,na,1966,5120.740299983793
SIM,1833,34,30-34,1867,30
SIM,1900,49,45-49,1949,2
SIM,1874,75,na,1949,975
SIM,1930,11,na,1941,5746
SIM,1807,90,na,1897,1
STAT,1943,21,25-29,1964,100.29796617648104
SIM,1824,35,35-39,1859,4
SIM,1893,58,na,1951,2583
SIM,1915,44,na,1959,4145
SIM,1868,27,na,1895,2381
SIM,1918,21,40-44,1939,6
SIM,1834,68,na,1902,1077
SIM,1909,38,25-29,1947,2
SIM,1828,82,na,1910,289
SIM,1889,74,na,1963,1736
SIM,1916,31,30-34,1947,24
STAT,1811,75,na,1886,442.4302423331229
STAT,1845,20,40-44,1865,2.050618678931182
SIM,1832,34,30-34,1866,30
SIM,1926,31,40-44,1957,8
STAT,1912,47,20-24,1959,0.010834371942861428
SIM,1891,26,35-39,1917,17
STAT,1812,92,na,1904,18.996556284175394
STAT,1825,34,30-34,1859,29.813907458961754
STAT,1930,16,50-100,1946,0.49523002601924665
STAT,1886,16,45-49,1902,0.07070926901127073
STAT,1909,37,20-24,1946,0.25447287923807943
SIM,1876,31,50-100,1907,1
STAT,1869,78,na,1947,769.5411692881028
SIM,1874,37,25-29,1911,4
SIM,1834,22,30-34,1856,29
STAT,1955,17,30-34,1972,16.503428618070764
STAT,1777,86,na,1863,80.76607696789516
SIM,1884,23,25-29,1907,70
SIM,1840,31,na,1871,1822
SIM,1802,91,na,1893,47
SIM,1850,25,35-39,1875,14
STAT,1897,31,45-49,1928,2.388357890155903
SIM,1859,36,45-49,1895,3
SIM,1826,81,na,1907,230
STAT,1888,25,50-100,1913,0.7767159303930912
STAT,1870,86,na,1956,243.3883443528033
STAT,1945,27,15-19,1972,0.7901932293601003
SIM,1892,26,35-39,1918,22
STAT,1822,47,na,1869,1515.4645482270275
STAT,1832,29,40-44,1861,2.663363410475389
STAT,1854,48,na,1902,1700.2899649786614
STAT,1948,21,25-29,1969,108.24212454690085
STAT,1938,21,15-19,1959,5.3759908909347445
SIM,1951,1,na,1952,5429
SIM,1851,21,20-24,1872,69
SIM,1900,45,na,1945,3181
SIM,1873,28,40-44,1901,4
SIM,1830,39,25-29,1869,6
SIM,1825,35,35-39,1860,9
SIM,1914,0,na,1914,4416
STAT,1822,39,25-29,1861,4.906554957136029
STAT,1842,25,35-39,1867,9.493231612526227
SIM,1845,30,na,1875,2120
SIM,1940,21,na,1961,3816
STAT,1855,18,50-100,1873,0.04490548194064861
SIM,1845,21,45-49,1866,1
SIM,1943,23,40-44,1966,6
STAT,1912,17,25-29,1929,8.939223403200392
SIM,1946,21,15-19,1967,6
STAT,1838,49,30-34,1887,0.0713209580981491
STAT,1852,67,na,1919,1277.054082883947
SIM,1866,33,30-34,1899,27
SIM,1875,29,na,1904,2459
STAT,1893,20,20-24,1913,89.71497602860903
SIM,1938,17,na,1955,3632
SIM,1868,23,40-44,1891,3
STAT,1817,42,25-29,1859,1.6145664520186114
STAT,1896,46,na,1942,3040.5024394287316
STAT,1865,35,30-34,1900,4.98153632037011
STAT,1866,37,25-29,1903,2.7092386957708254
STAT,1928,35,15-19,1963,0.02479771840407924
STAT,1848,21,20-24,1869,65.69617795060209
STAT,1844,38,15-19,1882,0.04550818393484344
STAT,1883,52,35-39,1935,0.008571496003736712
STAT,1851,31,20-24,1882,2.3453309050826276
STAT,1843,21,20-24,1864,70.3335317791969
STAT,1889,15,30-34,1904,2.017836231108992
SIM,1898,57,na,1955,3079
SIM,1934,22,35-39,1956,14
SIM,1920,17,25-29,1937,68
SIM,1854,41,40-44,1895,6
STAT,1767,108,na,1875,0.003355318328686525
STAT,1839,19,35-39,1858,0.4895615450056514
SIM,1844,28,15-19,1872,2
STAT,1855,45,15-19,1900,3.131704052707544E-4
SIM,1945,20,50-100,1965,1
SIM,1887,40,40-44,1927,4
SIM,1860,21,na,1881,2074
STAT,1858,33,30-34,1891,14.065437597230781
SIM,1873,35,30-34,1908,5
SIM,1885,29,na,1914,2386
STAT,1829,44,45-49,1873,1.2222708503878899
SIM,1923,18,na,1941,4178
SIM,1856,21,20-24,1877,82
STAT,1839,101,na,1940,0.39381292566042314
STAT,1883,19,45-49,1902,0.06503492028468046
SIM,1941,28,35-39,1969,29
STAT,1835,34,na,1869,2013.4233530019176
SIM,1839,24,25-29,1863,85
STAT,1862,102,na,1964,1.071565022922268
SIM,1815,64,na,1879,886
STAT,1836,28,15-19,1864,0.36281855627138965
SIM,1848,37,30-34,1885,10
STAT,1859,20,50-100,1879,0.38429308596193895
STAT,1896,35,45-49,1931,2.7114397985754928
STAT,1879,40,40-44,1919,2.422728540361946
STAT,1844,28,20-24,1872,11.048812729165586
STAT,1842,105,na,1947,0.022993405271249646
STAT,1855,49,30-34,1904,0.07347243226677416
STAT,1914,34,50-100,1948,0.8418673919798725
STAT,1846,41,40-44,1887,1.6489702092253404
STAT,1854,112,na,1966,1.6223074325063646E-4
SIM,1852,49,50-100,1901,1
SIM,1938,15,30-34,1953,14
SIM,1955,5,na,1960,5094
STAT,1851,24,30-34,1875,17.29812324390626
STAT,1937,33,na,1970,3814.3442549830907
STAT,1842,51,35-39,1893,0.006783566102031726
SIM,1900,27,35-39,1927,17
STAT,1933,28,35-39,1961,20.32028355836247
SIM,1889,20,20-24,1909,122
STAT,1847,25,20-24,1872,11.155453015672098
STAT,1825,34,na,1859,1719.3757629995907
STAT,1859,49,15-19,1908,3.19081465911416E-4
STAT,1855,16,15-19,1871,5.504200340882713
STAT,1894,15,40-44,1909,0.24112383937271467
STAT,1884,33,25-29,1917,10.294057444666457
STAT,1850,24,30-34,1874,15.851463081241723
SIM,1863,16,15-19,1879,5
STAT,1874,29,30-34,1903,26.04104612445827
STAT,1899,37,35-39,1936,2.132653002418281
STAT,1884,50,50-100,1934,0.015461989980406139
STAT,1947,18,35-39,1965,4.821087450163213
SIM,1829,28,30-34,1857,33
STAT,1877,30,50-100,1907,0.9772592691736162
STAT,1837,28,15-19,1865,0.38547258691896624
SIM,1825,64,na,1889,1046
SIM,1928,33,15-19,1961,2
SIM,1878,20,45-49,1898,2
SIM,1866,35,25-29,1901,2
SIM,1928,17,na,1945,4841
STAT,1851,23,20-24,1874,67.40728684253692
STAT,1956,16,na,1972,4968.77756425827
SIM,1908,32,35-39,1940,3
SIM,1936,35,50-100,1971,2
SIM,1858,34,35-39,1892,17
STAT,1863,47,15-19,1910,3.5611239734496786E-4
SIM,1844,78,na,1922,514
STAT,1888,19,30-34,1907,1.911930176765472
SIM,1905,44,na,1949,3335
STAT,1901,22,30-34,1923,25.41063211726617
SIM,1879,23,15-19,1902,3
STAT,1860,96,na,1956,8.237722857608702
SIM,1865,36,35-39,1901,13
STAT,1889,1,na,1890,3429.942706847647
STAT,1943,25,40-44,1968,5.068995565325255
SIM,1902,26,na,1928,3456
STAT,1949,14,na,1963,4659.281475525999
SIM,1949,4,na,1953,4797
STAT,1830,38,20-24,1868,0.6865749026465253
SIM,1882,29,30-34,1911,37
SIM,1824,36,50-100,1860,2
SIM,1830,55,na,1885,1431
SIM,1855,25,20-24,1880,12
STAT,1950,17,45-49,1967,0.602589384587693
STAT,1841,40,50-100,1881,0.8315905520737864
STAT,1887,42,40-44,1929,2.5680567155192056
STAT,1925,26,35-39,1951,18.153869690411003
STAT,1841,29,35-39,1870,8.722127337776966
STAT,1914,38,40-44,1952,1.5174144270958763
STAT,1879,54,na,1933,2232.901520245521
STAT,1899,33,20-24,1932,3.760156053885403
STAT,1835,38,50-100,1873,1.1196890566223108
STAT,1889,48,30-34,1937,0.06794337779103525
STAT,1935,23,40-44,1958,4.6678137631480645
STAT,1882,20,45-49,1902,0.6971868934492156
STAT,1887,63,na,1950,2039.6977592664614
STAT,1941,17,na,1958,3867.860105871085
STAT,1951,16,35-39,1967,5.098907649820317
SIM,1818,62,na,1880,987
STAT,1825,33,20-24,1858,4.958559316900784
STAT,1903,20,40-44,1923,3.0398960985518038
SIM,1868,31,40-44,1899,10
STAT,1904,39,50-100,1943,0.38354432487327283
SIM,1768,92,na,1860,5
STAT,1934,15,na,1949,5100.763283337563
STAT,1863,18,15-19,1881,5.479513886202738
STAT,1928,35,50-100,1963,0.5421682293093316
SIM,1897,22,20-24,1919,109
STAT,1848,52,na,1900,1664.8184271397442
SIM,1869,30,30-34,1899,6
SIM,1902,26,20-24,1928,20
SIM,1798,67,na,1865,710
STAT,1884,45,na,1929,2293.3633324066464
STAT,1839,26,25-29,1865,37.04399520580834
SIM,1835,24,40-44,1859,3
STAT,1782,77,na,1859,313.7698247710506
STAT,1832,47,na,1879,1608.2666653116873
SIM,1851,32,25-29,1883,12
STAT,1899,44,na,1943,3196.1501677377473
STAT,1856,81,na,1937,433.0461084393065
STAT,1889,22,20-24,1911,86.83964017505687
STAT,1913,24,15-19,1937,5.449408996973637
STAT,1920,39,50-100,1959,0.4681162586944944
SIM,1855,18,30-34,1873,2
STAT,1859,39,20-24,1898,0.6217013594467494
SIM,1838,40,45-49,1878,5
SIM,1901,30,25-29,1931,20
SIM,1933,26,35-39,1959,34
STAT,1940,28,40-44,1968,4.846530909849954
SIM,1838,22,15-19,1860,3
SIM,1932,27,45-49,1959,2
SIM,1838,82,na,1920,264
STAT,1849,39,50-100,1888,0.9552994694041006
STAT,1892,24,20-24,1916,87.55731125385873
STAT,1873,15,20-24,1888,18.553644473652273
STAT,1930,38,25-29,1968,1.3085408664477303
SIM,1900,42,45-49,1942,1
STAT,1824,34,30-34,1858,27.79801318185449
SIM,1834,39,50-100,1873,4
STAT,1881,35,15-19,1916,0.05590996368189117
STAT,1924,27,45-49,1951,2.0522555922398293
STAT,1897,46,15-19,1943,3.0864565500084525E-4
SIM,1905,16,30-34,1921,2
STAT,1843,25,35-39,1868,9.72530258387989
SIM,1845,28,15-19,1873,2
STAT,1815,99,na,1914,0.9792721271434275
SIM,1911,20,40-44,1931,4
STAT,1835,22,25-29,1857,56.71950614387175
STAT,1911,42,na,1953,3615.74846691927
SIM,1899,34,25-29,1933,3
STAT,1891,25,30-34,1916,32.02046090395408
STAT,1885,39,15-19,1924,0.05657770344353384
STAT,1906,39,45-49,1945,0.6324641781573348
SIM,1853,28,na,1881,1996
STAT,1853,22,40-44,1875,2.0644742192723227
STAT,1868,38,na,1906,2284.2011182252254
STAT,1862,26,15-19,1888,0.39830760026685375
STAT,1871,39,20-24,1910,0.7711218830994678
STAT,1861,15,50-100,1876,0.04803211411355932
STAT,1884,27,50-100,1911,0.6456304057912345
STAT,1924,31,15-19,1955,0.1530483335123452
SIM,1878,27,na,1905,2624
SIM,1926,20,35-39,1946,20
STAT,1927,24,45-49,1951,1.405251942111803
SIM,1841,36,30-34,1877,7
SIM,1861,22,40-44,1883,5
STAT,1934,21,30-34,1955,39.402639284820324
SIM,1881,15,20-24,1896,13
STAT,1907,38,35-39,1945,2.2753740030139262
SIM,1865,29,na,1894,2277
SIM,1920,11,na,1931,4391
SIM,1895,42,40-44,1937,1
STAT,1843,32,25-29,1875,9.940418532883104
STAT,1833,84,na,1917,218.45848897219793
STAT,1892,17,30-34,1909,2.0378607238872797
STAT,1831,30,40-44,1861,4.075283171260157
SIM,1899,31,50-100,1930,4
SIM,1915,38,35-39,1953,3
SIM,1866,46,na,1912,2287
SIM,1905,23,20-24,1928,100
STAT,1844,48,na,1892,1721.5210082740944
SIM,1902,19,30-34,1921,4
SIM,1942,21,30-34,1963,59
STAT,1847,18,30-34,1865,1.5421496691163947
STAT,1918,20,35-39,1938,10.42510154586665
SIM,1925,35,40-44,1960,3
STAT,1852,35,50-100,1887,1.0153062192540225
STAT,1891,18,40-44,1909,0.23040094938277209
SIM,1896,12,na,1908,3531
STAT,1920,49,20-24,1969,0.012393351327775096
STAT,1833,36,30-34,1869,4.460465396835069
STAT,1871,27,na,1898,2411.6405147634787
SIM,1833,26,30-34,1859,37
STAT,1832,67,na,1899,1059.2868605998167
SIM,1866,32,20-24,1898,1
SIM,1872,32,45-49,1904,4
SIM,1888,46,30-34,1934,1
STAT,1917,35,40-44,1952,1.6018045293185947
SIM,1838,37,50-100,1875,3
STAT,1845,65,na,1910,1320.4470452472472
STAT,1909,22,35-39,1931,8.925128293070836
SIM,1865,25,50-100,1890,1
SIM,1865,30,na,1895,2308
SIM,1929,27,50-100,1956,1
SIM,1827,76,na,1903,496
STAT,1874,45,na,1919,2366.710504316267
SIM,1897,18,35-39,1915,2
SIM,1909,33,50-100,1942,1
SIM,1931,20,45-49,1951,2
STAT,1793,93,na,1886,7.662206818740522
STAT,1897,38,30-34,1935,7.233681189751091
SIM,1903,21,45-49,1924,2
SIM,1906,22,25-29,1928,2
SIM,1896,26,20-24,1922,23
STAT,1823,53,na,1876,1315.6159498229265
STAT,1838,20,35-39,1858,5.643512172074283
STAT,1901,32,25-29,1933,14.61188599955057
SIM,1835,95,na,1930,15
SIM,1845,31,50-100,1876,1
STAT,1919,43,50-100,1962,0.12971155316342506
SIM,1893,25,40-44,1918,11
SIM,1833,37,35-39,1870,13
STAT,1950,21,15-19,1971,6.444628790303397
SIM,1853,23,45-49,1876,1
SIM,1934,33,40-44,1967,12
SIM,1856,38,35-39,1894,10
STAT,1797,105,na,1902,0.007383398916140245
STAT,1851,34,25-29,1885,8.614503573724143
SIM,1939,22,20-24,1961,112
SIM,1856,24,25-29,1880,60
STAT,1787,76,na,1863,434.94050686415954
SIM,1863,31,40-44,1894,7
STAT,1872,37,15-19,1909,0.05741408904092244
STAT,1897,24,20-24,1921,93.41071196680333
STAT,1899,26,30-34,1925,35.299073722562156
STAT,1900,15,40-44,1915,0.25981729804653514
STAT,1892,28,35-39,1920,12.293326784647181
SIM,1885,42,50-100,1927,6
STAT,1840,34,15-19,1874,0.12225001801184086
SIM,1882,25,30-34,1907,3
SIM,1820,55,na,1875,1398
SIM,1936,21,40-44,1957,3
STAT,1851,48,35-39,1899,0.11405114136381146
STAT,1841,19,40-44,1860,0.17212937360235486
STAT,1952,19,20-24,1971,165.62533942673136
STAT,1850,17,40-44,1867,0.16812125572165013
STAT,1859,24,35-39,1883,4.862119329610189
SIM,1938,26,35-39,1964,19
SIM,1829,35,20-24,1864,1
STAT,1845,23,45-49,1868,0.6715396904744363
STAT,1848,38,35-39,1886,5.6072858270391865
STAT,1828,38,15-19,1866,0.04818593386756982
STAT,1916,7,na,1923,4313.738465354561
STAT,1938,32,20-24,1970,2.5018645839648177
SIM,1937,32,na,1969,4454
SIM,1838,33,20-24,1871,5
SIM,1843,28,na,1871,1981
SIM,1881,77,na,1958,884
SIM,1875,23,30-34,1898,26
STAT,1923,20,45-49,1943,1.3437397562529119
SIM,1849,47,40-44,1896,2
SIM,1861,18,20-24,1879,23
SIM,1835,20,25-29,1855,65
SIM,1948,20,20-24,1968,138
STAT,1853,18,20-24,1871,17.776723616904498
STAT,1929,34,20-24,1963,3.155985689253608
STAT,1910,19,15-19,1929,9.12245937942014
STAT,1834,80,na,1914,415.7075579130109
SIM,1888,39,40-44,1927,12
SIM,1897,62,na,1959,2536
STAT,1787,86,na,1873,83.64338681797057
STAT,1855,31,40-44,1886,3.4587502923526636
STAT,1902,27,na,1929,3433.3609227509137
SIM,1879,27,30-34,1906,41
STAT,1861,82,na,1943,393.3141706440636
STAT,1859,78,na,1937,636.5634459557574
STAT,1876,2,na,1878,3432.957973257036
STAT,1848,24,25-29,1872,53.40671782565079
STAT,1857,36,35-39,1893,5.662252341653864
STAT,1944,24,45-49,1968,1.23862827547678
SIM,1864,23,20-24,1887,79
SIM,1900,20,15-19,1920,7
STAT,1924,38,35-39,1962,2.9069589561807834
SIM,1844,68,na,1912,1173
STAT,1816,46,25-29,1862,0.1203820924482708
SIM,1928,22,45-49,1950,2
SIM,1820,65,na,1885,1095
STAT,1845,49,20-24,1894,0.009180396531454658
SIM,1937,34,20-24,1971,1
STAT,1766,91,na,1857,24.057443150892
SIM,1932,38,35-39,1970,10
SIM,1849,33,30-34,1882,26
SIM,1900,33,50-100,1933,5
STAT,1895,29,15-19,1924,0.5995669816160678
SIM,1836,26,15-19,1862,4
STAT,1883,37,25-29,1920,2.8819768603500804
STAT,1883,23,15-19,1906,3.2920052018690393
STAT,1943,29,na,1972,4066.4552182895445
SIM,1841,24,15-19,1865,4
STAT,1829,41,40-44,1870,1.913328214408758
STAT,1874,55,na,1929,2153.6515741981534
SIM,1891,37,25-29,1928,6
STAT,1941,19,45-49,1960,0.5245821458122021
SIM,1792,73,na,1865,473
SIM,1847,45,30-34,1892,1
STAT,1804,73,na,1877,517.3341522508235
STAT,1841,26,30-34,1867,23.260565872263786
SIM,1803,63,na,1866,780
SIM,1865,29,45-49,1894,3
SIM,1948,17,na,1965,4239
STAT,1802,92,na,1894,13.215588115656494
STAT,1869,39,15-19,1908,0.05475045999912351
STAT,1839,38,40-44,1877,3.5729713155076404
SIM,1805,88,na,1893,18
STAT,1831,36,15-19,1867,0.04999309959657408
STAT,1867,23,30-34,1890,17.006674859791087
STAT,1889,39,35-39,1928,8.823192587136088
SIM,1867,35,40-44,1902,9
SIM,1833,25,35-39,1858,13
STAT,1882,74,na,1956,1137.5103768148313
SIM,1891,23,15-19,1914,5
STAT,1805,53,50-100,1858,0.05216494141882805
STAT,1865,85,na,1950,253.8218446481664
STAT,1861,27,50-100,1888,0.5431580644905181
STAT,1902,24,40-44,1926,2.9790950722574543
STAT,1907,27,45-49,1934,1.6631085679174042
STAT,1928,21,40-44,1949,4.295037590623449
STAT,1825,65,na,1890,1013.4076936562187
STAT,1929,20,45-49,1949,1.459905682952317
STAT,1927,39,15-19,1966,0.02430301343279078
SIM,1946,25,30-34,1971,59
SIM,1897,39,35-39,1936,4
STAT,1914,16,30-34,1930,2.5788194161740776
SIM,1852,87,na,1939,102
STAT,1896,46,15-19,1942,3.0487069832113556E-4
STAT,1922,20,50-100,1942,0.7745263937859946
STAT,1884,7,na,1891,2629.540695868423
STAT,1857,29,45-49,1886,0.898114075730533
SIM,1884,20,20-24,1904,72
SIM,1915,27,45-49,1942,3
STAT,1896,32,40-44,1928,5.843089924069108
SIM,1803,76,na,1879,307
SIM,1922,16,30-34,1938,18
STAT,1825,37,35-39,1862,10.83624044683189
STAT,1856,30,45-49,1886,1.4432191265746523
STAT,1889,25,25-29,1914,53.66751051638659
SIM,1905,30,45-49,1935,5
SIM,1865,20,na,1885,2335
STAT,1947,25,25-29,1972,76.04032113202864
STAT,1926,33,40-44,1959,4.824285243640153
STAT,1827,46,na,1873,1653.7767184949812
STAT,1888,26,20-24,1914,14.196920724072175
STAT,1839,45,30-34,1884,0.06983333497510148
STAT,1833,24,15-19,1857,2.9938219251655096
STAT,1856,19,35-39,1875,0.5134689801237213
SIM,1769,87,na,1856,90
SIM,1846,20,35-39,1866,7
STAT,1867,30,20-24,1897,2.6096142542891823
STAT,1808,86,na,1894,73.8647228795362
SIM,1929,28,35-39,1957,2
SIM,1854,78,na,1932,723
STAT,1877,26,45-49,1903,1.1788277401938914
SIM,1862,97,na,1959,8
STAT,1889,18,35-39,1907,0.6896407260140441
STAT,1912,37,na,1949,3745.8632619702516
STAT,1906,21,20-24,1927,102.63334957381721
STAT,1933,6,na,1939,5471.715875210501
STAT,1842,13,na,1855,2393.08584
SIM,1926,27,20-24,1953,35
STAT,1890,62,na,1952,2279.7964205414073
STAT,1938,25,30-34,1963,39.632816109248495
STAT,1817,46,na,1863,1432.8739229116504
SIM,1847,38,40-44,1885,3
STAT,1953,18,25-29,1971,53.45702077420772
STAT,1869,42,50-100,1911,1.0392273355253596
STAT,1891,29,30-34,1920,31.577373405951647
STAT,1910,37,45-49,1947,0.6649777408120103
STAT,1892,74,na,1966,1752.7427094406858
SIM,1879,34,20-24,1913,6
STAT,1892,16,35-39,1908,0.7032816372220813
SIM,1852,97,na,1949,3
STAT,1873,22,45-49,1895,0.7212045455448599
STAT,1888,58,na,1946,2385.0225133551085
STAT,1863,102,na,1965,1.2604993502100725
SIM,1914,21,20-24,1935,113
SIM,1885,26,45-49,1911,1
STAT,1810,44,30-34,1854,3.8376895588704314
STAT,1910,56,na,1966,3365.6462174674075
SIM,1870,38,50-100,1908,5
SIM,1914,17,35-39,1931,1
STAT,1861,24,40-44,1885,1.7787866677034452
SIM,1920,28,15-19,1948,1
SIM,1926,0,na,1926,5519
STAT,1935,27,20-24,1962,25.375204199725527
SIM,1864,19,35-39,1883,3
STAT,1898,48,25-29,1946,0.04426010256850382
SIM,1835,28,20-24,1863,11
SIM,1887,21,35-39,1908,8
SIM,1923,26,40-44,1949,10
STAT,1776,91,na,1867,16.90933645050037
STAT,1937,1,na,1938,4143.9932180094065
SIM,1856,46,na,1902,2200
SIM,1944,18,25-29,1962,50
STAT,1887,48,15-19,1935,4.5150757086024403E-4
SIM,1889,37,35-39,1926,5
STAT,1918,27,20-24,1945,19.82401242608686
STAT,1806,51,na,1857,1233.4363964687186
SIM,1867,11,na,1878,2461
SIM,1938,33,25-29,1971,10
SIM,1864,30,45-49,1894,3
STAT,1921,37,20-24,1958,0.30035679634407186
STAT,1841,38,30-34,1879,4.588437516074436
SIM,1855,30,na,1885,1902
SIM,1910,24,40-44,1934,3
STAT,1865,28,40-44,1893,2.763838016199657
STAT,1865,25,50-100,1890,0.5963113028910632
SIM,1918,32,45-49,1950,4
SIM,1860,26,40-44,1886,2
STAT,1833,53,na,1886,1428.4762199954587
SIM,1841,27,35-39,1868,13
STAT,1936,18,25-29,1954,42.20542762033607
STAT,1907,26,50-100,1933,0.9614751320192733
SIM,1889,23,25-29,1912,3
STAT,1833,27,35-39,1860,8.50467473930602
STAT,1898,37,35-39,1935,9.757465951440754
STAT,1911,22,40-44,1933,3.252736099435446
STAT,1915,45,50-100,1960,0.23366696702490128
SIM,1864,16,30-34,1880,3
STAT,1854,30,50-100,1884,0.7331947329804889
STAT,1894,19,20-24,1913,23.138943288971028
STAT,1902,37,na,1939,3416.16093822905
STAT,1851,15,35-39,1866,0.5569351175449226
STAT,1893,59,na,1952,2515.1272555825476
STAT,1826,36,40-44,1862,4.013124389020628
STAT,1814,52,50-100,1866,0.04308339008824828
STAT,1906,17,35-39,1923,0.8147484352062707
STAT,1851,82,na,1933,384.93861454404305
STAT,1905,55,na,1960,3145.3896156134283
SIM,1854,68,na,1922,1309
STAT,1827,28,20-24,1855,26.886266640323445
STAT,1856,26,na,1882,1994.6965467665998
STAT,1856,37,30-34,1893,4.267944542222218
STAT,1831,29,25-29,1860,39.768655683005846
STAT,1850,53,35-39,1903,0.006371800382640163
SIM,1934,29,20-24,1963,1
SIM,1829,42,45-49,1871,3
SIM,1943,27,20-24,1970,27
SIM,1897,25,25-29,1922,60
SIM,1880,34,45-49,1914,6
SIM,1902,22,40-44,1924,4
SIM,1816,48,50-100,1864,1
STAT,1925,23,30-34,1948,34.991146575837945
STAT,1898,34,15-19,1932,0.19477684929673184
STAT,1882,33,na,1915,2361.690684853282
SIM,1774,88,na,1862,62
SIM,1891,77,na,1968,1436
STAT,1862,15,45-49,1877,0.06574054353287366
STAT,1879,21,35-39,1900,6.241480212722239
STAT,1888,33,45-49,1921,2.0942097743566315
STAT,1915,26,40-44,1941,4.868014057693484
STAT,1863,41,50-100,1904,0.9492208637578327
STAT,1842,18,45-49,1860,0.06539373332880134
STAT,1893,27,40-44,1920,3.876698428904792
STAT,1830,35,na,1865,1738.8058392576786
STAT,1856,23,20-24,1879,63.6324559948348
STAT,1882,16,25-29,1898,5.645862450917942
SIM,1892,15,30-34,1907,4
STAT,1956,16,35-39,1972,5.66451453099
SIM,1850,29,35-39,1879,10
STAT,1872,34,45-49,1906,1.7676707347738652
STAT,1926,29,20-24,1955,22.163746983105863
SIM,1925,29,50-100,1954,2
STAT,1874,24,50-100,1898,0.42207999460175205
STAT,1930,16,15-19,1946,59.9888759575654
STAT,1882,43,50-100,1925,1.0423982064498731
STAT,1842,29,35-39,1871,9.223508363548811
STAT,1854,19,50-100,1873,0.044327525670734065
STAT,1851,27,35-39,1878,9.320678832965362
STAT,1857,44,20-24,1901,0.12482143413591137
STAT,1842,36,25-29,1878,2.676309506424478
SIM,1887,62,na,1949,2216
SIM,1917,22,na,1939,4143
SIM,1952,17,20-24,1969,3
SIM,1895,20,30-34,1915,32
SIM,1848,22,25-29,1870,2
SIM,1863,41,50-100,1904,1
STAT,1901,42,na,1943,3304.4800618441977
STAT,1833,39,35-39,1872,5.733318428048846
STAT,1853,25,45-49,1878,1.0941634665870352
STAT,1927,28,25-29,1955,81.33764678137655
STAT,1838,83,na,1921,291.68704934754584
STAT,1871,37,50-100,1908,1.2406643024273158
STAT,1852,26,40-44,1878,2.8311171620761946
SIM,1929,21,15-19,1950,7
STAT,1867,26,35-39,1893,9.27279769872427
SIM,1844,25,45-49,1869,2
STAT,1944,17,20-24,1961,148.85573766976023
SIM,1875,30,na,1905,2460
STAT,1889,36,50-100,1925,1.5545786537537165
STAT,1917,24,35-39,1941,10.148510778428378
SIM,1907,26,50-100,1933,1
SIM,1824,39,35-39,1863,10
STAT,1951,20,20-24,1971,135.61928582722044
STAT,1816,39,35-39,1855,19.470400079181886
STAT,1847,32,45-49,1879,1.5966433159093074
SIM,1899,24,30-34,1923,36
SIM,1855,32,45-49,1887,4
STAT,1821,49,50-100,1870,0.37558197340125454
SIM,1825,47,50-100,1872,1
STAT,1897,17,30-34,1914,2.1740962391545207
STAT,1892,46,30-34,1938,0.07001186292235678
SIM,1874,49,40-44,1923,1
STAT,1887,20,30-34,1907,20.48330574838596
SIM,1935,28,25-29,1963,130
STAT,1836,25,45-49,1861,0.9072945237872577
SIM,1947,23,25-29,1970,147
SIM,1899,31,20-24,1930,7
SIM,1937,27,30-34,1964,64
STAT,1885,38,50-100,1923,1.2433726798816567
STAT,1887,27,15-19,1914,0.5186425214379061
SIM,1850,36,25-29,1886,4
STAT,1851,72,na,1923,1041.91024657715
STAT,1926,28,50-100,1954,1.2129596142663837
SIM,1874,36,50-100,1910,2
SIM,1937,22,na,1959,4545
SIM,1925,24,35-39,1949,22
STAT,1880,39,15-19,1919,0.05959347339430528
STAT,1842,22,15-19,1864,3.2631077088573477
STAT,1866,49,40-44,1915,0.15773057342853
STAT,1835,65,na,1900,1259.1334144786008
STAT,1912,28,15-19,1940,0.7071902424487467
STAT,1873,60,na,1933,1972.4997809170034
STAT,1843,24,50-100,1867,0.407298694318454
SIM,1850,22,15-19,1872,5
SIM,1839,39,45-49,1878,8
SIM,1838,26,30-34,1864,36
SIM,1918,28,25-29,1946,91
SIM,1833,83,na,1916,276
SIM,1876,29,20-24,1905,17
STAT,1901,39,45-49,1940,0.6076457624821427
STAT,1901,25,35-39,1926,13.85834635766377
SIM,1861,25,45-49,1886,1
SIM,1848,36,35-39,1884,14
SIM,1886,41,50-100,1927,1
STAT,1813,48,15-19,1861,9.885808077800446E-4
STAT,1861,27,na,1888,2026.3791890916975
STAT,1929,27,30-34,1956,50.01596593170144
SIM,1841,39,35-39,1880,11
STAT,1844,20,25-29,1864,56.190697565320555
SIM,1882,28,35-39,1910,7
SIM,1931,37,na,1968,4929
SIM,1857,35,30-34,1892,8
STAT,1888,15,15-19,1903,7.190441462392919
STAT,1930,22,na,1952,4771.355525748156
STAT,1936,22,45-49,1958,1.0971714968297661
SIM,1793,68,na,1861,608
SIM,1907,33,30-34,1940,16
STAT,1850,32,50-100,1882,0.7209768072784477
SIM,1913,36,25-29,1949,1
STAT,1908,45,40-44,1953,0.14753445637139165
STAT,1816,43,20-24,1859,0.3588352164373012
STAT,1921,38,50-100,1959,0.4778996775603095
STAT,1901,44,50-100,1945,0.10324429456172171
SIM,1877,21,40-44,1898,4
STAT,1817,49,45-49,1866,0.511170829977965
STAT,1939,23,25-29,1962,94.60116977300622
STAT,1903,28,50-100,1931,0.924393931552724
STAT,1929,23,15-19,1952,6.84462376663121
STAT,1851,27,na,1878,2089.677555972251
STAT,1891,25,15-19,1916,0.5769129647784158
STAT,1870,96,na,1966,33.2915250253809
STAT,1855,20,35-39,1875,5.361464718080068
STAT,1898,58,na,1956,2750.738938695852
SIM,1811,51,na,1862,1126
SIM,1883,28,35-39,1911,14
STAT,1865,20,45-49,1885,0.6629867755072916
STAT,1867,37,40-44,1904,4.1924732510054685
STAT,1900,56,na,1956,2905.89654455785
STAT,1834,34,25-29,1868,8.647734475719442
STAT,1843,46,35-39,1889,0.11394180412423673
STAT,1843,94,na,1937,16.134221145213353
STAT,1883,34,20-24,1917,2.6825035237867594
STAT,1939,14,na,1953,4024.1228687594407
STAT,1886,27,15-19,1913,0.4899134927674603
SIM,1842,34,25-29,1876,16
SIM,1880,82,na,1962,466
STAT,1877,23,40-44,1900,2.1980359001221945
SIM,1779,87,na,1866,18
STAT,1847,47,30-34,1894,0.07513398065733261
STAT,1916,36,35-39,1952,2.5398331517508383
STAT,1824,34,15-19,1858,0.22673049654785815
SIM,1809,47,na,1856,1120
SIM,1865,37,30-34,1902,5
SIM,1836,49,na,1885,1746
SIM,1875,37,40-44,1912,9
STAT,1865,41,na,1906,2149.666352978706
STAT,1926,36,45-49,1962,0.8507181489769474
SIM,1833,22,15-19,1855,2
STAT,1819,36,15-19,1855,0.17258023842807343
STAT,1874,28,35-39,1902,10.01457994801989
STAT,1924,15,na,1939,4492.7149686643215
SIM,1836,20,50-100,1856,1
SIM,1833,48,40-44,1881,1
SIM,1852,20,25-29,1872,80
STAT,1908,22,na,1930,3577.4885784838125
STAT,1850,28,30-34,1878,22.130836630668004
STAT,1900,18,45-49,1918,0.09212074846420021
SIM,1911,23,45-49,1934,2
SIM,1864,26,25-29,1890,48
SIM,1866,56,na,1922,2137
SIM,1904,24,15-19,1928,6
SIM,1914,24,25-29,1938,97
SIM,1909,37,na,1946,3443
STAT,1843,53,na,1896,1710.285594331752
STAT,1905,36,25-29,1941,0.9200159941135114
SIM,1851,16,na,1867,2259
STAT,1911,18,20-24,1929,27.60097159952987
SIM,1888,25,50-100,1913,1
SIM,1826,50,na,1876,1458
STAT,1866,24,50-100,1890,0.38131647062061236
SIM,1918,32,50-100,1950,4
STAT,1847,97,na,1944,4.189344445577348
STAT,1864,32,45-49,1896,1.5817902659243992
STAT,1881,21,40-44,1902,2.0614184388743753
STAT,1889,36,30-34,1925,6.748358126062492
STAT,1879,36,20-24,1915,0.8259548902944445
STAT,1933,21,15-19,1954,7.222624680928866
SIM,1888,24,20-24,1912,77
STAT,1806,49,35-39,1855,0.47206832475381244
STAT,1892,39,40-44,1931,5.540577861703393
SIM,1866,15,na,1881,2602
STAT,1951,17,na,1968,4471.388306881837
SIM,1905,6,na,1911,3788
SIM,1770,95,na,1865,3
SIM,1891,27,30-34,1918,47
STAT,1883,5,na,1888,2649.4090911742037
SIM,1863,20,35-39,1883,7
SIM,1929,25,30-34,1954,9
SIM,1872,28,25-29,1900,40
SIM,1941,21,15-19,1962,6
STAT,1909,48,na,1957,3433.3200350688667
STAT,1875,28,35-39,1903,10.066969979418367
STAT,1886,26,na,1912,2585.8402471376758
SIM,1919,20,45-49,1939,2
STAT,1825,48,40-44,1873,0.2171952812362204
STAT,1828,49,20-24,1877,0.009141373734178185
SIM,1847,42,na,1889,1614
STAT,1938,28,35-39,1966,15.165582553150742
STAT,1892,33,na,1925,3038.1709440048435
SIM,1834,36,40-44,1870,7
SIM,1883,35,50-100,1918,2
SIM,1909,20,35-39,1929,16
STAT,1846,26,15-19,1872,0.3953459766123735
SIM,1844,22,40-44,1866,2
STAT,1856,26,25-29,1882,35.35624406462386
SIM,1890,27,30-34,1917,50
SIM,1880,27,20-24,1907,11
STAT,1941,22,50-100,1963,0.6937278812462327
STAT,1940,9,na,1949,4106.566065062332
SIM,1904,38,na,1942,3671
STAT,1903,23,45-49,1926,1.0081063940728563
SIM,1849,36,35-39,1885,9
STAT,1889,29,40-44,1918,3.7478612720160513
STAT,1906,24,25-29,1930,84.46878228929815
STAT,1879,29,30-34,1908,26.660922427052846
SIM,1948,23,25-29,1971,4
SIM,1824,36,30-34,1860,9
SIM,1922,5,na,1927,4742
STAT,1883,59,na,1942,1945.3404405902127
STAT,1862,67,na,1929,1376.603216697539
SIM,1894,27,15-19,1921,1
STAT,1866,16,40-44,1882,0.17769981504896712
STAT,1943,29,20-24,1972,19.81468115065977
SIM,1926,16,15-19,1942,80
STAT,1810,47,35-39,1857,0.440137217017818
STAT,1838,35,20-24,1873,0.6977691320141096
STAT,1856,16,30-34,1872,1.5181735913250214
STAT,1915,55,na,1970,3659.070015530672
SIM,1810,105,na,1915,1
SIM,1891,34,20-24,1925,5
SIM,1893,48,na,1941,2954
STAT,1914,30,45-49,1944,1.6290906030982424
STAT,1848,35,30-34,1883,4.358885353108829
STAT,1810,54,50-100,1864,0.043444564587231546
STAT,1854,49,15-19,1903,2.9974958647404373E-4
STAT,1875,35,50-100,1910,1.297667922032869
SIM,1869,22,45-49,1891,2
SIM,1840,39,35-39,1879,13
STAT,1857,33,15-19,1890,0.11298008758136939
SIM,1859,22,35-39,1881,9
STAT,1890,52,na,1942,2671.5011455217714
SIM,1898,36,30-34,1934,16
STAT,1832,39,35-39,1871,5.877763988479017
SIM,1849,23,na,1872,2121
SIM,1861,57,na,1918,2106
SIM,1933,23,30-34,1956,46
SIM,1885,23,40-44,1908,2
SIM,1883,48,na,1931,2326
STAT,1875,85,na,1960,419.0955612900076
SIM,1896,15,15-19,1911,8
SIM,1897,29,40-44,1926,5
SIM,1887,29,30-34,1916,32
STAT,1882,27,30-34,1909,25.02770660991588
STAT,1941,16,40-44,1957,1.4702266403314945
SIM,1898,47,na,1945,3457
STAT,1918,49,15-19,1967,3.9768605554491986E-4
STAT,1931,26,25-29,1957,86.70333185303888
SIM,1822,36,na,1858,1540
SIM,1934,36,45-49,1970,5
STAT,1896,44,50-100,1940,0.09751057558225315
SIM,1842,27,35-39,1869,12
STAT,1839,48,35-39,1887,0.09719038052743507
STAT,1851,45,30-34,1896,0.08065786922470096
SIM,1944,22,45-49,1966,5
STAT,1817,91,na,1908,28.280419760743722
STAT,1916,43,25-29,1959,0.07455937285243659
STAT,1812,108,na,1920,8.354605091187391E-4
SIM,1906,8,na,1914,3877
SIM,1933,30,20-24,1963,7
STAT,1834,27,35-39,1861,8.514536699109652
SIM,1846,35,20-24,1881,3
STAT,1799,64,na,1863,822.3586089515377
STAT,1839,30,45-49,1869,1.512112046338749
STAT,1829,27,na,1856,1892.606139020022
SIM,1924,36,35-39,1960,6
STAT,1829,30,35-39,1859,9.886515963695464
SIM,1922,30,45-49,1952,2
SIM,1856,35,30-34,1891,14
STAT,1880,18,15-19,1898,6.3453456912811586
STAT,1896,21,35-39,1917,7.886191622519063
STAT,1947,22,20-24,1969,128.21835982574135
STAT,1864,102,na,1966,1.453110389103877
SIM,1905,38,40-44,1943,2
STAT,1925,30,20-24,1955,2.958481684934955
STAT,1860,86,na,1946,183.65008037327715
STAT,1888,2,na,1890,3214.839737218394
SIM,1879,37,25-29,1916,6
STAT,1915,29,45-49,1944,1.7853025866803138
STAT,1839,27,na,1866,1880.8068669630845
STAT,1864,25,20-24,1889,10.755132265328253
SIM,1810,55,na,1865,1495
SIM,1846,28,30-34,1874,37
STAT,1898,45,20-24,1943,0.009431287556227849
SIM,1867,31,25-29,1898,11
STAT,1884,47,35-39,1931,0.1406408202492477
STAT,1873,44,50-100,1917,1.07788640358893
SIM,1780,95,na,1875,7
STAT,1844,24,40-44,1868,1.987294216001856
STAT,1929,14,na,1943,5140.8194084984925
SIM,1871,18,50-100,1889,1
STAT,1824,38,30-34,1862,7.1148867631223975
SIM,1934,18,15-19,1952,62
STAT,1876,26,na,1902,2522.661207974771
STAT,1888,30,40-44,1918,5.272208538788592
SIM,1900,24,30-34,1924,42
STAT,1864,45,na,1909,2061.136579660715
SIM,1903,17,25-29,1920,15
STAT,1769,98,na,1867,0.27393075190117916
STAT,1880,29,20-24,1909,12.486576849093137
STAT,1857,47,25-29,1904,0.045677061519749707
SIM,1861,16,na,1877,2912
SIM,1832,38,30-34,1870,8
STAT,1851,38,40-44,1889,3.6124845681237363
STAT,1901,36,40-44,1937,1.354384446809402
SIM,1850,26,30-34,1876,33
SIM,1847,30,45-49,1877,1
STAT,1840,20,40-44,1860,1.9346048447879016
SIM,1854,44,45-49,1898,4
STAT,1929,41,45-49,1970,0.22014716789478336
SIM,1831,27,25-29,1858,2
SIM,1852,24,40-44,1876,3
STAT,1871,16,15-19,1887,6.07150177211496
SIM,1910,45,na,1955,3466
STAT,1848,17,35-39,1865,0.5287468337809215
STAT,1904,26,15-19,1930,0.665619398637773
STAT,1907,26,na,1933,3587.0096123502553
SIM,1881,44,50-100,1925,4
STAT,1856,71,na,1927,1068.913003637396
STAT,1917,9,na,1926,4357.321206063758
STAT,1926,18,15-19,1944,56.61504761398436
SIM,1896,30,40-44,1926,8
STAT,1824,80,na,1904,340.60858968855484
SIM,1923,29,45-49,1952,6
STAT,1890,8,na,1898,3242.509841519913
STAT,1903,49,20-24,1952,0.009611209967729474
STAT,1819,54,50-100,1873,0.02765129530565113
SIM,1849,43,25-29,1892,1
STAT,1879,46,15-19,1925,4.277526725169662E-4
STAT,1906,41,na,1947,3459.268396803298
STAT,1841,15,25-29,1856,5.460452737936892
STAT,1887,73,na,1960,1521.2709538939039
STAT,1846,37,20-24,1883,0.575660702499443
SIM,1886,33,35-39,1919,17
STAT,1797,86,na,1883,74.77686020551033
SIM,1882,63,na,1945,1670
STAT,1863,18,50-100,1881,0.0452353834126939
SIM,1830,65,na,1895,1105
SIM,1819,42,35-39,1861,3
STAT,1905,42,50-100,1947,0.10795470462996816
STAT,1849,78,na,1927,606.5958797952931
SIM,1860,31,na,1891,2075
SIM,1922,23,20-24,1945,5
SIM,1908,46,45-49,1954,1
SIM,1877,24,45-49,1901,1
SIM,1939,21,25-29,1960,5
SIM,1823,36,30-34,1859,10
STAT,1918,16,15-19,1934,10.13827163461273
STAT,1861,27,45-49,1888,0.9427501492448692
STAT,1878,33,35-39,1911,10.708158828281409
STAT,1868,29,20-24,1897,11.349045447864103
STAT,1890,18,25-29,1908,7.049800272616794
SIM,1837,41,40-44,1878,3
SIM,1897,36,30-34,1933,11
STAT,1872,16,15-19,1888,6.123688012488345
SIM,1880,16,15-19,1896,8
SIM,1944,15,20-24,1959,125
SIM,1885,81,na,1966,889
STAT,1950,21,50-100,1971,0.7966167530567644
STAT,1883,27,30-34,1910,25.206211274657814
STAT,1838,28,30-34,1866,23.367002960269662
STAT,1850,24,15-19,1874,2.9358593285680095
STAT,1936,15,20-24,1951,133.00290647819727
STAT,1836,22,40-44,1858,1.7118887724229814
STAT,1892,49,35-39,1941,0.098861973791046
STAT,1852,15,35-39,1867,0.5409858635513429
SIM,1940,11,na,1951,4133
STAT,1914,23,20-24,1937,115.54899916089168
SIM,1838,29,35-39,1867,15
SIM,1843,83,na,1926,219
SIM,1926,34,45-49,1960,2
SIM,1918,25,20-24,1943,24
STAT,1917,21,30-34,1938,31.26668362927143
STAT,1913,38,25-29,1951,0.9863434038773577
STAT,1816,61,na,1877,1006.3255857002433
SIM,1845,32,35-39,1877,17
SIM,1854,37,20-24,1891,1
STAT,1893,16,35-39,1909,0.7118540396549239
SIM,1881,22,45-49,1903,3
STAT,1854,0,na,1854,3080.7854187914427
SIM,1853,26,15-19,1879,4
STAT,1945,21,na,1966,4084.7672075806977
STAT,1849,42,20-24,1891,0.12314437318071438
SIM,1856,7,na,1863,2903
STAT,1842,33,20-24,1875,2.5342597042204593
SIM,1901,19,15-19,1920,12
SIM,1929,32,20-24,1961,4
STAT,1934,35,40-44,1969,2.1103513016318884
SIM,1878,42,40-44,1920,5
STAT,1843,39,45-49,1882,1.6744798649491806
SIM,1834,25,35-39,1859,10
SIM,1899,20,15-19,1919,6
STAT,1842,26,30-34,1868,24.597671594919003
SIM,1874,34,na,1908,2408
SIM,1850,33,20-24,1883,4
SIM,1888,31,45-49,1919,1
SIM,1921,38,25-29,1959,3
STAT,1866,26,na,1892,2253.3536798285477
STAT,1837,32,35-39,1869,8.46573391788331
STAT,1923,28,40-44,1951,5.440832498637059
SIM,1879,26,50-100,1905,1
STAT,1867,8,na,1875,2642.085602057006
SIM,1906,15,35-39,1921,1
STAT,1864,18,30-34,1882,1.4868086209139584
SIM,1931,28,40-44,1959,8
STAT,1782,87,na,1869,53.68912686343868
SIM,1937,23,15-19,1960,8
STAT,1865,39,30-34,1904,4.885005880314583
SIM,1872,25,20-24,1897,14
SIM,1895,38,20-24,1933,2
STAT,1897,27,25-29,1924,57.700685793341925
STAT,1849,35,30-34,1884,4.322782014845177
STAT,1823,34,15-19,1857,0.2978516191840052
STAT,1948,22,20-24,1970,130.25929828469404
SIM,1896,22,na,1918,3158
STAT,1918,34,45-49,1952,1.6917722447029835
SIM,1816,44,25-29,1860,1
STAT,1885,25,40-44,1910,3.0695056209945246
STAT,1854,28,15-19,1882,0.3614105235307375
SIM,1874,26,35-39,1900,17
SIM,1883,35,25-29,1918,7
SIM,1846,49,na,1895,1814
SIM,1925,21,30-34,1946,63
SIM,1867,24,35-39,1891,5
SIM,1873,39,30-34,1912,3
STAT,1859,31,25-29,1890,8.378905150449032
STAT,1852,22,25-29,1874,54.785026505590565
STAT,1875,35,25-29,1910,3.0431796701981346
STAT,1879,44,na,1923,2431.3345779006936
STAT,1940,20,45-49,1960,1.170132137602719
STAT,1894,11,na,1905,3393.8723713793415
STAT,1903,16,20-24,1919,25.772432093804404
SIM,1858,82,na,1940,435
STAT,1907,31,15-19,1938,0.12298349519785652
SIM,1860,22,25-29,1882,4
SIM,1911,16,20-24,1927,27
STAT,1869,21,40-44,1890,2.0585571519223365
SIM,1848,26,40-44,1874,5
STAT,1839,45,15-19,1884,2.8856725674322265E-4
STAT,1833,24,30-34,1857,16.164418116627004
STAT,1845,26,15-19,1871,0.43460914081462565
SIM,1908,28,15-19,1936,1
STAT,1911,25,45-49,1936,1.7302068812951377
SIM,1841,24,30-34,1865,40
SIM,1927,22,na,1949,4396
STAT,1850,50,30-34,1900,0.0045418805667001485
SIM,1838,36,25-29,1874,2
STAT,1903,23,na,1926,3419.112093229671
SIM,1826,34,40-44,1860,6
STAT,1848,93,na,1941,22.717866231730326
STAT,1890,25,15-19,1915,0.5697592879399538
STAT,1933,17,45-49,1950,0.6819611993325654
SIM,1870,31,na,1901,2636
STAT,1942,26,35-39,1968,16.08377749445204
STAT,1841,72,na,1913,932.4618206552982
STAT,1868,39,15-19,1907,0.05416448768320118
SIM,1851,39,45-49,1890,3
STAT,1860,16,45-49,1876,0.06272762476536535
STAT,1810,69,na,1879,706.2991471690011
STAT,1841,35,20-24,1876,0.6846522661786641
STAT,1925,45,na,1970,4563.261990492851
SIM,1852,20,50-100,1872,1
SIM,1889,29,35-39,1918,1
SIM,1901,63,na,1964,2901
SIM,1859,67,na,1926,1381
SIM,1867,86,na,1953,91
STAT,1815,43,25-29,1858,1.919894070589234
STAT,1910,48,15-19,1958,3.495604328717615E-4
STAT,1849,39,40-44,1888,3.4061093561005213
SIM,1954,17,15-19,1971,54
STAT,1861,34,35-39,1895,8.463706390500707
SIM,1863,72,na,1935,947
STAT,1847,14,na,1861,2302.4095034065085
STAT,1877,41,35-39,1918,1.924666075140125
STAT,1855,45,20-24,1900,0.009395120422383397
SIM,1892,7,na,1899,3814
STAT,1814,59,na,1873,1154.5878554323526
STAT,1865,27,50-100,1892,0.5922929927474525
STAT,1886,47,45-49,1933,0.25364759892420774
SIM,1813,41,45-49,1854,4
STAT,1864,35,15-19,1899,0.05142056277600648
STAT,1921,31,na,1952,4312.40961150406
SIM,1866,24,35-39,1890,9
STAT,1835,24,40-44,1859,2.0351159179098284
SIM,1843,24,40-44,1867,5
SIM,1907,22,25-29,1929,105
SIM,1892,61,na,1953,2657
STAT,1872,32,45-49,1904,1.7829355169218923
STAT,1890,44,50-100,1934,1.2999642106674285
STAT,1832,40,20-24,1872,0.13392213236753028
STAT,1845,26,20-24,1871,11.237750550959433
SIM,1880,32,45-49,1912,2
STAT,1946,17,15-19,1963,51.35681016330282
SIM,1848,44,40-44,1892,5
SIM,1857,39,40-44,1896,6
STAT,1885,18,45-49,1903,0.0663096726146374
SIM,1862,19,25-29,1881,10
STAT,1856,50,na,1906,1749.0426256036262
STAT,1798,71,na,1869,744.8633151290443
SIM,1885,41,35-39,1926,6
STAT,1853,20,50-100,1873,0.409871348638543
STAT,1839,70,na,1909,968.3244179958733
STAT,1882,34,25-29,1916,10.092730958836333
SIM,1839,35,30-34,1874,5
STAT,1936,31,40-44,1967,3.8791182840780993
STAT,1877,52,45-49,1929,0.015273637021451262
STAT,1850,44,30-34,1894,0.8531130113555458
STAT,1945,24,45-49,1969,1.257306050745215
STAT,1882,23,15-19,1905,3.2686919685359843
STAT,1884,31,25-29,1915,10.379928774780714
SIM,1848,33,30-34,1881,25
SIM,1892,26,50-100,1918,1
SIM,1922,33,na,1955,4293
STAT,1946,15,na,1961,4167.440951591135
STAT,1892,41,30-34,1933,1.4765730335706917
STAT,1872,13,na,1885,2678.783880851558
STAT,1896,49,25-29,1945,0.04286309274904113
SIM,1909,30,35-39,1939,11
STAT,1912,27,50-100,1939,1.0006164678358067
STAT,1861,42,40-44,1903,1.8937337281758697
STAT,1824,38,25-29,1862,3.8436744371392155
STAT,1875,44,35-39,1919,1.8703496737026182
SIM,1890,34,25-29,1924,5
STAT,1858,24,35-39,1882,4.858598018944802
SIM,1947,17,50-100,1964,4
SIM,1832,38,25-29,1870,8
STAT,1856,16,25-29,1872,5.3976048709944005
STAT,1817,40,25-29,1857,1.7434584056407025
SIM,1865,40,25-29,1905,3
STAT,1826,46,35-39,1872,0.1108543561283584
STAT,1926,15,50-100,1941,0.47078280046114285
STAT,1836,53,40-44,1889,0.006500649739292116
STAT,1810,45,na,1855,1280.8614712009726
SIM,1823,43,25-29,1866,1
STAT,1852,41,30-34,1893,0.9303653329714281
STAT,1823,95,na,1918,7.399669936883289
SIM,1823,32,15-19,1855,1
SIM,1888,56,na,1944,2315
STAT,1833,27,40-44,1860,2.640323926794403
SIM,1854,36,na,1890,2049
SIM,1857,37,45-49,1894,4
STAT,1866,35,25-29,1901,2.7349686639523587
SIM,1821,41,na,1862,1541
SIM,1864,16,25-29,1880,6
STAT,1808,53,35-39,1861,0.02011802062555036
SIM,1841,27,40-44,1868,6
SIM,1874,35,25-29,1909,5
SIM,1891,32,20-24,1923,6
STAT,1893,37,35-39,1930,9.153396307820131
SIM,1815,39,50-100,1854,2
STAT,1820,41,40-44,1861,4.601849432804114
STAT,1851,23,40-44,1874,2.0382936695158818
STAT,1874,28,40-44,1902,3.1090824592440582
STAT,1893,40,35-39,1933,2.3671045899323095
SIM,1890,23,15-19,1913,2
SIM,1836,29,25-29,1865,64
STAT,1844,57,na,1901,1557.2859422852664
SIM,1809,92,na,1901,2
STAT,1832,48,30-34,1880,0.07586940200015391
STAT,1879,37,30-34,1916,5.683221924646142
STAT,1831,28,15-19,1859,0.43649475245966896
STAT,1880,39,20-24,1919,0.8180557591247806
STAT,1869,47,15-19,1916,3.9212636520333667E-4
STAT,1838,45,15-19,1883,3.102113439317516E-4
SIM,1855,29,35-39,1884,7
STAT,1843,30,25-29,1873,10.149014175612495
STAT,1889,77,na,1966,1460.104020995326
SIM,1806,52,na,1858,1387
STAT,1883,32,20-24,1915,2.7056683763220133
SIM,1855,23,20-24,1878,74
STAT,1834,26,45-49,1860,0.9868541682696003
STAT,1841,33,25-29,1874,9.08097138692393
STAT,1871,79,na,1950,706.4630756095272
SIM,1935,20,35-39,1955,18
STAT,1833,47,35-39,1880,0.10847655502056332
SIM,1943,19,na,1962,3613
SIM,1869,77,na,1946,726
STAT,1919,34,45-49,1953,1.7176248897471487
STAT,1931,39,45-49,1970,0.918816157949428
SIM,1838,26,25-29,1864,41
STAT,1849,54,35-39,1903,0.00649993555684234
SIM,1921,22,50-100,1943,2
SIM,1872,38,25-29,1910,5
STAT,1927,36,na,1963,4775.800405618564
STAT,1853,20,40-44,1873,2.0944424391643204
STAT,1864,38,25-29,1902,2.598714954990582
STAT,1847,29,35-39,1876,8.91449250850269
STAT,1889,21,na,1910,2989.2987233068857
SIM,1840,48,30-34,1888,1
STAT,1831,31,15-19,1862,0.13211733702402
STAT,1813,48,20-24,1861,0.029657450321082208
STAT,1841,22,15-19,1863,3.085728318522906
STAT,1899,25,35-39,1924,13.57070838786812
STAT,1877,44,na,1921,2412.4808221758344
STAT,1904,20,40-44,1924,3.0648438402170677
SIM,1872,26,30-34,1898,39
SIM,1908,31,30-34,1939,26
STAT,1896,18,20-24,1914,23.82401501257101
STAT,1897,72,na,1969,2105.817807904754
STAT,1881,89,na,1970,306.2465471510499
STAT,1864,26,30-34,1890,22.920443755976724
SIM,1882,28,40-44,1910,5
STAT,1845,46,45-49,1891,0.18492141845422363
SIM,1811,44,45-49,1855,2
STAT,1870,35,45-49,1905,2.0069104909949043
STAT,1882,36,20-24,1918,0.7698162660656758
STAT,1836,23,45-49,1859,0.5687498382739022
STAT,1887,43,15-19,1930,0.015672439311628573
STAT,1898,26,30-34,1924,34.85896848010949
STAT,1828,29,25-29,1857,47.967608659506936
STAT,1866,51,30-34,1917,0.005627971065356866
STAT,1823,104,na,1927,0.03712209880794489
SIM,1853,26,20-24,1879,13
STAT,1881,35,20-24,1916,0.7674912230707309
STAT,1821,40,45-49,1861,2.770043414913722
SIM,1912,20,40-44,1932,2
STAT,1920,49,40-44,1969,0.1768118054049437
STAT,1847,23,20-24,1870,65.40559386346393
STAT,1880,26,15-19,1906,0.48805169484299005
SIM,1829,27,50-100,1856,1
SIM,1861,20,40-44,1881,2
STAT,1815,45,20-24,1860,0.03337767887206425
STAT,1829,27,20-24,1856,16.68982640206025
STAT,1871,33,40-44,1904,4.363865283534907
SIM,1837,27,20-24,1864,13
SIM,1851,30,25-29,1881,15
SIM,1889,34,30-34,1923,10
STAT,1909,47,50-100,1956,0.2119641301097826
SIM,1873,82,na,1955,311
STAT,1897,17,25-29,1914,7.729624937178057
SIM,1905,53,na,1958,3132
STAT,1868,44,50-100,1912,1.0154776335999387
STAT,1879,15,50-100,1894,0.052485462252286404
STAT,1931,41,na,1972,5067.346702484627
STAT,1889,40,15-19,1929,0.01757796498044447
STAT,1865,39,25-29,1904,2.6390261507408486
STAT,1934,29,50-100,1963,1.3641506244558739
STAT,1884,14,na,1898,2598.043385922602
SIM,1858,38,45-49,1896,5
SIM,1855,61,na,1916,1395
SIM,1890,36,20-24,1926,1
STAT,1920,38,30-34,1958,2.034350732834857
STAT,1874,25,30-34,1899,26.406448966053613
STAT,1761,94,na,1855,1.83654
STAT,1857,25,30-34,1882,20.96507224303798
SIM,1867,94,na,1961,20
SIM,1858,47,35-39,1905,1
STAT,1878,17,15-19,1895,6.301669380406397
SIM,1785,73,na,1858,422
STAT,1899,42,25-29,1941,0.062217958298600384
STAT,1891,45,30-34,1936,0.06965134624458942
STAT,1847,53,50-100,1900,0.011588223089995657
SIM,1912,47,na,1959,3679
STAT,1772,86,na,1858,36.46339375694822
STAT,1839,48,40-44,1887,0.11884995077089612
SIM,1850,31,20-24,1881,3
STAT,1903,49,40-44,1952,0.13711992354414418
SIM,1877,27,20-24,1904,18
SIM,1812,42,40-44,1854,1
STAT,1867,47,35-39,1914,0.13345734027551057
STAT,1814,44,20-24,1858,0.49601863544152547
STAT,1839,49,25-29,1888,0.03947786578905102
SIM,1830,85,na,1915,164
SIM,1926,15,na,1941,4818
STAT,1874,45,30-34,1919,0.10182835142704996
STAT,1878,50,40-44,1928,0.011339548370269514
STAT,1917,31,30-34,1948,16.905002196812422
STAT,1809,54,35-39,1863,0.03513009287648959
STAT,1843,49,45-49,1892,0.1865385928976923
STAT,1851,52,25-29,1903,0.002906665705784743
STAT,1827,77,na,1904,558.6733533391563
SIM,1789,87,na,1876,15
SIM,1888,48,na,1936,2590
STAT,1867,50,35-39,1917,0.008363655517226292
STAT,1814,45,50-100,1859,0.7564019925488048
STAT,1825,33,40-44,1858,7.955382416742391
STAT,1886,18,50-100,1904,0.05276342017513603
STAT,1828,33,50-100,1861,0.8744000806248642
STAT,1862,41,45-49,1903,1.3055631341256972
STAT,1871,36,45-49,1907,2.0241631582237973
STAT,1834,43,35-39,1877,1.450372769754653
SIM,1842,25,50-100,1867,1
SIM,1933,17,na,1950,4847
STAT,1825,51,50-100,1876,0.019104154068421312
SIM,1887,37,30-34,1924,7
SIM,1888,17,25-29,1905,7
SIM,1909,35,na,1944,3491
SIM,1833,33,40-44,1866,6
STAT,1834,28,40-44,1862,2.6244061186693837
STAT,1876,45,35-39,1921,0.14895042744697914
SIM,1842,26,45-49,1868,1
STAT,1873,19,35-39,1892,0.5644588043273964
SIM,1922,25,na,1947,4293
SIM,1865,25,30-34,1890,34
SIM,1934,21,30-34,1955,68
STAT,1845,46,15-19,1891,3.1342586916779697E-4
STAT,1935,31,na,1966,5339.148460301482
STAT,1865,36,20-24,1901,0.7171663930766458
SIM,1913,40,na,1953,3854
STAT,1807,54,30-34,1861,0.02361613548812939
STAT,1876,25,40-44,1901,3.1770237635598733
SIM,1843,44,35-39,1887,4
STAT,1849,37,45-49,1886,1.5836699861049273
STAT,1905,49,45-49,1954,0.19204182035702483
SIM,1946,23,15-19,1969,6
STAT,1890,28,25-29,1918,52.57839177927061
SIM,1810,97,na,1907,18
SIM,1856,38,40-44,1894,10
STAT,1868,31,40-44,1899,4.242823254079073
SIM,1821,35,45-49,1856,2
STAT,1860,18,40-44,1878,0.17357447680522098
SIM,1883,24,40-44,1907,1
SIM,1911,49,40-44,1960,1
STAT,1884,19,40-44,1903,0.18361090004249792
STAT,1927,20,35-39,1947,11.904428097296295
STAT,1938,0,na,1938,4533.349613699691
STAT,1881,57,na,1938,1982.0536432938045
SIM,1821,49,na,1870,1388
STAT,1850,28,50-100,1878,0.5621866456259977
SIM,1892,53,na,1945,3086
SIM,1831,37,25-29,1868,2
SIM,1884,25,40-44,1909,7
STAT,1809,80,na,1889,340.90356965944943
STAT,1886,27,20-24,1913,12.667763068559717
STAT,1928,21,35-39,1949,12.027785753365858
SIM,1833,22,30-34,1855,17
STAT,1851,43,35-39,1894,1.4831608598020454
SIM,1894,27,20-24,1921,13
STAT,1938,23,15-19,1961,5.372443322392136
STAT,1926,21,30-34,1947,35.728574975922605
STAT,1823,37,25-29,1860,5.394567797208146
STAT,1903,38,30-34,1941,1.659911893298313
SIM,1936,21,35-39,1957,11
STAT,1881,22,15-19,1903,3.2537528516182626
STAT,1897,24,50-100,1921,0.5527588725180674
SIM,1876,79,na,1955,798
STAT,1819,36,20-24,1855,2.3690557021753373
SIM,1911,38,30-34,1949,4
STAT,1869,30,50-100,1899,0.9096717346636934
STAT,1800,59,na,1859,1204.6080679662414
STAT,1881,19,15-19,1900,5.82172427974327
STAT,1877,24,45-49,1901,0.7332072484183014
STAT,1885,46,45-49,1931,0.24087775597399072
STAT,1886,47,15-19,1933,4.299108227683444E-4
SIM,1842,28,40-44,1870,3
STAT,1850,28,25-29,1878,37.17614016634686
STAT,1844,17,45-49,1861,0.06434562405732352
SIM,1858,26,na,1884,2019
STAT,1835,44,35-39,1879,1.5763548159088339
SIM,1862,31,na,1893,2217
SIM,1878,28,20-24,1906,18
STAT,1846,100,na,1946,0.7592054741647722
STAT,1855,42,50-100,1897,0.8179514103703536
STAT,1861,17,45-49,1878,0.06329061619227683
STAT,1830,35,45-49,1865,1.8512006252665556
STAT,1880,26,45-49,1906,1.1943625459193108
STAT,1826,52,na,1878,1378.9723595455102
STAT,1883,15,30-34,1898,1.6028207241077073
SIM,1854,44,na,1898,1961
STAT,1882,30,50-100,1912,0.9179550382017397
SIM,1872,33,na,1905,2476
STAT,1847,51,20-24,1898,5.781923978756378E-4
STAT,1858,24,50-100,1882,0.33952470912727106
STAT,1879,50,50-100,1929,0.016336326543071454
SIM,1829,69,na,1898,724
STAT,1825,53,35-39,1878,0.010465887454522567
STAT,1782,110,na,1892,7.549155567148449E-4
STAT,1851,59,na,1910,1603.3917012779098
SIM,1809,49,na,1858,1083
STAT,1841,54,50-100,1895,0.010844505947796084
STAT,1943,21,30-34,1964,31.20825719540194
SIM,1879,27,25-29,1906,56
STAT,1923,33,50-100,1956,0.9664844150804042
STAT,1856,46,20-24,1902,0.009636925924294779
SIM,1884,45,35-39,1929,1
SIM,1864,46,20-24,1910,1
STAT,1891,29,25-29,1920,53.0447573860789
STAT,1848,50,25-29,1898,0.002792890323864265
STAT,1944,20,35-39,1964,10.379574835797944
SIM,1869,38,50-100,1907,2
SIM,1880,84,na,1964,340
STAT,1840,67,na,1907,1140.7194993146284
STAT,1937,21,50-100,1958,0.6538054448151286
SIM,1868,37,20-24,1905,2
STAT,1885,31,na,1916,2438.662140013127
STAT,1850,27,40-44,1877,2.651657407127909
STAT,1856,44,25-29,1900,0.5073003039699032
STAT,1872,29,15-19,1901,0.46056350028150583
SIM,1842,43,35-39,1885,11
SIM,1898,38,45-49,1936,1
STAT,1901,11,na,1912,3689.651308600337
SIM,1867,62,na,1929,1557
STAT,1871,19,25-29,1890,5.695659328669277
STAT,1892,44,35-39,1936,0.1586046820905324
STAT,1854,19,25-29,1873,5.127218170732338
STAT,1950,20,na,1970,4422.720532116615
STAT,1838,36,30-34,1874,4.774475992200103
STAT,1870,52,35-39,1922,0.008539788600710434
STAT,1909,21,25-29,1930,87.81915925767392
STAT,1840,37,25-29,1877,2.4505086609886013
STAT,1905,25,na,1930,3540.025895760655
SIM,1870,41,45-49,1911,1
STAT,1889,39,40-44,1928,5.460763353861148
STAT,1900,20,50-100,1920,0.5800354374609348
STAT,1830,65,na,1895,1069.0570116426093
STAT,1879,49,25-29,1928,0.06013960205658066
SIM,1877,47,45-49,1924,1
SIM,1887,49,25-29,1936,1
STAT,1843,18,40-44,1861,0.18757861054107952
SIM,1884,66,na,1950,1584
STAT,1872,32,15-19,1904,0.14560182840881092
STAT,1896,23,na,1919,3176.709932548016
SIM,1813,54,na,1867,1228
SIM,1913,1,na,1914,4371
SIM,1880,29,15-19,1909,4
STAT,1895,37,15-19,1932,0.07474233639326956
SIM,1870,30,35-39,1900,16
STAT,1918,1,na,1919,4638.500029105009
SIM,1846,36,30-34,1882,10
STAT,1866,34,40-44,1900,4.04578341582653
STAT,1824,54,30-34,1878,0.006432287095790502
STAT,1897,64,na,1961,2518.2587157823436
SIM,1899,39,45-49,1938,1
SIM,1897,39,40-44,1936,3
SIM,1874,34,40-44,1908,6
STAT,1828,46,15-19,1874,3.1697740723333047E-4
SIM,1937,17,15-19,1954,53
STAT,1902,42,50-100,1944,0.10541223973851162
STAT,1805,98,na,1903,1.3056760339546485
STAT,1832,43,25-29,1875,0.5208380950465212
STAT,1855,48,25-29,1903,0.044090373775481605
SIM,1863,36,30-34,1899,8
STAT,1883,80,na,1963,868.2773901325504
STAT,1916,22,25-29,1938,98.7730161284523
STAT,1940,29,45-49,1969,1.795446269568892
SIM,1852,45,45-49,1897,1
SIM,1847,16,25-29,1863,10
SIM,1939,25,25-29,1964,79
STAT,1771,109,na,1880,0.0028563613372555303
STAT,1882,31,20-24,1913,2.6974862161493167
SIM,1888,49,40-44,1937,1
STAT,1848,109,na,1957,7.620543030127405E-4
STAT,1894,41,35-39,1935,2.3869344822610565
STAT,1813,105,na,1918,0.012608690438232482
STAT,1940,31,50-100,1971,0.8734630660725227
SIM,1912,55,na,1967,3564
SIM,1930,12,na,1942,5739
STAT,1857,33,30-34,1890,13.85178443876014
SIM,1881,16,25-29,1897,4
SIM,1945,10,na,1955,4698
STAT,1918,43,na,1961,4023.206806756668
STAT,1939,13,na,1952,4030.9351491615234
STAT,1846,42,45-49,1888,1.083236864730249
STAT,1884,47,50-100,1931,0.24672418105952051
STAT,1961,2,na,1963,5184.6961750993905
STAT,1834,40,25-29,1874,0.5344896124351192
STAT,1762,112,na,1874,7.236023217500756E-4
STAT,1897,32,na,1929,3255.0155848392687
STAT,1862,11,na,1873,2385.124950908233
STAT,1839,16,25-29,1855,5.146289030619419
STAT,1839,78,na,1917,539.2327321032279
STAT,1883,18,40-44,1901,0.18259997099898834
SIM,1856,70,na,1926,1373
STAT,1835,52,40-44,1887,0.007997062068211172
STAT,1794,65,na,1859,834.0637986065057
STAT,1918,49,30-34,1967,0.09624010653609075
SIM,1834,30,25-29,1864,3
SIM,1890,31,20-24,1921,7
STAT,1898,43,20-24,1941,0.015104218350737853
SIM,1862,16,20-24,1878,17
STAT,1849,51,30-34,1900,0.004643435812770506
STAT,1818,65,na,1883,937.3579831668677
STAT,1858,41,25-29,1899,0.5218606249903744
STAT,1890,49,30-34,1939,0.0666866038561987
SIM,1873,34,25-29,1907,14
SIM,1843,27,45-49,1870,1
SIM,1843,84,na,1927,173
STAT,1775,106,na,1881,0.012026033632766369
STAT,1878,29,50-100,1907,0.6744097152170538
STAT,1833,44,30-34,1877,0.8982645863865504
STAT,1827,50,35-39,1877,0.009705806872554987
STAT,1830,97,na,1927,3.398438267893494
STAT,1858,5,na,1863,2376.321408932927
STAT,1888,44,15-19,1932,0.01643012315129372
STAT,1863,52,na,1915,1915.6519724931263
SIM,1908,24,50-100,1932,1
STAT,1855,36,30-34,1891,4.151364555865984
STAT,1919,31,40-44,1950,4.326060678012958
SIM,1823,48,30-34,1871,1
STAT,1874,29,25-29,1903,43.74464449570802
SIM,1895,58,na,1953,2710
STAT,1788,93,na,1881,7.672231244655929
STAT,1815,40,20-24,1855,0.5578438104546161
SIM,1854,42,45-49,1896,3
SIM,1947,3,na,1950,4766
STAT,1860,30,25-29,1890,8.546096584192078
STAT,1822,38,20-24,1860,1.3883867574211428
SIM,1870,26,20-24,1896,15
STAT,1778,104,na,1882,0.02163289985205458
STAT,1862,43,40-44,1905,1.9391612171732586
STAT,1830,48,50-100,1878,0.20119929519142513
STAT,1862,26,20-24,1888,10.299096438607473
STAT,1834,47,na,1881,1603.4164704173215
STAT,1854,16,20-24,1870,16.327467567024268
SIM,1870,43,40-44,1913,4
STAT,1882,39,30-34,1921,5.243632471900755
STAT,1835,27,45-49,1862,1.0786036787766469
SIM,1890,39,30-34,1929,14
STAT,1904,23,45-49,1927,1.0163796958815638
SIM,1898,35,40-44,1933,1
STAT,1869,27,15-19,1896,0.4468554570129813
STAT,1860,87,na,1947,145.82734632040072
SIM,1886,29,50-100,1915,2
STAT,1847,35,15-19,1882,0.04638755032116049
SIM,1817,44,na,1861,1403
SIM,1882,29,25-29,1911,56
STAT,1848,38,40-44,1886,3.4704060527437175
STAT,1868,51,35-39,1919,0.008428521428174376
SIM,1939,16,35-39,1955,4
STAT,1826,30,25-29,1856,13.219640072207099
SIM,1898,26,na,1924,3656
STAT,1876,33,50-100,1909,0.9611268447101717
STAT,1891,28,40-44,1919,3.770073494598765
SIM,1830,29,30-34,1859,38
SIM,1832,42,50-100,1874,2
SIM,1872,23,20-24,1895,62
STAT,1834,23,40-44,1857,1.8620023888468602
SIM,1879,28,50-100,1907,1
STAT,1845,98,na,1943,2.538237726298377
SIM,1810,65,na,1875,1123
STAT,1826,60,na,1886,1176.956915746329
SIM,1864,46,na,1910,2079
SIM,1906,9,na,1915,3866
STAT,1841,18,30-34,1859,1.508871736121191
SIM,1832,37,40-44,1869,8
SIM,1872,41,na,1913,2437
STAT,1891,24,25-29,1915,71.84847208681477
STAT,1836,20,40-44,1856,1.821748333449882
STAT,1931,36,40-44,1967,2.0237769413768523
SIM,1883,27,45-49,1910,2
STAT,1871,31,45-49,1902,1.7693766393518249
SIM,1814,79,na,1893,380
STAT,1824,37,40-44,1861,6.0542830056765595
STAT,1875,41,30-34,1916,1.2091614142999032
STAT,1881,38,25-29,1919,2.825602267054671
SIM,1836,26,20-24,1862,19
SIM,1843,52,na,1895,1592
STAT,1838,48,25-29,1886,0.042986130244418864
STAT,1849,24,50-100,1873,0.3772928590559689
SIM,1798,91,na,1889,10
STAT,1820,44,45-49,1864,2.807815528981567
STAT,1833,54,na,1887,1400.4638013434815
SIM,1832,33,na,1865,1831
STAT,1861,45,45-49,1906,0.20092385636170904
SIM,1876,23,na,1899,2724
STAT,1847,26,25-29,1873,39.93566697008797
SIM,1916,38,50-100,1954,1
STAT,1864,23,20-24,1887,63.058471485960624
STAT,1883,51,30-34,1934,0.005986804487326099
STAT,1808,50,30-34,1858,0.014815602663902685
STAT,1875,27,45-49,1902,1.1624991991172722
STAT,1815,48,25-29,1863,0.15239287665249682
STAT,1800,67,na,1867,909.6852107538022
STAT,1830,30,45-49,1860,1.7260818178981034
STAT,1842,31,20-24,1873,2.5874401140891514
STAT,1852,44,35-39,1896,1.4391035608383602
SIM,1831,25,30-34,1856,29
SIM,1877,64,na,1941,1768
STAT,1892,9,na,1901,3317.3989844694433
STAT,1844,45,45-49,1889,0.18576307869099146
STAT,1876,28,45-49,1904,1.1655088509411096
SIM,1842,43,na,1885,1709
STAT,1836,36,20-24,1872,0.5951218779264824
SIM,1875,35,50-100,1910,4
STAT,1841,30,20-24,1871,2.472328516629361
STAT,1814,47,25-29,1861,0.17174359347048437
STAT,1895,17,20-24,1912,23.5968693590252
SIM,1847,74,na,1921,674
STAT,1893,21,25-29,1914,74.30787255001214
SIM,1871,39,20-24,1910,3
SIM,1924,22,25-29,1946,4
STAT,1904,38,50-100,1942,0.3855220530051894
STAT,1861,31,30-34,1892,14.778134271116409
STAT,1888,36,15-19,1924,0.06804949298889713
STAT,1859,28,45-49,1887,0.9135875245321301
STAT,1886,80,na,1966,1002.9034554686139
SIM,1855,26,25-29,1881,41
SIM,1926,30,35-39,1956,18
STAT,1832,32,15-19,1864,0.12490437462117152
STAT,1945,21,40-44,1966,3.7610100300242517
STAT,1925,39,20-24,1964,0.32210828245037676
SIM,1840,43,25-29,1883,2
STAT,1828,26,20-24,1854,24.055319145416362
SIM,1809,57,na,1866,882
SIM,1824,38,na,1862,1598
STAT,1846,72,na,1918,903.1236336943404
SIM,1868,41,35-39,1909,2
STAT,1810,51,25-29,1861,0.010822477207322458
STAT,1824,33,25-29,1857,18.128916244816725
STAT,1914,39,45-49,1953,0.687475861550945
STAT,1860,18,50-100,1878,0.04649315212399536
STAT,1905,33,na,1938,3530.802086752186
STAT,1921,46,25-29,1967,0.061172716087330464
SIM,1779,77,na,1856,204
SIM,1922,39,45-49,1961,4
STAT,1890,16,30-34,1906,1.9929748971051895
SIM,1849,24,35-39,1873,4
SIM,1918,20,35-39,1938,10
SIM,1832,33,25-29,1865,12
SIM,1842,23,40-44,1865,1
STAT,1936,34,45-49,1970,1.5569038971802642
SIM,1867,28,45-49,1895,1
STAT,1863,39,20-24,1902,0.6825477339845832
STAT,1902,68,na,1970,2561.7097403497314
STAT,1808,55,na,1863,980.8749066966647
STAT,1826,49,45-49,1875,0.17959541493805664
STAT,1918,30,35-39,1948,9.989288724543986
SIM,1861,23,45-49,1884,2
STAT,1900,41,35-39,1941,0.17860390619950817
SIM,1862,16,15-19,1878,6
SIM,1896,43,na,1939,3118
STAT,1847,46,na,1893,1759.4363386572822
STAT,1843,51,30-34,1894,0.004828324243352152
STAT,1892,25,25-29,1917,54.451914758323795
STAT,1860,105,na,1965,0.1422353331577862
STAT,1905,46,40-44,1951,0.14268640840806304
SIM,1917,24,35-39,1941,12
STAT,1838,85,na,1923,201.42086281501724
SIM,1858,44,30-34,1902,2
STAT,1876,53,40-44,1929,0.010912071309317964
SIM,1792,75,na,1867,392
SIM,1858,35,40-44,1893,8
STAT,1854,24,na,1878,1895.2315308145016
STAT,1937,30,45-49,1967,1.5897904638531368
SIM,1930,20,na,1950,5610
SIM,1833,34,25-29,1867,19
SIM,1874,30,25-29,1904,16
STAT,1843,32,na,1875,2103.3125033009055
STAT,1809,51,30-34,1860,0.025796518128892908
STAT,1858,38,na,1896,1896.5498217413624
STAT,1913,20,na,1933,3794.9445977989303
STAT,1892,15,50-100,1907,0.06293017948061923
STAT,1909,4,na,1913,4023.529398871577
SIM,1838,39,30-34,1877,6
STAT,1886,42,45-49,1928,1.6141005035520746
STAT,1854,16,15-19,1870,5.465550590943532
STAT,1819,40,35-39,1859,4.140672326386258
STAT,1847,22,na,1869,2043.9961094267883
STAT,1819,51,45-49,1870,0.02820611288812506
SIM,1839,43,30-34,1882,2
SIM,1885,51,na,1936,2147
STAT,1821,42,40-44,1863,3.9028074988054264
STAT,1850,23,25-29,1873,51.31229582413809
STAT,1855,17,20-24,1872,16.34607873590914
SIM,1817,37,45-49,1854,3
SIM,1853,30,35-39,1883,17
STAT,1825,34,25-29,1859,17.490091654869108
STAT,1913,38,50-100,1951,0.4205950137794604
STAT,1853,40,35-39,1893,1.533685826965162
STAT,1898,34,30-34,1932,23.88037562969729
STAT,1912,27,na,1939,3765.9722053401165
STAT,1816,82,na,1898,207.02888131994146
STAT,1853,23,45-49,1876,0.6858911614157461
SIM,1800,87,na,1887,20
STAT,1849,34,40-44,1883,3.4749060936104246
SIM,1890,38,na,1928,3093
STAT,1816,41,20-24,1857,0.3948643531034905
STAT,1871,49,50-100,1920,0.24300293853183652
SIM,1940,19,na,1959,3715
SIM,1920,42,na,1962,3989
SIM,1891,15,30-34,1906,2
STAT,1861,34,50-100,1895,0.7657532136661542
SIM,1853,41,45-49,1894,1
SIM,1884,42,30-34,1926,3
STAT,1864,51,20-24,1915,6.725562254368292E-4
STAT,1932,23,20-24,1955,148.32923277478983
STAT,1890,41,20-24,1931,0.1989896739973341
SIM,1873,38,40-44,1911,9
STAT,1917,34,35-39,1951,9.681802350668518
SIM,1863,17,20-24,1880,15
STAT,1832,24,15-19,1856,3.178377843777839
STAT,1927,41,40-44,1968,0.32045231325741974
STAT,1849,88,na,1937,106.58156211341203
STAT,1828,26,15-19,1854,0.9303162175030171
SIM,1827,40,35-39,1867,3
STAT,1831,43,50-100,1874,0.8834601885144068
SIM,1937,20,45-49,1957,1
STAT,1898,45,40-44,1943,0.134553030573143
SIM,1848,28,35-39,1876,13
SIM,1868,24,45-49,1892,1
STAT,1831,31,45-49,1862,1.6178141109594102
STAT,1909,24,35-39,1933,8.869255438768915
SIM,1940,23,20-24,1963,111
STAT,1838,33,20-24,1871,2.4424129740855762
STAT,1872,64,na,1936,1777.349186946435
STAT,1840,34,20-24,1874,2.3204436330996114
SIM,1846,33,20-24,1879,4
SIM,1838,23,20-24,1861,85
STAT,1876,42,30-34,1918,1.2096032432347756
SIM,1905,22,15-19,1927,5
STAT,1815,48,30-34,1863,0.2561046979537464
STAT,1865,38,40-44,1903,4.033038655348492
STAT,1947,17,30-34,1964,14.00859416744431
STAT,1810,52,50-100,1862,0.04522724643582449
STAT,1823,50,20-24,1873,0.0011113713736709435
STAT,1860,53,50-100,1913,0.012300047939965824
SIM,1783,90,na,1873,19
SIM,1857,34,40-44,1891,4
SIM,1875,31,25-29,1906,2
STAT,1897,47,20-24,1944,0.009190117648976669
STAT,1877,54,40-44,1931,0.010832838664236503
STAT,1895,17,15-19,1912,7.898952041412184
STAT,1888,28,na,1916,2868.063991702151
SIM,1864,29,30-34,1893,37
SIM,1885,21,40-44,1906,1
SIM,1776,88,na,1864,72
STAT,1874,40,25-29,1914,0.6755951704992207
SIM,1927,31,40-44,1958,6
SIM,1865,38,50-100,1903,1
STAT,1866,38,35-39,1904,6.622397386529576
STAT,1937,27,15-19,1964,0.7019371274878529
STAT,1892,42,15-19,1934,0.01763498347323545
SIM,1871,48,na,1919,2020
SIM,1894,31,35-39,1925,3
STAT,1842,50,30-34,1892,0.004735098093981654
STAT,1845,30,35-39,1875,9.605726023158493
SIM,1899,36,40-44,1935,2
STAT,1835,41,30-34,1876,1.040027678155579
SIM,1948,19,40-44,1967,3
STAT,1886,31,35-39,1917,10.980017095071426
STAT,1881,49,na,1930,2172.63677591893
STAT,1866,18,35-39,1884,0.5268379975190386
SIM,1882,40,25-29,1922,1
SIM,1826,45,50-100,1871,1
STAT,1852,36,35-39,1888,5.788671507953654
STAT,1910,28,20-24,1938,17.914669056875127
SIM,1879,24,20-24,1903,87
STAT,1880,64,na,1944,1863.571696183253
STAT,1851,24,25-29,1875,55.59319026278504
STAT,1929,17,15-19,1946,59.0734675218463
SIM,1909,27,na,1936,3648
SIM,1905,13,na,1918,3743
SIM,1823,83,na,1906,226
STAT,1864,77,na,1941,784.0748266707286
STAT,1943,24,35-39,1967,10.213810722310562
STAT,1846,39,15-19,1885,0.04107363950921813
STAT,1887,29,50-100,1916,0.7260273201007532
STAT,1929,32,50-100,1961,1.071153822401644
SIM,1865,33,30-34,1898,27
STAT,1805,90,na,1895,31.68814337973172
STAT,1887,43,45-49,1930,1.6985004911495927
SIM,1874,18,35-39,1892,6
STAT,1818,40,40-44,1858,6.257603201384225
STAT,1925,21,na,1946,4473.140341839056
STAT,1854,8,na,1862,2248.2601135886175
SIM,1842,40,30-34,1882,3
SIM,1860,36,35-39,1896,14
STAT,1856,49,30-34,1905,0.07589926678950042
SIM,1900,31,50-100,1931,1
STAT,1879,34,20-24,1913,2.8577420795631214
STAT,1867,42,na,1909,2210.8223674097353
STAT,1875,41,25-29,1916,0.6753874593993261
SIM,1847,44,25-29,1891,3
SIM,1843,41,30-34,1884,1
SIM,1829,39,35-39,1868,10
STAT,1846,42,15-19,1888,0.009995265889568953
STAT,1929,35,na,1964,4934.889652340273
SIM,1825,31,na,1856,1668
SIM,1844,69,na,1913,1096
SIM,1859,99,na,1958,9
STAT,1847,43,15-19,1890,0.010691291376516867
SIM,1874,38,35-39,1912,15
STAT,1834,40,30-34,1874,0.9569088183476869
STAT,1896,46,20-24,1942,0.009146128994873683
SIM,1937,32,50-100,1969,1
STAT,1856,29,30-34,1885,20.59734343440331
STAT,1874,48,35-39,1922,0.14398644317142145
STAT,1873,16,25-29,1889,5.895536239932863
STAT,1808,50,25-29,1858,0.008815895715041877
STAT,1891,41,15-19,1932,0.017520706271163256
SIM,1824,32,30-34,1856,21
STAT,1884,5,na,1889,2657.52149627372
SIM,1923,10,na,1933,4579
STAT,1844,20,50-100,1864,0.40027570476511554
STAT,1879,46,20-24,1925,0.012832591463483747
SIM,1934,21,25-29,1955,197
STAT,1855,39,35-39,1894,5.427733426647289
STAT,1863,42,15-19,1905,0.012337018263712023
SIM,1891,34,40-44,1925,10
SIM,1829,77,na,1906,374
STAT,1807,54,25-29,1861,0.014052576353367562
STAT,1859,25,40-44,1884,2.5186953235668543
STAT,1883,23,30-34,1906,17.77438667203975
STAT,1894,36,45-49,1930,2.6284799765397606
SIM,1914,33,20-24,1947,3
STAT,1885,31,40-44,1916,4.431855743501568
SIM,1908,22,40-44,1930,5
STAT,1892,29,40-44,1921,3.8026400059590726
STAT,1920,45,25-29,1965,0.0601204589087134
STAT,1839,44,25-29,1883,0.4552772059939947
SIM,1908,42,na,1950,3770
SIM,1850,34,30-34,1884,24
SIM,1842,27,50-100,1869,5
STAT,1825,38,40-44,1863,6.487897476865987
STAT,1825,67,na,1892,950.5962014079365
SIM,1841,26,na,1867,1946
SIM,1833,38,40-44,1871,9
STAT,1926,21,25-29,1947,114.82548935789107
STAT,1867,7,na,1874,2663.0437564200315
STAT,1863,39,15-19,1902,0.04972202661230731
SIM,1891,23,30-34,1914,32
STAT,1920,34,15-19,1954,0.14241194569085064
STAT,1881,44,50-100,1925,1.0278901928672073
STAT,1852,44,na,1896,1836.805864014364
STAT,1861,18,na,1879,2210.9418314434633
SIM,1887,34,20-24,1921,6
STAT,1916,18,40-44,1934,0.30204268968598175
STAT,1899,46,40-44,1945,0.13528986640052762
SIM,1824,43,40-44,1867,2
STAT,1897,26,15-19,1923,0.6209906525003929
SIM,1899,15,35-39,1914,1
STAT,1822,54,20-24,1876,9.719132978476561E-4
STAT,1936,35,50-100,1971,0.4211286025246203
SIM,1826,36,35-39,1862,7
SIM,1941,22,25-29,1963,2
STAT,1827,45,45-49,1872,0.27229892921983123
STAT,1836,81,na,1917,336.5905288246648
SIM,1817,43,30-34,1860,1
STAT,1925,29,50-100,1954,1.1908535320747708
STAT,1832,28,30-34,1860,22.64736605148053
STAT,1883,34,40-44,1917,4.303738243736673
STAT,1802,93,na,1895,9.273378180756163
STAT,1885,27,35-39,1912,9.820474758147075
STAT,1834,24,25-29,1858,50.78495538746858
SIM,1790,71,na,1861,437
SIM,1929,12,na,1941,5413
STAT,1861,80,na,1941,521.4570269007118
STAT,1870,54,na,1924,2088.225206905293
STAT,1837,36,15-19,1873,0.046060189054915546
SIM,1833,82,na,1915,276
STAT,1913,22,50-100,1935,0.6504573538763552
SIM,1840,28,30-34,1868,23
STAT,1940,26,40-44,1966,4.851041330462353
STAT,1874,45,25-29,1919,0.060592076298233835
STAT,1891,42,20-24,1933,0.2003335843584481
SIM,1872,29,35-39,1901,15
SIM,1893,30,35-39,1923,20
STAT,1885,30,35-39,1915,10.389963074580308
STAT,1795,95,na,1890,2.378577204945254
SIM,1801,72,na,1873,577
STAT,1791,81,na,1872,185.79911948524833
SIM,1893,27,35-39,1920,15
SIM,1842,24,25-29,1866,92
STAT,1824,51,20-24,1875,8.463147300859013E-4
STAT,1874,47,na,1921,2332.4235167251895
SIM,1848,59,na,1907,1537
SIM,1843,33,30-34,1876,24
STAT,1933,22,25-29,1955,124.95181560079126
STAT,1797,103,na,1900,0.03613930414900713
STAT,1863,26,15-19,1889,0.40874984214792787
SIM,1852,30,40-44,1882,2
SIM,1925,34,35-39,1959,5
STAT,1919,31,35-39,1950,10.102182620596636
STAT,1823,34,20-24,1857,5.653560666772186
STAT,1865,34,25-29,1899,9.402461050912812
STAT,1894,24,45-49,1918,0.909309768847032
STAT,1920,47,20-24,1967,0.012466422136657844
STAT,1826,32,50-100,1858,0.9988392749262316
STAT,1866,39,40-44,1905,4.077642718108685
STAT,1812,52,40-44,1864,0.023764354120423183
STAT,1833,44,25-29,1877,0.5017333746291112
STAT,1849,45,50-100,1894,0.19257508742496823
STAT,1856,49,25-29,1905,0.04516319963781475
STAT,1823,53,25-29,1876,0.005025557403583777
STAT,1838,39,50-100,1877,1.0661333010103848
SIM,1850,22,30-34,1872,30
SIM,1876,44,50-100,1920,1
STAT,1829,51,50-100,1880,0.0120508300266865
STAT,1827,33,45-49,1860,2.5625520258040297
STAT,1882,42,na,1924,2294.2595487797826
STAT,1891,16,na,1907,3197.6696265365094
STAT,1904,46,25-29,1950,0.04763914175346608
STAT,1850,41,20-24,1891,0.12000045765078338
SIM,1922,36,40-44,1958,3
STAT,1811,43,35-39,1854,5.592993106470461
STAT,1870,65,na,1935,1685.3365763029117
SIM,1811,82,na,1893,97
STAT,1842,34,30-34,1876,16.200307190955268
STAT,1890,25,20-24,1915,14.732347184323189
STAT,1907,32,25-29,1939,8.809528194561077
STAT,1823,63,na,1886,1024.1623411459193
SIM,1882,24,25-29,1906,72
SIM,1820,56,na,1876,1363
SIM,1867,37,35-39,1904,3
STAT,1843,34,40-44,1877,4.122267000349668
STAT,1873,16,30-34,1889,1.6582257575510058
STAT,1884,54,na,1938,2113.4523128519554
STAT,1859,87,na,1946,143.53712070719004
STAT,1914,36,40-44,1950,1.5323181233718495
SIM,1867,40,35-39,1907,1
SIM,1831,34,20-24,1865,5
SIM,1794,85,na,1879,93
STAT,1908,41,30-34,1949,0.1213092468745342
STAT,1858,27,45-49,1885,0.9195280853127384
STAT,1906,33,20-24,1939,2.2948982523778376
STAT,1842,22,30-34,1864,17.618361640745515
STAT,1844,30,40-44,1874,4.103011907061836
SIM,1898,4,na,1902,4060
STAT,1929,33,15-19,1962,0.16638110665372322
STAT,1785,96,na,1881,1.615557873688335
STAT,1811,54,45-49,1865,0.036892791132867295
SIM,1908,50,na,1958,3566
STAT,1763,111,na,1874,4.241226189180539E-4
STAT,1876,34,30-34,1910,18.235109424907197
STAT,1874,79,na,1953,728.1613611929123
SIM,1831,28,35-39,1859,12
SIM,1884,34,30-34,1918,24
SIM,1851,34,40-44,1885,4
SIM,1881,16,30-34,1897,1
STAT,1871,49,20-24,1920,0.011873108215942613
STAT,1939,23,30-34,1962,29.435668038044007
STAT,1836,39,25-29,1875,2.1546626877776305
SIM,1819,70,na,1889,745
STAT,1861,29,na,1890,1997.3848486468478
STAT,1843,46,40-44,1889,0.13933454872203094
SIM,1903,33,45-49,1936,1
SIM,1833,85,na,1918,168
SIM,1864,29,50-100,1893,1
STAT,1944,22,50-100,1966,0.7248368536880875
SIM,1927,31,35-39,1958,14
STAT,1874,26,20-24,1900,12.260964651385768
SIM,1841,44,25-29,1885,1
STAT,1875,24,40-44,1899,2.1681117965668437
STAT,1842,33,40-44,1875,4.065899750699227
SIM,1839,20,50-100,1859,1
SIM,1850,33,40-44,1883,6
SIM,1882,26,20-24,1908,15
SIM,1929,15,50-100,1944,4
SIM,1865,39,na,1904,2261
STAT,1867,49,50-100,1916,0.2303077160943192
STAT,1853,112,na,1965,1.4766840169728201E-4
STAT,1848,39,na,1887,1848.4824921398856
STAT,1938,20,na,1958,3689.35218263978
SIM,1874,13,na,1887,2676
STAT,1897,7,na,1904,3553.8011567371805
STAT,1875,25,25-29,1900,44.59051652954382
STAT,1927,44,45-49,1971,0.2122095129726702
STAT,1859,6,na,1865,2359.3284646249012
STAT,1865,62,na,1927,1692.3014337352827
STAT,1799,88,na,1887,46.89631256865001
STAT,1857,45,30-34,1902,0.07789126590020372
STAT,1795,74,na,1869,405.3306049932589
STAT,1814,70,na,1884,779.636705491866
STAT,1827,101,na,1928,0.3688050579103368
STAT,1945,21,35-39,1966,10.532299637178596
SIM,1857,7,na,1864,2474
SIM,1881,25,20-24,1906,10
SIM,1833,74,na,1907,670
STAT,1843,54,35-39,1897,0.006758744536322856
STAT,1822,38,15-19,1860,0.10114076988823233
STAT,1846,80,na,1926,442.371671135653
STAT,1863,35,50-100,1898,1.1085859563122824
SIM,1881,29,30-34,1910,32
STAT,1841,54,30-34,1895,0.00427421896766459
STAT,1861,23,30-34,1884,15.314931634097345
STAT,1826,46,40-44,1872,0.13555904089577786
STAT,1882,39,25-29,1921,2.8327669520284857
STAT,1916,17,na,1933,4181.694767783009
SIM,1820,34,45-49,1854,4
SIM,1844,77,na,1921,604
STAT,1828,46,45-49,1874,0.18701682767655892
SIM,1881,44,25-29,1925,2
SIM,1890,39,25-29,1929,10
STAT,1873,29,30-34,1902,25.85822531491432
STAT,1893,37,40-44,1930,5.665129784652762
STAT,1873,33,15-19,1906,0.14666353423525097
STAT,1912,25,50-100,1937,1.0074049785084
STAT,1878,37,15-19,1915,0.059628351988993133
STAT,1884,35,40-44,1919,4.460097065814074
STAT,1836,73,na,1909,739.2983295065287
STAT,1890,44,25-29,1934,0.7901743290981349
STAT,1882,15,15-19,1897,5.92561644831294
SIM,1805,67,na,1872,727
SIM,1848,49,40-44,1897,1
SIM,1871,42,45-49,1913,2
SIM,1915,32,25-29,1947,9
STAT,1822,41,15-19,1863,0.022145068028344272
STAT,1930,36,25-29,1966,1.3110568906854587
SIM,1825,44,40-44,1869,4
STAT,1873,44,25-29,1917,0.6551858572803281
STAT,1876,4,na,1880,3055.344817529147
SIM,1875,34,35-39,1909,17
SIM,1871,4,na,1875,2690
SIM,1880,28,na,1908,2344
STAT,1898,49,35-39,1947,0.10667084397021721
STAT,1949,12,na,1961,4661.005889230813
STAT,1867,34,35-39,1901,9.615973169511372
STAT,1835,33,30-34,1868,16.39748168714716
STAT,1817,44,40-44,1861,5.2263052428903665
STAT,1847,54,25-29,1901,0.0026861516031774536
STAT,1890,33,15-19,1923,0.17688074075432328
SIM,1832,44,na,1876,1618
SIM,1841,18,na,1859,2109
STAT,1878,37,45-49,1915,2.1168062438692252
STAT,1847,26,30-34,1873,23.773574058445064
STAT,1934,31,30-34,1965,21.949779755875092
STAT,1870,20,40-44,1890,2.090503979960498
STAT,1816,85,na,1901,121.6371228792917
SIM,1859,46,45-49,1905,1
SIM,1908,31,25-29,1939,20
STAT,1957,15,25-29,1972,58.30071241598482
SIM,1892,35,40-44,1927,8
SIM,1911,17,na,1928,4012
STAT,1918,47,50-100,1965,0.24561911752779997
STAT,1823,42,15-19,1865,0.022339564971222373
STAT,1827,37,na,1864,1812.8254676738795
STAT,1887,40,40-44,1927,2.597166872635981
SIM,1874,35,30-34,1909,9
SIM,1870,29,25-29,1899,56
STAT,1863,42,45-49,1905,1.3370242604601235
SIM,1821,36,50-100,1857,3
SIM,1769,86,na,1855,90
STAT,1806,53,25-29,1859,0.011272836518166093
SIM,1891,35,30-34,1926,8
STAT,1830,48,20-24,1878,0.009830584844825654
SIM,1810,57,na,1867,1433
SIM,1960,4,na,1964,5247
STAT,1893,24,35-39,1917,7.504689276559572
SIM,1855,26,30-34,1881,32
STAT,1857,44,40-44,1901,1.7678513711326964
STAT,1899,28,45-49,1927,1.5456000872897933
STAT,1868,46,45-49,1914,0.23060356735107934
STAT,1877,50,25-29,1927,0.0038016109229905746
SIM,1886,37,45-49,1923,1
STAT,1864,43,15-19,1907,0.012436162425611998
SIM,1865,44,40-44,1909,7
SIM,1819,46,45-49,1865,2
STAT,1816,43,40-44,1859,5.0821986927233365
STAT,1826,33,35-39,1859,10.354132053829543
SIM,1881,69,na,1950,1392
STAT,1837,44,na,1881,1612.8231768275386
SIM,1883,25,na,1908,2456
STAT,1921,23,45-49,1944,1.2928306268951004
STAT,1933,16,50-100,1949,0.5127270808475003
SIM,1951,2,na,1953,5371
STAT,1863,84,na,1947,297.55116534552803
STAT,1866,35,30-34,1901,5.0626015972341785
STAT,1894,67,na,1961,2236.578954824387
SIM,1810,89,na,1899,81
STAT,1862,29,25-29,1891,36.4720065089314
STAT,1842,53,35-39,1895,0.006642865087267472
STAT,1882,19,30-34,1901,1.5756146493538143
SIM,1869,10,na,1879,2692
STAT,1873,25,15-19,1898,0.4724251519768199
STAT,1885,39,na,1924,2373.7301721751187
SIM,1834,33,35-39,1867,18
SIM,1816,59,na,1875,1230
STAT,1902,23,35-39,1925,8.36924602150773
STAT,1853,53,40-44,1906,0.00868568657520646
SIM,1909,21,45-49,1930,1
STAT,1941,8,na,1949,4167.008754199489
SIM,1827,40,50-100,1867,2
STAT,1912,35,na,1947,3781.4381792683557
STAT,1816,44,30-34,1860,2.4787347234965553
STAT,1902,28,na,1930,3421.275492302829
STAT,1883,35,30-34,1918,5.385387665980116
STAT,1851,28,40-44,1879,2.8728805129167343
SIM,1910,23,35-39,1933,15
STAT,1873,45,15-19,1918,4.17823891208656E-4
STAT,1856,25,15-19,1881,0.38195470239614243
STAT,1893,45,35-39,1938,0.10321979254700757
SIM,1887,31,na,1918,2822
STAT,1857,40,25-29,1897,0.5167810568351142
SIM,1855,21,na,1876,1900
STAT,1846,29,na,1875,1844.7116271895945
SIM,1891,76,na,1967,1522
SIM,1927,44,50-100,1971,2
STAT,1841,38,25-29,1879,2.4788110582951917
STAT,1826,54,35-39,1880,0.006242958069749303
STAT,1869,47,45-49,1916,0.23135475019734025
SIM,1876,34,45-49,1910,3
SIM,1874,15,30-34,1889,2
SIM,1948,15,25-29,1963,70
STAT,1833,62,na,1895,1200.2631857669976
STAT,1867,47,40-44,1914,0.16319926144626812
STAT,1868,34,45-49,1902,1.6845761921563083
SIM,1869,21,na,1890,2265
SIM,1891,18,35-39,1909,1
STAT,1823,55,na,1878,1264.60388806389
STAT,1864,54,25-29,1918,0.0031245446841255253
STAT,1866,15,30-34,1881,1.5577017613551654
SIM,1820,64,na,1884,1095
STAT,1883,18,35-39,1901,0.5477998812800033
STAT,1859,79,na,1938,569.5715089033732
STAT,1852,52,40-44,1904,0.008435942480826429
STAT,1907,30,50-100,1937,0.7943851164804768
SIM,1831,59,na,1890,1249
SIM,1830,34,na,1864,1883
SIM,1816,38,40-44,1854,2
STAT,1903,34,15-19,1937,0.11756543570232539
SIM,1829,36,30-34,1865,8
STAT,1916,18,50-100,1934,0.08090427220627333
STAT,1875,29,40-44,1904,3.113970974100642
SIM,1830,41,45-49,1871,2
STAT,1818,43,45-49,1861,3.680312459733601
SIM,1834,48,na,1882,1576
STAT,1888,27,30-34,1915,30.36987980681406
SIM,1822,90,na,1912,53
STAT,1824,35,20-24,1859,1.1513210940068483
STAT,1843,16,45-49,1859,0.06778854191352815
STAT,1901,38,20-24,1939,0.23617832850640053
STAT,1838,39,35-39,1877,6.141903122895482
STAT,1811,51,40-44,1862,0.028426878974044653
STAT,1809,46,35-39,1855,0.6332210961530578
STAT,1871,24,50-100,1895,0.40950254576967066
SIM,1917,21,25-29,1938,101
SIM,1818,85,na,1903,113
STAT,1837,47,na,1884,1557.1061433555385
STAT,1807,51,20-24,1858,0.003111484435125933
STAT,1858,45,40-44,1903,0.13988291958636173
STAT,1898,29,35-39,1927,13.216064956824116
SIM,1925,22,40-44,1947,3
SIM,1826,43,45-49,1869,2
SIM,1851,49,45-49,1900,2
SIM,1866,45,40-44,1911,2
SIM,1857,95,na,1952,6
STAT,1854,36,15-19,1890,0.04318500933625661
SIM,1839,19,30-34,1858,2
STAT,1845,95,na,1940,10.388428246361793
STAT,1835,88,na,1923,102.28531952178697
SIM,1832,35,20-24,1867,3
STAT,1874,42,20-24,1916,0.1652099445856105
SIM,1896,27,30-34,1923,2
SIM,1897,35,50-100,1932,2
SIM,1900,22,na,1922,3617
SIM,1876,31,40-44,1907,8
STAT,1824,54,25-29,1878,0.0038274765820941106
SIM,1846,39,35-39,1885,4
STAT,1923,33,20-24,1956,2.851270754260604
STAT,1831,107,na,1938,0.0031777095706270954
SIM,1854,27,20-24,1881,15
SIM,1907,25,na,1932,3553
SIM,1919,30,50-100,1949,2
SIM,1849,6,na,1855,2404
SIM,1877,41,50-100,1918,1
STAT,1840,22,20-24,1862,63.06282140274846
SIM,1893,34,45-49,1927,2
STAT,1884,47,40-44,1931,0.1719836312224661
STAT,1833,43,40-44,1876,1.7802401284312628
SIM,1913,16,15-19,1929,8
STAT,1898,30,15-19,1928,0.1980380157253199
STAT,1859,47,na,1906,1824.433501451504
STAT,1816,47,35-39,1863,0.28789088861677126
STAT,1901,43,na,1944,3284.653181473133
STAT,1822,70,na,1892,815.8090864327918
STAT,1889,35,50-100,1924,1.5618255241859387
STAT,1905,16,15-19,1921,8.765112637004083
STAT,1813,85,na,1898,117.88530235945706
STAT,1771,93,na,1864,5.9471520911535745
STAT,1801,54,30-34,1855,0.01610729700987453
SIM,1867,34,30-34,1901,27
STAT,1891,26,20-24,1917,14.867646148452744
SIM,1911,45,25-29,1956,1
STAT,1833,32,30-34,1865,14.915049476808152
STAT,1903,45,25-29,1948,0.04758732702370284
SIM,1841,43,40-44,1884,6
STAT,1837,49,15-19,1886,2.698417853746457E-4
SIM,1938,17,30-34,1955,15
SIM,1832,89,na,1921,32
SIM,1889,26,30-34,1915,46
STAT,1861,40,na,1901,1967.960783685016
STAT,1885,34,45-49,1919,1.7596299033659435
SIM,1841,32,30-34,1873,20
SIM,1904,24,50-100,1928,1
STAT,1845,29,25-29,1874,39.65465290320132
SIM,1856,34,25-29,1890,13
STAT,1898,41,25-29,1939,0.06179632409229324
STAT,1854,111,na,1965,4.3809441616655357E-4
STAT,1886,24,na,1910,2537.8208217923175
STAT,1885,24,30-34,1909,18.015473585483065
STAT,1832,44,15-19,1876,0.01105640516534849
SIM,1884,37,35-39,1921,11
STAT,1850,44,25-29,1894,0.4765135758599576
STAT,1847,18,50-100,1865,0.047402131831400615
STAT,1876,40,35-39,1916,1.9268124592138334
SIM,1780,93,na,1873,7
SIM,1830,25,15-19,1855,1
SIM,1868,36,na,1904,2351
SIM,1836,46,45-49,1882,1
STAT,1843,23,50-100,1866,0.41024424801923204
STAT,1848,34,25-29,1882,8.275696346894577
STAT,1866,54,35-39,1920,0.007878099475389677
SIM,1850,17,35-39,1867,1
SIM,1849,44,35-39,1893,2
SIM,1895,28,20-24,1923,19
SIM,1948,20,15-19,1968,4
SIM,1853,29,25-29,1882,39
SIM,1874,54,35-39,1928,1
SIM,1810,86,na,1896,206
STAT,1846,27,20-24,1873,10.149119638989015
STAT,1870,62,na,1932,1822.7280863699602
SIM,1836,26,na,1862,2037
SIM,1891,68,na,1959,2018
STAT,1858,24,40-44,1882,1.7349711374146222
STAT,1874,76,na,1950,986.7795065024667
STAT,1895,37,45-49,1932,2.653352626412552
STAT,1862,30,35-39,1892,8.865034642006078
SIM,1826,33,30-34,1859,22
SIM,1869,13,na,1882,2659
SIM,1939,24,50-100,1963,4
SIM,1903,30,40-44,1933,11
SIM,1883,28,na,1911,2442
SIM,1840,15,30-34,1855,2
STAT,1812,60,na,1872,1104.4512392199601
STAT,1887,28,20-24,1915,13.363408300995198
SIM,1886,17,15-19,1903,7
STAT,1842,17,35-39,1859,0.5525620522231208
SIM,1893,24,30-34,1917,36
SIM,1848,25,30-34,1873,31
STAT,1864,69,na,1933,1331.1826475066405
STAT,1876,37,35-39,1913,7.450823307530354
STAT,1822,41,45-49,1863,2.3999715790748457
SIM,1783,93,na,1876,5
SIM,1821,39,30-34,1860,7
SIM,1884,40,35-39,1924,4
STAT,1935,23,na,1958,5069.630880691401
STAT,1860,55,na,1915,1711.4759958379846
SIM,1860,29,50-100,1889,1
STAT,1864,35,20-24,1899,0.7058640002072631
STAT,1891,45,25-29,1936,0.04144542877088913
SIM,1859,46,50-100,1905,1
STAT,1917,22,40-44,1939,3.6467912784927377
SIM,1883,25,25-29,1908,49
STAT,1833,41,20-24,1874,0.1289824316921812
STAT,1867,52,30-34,1919,0.005670596342531
STAT,1842,37,35-39,1879,6.506600925250566
STAT,1884,17,45-49,1901,0.06592886850383917
SIM,1831,48,na,1879,1501
STAT,1864,29,35-39,1893,8.689817476700924
STAT,1844,33,45-49,1877,1.599245591536284
SIM,1878,57,na,1935,2249
STAT,1837,36,na,1873,1756.7474689984094
SIM,1892,17,45-49,1909,2
SIM,1868,28,na,1896,2326
STAT,1889,44,30-34,1933,1.429191733800781
STAT,1852,23,35-39,1875,5.544556119984885
SIM,1925,31,30-34,1956,31
STAT,1881,23,20-24,1904,67.7568180060594
SIM,1860,23,35-39,1883,6
STAT,1936,16,na,1952,3603.044550530068
SIM,1839,38,35-39,1877,10
SIM,1850,37,35-39,1887,8
SIM,1883,29,40-44,1912,1
SIM,1947,23,30-34,1970,50
STAT,1883,83,na,1966,687.0809690708464
SIM,1839,47,50-100,1886,1
SIM,1852,33,45-49,1885,1
STAT,1872,33,50-100,1905,0.9328433400086181
STAT,1946,20,45-49,1966,1.278360810922084
STAT,1903,21,na,1924,3440.064490928513
STAT,1908,44,35-39,1952,0.18764302898324262
STAT,1812,71,na,1883,691.9091826268111
STAT,1833,22,na,1855,1864.2328552744254
STAT,1885,15,40-44,1900,0.18701975678997732
STAT,1872,17,20-24,1889,18.185799972212596
SIM,1841,23,25-29,1864,79
STAT,1849,35,25-29,1884,2.3352960181890294
SIM,1845,16,15-19,1861,4
STAT,1914,47,50-100,1961,0.2288669210297962
STAT,1888,23,15-19,1911,3.9663954735111853
SIM,1939,29,40-44,1968,6
STAT,1836,51,45-49,1887,0.009323248585350026
STAT,1857,48,35-39,1905,0.11013913290273007
SIM,1827,39,25-29,1866,4
SIM,1866,41,25-29,1907,6
STAT,1914,22,15-19,1936,5.548783083169061
STAT,1861,26,35-39,1887,8.252083563468016
SIM,1891,30,25-29,1921,12
STAT,1855,33,20-24,1888,2.1115164631152203
STAT,1922,45,35-39,1967,0.15184267646343458
STAT,1926,2,na,1928,5115.431143930779
STAT,1852,29,50-100,1881,0.5383979255741977
STAT,1847,39,30-34,1886,4.223483711559353
SIM,1896,23,15-19,1919,3
STAT,1853,35,45-49,1888,1.7066124876849262
SIM,1939,18,30-34,1957,15
STAT,1917,0,na,1917,4931.163995169611
SIM,1858,58,na,1916,1589
SIM,1863,33,20-24,1896,6
SIM,1922,22,15-19,1944,5
STAT,1898,46,30-34,1944,0.07554193204396008
STAT,1893,42,30-34,1935,1.4860073046373672
SIM,1877,61,na,1938,1905
STAT,1819,39,25-29,1858,6.86273566886065
STAT,1883,30,25-29,1913,10.334903910145629
STAT,1870,23,45-49,1893,0.693263967158915
STAT,1830,108,na,1938,0.0011587339611943241
STAT,1851,40,30-34,1891,0.9580669439341788
STAT,1902,36,na,1938,3432.603107112115
STAT,1826,51,30-34,1877,0.004581162604688926
STAT,1839,46,20-24,1885,0.00854682138501513
STAT,1833,23,25-29,1856,54.05399512354932
SIM,1809,45,50-100,1854,1
STAT,1916,49,20-24,1965,0.011499272779028806
STAT,1834,39,50-100,1873,1.0065826471616994
STAT,1894,75,na,1969,1764.9671835403285
SIM,1857,35,25-29,1892,3
SIM,1856,43,30-34,1899,1
SIM,1921,2,na,1923,5302
STAT,1878,53,45-49,1931,0.01516274300666596
STAT,1923,31,50-100,1954,0.9710361241903007
SIM,1879,20,na,1899,2839
STAT,1916,9,na,1925,4295.984043990811
STAT,1890,19,35-39,1909,0.6807547080829325
STAT,1850,66,na,1916,1232.871348859455
STAT,1950,12,na,1962,4738.469864765389
SIM,1862,36,45-49,1898,4
STAT,1838,45,20-24,1883,0.009306348504126575
STAT,1854,49,20-24,1903,0.008992495504319794
SIM,1877,72,na,1949,1247
SIM,1891,38,35-39,1929,5
SIM,1891,79,na,1970,1362
STAT,1894,21,40-44,1915,2.7426673328422635
SIM,1866,24,40-44,1890,1
STAT,1895,38,na,1933,3120.277676914551
STAT,1854,36,45-49,1890,1.5330676491178739
STAT,1860,34,40-44,1894,3.5588296730991598
STAT,1848,52,20-24,1900,5.705555568961001E-4
STAT,1890,18,50-100,1908,0.06094926959453602
STAT,1827,30,40-44,1857,7.428365660913606
STAT,1786,81,na,1867,169.72767283502017
SIM,1928,27,15-19,1955,5
STAT,1934,38,na,1972,5289.17531474161
STAT,1883,38,35-39,1921,7.044634368250414
STAT,1900,58,na,1958,2863.307402246294
SIM,1897,35,25-29,1932,7
SIM,1892,31,25-29,1923,16
STAT,1921,20,40-44,1941,3.8984682588003436
STAT,1825,50,30-34,1875,0.007680695095284229
SIM,1886,34,40-44,1920,8
SIM,1835,30,40-44,1865,7
STAT,1835,36,35-39,1871,6.585792988971075
STAT,1850,25,20-24,1875,10.535363672372036
STAT,1871,28,na,1899,2403.15154015151
SIM,1912,0,na,1912,4504
SIM,1844,40,35-39,1884,5
STAT,1829,43,20-24,1872,0.1314678648523313
STAT,1841,52,50-100,1893,0.011091792041903336
STAT,1848,43,30-34,1891,0.8872194756070899
SIM,1963,8,na,1971,5147
STAT,1923,46,35-39,1969,0.1542705765646589
SIM,1825,40,25-29,1865,1
SIM,1855,22,15-19,1877,2
SIM,1779,85,na,1864,35
STAT,1934,34,35-39,1968,12.707619807805866
STAT,1860,95,na,1955,11.004906629628886
SIM,1865,28,35-39,1893,13
STAT,1837,52,45-49,1889,0.009711138415883724
STAT,1888,38,50-100,1926,1.4733383898401071
SIM,1928,30,45-49,1958,3
STAT,1889,35,25-29,1924,3.6626594546264846
SIM,1908,10,na,1918,4184
STAT,1934,6,na,1940,5528.657578159816
STAT,1873,49,30-34,1922,0.09802502736402342
SIM,1880,17,20-24,1897,27
SIM,1843,36,35-39,1879,14
STAT,1896,34,20-24,1930,3.6107943755446823
STAT,1878,34,40-44,1912,4.565565017148246
SIM,1949,18,45-49,1967,1
SIM,1822,34,na,1856,1610
SIM,1847,66,na,1913,1154
SIM,1932,24,na,1956,4960
STAT,1884,46,na,1930,2277.1721872798585
STAT,1774,107,na,1881,0.005715389218153202
SIM,1910,20,30-34,1930,36
SIM,1860,44,35-39,1904,3
STAT,1931,5,na,1936,5367.303840146323
STAT,1857,28,35-39,1885,7.861374944773607
STAT,1881,50,45-49,1931,0.014518953683477625
STAT,1915,46,na,1961,3787.018295419531
SIM,1768,93,na,1861,4
SIM,1923,23,15-19,1946,8
SIM,1919,17,20-24,1936,143
STAT,1899,25,40-44,1924,4.213102459337734
STAT,1915,23,15-19,1938,5.597668427333254
STAT,1873,41,20-24,1914,0.1649955147197456
SIM,1898,36,25-29,1934,8
STAT,1828,54,50-100,1882,0.00997748846042352
STAT,1871,16,20-24,1887,18.13765084008194
STAT,1806,50,20-24,1856,0.0025030454952269117
STAT,1836,40,35-39,1876,1.3757440504235308
STAT,1902,20,30-34,1922,25.778457686756294
STAT,1915,44,50-100,1959,0.1202922317403693
SIM,1919,13,na,1932,4526
SIM,1819,43,40-44,1862,5
SIM,1890,15,15-19,1905,9
STAT,1846,26,45-49,1872,0.9674926491088542
SIM,1920,21,na,1941,3959
SIM,1875,92,na,1967,135
SIM,1845,31,45-49,1876,2
STAT,1821,83,na,1904,209.18802963817186
STAT,1835,43,45-49,1878,1.3196587650688434
SIM,1922,22,na,1944,4214
SIM,1834,70,na,1904,1024
SIM,1942,22,40-44,1964,7
STAT,1834,27,50-100,1861,0.5644859272567391
SIM,1860,20,30-34,1880,18
STAT,1831,28,na,1859,1911.794002844596
STAT,1925,44,35-39,1969,0.24790129597157884
SIM,1841,46,45-49,1887,1
STAT,1850,32,30-34,1882,13.738731134428795
STAT,1875,45,40-44,1920,0.18103525184437064
STAT,1946,18,20-24,1964,153.3712495768346
STAT,1849,26,na,1875,2005.2611599903187
STAT,1946,21,20-24,1967,126.28795784153687
STAT,1852,40,40-44,1892,1.830304241259201
STAT,1904,62,na,1966,2916.537805671905
SIM,1851,42,25-29,1893,4
SIM,1848,29,25-29,1877,54
STAT,1845,33,50-100,1878,0.8424219056186124
SIM,1818,42,40-44,1860,4
STAT,1888,26,50-100,1914,0.7741294663448824
STAT,1921,46,30-34,1967,0.10280414885979747
STAT,1849,30,25-29,1879,9.40133280152993
SIM,1865,26,20-24,1891,14
SIM,1918,33,50-100,1951,1
STAT,1906,16,50-100,1922,0.07292404643633882
STAT,1813,88,na,1901,59.03569843037771
SIM,1884,3,na,1887,3121
STAT,1929,29,50-100,1958,1.2692912763310933
STAT,1929,24,25-29,1953,118.39218751912875
SIM,1904,45,50-100,1949,1
STAT,1782,85,na,1867,81.97232634518244
STAT,1859,21,50-100,1880,0.3815338616047322
STAT,1873,48,40-44,1921,0.17483871901435918
SIM,1854,26,45-49,1880,3
STAT,1822,45,30-34,1867,0.14213189112415406
STAT,1887,65,na,1952,1931.8525748770348
SIM,1867,97,na,1964,8
STAT,1898,27,20-24,1925,16.184152058250245
SIM,1836,22,35-39,1858,5
STAT,1837,31,45-49,1868,1.4729661554935507
STAT,1853,16,35-39,1869,0.5567398026747303
SIM,1849,31,50-100,1880,3
STAT,1874,38,50-100,1912,1.272427329028407
SIM,1843,43,45-49,1886,3
SIM,1897,32,20-24,1929,4
STAT,1793,108,na,1901,3.6692285904497176E-4
STAT,1908,32,40-44,1940,3.7667121349856414
SIM,1938,33,30-34,1971,17
STAT,1889,32,20-24,1921,3.406242255912783
SIM,1928,15,15-19,1943,57
SIM,1869,98,na,1967,29
STAT,1908,52,na,1960,3330.975571421998
SIM,1855,50,45-49,1905,1
SIM,1852,32,na,1884,2086
STAT,1863,23,40-44,1886,1.8873619897704164
SIM,1871,23,40-44,1894,2
STAT,1917,22,50-100,1939,0.7136578363621604
SIM,1825,34,na,1859,1678
SIM,1922,32,25-29,1954,11
STAT,1903,29,50-100,1932,0.9210291376418722
STAT,1878,80,na,1958,770.9757008726248
STAT,1885,44,50-100,1929,1.060720683695818
STAT,1852,97,na,1949,4.3278871862421315
STAT,1877,33,na,1910,2514.267057366079
STAT,1857,21,na,1878,1980.7997026171315
STAT,1899,32,50-100,1931,1.2799672739713732
SIM,1908,29,20-24,1937,21
STAT,1905,32,15-19,1937,0.12047610845490749
SIM,1846,39,50-100,1885,5
STAT,1846,43,20-24,1889,0.1134822946508622
STAT,1807,70,na,1877,816.618599427396
STAT,1899,44,50-100,1943,0.10110139969430518
STAT,1827,49,25-29,1876,0.0629668526303633
SIM,1924,37,na,1961,4540
SIM,1859,43,40-44,1902,1
STAT,1837,33,40-44,1870,3.5878345804904876
STAT,1857,26,20-24,1883,9.696837815316705
STAT,1914,32,25-29,1946,9.492409587134244
STAT,1889,16,15-19,1905,7.49675339764735
STAT,1847,11,na,1858,2334.0552281893247
SIM,1937,24,25-29,1961,137
STAT,1861,33,45-49,1894,1.4637833821654176
STAT,1859,34,30-34,1893,14.102906872126027
STAT,1914,43,20-24,1957,0.017826234835750576
SIM,1894,65,na,1959,2346
STAT,1858,25,25-29,1883,35.54163136352556
SIM,1845,33,40-44,1878,10
STAT,1911,39,25-29,1950,0.9602926672842643
SIM,1877,23,35-39,1900,10
STAT,1929,8,na,1937,5191.540984868305
STAT,1845,45,50-100,1890,0.19381195775124893
STAT,1870,27,50-100,1897,0.6379413570890912
STAT,1889,3,na,1892,3331.3681050902455
STAT,1844,46,20-24,1890,0.009325338389454553
SIM,1897,16,15-19,1913,14
STAT,1845,10,na,1855,2387.0647799999997
STAT,1852,20,30-34,1872,17.294110574229745
STAT,1863,21,45-49,1884,0.6407511512069967
STAT,1910,27,15-19,1937,0.6952798957502042
STAT,1831,38,35-39,1869,6.147457399331313
STAT,1912,35,25-29,1947,0.989642319505182
SIM,1943,21,45-49,1964,1
SIM,1849,41,30-34,1890,2
STAT,1920,40,40-44,1960,0.2826914444189215
STAT,1934,22,40-44,1956,4.608082629586388
SIM,1932,32,na,1964,5223
STAT,1827,36,50-100,1863,1.6370193914024287
STAT,1904,29,40-44,1933,4.348409000581994
STAT,1887,27,45-49,1914,1.2692245695937379
STAT,1877,53,35-39,1930,0.008962867923166983
STAT,1930,33,20-24,1963,3.2085233582258885
STAT,1952,15,40-44,1967,1.7107880989757422
SIM,1876,24,30-34,1900,23
STAT,1927,25,na,1952,4677.191545811963
STAT,1930,39,35-39,1969,3.210909286966486
SIM,1841,20,20-24,1861,51
SIM,1866,25,25-29,1891,46
SIM,1914,27,na,1941,3829
STAT,1925,41,50-100,1966,0.14532086476374856
SIM,1907,21,35-39,1928,18
STAT,1894,13,na,1907,3383.56283751859
SIM,1928,27,na,1955,4814
STAT,1875,20,25-29,1895,60.29438219782272
SIM,1869,66,na,1935,1537
STAT,1870,50,50-100,1920,0.015277847485063641
SIM,1943,18,45-49,1961,1
STAT,1856,29,50-100,1885,0.5232315256508377
STAT,1841,54,25-29,1895,0.0025433368818666147
STAT,1935,18,45-49,1953,0.6946005165589796
STAT,1843,42,25-29,1885,0.5337473312284661
STAT,1845,101,na,1946,0.44585499937699474
STAT,1903,43,45-49,1946,0.1496265374546191
STAT,1860,102,na,1962,0.7718149803945731
STAT,1935,21,45-49,1956,1.5630592006293536
STAT,1833,46,45-49,1879,0.18522012725744674
STAT,1813,48,50-100,1861,0.6069891258725277
SIM,1836,71,na,1907,995
SIM,1912,29,40-44,1941,8
STAT,1877,3,na,1880,3243.682038185697
STAT,1920,5,na,1925,4603.532335085557
SIM,1932,17,30-34,1949,19
STAT,1857,13,na,1870,2225.306159766062
STAT,1899,23,20-24,1922,95.97119565502554
SIM,1835,23,30-34,1858,20
STAT,1864,15,na,1879,2395.101864466969
SIM,1882,62,na,1944,1719
STAT,1858,41,30-34,1899,0.9342988570471852
STAT,1796,99,na,1895,0.4119963638016858
STAT,1907,42,35-39,1949,0.1881223331525764
SIM,1911,40,40-44,1951,1
SIM,1875,60,na,1935,1907
STAT,1853,39,25-29,1892,2.3899051715993718
STAT,1883,16,20-24,1899,17.789230797553017
SIM,1852,23,30-34,1875,19
STAT,1854,70,na,1924,1073.8493213939325
STAT,1872,10,na,1882,2724.7174150194573
SIM,1822,32,20-24,1854,3
STAT,1909,28,45-49,1937,1.6779425930879368
SIM,1915,17,30-34,1932,3
STAT,1832,47,40-44,1879,0.13591481932176594
STAT,1871,32,35-39,1903,10.23364963736121
STAT,1924,42,35-39,1966,0.24436946916637262
STAT,1780,76,na,1856,326.7904460355
STAT,1858,60,na,1918,1542.9229832677888
STAT,1834,44,40-44,1878,1.7786254631041711
STAT,1871,52,45-49,1923,0.014587081704172644
SIM,1934,19,20-24,1953,191
STAT,1926,19,20-24,1945,168.66339308570676
STAT,1868,27,35-39,1895,9.401600837540485
STAT,1858,50,20-24,1908,6.05561331687863E-4
SIM,1836,28,na,1864,2039
SIM,1816,73,na,1889,643
SIM,1918,49,na,1967,4079
SIM,1861,92,na,1953,4
STAT,1915,42,25-29,1957,0.0733629036086653
STAT,1935,20,na,1955,5074.805424002759
STAT,1909,31,45-49,1940,1.5377101352043319
SIM,1873,15,15-19,1888,7
SIM,1895,27,45-49,1922,2
STAT,1907,17,30-34,1924,2.38743625637608
SIM,1917,28,45-49,1945,3
SIM,1921,49,50-100,1970,1
STAT,1885,84,na,1969,666.3576234742147
STAT,1841,20,na,1861,2028.9195586156438
STAT,1865,15,15-19,1880,6.296269404506179
SIM,1855,29,50-100,1884,4
SIM,1828,36,45-49,1864,1
SIM,1880,39,35-39,1919,6
STAT,1904,43,20-24,1947,0.016007627664673865
STAT,1812,49,na,1861,1361.515028504161
STAT,1915,32,na,1947,3930.628331448755
STAT,1839,25,15-19,1864,0.4001875351504245
STAT,1859,44,45-49,1903,1.2028764122359707
STAT,1932,26,na,1958,5006.186985286709
STAT,1854,78,na,1932,597.9965935805988
STAT,1821,41,35-39,1862,3.2453710501375808
STAT,1848,31,20-24,1879,2.475922409832725
STAT,1878,82,na,1960,665.1309119404307
STAT,1875,50,20-24,1925,7.837121823986664E-4
SIM,1898,31,25-29,1929,21
STAT,1803,64,na,1867,970.2004749732591
STAT,1929,38,na,1967,4921.38035612097
STAT,1817,105,na,1922,0.014309441327248255
STAT,1865,43,30-34,1908,1.0567914964659475
STAT,1924,17,30-34,1941,14.80878514336017
SIM,1827,65,na,1892,955
SIM,1867,44,45-49,1911,3
SIM,1873,43,30-34,1916,5
STAT,1872,39,35-39,1911,7.1587821536058
SIM,1878,35,na,1913,2635
STAT,1791,68,na,1859,638.2040409237839
SIM,1882,40,na,1922,2239
SIM,1873,27,50-100,1900,1
STAT,1881,43,15-19,1924,0.013521932705927237
SIM,1927,19,15-19,1946,64
STAT,1874,33,30-34,1907,18.108633329043375
SIM,1869,37,45-49,1906,2
STAT,1821,85,na,1906,144.45219119101247
SIM,1887,4,na,1891,3083
STAT,1861,50,35-39,1911,0.007361451971760405
SIM,1887,18,na,1905,2967
STAT,1809,53,45-49,1862,0.06041917130777545
STAT,1954,7,na,1961,4956.3427221921
SIM,1857,30,25-29,1887,3
STAT,1859,15,30-34,1874,1.5252582647227835
SIM,1929,24,20-24,1953,161
SIM,1876,0,na,1876,3870
SIM,1837,30,50-100,1867,1
SIM,1916,32,40-44,1948,7
STAT,1899,21,25-29,1920,80.21182240210649
STAT,1870,94,na,1964,57.97466489001624
SIM,1827,43,na,1870,1531
SIM,1901,33,35-39,1934,28
SIM,1815,42,30-34,1857,4
SIM,1872,3,na,1875,3068
SIM,1931,39,na,1970,4924
STAT,1860,51,30-34,1911,0.004950583945839747
SIM,1829,91,na,1920,2
STAT,1824,42,30-34,1866,1.4165453505687684
SIM,1910,43,na,1953,3524
STAT,1857,35,na,1892,1894.8781042807718
SIM,1892,64,na,1956,2471
STAT,1923,41,na,1964,4435.348949261323
SIM,1903,33,na,1936,3380
SIM,1766,89,na,1855,12
SIM,1856,31,20-24,1887,5
STAT,1933,32,35-39,1965,12.559218686966945
SIM,1816,51,na,1867,1428
SIM,1906,27,30-34,1933,42
SIM,1891,29,50-100,1920,2
STAT,1891,33,30-34,1924,21.958529383564066
STAT,1820,58,na,1878,1167.2786515879673
STAT,1876,44,45-49,1920,1.5553235372429317
STAT,1808,54,40-44,1862,0.024090070649184357
STAT,1904,49,35-39,1953,0.11305101086997615
STAT,1919,19,15-19,1938,50.90443237523031
STAT,1891,0,na,1891,3708.5869457303643
SIM,1863,39,35-39,1902,13
SIM,1882,33,30-34,1915,2
STAT,1868,30,35-39,1898,9.946798698601786
STAT,1819,40,50-100,1859,2.4157211207132776
STAT,1884,15,25-29,1899,5.745903340627834
SIM,1898,55,na,1953,3147
STAT,1910,33,35-39,1943,8.948899728932373
SIM,1870,42,35-39,1912,3
STAT,1854,56,na,1910,1561.0433118315905
STAT,1855,110,na,1965,0.00134440007614295
STAT,1908,16,35-39,1924,0.8320428810627324
SIM,1849,78,na,1927,819
SIM,1857,87,na,1944,88
SIM,1884,44,45-49,1928,3
SIM,1832,42,30-34,1874,1
STAT,1838,42,50-100,1880,0.9077822764742198
SIM,1907,57,na,1964,3259
STAT,1885,47,20-24,1932,0.01215640675079525
SIM,1831,45,50-100,1876,1
STAT,1862,42,35-39,1904,1.5705747271504098
STAT,1867,31,30-34,1898,16.790060534943137
SIM,1770,94,na,1864,3
STAT,1848,15,15-19,1863,5.786614457724437
SIM,1867,15,30-34,1882,1
STAT,1923,43,30-34,1966,0.1522187078325602
SIM,1916,16,35-39,1932,2
STAT,1803,86,na,1889,84.47337665726806
STAT,1938,30,50-100,1968,0.8490066396619351
STAT,1884,40,20-24,1924,0.1619045878803648
STAT,1844,23,30-34,1867,17.11013220837767
SIM,1877,10,na,1887,2722
SIM,1911,30,na,1941,3829
STAT,1883,37,45-49,1920,1.995411291286569
STAT,1810,91,na,1901,24.705085896989
SIM,1822,38,35-39,1860,12
STAT,1881,29,35-39,1910,9.448503736550215
STAT,1905,42,25-29,1947,0.06561952675618361
STAT,1936,24,50-100,1960,0.6411845548024457
SIM,1909,38,na,1947,3419
STAT,1850,35,35-39,1885,5.517947352949755
STAT,1927,24,50-100,1951,0.821784792781243
SIM,1854,23,40-44,1877,3
SIM,1851,17,na,1868,2270
STAT,1863,26,45-49,1889,1.0002946558129908
SIM,1942,25,45-49,1967,5
SIM,1847,63,na,1910,1265
STAT,1834,58,na,1892,1328.980196192187
STAT,1855,1,na,1856,2926.9657212918723
STAT,1896,17,45-49,1913,0.08801250219733976
STAT,1905,22,na,1927,3484.53150242194
STAT,1894,23,50-100,1917,0.5334565107065835
SIM,1948,22,35-39,1970,10
STAT,1898,42,15-19,1940,0.0013213383926629174
SIM,1779,88,na,1867,14
STAT,1950,22,25-29,1972,111.79214452671609
SIM,1880,81,na,1961,516
STAT,1829,26,45-49,1855,2.152607903639784
STAT,1925,38,15-19,1963,0.023491154813546664
STAT,1793,106,na,1899,0.0024321702022373315
STAT,1846,23,40-44,1869,1.8254709578733992
STAT,1890,31,na,1921,2988.6977341490356
STAT,1820,49,15-19,1869,7.085534312966706E-4
STAT,1864,19,15-19,1883,5.5033181198594425
STAT,1868,47,20-24,1915,0.011637898034913705
STAT,1867,22,50-100,1889,0.3921627224915408
SIM,1880,33,20-24,1913,3
SIM,1928,41,na,1969,4983
SIM,1937,21,20-24,1958,159
SIM,1849,44,na,1893,1811
STAT,1825,54,40-44,1879,0.012546600647276394
STAT,1921,29,40-44,1950,5.263028251216992
STAT,1864,22,15-19,1886,3.040607999897345
STAT,1912,33,45-49,1945,1.5728822189275762
SIM,1819,56,na,1875,1235
SIM,1849,46,na,1895,1801
STAT,1869,23,35-39,1892,5.72965401573416
STAT,1898,57,na,1955,2772.391314864948
SIM,1878,89,na,1967,218
STAT,1816,46,45-49,1862,0.4932321886262757
STAT,1925,16,35-39,1941,5.184258156632473
SIM,1872,19,15-19,1891,9
STAT,1894,33,40-44,1927,5.666703532018499
SIM,1891,37,45-49,1928,4
STAT,1857,29,25-29,1886,34.21723378547425
STAT,1929,21,20-24,1950,143.85180464474556
STAT,1892,45,40-44,1937,0.12470303680865105
STAT,1942,9,na,1951,4213.642075510309
STAT,1868,43,40-44,1911,2.17578915935214
SIM,1882,21,20-24,1903,63
STAT,1859,40,35-39,1899,1.4901833621699325
SIM,1937,18,20-24,1955,170
STAT,1931,35,35-39,1966,3.2725878467745235
STAT,1929,18,20-24,1947,176.01027861695172
STAT,1859,37,35-39,1896,5.76241495338882
STAT,1901,40,30-34,1941,0.11504061105132268
STAT,1934,25,45-49,1959,2.372141986377786
STAT,1836,59,na,1895,1209.6792952983553
STAT,1870,53,40-44,1923,0.010330262126381096
SIM,1824,46,45-49,1870,1
SIM,1865,29,25-29,1894,43
SIM,1900,21,25-29,1921,117
SIM,1898,23,na,1921,3602
SIM,1872,86,na,1958,154
STAT,1865,101,na,1966,2.714119738392212
STAT,1937,35,na,1972,3844.0079716143878
SIM,1854,47,na,1901,1928
STAT,1865,64,na,1929,1609.5509736142367
STAT,1880,47,50-100,1927,0.2620629987388268
SIM,1903,39,40-44,1942,4
STAT,1931,32,25-29,1963,12.351381713505738
SIM,1874,11,na,1885,2703
STAT,1872,33,20-24,1905,2.7520246495149947
SIM,1908,49,50-100,1957,2
STAT,1830,46,50-100,1876,0.2064890999570651
STAT,1918,21,45-49,1939,1.2421168525715502
SIM,1879,76,na,1955,1200
STAT,1816,53,na,1869,1199.771586219968
SIM,1839,39,25-29,1878,8
SIM,1856,48,na,1904,2160
STAT,1914,46,25-29,1960,0.0538090758171359
SIM,1866,22,20-24,1888,72
SIM,1773,83,na,1856,61
SIM,1920,33,45-49,1953,2
SIM,1962,9,na,1971,5404
SIM,1846,89,na,1935,34
STAT,1837,36,45-49,1873,1.635136516991781
STAT,1952,18,45-49,1970,0.610476401175271
SIM,1884,33,50-100,1917,1
SIM,1859,30,35-39,1889,6
STAT,1831,42,na,1873,1726.7093719436175
STAT,1818,62,na,1880,1048.2999293939852
STAT,1842,30,15-19,1872,0.13773928041756248
STAT,1838,29,20-24,1867,10.807787128470508
STAT,1865,31,20-24,1896,2.512997640198905
SIM,1809,46,na,1855,1140
SIM,1846,29,20-24,1875,1
STAT,1906,16,25-29,1922,8.434883073534152
SIM,1856,36,20-24,1892,4
STAT,1822,48,35-39,1870,0.19671469250591142
SIM,1861,78,na,1939,659
STAT,1832,77,na,1909,577.6109911474543
SIM,1841,40,na,1881,1832
STAT,1908,35,45-49,1943,0.6570387598131724
SIM,1892,15,25-29,1907,11
SIM,1850,36,45-49,1886,2
STAT,1868,15,40-44,1883,0.18359791004586593
STAT,1918,18,45-49,1936,0.5534012113662724
STAT,1884,20,50-100,1904,0.4140314651148447
STAT,1935,15,40-44,1950,1.959050837545194
SIM,1848,26,20-24,1874,16
SIM,1888,26,15-19,1914,5
SIM,1861,32,40-44,1893,11
SIM,1922,46,25-29,1968,1
STAT,1946,24,25-29,1970,104.80149113807613
STAT,1850,54,40-44,1904,0.007701182940278316
STAT,1840,42,15-19,1882,0.010366287427598339
STAT,1941,17,30-34,1958,12.808387144997413
SIM,1837,26,45-49,1863,1
STAT,1889,74,na,1963,1664.28309132128
SIM,1785,70,na,1855,542
SIM,1896,14,na,1910,3515
STAT,1851,44,40-44,1895,1.8306433083809512
SIM,1830,88,na,1918,106
STAT,1858,22,20-24,1880,63.96610707829839
STAT,1831,35,30-34,1866,4.801654147902597
SIM,1811,50,na,1861,1154
STAT,1915,54,na,1969,3679.04724205503
SIM,1834,45,na,1879,1659
SIM,1844,39,25-29,1883,2
STAT,1924,32,25-29,1956,11.00154412197106
STAT,1926,40,35-39,1966,0.253950352343881
SIM,1845,62,na,1907,1401
STAT,1848,36,20-24,1884,0.6239392362205141
SIM,1917,19,20-24,1936,157
SIM,1866,16,na,1882,2621
SIM,1864,35,na,1899,2173
STAT,1841,52,na,1893,1581.333800625256
STAT,1921,36,50-100,1957,0.47881856913089377
STAT,1839,48,na,1887,1561.8777191998252
SIM,1902,20,45-49,1922,1
STAT,1844,49,25-29,1893,0.04370295285879086
STAT,1853,32,40-44,1885,3.7446678821474335
SIM,1932,32,25-29,1964,23
SIM,1845,36,45-49,1881,2
STAT,1870,16,35-39,1886,0.555692889924398
STAT,1849,77,na,1926,671.0799524236847
STAT,1931,22,15-19,1953,7.041155725318645
SIM,1917,25,40-44,1942,10
STAT,1895,52,na,1947,2850.711287917663
SIM,1841,58,na,1899,1480
STAT,1830,39,30-34,1869,4.67876596903972
STAT,1870,7,na,1877,2738.3134414313918
STAT,1948,18,30-34,1966,14.227024341901974
STAT,1844,17,na,1861,2261.11456494182
SIM,1871,70,na,1941,1351
SIM,1872,19,20-24,1891,33
SIM,1852,26,35-39,1878,14
STAT,1832,106,na,1938,0.008113416519803244
STAT,1889,37,20-24,1926,0.9713803145811815
SIM,1897,37,20-24,1934,2
STAT,1831,32,20-24,1863,2.475542809528541
STAT,1940,21,na,1961,3796.3489719425284
STAT,1844,26,35-39,1870,9.21938437223502
STAT,1905,45,35-39,1950,0.11751244877148087
STAT,1917,8,na,1925,4365.57213740345
STAT,1902,46,20-24,1948,0.009765839366986629
SIM,1864,40,45-49,1904,1
SIM,1791,88,na,1879,24
SIM,1867,41,40-44,1908,2
STAT,1829,71,na,1900,887.7543213139664
STAT,1806,75,na,1881,442.61146804751075
STAT,1867,19,40-44,1886,0.1769750656508433
SIM,1854,46,30-34,1900,1
STAT,1858,53,25-29,1911,0.0028195066662721493
STAT,1947,17,25-29,1964,49.805145173147345
SIM,1895,24,40-44,1919,2
STAT,1839,53,30-34,1892,0.004042161003858173
SIM,1901,30,30-34,1931,35
SIM,1875,31,30-34,1906,6
STAT,1850,40,15-19,1890,0.01049263740008424
STAT,1891,36,35-39,1927,8.976080661019147
SIM,1885,17,35-39,1902,1
STAT,1892,12,na,1904,3301.897738127141
STAT,1842,50,25-29,1892,0.0028175790039741576
SIM,1823,53,na,1876,1366
SIM,1828,33,40-44,1861,9
SIM,1863,59,na,1922,1615
SIM,1916,35,45-49,1951,2
STAT,1914,48,40-44,1962,0.15909238966575484
SIM,1858,29,na,1887,1998
SIM,1854,98,na,1952,6
STAT,1867,51,40-44,1918,0.010130905463116627
STAT,1875,40,na,1915,2444.310246435337
SIM,1832,45,35-39,1877,1
SIM,1872,30,na,1902,2483
SIM,1890,30,45-49,1920,2
STAT,1915,22,30-34,1937,30.316937499650045
SIM,1913,11,na,1924,4255
STAT,1899,26,25-29,1925,59.29659751921324
SIM,1935,24,15-19,1959,6
STAT,1840,28,35-39,1868,8.595183007334155
STAT,1887,24,40-44,1911,2.3671592753940964
SIM,1844,23,na,1867,2282
STAT,1809,51,na,1860,1525.953224949196
STAT,1927,24,15-19,1951,6.648238208234273
STAT,1802,53,35-39,1855,0.022358966973536325
STAT,1937,31,20-24,1968,2.4629423343058376
SIM,1885,20,35-39,1905,9
STAT,1890,40,45-49,1930,1.8856512925492437
STAT,1824,45,35-39,1869,0.16762817630811064
STAT,1840,56,na,1896,1467.7164527814084
SIM,1923,22,30-34,1945,58
STAT,1848,92,na,1940,32.375468479022835
SIM,1899,16,25-29,1915,8
STAT,1827,45,na,1872,1675.0999931316644
STAT,1829,49,35-39,1878,0.11041829067387186
STAT,1937,28,20-24,1965,18.141376394208613
STAT,1918,40,45-49,1958,0.18107587187499707
STAT,1818,36,35-39,1854,29.692763217909864
SIM,1929,27,25-29,1956,132
SIM,1799,76,na,1875,470
STAT,1880,53,na,1933,2271.1979442662973
STAT,1857,47,45-49,1904,0.18714907313215426
SIM,1876,43,40-44,1919,7
SIM,1834,30,30-34,1864,2
SIM,1906,23,15-19,1929,5
STAT,1827,42,40-44,1869,2.6655212846665965
STAT,1893,21,30-34,1914,23.121298333242926
STAT,1836,52,35-39,1888,0.005422282868926891
STAT,1818,45,50-100,1863,0.5755034130535546
STAT,1855,16,45-49,1871,0.06058557211970844
STAT,1872,36,30-34,1908,5.475345261014839
STAT,1833,25,20-24,1858,10.576859322932055
STAT,1865,52,20-24,1917,6.796044015790012E-4
STAT,1824,40,na,1864,1553.0171309457955
SIM,1819,41,45-49,1860,4
STAT,1878,32,45-49,1910,1.8516971766445691
STAT,1956,14,na,1970,5299.289571837536
STAT,1884,43,25-29,1927,0.643436069928888
STAT,1775,97,na,1872,0.8654691169297857
STAT,1898,35,na,1933,3281.0614986439327
SIM,1841,25,20-24,1866,2
STAT,1914,35,50-100,1949,0.4317672558852754
SIM,1935,21,na,1956,5065
STAT,1816,40,50-100,1856,2.6994381964909793
STAT,1887,44,20-24,1931,0.17909396952153853
SIM,1922,35,50-100,1957,3
STAT,1864,50,45-49,1914,0.013353125635547509
STAT,1865,46,35-39,1911,0.12999442975606731
STAT,1817,52,25-29,1869,0.007586767357351724
SIM,1889,27,20-24,1916,15
SIM,1869,34,40-44,1903,6
STAT,1852,46,na,1898,1817.6213686898748
SIM,1900,31,35-39,1931,23
STAT,1872,75,na,1947,1052.5525527492468
STAT,1933,21,35-39,1954,12.775742767074068
SIM,1886,32,45-49,1918,6
STAT,1910,40,50-100,1950,0.11452277976078512
SIM,1823,75,na,1898,567
SIM,1837,18,15-19,1855,6
STAT,1826,30,30-34,1856,22.534423119723485
SIM,1854,76,na,1930,827
STAT,1909,25,40-44,1934,4.612675597752802
SIM,1873,18,na,1891,2535
STAT,1887,43,na,1930,2622.969720177845
STAT,1835,32,na,1867,2055.6742237289864
STAT,1945,22,na,1967,4083.419234402193
STAT,1851,42,50-100,1893,0.8705180974217703
STAT,1862,46,15-19,1908,3.483459393714044E-4
STAT,1822,99,na,1921,1.1011776305418788
STAT,1837,98,na,1935,2.1658886669231188
STAT,1848,19,30-34,1867,1.5178442609175498
SIM,1852,10,na,1862,2522
SIM,1837,49,35-39,1886,1
STAT,1829,89,na,1918,69.86939993777455
SIM,1879,23,45-49,1902,1
STAT,1842,103,na,1945,0.11254514024734175
SIM,1880,36,30-34,1916,3
SIM,1939,17,40-44,1956,7
STAT,1883,31,15-19,1914,0.143127689172735
STAT,1838,32,15-19,1870,0.13001893404265075
SIM,1891,31,15-19,1922,4
STAT,1862,31,50-100,1893,0.7989192693644132
STAT,1869,18,50-100,1887,0.04863254919251856
STAT,1893,41,40-44,1934,2.9240634729280877
STAT,1838,29,15-19,1867,0.417980721027031
SIM,1893,31,40-44,1924,10
STAT,1816,40,15-19,1856,0.03528677638886868
SIM,1826,40,40-44,1866,2
SIM,1915,20,na,1935,4489
STAT,1883,51,25-29,1934,0.0035623960242403487
SIM,1840,40,50-100,1880,1
STAT,1864,19,20-24,1883,16.440292083639836
SIM,1856,19,30-34,1875,5
STAT,1826,50,40-44,1876,0.008264503624354588
STAT,1916,39,50-100,1955,0.43434551386939385
SIM,1852,64,na,1916,1455
STAT,1844,49,na,1893,1707.0258013844266
STAT,1856,41,20-24,1897,0.12775348222326577
STAT,1887,11,na,1898,2956.557675628049
STAT,1910,23,na,1933,3643.8073807417045
STAT,1935,30,35-39,1965,12.90779705188243
SIM,1925,11,na,1936,5034
SIM,1831,81,na,1912,436
SIM,1906,29,50-100,1935,2
STAT,1899,45,35-39,1944,0.11142086812659657
STAT,1810,99,na,1909,0.8074186425766193
STAT,1936,35,20-24,1971,0.26440922668528566
STAT,1904,32,50-100,1936,0.7692048621212295
STAT,1927,45,50-100,1972,0.2909758270621563
STAT,1866,37,45-49,1903,1.8758115509903563
STAT,1922,42,25-29,1964,0.08363217009816203
SIM,1861,40,35-39,1901,5
STAT,1928,21,na,1949,4664.765200158732
SIM,1937,29,50-100,1966,1
STAT,1912,30,40-44,1942,3.9597575976772936
SIM,1862,44,50-100,1906,3
STAT,1863,43,20-24,1906,0.14102444815563916
SIM,1891,19,25-29,1910,1
STAT,1863,81,na,1944,483.68774318124
SIM,1903,19,na,1922,3640
STAT,1872,48,25-29,1920,0.0581519680720012
SIM,1825,87,na,1912,93
SIM,1837,23,40-44,1860,3
STAT,1850,31,na,1881,1897.3439265495633
STAT,1867,96,na,1963,23.450646028225023
STAT,1901,43,35-39,1944,0.1780916591260189
STAT,1800,81,na,1881,255.1419544483106
STAT,1905,23,25-29,1928,84.08189222414202
SIM,1874,37,45-49,1911,1
STAT,1842,54,40-44,1896,0.008028801313991777
STAT,1832,91,na,1923,38.72235075397137
STAT,1872,54,50-100,1926,0.01501686787898595
SIM,1865,31,na,1896,2312
STAT,1892,20,25-29,1912,73.62876269142038
SIM,1880,48,25-29,1928,1
SIM,1792,72,na,1864,473
STAT,1859,18,35-39,1877,0.515865122465312
STAT,1829,57,na,1886,1368.9820343719896
STAT,1881,26,30-34,1907,24.921570453278754
STAT,1797,106,na,1903,0.0030574654911736756
SIM,1901,24,45-49,1925,1
STAT,1911,48,30-34,1959,0.08584591032365864
STAT,1870,47,20-24,1917,0.011911361344153455
SIM,1850,86,na,1936,151
STAT,1841,37,40-44,1878,3.808097376539083
STAT,1853,52,35-39,1905,0.007180256057091597
SIM,1822,35,30-34,1857,3
STAT,1910,21,40-44,1931,3.230178048461006
STAT,1868,18,45-49,1886,0.06441884349593457
SIM,1801,74,na,1875,512
STAT,1865,96,na,1961,17.913705683487994
SIM,1882,38,50-100,1920,3
STAT,1918,15,40-44,1933,0.3131445343987492
STAT,1856,0,na,1856,3186.280964303872
STAT,1845,41,45-49,1886,1.2061713929870082
STAT,1876,59,na,1935,2047.302241386523
SIM,1803,84,na,1887,25
SIM,1852,42,40-44,1894,6
SIM,1835,94,na,1929,15
STAT,1962,1,na,1963,5144.892907302032
STAT,1865,19,na,1884,2381.4432423262397
SIM,1937,21,na,1958,4156
SIM,1856,39,25-29,1895,1
STAT,1849,51,25-29,1900,0.00276303615948163
STAT,1768,95,na,1863,3.319528152456713
STAT,1878,69,na,1947,1558.327423734507
STAT,1925,35,45-49,1960,0.8362250688973341
SIM,1807,77,na,1884,250
SIM,1832,30,20-24,1862,5
STAT,1933,7,na,1940,5457.051676664936
STAT,1876,56,na,1932,2148.610405187739
STAT,1808,87,na,1895,58.6522832024957
STAT,1860,42,25-29,1902,0.5308681400390998
STAT,1793,91,na,1884,20.445399274695056
STAT,1878,37,na,1915,2501.7208125920797
STAT,1866,49,na,1915,2072.831050216641
SIM,1788,68,na,1856,819
SIM,1914,32,30-34,1946,18
STAT,1860,49,45-49,1909,0.19126200245361155
STAT,1843,33,35-39,1876,9.726762697811006
STAT,1859,41,40-44,1900,1.8408103958815236
SIM,1859,22,na,1881,2261
STAT,1909,40,35-39,1949,0.19426494424262236
SIM,1829,29,20-24,1858,10
SIM,1871,56,na,1927,1882
STAT,1844,42,40-44,1886,1.7851120157582538
STAT,1920,46,15-19,1966,4.165801578173142E-4
STAT,1813,51,45-49,1864,0.035535902511896394
STAT,1860,30,30-34,1890,14.567821468535278
STAT,1891,21,20-24,1912,87.29910805124709
STAT,1841,45,35-39,1886,0.10653305531299943
STAT,1879,33,15-19,1912,0.15121629816057597
SIM,1763,92,na,1855,10
STAT,1880,42,45-49,1922,1.6024672589179823
SIM,1850,54,na,1904,1562
STAT,1821,45,15-19,1866,6.493814909096314E-4
STAT,1821,51,na,1872,1292.6211597899148
STAT,1921,43,20-24,1964,0.020265711424208833
STAT,1853,36,20-24,1889,0.6531023265716283
STAT,1848,39,25-29,1887,2.258997092173597
STAT,1824,30,20-24,1854,7.641856754987089
STAT,1856,53,30-34,1909,0.004690286020578491
STAT,1874,44,na,1918,2374.8051501345262
STAT,1922,49,45-49,1971,0.25327102524064277
STAT,1793,94,na,1887,4.690649770296572
STAT,1906,32,30-34,1938,14.886128439392554
STAT,1902,49,25-29,1951,0.0457673490931522
STAT,1844,46,na,1890,1748.3771456431793
SIM,1917,47,50-100,1964,1
STAT,1893,29,na,1922,3066.436447778143
STAT,1910,43,45-49,1953,0.15945961017527335
STAT,1940,25,35-39,1965,15.632121220584747
STAT,1843,39,50-100,1882,1.031273763158297
SIM,1803,52,na,1855,1038
STAT,1891,48,na,1939,2806.3618387908505
SIM,1859,24,30-34,1883,26
SIM,1929,26,na,1955,4991
STAT,1776,90,na,1866,27.62151074929003
SIM,1913,23,25-29,1936,115
STAT,1879,14,na,1893,2744.9561912330105
STAT,1892,27,45-49,1919,1.4195912544545932
SIM,1942,29,50-100,1971,1
SIM,1833,36,45-49,1869,3
SIM,1803,87,na,1890,4
SIM,1920,30,40-44,1950,1
SIM,1898,16,30-34,1914,4
STAT,1822,42,20-24,1864,0.24728173326286032
STAT,1909,19,20-24,1928,26.969651760163842
STAT,1799,85,na,1884,88.47286161176348
STAT,1846,27,na,1873,1871.4897400693144
SIM,1878,47,30-34,1925,1
STAT,1866,22,50-100,1888,0.38685171815885855
SIM,1835,36,50-100,1871,2
SIM,1786,87,na,1873,36
STAT,1834,51,50-100,1885,0.01062962138417873
STAT,1912,39,40-44,1951,1.4754859354881404
STAT,1851,40,25-29,1891,0.5351364933959863
STAT,1825,36,45-49,1861,3.1560970232729018
STAT,1880,21,45-49,1901,0.7498062924506502
SIM,1933,35,45-49,1968,2
STAT,1900,33,40-44,1933,6.106022549864921
SIM,1949,5,na,1954,4797
STAT,1910,22,45-49,1932,1.0776866153144833
SIM,1848,40,25-29,1888,1
SIM,1889,41,na,1930,3029
SIM,1940,25,35-39,1965,25
STAT,1847,50,45-49,1897,0.011479598936634992
SIM,1796,65,na,1861,689
STAT,1815,52,30-34,1867,0.015298542321527029
SIM,1844,36,20-24,1880,3
STAT,1851,19,na,1870,2275.446122848274
SIM,1847,12,na,1859,2132
STAT,1842,18,25-29,1860,5.672907511226468
SIM,1850,18,25-29,1868,8
STAT,1817,43,35-39,1860,4.375357292192173
STAT,1913,49,50-100,1962,0.22389226585209596
STAT,1937,34,25-29,1971,9.315298393858855
STAT,1920,43,45-49,1963,0.18728232298654562
STAT,1823,45,50-100,1868,0.3798366389183962
SIM,1934,4,na,1938,5731
STAT,1850,34,na,1884,1839.1505372679817
STAT,1883,52,50-100,1935,0.015036852943754104
SIM,1928,34,25-29,1962,2
STAT,1901,42,50-100,1943,0.10452811726016033
SIM,1902,56,na,1958,3011
SIM,1905,40,50-100,1945,1
STAT,1892,63,na,1955,2281.3434045892473
SIM,1928,19,30-34,1947,22
SIM,1960,10,na,1970,5241
STAT,1854,45,50-100,1899,0.18984508488168358
SIM,1878,19,15-19,1897,11
STAT,1943,10,na,1953,4262.733500648494
STAT,1840,25,30-34,1865,22.922024958330294
SIM,1939,11,na,1950,3996
STAT,1921,18,na,1939,4270.1069741569645
STAT,1921,24,20-24,1945,127.3571233522508
SIM,1805,65,na,1870,813
STAT,1847,29,50-100,1876,0.591001688936474
STAT,1890,45,15-19,1935,5.039084852768918E-4
STAT,1831,47,25-29,1878,0.04710827318558748
STAT,1910,26,na,1936,3702.174982247477
STAT,1842,36,45-49,1878,1.8530121742366399
STAT,1887,47,30-34,1934,0.11013943130196033
STAT,1921,25,25-29,1946,75.36394853491743
STAT,1852,12,na,1864,2325.991959338539
STAT,1893,44,45-49,1937,0.13268483501373213
STAT,1897,42,20-24,1939,0.015024488037896234
STAT,1879,18,20-24,1897,18.855377272846646
SIM,1889,48,45-49,1937,1
SIM,1879,34,na,1913,2894
SIM,1915,23,na,1938,4144
SIM,1857,15,30-34,1872,4
SIM,1860,61,na,1921,1786
STAT,1827,46,20-24,1873,0.013660095570193672
SIM,1861,49,na,1910,2388
STAT,1867,54,45-49,1921,0.01351678579698524
SIM,1851,33,35-39,1884,13
SIM,1868,81,na,1949,455
STAT,1890,63,na,1953,2225.6284575893433
STAT,1906,35,35-39,1941,2.288335169599622
STAT,1927,37,50-100,1964,0.532485773426342
STAT,1936,19,15-19,1955,44.078600608668104
STAT,1850,20,20-24,1870,63.11980692244374
SIM,1837,75,na,1912,586
SIM,1935,3,na,1938,5669
STAT,1861,26,na,1887,2041.0338118608577
STAT,1936,36,25-29,1972,0.9867849028235531
SIM,1869,17,15-19,1886,7
SIM,1947,24,15-19,1971,7
STAT,1900,31,25-29,1931,14.541712490434115
STAT,1892,41,na,1933,2968.4340294166354
STAT,1915,44,40-44,1959,0.25611238317433366
STAT,1939,4,na,1943,4112.509618195937
STAT,1877,37,20-24,1914,0.8156243880411319
SIM,1938,18,na,1956,3648
STAT,1826,53,45-49,1879,0.010734628913476693
SIM,1849,22,20-24,1871,107
SIM,1944,19,15-19,1963,46
SIM,1922,32,30-34,1954,21
SIM,1895,69,na,1964,2146
STAT,1912,46,15-19,1958,3.620432810900065E-4
STAT,1779,87,na,1866,44.73366736973348
STAT,1883,29,50-100,1912,0.6357335559619628
STAT,1939,24,15-19,1963,5.449890241434083
SIM,1847,34,na,1881,1766
STAT,1825,64,na,1889,1051.9075084660765
SIM,1897,70,na,1967,2136
STAT,1768,107,na,1875,0.010832891008848378
STAT,1849,15,30-34,1864,1.541265057070068
SIM,1794,87,na,1881,52
STAT,1829,46,30-34,1875,0.07935544946027943
SIM,1890,43,30-34,1933,4
STAT,1812,51,35-39,1863,0.019827705551098074
STAT,1883,19,25-29,1902,5.641780473366663
SIM,1860,93,na,1953,12
SIM,1903,32,20-24,1935,3
STAT,1851,26,45-49,1877,1.0802878750144949
SIM,1812,66,na,1878,773
STAT,1896,37,30-34,1933,7.18082499720257
STAT,1893,26,na,1919,3099.10956600192
SIM,1902,34,na,1936,3501
SIM,1922,29,30-34,1951,58
SIM,1885,2,na,1887,3023
STAT,1943,18,na,1961,3980.9452538038254
STAT,1932,25,35-39,1957,20.071875147658844
SIM,1885,37,20-24,1922,1
STAT,1855,86,na,1941,171.99803558113518
SIM,1856,57,na,1913,1972
SIM,1900,2,na,1902,3821
STAT,1874,18,50-100,1892,0.050894378438785
STAT,1914,32,30-34,1946,16.180922694855923
STAT,1882,43,30-34,1925,1.134374521272957
STAT,1898,48,45-49,1946,0.18134347737864207
SIM,1825,43,35-39,1868,2
STAT,1831,54,30-34,1885,0.004116129839292501
STAT,1901,19,50-100,1920,0.0695159837509273
SIM,1814,92,na,1906,27
SIM,1887,63,na,1950,2150
STAT,1836,19,45-49,1855,0.062264601060706554
STAT,1855,16,50-100,1871,0.04543917908978133
STAT,1882,34,na,1916,2351.3937134673233
STAT,1897,49,40-44,1946,0.12897610763645093
STAT,1884,34,35-39,1918,10.133562914283578
STAT,1820,106,na,1926,0.00668709054146497
SIM,1853,33,50-100,1886,1
SIM,1892,34,35-39,1926,25
STAT,1870,40,35-39,1910,1.8240787846629254
SIM,1849,44,50-100,1893,4
STAT,1833,28,25-29,1861,36.91083251347772
STAT,1854,52,45-49,1906,0.011048014071815146
SIM,1841,28,25-29,1869,63
STAT,1846,46,30-34,1892,0.06942032611792821
SIM,1812,43,50-100,1855,1
SIM,1866,44,35-39,1910,2
STAT,1907,59,na,1966,3138.4584133327526
SIM,1913,17,20-24,1930,28
STAT,1841,51,20-24,1892,5.474516213427805E-4
SIM,1839,68,na,1907,1111
SIM,1873,19,30-34,1892,7
STAT,1830,35,15-19,1865,0.0521465026878756
STAT,1934,36,na,1970,5299.345186872242
STAT,1820,36,na,1856,1559.569534629685
SIM,1933,18,50-100,1951,1
STAT,1874,41,15-19,1915,0.01444887496736676
SIM,1876,30,35-39,1906,17
STAT,1830,68,na,1898,966.7257634789004
SIM,1933,33,45-49,1966,6
STAT,1921,23,50-100,1944,0.7560413310851748
SIM,1772,84,na,1856,88
SIM,1903,34,20-24,1937,1
STAT,1839,41,20-24,1880,0.12857944536358168
SIM,1917,33,na,1950,3907
SIM,1876,27,35-39,1903,11
STAT,1799,56,na,1855,1033.3303474025483
STAT,1840,18,15-19,1858,5.496555922807856
STAT,1883,17,50-100,1900,0.04903917726816819
SIM,1913,20,20-24,1933,119
STAT,1830,43,na,1873,1601.405682550554
STAT,1835,104,na,1939,0.04969592499039427
STAT,1869,55,na,1924,2036.5085257312737
SIM,1887,18,20-24,1905,29
STAT,1816,50,na,1866,1273.215531736402
SIM,1843,40,40-44,1883,2
STAT,1925,18,50-100,1943,0.46053627588174145
STAT,1901,37,15-19,1938,0.017290808372673896
STAT,1858,44,35-39,1902,1.4451879970307386
SIM,1862,31,45-49,1893,1
STAT,1827,90,na,1917,50.95618250445946
STAT,1866,30,25-29,1896,9.715456767074306
STAT,1839,29,30-34,1868,21.58056975853555
STAT,1881,45,30-34,1926,0.09642346412352126
STAT,1925,33,45-49,1958,1.9052648866662503
STAT,1856,16,50-100,1872,0.046665162376991046
STAT,1863,46,25-29,1909,0.05166669481057641
STAT,1865,19,30-34,1884,1.5028905625855478
STAT,1807,50,15-19,1857,1.058434882728323E-4
STAT,1867,15,25-29,1882,5.614172419009414
STAT,1805,54,20-24,1859,0.00249814209291713
SIM,1891,16,20-24,1907,21
SIM,1924,21,35-39,1945,14
SIM,1863,27,na,1890,2096
SIM,1781,80,na,1861,192
SIM,1851,51,30-34,1902,1
STAT,1843,30,30-34,1873,17.300182034618764
STAT,1835,35,na,1870,2014.1707666413129
SIM,1826,80,na,1906,275
STAT,1940,22,30-34,1962,29.869068656606185
STAT,1835,40,40-44,1875,2.0610054680388723
STAT,1872,45,20-24,1917,0.012391474511356148
STAT,1843,83,na,1926,320.476886873447
STAT,1881,33,50-100,1914,0.8998587875882458
STAT,1814,54,30-34,1868,0.01631431872502567
STAT,1813,107,na,1920,0.0020279890957344573
SIM,1857,41,na,1898,1979
STAT,1952,8,na,1960,4804.427941670108
STAT,1915,47,45-49,1962,0.22348157411713857
STAT,1845,42,na,1887,1838.961193518268
STAT,1856,51,50-100,1907,0.012152201455921063
STAT,1931,26,50-100,1957,1.3111489003686818
STAT,1921,49,35-39,1970,0.14744561618584925
SIM,1862,42,na,1904,2121
STAT,1894,37,20-24,1931,1.0115219473833714
SIM,1830,32,na,1862,1925
STAT,1829,30,50-100,1859,0.8944818052358806
SIM,1787,83,na,1870,103
STAT,1841,42,30-34,1883,0.8820724041799392
SIM,1841,72,na,1913,882
STAT,1836,47,50-100,1883,0.15999339323688527
STAT,1822,45,25-29,1867,0.08457434762239772
SIM,1844,47,50-100,1891,1
STAT,1860,46,40-44,1906,0.14210700640258592
STAT,1860,33,35-39,1893,8.346943530365065
SIM,1828,28,na,1856,1899
STAT,1834,52,25-29,1886,0.002444053939227608
STAT,1930,36,30-34,1966,2.4268500024630257
STAT,1916,21,35-39,1937,10.099082116716147
SIM,1803,55,na,1858,963
STAT,1904,48,na,1952,3248.687606651026
STAT,1814,72,na,1886,645.0071562869233
STAT,1816,53,50-100,1869,0.02912544110798902
STAT,1911,36,20-24,1947,0.26096354835319563
SIM,1898,58,na,1956,3047
SIM,1914,35,35-39,1949,5
STAT,1886,48,50-100,1934,0.2618695811141467
STAT,1910,40,40-44,1950,0.24382872965221433
STAT,1867,45,na,1912,2176.2257222757494
STAT,1909,37,na,1946,3631.8040443202776
STAT,1827,79,na,1906,451.8452378776369
STAT,1821,49,30-34,1870,0.1480306804526016
STAT,1870,32,40-44,1902,4.32484559480232
SIM,1866,29,40-44,1895,6
SIM,1813,62,na,1875,988
STAT,1858,29,40-44,1887,2.445361443438543
SIM,1890,38,40-44,1928,2
STAT,1894,35,50-100,1929,1.6263669048911797
STAT,1925,32,40-44,1957,4.741148319090274
SIM,1923,46,40-44,1969,1
STAT,1903,40,40-44,1943,0.228793037369889
SIM,1907,23,na,1930,3536
STAT,1876,88,na,1964,305.21841469940273
SIM,1849,25,25-29,1874,61
STAT,1940,19,30-34,1959,12.616920573855225
SIM,1861,39,25-29,1900,5
SIM,1884,74,na,1958,1077
STAT,1915,46,40-44,1961,0.16252189095890046
SIM,1839,18,25-29,1857,7
SIM,1861,46,na,1907,2417
STAT,1853,93,na,1946,24.505454217543427
STAT,1905,17,20-24,1922,26.120235335926793
SIM,1901,21,40-44,1922,5
STAT,1892,24,40-44,1916,2.647599712260653
STAT,1777,87,na,1864,65.36398609011755
SIM,1901,22,45-49,1923,1
STAT,1843,61,na,1904,1508.4990647718082
STAT,1861,30,40-44,1891,3.6850994302899944
STAT,1838,31,na,1869,1999.366137337991
STAT,1925,41,30-34,1966,0.1581432943546384
STAT,1918,34,15-19,1952,0.13815706162233782
STAT,1899,42,30-34,1941,0.11139021520787082
SIM,1838,38,na,1876,1677
STAT,1877,50,30-34,1927,0.006388818418267005
STAT,1831,44,20-24,1875,0.1310453178715186
STAT,1854,31,45-49,1885,1.3810203005230375
SIM,1904,42,15-19,1946,1
STAT,1843,86,na,1929,179.11465497015314
STAT,1818,94,na,1912,10.185240979394079
STAT,1840,21,15-19,1861,3.040817747952958
STAT,1850,47,35-39,1897,0.10481772200919057
SIM,1950,18,na,1968,4430
STAT,1905,20,20-24,1925,102.13764496567173
SIM,1894,33,na,1927,3115
STAT,1921,22,20-24,1943,128.1594236182086
STAT,1830,51,45-49,1881,0.010803145891626155
STAT,1819,79,na,1898,412.1624143776765
SIM,1849,12,na,1861,2298
SIM,1836,79,na,1915,440
STAT,1852,43,45-49,1895,1.196986102620623
SIM,1850,15,20-24,1865,17
STAT,1868,24,30-34,1892,17.247057369548564
STAT,1838,17,20-24,1855,17.20598738637641
STAT,1929,43,30-34,1972,0.16859926286434074
SIM,1855,19,20-24,1874,17
STAT,1873,40,45-49,1913,1.563518344174403
STAT,1891,48,35-39,1939,0.09848779310783852
SIM,1874,96,na,1970,28
STAT,1909,15,na,1924,3880.758549918765
STAT,1797,75,na,1872,427.49333155867544
STAT,1878,54,20-24,1932,7.620203834357575E-4
STAT,1897,45,25-29,1942,0.04476102417285951
STAT,1910,30,30-34,1940,15.618408476906133
SIM,1904,60,na,1964,3019
SIM,1905,45,na,1950,3307
STAT,1892,41,25-29,1933,0.8247525086121541
STAT,1900,36,45-49,1936,0.6113176868198607
SIM,1812,69,na,1881,663
STAT,1817,40,30-34,1857,3.121352939263163
STAT,1937,32,na,1969,3816.710615564742
SIM,1915,52,na,1967,4029
STAT,1805,76,na,1881,463.6800674571064
SIM,1835,26,35-39,1861,11
SIM,1916,37,na,1953,3896
STAT,1882,38,40-44,1920,4.329119139617995
SIM,1940,22,30-34,1962,38
STAT,1855,32,15-19,1887,0.11240405396656304
STAT,1816,39,na,1855,1397.2294219444682
SIM,1851,39,50-100,1890,4
SIM,1863,32,15-19,1895,1
SIM,1938,17,25-29,1955,55
STAT,1859,53,40-44,1912,0.008439320097915612
STAT,1884,31,30-34,1915,17.69380298449
SIM,1885,59,na,1944,2019
STAT,1922,46,40-44,1968,0.18527154407427615
STAT,1815,47,40-44,1862,0.4605518373587545
STAT,1806,50,50-100,1856,0.05122899577402077
STAT,1868,59,na,1927,1893.6480125559613
SIM,1874,67,na,1941,1531
STAT,1839,16,na,1855,2084.626013660275
STAT,1918,26,50-100,1944,1.0846730144487267
STAT,1856,82,na,1938,373.64084328360246
STAT,1833,40,15-19,1873,0.011361530292758874
STAT,1847,19,20-24,1866,17.052222216317954
STAT,1821,34,50-100,1855,2.48098786012826
STAT,1825,50,25-29,1875,0.0045703309217407714
STAT,1859,45,na,1904,1851.252956999116
SIM,1884,41,40-44,1925,5
SIM,1838,20,na,1858,1886
STAT,1829,39,15-19,1868,0.047814490868133164
SIM,1842,57,na,1899,1499
STAT,1858,35,50-100,1893,1.002686359359294
SIM,1823,47,40-44,1870,1
SIM,1892,31,30-34,1923,32
STAT,1911,44,15-19,1955,0.0014767253585148447
SIM,1854,90,na,1944,70
STAT,1840,36,50-100,1876,1.0558489960671997
STAT,1863,30,na,1893,2151.596962786274
SIM,1885,5,na,1890,2657
STAT,1858,111,na,1969,9.061195811853859E-4
SIM,1881,15,na,1896,2333
STAT,1865,30,na,1895,2227.252366960643
SIM,1877,42,45-49,1919,1
SIM,1825,40,30-34,1865,6
STAT,1839,102,na,1941,0.2023332049458122
STAT,1829,42,15-19,1871,0.011588319672357678
STAT,1871,36,15-19,1907,0.05701868729426196
STAT,1869,42,45-49,1911,1.4722387295464818
SIM,1903,35,25-29,1938,2
STAT,1876,70,na,1946,1478.0395957391054
STAT,1926,40,na,1966,4683.761366793201
SIM,1951,14,na,1965,5309
SIM,1820,38,25-29,1858,3
STAT,1862,103,na,1965,0.6367239366204117
STAT,1849,18,35-39,1867,0.5212788586734611
SIM,1847,29,30-34,1876,26
STAT,1955,9,na,1964,5320.66545978807
SIM,1939,32,35-39,1971,12
SIM,1927,9,na,1936,4894
STAT,1866,51,25-29,1917,0.0033488753123991823
STAT,1896,33,15-19,1929,0.1910637642191864
SIM,1814,47,na,1861,1292
SIM,1882,41,50-100,1923,3
SIM,1926,15,40-44,1941,2
STAT,1859,4,na,1863,2520.716205527219
STAT,1900,35,40-44,1935,6.2483520472776375
SIM,1922,35,35-39,1957,4
SIM,1872,19,na,1891,2592
STAT,1838,18,50-100,1856,0.04726779849362941
STAT,1842,68,na,1910,1198.419555097731
STAT,1894,22,na,1916,3103.4598492964174
STAT,1828,41,45-49,1869,1.2437860678095756
STAT,1855,29,15-19,1884,0.3613529676103491
STAT,1872,16,45-49,1888,0.06740436734534049
SIM,1845,53,na,1898,1662
SIM,1885,37,na,1922,2420
SIM,1865,82,na,1947,345
STAT,1922,32,15-19,1954,0.14815041194092118
STAT,1928,40,45-49,1968,0.21701536752037198
STAT,1809,50,40-44,1859,0.04654799358834532
STAT,1900,47,50-100,1947,0.19497374017026955
SIM,1851,30,30-34,1881,21
STAT,1876,41,40-44,1917,2.3801744777703413
STAT,1895,32,45-49,1927,2.32104642604886
STAT,1846,49,35-39,1895,0.09802667969066316
SIM,1935,29,na,1964,5410
STAT,1936,33,20-24,1969,2.4149389952091957
STAT,1939,28,30-34,1967,40.16395255045788
STAT,1774,98,na,1872,0.4018048779557907
STAT,1918,29,na,1947,4039.29281971365
STAT,1914,35,35-39,1949,2.487374378769128
SIM,1889,44,na,1933,2969
SIM,1883,20,25-29,1903,61
STAT,1930,22,50-100,1952,0.8597220988298511
STAT,1939,1,na,1940,4255.047795414135
STAT,1817,102,na,1919,0.1430789323197709
STAT,1901,18,40-44,1919,0.2602420681344955
STAT,1818,52,40-44,1870,0.022912075238359746
STAT,1875,53,25-29,1928,0.0036489808828327184
STAT,1867,74,na,1941,1062.8797077562624
STAT,1894,20,35-39,1914,7.703111760259267
SIM,1928,28,20-24,1956,3
STAT,1842,15,20-24,1857,18.065198381649655
STAT,1882,52,20-24,1934,7.294967079828458E-4
STAT,1856,48,40-44,1904,0.13537492349097446
STAT,1910,24,45-49,1934,1.0709401098006808
SIM,1878,24,40-44,1902,2
STAT,1882,46,35-39,1928,0.13953780808780522
STAT,1932,22,30-34,1954,38.45850701335011
STAT,1844,50,35-39,1894,0.006767126766619925
STAT,1944,24,15-19,1968,5.859942676506113
SIM,1844,22,50-100,1866,1
STAT,1860,54,35-39,1914,0.006929885092456426
SIM,1836,41,45-49,1877,4
SIM,1928,31,20-24,1959,6
STAT,1916,48,15-19,1964,3.8449685073161266E-4
SIM,1874,45,na,1919,2325
SIM,1822,76,na,1898,467
STAT,1871,6,na,1877,2788.240359538028
SIM,1950,9,na,1959,4743
SIM,1850,83,na,1933,235
SIM,1851,3,na,1854,2639
STAT,1904,46,30-34,1950,0.08006022510729496
STAT,1900,16,na,1916,3579.8507641845836
STAT,1837,53,20-24,1890,4.841035603149972E-4
STAT,1907,37,na,1944,3556.833783067199
SIM,1827,68,na,1895,880
STAT,1857,67,na,1924,1262.9729939853125
STAT,1874,41,50-100,1915,1.105338854232546
STAT,1894,17,35-39,1911,0.720026129827879
STAT,1789,97,na,1886,0.7895159875603721
STAT,1836,22,50-100,1858,0.3350076119313864
STAT,1885,43,40-44,1928,2.2727281117007667
STAT,1949,17,35-39,1966,4.97900281641078
STAT,1918,11,na,1929,4407.579882226383
STAT,1919,39,na,1958,4115.722121206982
STAT,1909,35,50-100,1944,0.409152040700433
SIM,1859,27,40-44,1886,6
SIM,1882,20,45-49,1902,1
STAT,1847,16,15-19,1863,5.8102222470255915
SIM,1854,22,na,1876,2336
SIM,1942,25,40-44,1967,8
STAT,1913,15,25-29,1928,9.080867626104709
STAT,1765,109,na,1874,0.0010701195502068024
STAT,1831,39,40-44,1870,3.759323740876489
STAT,1923,37,30-34,1960,2.15467017792417
STAT,1889,43,na,1932,2891.454853814481
STAT,1927,34,na,1961,4739.657591543842
SIM,1855,48,35-39,1903,1
SIM,1912,32,50-100,1944,1
STAT,1878,91,na,1969,205.895599682587
SIM,1872,6,na,1878,2889
STAT,1878,16,45-49,1894,0.0695337931837974
STAT,1882,42,50-100,1924,1.0486903485411196
SIM,1869,75,na,1944,843
STAT,1811,107,na,1918,0.0020427550399470884
STAT,1912,34,20-24,1946,2.4274585494120413
SIM,1843,25,50-100,1868,1
SIM,1850,32,na,1882,1914
STAT,1885,53,na,1938,2156.3214566230727
STAT,1937,31,15-19,1968,0.12975740519446122
SIM,1869,30,25-29,1899,3
STAT,1853,20,na,1873,2149.0385671376416
STAT,1916,41,25-29,1957,0.07478505356324366
STAT,1893,15,30-34,1908,2.0722841127966056
STAT,1812,46,na,1858,1414.8339181968904
SIM,1918,30,45-49,1948,4
STAT,1946,24,20-24,1970,126.16044992458032
SIM,1928,2,na,1930,5384
SIM,1921,15,25-29,1936,73
SIM,1846,27,na,1873,2081
SIM,1933,32,35-39,1965,3
STAT,1955,17,25-29,1972,58.67509961048751
STAT,1902,27,15-19,1929,0.6527171179140934
STAT,1899,73,na,1972,2120.02328848247
STAT,1906,38,40-44,1944,1.3959912227204179
SIM,1920,44,na,1964,3974
STAT,1865,50,50-100,1915,0.01418462983957906
STAT,1871,36,50-100,1907,1.2466356873698166
SIM,1855,16,15-19,1871,6
STAT,1929,25,30-34,1954,50.20566812401652
SIM,1880,30,na,1910,2387
SIM,1882,65,na,1947,1553
SIM,1940,28,40-44,1968,4
SIM,1950,0,na,1950,4987
STAT,1927,28,30-34,1955,48.420039433548034
STAT,1864,45,30-34,1909,0.08868095172183843
SIM,1919,29,30-34,1948,8
SIM,1900,25,35-39,1925,3
STAT,1822,48,30-34,1870,0.13601415875673464
STAT,1932,28,40-44,1960,6.22301746187065
STAT,1908,35,40-44,1943,1.4427931776184253
SIM,1907,54,na,1961,3336
SIM,1929,30,20-24,1959,1
SIM,1914,38,40-44,1952,2
SIM,1938,27,50-100,1965,4
SIM,1905,29,30-34,1934,7
STAT,1914,44,25-29,1958,0.07195385212437062
STAT,1925,32,35-39,1957,11.071491991366207
SIM,1883,36,50-100,1919,1
STAT,1926,27,50-100,1953,1.2172443142525535
SIM,1890,60,na,1950,2479
SIM,1935,28,30-34,1963,97
SIM,1901,26,50-100,1927,1
STAT,1901,34,45-49,1935,2.4664017210553273
SIM,1937,27,25-29,1964,85
SIM,1855,63,na,1918,1358
SIM,1871,14,na,1885,2541
STAT,1805,49,40-44,1854,0.6110267250994842
STAT,1933,27,45-49,1960,2.3393798821021283
SIM,1868,30,35-39,1898,5
SIM,1902,20,40-44,1922,2
STAT,1868,81,na,1949,526.9032779442437
STAT,1859,33,25-29,1892,8.309587937799328
STAT,1884,12,na,1896,2606.481558493679
SIM,1859,45,na,1904,2143
STAT,1859,31,30-34,1890,14.28282410934999
STAT,1938,2,na,1940,4115.457630814119
STAT,1904,42,45-49,1946,0.15176507917592416
STAT,1928,28,20-24,1956,22.927821406082803
STAT,1842,76,na,1918,742.9583098414155
STAT,1902,45,45-49,1947,0.19342709555657833
STAT,1913,22,na,1935,3772.4360956428964
STAT,1869,23,40-44,1892,2.046019099729824
STAT,1875,31,15-19,1906,0.14971167841451982
STAT,1902,50,na,1952,3142.245587944156
SIM,1863,50,na,1913,1865
STAT,1930,30,20-24,1960,3.214144835181074
STAT,1900,32,50-100,1932,1.295525160955261
SIM,1808,61,na,1869,1171
STAT,1850,50,25-29,1900,0.0027026065921544077
SIM,1941,27,45-49,1968,1
STAT,1900,31,20-24,1931,3.837608272326393
SIM,1804,71,na,1875,811
SIM,1937,25,30-34,1962,53
STAT,1937,33,50-100,1970,0.8338526810644648
SIM,1936,28,20-24,1964,29
SIM,1844,91,na,1935,16
STAT,1827,99,na,1926,1.2240428684173845
STAT,1904,22,20-24,1926,100.75460256867846
STAT,1929,27,25-29,1956,84.0185389763115
SIM,1910,30,45-49,1940,1
STAT,1899,53,na,1952,2959.6959099484884
SIM,1886,55,na,1941,2361
STAT,1934,25,40-44,1959,6.399966603271016
STAT,1853,32,50-100,1885,0.7911596930616612
SIM,1893,9,na,1902,3417
STAT,1865,30,45-49,1895,1.62758836618627
SIM,1863,19,na,1882,2263
SIM,1838,83,na,1921,211
SIM,1879,73,na,1952,1511
STAT,1912,18,15-19,1930,9.337183516762348
SIM,1943,24,45-49,1967,1
STAT,1794,107,na,1901,9.347799350348076E-4
STAT,1913,33,25-29,1946,9.341547580769232
SIM,1781,89,na,1870,8
STAT,1788,79,na,1867,305.03715477755026
SIM,1867,31,30-34,1898,18
SIM,1920,18,15-19,1938,46
SIM,1905,16,25-29,1921,15
STAT,1945,26,25-29,1971,73.70764329194606
SIM,1880,50,na,1930,2088
STAT,1784,97,na,1881,0.8158492660708505
SIM,1900,23,40-44,1923,3
SIM,1925,28,45-49,1953,5
STAT,1917,28,45-49,1945,1.8423954116582217
SIM,1921,33,25-29,1954,23
SIM,1889,34,50-100,1923,1
STAT,1876,17,na,1893,2660.547710447865
STAT,1848,53,na,1901,1646.855036310906
STAT,1935,24,45-49,1959,1.5614810420609644
STAT,1944,27,20-24,1971,20.128611600876575
STAT,1943,19,50-100,1962,0.40506919074734643
STAT,1833,53,50-100,1886,0.010093561068918837
SIM,1877,19,na,1896,2614
STAT,1859,54,50-100,1913,0.011966072127659606
STAT,1919,47,na,1966,4066.299951955753
STAT,1937,19,30-34,1956,12.059226790121757
SIM,1901,21,35-39,1922,15
SIM,1825,65,na,1890,1006
STAT,1902,30,45-49,1932,2.5289075765832254
SIM,1852,20,30-34,1872,23
STAT,1867,20,na,1887,2307.4289539499564
STAT,1913,45,20-24,1958,0.011055650497229322
SIM,1932,21,na,1953,5402
SIM,1872,55,na,1927,2165
SIM,1849,35,30-34,1884,4
SIM,1835,20,30-34,1855,22
STAT,1896,25,na,1921,3237.305255363135
SIM,1932,36,35-39,1968,4
STAT,1868,24,35-39,1892,5.650306521017566
STAT,1904,42,15-19,1946,0.0014003699177027157
SIM,1843,50,na,1893,1648
SIM,1921,17,20-24,1938,175
STAT,1860,20,15-19,1880,3.1382097736651406
STAT,1934,23,45-49,1957,1.5415305730954754
STAT,1934,38,15-19,1972,0.026997456533021956
STAT,1810,109,na,1919,3.033190127941509E-4
STAT,1912,1,na,1913,4293.724814925043
SIM,1900,40,30-34,1940,1
SIM,1928,16,na,1944,4787
SIM,1914,36,na,1950,3850
STAT,1770,101,na,1871,0.08200268389296508
STAT,1910,21,35-39,1931,9.045762392611525
SIM,1852,22,25-29,1874,1
STAT,1845,33,na,1878,1992.6329198149303
SIM,1915,34,40-44,1949,6
SIM,1921,30,20-24,1951,5
STAT,1909,34,45-49,1943,1.518339977239834
SIM,1867,15,25-29,1882,12
SIM,1894,42,na,1936,3109
STAT,1840,44,30-34,1884,0.8411614066287895
STAT,1907,34,40-44,1941,3.6980180053954705
SIM,1926,37,20-24,1963,2
STAT,1902,8,na,1910,3739.8254999145597
SIM,1912,22,20-24,1934,111
STAT,1877,17,40-44,1894,0.19352715876504697
SIM,1891,14,na,1905,3333
SIM,1867,40,na,1907,2129
SIM,1875,83,na,1958,521
STAT,1864,32,50-100,1896,0.8311101345925707
STAT,1839,22,15-19,1861,2.9254236293968647
STAT,1913,17,20-24,1930,28.278383633337437
STAT,1853,26,50-100,1879,0.6258674268862149
SIM,1840,22,na,1862,1849
STAT,1928,26,25-29,1954,82.99699101755013
STAT,1844,22,25-29,1866,55.38669591359972
STAT,1858,35,30-34,1893,4.352617749340515
STAT,1922,33,50-100,1955,0.9491716320387802
SIM,1886,75,na,1961,1262
STAT,1912,16,20-24,1928,28.035317418416067
STAT,1907,36,35-39,1943,2.2977222043026577
SIM,1888,41,45-49,1929,4
STAT,1947,20,20-24,1967,128.30687632755038
SIM,1837,20,35-39,1857,7
STAT,1915,45,25-29,1960,0.054801372987316146
SIM,1932,34,40-44,1966,9
STAT,1843,104,na,1947,0.05384514293883707
STAT,1924,34,40-44,1958,4.652044495780843
STAT,1933,29,40-44,1962,6.305328532296011
SIM,1874,42,na,1916,2365
SIM,1903,44,na,1947,3227
STAT,1927,45,20-24,1972,0.014217060517067627
SIM,1847,22,15-19,1869,2
SIM,1941,29,40-44,1970,5
STAT,1917,38,15-19,1955,0.020253663054213347
STAT,1930,32,15-19,1962,0.16914238883941277
SIM,1920,16,20-24,1936,163
SIM,1936,26,25-29,1962,66
STAT,1885,20,20-24,1905,70.55615628002174
STAT,1904,40,20-24,1944,0.016286802633558937
SIM,1926,24,45-49,1950,1
SIM,1915,36,35-39,1951,6
STAT,1819,43,50-100,1862,2.2147270854215164
STAT,1869,25,35-39,1894,9.567784563194559
STAT,1918,39,15-19,1957,0.020611263873165704
STAT,1861,51,50-100,1912,0.01279205184082972
SIM,1808,53,na,1861,1403
STAT,1928,44,25-29,1972,0.09254715925892666
STAT,1846,58,na,1904,1414.2230014945924
STAT,1889,31,45-49,1920,2.206446664293875
SIM,1819,45,na,1864,1430
STAT,1839,16,50-100,1855,0.044492403388642264
STAT,1904,24,15-19,1928,4.793195041557656
STAT,1918,37,20-24,1955,0.28354002435426523
SIM,1856,17,na,1873,2674
STAT,1923,19,30-34,1942,14.524875775060284
SIM,1893,20,20-24,1913,5
STAT,1812,109,na,1921,3.2450121634680954E-4
SIM,1917,34,45-49,1951,2
STAT,1953,18,30-34,1971,15.03574995762216
SIM,1836,21,30-34,1857,3
SIM,1878,28,50-100,1906,1
SIM,1916,35,40-44,1951,3
STAT,1919,36,25-29,1955,1.0804090869845804
STAT,1940,24,na,1964,3792.515949715184
STAT,1928,29,30-34,1957,49.190132475341144
SIM,1897,31,45-49,1928,2
SIM,1848,81,na,1929,328
STAT,1943,18,45-49,1961,0.5402813528032766
SIM,1941,26,35-39,1967,1
SIM,1915,18,35-39,1933,1
STAT,1811,84,na,1895,144.09585987818417
SIM,1931,19,30-34,1950,22
STAT,1851,30,15-19,1881,0.12485088618983234
SIM,1951,18,45-49,1969,1
STAT,1943,28,15-19,1971,0.7667046611823932
SIM,1831,44,30-34,1875,3
SIM,1890,80,na,1970,1064
SIM,1945,19,30-34,1964,27
SIM,1879,0,na,1879,3816
STAT,1844,20,30-34,1864,17.484040887947494
STAT,1916,42,50-100,1958,0.12285630624037505
STAT,1946,3,na,1949,4530.867193776306
SIM,1835,63,na,1898,1183
SIM,1880,7,na,1887,2693
SIM,1931,37,30-34,1968,3
STAT,1862,96,na,1958,11.437010043816485
SIM,1828,81,na,1909,352
STAT,1908,33,45-49,1941,1.5082279979247477
STAT,1907,18,35-39,1925,0.8197508809718435
SIM,1839,45,na,1884,1723
SIM,1956,6,na,1962,5511
SIM,1930,36,30-34,1966,4
STAT,1839,40,45-49,1879,1.227345602174448
SIM,1829,39,50-100,1868,1
STAT,1866,100,na,1966,4.841615255483441
STAT,1858,51,na,1909,1750.2636463088243
SIM,1934,36,na,1970,5426
STAT,1860,10,na,1870,2307.457249600495
STAT,1876,30,20-24,1906,2.870369968994641
STAT,1868,100,na,1968,6.292217809111561
SIM,1903,64,na,1967,2750
SIM,1916,33,45-49,1949,1
STAT,1868,9,na,1877,2655.882684389942
SIM,1863,9,na,1872,2458
STAT,1924,36,35-39,1960,2.9125483721320675
STAT,1938,18,35-39,1956,4.221069120653114
STAT,1868,32,50-100,1900,0.8927597514921003
SIM,1946,18,35-39,1964,5
STAT,1810,49,20-24,1859,0.036422204702492064
STAT,1865,33,na,1898,2200.168098129592
SIM,1927,36,25-29,1963,1
STAT,1834,30,15-19,1864,0.12533250506984026
SIM,1847,40,45-49,1887,1
STAT,1890,35,30-34,1925,6.710913579331809
STAT,1922,36,30-34,1958,2.118000622280612
STAT,1938,30,20-24,1968,2.5046940892882996
SIM,1912,24,15-19,1936,7
STAT,1771,90,na,1861,25.922186691692545
STAT,1880,45,15-19,1925,4.330865506544662E-4
STAT,1886,27,na,1913,2576.9966734924687
STAT,1849,15,na,1864,2219.6830618084828
STAT,1823,44,30-34,1867,1.768853150505044
STAT,1807,79,na,1886,347.97209428186426
STAT,1867,25,30-34,1892,24.28112494920011
SIM,1887,60,na,1947,2216
SIM,1925,25,40-44,1950,8
STAT,1904,0,na,1904,4293.117260307757
STAT,1906,37,30-34,1943,1.708081226540619
STAT,1888,49,35-39,1937,0.09325284824810874
STAT,1915,32,50-100,1947,0.8592735089824803
STAT,1905,23,20-24,1928,101.21811472636422
STAT,1852,15,na,1867,2263.133120454989
STAT,1920,40,35-39,1960,0.22758505381012678
STAT,1840,47,40-44,1887,0.12423249560301003
STAT,1860,2,na,1862,2858.9274710727195
SIM,1858,83,na,1941,359
STAT,1927,29,15-19,1956,0.871939419370166
SIM,1946,15,30-34,1961,18
SIM,1915,39,40-44,1954,3
STAT,1916,42,35-39,1958,0.2105821334299354
SIM,1936,29,30-34,1965,46
SIM,1939,0,na,1939,4176
SIM,1902,59,na,1961,2909
SIM,1876,24,35-39,1900,9
SIM,1869,35,na,1904,2343
STAT,1844,71,na,1915,1034.3521934393655
STAT,1859,48,50-100,1907,0.19757980661891278
STAT,1930,15,25-29,1945,57.40676465088003
SIM,1822,39,40-44,1861,5
SIM,1909,22,50-100,1931,4
STAT,1879,27,50-100,1906,0.6821391779781951
SIM,1931,36,na,1967,4930
STAT,1905,47,na,1952,3299.950380911023
STAT,1942,17,45-49,1959,0.5326072388858298
SIM,1895,20,25-29,1915,88
SIM,1879,65,na,1944,2021
STAT,1762,110,na,1872,0.001842562136495612
STAT,1826,38,na,1864,1644.4400786198726
STAT,1860,41,na,1901,1921.7021796097426
SIM,1922,4,na,1926,4756
STAT,1878,51,na,1929,2297.3046810738865
STAT,1937,24,na,1961,3624.8789611580055
STAT,1839,110,na,1949,1.907133038234865E-4
STAT,1933,26,35-39,1959,20.3391946160894
SIM,1851,24,30-34,1875,22
STAT,1900,55,na,1955,2923.6430579194216
STAT,1914,43,15-19,1957,0.0015501074607444357
STAT,1801,54,na,1855,1061.6005569786134
STAT,1893,18,35-39,1911,0.7082495090649543
STAT,1922,23,25-29,1945,107.74914152864712
SIM,1930,23,25-29,1953,143
STAT,1903,28,15-19,1931,0.6556274265834707
STAT,1907,34,na,1941,3573.9660783524705
STAT,1843,24,30-34,1867,17.79080503836789
SIM,1824,71,na,1895,699
STAT,1919,38,20-24,1957,0.28870334996196517
STAT,1873,20,na,1893,2460.6450643305197
STAT,1887,20,25-29,1907,65.82981850831531
STAT,1924,14,na,1938,4798.377597565103
SIM,1826,30,30-34,1856,3
STAT,1889,23,50-100,1912,0.5122866137764029
SIM,1866,55,na,1921,2178
SIM,1843,49,50-100,1892,1
STAT,1852,17,35-39,1869,0.5346318180143848
STAT,1828,61,na,1889,1044.707022336786
STAT,1832,37,35-39,1869,6.006680214602
SIM,1933,35,40-44,1968,6
STAT,1916,27,45-49,1943,1.8228768969135614
SIM,1822,37,na,1859,1516
STAT,1908,32,35-39,1940,8.795996334549892
STAT,1885,21,30-34,1906,18.183696979165173
STAT,1901,15,35-39,1916,0.7864139312972539
STAT,1953,19,15-19,1972,55.9639255363715
STAT,1862,47,20-24,1909,0.010372218476095936
STAT,1897,10,na,1907,3533.299444550025
STAT,1907,39,40-44,1946,1.4010277083697789
SIM,1893,49,na,1942,2916
STAT,1881,48,40-44,1929,0.16672907646849072
STAT,1925,35,40-44,1960,1.8362688750685525
STAT,1939,17,40-44,1956,1.4282629607935624
STAT,1866,27,na,1893,2245.6472102435346
STAT,1893,37,50-100,1930,1.5888789558946965
STAT,1922,38,25-29,1960,1.1420114002114263
SIM,1858,41,30-34,1899,1
STAT,1822,49,40-44,1871,0.237054238811742
SIM,1869,7,na,1876,2770
SIM,1925,28,50-100,1953,5
SIM,1930,38,25-29,1968,1
STAT,1954,16,25-29,1970,54.65907160013337
SIM,1893,21,30-34,1914,27
STAT,1888,81,na,1969,1078.9816133367585
SIM,1891,22,na,1913,3059
STAT,1917,25,40-44,1942,5.022127459594553
STAT,1871,81,na,1952,546.455851778528
STAT,1901,30,25-29,1931,14.729338415735473
STAT,1905,36,50-100,1941,0.39231178330018024
STAT,1794,87,na,1881,61.004313151120556
SIM,1860,17,35-39,1877,1
SIM,1913,23,20-24,1936,125
STAT,1859,15,25-29,1874,5.422793207729854
STAT,1959,5,na,1964,5244.864165024767
SIM,1856,8,na,1864,2903
SIM,1901,24,40-44,1925,4
SIM,1879,45,na,1924,2821
SIM,1921,32,45-49,1953,4
STAT,1911,20,40-44,1931,3.2721437754439853
STAT,1921,49,na,1970,4201.391233407959
SIM,1916,32,35-39,1948,13
SIM,1899,26,30-34,1925,46
SIM,1848,34,50-100,1882,1
STAT,1904,25,25-29,1929,62.26705548328651
STAT,1921,42,45-49,1963,0.1912845286879487
SIM,1861,24,na,1885,2517
STAT,1831,84,na,1915,224.15550766895058
STAT,1869,26,45-49,1895,1.0972996717633068
STAT,1913,42,na,1955,3694.7841996470356
SIM,1912,25,25-29,1937,82
STAT,1883,6,na,1889,2628.5582416266625
SIM,1855,83,na,1938,220
STAT,1899,36,30-34,1935,7.481093105014911
SIM,1835,22,25-29,1857,67
STAT,1798,104,na,1902,0.022960038957775396
SIM,1892,25,30-34,1917,46
STAT,1930,14,na,1944,5207.691885654779
STAT,1852,35,na,1887,1948.3220288643427
SIM,1900,41,40-44,1941,1
SIM,1921,18,30-34,1939,25
STAT,1934,22,35-39,1956,12.904434346155877
SIM,1909,38,30-34,1947,3
STAT,1926,31,40-44,1957,4.830079602266249
STAT,1924,37,45-49,1961,0.820148068967523
SIM,1932,33,30-34,1965,36
SIM,1835,23,35-39,1858,10
SIM,1900,28,40-44,1928,4
STAT,1916,45,45-49,1961,0.2285564201750472
SIM,1814,61,na,1875,1003
SIM,1846,78,na,1924,495
SIM,1930,39,35-39,1969,2
SIM,1879,20,40-44,1899,3
SIM,1838,91,na,1929,33
STAT,1855,94,na,1949,15.493173035287008
STAT,1862,3,na,1865,2810.010221623275
SIM,1910,46,na,1956,3463
STAT,1790,97,na,1887,1.0422415542594359
STAT,1863,49,30-34,1912,0.08477514136966224
SIM,1904,33,25-29,1937,10
STAT,1931,39,na,1970,5070.671012885102
SIM,1897,39,na,1936,3191
SIM,1898,15,25-29,1913,10
SIM,1840,37,35-39,1877,11
STAT,1900,19,35-39,1919,0.7716864407848856
STAT,1859,25,na,1884,2006.6088131675463
SIM,1932,32,20-24,1964,5
STAT,1872,35,na,1907,2431.6977806660393
STAT,1924,33,30-34,1957,18.74179194912864
STAT,1936,35,15-19,1971,0.019261601718367615
SIM,1861,32,50-100,1893,1
STAT,1936,20,45-49,1956,1.0979289373625887
STAT,1945,23,20-24,1968,124.2962142554694
SIM,1825,34,30-34,1859,3
STAT,1840,47,35-39,1887,0.10159199430216485
STAT,1783,95,na,1878,2.6760169687937143
STAT,1815,43,50-100,1858,3.1585353865990338
SIM,1814,44,50-100,1858,3
SIM,1877,25,35-39,1902,13
STAT,1868,21,30-34,1889,17.481222288526293
SIM,1951,15,40-44,1966,4
SIM,1936,25,15-19,1961,1
STAT,1913,18,30-34,1931,2.535684530917883
SIM,1862,65,na,1927,1468
STAT,1850,45,50-100,1895,0.18658329970389276
SIM,1853,37,na,1890,1933
SIM,1921,38,na,1959,4912
STAT,1862,68,na,1930,1327.0867989929284
STAT,1810,46,45-49,1856,0.7551325780331493
STAT,1844,48,50-100,1892,0.18792688075679254
STAT,1835,22,50-100,1857,0.40404268463254583
STAT,1943,15,40-44,1958,1.5140747565260697
STAT,1895,63,na,1958,2449.073039479438
STAT,1861,101,na,1962,1.4658103928365647
STAT,1872,66,na,1938,1675.7725718465535
STAT,1877,19,na,1896,2657.9773548323096
SIM,1849,38,35-39,1887,15
SIM,1903,18,15-19,1921,10
STAT,1912,17,30-34,1929,2.5143175949433996
STAT,1836,28,na,1864,1729.763510922964
STAT,1895,20,50-100,1915,0.5460119938204054
STAT,1895,15,35-39,1910,0.733731132063397
STAT,1806,86,na,1892,78.84014228279369
STAT,1890,7,na,1897,3249.7567991820893
SIM,1944,20,45-49,1964,1
SIM,1938,26,na,1964,3695
SIM,1910,27,15-19,1937,1
SIM,1865,26,50-100,1891,1
SIM,1881,38,35-39,1919,11
STAT,1857,26,50-100,1883,0.5287490174172672
STAT,1918,21,40-44,1939,3.7118227466103244
SIM,1860,30,na,1890,2079
STAT,1879,45,na,1924,2423.0472486127837
SIM,1920,17,30-34,1937,21
SIM,1815,55,na,1870,1223
STAT,1938,33,25-29,1971,9.474348715321977
STAT,1835,63,na,1898,1329.424220837868
STAT,1928,25,15-19,1953,0.8931557878164066
STAT,1869,22,30-34,1891,17.543467845147777
STAT,1946,25,30-34,1971,44.570331086148386
STAT,1901,16,45-49,1917,0.09341659565962858
SIM,1881,24,na,1905,2145
SIM,1844,12,na,1856,2456
STAT,1817,38,na,1855,1504.5725604914578
STAT,1867,28,35-39,1895,9.208556112342942
STAT,1948,19,35-39,1967,4.896113724015155
STAT,1835,43,na,1878,1852.9771105418258
STAT,1888,17,15-19,1905,7.157188122569891
SIM,1863,39,30-34,1902,8
SIM,1934,31,40-44,1965,11
STAT,1906,40,na,1946,3478.434571291112
STAT,1938,15,30-34,1953,12.322111403830835
SIM,1927,33,20-24,1960,2
SIM,1886,47,na,1933,2498
SIM,1915,0,na,1915,4860
STAT,1848,61,na,1909,1452.5523049034443
STAT,1884,25,30-34,1909,25.588081722445462
STAT,1914,16,na,1930,4086.333512709033
STAT,1922,39,35-39,1961,2.802277792603386
SIM,1807,68,na,1875,741
SIM,1938,23,25-29,1961,108
STAT,1790,107,na,1897,0.0010621748142558068
SIM,1942,22,35-39,1964,26
SIM,1922,29,35-39,1951,23
SIM,1856,48,50-100,1904,1
STAT,1832,40,50-100,1872,0.8908732983320263
STAT,1840,29,40-44,1869,2.6492634505750208
STAT,1919,33,20-24,1952,2.6741100263841493
STAT,1877,10,na,1887,2775.063529218119
STAT,1883,58,na,1941,1979.5067266929327
STAT,1891,25,na,1916,3034.6230774956957
STAT,1881,48,35-39,1929,0.1363438712582839
STAT,1830,39,25-29,1869,2.5276091877901754
STAT,1890,60,na,1950,2378.8955053183327
STAT,1902,17,45-49,1919,0.09397592787369694
STAT,1914,47,na,1961,3717.4399491067015
SIM,1944,26,na,1970,4047
STAT,1824,71,na,1895,734.9616570914485
STAT,1873,38,35-39,1911,7.278882853731019
SIM,1890,29,na,1919,3121
SIM,1905,17,35-39,1922,1
STAT,1922,20,15-19,1942,6.265917804376634
SIM,1836,24,35-39,1860,9
STAT,1950,22,20-24,1972,134.5758261487187
SIM,1900,21,20-24,1921,126
STAT,1925,0,na,1925,5552.378266225236
STAT,1851,73,na,1924,979.9165869058097
STAT,1903,29,25-29,1932,60.90558817905934
STAT,1766,92,na,1858,14.727485548113066
STAT,1863,45,15-19,1908,3.613473048397865E-4
STAT,1954,15,15-19,1969,57.25669639302802
STAT,1839,25,20-24,1864,10.347706183064332
STAT,1866,25,50-100,1891,0.6060151648639986
STAT,1878,17,50-100,1895,0.05202257654287283
STAT,1893,30,20-24,1923,3.526272573088568
STAT,1952,18,15-19,1970,55.46179226979209
STAT,1929,40,20-24,1969,0.0233915949901573
SIM,1822,38,30-34,1860,5
STAT,1953,15,50-100,1968,0.4625574144398257
STAT,1904,9,na,1913,3793.524388315116
SIM,1867,19,40-44,1886,2
STAT,1931,26,30-34,1957,51.61421449317586
STAT,1886,42,50-100,1928,1.1393650580658792
STAT,1886,78,na,1964,1132.9436421308567
STAT,1888,46,30-34,1934,0.11707421000841742
STAT,1904,17,na,1921,3692.6024220839727
SIM,1950,16,35-39,1966,9
STAT,1905,24,30-34,1929,26.079340797133614
STAT,1905,26,25-29,1931,62.53844989237125
SIM,1846,58,na,1904,1566
SIM,1908,41,45-49,1949,1
SIM,1929,15,30-34,1944,23
STAT,1927,45,15-19,1972,4.739016003755928E-4
SIM,1928,41,50-100,1969,1
STAT,1852,22,50-100,1874,0.39026237518423135
STAT,1804,71,na,1875,625.3150684731969
STAT,1860,24,30-34,1884,14.980956439317636
SIM,1868,50,na,1918,2166
STAT,1894,17,40-44,1911,0.24000872383884514
STAT,1892,48,45-49,1940,0.16806817533748952
STAT,1897,23,15-19,1920,4.486084512611505
STAT,1922,20,20-24,1942,130.88720141396854
SIM,1927,23,na,1950,4405
SIM,1830,63,na,1893,1184
STAT,1797,84,na,1881,114.16898627212261
STAT,1804,82,na,1886,174.51916430881028
STAT,1858,31,15-19,1889,0.1164114304768938
SIM,1868,32,30-34,1900,21
STAT,1913,25,50-100,1938,1.0186348354826749
STAT,1872,54,25-29,1926,0.0035218712692490126
SIM,1911,29,25-29,1940,60
SIM,1893,24,35-39,1917,11
SIM,1938,27,40-44,1965,8
STAT,1916,24,40-44,1940,3.5729479277162346
STAT,1764,110,na,1874,0.0031764223868664754
SIM,1906,28,40-44,1934,7
SIM,1884,15,30-34,1899,2
STAT,1858,20,na,1878,2013.46727317094
SIM,1941,25,25-29,1966,98
STAT,1859,76,na,1935,771.8639335006326
SIM,1826,33,35-39,1859,12
STAT,1876,15,30-34,1891,1.6868299206337847
STAT,1882,30,45-49,1912,1.747075728652475
SIM,1901,27,45-49,1928,2
SIM,1858,25,30-34,1883,38
STAT,1911,20,45-49,1931,1.0949835714077976
STAT,1902,19,50-100,1921,0.07010396567818163
SIM,1782,74,na,1856,405
STAT,1840,30,50-100,1870,0.8199092696709924
STAT,1933,25,25-29,1958,89.20558865884063
SIM,1850,63,na,1913,1326
SIM,1848,50,na,1898,1753
STAT,1848,18,25-29,1866,5.428407312490963
STAT,1863,101,na,1964,2.038356619948693
STAT,1920,26,20-24,1946,20.504667257608087
STAT,1881,29,30-34,1910,24.65882872040335
STAT,1841,104,na,1945,0.04924815312621924
SIM,1873,15,20-24,1888,23
SIM,1923,46,35-39,1969,1
STAT,1845,24,35-39,1869,5.579376803982297
STAT,1875,36,50-100,1911,1.291646742874637
STAT,1903,40,35-39,1943,0.18419332013474732
STAT,1920,44,20-24,1964,0.019838317807782474
SIM,1897,19,25-29,1916,9
SIM,1924,24,40-44,1948,6
STAT,1880,61,na,1941,2003.2326683871872
STAT,1840,33,na,1873,1879.8996323232054
STAT,1831,53,25-29,1884,0.0024982665445737458
SIM,1899,42,na,1941,3229
STAT,1903,47,25-29,1950,0.04689792031841353
STAT,1787,77,na,1864,395.6088368284336
STAT,1942,16,35-39,1958,4.475154678858517
STAT,1899,32,15-19,1931,0.19893920523010605
STAT,1921,39,50-100,1960,0.47736442992144196
SIM,1903,27,50-100,1930,1
STAT,1859,37,40-44,1896,3.566417041954319
STAT,1904,27,20-24,1931,17.152154067229777
SIM,1867,34,35-39,1901,20
STAT,1907,35,25-29,1942,0.9397014757334112
STAT,1924,32,20-24,1956,2.90334558317069
STAT,1849,45,30-34,1894,0.07590093041894132
SIM,1847,25,20-24,1872,15
SIM,1857,10,na,1867,2423
SIM,1912,27,20-24,1939,30
STAT,1904,43,25-29,1947,0.06472649364320786
STAT,1891,49,40-44,1940,0.11942242566992552
SIM,1878,80,na,1958,711
SIM,1932,37,45-49,1969,1
SIM,1870,29,na,1899,2611
STAT,1924,39,40-44,1963,1.7971313287977901
SIM,1780,96,na,1876,6
SIM,1928,35,30-34,1963,3
SIM,1930,20,20-24,1950,5
STAT,1876,25,na,1901,2531.0897367983102
SIM,1933,31,na,1964,5135
STAT,1796,107,na,1903,0.0010259198640225776
STAT,1889,19,25-29,1908,7.102596613517141
SIM,1913,26,25-29,1939,87
STAT,1871,25,na,1896,2428.001875883528
SIM,1833,29,na,1862,1867
STAT,1866,35,na,1901,2237.958476964097
STAT,1922,35,20-24,1957,0.30659057211602336
STAT,1872,36,25-29,1908,2.9579451247707844
STAT,1900,16,30-34,1916,2.2591862923015813
STAT,1923,22,25-29,1945,109.65810005313246
SIM,1866,35,30-34,1901,3
STAT,1868,23,25-29,1891,55.605900095809375
SIM,1835,26,40-44,1861,2
SIM,1890,42,50-100,1932,3
STAT,1888,50,na,1938,2634.15250953719
SIM,1932,39,40-44,1971,5
SIM,1821,48,50-100,1869,1
SIM,1889,24,15-19,1913,5
STAT,1841,74,na,1915,819.4153526560091
STAT,1909,60,na,1969,3206.0699634123384
STAT,1853,51,na,1904,1814.0665697380666
STAT,1859,19,40-44,1878,0.17094223552868199
STAT,1841,16,50-100,1857,0.0469304574270439
STAT,1925,38,45-49,1963,0.8339358967055337
STAT,1828,84,na,1912,183.18655510263244
SIM,1900,44,45-49,1944,2
SIM,1862,88,na,1950,69
SIM,1865,21,20-24,1886,68
STAT,1924,18,40-44,1942,1.6949165082886073
SIM,1843,81,na,1924,313
STAT,1851,81,na,1932,446.1401156023771
STAT,1811,53,na,1864,1185.0851359416577
SIM,1923,25,35-39,1948,20
STAT,1856,25,na,1881,2009.1220430355966
STAT,1807,48,na,1855,1478.7146975442417
STAT,1843,20,15-19,1863,3.3914031588360594
STAT,1832,52,30-34,1884,0.0041575477304970476
SIM,1876,23,25-29,1899,75
SIM,1915,35,25-29,1950,2
STAT,1872,46,50-100,1918,0.25182166638311687
STAT,1810,100,na,1910,0.45261466846917564
STAT,1831,35,25-29,1866,2.593997054167761
SIM,1827,31,30-34,1858,19
SIM,1851,25,na,1876,2158
STAT,1852,52,50-100,1904,0.012102029624870692
SIM,1887,49,na,1936,2616
STAT,1926,31,45-49,1957,1.9422067368892861
SIM,1838,38,50-100,1876,2
STAT,1921,36,15-19,1957,0.02190022838313092
STAT,1897,41,45-49,1938,0.14240544972551158
STAT,1921,42,15-19,1963,0.0017650246100819741
STAT,1911,35,45-49,1946,0.678021957872551
STAT,1902,30,40-44,1932,6.289147632777209
SIM,1928,37,25-29,1965,4
SIM,1872,95,na,1967,47
STAT,1840,28,30-34,1868,22.431821112425077
SIM,1828,30,na,1858,1901
STAT,1848,48,50-100,1896,0.18851418345828796
STAT,1857,21,20-24,1878,63.84176324952701
STAT,1873,35,30-34,1908,5.564462808640088
STAT,1815,66,na,1881,992.5606573355892
STAT,1830,54,20-24,1884,5.176111426691423E-4
STAT,1930,33,25-29,1963,12.157943407256328
STAT,1906,34,25-29,1940,8.658061842305633
SIM,1859,27,35-39,1886,11
SIM,1932,18,40-44,1950,2
STAT,1923,46,50-100,1969,0.2706346677802394
STAT,1851,47,45-49,1898,0.19379638129848162
SIM,1861,26,50-100,1887,4
STAT,1905,42,30-34,1947,0.11748012000217554
STAT,1825,33,na,1858,1732.125170396602
SIM,1904,30,20-24,1934,5
SIM,1913,36,30-34,1949,2
STAT,1921,27,20-24,1948,20.759839153348906
SIM,1948,16,na,1964,4224
SIM,1814,44,30-34,1858,1
SIM,1910,30,40-44,1940,6
SIM,1925,23,45-49,1948,1
STAT,1821,46,20-24,1867,0.019192317425001278
STAT,1855,66,na,1921,1270.5578418933803
SIM,1876,27,40-44,1903,5
STAT,1880,49,35-39,1929,0.14695050351964045
SIM,1818,44,50-100,1862,3
SIM,1883,50,na,1933,2286
SIM,1934,31,45-49,1965,5
STAT,1916,42,40-44,1958,0.26157151566636677
SIM,1894,22,30-34,1916,30
STAT,1946,21,15-19,1967,6.045739804726251
SIM,1825,96,na,1921,6
SIM,1852,33,50-100,1885,2
STAT,1917,23,45-49,1940,1.2165839571824084
STAT,1932,27,30-34,1959,52.33827843296781
STAT,1776,93,na,1869,6.337016524385485
STAT,1920,24,na,1944,4117.056983028658
SIM,1904,32,45-49,1936,1
STAT,1886,22,30-34,1908,19.23391887104177
SIM,1860,42,35-39,1902,9
SIM,1859,23,25-29,1882,65
STAT,1884,43,na,1927,2315.8432448360104
STAT,1847,99,na,1946,1.4768621533532371
STAT,1910,57,na,1967,3342.4232585668824
SIM,1914,34,25-29,1948,18
SIM,1847,16,50-100,1863,1
SIM,1896,20,40-44,1916,5
STAT,1869,86,na,1955,218.52772422220846
STAT,1921,24,15-19,1945,6.0969235960903845
SIM,1805,56,na,1861,1044
SIM,1924,26,35-39,1950,30
SIM,1815,63,na,1878,939
STAT,1865,15,20-24,1880,18.809108576483748
STAT,1877,17,35-39,1894,0.5805814426801659
STAT,1915,46,35-39,1961,0.1329034158102643
SIM,1827,43,50-100,1870,2
SIM,1839,35,50-100,1874,2
STAT,1926,28,15-19,1954,0.8602929587771644
STAT,1931,16,25-29,1947,57.98994056163858
STAT,1867,40,20-24,1907,0.15363502316484623
SIM,1853,21,30-34,1874,35
SIM,1907,26,35-39,1933,23
STAT,1829,49,30-34,1878,0.07634636094562167
STAT,1915,27,30-34,1942,40.78250453603484
STAT,1896,27,50-100,1923,0.8618917448137524
STAT,1905,36,30-34,1941,1.7030083388776944
STAT,1887,47,25-29,1934,0.06553751220919476
STAT,1768,116,na,1884,1.6147099267976064E-4
STAT,1926,46,45-49,1972,0.2742559382777491
SIM,1859,14,na,1873,2602
SIM,1864,22,15-19,1886,4
STAT,1832,34,30-34,1866,14.978581753581738
STAT,1850,48,40-44,1898,0.1271593735892567
STAT,1840,19,50-100,1859,0.04510880657165732
STAT,1901,45,50-100,1946,0.19960699491315145
SIM,1839,31,20-24,1870,2
SIM,1881,35,30-34,1916,6
SIM,1905,32,25-29,1937,7
SIM,1855,32,na,1887,1824
SIM,1913,24,30-34,1937,36
SIM,1917,47,20-24,1964,1
SIM,1801,83,na,1884,127
STAT,1822,44,15-19,1866,0.02026420093925378
SIM,1914,33,50-100,1947,3
SIM,1868,17,35-39,1885,1
STAT,1897,19,na,1916,3426.5442373494852
SIM,1851,20,15-19,1871,2
SIM,1840,34,30-34,1874,23
STAT,1794,104,na,1898,0.013221049893705905
STAT,1931,16,na,1947,4925.488609281707
STAT,1791,99,na,1890,0.3341502176725311
STAT,1917,41,45-49,1958,0.17749857213969863
STAT,1916,26,35-39,1942,15.895811281892694
STAT,1856,22,15-19,1878,3.0682848821365325
STAT,1931,32,30-34,1963,21.05437516642497
STAT,1850,15,50-100,1865,0.04556767462919045
SIM,1842,88,na,1930,90
SIM,1909,24,45-49,1933,1
STAT,1804,74,na,1878,470.55162486278147
STAT,1857,23,15-19,1880,3.012544144361183
SIM,1934,28,15-19,1962,2
STAT,1853,19,45-49,1872,0.06511427841419923
STAT,1845,21,30-34,1866,17.40272030714434
SIM,1849,20,25-29,1869,57
STAT,1827,48,na,1875,1611.94101806325
STAT,1888,20,40-44,1908,2.5281102339246457
SIM,1879,17,15-19,1896,10
STAT,1866,58,na,1924,1860.8602644518403
STAT,1882,65,na,1947,1679.6145817296206
STAT,1915,25,35-39,1940,15.732615724632588
STAT,1814,81,na,1895,251.98933821242164
STAT,1930,17,20-24,1947,178.76821695755228
STAT,1776,82,na,1858,150.0966866311327
STAT,1917,44,45-49,1961,0.17665324516856903
SIM,1944,18,30-34,1962,17
STAT,1878,30,25-29,1908,10.963649059377252
STAT,1952,18,50-100,1970,0.45785730088145327
SIM,1880,39,na,1919,2311
SIM,1922,26,30-34,1948,51
STAT,1787,85,na,1872,103.35275771403752
SIM,1866,1,na,1867,3261
SIM,1884,30,20-24,1914,2
SIM,1911,39,na,1950,3721
STAT,1900,32,30-34,1932,24.68716286649958
STAT,1933,4,na,1937,5510.109928875076
STAT,1783,92,na,1875,11.664105842928326
STAT,1863,49,35-39,1912,0.12260867559019877
STAT,1912,34,15-19,1946,0.1278879810548193
SIM,1873,29,na,1902,2372
SIM,1923,27,30-34,1950,4
STAT,1906,19,30-34,1925,2.3539583990548922
STAT,1909,47,20-24,1956,0.010356553998468914
SIM,1888,24,50-100,1912,1
SIM,1914,19,30-34,1933,7
STAT,1936,18,30-34,1954,11.87103672002751
STAT,1898,22,20-24,1920,95.06839794865618
STAT,1951,16,na,1967,4472.640646262791
SIM,1865,23,15-19,1888,3
SIM,1852,95,na,1947,3
SIM,1908,23,45-49,1931,1
SIM,1886,30,25-29,1916,17
STAT,1864,100,na,1964,3.6601118484247475
SIM,1856,88,na,1944,68
STAT,1828,100,na,1928,0.5846126110472698
STAT,1904,26,50-100,1930,0.938481991259704
STAT,1922,36,50-100,1958,0.4879110584422524
SIM,1911,26,20-24,1937,25
SIM,1930,36,50-100,1966,1
SIM,1892,21,15-19,1913,5
STAT,1893,33,25-29,1926,13.199492255348325
STAT,1937,15,15-19,1952,45.24379902052419
STAT,1933,22,20-24,1955,150.4174902847513
STAT,1942,15,50-100,1957,0.3996672248168194
STAT,1875,48,45-49,1923,0.24398976342439377
STAT,1920,29,25-29,1949,73.15650971927984
SIM,1877,20,35-39,1897,9
SIM,1856,5,na,1861,2957
SIM,1872,29,30-34,1901,25
STAT,1934,28,45-49,1962,2.3689410334223044
SIM,1828,31,45-49,1859,4
STAT,1862,65,na,1927,1467.5635026175667
STAT,1855,39,30-34,1894,4.089898015960266
SIM,1835,29,45-49,1864,5
SIM,1929,18,35-39,1947,8
STAT,1826,42,25-29,1868,0.5262592143900562
SIM,1900,47,na,1947,3116
STAT,1927,30,45-49,1957,1.976778658011221
SIM,1928,31,15-19,1959,2
STAT,1898,40,20-24,1938,0.015367637751565513
SIM,1873,18,25-29,1891,7
STAT,1916,42,na,1958,3883.8948321694984
SIM,1895,22,45-49,1917,1
STAT,1887,22,45-49,1909,0.7971315718456838
STAT,1901,31,40-44,1932,6.21195207715675
STAT,1860,41,50-100,1901,0.8783969231375793
SIM,1836,48,na,1884,1742
STAT,1896,5,na,1901,3530.9263389076705
SIM,1947,23,na,1970,4256
STAT,1830,36,20-24,1866,0.7062459067239474
STAT,1848,84,na,1932,258.59011459134825
STAT,1893,68,na,1961,2137.492710335033
STAT,1862,76,na,1938,822.7253644173337
SIM,1847,88,na,1935,62
SIM,1883,48,45-49,1931,1
STAT,1893,57,na,1950,2600.756851380084
STAT,1884,21,15-19,1905,3.3397000906627285
STAT,1856,28,na,1884,1966.1555357492894
STAT,1939,29,40-44,1968,4.775347675012381
STAT,1876,18,35-39,1894,0.5765119057698497
STAT,1880,20,50-100,1900,0.43977175992348605
SIM,1802,68,na,1870,678
SIM,1840,30,na,1870,1862
STAT,1889,16,20-24,1905,22.395364551357172
STAT,1941,15,35-39,1956,4.411782611274196
SIM,1842,96,na,1938,2
SIM,1903,31,45-49,1934,3
STAT,1829,28,50-100,1857,0.7420843692852847
STAT,1855,54,25-29,1909,0.002670255638778333
SIM,1828,40,50-100,1868,2
STAT,1869,41,50-100,1910,1.0452164256443013
STAT,1769,89,na,1858,17.159244120916803
STAT,1856,40,45-49,1896,1.2106081388182748
SIM,1872,48,35-39,1920,1
SIM,1900,24,25-29,1924,145
STAT,1931,29,35-39,1960,19.748512209863488
SIM,1843,100,na,1943,3
STAT,1929,24,20-24,1953,142.52098403151365
STAT,1859,34,35-39,1893,8.180033248511743
STAT,1864,48,35-39,1912,0.1253958709587053
SIM,1940,27,30-34,1967,51
STAT,1880,35,50-100,1915,1.3286764879459692
SIM,1897,16,20-24,1913,47
STAT,1914,16,25-29,1930,9.168548525473707
STAT,1869,20,35-39,1889,5.806455820369508
SIM,1910,54,na,1964,3358
STAT,1835,74,na,1909,826.8656044259
STAT,1873,53,30-34,1926,0.006057573873373766
STAT,1827,29,45-49,1856,2.1453426694894655
SIM,1866,20,25-29,1886,2
SIM,1922,16,25-29,1938,59
STAT,1899,38,50-100,1937,0.36835730324575083
STAT,1814,53,25-29,1867,0.00990398596624015
STAT,1803,89,na,1892,40.764439346429334
SIM,1848,73,na,1921,845
STAT,1876,28,na,1904,2505.1843079961127
STAT,1845,73,na,1918,928.0469089493079
STAT,1908,38,45-49,1946,0.647629234251346
SIM,1923,43,30-34,1966,1
STAT,1849,41,15-19,1890,0.010769918575336589
SIM,1816,44,30-34,1860,1
STAT,1811,52,50-100,1863,0.03996886282851278
STAT,1773,100,na,1873,0.210286116731372
STAT,1903,44,20-24,1947,0.015776981330381478
SIM,1858,80,na,1938,508
SIM,1883,35,30-34,1918,11
STAT,1851,25,50-100,1876,0.6269004861380869
STAT,1913,30,20-24,1943,2.4956144059951306
SIM,1815,86,na,1901,44
STAT,1862,22,40-44,1884,1.8524465362669875
SIM,1860,22,na,1882,2246
SIM,1941,24,40-44,1965,5
STAT,1918,24,45-49,1942,1.2306256188291078
STAT,1858,20,25-29,1878,53.90798749491644
STAT,1879,53,na,1932,2259.1757340323184
STAT,1767,109,na,1876,0.0021026773370379846
SIM,1939,19,35-39,1958,7
STAT,1831,46,50-100,1877,0.2034661675281666
STAT,1835,66,na,1901,1221.1705420320714
STAT,1875,35,30-34,1910,5.633119845969846
STAT,1922,22,45-49,1944,1.3165845894510348
SIM,1870,37,50-100,1907,1
SIM,1930,22,45-49,1952,4
STAT,1935,37,20-24,1972,0.3759088238683491
SIM,1853,29,na,1882,1996
SIM,1918,28,30-34,1946,56
SIM,1870,22,40-44,1892,1
SIM,1900,44,na,1944,3211
STAT,1852,32,25-29,1884,8.543400341879877
SIM,1927,17,20-24,1944,220
STAT,1919,17,20-24,1936,152.88884857829862
STAT,1772,101,na,1873,0.07246453735549474
STAT,1810,49,15-19,1859,0.0012140724221435986
STAT,1911,17,15-19,1928,9.26357887828033
SIM,1931,34,25-29,1965,17
STAT,1915,43,30-34,1958,0.13113574002034525
STAT,1846,46,25-29,1892,0.04130796225056436
SIM,1860,32,25-29,1892,12
SIM,1900,26,45-49,1926,3
STAT,1848,15,20-24,1863,17.286595066547353
STAT,1872,26,15-19,1898,0.46547084010430123
STAT,1814,41,na,1855,1517.5799533584488
STAT,1923,38,40-44,1961,1.7679727646742027
SIM,1873,40,na,1913,2330
SIM,1888,23,15-19,1911,3
SIM,1831,28,30-34,1859,29
SIM,1846,47,na,1893,1829
STAT,1903,26,20-24,1929,17.070918562581404
STAT,1911,32,40-44,1943,3.8870059008869746
STAT,1846,21,45-49,1867,0.6197394162285748
SIM,1941,22,20-24,1963,2
STAT,1834,47,45-49,1881,0.1684301608705615
STAT,1881,44,25-29,1925,0.6247960035133517
STAT,1923,34,25-29,1957,10.79697999890712
STAT,1897,37,50-100,1934,1.6746860503496528
STAT,1839,28,25-29,1867,36.51395314151138
SIM,1917,24,na,1941,3805
STAT,1871,37,20-24,1908,0.7789617870034548
STAT,1847,22,45-49,1869,0.6666217968868313
SIM,1868,35,35-39,1903,12
SIM,1932,35,25-29,1967,4
STAT,1913,48,25-29,1961,0.05267169046695969
STAT,1924,35,25-29,1959,1.1865935580968179
STAT,1868,27,40-44,1895,2.918779659709129
SIM,1931,38,40-44,1969,3
STAT,1874,21,20-24,1895,71.9933247822985
STAT,1770,97,na,1867,0.5703635337383748
STAT,1822,48,na,1870,1496.1751789092334
STAT,1858,91,na,1949,46.88022822204338
STAT,1861,21,50-100,1882,0.35570620838367495
SIM,1886,24,na,1910,2589
STAT,1891,20,45-49,1911,0.8859705602959174
STAT,1869,46,na,1915,2222.1784641987156
STAT,1866,8,na,1874,2606.304210111612
STAT,1890,19,30-34,1909,1.9774303781877034
SIM,1847,28,25-29,1875,61
SIM,1858,22,50-100,1880,2
STAT,1906,32,na,1938,3573.4440685681393
STAT,1933,24,40-44,1957,4.545303384586889
STAT,1798,69,na,1867,850.0291434663349
STAT,1907,37,45-49,1944,0.6445056961333148
STAT,1863,46,30-34,1909,0.08682875183795057
STAT,1836,32,40-44,1868,3.4122276528798166
STAT,1906,31,20-24,1937,2.3140419152598306
STAT,1921,21,45-49,1942,1.3007531227692741
STAT,1812,106,na,1918,0.005537900148040596
STAT,1842,99,na,1941,1.485179245411417
SIM,1925,21,25-29,1946,151
STAT,1930,19,40-44,1949,1.8344387472630577
STAT,1901,40,na,1941,3341.937931527613
STAT,1880,49,30-34,1929,0.10160577667324895
STAT,1940,22,25-29,1962,95.99404475186984
STAT,1852,66,na,1918,1320.3892583427564
SIM,1859,20,20-24,1879,88
SIM,1936,23,20-24,1959,92
SIM,1839,22,na,1861,2019
STAT,1833,27,50-100,1860,0.5638321115858401
STAT,1886,25,35-39,1911,10.489715812657215
SIM,1852,23,35-39,1875,9
SIM,1927,31,na,1958,4610
SIM,1904,18,30-34,1922,3
STAT,1844,23,35-39,1867,5.605448484398443
STAT,1887,16,50-100,1903,0.0561417996908134
STAT,1905,20,15-19,1925,4.889600214335404
SIM,1908,20,40-44,1928,6
STAT,1915,57,na,1972,3611.7651302587
SIM,1829,55,na,1884,1140
STAT,1822,47,50-100,1869,0.3501901056961909
STAT,1823,47,35-39,1870,0.21046819742071113
SIM,1913,39,35-39,1952,3
SIM,1787,74,na,1861,323
STAT,1868,50,na,1918,2128.125099694601
STAT,1937,35,30-34,1972,1.862202607653445
SIM,1919,25,15-19,1944,1
SIM,1899,29,35-39,1928,21
STAT,1870,40,na,1910,2328.1706051378337
SIM,1915,37,45-49,1952,1
STAT,1917,21,25-29,1938,100.48573867692427
SIM,1869,32,45-49,1901,2
SIM,1819,48,na,1867,1385
STAT,1788,70,na,1858,715.859168597542
SIM,1844,32,40-44,1876,8
SIM,1916,38,45-49,1954,2
STAT,1900,35,35-39,1935,10.095733854933586
STAT,1890,38,35-39,1928,8.778556972224067
SIM,1835,55,na,1890,1417
SIM,1915,32,20-24,1947,4
STAT,1855,29,20-24,1884,9.343555230436538
STAT,1955,0,na,1955,5363.0683302682355
SIM,1878,21,35-39,1899,12
STAT,1821,49,25-29,1870,0.08808437099062008
STAT,1920,47,25-29,1967,0.05983882346464271
SIM,1913,20,15-19,1933,7
SIM,1795,92,na,1887,11
STAT,1893,43,35-39,1936,0.16155899050923747
STAT,1864,91,na,1955,52.563439617707246
STAT,1915,19,45-49,1934,0.10611673032135474
SIM,1848,25,35-39,1873,10
STAT,1875,94,na,1969,88.87470022292257
SIM,1845,22,na,1867,2000
SIM,1862,101,na,1963,8
STAT,1937,33,45-49,1970,1.5870099511773217
SIM,1771,90,na,1861,5
SIM,1829,32,45-49,1861,4
STAT,1857,98,na,1955,2.5881741332581822
STAT,1907,32,20-24,1939,2.3248649907622347
STAT,1839,25,na,1864,1908.1089438005467
STAT,1866,15,35-39,1881,0.5362579737464458
STAT,1868,61,na,1929,1820.7374904214373
STAT,1790,74,na,1864,473.91696421406454
SIM,1866,47,na,1913,2285
SIM,1896,38,50-100,1934,6
STAT,1831,31,50-100,1862,0.8500379174602274
STAT,1926,43,40-44,1969,0.31407053082716047
SIM,1822,45,na,1867,1366
SIM,1873,30,45-49,1903,2
STAT,1888,23,45-49,1911,0.8383852635472003
SIM,1906,49,40-44,1955,1
SIM,1853,24,35-39,1877,6
STAT,1842,53,30-34,1895,0.004593066715400613
SIM,1858,28,35-39,1886,13
SIM,1909,49,50-100,1958,1
STAT,1796,104,na,1900,0.01451008649290425
SIM,1896,23,45-49,1919,2
STAT,1865,18,25-29,1883,5.37492701318466
STAT,1874,13,na,1887,2710.583955835806
SIM,1937,24,20-24,1961,143
STAT,1821,74,na,1895,584.7911592741598
STAT,1885,24,35-39,1909,5.902047270915933
STAT,1786,92,na,1878,9.473201916740303
STAT,1828,33,na,1861,1570.3773497104714
STAT,1857,10,na,1867,2263.463839172121
STAT,1928,23,20-24,1951,141.1737058663188
SIM,1874,15,35-39,1889,1
SIM,1894,25,35-39,1919,18
STAT,1899,45,na,1944,3174.8835311301336
STAT,1850,88,na,1938,103.26537981951586
SIM,1885,43,50-100,1928,4
SIM,1943,16,na,1959,3661
SIM,1769,89,na,1858,50
SIM,1906,6,na,1912,3887
SIM,1914,31,20-24,1945,2
STAT,1929,43,25-29,1972,0.09417256162484823
STAT,1928,41,20-24,1969,0.022997531873650248
STAT,1891,15,50-100,1906,0.062164129709282305
STAT,1894,53,na,1947,2780.1368019455363
STAT,1905,39,35-39,1944,2.2266113135557495
STAT,1867,43,25-29,1910,0.6105714285358492
SIM,1850,26,50-100,1876,1
SIM,1909,21,40-44,1930,3
SIM,1901,18,na,1919,3717
STAT,1900,47,na,1947,3166.9197430298263
SIM,1830,47,50-100,1877,2
SIM,1935,30,45-49,1965,4
STAT,1834,34,30-34,1868,14.741075145652362
SIM,1842,34,30-34,1876,31
SIM,1893,57,na,1950,2647
SIM,1838,16,15-19,1854,6
STAT,1917,41,40-44,1958,0.2667596766314077
SIM,1912,26,50-100,1938,2
STAT,1876,1,na,1877,3638.920895968874
SIM,1889,75,na,1964,1667
STAT,1842,26,50-100,1868,0.6248513201256232
STAT,1853,16,40-44,1869,0.18557994496976746
SIM,1798,66,na,1864,749
SIM,1885,33,40-44,1918,1
STAT,1846,36,15-19,1882,0.042373269009216494
STAT,1887,40,45-49,1927,1.7281225458163436
STAT,1910,54,na,1964,3404.6879095735344
STAT,1877,33,40-44,1910,4.569254886133863
SIM,1877,39,na,1916,2375
SIM,1903,17,30-34,1920,1
SIM,1832,24,30-34,1856,22
SIM,1886,44,na,1930,2546
STAT,1870,41,45-49,1911,1.4992968268086477
SIM,1833,51,na,1884,1506
SIM,1922,25,20-24,1947,31
STAT,1895,60,na,1955,2538.477021114307
STAT,1847,19,15-19,1866,5.708159139114002
SIM,1921,5,na,1926,5277
SIM,1882,54,na,1936,2010
STAT,1927,41,35-39,1968,0.2579850165121871
SIM,1862,30,35-39,1892,18
STAT,1829,39,20-24,1868,0.6563624738818019
STAT,1949,18,45-49,1967,0.5925486444421474
STAT,1858,48,45-49,1906,0.18852682065662116
SIM,1868,36,45-49,1904,5
STAT,1859,22,na,1881,1999.1623284470572
SIM,1873,19,35-39,1892,1
STAT,1912,37,20-24,1949,0.26246476898896615
STAT,1924,15,35-39,1939,5.12179281412335
SIM,1878,49,na,1927,2509
STAT,1920,22,40-44,1942,3.814620718177726
SIM,1887,30,40-44,1917,7
STAT,1897,16,50-100,1913,0.066990842640447
STAT,1879,30,40-44,1909,4.661651550957703
SIM,1863,42,50-100,1905,5
STAT,1879,53,50-100,1932,0.015846311144486237
SIM,1844,15,na,1859,2412
STAT,1868,42,30-34,1910,1.1188200409439835
STAT,1844,29,45-49,1873,1.0381878670184634
SIM,1885,35,35-39,1920,6
SIM,1914,26,40-44,1940,8
STAT,1828,40,35-39,1868,1.5296582189517645
SIM,1941,6,na,1947,4008
STAT,1865,19,35-39,1884,0.5173885450021157
SIM,1869,17,20-24,1886,22
STAT,1828,30,na,1858,1616.5146820400764
SIM,1821,36,20-24,1857,1
STAT,1856,28,25-29,1884,34.85035109909239
STAT,1850,47,30-34,1897,0.07247396775636829
STAT,1879,22,na,1901,2521.981409802721
SIM,1872,32,50-100,1904,1
STAT,1930,26,15-19,1956,0.915937757528533
SIM,1883,38,35-39,1921,9
SIM,1855,19,15-19,1874,5
STAT,1860,19,na,1879,2165.537559719097
STAT,1922,27,35-39,1949,17.334623603853487
STAT,1877,18,15-19,1895,6.262813203209198
STAT,1891,70,na,1961,1943.2186840025827
SIM,1965,0,na,1965,4980
STAT,1877,35,35-39,1912,7.554833096183505
STAT,1930,37,40-44,1967,1.9915039649818729
STAT,1898,25,25-29,1923,58.75294089658164
STAT,1903,25,45-49,1928,1.6210459431658197
STAT,1892,44,30-34,1936,0.1006965854772268
STAT,1936,32,45-49,1968,1.5589142489884806
SIM,1830,27,30-34,1857,31
SIM,1859,42,na,1901,2192
SIM,1901,40,na,1941,3516
STAT,1848,15,50-100,1863,0.0477706105126782
STAT,1865,28,35-39,1893,8.902522573601333
SIM,1863,29,20-24,1892,15
SIM,1880,53,na,1933,2013
STAT,1875,47,35-39,1922,0.14589812145313155
STAT,1829,46,25-29,1875,0.047219771124573026
SIM,1905,26,30-34,1931,61
STAT,1894,32,30-34,1926,22.910959117601667
STAT,1880,27,20-24,1907,12.57646318579593
STAT,1896,37,25-29,1933,3.879296241561701
STAT,1901,37,45-49,1938,0.6138236242312828
STAT,1911,10,na,1921,4043.3876410378434
SIM,1903,30,35-39,1933,20
STAT,1818,103,na,1921,0.07313766561182514
STAT,1891,15,30-34,1906,2.022406764384667
STAT,1798,60,na,1858,1188.978600226895
STAT,1873,25,20-24,1898,12.215564546027466
SIM,1853,51,na,1904,1814
STAT,1868,84,na,1952,324.1361531006213
STAT,1923,2,na,1925,4899.974873179096
SIM,1799,62,na,1861,1107
SIM,1914,13,na,1927,4139
STAT,1927,11,na,1938,5033.017430113847
SIM,1888,36,30-34,1924,5
STAT,1870,23,na,1893,2351.2867568838356
SIM,1859,45,35-39,1904,1
SIM,1818,60,na,1878,1057
STAT,1890,49,25-29,1939,0.039681284556783165
SIM,1864,28,25-29,1892,43
SIM,1843,36,40-44,1879,8
STAT,1884,38,45-49,1922,2.002011994669801
SIM,1836,40,35-39,1876,6
SIM,1923,19,45-49,1942,1
STAT,1921,28,30-34,1949,44.404738774309415
STAT,1919,47,15-19,1966,4.0772725252898306E-4
SIM,1865,62,na,1927,1703
SIM,1910,23,na,1933,3562
SIM,1876,42,30-34,1918,5
STAT,1814,50,20-24,1864,0.0021910423330959933
STAT,1866,54,30-34,1920,0.005447143063372349
STAT,1895,31,35-39,1926,13.534320395658064
STAT,1882,16,30-34,1898,1.5880005072801984
STAT,1761,111,na,1872,5.658524032528207E-4
STAT,1840,64,na,1904,1250.919147181294
STAT,1929,37,30-34,1966,2.3865384806274577
STAT,1931,32,50-100,1963,1.1048848716961828
STAT,1881,41,20-24,1922,0.15734243504956774
SIM,1892,38,45-49,1930,5
STAT,1946,6,na,1952,4477.249881242354
SIM,1907,23,30-34,1930,37
SIM,1890,15,20-24,1905,33
SIM,1911,25,45-49,1936,4
STAT,1833,48,40-44,1881,0.1191749362161758
SIM,1919,8,na,1927,4542
STAT,1875,22,20-24,1897,72.152115374593
STAT,1923,21,na,1944,4348.389214612748
SIM,1869,52,na,1921,2119
STAT,1847,35,20-24,1882,0.6367744742923841
SIM,1859,76,na,1935,773
STAT,1812,69,na,1881,789.598518169561
STAT,1817,47,45-49,1864,0.5272949149311413
SIM,1940,21,20-24,1961,118
SIM,1855,52,na,1907,1689
SIM,1863,36,25-29,1899,4
STAT,1849,18,40-44,1867,0.17375962961829566
SIM,1818,44,35-39,1862,3
STAT,1914,25,20-24,1939,18.902538057962566
SIM,1910,33,45-49,1943,2
STAT,1906,63,na,1969,2956.5237850165945
STAT,1887,46,15-19,1933,4.5855119640296206E-4
STAT,1904,47,40-44,1951,0.14053499287536073
STAT,1906,26,40-44,1932,4.463214498345704
SIM,1901,60,na,1961,3024
STAT,1835,36,40-44,1871,4.076014056717113
SIM,1886,39,30-34,1925,9
STAT,1875,32,na,1907,2498.4930968152576
SIM,1923,24,25-29,1947,121
STAT,1913,36,25-29,1949,0.9960310424372019
SIM,1857,48,35-39,1905,1
STAT,1913,11,na,1924,4125.44942081309
STAT,1845,47,20-24,1892,0.00933245151912777
SIM,1826,39,45-49,1865,2
STAT,1818,39,45-49,1857,5.975707666115953
STAT,1957,15,50-100,1972,0.5040406396189153
STAT,1868,47,50-100,1915,0.23818897035070918
SIM,1865,24,25-29,1889,69
STAT,1889,34,15-19,1923,0.17791770843234828
STAT,1909,20,50-100,1929,0.6274201077710749
SIM,1888,27,30-34,1915,57
STAT,1919,16,na,1935,4380.544790654802
SIM,1873,26,na,1899,2511
STAT,1902,33,45-49,1935,2.4981550612108725
SIM,1903,41,na,1944,3283
SIM,1921,36,25-29,1957,2
SIM,1889,37,50-100,1926,1
SIM,1907,27,50-100,1934,4
STAT,1915,24,25-29,1939,96.82346798221795
STAT,1932,21,20-24,1953,149.23819773139812
SIM,1838,38,25-29,1876,3
STAT,1937,30,40-44,1967,3.9536545443319393
STAT,1891,48,30-34,1939,0.06809727406084543
STAT,1895,38,20-24,1933,1.0209193056539374
SIM,1788,90,na,1878,80
STAT,1935,36,45-49,1971,0.9730205263755803
SIM,1906,25,35-39,1931,29
STAT,1808,95,na,1903,4.426213028932543
STAT,1876,37,40-44,1913,4.611390091742617
SIM,1857,32,20-24,1889,5
SIM,1899,18,45-49,1917,1
STAT,1873,37,na,1910,2436.6684036725796
STAT,1874,48,30-34,1922,0.09955634066198057
STAT,1911,2,na,1913,4160.980677989965
STAT,1943,19,20-24,1962,146.5810672971204
SIM,1835,32,na,1867,1863
SIM,1840,33,na,1873,1734
SIM,1894,40,25-29,1934,2
STAT,1819,35,45-49,1854,6.633190948128558
STAT,1881,26,25-29,1907,41.86411077892514
STAT,1822,45,na,1867,1554.7925172818532
STAT,1813,96,na,1909,3.69249757644939
STAT,1874,24,25-29,1898,59.251583452851456
STAT,1904,21,45-49,1925,1.0226080940798281
STAT,1899,42,na,1941,3235.8936726973075
SIM,1912,21,45-49,1933,2
STAT,1834,46,35-39,1880,0.11121370610943555
STAT,1859,21,25-29,1880,53.55971789729461
SIM,1847,38,35-39,1885,4
STAT,1849,46,na,1895,1751.6467660849978
STAT,1862,14,na,1876,2352.7868096091415
SIM,1829,38,na,1867,1465
STAT,1815,97,na,1912,2.777854546033445
SIM,1822,35,25-29,1857,5
SIM,1897,16,na,1913,3412
STAT,1897,29,25-29,1926,57.28828819040854
STAT,1845,49,15-19,1894,3.060129485357392E-4
SIM,1842,37,35-39,1879,1
SIM,1808,84,na,1892,120
SIM,1921,33,20-24,1954,4
STAT,1878,39,30-34,1917,5.602313960407468
STAT,1931,30,na,1961,5059.859713039818
STAT,1822,32,50-100,1854,2.8864501502090034
STAT,1874,23,15-19,1897,3.4255199165603187
STAT,1949,23,25-29,1972,109.92829073653584
SIM,1768,90,na,1858,11
SIM,1884,37,40-44,1921,6
STAT,1869,40,25-29,1909,0.6388476860175466
SIM,1867,21,25-29,1888,62
STAT,1877,41,na,1918,2456.5556150993184
STAT,1919,36,na,1955,4128.25936222563
STAT,1859,33,50-100,1892,0.7433288206504345
SIM,1912,58,na,1970,3501
STAT,1831,34,15-19,1865,0.1270780845991087
STAT,1864,22,45-49,1886,0.6426996390960039
STAT,1834,37,35-39,1871,5.920523114243123
STAT,1870,19,45-49,1889,0.06499183527653776
STAT,1886,26,45-49,1912,1.2030331203732674
STAT,1828,47,20-24,1875,0.009385054640432693
SIM,1926,36,45-49,1962,1
STAT,1917,28,50-100,1945,1.061481588333927
SIM,1863,81,na,1944,320
STAT,1831,81,na,1912,364.37858174790483
STAT,1808,47,35-39,1855,0.37122211053194787
STAT,1776,99,na,1875,0.3335490144836904
STAT,1859,22,35-39,1881,4.932698588896001
STAT,1766,110,na,1876,0.002713630723673946
STAT,1932,16,40-44,1948,1.893457622416934
SIM,1888,29,25-29,1917,74
SIM,1902,32,40-44,1934,1
STAT,1809,46,40-44,1855,0.774338938652882
STAT,1827,41,30-34,1868,1.3883029455233777
STAT,1849,32,20-24,1881,2.211346066206923
STAT,1929,39,25-29,1968,1.2865346953038876
STAT,1840,18,20-24,1858,16.42009108994223
STAT,1881,25,15-19,1906,0.45051239069712345
SIM,1880,59,na,1939,1782
STAT,1913,45,na,1958,3675.2961088935003
STAT,1835,97,na,1932,4.002674444436452
STAT,1851,46,35-39,1897,0.11583036630782664
SIM,1851,37,45-49,1888,6
STAT,1889,12,na,1901,3254.332421026259
SIM,1848,20,45-49,1868,1
STAT,1923,16,30-34,1939,14.63905537336629
STAT,1918,36,45-49,1954,0.7367900207115509
STAT,1843,37,45-49,1880,1.8787012483001468
SIM,1951,19,20-24,1970,218
STAT,1850,17,35-39,1867,0.5043637379628899
STAT,1852,50,25-29,1902,0.0028944566820441257
STAT,1893,51,na,1944,2799.9234982487574
SIM,1827,35,45-49,1862,6
SIM,1906,24,25-29,1930,119
STAT,1866,89,na,1955,98.85223166794044
STAT,1938,20,45-49,1958,1.136743607370026
SIM,1831,25,25-29,1856,45
SIM,1888,79,na,1967,1100
STAT,1873,43,50-100,1916,1.0847419728573895
STAT,1869,48,20-24,1917,0.011670396721578232
STAT,1875,38,35-39,1913,7.368693235971612
STAT,1832,69,na,1901,980.6535068718692
STAT,1872,35,15-19,1907,0.057959357601607295
SIM,1867,22,35-39,1889,10
STAT,1909,46,45-49,1955,0.20418526703579953
SIM,1883,81,na,1964,839
SIM,1852,48,50-100,1900,1
SIM,1931,16,30-34,1947,18
SIM,1949,21,40-44,1970,5
STAT,1928,40,40-44,1968,0.32614881666889134
STAT,1837,38,30-34,1875,4.281680825759191
STAT,1948,19,na,1967,4294.754632696069
STAT,1818,54,na,1872,1271.8529546309028
STAT,1919,44,50-100,1963,0.129484557945389
SIM,1845,38,30-34,1883,6
STAT,1906,33,50-100,1939,0.7778929418765796
SIM,1932,15,35-39,1947,6
STAT,1848,33,15-19,1881,0.11626182550143217
STAT,1841,17,25-29,1858,5.396318039256424
STAT,1931,20,50-100,1951,0.8755461169052723
SIM,1866,24,na,1890,2332
STAT,1954,13,na,1967,4952.378963196049
SIM,1926,38,na,1964,4916
STAT,1844,41,30-34,1885,0.9241859158492899
SIM,1858,53,35-39,1911,1
STAT,1858,23,30-34,1881,14.9376903026501
STAT,1862,0,na,1862,3346.7269732325444
STAT,1890,16,25-29,1906,7.085679183100438
STAT,1881,19,20-24,1900,17.39148010434142
STAT,1886,48,20-24,1934,0.012794931179914433
SIM,1868,59,na,1927,1868
SIM,1867,37,40-44,1904,1
STAT,1864,53,50-100,1917,0.013479477782071637
SIM,1929,37,40-44,1966,5
SIM,1904,29,na,1933,3608
STAT,1852,69,na,1921,1182.2553563404392
STAT,1860,37,45-49,1897,1.6500373654932374
SIM,1823,61,na,1884,1078
SIM,1941,15,na,1956,3547
STAT,1892,47,35-39,1939,0.10049942552361889
SIM,1907,8,na,1915,3962
STAT,1839,38,35-39,1877,5.773004977911461
STAT,1940,18,25-29,1958,44.87299481703271
STAT,1922,42,30-34,1964,0.14972856198248294
SIM,1842,46,35-39,1888,1
STAT,1853,31,30-34,1884,15.233478284972799
STAT,1879,15,15-19,1894,6.357740280686303
STAT,1838,54,na,1892,1538.5394144289305
STAT,1928,34,50-100,1962,1.0531514031947322
STAT,1824,54,50-100,1878,0.016319934986004207
SIM,1894,73,na,1967,1884
STAT,1855,51,20-24,1906,5.747708018042914E-4
STAT,1857,110,na,1967,0.0019318086566348799
STAT,1899,49,45-49,1948,0.1820868049682287
STAT,1840,98,na,1938,2.337643572340457
STAT,1861,29,45-49,1890,0.9292608581345072
STAT,1904,36,15-19,1940,0.01780621507180638
STAT,1903,7,na,1910,3778.195449008684
STAT,1907,15,35-39,1922,0.8257229572654863
STAT,1865,33,15-19,1898,0.13129923728348242
STAT,1839,29,35-39,1868,8.269009704896902
SIM,1847,29,35-39,1876,8
STAT,1880,42,15-19,1922,0.014786319459504912
STAT,1886,40,25-29,1926,0.7004056821760462
STAT,1840,25,25-29,1865,38.50520551792019
STAT,1854,30,35-39,1884,8.103844471378032
STAT,1918,18,15-19,1936,50.27651022637237
SIM,1917,46,45-49,1963,2
STAT,1940,13,na,1953,4081.0418343458855
SIM,1846,24,na,1870,2058
SIM,1888,59,na,1947,2218
STAT,1914,26,30-34,1940,40.439730800062144
STAT,1853,31,na,1884,2082.0392880982404
SIM,1861,31,30-34,1892,24
SIM,1879,39,25-29,1918,6
SIM,1871,28,30-34,1899,25
SIM,1909,18,15-19,1927,7
STAT,1846,39,20-24,1885,0.5638289805061416
SIM,1840,84,na,1924,220
STAT,1830,38,15-19,1868,0.05001539655174349
STAT,1839,43,15-19,1882,0.009917153675991766
STAT,1865,25,30-34,1890,23.474175574925166
SIM,1843,42,35-39,1885,1
SIM,1930,21,50-100,1951,1
SIM,1891,45,na,1936,2928
STAT,1899,22,na,1921,3303.9012383218337
SIM,1868,33,40-44,1901,3
STAT,1906,29,45-49,1935,1.6368458049566679
STAT,1891,18,35-39,1909,0.6912028081284959
SIM,1890,69,na,1959,1927
STAT,1875,2,na,1877,3421.0892291163323
STAT,1802,79,na,1881,260.2458296238597
STAT,1914,28,25-29,1942,67.46141936511707
STAT,1935,26,50-100,1961,1.3842816557974074
STAT,1765,100,na,1865,0.07179300914325268
SIM,1931,26,40-44,1957,6
STAT,1832,24,20-24,1856,66.39234570196089
SIM,1879,42,na,1921,2812
SIM,1889,21,45-49,1910,1
STAT,1877,36,45-49,1913,2.1194323839333182
STAT,1886,21,50-100,1907,0.44166643421363244
SIM,1858,31,25-29,1889,16
SIM,1848,28,40-44,1876,4
STAT,1834,21,20-24,1855,62.4711197801055
STAT,1879,76,na,1955,1010.2686255280028
STAT,1846,83,na,1929,283.8940406385593
STAT,1767,88,na,1855,29.1348
STAT,1822,79,na,1901,406.49055785198647
SIM,1885,36,45-49,1921,2
STAT,1840,15,15-19,1855,5.5948355198932855
SIM,1873,25,30-34,1898,32
STAT,1858,47,35-39,1905,0.11273304499045421
SIM,1837,67,na,1904,993
SIM,1898,33,20-24,1931,6
STAT,1916,23,30-34,1939,30.638793380805275
STAT,1923,26,40-44,1949,5.478789340804644
SIM,1874,37,50-100,1911,1
STAT,1860,52,40-44,1912,0.008667497085325973
STAT,1881,80,na,1961,806.5996739499567
SIM,1857,45,50-100,1902,1
STAT,1917,16,50-100,1933,0.08247703564181182
SIM,1922,28,25-29,1950,86
SIM,1824,60,na,1884,1059
STAT,1839,26,30-34,1865,22.052171160822066
STAT,1912,4,na,1916,4149.891011399836
SIM,1867,48,50-100,1915,1
SIM,1906,38,na,1944,3508
STAT,1895,30,25-29,1925,13.742602617040147
STAT,1891,41,50-100,1932,1.3403339318010576
STAT,1837,78,na,1915,520.9352610608985
STAT,1848,19,35-39,1867,0.5225365394170148
STAT,1865,16,30-34,1881,1.5297625677154347
SIM,1858,47,40-44,1905,2
STAT,1789,106,na,1895,0.0024152753943422487
SIM,1924,23,30-34,1947,34
STAT,1866,37,50-100,1903,1.1552693332770159
STAT,1824,103,na,1927,0.07902156792390896
STAT,1949,15,40-44,1964,1.6605476755927666
STAT,1920,25,45-49,1945,1.9471130128151894
STAT,1872,51,20-24,1923,7.580805162923929E-4
SIM,1920,15,45-49,1935,1
SIM,1844,17,15-19,1861,8
SIM,1840,53,na,1893,1489
SIM,1852,26,40-44,1878,4
STAT,1911,38,15-19,1949,0.01882569039614674
SIM,1845,30,35-39,1875,3
SIM,1873,16,30-34,1889,1
SIM,1864,15,na,1879,2437
SIM,1928,16,25-29,1944,81
STAT,1934,13,na,1947,5457.016941630707
STAT,1863,28,30-34,1891,22.444709143716167
STAT,1896,36,15-19,1932,0.07602419827803963
SIM,1798,69,na,1867,674
SIM,1889,72,na,1961,1937
STAT,1852,36,40-44,1888,3.5826674897996194
SIM,1840,24,20-24,1864,4
STAT,1844,26,40-44,1870,2.8622095370472493
SIM,1930,8,na,1938,5784
STAT,1837,32,50-100,1869,0.765936654057088
STAT,1917,29,20-24,1946,19.39587194359116
SIM,1826,36,40-44,1862,8
SIM,1905,22,na,1927,3430
STAT,1876,43,35-39,1919,1.8937846255468365
SIM,1955,7,na,1962,5094
STAT,1824,42,50-100,1866,1.3016903192878448
STAT,1854,33,40-44,1887,3.363873889495906
SIM,1839,48,na,1887,1641
STAT,1860,36,35-39,1896,5.882535275279619
STAT,1915,21,20-24,1936,117.6448454333559
STAT,1898,24,15-19,1922,4.522685436089312
STAT,1903,47,20-24,1950,0.009770400522098176
STAT,1835,49,50-100,1884,0.18808168333975775
SIM,1886,31,35-39,1917,13
SIM,1918,6,na,1924,4632
STAT,1871,50,na,1921,2207.096563494786
STAT,1908,38,50-100,1946,0.3988599991663573
STAT,1885,27,40-44,1912,3.0488214154245266
SIM,1860,36,40-44,1896,7
STAT,1817,78,na,1895,381.315778603248
STAT,1871,70,na,1941,1417.8410425005952
STAT,1792,75,na,1867,364.04912541779504
SIM,1846,32,45-49,1878,4
STAT,1873,51,na,1924,2237.56771811076
STAT,1850,22,15-19,1872,2.9784767064500697
SIM,1860,39,na,1899,2023
STAT,1913,33,20-24,1946,2.465266748732178
SIM,1819,40,35-39,1859,4
SIM,1888,39,35-39,1927,16
SIM,1870,24,35-39,1894,8
SIM,1947,20,na,1967,4327
STAT,1944,26,45-49,1970,1.90589563573347
SIM,1923,16,40-44,1939,2
SIM,1832,58,na,1890,1246
STAT,1862,24,35-39,1886,5.1133489533044525
STAT,1932,24,25-29,1956,123.1739740131202
SIM,1878,40,40-44,1918,8
SIM,1893,27,40-44,1920,6
STAT,1830,29,15-19,1859,0.45853028721932704
SIM,1842,21,20-24,1863,72
SIM,1898,16,35-39,1914,1
SIM,1832,75,na,1907,536
STAT,1868,20,20-24,1888,68.12078677818138
STAT,1921,47,40-44,1968,0.18136799667314096
SIM,1898,49,35-39,1947,1
STAT,1915,49,40-44,1964,0.1611685917313042
SIM,1866,38,35-39,1904,14
STAT,1940,16,30-34,1956,12.62891425917477
STAT,1818,36,40-44,1854,18.377152221707192
STAT,1915,16,40-44,1931,0.2994626226406767
SIM,1884,43,35-39,1927,5
SIM,1925,29,20-24,1954,35
STAT,1901,34,40-44,1935,6.133701638242639
SIM,1869,39,30-34,1908,3
STAT,1884,23,na,1907,2379.6266006413853
SIM,1887,71,na,1958,1649
SIM,1864,43,na,1907,2084
STAT,1860,27,35-39,1887,8.072129040568827
STAT,1875,60,na,1935,1996.8374386116616
STAT,1860,33,na,1893,1966.8484012994868
STAT,1931,17,35-39,1948,5.601407028219004
SIM,1862,33,40-44,1895,5
SIM,1844,35,45-49,1879,3
STAT,1858,29,na,1887,1948.1847517924493
SIM,1908,22,35-39,1930,13
STAT,1890,46,20-24,1936,0.008467194594742508
STAT,1840,24,15-19,1864,2.9757876924734292
STAT,1876,21,25-29,1897,60.48627308484552
STAT,1800,98,na,1898,1.565692169953527
STAT,1836,35,45-49,1871,1.5551045942453072
STAT,1857,24,25-29,1881,47.228271195855086
STAT,1897,41,na,1938,3177.817416147152
SIM,1931,22,25-29,1953,134
STAT,1873,31,50-100,1904,0.9514991824702725
SIM,1914,29,45-49,1943,3
STAT,1934,21,25-29,1955,126.63329956263173
STAT,1809,52,35-39,1861,0.036568090936940544
STAT,1878,31,35-39,1909,10.797484523868587
STAT,1831,50,20-24,1881,5.523384915121129E-4
STAT,1908,17,45-49,1925,0.0988100264552473
STAT,1809,49,na,1858,1572.6817723086713
SIM,1920,13,na,1933,4373
SIM,1853,26,na,1879,2000
SIM,1888,26,20-24,1914,19
SIM,1942,21,25-29,1963,163
SIM,1902,35,45-49,1937,1
STAT,1836,34,35-39,1870,7.804434102846772
SIM,1839,76,na,1915,712
SIM,1842,34,na,1876,1897
STAT,1906,33,15-19,1939,0.12090418775386357
STAT,1820,44,na,1864,1460.8649137037066
SIM,1876,20,20-24,1896,87
STAT,1810,45,35-39,1855,0.4559305428304362
STAT,1949,20,20-24,1969,132.46718220856397
STAT,1908,22,25-29,1930,86.59252128369647
SIM,1883,22,20-24,1905,90
STAT,1815,49,35-39,1864,0.36429166618224995
STAT,1880,46,30-34,1926,0.10406709591428559
SIM,1912,20,35-39,1932,17
STAT,1920,47,na,1967,4144.287374330872
STAT,1855,36,25-29,1891,2.242691184536198
SIM,1804,94,na,1898,24
SIM,1888,25,na,1913,2797
STAT,1829,36,15-19,1865,0.0497803144988661
STAT,1848,50,50-100,1898,0.011908574103820421
SIM,1919,23,20-24,1942,178
SIM,1940,24,25-29,1964,114
SIM,1827,32,40-44,1859,5
STAT,1817,48,50-100,1865,0.5402883130984191
STAT,1826,38,50-100,1864,1.068193413089319
SIM,1824,49,na,1873,1379
SIM,1910,18,20-24,1928,43
STAT,1945,22,45-49,1967,1.2581614552171139
STAT,1855,35,15-19,1890,0.043944338002071086
STAT,1902,18,20-24,1920,25.438248664528004
STAT,1808,64,na,1872,765.305009572343
STAT,1880,84,na,1964,608.7579098134661
STAT,1838,47,15-19,1885,3.0236363376314607E-4
STAT,1870,16,40-44,1886,0.18523097403278513
SIM,1849,24,40-44,1873,2
STAT,1851,43,30-34,1894,0.9416445487421643
STAT,1939,25,25-29,1964,67.55995317582392
SIM,1836,43,40-44,1879,8
STAT,1861,32,35-39,1893,8.536795021586963
STAT,1925,3,na,1928,4998.915518500717
SIM,1870,25,45-49,1895,2
SIM,1893,71,na,1964,1950
SIM,1874,39,40-44,1913,4
STAT,1899,27,35-39,1926,13.479260657619552
SIM,1872,72,na,1944,1243
SIM,1784,86,na,1870,98
STAT,1871,39,15-19,1910,0.05617444888282394
SIM,1923,21,20-24,1944,123
STAT,1908,31,25-29,1939,8.932704767838441
SIM,1894,23,40-44,1917,3
SIM,1835,86,na,1921,175
STAT,1838,32,45-49,1870,1.5921185737179853
STAT,1874,49,40-44,1923,0.17459229986286992
SIM,1916,22,25-29,1938,102
STAT,1878,50,45-49,1928,0.01563162043121671
STAT,1862,99,na,1961,4.059058291977797
STAT,1822,90,na,1912,45.84137513440971
STAT,1843,21,na,1864,2182.217904723646
STAT,1921,40,na,1961,4280.416281240353
STAT,1841,20,15-19,1861,3.130521217321641
SIM,1858,21,15-19,1879,6
STAT,1898,22,50-100,1920,0.5625682467860165
SIM,1823,43,50-100,1866,3
STAT,1828,43,40-44,1871,1.8095867464675233
STAT,1939,26,35-39,1965,15.403911980808282
STAT,1845,87,na,1932,137.65831683916085
STAT,1935,33,40-44,1968,5.517842275726371
STAT,1895,34,40-44,1929,5.72279771206871
SIM,1868,25,na,1893,2369
STAT,1866,18,40-44,1884,0.17561267600744396
STAT,1913,19,40-44,1932,0.29018000811229866
SIM,1847,35,30-34,1882,10
STAT,1848,27,50-100,1875,0.5936273922766996
STAT,1886,23,40-44,1909,2.2431691225569033
STAT,1829,45,15-19,1874,3.321677610058688E-4
SIM,1909,60,na,1969,3013
STAT,1847,45,30-34,1892,0.07623846183066736
SIM,1828,84,na,1912,237
SIM,1920,3,na,1923,4484
SIM,1807,48,40-44,1855,1
SIM,1858,43,25-29,1901,4
STAT,1946,18,na,1964,4163.899625207783
STAT,1900,38,40-44,1938,1.3293377007846487
STAT,1849,48,35-39,1897,0.10732477597120137
STAT,1891,18,50-100,1909,0.06171452500580988
STAT,1929,36,20-24,1965,0.34549381267999035
STAT,1862,25,45-49,1887,0.9817895986304966
SIM,1917,47,na,1964,3758
STAT,1825,53,30-34,1878,0.007236413608133369
SIM,1913,27,35-39,1940,2
STAT,1839,35,30-34,1874,4.4877089589937835
STAT,1858,26,35-39,1884,8.04881612061729
STAT,1880,33,na,1913,2547.4005245778235
STAT,1932,23,15-19,1955,7.100914149837512
SIM,1886,78,na,1964,1118
STAT,1888,36,20-24,1924,0.9341338316824527
STAT,1793,71,na,1864,650.273274788235
STAT,1841,46,50-100,1887,0.18451031419569966
STAT,1830,88,na,1918,86.84452081525585
STAT,1855,26,15-19,1881,0.36924963429488045
SIM,1907,20,25-29,1927,90
STAT,1906,19,35-39,1925,0.8103791063716888
SIM,1847,26,30-34,1873,34
STAT,1906,49,na,1955,3271.5240788711185
SIM,1873,57,na,1930,1992
SIM,1896,54,na,1950,2831
STAT,1932,19,45-49,1951,0.6709603025617759
SIM,1920,30,35-39,1950,2
SIM,1928,19,na,1947,4837
STAT,1842,52,50-100,1894,0.01178059591910282
STAT,1785,73,na,1858,494.423836119574
SIM,1857,33,na,1890,1954
SIM,1903,38,30-34,1941,3
STAT,1883,27,na,1910,2388.8272770259578
SIM,1940,23,15-19,1963,6
SIM,1916,31,25-29,1947,17
STAT,1909,43,40-44,1952,0.2371671342805658
STAT,1896,27,15-19,1923,0.611297680953618
STAT,1891,23,15-19,1914,4.153785565978284
SIM,1914,19,35-39,1933,2
STAT,1896,48,na,1944,2993.798470901224
SIM,1830,29,25-29,1859,51
SIM,1887,33,45-49,1920,5
SIM,1852,44,35-39,1896,3
STAT,1835,42,35-39,1877,1.6172683859839585
SIM,1839,34,25-29,1873,4
SIM,1907,48,45-49,1955,1
STAT,1871,21,50-100,1892,0.4133263646464805
STAT,1940,15,20-24,1955,140.50591837456378
STAT,1891,56,na,1947,2576.0535572230665
STAT,1824,32,15-19,1856,0.28537386924078467
STAT,1924,31,50-100,1955,0.9847071521426405
STAT,1928,43,45-49,1971,0.2160727154322557
SIM,1857,15,35-39,1872,2
SIM,1890,21,15-19,1911,3
STAT,1910,27,45-49,1937,1.701492434488683
STAT,1814,106,na,1920,0.005657872079010374
STAT,1912,30,35-39,1942,9.246794569558562
STAT,1928,44,20-24,1972,0.022888007420986435
SIM,1815,66,na,1881,813
SIM,1823,49,35-39,1872,1
SIM,1873,28,35-39,1901,11
SIM,1902,48,na,1950,3267
STAT,1905,27,35-39,1932,14.216196248859173
SIM,1932,31,50-100,1963,5
STAT,1919,32,45-49,1951,1.7324574992587685
SIM,1866,26,35-39,1892,10
SIM,1866,48,45-49,1914,1
STAT,1844,44,35-39,1888,1.4007751426652062
STAT,1849,15,35-39,1864,0.5305994363077209
SIM,1881,55,na,1936,1855
STAT,1904,20,35-39,1924,8.582761919972635
SIM,1927,32,45-49,1959,6
STAT,1879,33,45-49,1912,1.8516862849479607
STAT,1882,21,15-19,1903,3.2887225882443554
SIM,1838,19,15-19,1857,6
SIM,1844,34,35-39,1878,14
STAT,1825,36,na,1861,1726.2333698745035
STAT,1802,70,na,1872,610.7431842569262
STAT,1884,77,na,1961,1069.415992239236
STAT,1876,33,25-29,1909,10.744327158619104
STAT,1872,29,20-24,1901,11.908856126079252
STAT,1922,23,20-24,1945,129.7088431340324
STAT,1896,33,45-49,1929,2.3396297625240754
STAT,1891,44,15-19,1935,0.01720635495095369
SIM,1877,44,40-44,1921,4
STAT,1832,27,25-29,1859,38.52931005253354
STAT,1923,29,45-49,1952,2.009299206224877
SIM,1822,68,na,1890,808
STAT,1852,27,45-49,1879,1.041816742566801
STAT,1799,96,na,1895,2.7862749928660175
STAT,1841,27,35-39,1868,8.848739056898676
SIM,1854,28,30-34,1882,30
STAT,1848,100,na,1948,0.8252518422957577
STAT,1857,28,40-44,1885,2.4406079010002824
STAT,1879,48,15-19,1927,4.211821310512787E-4
STAT,1881,16,15-19,1897,5.867488673876728
SIM,1826,42,35-39,1868,3
SIM,1898,34,30-34,1932,3
STAT,1846,31,50-100,1877,0.7823972353740435
STAT,1854,15,45-49,1869,0.060516591152901436
STAT,1931,28,25-29,1959,86.62271648233528
SIM,1930,16,15-19,1946,64
SIM,1884,12,na,1896,2834
SIM,1899,65,na,1964,2534
SIM,1880,29,20-24,1909,12
STAT,1925,17,45-49,1942,0.6156614007121881
SIM,1918,27,20-24,1945,16
STAT,1847,68,na,1915,1191.7083343512345
SIM,1866,44,30-34,1910,3
SIM,1933,17,45-49,1950,3
SIM,1828,30,35-39,1858,17
SIM,1837,42,45-49,1879,1
STAT,1931,19,na,1950,4887.071491747487
STAT,1857,75,na,1932,820.191884726357
STAT,1846,28,30-34,1874,21.62896002758054
STAT,1914,29,35-39,1943,15.33189685159678
STAT,1806,83,na,1889,146.060210499432
STAT,1869,44,40-44,1913,2.185427934583554
STAT,1835,25,50-100,1860,0.6304497616447285
SIM,1956,14,na,1970,5505
STAT,1829,42,45-49,1871,1.2558840563187799
STAT,1898,21,45-49,1919,0.9648960023164243
STAT,1789,89,na,1878,30.27592558909989
STAT,1845,56,na,1901,1593.6618037234432
SIM,1927,18,30-34,1945,19
SIM,1884,33,25-29,1917,17
SIM,1842,68,na,1910,1152
STAT,1853,85,na,1938,229.86135966074198
STAT,1887,21,35-39,1908,6.690871624549995
SIM,1931,7,na,1938,5223
STAT,1914,17,35-39,1931,0.8856151886302993
STAT,1843,27,35-39,1870,9.586148601464304
SIM,1931,29,45-49,1960,4
SIM,1896,39,25-29,1935,3
SIM,1859,11,na,1870,2622
STAT,1863,27,20-24,1890,10.49321681713898
STAT,1919,39,30-34,1958,1.9938326150946504
STAT,1900,27,na,1927,3374.423912872345
STAT,1818,42,35-39,1860,4.636524327692796
STAT,1851,50,na,1901,1801.9283950906402
SIM,1871,45,na,1916,2089
SIM,1871,27,20-24,1898,2
SIM,1826,58,na,1884,1322
SIM,1831,70,na,1901,884
STAT,1851,21,20-24,1872,68.3857812095589
STAT,1895,32,50-100,1927,1.2195328603958366
STAT,1928,10,na,1938,5107.9297042237495
SIM,1889,22,20-24,1911,102
SIM,1922,17,35-39,1939,6
SIM,1884,21,25-29,1905,89
STAT,1884,26,50-100,1910,0.647846039245454
STAT,1910,24,40-44,1934,3.2002946031895525
SIM,1902,17,15-19,1919,8
STAT,1863,92,na,1955,37.25338994402134
STAT,1885,33,35-39,1918,10.263617018232575
STAT,1826,83,na,1909,231.5389658464528
SIM,1893,33,35-39,1926,20
STAT,1908,39,20-24,1947,0.24914299786880018
STAT,1827,68,na,1895,987.7036151168105
STAT,1913,3,na,1916,4216.813524940674
STAT,1906,18,na,1924,3740.3101552301796
STAT,1889,17,30-34,1906,2.008504426622269
STAT,1862,21,30-34,1883,15.949125644941663
STAT,1905,38,25-29,1943,0.911067696278899
SIM,1843,32,25-29,1875,15
SIM,1886,17,20-24,1903,18
SIM,1863,32,45-49,1895,2
SIM,1937,21,15-19,1958,5
STAT,1940,19,35-39,1959,4.343529955290828
STAT,1911,23,45-49,1934,1.0851255948919614
SIM,1945,16,25-29,1961,53
SIM,1831,28,na,1859,1795
SIM,1897,17,30-34,1914,1
STAT,1880,23,40-44,1903,2.22700201579935
STAT,1902,16,50-100,1918,0.07065505077968294
STAT,1855,54,50-100,1909,0.011385673429001273
STAT,1860,33,30-34,1893,14.39067100333002
STAT,1908,17,50-100,1925,0.07410751984143547
STAT,1936,17,20-24,1953,132.38781338972686
STAT,1823,36,15-19,1859,0.10871272310570308
SIM,1851,27,35-39,1878,15
STAT,1929,21,15-19,1950,6.886567778803661
STAT,1939,17,50-100,1956,0.3825703428952853
STAT,1922,16,15-19,1938,53.72362484097401
STAT,1899,39,35-39,1938,2.111188798552997
STAT,1841,39,35-39,1880,6.026445852659438
STAT,1826,37,45-49,1863,1.7812218165005234
STAT,1832,38,na,1870,1777.0143394586105
STAT,1909,21,30-34,1930,27.325408612723354
STAT,1837,49,20-24,1886,0.00809526068210023
STAT,1875,15,50-100,1890,0.05153334314857602
STAT,1873,46,20-24,1919,0.01244623258422231
STAT,1890,27,15-19,1917,0.5659199015069858
SIM,1927,39,30-34,1966,4
STAT,1867,31,25-29,1898,9.849755455609856
STAT,1869,27,20-24,1896,11.554405295835114
STAT,1821,48,15-19,1869,6.209033321539512E-4
STAT,1859,43,35-39,1902,1.4646398651971364
STAT,1934,29,20-24,1963,25.0174410264155
SIM,1857,33,30-34,1890,33
SIM,1897,30,na,1927,3248
SIM,1930,23,20-24,1953,156
SIM,1904,19,40-44,1923,4
SIM,1917,21,30-34,1938,37
STAT,1872,18,30-34,1890,1.625349778498643
SIM,1836,25,45-49,1861,1
SIM,1845,16,20-24,1861,16
STAT,1920,28,15-19,1948,0.7875043265992291
STAT,1937,16,25-29,1953,43.10779616854561
SIM,1929,27,30-34,1956,85
STAT,1897,32,15-19,1929,0.1942492775886395
STAT,1897,4,na,1901,3588.354334762807
STAT,1903,52,na,1955,3105.910409225761
STAT,1944,23,40-44,1967,3.702693760574733
STAT,1843,15,35-39,1858,0.5727976356482896
STAT,1858,44,30-34,1902,0.9175359438039872
STAT,1895,16,45-49,1911,0.08715850744630274
STAT,1944,25,50-100,1969,1.098528123519743
SIM,1845,93,na,1938,10
SIM,1925,22,na,1947,4530
STAT,1875,18,na,1893,2637.4083668334233
STAT,1880,30,na,1910,2578.7592560705125
SIM,1942,29,20-24,1971,19
SIM,1859,21,30-34,1880,13
STAT,1930,29,50-100,1959,1.2895565760592784
STAT,1862,46,45-49,1908,0.20552427721542896
STAT,1855,63,na,1918,1383.1895798745772
STAT,1845,22,40-44,1867,2.0212775090161137
STAT,1930,18,30-34,1948,16.029904970404367
STAT,1884,50,35-39,1934,0.008813837963476167
STAT,1857,20,45-49,1877,0.6506830443687288
SIM,1843,20,25-29,1863,63
SIM,1917,20,50-100,1937,1
SIM,1834,37,45-49,1871,1
STAT,1859,56,na,1915,1661.7203518096171
STAT,1910,40,45-49,1950,0.16224060512603355
SIM,1899,30,50-100,1929,3
SIM,1880,18,30-34,1898,1
STAT,1899,20,15-19,1919,4.636134353158525
SIM,1877,33,na,1910,2439
STAT,1825,31,20-24,1856,5.850901304452419
STAT,1855,32,45-49,1887,1.3764193915223037
SIM,1901,20,25-29,1921,107
STAT,1837,37,20-24,1874,0.6257492378707584
STAT,1835,32,25-29,1867,9.719858333924085
SIM,1865,28,40-44,1893,3
SIM,1853,22,40-44,1875,4
STAT,1892,22,20-24,1914,88.10888820736156
SIM,1944,17,20-24,1961,176
SIM,1919,26,25-29,1945,91
SIM,1825,37,35-39,1862,9
STAT,1913,32,45-49,1945,1.5971556235064202
SIM,1914,22,25-29,1936,129
STAT,1872,89,na,1961,194.74819780324577
STAT,1941,18,40-44,1959,1.4693446360796025
SIM,1844,31,30-34,1875,22
STAT,1853,82,na,1935,391.228755027926
STAT,1846,20,35-39,1866,5.223746468149985
SIM,1938,20,20-24,1958,122
SIM,1881,28,25-29,1909,38
STAT,1838,36,25-29,1874,2.5793146023171265
STAT,1916,45,40-44,1961,0.16580025041644772
SIM,1855,38,25-29,1893,5
STAT,1862,45,na,1907,1973.2399683039691
SIM,1831,73,na,1904,749
STAT,1877,95,na,1972,77.03749316216278
STAT,1878,38,20-24,1916,0.8144746156928167
SIM,1794,76,na,1870,362
SIM,1848,21,20-24,1869,79
STAT,1863,20,35-39,1883,5.400853125414389
STAT,1860,30,na,1890,1991.0604835017555
SIM,1868,21,40-44,1889,4
SIM,1887,40,na,1927,2805
STAT,1849,33,30-34,1882,14.136075130106802
SIM,1836,33,50-100,1869,1
SIM,1875,28,35-39,1903,14
STAT,1866,32,20-24,1898,2.5434976817144155
SIM,1918,40,na,1958,4170
STAT,1909,49,15-19,1958,3.43194697826519E-4
STAT,1820,37,50-100,1857,2.98673020325013
STAT,1886,58,na,1944,2135.4336912104086
STAT,1904,37,na,1941,3471.774089780386
STAT,1817,50,50-100,1867,0.033667876475499854
STAT,1951,21,25-29,1972,112.61838930544282
STAT,1835,20,25-29,1855,77.01864290936794
STAT,1900,24,na,1924,3323.1254645103754
SIM,1949,20,30-34,1969,60
SIM,1837,64,na,1901,1068
SIM,1943,7,na,1950,3927
SIM,1847,28,50-100,1875,3
STAT,1873,28,25-29,1901,43.59622607790901
SIM,1886,38,20-24,1924,1
STAT,1820,98,na,1918,1.7891487324034803
STAT,1893,28,45-49,1921,1.43183698936382
STAT,1877,21,40-44,1898,2.2115055147706526
SIM,1915,12,na,1927,4563
STAT,1906,22,25-29,1928,85.00090271344118
STAT,1921,40,20-24,1961,0.020354123860517485
STAT,1857,38,50-100,1895,0.9733141510696156
SIM,1841,80,na,1921,402
SIM,1895,29,30-34,1924,49
SIM,1838,60,na,1898,1191
STAT,1926,34,45-49,1960,1.9385770697751221
SIM,1828,39,na,1867,1818
SIM,1859,24,35-39,1883,5
SIM,1829,36,25-29,1865,6
SIM,1867,43,35-39,1910,5
STAT,1835,37,50-100,1872,1.1313761724840705
STAT,1831,53,na,1884,1474.7408280753475
STAT,1861,22,25-29,1883,49.575505964821915
SIM,1904,33,20-24,1937,2
STAT,1832,48,25-29,1880,0.04514542885424264
SIM,1846,36,25-29,1882,8
STAT,1873,82,na,1955,482.5626838895715
SIM,1839,38,40-44,1877,6
STAT,1842,45,na,1887,1810.4304799543938
STAT,1837,110,na,1947,1.842419400758027E-4
SIM,1905,39,45-49,1944,1
STAT,1816,103,na,1919,0.06367953922937056
SIM,1860,20,25-29,1880,59
STAT,1840,19,30-34,1859,1.4675401388305307
STAT,1898,29,40-44,1927,4.103001419007725
STAT,1866,49,50-100,1915,0.22627703741679736
SIM,1942,8,na,1950,4699
SIM,1837,98,na,1935,1
SIM,1896,27,25-29,1923,8
SIM,1849,27,45-49,1876,2
STAT,1877,39,15-19,1916,0.05881835445337182
STAT,1888,27,25-29,1915,51.01636812811027
SIM,1899,32,25-29,1931,19
STAT,1797,61,na,1858,960.4813314498948
SIM,1840,48,25-29,1888,1
SIM,1952,1,na,1953,4920
SIM,1828,38,30-34,1866,8
SIM,1937,28,35-39,1965,3
STAT,1857,42,20-24,1899,0.12637356436330663
STAT,1900,34,25-29,1934,14.358534099679359
SIM,1934,34,45-49,1968,1
STAT,1852,20,25-29,1872,55.58029423321914
STAT,1821,45,45-49,1866,0.38313540211525593
STAT,1936,31,35-39,1967,9.05848628333434
SIM,1930,33,50-100,1963,1
SIM,1821,80,na,1901,283
STAT,1882,15,20-24,1897,17.701841518907763
SIM,1870,21,30-34,1891,1
SIM,1875,35,40-44,1910,10
STAT,1846,49,30-34,1895,0.06777844706968582
SIM,1938,32,20-24,1970,4
SIM,1964,1,na,1965,5244
STAT,1919,18,30-34,1937,13.709336902580395
STAT,1888,39,25-29,1927,3.437422101621372
STAT,1852,39,45-49,1891,1.5897929222158067
SIM,1849,41,25-29,1890,3
STAT,1855,97,na,1952,4.164552966911813
STAT,1875,48,50-100,1923,0.2539147703331188
SIM,1907,24,40-44,1931,4
STAT,1888,36,na,1924,2855.031662255022
SIM,1879,34,50-100,1913,4
STAT,1875,23,30-34,1898,18.5920228073287
STAT,1878,29,na,1907,2516.0444098698513
STAT,1897,39,35-39,1936,2.061418203102816
SIM,1875,38,na,1913,2354
STAT,1856,31,15-19,1887,0.11664170888425508
STAT,1781,83,na,1864,121.76329001484996
STAT,1929,28,35-39,1957,19.155378783353918
SIM,1894,8,na,1902,3532
SIM,1921,15,na,1936,4848
STAT,1882,25,30-34,1907,25.197502789464494
STAT,1909,28,15-19,1937,0.6856567373146125
SIM,1929,1,na,1930,5560
STAT,1887,29,30-34,1916,28.580529501301342
SIM,1777,84,na,1861,47
STAT,1837,30,35-39,1867,8.64338390333766
SIM,1860,39,45-49,1899,2
SIM,1824,46,na,1870,1432
STAT,1939,22,20-24,1961,113.91885590629573
SIM,1834,27,35-39,1861,11
SIM,1942,14,na,1956,4653
STAT,1914,47,30-34,1961,0.09020487790274599
STAT,1791,90,na,1881,27.671296956479935
SIM,1871,20,35-39,1891,7
STAT,1869,15,na,1884,2551.90931108283
SIM,1877,26,45-49,1903,2
STAT,1884,16,35-39,1900,0.5551627467682685
STAT,1902,59,na,1961,2928.4544685861692
SIM,1830,26,20-24,1856,11
STAT,1833,31,na,1864,1850.8087970092517
STAT,1868,30,na,1898,2343.8334100646634
SIM,1834,20,15-19,1854,2
STAT,1817,37,35-39,1854,25.01615407719333
SIM,1828,53,na,1881,1471
STAT,1864,37,15-19,1901,0.05093680972188877
STAT,1867,35,40-44,1902,4.232289677486714
STAT,1853,50,40-44,1903,0.008954274016809038
STAT,1856,38,35-39,1894,5.635926727092269
SIM,1860,27,45-49,1887,3
SIM,1945,21,50-100,1966,1
SIM,1854,20,35-39,1874,6
STAT,1836,38,15-19,1874,0.04246220277303869
STAT,1836,31,30-34,1867,13.881096398786552
STAT,1879,37,25-29,1916,3.070246310253993
SIM,1840,27,25-29,1867,35
SIM,1947,22,20-24,1969,139
SIM,1892,16,35-39,1908,2
STAT,1893,37,na,1930,3048.979521905311
STAT,1847,48,35-39,1895,0.10780204921339746
SIM,1907,45,40-44,1952,1
STAT,1831,28,20-24,1859,11.286507080247473
STAT,1836,103,na,1939,0.08932871191099051
STAT,1857,45,25-29,1902,0.0463485214112721
SIM,1929,20,45-49,1949,2
SIM,1859,31,40-44,1890,6
STAT,1838,103,na,1941,0.10544797041912118
STAT,1924,37,na,1961,4526.15139993675
STAT,1800,92,na,1892,20.07367534345965
STAT,1855,19,50-100,1874,0.044640988652018196
SIM,1823,34,30-34,1857,26
SIM,1840,15,25-29,1855,7
SIM,1893,6,na,1899,3439
SIM,1948,21,25-29,1969,7
STAT,1859,110,na,1969,0.002696919634270154
SIM,1892,28,35-39,1920,19
STAT,1906,16,30-34,1922,2.3724627930748836
STAT,1884,28,35-39,1912,9.704216210794561
SIM,1864,97,na,1961,15
SIM,1914,16,30-34,1930,3
STAT,1861,104,na,1965,0.30676425865341483
SIM,1890,25,30-34,1915,33
SIM,1890,30,50-100,1920,7
SIM,1936,34,50-100,1970,2
STAT,1842,17,40-44,1859,0.18418736140526884
SIM,1887,37,25-29,1924,6
STAT,1854,16,na,1870,2114.0363441845934
STAT,1896,48,15-19,1944,3.0018769878964176E-4
STAT,1927,27,20-24,1954,22.637048616550516
SIM,1837,28,30-34,1865,36
SIM,1942,5,na,1947,4729
STAT,1775,83,na,1858,118.12201131812255
STAT,1860,64,na,1924,1438.864040413301
SIM,1879,11,na,1890,3176
STAT,1864,23,na,1887,2164.1409510312924
STAT,1928,22,50-100,1950,0.837986269866025
STAT,1852,24,40-44,1876,1.9657061050889553
STAT,1871,15,45-49,1886,0.0672259060296737
SIM,1875,52,na,1927,2127
STAT,1895,69,na,1964,2190.927292011488
SIM,1850,38,40-44,1888,6
SIM,1856,30,45-49,1886,2
STAT,1896,30,40-44,1926,5.89005751125044
STAT,1933,11,na,1944,5417.269079089323
STAT,1842,38,40-44,1880,3.9854023622427937
STAT,1935,18,15-19,1953,63.104469698942594
STAT,1856,25,20-24,1881,9.876257225626553
SIM,1828,50,na,1878,1562
SIM,1943,18,15-19,1961,48
SIM,1883,44,30-34,1927,2
STAT,1820,50,45-49,1870,0.026481945318497034
STAT,1924,1,na,1925,5073.733254168315
STAT,1841,24,30-34,1865,16.422256522565128
SIM,1872,16,15-19,1888,6
SIM,1929,33,25-29,1962,19
STAT,1893,25,50-100,1918,0.833472087131545
STAT,1860,15,35-39,1875,0.5300340461853775
STAT,1864,16,15-19,1880,6.155734788849033
SIM,1857,19,na,1876,2263
SIM,1936,14,na,1950,3441
STAT,1881,18,na,1899,2484.4219709660706
STAT,1854,37,20-24,1891,0.5899727552604778
STAT,1882,18,25-29,1900,5.617274169082861
STAT,1931,25,20-24,1956,24.05553474820025
SIM,1899,11,na,1910,3606
SIM,1918,41,35-39,1959,2
SIM,1931,19,35-39,1950,5
STAT,1850,29,35-39,1879,8.418969664411568
STAT,1929,15,20-24,1944,177.29255453365397
STAT,1953,17,na,1970,4541.929651114209
STAT,1801,77,na,1878,334.456011025577
SIM,1835,44,35-39,1879,5
SIM,1935,27,20-24,1962,31
STAT,1867,17,45-49,1884,0.0639565546461614
STAT,1913,26,15-19,1939,0.7200620746843923
SIM,1824,91,na,1915,17
SIM,1845,19,25-29,1864,8
STAT,1837,19,25-29,1856,5.372158888559302
STAT,1834,25,35-39,1859,8.63813500113512
SIM,1875,38,45-49,1913,2
SIM,1933,31,25-29,1964,3
SIM,1802,99,na,1901,2
STAT,1830,32,40-44,1862,4.147351071914723
STAT,1922,26,25-29,1948,76.2567194962368
STAT,1938,27,30-34,1965,39.5983430498357
SIM,1930,26,25-29,1956,124
STAT,1839,31,15-19,1870,0.12220966993974804
SIM,1885,24,45-49,1909,1
SIM,1890,18,25-29,1908,13
STAT,1824,39,35-39,1863,9.130303168610412
SIM,1791,65,na,1856,824
SIM,1860,24,40-44,1884,2
SIM,1813,51,na,1864,1293
SIM,1937,15,20-24,1952,149
STAT,1849,54,30-34,1903,0.004494241154408593
STAT,1844,36,50-100,1880,1.1163224008979244
SIM,1819,79,na,1898,387
STAT,1848,30,na,1878,2005.8602422020222
STAT,1848,30,45-49,1878,1.613962134006072
STAT,1870,50,40-44,1920,0.010649704769352909
SIM,1877,30,na,1907,2477
SIM,1852,36,50-100,1888,4
STAT,1840,36,15-19,1876,0.04829247577833595
STAT,1877,32,30-34,1909,18.473881914345544
SIM,1870,60,na,1930,2020
SIM,1908,34,35-39,1942,12
SIM,1926,15,45-49,1941,1
STAT,1873,49,25-29,1922,0.05832894134039349
STAT,1935,21,40-44,1956,4.670896045877764
STAT,1837,75,na,1912,686.3697017150897
STAT,1923,19,35-39,1942,5.000366979925824
SIM,1836,22,40-44,1858,4
STAT,1808,53,30-34,1861,0.013910174254791064
STAT,1826,34,40-44,1860,4.183878890873538
STAT,1845,25,45-49,1870,1.0712693748139983
STAT,1883,35,25-29,1918,2.909347343811902
STAT,1953,17,20-24,1970,167.29544148094143
STAT,1835,39,45-49,1874,1.7992594816867253
SIM,1826,32,25-29,1858,15
STAT,1948,10,na,1958,4587.721756003678
SIM,1903,16,20-24,1919,29
STAT,1796,68,na,1864,713.9782119729192
STAT,1925,31,25-29,1956,11.20430363256821
SIM,1860,53,na,1913,1876
SIM,1893,23,25-29,1916,85
STAT,1885,23,25-29,1908,58.08333577771851
STAT,1875,63,na,1938,1868.1855586419404
STAT,1832,45,20-24,1877,0.009774348748196972
STAT,1814,95,na,1909,6.195550700357503
STAT,1875,44,30-34,1919,1.18746699850131
STAT,1905,35,20-24,1940,0.2474645737194251
SIM,1888,32,15-19,1920,1
SIM,1839,79,na,1918,464
SIM,1878,29,30-34,1907,28
SIM,1923,41,na,1964,4236
STAT,1816,44,25-29,1860,1.3845184998700315
SIM,1843,39,45-49,1882,4
STAT,1897,36,30-34,1933,7.30472874636066
STAT,1781,111,na,1892,4.602623750678968E-4
SIM,1885,32,30-34,1917,24
STAT,1901,19,15-19,1920,8.420704535674583
STAT,1918,15,45-49,1933,0.11183730651779648
STAT,1860,15,50-100,1875,0.04732445964131134
STAT,1911,27,50-100,1938,0.9901276997946342
SIM,1834,34,40-44,1868,4
SIM,1898,48,50-100,1946,1
SIM,1911,22,40-44,1933,1
STAT,1878,17,20-24,1895,18.825240150038223
STAT,1881,22,45-49,1903,0.6877525098642283
SIM,1891,35,25-29,1926,4
STAT,1918,51,na,1969,3938.7189258141225
STAT,1885,70,na,1955,1428.0191729161295
STAT,1853,47,50-100,1900,0.20497519623371485
STAT,1831,38,30-34,1869,4.632223406051813
STAT,1867,34,na,1901,2265.87868799982
SIM,1864,25,20-24,1889,9
STAT,1862,28,15-19,1890,0.39260843683975366
SIM,1861,47,50-100,1908,1
STAT,1830,57,na,1887,1280.3207545529958
SIM,1891,39,40-44,1930,10
STAT,1908,44,na,1952,3460.8149261776175
STAT,1870,22,35-39,1892,5.819506595207777
STAT,1899,24,30-34,1923,24.727446514510902
SIM,1888,70,na,1958,1653
SIM,1838,45,30-34,1883,1
STAT,1915,28,40-44,1943,4.834288643233524
STAT,1862,42,na,1904,2004.6096383932586
SIM,1923,28,40-44,1951,5
SIM,1898,37,35-39,1935,5
STAT,1816,48,40-44,1864,0.34639992943012055
STAT,1921,43,25-29,1964,0.08194396253786568
STAT,1847,38,25-29,1885,2.3054675876938755
STAT,1903,22,40-44,1925,3.021865925482069
SIM,1936,22,50-100,1958,1
STAT,1819,50,na,1869,1531.1500758640811
SIM,1900,13,na,1913,3718
STAT,1883,39,40-44,1922,4.337628861092538
SIM,1907,34,na,1941,3608
SIM,1902,23,45-49,1925,2
STAT,1893,25,40-44,1918,3.902999223969626
STAT,1868,45,35-39,1913,0.13777139261729615
STAT,1928,37,15-19,1965,0.02475483685529767
STAT,1774,87,na,1861,38.428504832421424
SIM,1926,33,40-44,1959,9
SIM,1875,25,30-34,1900,35
STAT,1809,49,45-49,1858,1.0151162774437852
SIM,1837,24,15-19,1861,1
STAT,1834,43,30-34,1877,0.9208277060829568
SIM,1833,31,20-24,1864,2
STAT,1858,38,35-39,1896,5.693666359909208
SIM,1865,93,na,1958,10
STAT,1853,34,35-39,1887,8.564790130166546
STAT,1763,95,na,1858,0.8426899189787482
STAT,1928,22,45-49,1950,1.432956466871159
STAT,1947,23,25-29,1970,106.475848351818
STAT,1853,9,na,1862,2457.418612443291
SIM,1904,36,25-29,1940,4
STAT,1842,90,na,1932,61.82713582480008
STAT,1916,48,45-49,1964,0.22685333287025655
STAT,1896,15,15-19,1911,8.033087734140606
STAT,1917,22,35-39,1939,10.212442443044338
SIM,1890,28,35-39,1918,25
SIM,1842,65,na,1907,1254
STAT,1857,49,40-44,1906,0.13355038220852863
SIM,1915,33,30-34,1948,24
STAT,1849,36,35-39,1885,5.677534379415943
STAT,1918,33,40-44,1951,4.22569737330708
SIM,1838,35,20-24,1873,1
SIM,1861,34,35-39,1895,11
STAT,1845,43,40-44,1888,1.7668766169516255
STAT,1846,43,50-100,1889,0.7549039456783018
STAT,1792,107,na,1899,7.822585022258883E-4
STAT,1874,20,45-49,1894,0.7306370903296732
STAT,1888,24,20-24,1912,82.5895776330132
SIM,1873,71,na,1944,1316
STAT,1839,56,na,1895,1407.6428846027632
STAT,1930,32,45-49,1962,2.0711963288817667
SIM,1806,49,35-39,1855,1
SIM,1893,26,na,1919,3058
STAT,1790,101,na,1891,0.1285216179616
STAT,1804,51,na,1855,1192.7300819899926
SIM,1934,24,35-39,1958,13
STAT,1919,20,45-49,1939,1.264804010343389
SIM,1862,34,na,1896,2214
SIM,1934,33,na,1967,5368
STAT,1919,35,15-19,1954,0.021170040006546032
STAT,1879,27,15-19,1906,0.48380797251490804
STAT,1824,57,na,1881,1197.825229335802
SIM,1924,26,na,1950,4427
STAT,1921,20,35-39,1941,10.917236460401135
SIM,1853,25,45-49,1878,1
SIM,1853,43,40-44,1896,4
STAT,1859,30,20-24,1889,2.234302422549298
STAT,1907,33,30-34,1940,14.953500270692542
STAT,1917,49,50-100,1966,0.23967424834792567
STAT,1937,34,20-24,1971,2.458339497426984
SIM,1943,21,40-44,1964,6
STAT,1898,6,na,1904,3603.8838420310326
STAT,1829,49,na,1878,1592.0741594218573
STAT,1882,28,35-39,1910,9.556090124042845
SIM,1936,22,45-49,1958,1
SIM,1891,48,na,1939,2845
STAT,1867,38,45-49,1905,1.8997556721781894
SIM,1878,43,45-49,1921,4
SIM,1925,22,35-39,1947,16
STAT,1915,42,20-24,1957,0.018143514027506823
SIM,1855,86,na,1941,220
SIM,1908,19,na,1927,4063
STAT,1842,34,25-29,1876,9.503781347576165
STAT,1910,20,25-29,1930,88.99900192226607
SIM,1850,34,25-29,1884,13
STAT,1839,47,30-34,1886,0.06806669496108476
STAT,1861,51,45-49,1912,0.012292036805349743
STAT,1815,43,na,1858,1629.6556469321683
STAT,1833,22,15-19,1855,3.396966057271569
SIM,1848,24,25-29,1872,73
SIM,1857,36,35-39,1893,16
STAT,1850,43,15-19,1893,0.010312781243808657
SIM,1841,22,15-19,1863,1
SIM,1939,25,na,1964,3770
SIM,1869,31,35-39,1900,2
SIM,1872,26,25-29,1898,67
SIM,1907,27,45-49,1934,2
STAT,1897,26,20-24,1923,16.05704388590738
SIM,1864,38,35-39,1902,12
STAT,1864,26,25-29,1890,38.50254935984951
STAT,1904,28,30-34,1932,36.6879972020006
SIM,1920,19,25-29,1939,2
STAT,1876,48,na,1924,2340.268641427401
STAT,1846,45,15-19,1891,2.889002457461155E-4
STAT,1838,26,15-19,1864,0.4271148771855869
SIM,1821,39,25-29,1860,4
SIM,1808,47,45-49,1855,1
STAT,1827,44,35-39,1871,2.0660701507623314
SIM,1832,39,35-39,1871,17
SIM,1901,49,na,1950,3338
SIM,1927,20,45-49,1947,1
SIM,1831,29,40-44,1860,3
STAT,1831,50,na,1881,1565.0170933255574
STAT,1872,39,30-34,1911,5.394275404717059
SIM,1822,65,na,1887,921
STAT,1912,19,25-29,1931,8.891284180629826
SIM,1919,5,na,1924,4579
STAT,1769,106,na,1875,0.0062177390499419255
SIM,1927,23,50-100,1950,1
SIM,1859,42,30-34,1901,4
SIM,1906,21,20-24,1927,107
STAT,1840,21,45-49,1861,0.6427439739789115
SIM,1875,21,15-19,1896,3
SIM,1879,36,20-24,1915,1
STAT,1948,16,35-39,1964,4.900767985484967
SIM,1874,32,20-24,1906,3
STAT,1886,55,na,1941,2232.7421299964935
SIM,1839,90,na,1929,56
STAT,1789,86,na,1875,57.11744971188023
SIM,1853,20,na,1873,2041
STAT,1894,35,35-39,1929,9.369361188378914
SIM,1867,33,25-29,1900,13
SIM,1840,87,na,1927,79
STAT,1863,2,na,1865,3056.6874389815525
STAT,1921,49,30-34,1970,0.10194811171658678
STAT,1926,24,35-39,1950,11.59674727707878
SIM,1912,28,30-34,1940,54
STAT,1813,65,na,1878,869.6025114617474
STAT,1911,19,na,1930,3921.2206149520994
STAT,1926,18,na,1944,4591.695542202986
STAT,1955,15,30-34,1970,16.512178917044285
SIM,1826,72,na,1898,772
SIM,1834,24,30-34,1858,21
SIM,1823,37,35-39,1860,11
STAT,1900,17,40-44,1917,0.25861573164076845
SIM,1842,43,30-34,1885,4
STAT,1844,32,35-39,1876,9.384393220315891
STAT,1867,21,15-19,1888,3.1955400371843643
SIM,1896,24,20-24,1920,120
SIM,1851,79,na,1930,417
SIM,1866,78,na,1944,787
STAT,1848,16,30-34,1864,1.5449836413762141
STAT,1861,26,40-44,1887,2.561905580919292
SIM,1864,35,30-34,1899,7
SIM,1882,85,na,1967,416
SIM,1868,18,15-19,1886,7
STAT,1933,23,30-34,1956,38.8666061988861
SIM,1864,12,na,1876,2514
STAT,1779,103,na,1882,0.0431391128332915
STAT,1828,64,na,1892,957.2561576499039
STAT,1947,5,na,1952,4553.528087350841
SIM,1856,16,30-34,1872,1
SIM,1916,48,na,1964,3801
SIM,1941,23,30-34,1964,2
STAT,1886,44,40-44,1930,2.396011094460692
SIM,1877,23,40-44,1900,3
STAT,1856,35,30-34,1891,4.308477728701263
STAT,1919,23,50-100,1942,0.7329925222681215
SIM,1829,33,20-24,1862,1
SIM,1880,39,30-34,1919,2
STAT,1920,26,50-100,1946,1.1180781685141734
SIM,1889,25,25-29,1914,65
STAT,1862,49,15-19,1911,3.4010711464415325E-4
STAT,1898,46,25-29,1944,0.044950570700368946
SIM,1811,73,na,1884,370
SIM,1852,32,35-39,1884,15
STAT,1816,106,na,1922,0.005387430618057147
STAT,1909,31,40-44,1940,3.824135823019701
SIM,1845,44,50-100,1889,4
SIM,1795,72,na,1867,508
STAT,1819,53,40-44,1872,0.01966250762784595
STAT,1945,25,15-19,1970,0.7908811464810023
STAT,1942,25,na,1967,4014.875295023895
STAT,1923,33,15-19,1956,0.1502160604519329
STAT,1837,44,50-100,1881,0.7372296206961625
STAT,1821,43,na,1864,1427.8771797176914
STAT,1778,94,na,1872,2.6649207540796684
SIM,1860,23,30-34,1883,20
STAT,1883,52,na,1935,2143.772956178633
SIM,1856,23,na,1879,2325
STAT,1819,43,40-44,1862,4.715342160683315
STAT,1928,43,50-100,1971,0.15252191633863874
SIM,1841,18,25-29,1859,6
STAT,1908,26,40-44,1934,4.546786964658776
STAT,1938,4,na,1942,4061.464777424754
SIM,1881,34,30-34,1915,24
STAT,1925,30,25-29,1955,11.210469390733111
STAT,1859,52,25-29,1911,0.0028703686719874113
STAT,1845,39,25-29,1884,2.315107092748909
SIM,1819,39,na,1858,1564
STAT,1886,47,50-100,1933,0.2639654669215035
STAT,1881,53,20-24,1934,7.161077150137752E-4
STAT,1854,87,na,1941,134.84077632888872
STAT,1858,45,45-49,1903,0.192829258484167
STAT,1929,18,25-29,1947,56.259733536133155
SIM,1823,44,na,1867,1551
STAT,1846,41,50-100,1887,0.7744971331826582
STAT,1879,47,na,1926,2387.944099835498
STAT,1926,17,45-49,1943,0.6248074540612599
STAT,1841,51,25-29,1892,0.0026277676598672832
SIM,1885,36,40-44,1921,4
SIM,1888,37,20-24,1925,4
STAT,1903,49,50-100,1952,0.1967094228846224
STAT,1875,33,na,1908,2487.9494559466975
SIM,1843,26,35-39,1869,9
SIM,1868,39,45-49,1907,5
SIM,1883,42,40-44,1925,6
STAT,1909,8,na,1917,3975.899736937722
SIM,1924,32,25-29,1956,1
STAT,1905,30,50-100,1935,1.3607964558654229
STAT,1835,35,50-100,1870,1.1551176416271791
SIM,1897,22,15-19,1919,4
STAT,1835,26,35-39,1861,9.44123710429351
STAT,1874,40,50-100,1914,1.1114630154476626
SIM,1912,27,na,1939,3736
STAT,1890,38,na,1928,2924.1212267104866
SIM,1808,87,na,1895,49
SIM,1823,49,40-44,1872,1
STAT,1866,30,20-24,1896,2.5639426775409118
STAT,1873,52,50-100,1925,0.015536859025594759
STAT,1875,42,40-44,1917,2.3521163603336053
SIM,1937,18,25-29,1955,65
STAT,1813,89,na,1902,45.17588750987793
STAT,1862,48,15-19,1910,3.4299513366965165E-4
SIM,1864,37,35-39,1901,4
STAT,1882,18,20-24,1900,17.573812199680656
STAT,1862,36,20-24,1898,0.6726270824797981
SIM,1814,43,30-34,1857,1
STAT,1894,40,25-29,1934,0.8511527977088198
STAT,1903,45,20-24,1948,0.00991402692573322
SIM,1931,22,15-19,1953,7
SIM,1827,43,40-44,1870,5
SIM,1834,28,35-39,1862,9
SIM,1836,36,45-49,1872,3
STAT,1874,3,na,1877,3222.6415338414213
STAT,1852,23,30-34,1875,16.92426368982888
STAT,1837,29,50-100,1866,0.5395901193408429
STAT,1873,34,30-34,1907,17.903102567110196
SIM,1916,26,40-44,1942,2
SIM,1890,74,na,1964,1615
SIM,1891,16,na,1907,3285
SIM,1853,39,25-29,1892,5
SIM,1886,69,na,1955,1577
SIM,1921,6,na,1927,5277
SIM,1882,55,na,1937,2010
SIM,1920,46,na,1966,3955
STAT,1815,49,40-44,1864,0.44547666504697364
STAT,1895,27,45-49,1922,1.4778256091165325
STAT,1927,32,na,1959,4745.777673346413
STAT,1854,37,25-29,1891,2.2036068541920972
SIM,1821,33,20-24,1854,2
SIM,1950,2,na,1952,4809
SIM,1811,59,na,1870,954
STAT,1831,27,na,1858,1923.6910182419788
SIM,1827,30,35-39,1857,17
STAT,1848,35,50-100,1883,1.0041301895245571
SIM,1872,36,30-34,1908,10
STAT,1916,32,25-29,1948,9.737788022386505
SIM,1853,33,40-44,1886,2
STAT,1895,6,na,1901,3477.076160225342
SIM,1928,26,na,1954,4827
STAT,1944,28,na,1972,4128.898570325814
STAT,1899,47,50-100,1946,0.19263231176284398
STAT,1932,20,15-19,1952,7.165423405963791
STAT,1940,14,na,1954,4074.144873645841
STAT,1838,49,35-39,1887,0.10315014605646494
STAT,1886,21,35-39,1907,6.320245933854509
SIM,1924,12,na,1936,4905
SIM,1894,21,35-39,1915,9
STAT,1863,41,35-39,1904,1.6270141981579425
STAT,1849,52,40-44,1901,0.008129741221115616
STAT,1865,39,na,1904,2159.451047035212
STAT,1917,24,40-44,1941,3.623961731277047
STAT,1880,24,20-24,1904,73.4137560820369
STAT,1847,47,35-39,1894,0.10866484810736997
SIM,1834,20,25-29,1854,60
STAT,1917,37,50-100,1954,0.44502599702578843
STAT,1923,22,15-19,1945,6.319518592171618
STAT,1866,44,40-44,1910,2.08793270295385
STAT,1956,13,na,1969,5300.349641765889
SIM,1943,15,na,1958,3901
STAT,1934,16,40-44,1950,1.9341015998358682
SIM,1887,31,45-49,1918,4
SIM,1787,76,na,1863,259
STAT,1841,21,na,1862,2014.3519161847837
STAT,1864,36,30-34,1900,4.857633803493286
STAT,1833,93,na,1926,19.192190457470698
SIM,1877,37,45-49,1914,4
SIM,1898,54,na,1952,3211
SIM,1873,19,na,1892,2507
SIM,1894,29,45-49,1923,2
STAT,1890,46,25-29,1936,0.04064253215890279
SIM,1892,35,45-49,1927,6
STAT,1849,49,na,1898,1710.21809114229
SIM,1899,38,35-39,1937,2
SIM,1871,41,35-39,1912,2
SIM,1922,46,35-39,1968,1
STAT,1866,72,na,1938,1188.3464503498133
STAT,1796,60,na,1856,962.1257166520999
STAT,1858,31,25-29,1889,8.372836864981243
STAT,1850,54,30-34,1904,0.004354407184580957
STAT,1825,41,15-19,1866,0.019254246123037687
SIM,1825,44,45-49,1869,3
STAT,1870,53,45-49,1923,0.014240314626456762
STAT,1912,38,25-29,1950,0.9754695411669646
STAT,1901,43,45-49,1944,0.147193010876983
STAT,1907,19,50-100,1926,0.07299075130236778
SIM,1874,44,40-44,1918,7
STAT,1856,23,15-19,1879,3.046254596682791
SIM,1869,73,na,1942,994
SIM,1942,16,40-44,1958,2
SIM,1844,38,na,1882,1983
STAT,1914,46,35-39,1960,0.13078594948641487
SIM,1890,18,20-24,1908,31
STAT,1786,98,na,1884,0.49862220670793433
SIM,1894,40,na,1934,3117
STAT,1857,36,na,1893,1886.0858698769089
SIM,1861,18,na,1879,2821
STAT,1874,16,na,1890,2637.035739638869
SIM,1820,95,na,1915,13
SIM,1842,41,40-44,1883,3
STAT,1845,35,na,1880,1972.7711283366655
STAT,1858,39,35-39,1897,5.664457851482874
STAT,1929,31,50-100,1960,1.0717754521638991
SIM,1938,27,30-34,1965,63
SIM,1927,8,na,1935,4906
STAT,1850,15,20-24,1865,16.489425841228105
STAT,1896,47,30-34,1943,0.07322690595318763
STAT,1845,44,20-24,1889,0.12316450962553797
SIM,1825,35,30-34,1860,3
STAT,1819,110,na,1929,1.6291706131069155E-4
STAT,1869,37,45-49,1906,1.9634018652752698
SIM,1919,27,20-24,1946,27
STAT,1817,44,45-49,1861,3.4775185286382206
SIM,1887,3,na,1890,3092
SIM,1835,61,na,1896,1250
STAT,1889,22,15-19,1911,4.157244112643078
SIM,1933,30,25-29,1963,13
STAT,1851,36,45-49,1887,1.6796241070646172
SIM,1799,77,na,1876,424
STAT,1892,32,15-19,1924,0.1820770241501858
STAT,1884,35,45-49,1919,2.031099599185841
STAT,1801,54,35-39,1855,0.023295677504177253
STAT,1886,34,40-44,1920,4.642746356906741
STAT,1875,23,25-29,1898,59.75156071696816
STAT,1912,43,20-24,1955,0.017271395784912224
STAT,1859,40,30-34,1899,0.9461030678768542
STAT,1884,26,30-34,1910,25.50287341030973
STAT,1909,23,50-100,1932,0.621771536550944
SIM,1949,20,35-39,1969,22
STAT,1854,71,na,1925,1021.595813414904
SIM,1894,34,40-44,1928,12
STAT,1858,85,na,1943,221.7768566031208
STAT,1862,90,na,1952,68.46515097623198
STAT,1882,27,35-39,1909,9.589846383312103
STAT,1872,41,50-100,1913,1.0850351480786051
SIM,1877,92,na,1969,111
STAT,1826,39,15-19,1865,0.04762018894346621
STAT,1828,47,25-29,1875,0.04504826017270071
SIM,1853,20,35-39,1873,12
STAT,1874,50,25-29,1924,0.003742241229749211
SIM,1849,44,30-34,1893,2
STAT,1927,32,50-100,1959,1.0374730680079443
STAT,1942,22,25-29,1964,98.80908450825034
SIM,1823,36,35-39,1859,6
SIM,1892,26,30-34,1918,43
STAT,1832,33,30-34,1865,15.145391978292343
SIM,1840,33,30-34,1873,31
SIM,1791,81,na,1872,145
STAT,1867,17,40-44,1884,0.1790783965566393
SIM,1858,7,na,1865,2427
SIM,1875,29,35-39,1904,3
SIM,1839,17,30-34,1856,5
SIM,1863,19,15-19,1882,7
SIM,1866,31,25-29,1897,18
STAT,1875,51,50-100,1926,0.0158883975974984
SIM,1890,27,35-39,1917,15
STAT,1908,49,15-19,1957,3.37721362144718E-4
STAT,1875,37,45-49,1912,2.087201821481681
STAT,1848,17,30-34,1865,1.5358836877285083
STAT,1948,18,35-39,1966,4.897827963802485
STAT,1865,21,15-19,1886,3.1140656264781255
SIM,1870,54,na,1924,2271
STAT,1888,18,50-100,1906,0.05893039222771878
SIM,1866,49,na,1915,2265
STAT,1892,37,45-49,1929,2.5487961233065675
STAT,1925,25,na,1950,4544.848277614791
STAT,1881,48,25-29,1929,0.05609576360877267
STAT,1848,21,15-19,1869,3.1450504453695314
SIM,1868,44,40-44,1912,6
STAT,1895,35,20-24,1930,1.0357524320711198
STAT,1834,41,40-44,1875,1.8483179632181808
SIM,1833,46,45-49,1879,1
STAT,1810,65,na,1875,819.9023174450898
STAT,1871,26,45-49,1897,1.1258390216556013
SIM,1853,44,20-24,1897,1
STAT,1916,26,50-100,1942,1.0538402837462215
STAT,1922,45,30-34,1967,0.10498836482142514
SIM,1862,26,45-49,1888,2
STAT,1825,46,45-49,1871,0.3077220923392122
STAT,1879,79,na,1958,862.7129792211166
STAT,1899,37,30-34,1936,1.606993674468279
STAT,1844,37,50-100,1881,1.0053596242837244
STAT,1890,26,30-34,1916,31.518103672650373
SIM,1847,23,15-19,1870,3
SIM,1856,21,15-19,1877,4
STAT,1829,40,45-49,1869,1.290610110419909
STAT,1810,51,50-100,1861,0.046145840640096136
SIM,1863,30,45-49,1893,1
STAT,1854,26,45-49,1880,0.9860268056127036
STAT,1818,51,25-29,1869,0.007864344489698262
STAT,1886,17,na,1903,2727.1800618162465
SIM,1841,89,na,1930,43
SIM,1816,46,45-49,1862,1
STAT,1877,45,50-100,1922,0.2624566639706534
SIM,1898,34,25-29,1932,1
STAT,1845,30,50-100,1875,0.8690773560016024
STAT,1849,46,30-34,1895,0.0753650698501836
STAT,1882,52,25-29,1934,0.0035015840349784896
SIM,1856,17,30-34,1873,5
STAT,1949,22,35-39,1971,11.209524906456545
STAT,1840,35,30-34,1875,4.631235094894252
STAT,1886,29,45-49,1915,1.1903498503784666
STAT,1839,39,25-29,1878,2.325760066540399
STAT,1828,44,20-24,1872,0.12572523724251972
STAT,1854,55,na,1909,1582.5341252525193
SIM,1876,1,na,1877,3632
STAT,1879,31,45-49,1910,1.8671327466660455
STAT,1938,33,15-19,1971,0.13172626011626268
STAT,1819,38,45-49,1857,5.129665693588842
SIM,1837,40,45-49,1877,3
STAT,1897,24,15-19,1921,4.471818763861397
SIM,1851,34,45-49,1885,4
SIM,1857,88,na,1945,59
SIM,1853,74,na,1927,901
STAT,1830,28,25-29,1858,44.915507578962526
STAT,1888,45,30-34,1933,0.1179066308220209
SIM,1925,24,40-44,1949,7
STAT,1857,37,50-100,1894,0.9781658537039872
STAT,1843,34,45-49,1877,1.6575906400339657
STAT,1844,100,na,1944,0.822680828128531
STAT,1883,84,na,1967,624.336734975297
STAT,1844,41,25-29,1885,0.5162119551089793
SIM,1847,39,25-29,1886,2
SIM,1906,19,35-39,1925,2
STAT,1820,54,45-49,1874,0.024453663748585177
SIM,1827,38,45-49,1865,1
STAT,1795,59,na,1854,877.0
STAT,1834,24,50-100,1858,0.36176777811937766
SIM,1862,37,25-29,1899,2
STAT,1829,29,15-19,1858,0.46615063574300314
STAT,1869,45,20-24,1914,0.011936731008352412
STAT,1819,49,25-29,1868,0.1108475992049474
STAT,1828,36,45-49,1864,1.7866253528502667
STAT,1866,40,na,1906,2196.752296437054
STAT,1859,18,45-49,1877,0.06141250320092688
STAT,1937,17,20-24,1954,134.53362771532835
STAT,1891,1,na,1892,3437.7117552142186
STAT,1907,12,na,1919,3868.3067407147037
STAT,1838,54,30-34,1892,0.004253376105509971
STAT,1881,36,30-34,1917,5.281741678252577
STAT,1915,31,na,1946,3946.6913653055462
SIM,1932,31,na,1963,5269
STAT,1881,40,15-19,1921,0.013757756853110146
STAT,1960,2,na,1962,5226.72299615388
SIM,1888,24,15-19,1912,4
STAT,1838,30,45-49,1868,1.625528534886871
STAT,1860,25,30-34,1885,21.37255612322483
STAT,1845,36,45-49,1881,1.6536431815713024
STAT,1874,91,na,1965,161.34242945015907
SIM,1832,25,20-24,1857,9
SIM,1929,21,20-24,1950,150
STAT,1855,30,45-49,1885,1.4053029930215768
STAT,1899,24,25-29,1923,79.46975630887088
STAT,1819,54,20-24,1873,0.0013510405407380255
STAT,1843,25,30-34,1868,25.381221975105028
STAT,1808,51,40-44,1859,0.02565758590602221
STAT,1865,29,25-29,1894,38.88707136181048
STAT,1927,2,na,1929,5187.328285273478
STAT,1918,40,35-39,1958,0.21908718530705323
STAT,1885,42,25-29,1927,0.6527691551669654
SIM,1851,25,30-34,1876,5
STAT,1815,96,na,1911,4.439949725938536
STAT,1866,42,15-19,1908,0.01297863936551518
STAT,1886,45,20-24,1931,0.013086928868718489
STAT,1954,17,20-24,1971,170.95467860238435
STAT,1891,16,20-24,1907,22.446091541647462
STAT,1814,45,30-34,1859,0.2981258675401837
STAT,1929,43,15-19,1972,0.002025216514288405
STAT,1845,19,na,1864,2240.2488451162412
SIM,1906,24,30-34,1930,32
STAT,1807,61,na,1868,1142.2455885536194
STAT,1820,59,na,1879,1144.3883172303272
STAT,1896,31,45-49,1927,2.3591465682892236
SIM,1904,8,na,1912,4057
SIM,1945,17,20-24,1962,147
STAT,1835,51,25-29,1886,0.00274441834481061
SIM,1853,36,45-49,1889,7
SIM,1886,85,na,1971,586
SIM,1882,71,na,1953,1118
STAT,1823,35,30-34,1858,10.607514702504073
STAT,1790,71,na,1861,629.7872608867216
STAT,1853,39,50-100,1892,1.0190996306448925
STAT,1788,107,na,1895,0.0015616944736085068
STAT,1846,52,na,1898,1531.5800566512437
SIM,1873,21,15-19,1894,6
SIM,1884,27,35-39,1911,13
STAT,1860,34,45-49,1894,1.4310287895238039
STAT,1808,46,45-49,1854,0.6510438789320334
STAT,1849,33,25-29,1882,8.292816029096693
STAT,1938,21,20-24,1959,112.29773905587304
SIM,1896,47,na,1943,3050
SIM,1892,33,na,1925,3455
SIM,1900,42,40-44,1942,1
STAT,1929,39,na,1968,4915.868410122112
STAT,1939,28,35-39,1967,15.389589669911123
STAT,1866,39,50-100,1905,1.143642061301382
STAT,1848,29,25-29,1877,38.6935644921376
STAT,1817,106,na,1923,0.0059255396536135015
SIM,1856,29,25-29,1885,52
SIM,1883,20,20-24,1903,63
STAT,1899,46,45-49,1945,0.18649771319885491
STAT,1881,43,50-100,1924,1.0344277764141447
SIM,1831,35,30-34,1866,6
SIM,1812,76,na,1888,318
SIM,1846,30,45-49,1876,3
SIM,1878,34,na,1912,2606
STAT,1918,25,50-100,1943,1.0882970436039276
STAT,1936,34,50-100,1970,0.8180342460111152
SIM,1799,61,na,1860,1160
STAT,1884,48,50-100,1932,0.24476519106190792
STAT,1890,22,na,1912,2950.012302647667
SIM,1881,38,na,1919,2134
SIM,1946,21,20-24,1967,115
STAT,1876,27,35-39,1903,10.16446474724628
SIM,1857,33,25-29,1890,16
STAT,1875,45,45-49,1920,0.2495579408541882
STAT,1943,17,45-49,1960,0.5404542981786938
STAT,1836,43,40-44,1879,1.6444262170757782
STAT,1864,20,45-49,1884,0.6520291642260033
STAT,1885,17,35-39,1902,0.5584645302312501
SIM,1815,41,na,1856,1542
STAT,1871,18,45-49,1889,0.06604500715698886
SIM,1869,9,na,1878,2718
STAT,1902,15,50-100,1917,0.07080941530504792
SIM,1899,12,na,1911,3602
SIM,1843,23,30-34,1866,24
STAT,1876,52,25-29,1928,0.003711397040206466
SIM,1819,55,na,1874,1268
SIM,1866,42,40-44,1908,2
SIM,1931,34,50-100,1965,1
SIM,1929,37,30-34,1966,2
STAT,1913,21,50-100,1934,0.6524211415123073
STAT,1925,26,40-44,1951,5.635970566395952
STAT,1873,37,35-39,1910,7.315166077475295
STAT,1942,30,25-29,1972,10.056215560017264
SIM,1893,30,30-34,1923,40
SIM,1868,31,35-39,1899,14
STAT,1909,17,45-49,1926,0.09990810184059291
STAT,1899,45,30-34,1944,0.07703957164119143
SIM,1938,22,25-29,1960,109
STAT,1847,42,na,1889,1812.3868636433103
STAT,1857,54,40-44,1911,0.008156924396326294
SIM,1888,28,na,1916,2803
STAT,1894,68,na,1962,2189.5660651939784
STAT,1847,44,30-34,1891,0.8844248283629272
STAT,1830,33,20-24,1863,2.5406328392562587
STAT,1890,34,30-34,1924,21.591693261609336
STAT,1898,16,30-34,1914,2.204226810134014
STAT,1828,39,na,1867,1498.3479222185983
STAT,1885,30,30-34,1915,17.912968956732968
STAT,1813,50,35-39,1863,0.021507705762886357
STAT,1888,83,na,1971,915.8248963758896
SIM,1872,20,45-49,1892,1
SIM,1875,21,25-29,1896,67
SIM,1893,17,35-39,1910,1
SIM,1874,20,na,1894,2363
STAT,1910,38,15-19,1948,0.01863885999739299
STAT,1835,23,30-34,1858,17.521865727997735
STAT,1843,26,50-100,1869,0.6401263980687162
STAT,1808,54,45-49,1862,0.03320827499061095
STAT,1902,28,15-19,1930,0.6504195536590358
SIM,1821,36,25-29,1857,5
SIM,1942,20,25-29,1962,117
STAT,1823,43,30-34,1866,1.8137756266736962
SIM,1910,28,15-19,1938,5
STAT,1867,29,35-39,1896,9.175036968094009
SIM,1838,69,na,1907,872
SIM,1912,1,na,1913,4378
STAT,1854,34,20-24,1888,2.07503087585465
SIM,1877,34,40-44,1911,5
STAT,1861,52,40-44,1913,0.008827230798148742
SIM,1881,37,35-39,1918,5
STAT,1869,34,40-44,1903,4.234699749524254
SIM,1831,43,30-34,1874,4
STAT,1828,32,50-100,1860,0.9040960940604239
SIM,1839,25,30-34,1864,6
STAT,1928,27,20-24,1955,22.93883204546462
SIM,1875,35,45-49,1910,2
SIM,1903,38,25-29,1941,4
STAT,1923,34,50-100,1957,0.9658368705223002
SIM,1928,17,20-24,1945,181
SIM,1899,26,40-44,1925,5
SIM,1911,53,na,1964,3482
SIM,1936,27,20-24,1963,23
STAT,1868,20,50-100,1888,0.4031054736841419
SIM,1814,46,35-39,1860,1
STAT,1903,48,25-29,1951,0.04652555083108532
STAT,1841,25,20-24,1866,10.914730324858706
SIM,1833,22,na,1855,1926
STAT,1774,81,na,1855,136.77170000000004
STAT,1858,23,25-29,1881,48.00716513419045
STAT,1867,21,25-29,1888,55.449927713708576
SIM,1841,15,20-24,1856,21
STAT,1853,53,45-49,1906,0.011973259542162435
STAT,1866,33,25-29,1899,9.597312973941877
STAT,1834,22,25-29,1856,51.522157477981224
STAT,1829,43,50-100,1872,0.8745470843030104
STAT,1774,97,na,1871,0.6563508738537533
STAT,1877,40,na,1917,2470.1662310323063
STAT,1894,43,50-100,1937,0.09557178420746684
SIM,1899,35,30-34,1934,16
STAT,1926,15,na,1941,4625.147114786485
SIM,1849,39,35-39,1888,16
STAT,1930,39,30-34,1969,2.4194798251734397
SIM,1873,27,35-39,1900,11
SIM,1900,3,na,1903,3800
STAT,1820,40,25-29,1860,1.3496041826354805
STAT,1875,20,20-24,1895,72.5826159856828
STAT,1825,90,na,1915,47.27775705984471
STAT,1874,75,na,1949,1072.2484287588334
SIM,1876,42,25-29,1918,2
SIM,1898,70,na,1968,2533
STAT,1904,31,na,1935,3503.201878729414
STAT,1862,25,40-44,1887,2.6488383405196982
STAT,1812,52,45-49,1864,0.03275927323326431
STAT,1895,24,40-44,1919,2.756209327995338
STAT,1871,38,15-19,1909,0.056464109765923136
STAT,1870,61,na,1931,1863.5205512365274
STAT,1901,35,45-49,1936,0.6196531815697329
STAT,1892,39,50-100,1931,1.5539463176651906
STAT,1810,44,35-39,1854,6.04464917615758
STAT,1845,28,45-49,1873,1.0483595154761363
SIM,1890,24,30-34,1914,45
SIM,1836,33,40-44,1869,6
STAT,1846,29,15-19,1875,0.3868912210420936
SIM,1893,23,na,1916,3097
SIM,1840,28,35-39,1868,8
SIM,1870,25,40-44,1895,3
STAT,1841,80,na,1921,456.74222053753203
SIM,1906,16,30-34,1922,3
SIM,1862,34,20-24,1896,1
STAT,1828,33,40-44,1861,4.138656110490021
STAT,1917,1,na,1918,4570.991776962423
SIM,1840,36,35-39,1876,9
STAT,1832,28,35-39,1860,8.677773189745174
STAT,1803,110,na,1913,1.0722883905545101E-4
STAT,1903,46,na,1949,3272.5111454562957
STAT,1871,34,20-24,1905,2.708121361965529
SIM,1858,25,40-44,1883,3
SIM,1803,56,na,1859,925
SIM,1933,26,40-44,1959,12
STAT,1882,24,30-34,1906,17.592390231854424
STAT,1870,37,50-100,1907,1.2243820603329467
STAT,1834,44,45-49,1878,1.1834752690472046
STAT,1889,27,20-24,1916,14.78331361001675
SIM,1844,43,40-44,1887,6
STAT,1821,35,20-24,1856,1.8815567007965512
SIM,1916,30,25-29,1946,14
STAT,1916,32,na,1948,3984.669973547812
STAT,1845,94,na,1939,15.616060739525272
SIM,1842,22,25-29,1864,71
STAT,1856,28,20-24,1884,9.665046423616154
STAT,1916,40,25-29,1956,0.0748846501479405
STAT,1839,23,15-19,1862,2.904419087737794
STAT,1868,7,na,1875,2698.184999060689
SIM,1908,24,40-44,1932,6
STAT,1852,26,35-39,1878,9.119233578872931
SIM,1930,23,50-100,1953,1
SIM,1860,26,35-39,1886,14
SIM,1842,44,45-49,1886,1
SIM,1878,41,45-49,1919,5
STAT,1821,104,na,1925,0.035146869613124396
SIM,1897,27,20-24,1924,16
SIM,1939,26,na,1965,3784
STAT,1895,38,25-29,1933,3.81323503408694
STAT,1824,73,na,1897,653.9948009028082
SIM,1845,87,na,1932,126
STAT,1844,16,35-39,1860,0.5437057692045345
SIM,1853,58,na,1911,1615
SIM,1845,23,na,1868,2078
SIM,1774,85,na,1859,129
STAT,1807,77,na,1884,420.60280191424266
STAT,1897,37,20-24,1934,1.0514660862715912
SIM,1852,16,35-39,1868,2
STAT,1873,46,25-29,1919,0.05974191361747274
SIM,1841,73,na,1914,818
SIM,1864,28,20-24,1892,7
STAT,1890,45,50-100,1935,0.3094000698686679
STAT,1908,30,25-29,1938,8.967858774233436
STAT,1906,26,30-34,1932,37.51955349776448
STAT,1923,30,15-19,1953,0.15151745931808822
SIM,1850,43,40-44,1893,5
STAT,1873,29,35-39,1902,9.908075573207066
STAT,1872,19,15-19,1891,6.035121061917062
STAT,1843,87,na,1930,142.2259917790501
STAT,1900,44,50-100,1944,0.10233027810576376
STAT,1852,18,35-39,1870,0.53148283660628
STAT,1812,49,15-19,1861,9.147600054766716E-4
STAT,1817,43,30-34,1860,2.7778722151162567
STAT,1922,48,35-39,1970,0.15071122133120837
SIM,1883,34,40-44,1917,7
STAT,1851,31,15-19,1882,0.12356117653549137
SIM,1898,31,20-24,1929,8
STAT,1832,30,50-100,1862,0.8215165423023321
STAT,1901,21,25-29,1922,81.91195220299275
STAT,1881,45,20-24,1926,0.0119533224411685
SIM,1932,17,35-39,1949,15
STAT,1894,52,na,1946,2810.461683510616
SIM,1867,66,na,1933,1368
STAT,1767,115,na,1882,1.2735208556598958E-4
STAT,1854,51,35-39,1905,0.006620508982270082
SIM,1829,28,50-100,1857,1
STAT,1836,35,40-44,1871,3.4148583558421866
STAT,1933,28,na,1961,5070.272791613289
STAT,1810,81,na,1891,230.54593415690567
STAT,1924,17,35-39,1941,5.098106268889379
STAT,1859,41,50-100,1900,0.8646016564561504
STAT,1899,24,50-100,1923,0.5661046061417376
STAT,1849,49,35-39,1898,0.10642110135752388
STAT,1856,36,20-24,1892,0.6202695782240476
SIM,1853,28,45-49,1881,3
STAT,1845,20,35-39,1865,5.742534637154178
SIM,1869,38,25-29,1907,3
STAT,1875,34,40-44,1909,4.501713677141615
STAT,1884,34,30-34,1918,17.470918481776657
STAT,1870,100,na,1970,7.856614894432757
STAT,1820,51,40-44,1871,0.018831726843129518
SIM,1866,36,30-34,1902,1
STAT,1840,38,35-39,1878,5.9576375163815065
STAT,1872,42,15-19,1914,0.01410219575834178
SIM,1919,22,15-19,1941,6
STAT,1826,33,50-100,1859,0.9367893366247386
STAT,1840,52,20-24,1892,5.28178462428497E-4
STAT,1842,43,40-44,1885,1.801706668077567
SIM,1877,37,20-24,1914,3
SIM,1823,33,30-34,1856,24
SIM,1832,26,35-39,1858,16
SIM,1844,35,40-44,1879,9
SIM,1925,27,45-49,1952,1
STAT,1816,53,40-44,1869,0.020302424761112582
STAT,1913,16,20-24,1929,28.34783583112369
SIM,1892,34,30-34,1926,35
STAT,1863,34,50-100,1897,0.8125208610072562
STAT,1832,36,35-39,1868,6.072029366515814
STAT,1838,48,20-24,1886,0.008955444218667176
STAT,1858,27,40-44,1885,2.4808586798623584
STAT,1938,24,25-29,1962,93.19154973792106
STAT,1877,47,20-24,1924,0.01263783783414338
STAT,1849,41,25-29,1890,0.5008011803058252
STAT,1873,23,15-19,1896,3.40147110065402
SIM,1879,51,na,1930,2666
SIM,1838,40,50-100,1878,4
SIM,1856,26,20-24,1882,11
STAT,1861,35,50-100,1896,1.0447771859284192
STAT,1910,3,na,1913,4085.6575592438194
STAT,1857,15,30-34,1872,1.5102686663045921
SIM,1849,31,25-29,1880,15
SIM,1860,18,35-39,1878,1
STAT,1915,47,na,1962,3777.62649004689
STAT,1897,29,20-24,1926,15.887758585715355
STAT,1903,26,50-100,1929,0.9308427745504471
STAT,1911,33,na,1944,3740.7613648733754
STAT,1881,20,45-49,1901,0.6918560330144218
SIM,1816,43,40-44,1859,7
SIM,1825,43,30-34,1868,2
SIM,1866,27,40-44,1893,6
STAT,1867,35,45-49,1902,1.9273575755716479
SIM,1880,19,15-19,1899,6
SIM,1867,40,30-34,1907,2
SIM,1897,4,na,1901,3551
SIM,1807,49,50-100,1856,3
SIM,1808,55,na,1863,1345
STAT,1891,17,35-39,1908,0.6930185166420982
SIM,1911,26,50-100,1937,1
STAT,1869,21,na,1890,2336.3888442444463
STAT,1923,49,40-44,1972,0.1870800040685048
STAT,1826,28,35-39,1854,27.725737291848176
STAT,1897,25,50-100,1922,0.8784835827151048
SIM,1862,35,na,1897,2176
STAT,1876,24,30-34,1900,18.646516657728235
STAT,1919,36,50-100,1955,0.46070635545532157
STAT,1939,25,30-34,1964,40.21822275845648
SIM,1921,16,20-24,1937,203
STAT,1860,28,35-39,1888,8.014171154057543
SIM,1864,3,na,1867,2871
SIM,1891,7,na,1898,3367
STAT,1860,31,40-44,1891,3.6042312919526602
STAT,1862,33,40-44,1895,3.7501122085858487
SIM,1928,10,na,1938,5238
SIM,1857,72,na,1929,879
STAT,1860,24,na,1884,1989.1155943086562
STAT,1883,44,40-44,1927,2.2210570612602116
STAT,1951,16,40-44,1967,1.6996359816803353
SIM,1921,31,na,1952,4905
SIM,1933,4,na,1937,5360
STAT,1931,6,na,1937,5350.34316001146
STAT,1855,72,na,1927,978.9939556583298
STAT,1843,33,30-34,1876,16.7695685735086
STAT,1859,86,na,1945,180.7658468700838
SIM,1857,30,20-24,1887,3
SIM,1833,38,na,1871,1801
SIM,1850,93,na,1943,4
SIM,1903,50,na,1953,3062
SIM,1884,24,30-34,1908,28
STAT,1830,37,15-19,1867,0.05073474352048875
STAT,1880,41,35-39,1921,1.950029673691592
SIM,1907,64,na,1971,2997
SIM,1798,76,na,1874,304
SIM,1794,62,na,1856,960
STAT,1934,20,25-29,1954,127.00542545922728
SIM,1828,75,na,1903,616
SIM,1869,14,na,1883,2646
STAT,1852,29,15-19,1881,0.38185932898668856
SIM,1946,24,25-29,1970,129
STAT,1816,38,na,1854,1405.165850673566
STAT,1893,19,35-39,1912,0.7063018229150255
SIM,1842,33,40-44,1875,8
SIM,1851,33,30-34,1884,20
STAT,1861,41,25-29,1902,0.5437673207927997
STAT,1917,27,45-49,1944,1.8489035521618318
SIM,1883,23,25-29,1906,6
STAT,1804,96,na,1900,2.897308500486113
STAT,1869,48,25-29,1917,0.05601790165049598
STAT,1939,0,na,1939,4590.325143926529
STAT,1848,26,20-24,1874,10.965387258628596
SIM,1867,27,35-39,1894,15
SIM,1918,21,45-49,1939,2
STAT,1880,27,25-29,1907,45.348375827646706
STAT,1959,7,na,1966,5243.290823260217
SIM,1888,38,35-39,1926,13
STAT,1857,40,20-24,1897,0.1278060694523849
STAT,1870,18,na,1888,2527.709444453567
STAT,1849,107,na,1956,0.00465641794428541
STAT,1888,48,35-39,1936,0.09404470466135735
STAT,1921,36,25-29,1957,1.1228842992510892
SIM,1882,19,25-29,1901,6
STAT,1904,49,30-34,1953,0.07816669890896025
SIM,1788,93,na,1881,10
STAT,1938,28,50-100,1966,1.0054285080242948
STAT,1915,20,15-19,1935,5.42032536316759
STAT,1841,39,40-44,1880,3.729828442621929
SIM,1872,44,30-34,1916,4
STAT,1831,41,15-19,1872,0.011861381395846155
STAT,1849,30,20-24,1879,2.481044275478429
STAT,1899,28,40-44,1927,4.169981812839125
STAT,1881,39,35-39,1920,6.905653664518387
STAT,1864,44,30-34,1908,1.028767286515458
SIM,1885,6,na,1891,2648
STAT,1932,16,30-34,1948,16.500130051859646
STAT,1940,30,na,1970,3997.7352606267204
STAT,1952,9,na,1961,4803.851410317108
STAT,1868,50,25-29,1918,0.0035008172181675494
SIM,1906,27,35-39,1933,18
STAT,1861,41,na,1902,1957.1173197669114
STAT,1836,46,20-24,1882,0.00791806403520608
STAT,1850,41,na,1891,1746.3921305599117
STAT,1865,55,na,1920,1914.501841763422
SIM,1954,7,na,1961,4719
STAT,1857,20,na,1877,1995.1246979484004
STAT,1877,36,40-44,1913,4.65406726512155
STAT,1786,82,na,1868,137.36060562538182
STAT,1814,48,35-39,1862,0.4107336374447729
STAT,1876,15,40-44,1891,0.19357065434675272
SIM,1899,18,40-44,1917,1
STAT,1814,54,20-24,1868,0.0020224362804307783
SIM,1862,102,na,1964,5
STAT,1841,17,20-24,1858,16.88254426205531
STAT,1854,23,40-44,1877,1.8604413160023432
SIM,1881,29,35-39,1910,13
SIM,1923,20,15-19,1943,2
STAT,1854,18,45-49,1872,0.05945354896437893
STAT,1850,16,35-39,1866,0.5073520414872497
SIM,1887,16,50-100,1903,1
SIM,1835,48,45-49,1883,2
STAT,1851,35,30-34,1886,4.537338234491913
STAT,1897,3,na,1900,3606.0238516358227
STAT,1857,19,25-29,1876,5.24410813759504
STAT,1874,16,20-24,1890,18.51071327673141
SIM,1819,71,na,1890,654
STAT,1948,5,na,1953,4616.293794041657
SIM,1854,27,25-29,1881,56
STAT,1920,48,25-29,1968,0.05967247153541099
STAT,1872,46,30-34,1918,0.09925218798394092
STAT,1894,39,45-49,1933,2.5895617926040555
STAT,1853,31,25-29,1884,8.936598860561121
STAT,1899,48,35-39,1947,0.10893482756628799
STAT,1887,41,45-49,1928,1.718600590588895
SIM,1864,40,50-100,1904,5
SIM,1869,102,na,1971,17
STAT,1858,21,na,1879,1999.0105781495722
STAT,1895,27,20-24,1922,15.614690084875177
SIM,1858,29,35-39,1887,10
STAT,1931,25,50-100,1956,1.3116998142906844
STAT,1806,60,na,1866,1032.2279246527107
STAT,1839,28,20-24,1867,10.126413108981367
STAT,1886,49,15-19,1935,4.229062233099284E-4
SIM,1921,39,30-34,1960,6
SIM,1902,26,15-19,1928,1
SIM,1891,47,45-49,1938,1
STAT,1942,26,40-44,1968,4.993298844877909
STAT,1879,49,20-24,1928,0.012529084346234594
SIM,1849,36,50-100,1885,1
STAT,1884,53,na,1937,2138.320985918184
STAT,1919,24,15-19,1943,5.911051712423962
SIM,1870,43,45-49,1913,3
SIM,1871,34,50-100,1905,1
SIM,1849,35,40-44,1884,7
SIM,1824,45,na,1869,1455
STAT,1859,27,35-39,1886,7.996817185358877
SIM,1911,49,50-100,1960,1
STAT,1800,82,na,1882,206.48638373501788
STAT,1888,67,na,1955,1911.8047295674928
STAT,1899,43,40-44,1942,0.2166225253729805
SIM,1947,16,40-44,1963,1
STAT,1812,45,20-24,1857,0.02938978726392209
SIM,1889,34,na,1923,3116
SIM,1885,20,na,1905,2381
STAT,1827,48,45-49,1875,0.26149431803932227
STAT,1842,52,30-34,1894,0.00464316648173857
STAT,1840,31,15-19,1871,0.12611818581196638
SIM,1865,19,25-29,1884,8
STAT,1846,27,25-29,1873,36.59582864508627
STAT,1873,90,na,1963,179.61069304504466
SIM,1960,3,na,1963,5248
SIM,1872,18,na,1890,2659
STAT,1855,49,35-39,1904,0.10626178225216751
STAT,1872,68,na,1940,1562.4744854726434
SIM,1901,33,45-49,1934,6
STAT,1849,42,15-19,1891,0.010708206941899907
SIM,1873,18,20-24,1891,16
SIM,1805,63,na,1868,848
STAT,1814,41,15-19,1855,0.049794821725689685
SIM,1788,77,na,1865,417
STAT,1834,38,35-39,1872,5.85936411047299
STAT,1859,101,na,1960,1.0599207717839387
STAT,1844,45,40-44,1889,0.13475694509700425
STAT,1864,2,na,1866,3088.1556092951078
SIM,1809,77,na,1886,220
STAT,1902,16,45-49,1918,0.09420673437291055
STAT,1843,16,40-44,1859,0.18980796351442844
SIM,1855,22,na,1877,1942
STAT,1943,29,15-19,1972,0.7663136418051902
SIM,1882,40,50-100,1922,2
SIM,1892,17,na,1909,3699
STAT,1833,54,30-34,1887,0.0039002283529303698
SIM,1842,38,35-39,1880,1
SIM,1859,36,na,1895,2250
SIM,1882,16,20-24,1898,30
SIM,1891,75,na,1966,1613
STAT,1827,40,35-39,1867,2.228003528931319
STAT,1886,48,25-29,1934,0.061415666798719
STAT,1836,46,45-49,1882,0.15572192011602864
STAT,1920,19,50-100,1939,0.4266568728453436
STAT,1910,30,40-44,1940,3.8793646076600132
STAT,1899,21,20-24,1920,96.55930935360217
STAT,1900,17,na,1917,3571.0801298123306
SIM,1847,37,35-39,1884,6
STAT,1865,18,20-24,1883,16.81562178976213
STAT,1793,95,na,1888,2.871521976380155
STAT,1894,31,35-39,1925,13.34322737120755
STAT,1847,20,45-49,1867,0.6762985796760808
STAT,1901,32,40-44,1933,6.18666943220272
SIM,1881,54,na,1935,1894
SIM,1852,45,40-44,1897,2
STAT,1939,16,40-44,1955,1.428662986429763
STAT,1882,19,35-39,1901,0.5424247055691956
STAT,1843,31,40-44,1874,4.252701504438886
STAT,1816,81,na,1897,239.94446271521477
SIM,1803,83,na,1886,59
SIM,1913,17,na,1930,4153
STAT,1898,41,20-24,1939,0.015282962067554383
STAT,1850,29,40-44,1879,2.613716306064867
SIM,1780,97,na,1877,1
SIM,1845,29,25-29,1874,6
STAT,1853,30,35-39,1883,8.928018942241463
SIM,1882,15,30-34,1897,4
SIM,1943,5,na,1948,3953
STAT,1921,5,na,1926,4676.816055286512
SIM,1887,54,na,1941,2489
SIM,1888,36,50-100,1924,2
SIM,1933,32,na,1965,5138
STAT,1917,39,15-19,1956,0.020230978951592628
STAT,1882,17,50-100,1899,0.04869189294994636
SIM,1927,24,15-19,1951,9
STAT,1843,36,35-39,1879,6.73523588845045
SIM,1828,37,25-29,1865,4
STAT,1888,47,20-24,1935,0.014404772630328981
STAT,1823,37,20-24,1860,1.4442903100903544
STAT,1818,88,na,1906,69.96202401138748
SIM,1884,40,30-34,1924,2
STAT,1876,40,30-34,1916,1.2233146773502046
STAT,1940,32,50-100,1972,0.8729564574942007
SIM,1925,20,25-29,1945,143
STAT,1904,7,na,1911,3809.202246927748
SIM,1894,30,25-29,1924,1
STAT,1841,18,35-39,1859,0.519447637493646
SIM,1844,46,45-49,1890,1
SIM,1883,40,na,1923,2428
SIM,1917,23,50-100,1940,2
STAT,1821,39,15-19,1860,0.1082367139824919
SIM,1847,28,20-24,1875,17
SIM,1861,38,45-49,1899,5
SIM,1921,47,na,1968,4843
STAT,1884,17,40-44,1901,0.18460087670106595
STAT,1916,16,na,1932,4191.965082234485
STAT,1919,37,20-24,1956,0.2889952351494661
SIM,1880,41,50-100,1921,2
STAT,1837,29,25-29,1866,35.681882636422685
SIM,1903,18,na,1921,3585
SIM,1860,92,na,1952,22
STAT,1890,28,20-24,1918,14.581563209529984
SIM,1862,26,20-24,1888,13
STAT,1847,46,20-24,1893,0.009384324928730575
STAT,1874,15,30-34,1889,1.6740510411307392
SIM,1861,31,25-29,1892,14
SIM,1914,50,na,1964,3702
STAT,1939,17,30-34,1956,12.446291019318432
STAT,1854,26,20-24,1880,10.418349019019978
SIM,1914,26,30-34,1940,61
SIM,1916,34,40-44,1950,7
STAT,1827,100,na,1927,0.6861617107487336
SIM,1851,31,40-44,1882,6
STAT,1853,38,45-49,1891,1.6632451659478666
STAT,1892,36,30-34,1928,6.846992116893471
STAT,1925,44,45-49,1969,0.20489077553341592
STAT,1823,46,35-39,1869,0.21347189151525472
STAT,1906,49,40-44,1955,0.14039918430254314
STAT,1840,36,na,1876,1841.9357239683827
STAT,1895,19,45-49,1914,0.08647870105747829
SIM,1825,31,15-19,1856,2
SIM,1833,45,30-34,1878,1
SIM,1858,21,25-29,1879,81
STAT,1862,43,45-49,1905,1.2902937638229541
SIM,1836,28,45-49,1864,1
SIM,1879,35,na,1914,2947
STAT,1896,43,15-19,1939,0.0012827551525338844
SIM,1947,17,30-34,1964,17
SIM,1837,95,na,1932,6
STAT,1884,22,15-19,1906,3.329647593389834
SIM,1833,81,na,1914,344
SIM,1820,34,40-44,1854,2
STAT,1910,49,30-34,1959,0.0843323015148917
STAT,1814,108,na,1922,8.535597539314927E-4
SIM,1892,22,15-19,1914,3
STAT,1920,21,na,1941,4155.500895945036
SIM,1908,25,50-100,1933,1
STAT,1887,28,25-29,1915,48.18595284056178
STAT,1825,45,30-34,1870,0.127959947399288
SIM,1927,37,20-24,1964,1
SIM,1895,28,25-29,1923,71
SIM,1862,62,na,1924,1620
STAT,1920,16,15-19,1936,52.08865324027298
SIM,1861,30,35-39,1891,4
STAT,1808,48,35-39,1856,0.35746238705724853
STAT,1845,48,15-19,1893,3.086114570037105E-4
STAT,1890,37,35-39,1927,8.822315657887184
STAT,1828,28,45-49,1856,1.402407162454887
STAT,1947,23,15-19,1970,6.136127681863284
STAT,1875,39,35-39,1914,7.330891839671075
SIM,1885,32,25-29,1917,13
STAT,1847,39,35-39,1886,5.6050159756242115
STAT,1821,42,45-49,1863,2.5968795851078403
STAT,1882,17,30-34,1899,1.5841099060373622
SIM,1891,30,20-24,1921,2
STAT,1908,34,40-44,1942,3.734463049357379
STAT,1887,17,45-49,1904,0.07467233637542788
STAT,1893,15,40-44,1908,0.23780310439104788
STAT,1817,41,40-44,1858,5.887552219770717
SIM,1879,21,45-49,1900,3
STAT,1832,35,20-24,1867,0.6689377581941744
STAT,1882,26,20-24,1908,11.699630321440745
SIM,1924,36,40-44,1960,3
STAT,1866,53,30-34,1919,0.0055112387702705955
STAT,1838,19,15-19,1857,5.691982734381537
STAT,1825,74,na,1899,665.4989499201695
SIM,1834,24,40-44,1858,1
SIM,1883,39,35-39,1922,9
STAT,1911,18,15-19,1929,9.239308301619237
STAT,1817,46,35-39,1863,0.31769796347356455
STAT,1824,89,na,1913,57.844077719888524
STAT,1941,17,35-39,1958,4.409444675315004
STAT,1806,52,20-24,1858,0.002398905687703741
SIM,1836,20,35-39,1856,7
SIM,1875,69,na,1944,1416
STAT,1901,48,15-19,1949,3.17839034510671E-4
SIM,1823,35,20-24,1858,3
SIM,1928,16,30-34,1944,20
SIM,1924,40,25-29,1964,1
STAT,1868,36,na,1904,2306.636017413855
SIM,1818,41,25-29,1859,2
STAT,1845,47,25-29,1892,0.044795765202215274
SIM,1852,37,50-100,1889,1
STAT,1868,41,35-39,1909,1.7723813066522522
STAT,1873,30,15-19,1903,0.14846897564325826
STAT,1894,32,25-29,1926,13.440531920191539
SIM,1896,21,45-49,1917,1
STAT,1837,43,na,1880,1633.0195161804106
STAT,1865,27,35-39,1892,8.933970148524132
SIM,1867,45,50-100,1912,2
SIM,1846,19,15-19,1865,5
SIM,1856,87,na,1943,80
SIM,1852,73,na,1925,915
STAT,1877,13,na,1890,2728.2812556748927
SIM,1820,37,45-49,1857,1
SIM,1825,41,40-44,1866,4
STAT,1873,43,20-24,1916,0.163065789877879
SIM,1859,31,50-100,1890,1
SIM,1880,17,25-29,1897,12
SIM,1835,88,na,1923,98
SIM,1831,74,na,1905,749
SIM,1839,21,15-19,1860,3
SIM,1947,21,15-19,1968,7
STAT,1921,28,25-29,1949,74.59260669956497
SIM,1881,38,25-29,1919,5
STAT,1867,37,35-39,1904,6.773961168612541
STAT,1884,32,40-44,1916,4.376972562333348
SIM,1839,29,25-29,1868,48
SIM,1834,44,na,1878,1659
STAT,1868,20,na,1888,2337.877541417345
STAT,1880,16,20-24,1896,19.05218851758526
STAT,1842,46,45-49,1888,0.18748995839233765
STAT,1868,42,25-29,1910,0.6249265119129824
SIM,1875,37,35-39,1912,9
STAT,1916,36,40-44,1952,1.5719284899463477
SIM,1813,46,50-100,1859,1
SIM,1838,39,35-39,1877,8
STAT,1806,92,na,1898,14.79945101107503
STAT,1872,17,25-29,1889,5.812889273385653
SIM,1851,36,35-39,1887,11
STAT,1864,38,20-24,1902,0.695755242917188
SIM,1830,30,na,1860,1908
SIM,1898,49,50-100,1947,2
SIM,1828,26,45-49,1854,1
SIM,1892,32,40-44,1924,11
STAT,1909,37,15-19,1946,0.018537761747037102
SIM,1902,33,na,1935,3471
STAT,1868,49,45-49,1917,0.22514949954620472
STAT,1873,38,25-29,1911,2.963038549003607
SIM,1868,72,na,1940,1239
SIM,1843,37,na,1880,1882
STAT,1856,35,na,1891,1904.5927416105135
STAT,1852,21,na,1873,2061.022888664655
STAT,1893,20,15-19,1913,4.294894073248104
SIM,1854,40,45-49,1894,3
SIM,1847,73,na,1920,718
SIM,1943,27,15-19,1970,1
SIM,1923,24,30-34,1947,49
STAT,1875,17,na,1892,2644.3365285381933
SIM,1890,16,30-34,1906,4
SIM,1875,27,45-49,1902,3
SIM,1892,37,35-39,1929,19
STAT,1939,21,15-19,1960,5.455398339675193
STAT,1892,43,30-34,1935,1.4593035964678018
STAT,1871,24,na,1895,2374.9784297354813
STAT,1887,2,na,1889,3203.344248962709
SIM,1864,29,35-39,1893,18
STAT,1856,29,35-39,1885,7.892267658355525
STAT,1870,45,45-49,1915,0.23770037499240088
SIM,1850,77,na,1927,437
STAT,1827,41,25-29,1868,0.7754484952668824
STAT,1934,24,40-44,1958,4.604949665631811
SIM,1871,76,na,1947,992
STAT,1883,47,45-49,1930,0.23512653675300096
SIM,1835,40,35-39,1875,5
SIM,1875,32,40-44,1907,1
STAT,1846,16,45-49,1862,0.05902932967439268
STAT,1893,27,35-39,1920,12.487126623225578
STAT,1873,15,50-100,1888,0.05127203595210789
STAT,1915,24,30-34,1939,30.127148201818482
SIM,1822,38,na,1860,1501
SIM,1929,0,na,1929,5560
STAT,1773,96,na,1869,1.4972490734400863
SIM,1890,26,20-24,1916,17
STAT,1862,36,45-49,1898,1.7394760100558984
STAT,1910,15,40-44,1925,0.2839837422408877
SIM,1899,27,30-34,1926,48
SIM,1820,49,50-100,1869,2
SIM,1856,35,50-100,1891,2
SIM,1877,29,45-49,1906,2
SIM,1937,30,45-49,1967,2
STAT,1826,36,35-39,1862,6.4841794207078145
SIM,1868,51,na,1919,2147
STAT,1864,47,35-39,1911,0.1263994828525546
STAT,1877,32,25-29,1909,10.837555873811114
SIM,1918,30,35-39,1948,23
STAT,1884,37,35-39,1921,7.138576665198533
STAT,1883,30,20-24,1913,2.727416923238126
SIM,1876,49,45-49,1925,2
SIM,1855,39,35-39,1894,2
SIM,1872,47,35-39,1919,1
STAT,1803,54,45-49,1857,0.05630013731315073
SIM,1792,82,na,1874,147
STAT,1935,27,15-19,1962,0.981361496255747
SIM,1939,18,35-39,1957,9
SIM,1822,59,na,1881,1113
SIM,1926,25,50-100,1951,3
STAT,1900,39,20-24,1939,0.232886585212921
STAT,1764,117,na,1881,1.2056203792869319E-4
STAT,1888,21,45-49,1909,0.8435229077623378
STAT,1904,47,na,1951,3274.688634408225
STAT,1858,42,40-44,1900,1.8174410803325682
STAT,1867,28,45-49,1895,1.05962943584636
SIM,1834,36,35-39,1870,14
STAT,1945,27,20-24,1972,20.432139052485958
SIM,1871,55,na,1926,1905
SIM,1802,98,na,1900,2
SIM,1870,36,20-24,1906,5
STAT,1821,60,na,1881,1081.6623693500026
STAT,1836,74,na,1910,690.7707871577202
SIM,1907,36,40-44,1943,2
SIM,1819,39,25-29,1858,1
STAT,1831,45,30-34,1876,0.08123223017246267
STAT,1847,53,20-24,1900,5.661998476614201E-4
STAT,1846,8,na,1854,2206.0
SIM,1889,50,na,1939,2854
SIM,1924,26,50-100,1950,5
STAT,1900,33,na,1933,3359.8850865703375
SIM,1821,33,50-100,1854,1
SIM,1902,65,na,1967,2635
SIM,1840,35,20-24,1875,3
STAT,1876,19,35-39,1895,0.5749264980289824
STAT,1877,54,45-49,1931,0.014933118733010784
STAT,1933,19,50-100,1952,0.508727985916943
STAT,1846,40,45-49,1886,1.111351783355056
STAT,1869,54,50-100,1923,0.01446577744199429
SIM,1927,22,50-100,1949,2
SIM,1877,65,na,1942,1716
STAT,1912,28,50-100,1940,0.9970942978690248
STAT,1912,49,40-44,1961,0.1536643667803445
STAT,1834,35,30-34,1869,4.554841181184857
STAT,1906,22,15-19,1928,4.898541783859933
SIM,1849,38,45-49,1887,4
STAT,1830,26,50-100,1856,0.7872504205638106
STAT,1860,16,40-44,1876,0.17563739205364406
SIM,1823,60,na,1883,1127
SIM,1875,21,na,1896,2363
STAT,1857,16,20-24,1873,16.699700048519922
STAT,1828,39,25-29,1867,2.4196146443917295
STAT,1860,40,na,1900,1932.3494249411692
SIM,1830,89,na,1919,87
STAT,1852,51,25-29,1903,0.002867104066398809
SIM,1864,27,30-34,1891,38
SIM,1837,27,25-29,1864,44
STAT,1819,46,45-49,1865,0.4743976160889611
STAT,1930,18,25-29,1948,56.99156779187345
STAT,1894,36,40-44,1930,5.77188624113523
SIM,1860,55,na,1915,1849
STAT,1841,32,50-100,1873,0.8208114106190801
STAT,1838,22,na,1860,2038.2036100356763
STAT,1814,74,na,1888,533.6257627825142
STAT,1878,27,20-24,1905,12.4571732903953
SIM,1920,49,40-44,1969,1
STAT,1864,53,20-24,1917,6.586064323660962E-4
STAT,1922,41,15-19,1963,0.001801135047021621
SIM,1833,59,na,1892,1287
STAT,1862,10,na,1872,2404.044783353223
STAT,1893,17,45-49,1910,0.08453688877277289
SIM,1841,16,35-39,1857,1
STAT,1844,40,35-39,1884,1.4744317180303468
STAT,1935,31,45-49,1966,2.221425537624706
STAT,1874,19,25-29,1893,5.870595637396394
SIM,1836,39,25-29,1875,3
STAT,1910,33,45-49,1943,1.5409487731533271
STAT,1942,29,45-49,1971,1.8480980006460228
STAT,1930,28,50-100,1958,1.290214585497883
STAT,1775,82,na,1857,145.95577822577852
SIM,1842,35,30-34,1877,2
STAT,1848,108,na,1956,0.001718118553034091
SIM,1879,37,30-34,1916,8
STAT,1875,32,15-19,1907,0.14910235188337279
STAT,1851,33,40-44,1884,3.6854496806932002
SIM,1884,19,35-39,1903,1
STAT,1829,27,25-29,1856,60.180394837366975
SIM,1872,40,na,1912,2459
SIM,1923,27,35-39,1950,2
STAT,1872,49,35-39,1921,0.140151494298247
SIM,1912,54,na,1966,3564
STAT,1856,27,30-34,1883,20.896337585781367
SIM,1893,45,50-100,1938,1
STAT,1862,40,40-44,1902,1.9729804241043514
SIM,1880,49,35-39,1929,1
STAT,1868,46,40-44,1914,0.1672852995529607
SIM,1834,26,45-49,1860,3
SIM,1870,40,40-44,1910,3
STAT,1866,47,45-49,1913,0.22103366634818553
STAT,1810,60,na,1870,987.9362111255746
STAT,1920,45,20-24,1965,0.012525096190242885
SIM,1874,47,45-49,1921,1
STAT,1880,17,na,1897,2707.5245615853096
STAT,1847,49,25-29,1896,0.04397939172219963
SIM,1920,28,50-100,1948,1
SIM,1838,37,30-34,1875,7
STAT,1896,18,25-29,1914,7.615082180995952
STAT,1900,21,50-100,1921,0.5783359336291745
STAT,1905,32,na,1937,3545.765215963552
STAT,1921,33,20-24,1954,2.7581969015997028
SIM,1884,38,50-100,1922,3
STAT,1850,25,na,1875,1942.7128383627273
SIM,1884,20,15-19,1904,3
STAT,1912,46,25-29,1958,0.05213427590408898
STAT,1835,29,15-19,1864,0.4344427770871091
STAT,1888,41,15-19,1929,0.016730293112830443
STAT,1855,42,15-19,1897,0.010692176080273858
STAT,1841,15,30-34,1856,1.5358506859148706
SIM,1894,37,45-49,1931,5
STAT,1886,19,50-100,1905,0.05261832076965441
STAT,1834,26,40-44,1860,2.662502394668369
STAT,1908,13,na,1921,3900.375063189324
SIM,1900,69,na,1969,2373
SIM,1827,30,50-100,1857,2
SIM,1852,40,35-39,1892,3
SIM,1878,28,25-29,1906,60
SIM,1911,16,15-19,1927,7
STAT,1868,17,35-39,1885,0.5443244566720036
SIM,1858,73,na,1931,1009
STAT,1828,48,15-19,1876,3.08746712555211E-4
STAT,1925,41,40-44,1966,0.30940046968226975
STAT,1942,21,35-39,1963,10.075685579738378
SIM,1839,26,20-24,1865,8
STAT,1812,48,25-29,1860,0.13400578983163788
SIM,1798,92,na,1890,2
STAT,1763,97,na,1860,0.315810141760079
SIM,1861,77,na,1938,748
STAT,1858,48,50-100,1906,0.19619570795433255
STAT,1895,39,15-19,1934,0.07399008802286251
SIM,1832,37,na,1869,1784
SIM,1925,23,50-100,1948,4
STAT,1897,28,30-34,1925,34.22812401205464
STAT,1903,16,15-19,1919,8.627212449334976
STAT,1825,48,35-39,1873,0.17761296403734625
STAT,1852,17,45-49,1869,0.06364663320950435
STAT,1930,16,20-24,1946,179.2072747807651
STAT,1805,97,na,1902,2.159248596726668
SIM,1858,26,30-34,1884,33
STAT,1860,106,na,1966,0.07386423086216992
STAT,1904,28,25-29,1932,61.62975892714576
STAT,1886,37,45-49,1923,2.152591068156543
SIM,1866,48,50-100,1914,2
STAT,1954,6,na,1960,4957.036707331126
SIM,1914,22,15-19,1936,6
STAT,1832,37,25-29,1869,2.445158877406587
STAT,1844,48,45-49,1892,0.18058120493258056
STAT,1869,29,45-49,1898,1.0857311224303827
SIM,1896,20,na,1916,3105
SIM,1861,35,40-44,1896,5
SIM,1944,20,35-39,1964,14
STAT,1864,54,na,1918,1899.3913572229878
STAT,1911,17,na,1928,3942.3626979166725
SIM,1863,36,na,1899,2050
SIM,1901,30,40-44,1931,10
STAT,1826,37,na,1863,1661.2632362554293
SIM,1862,29,25-29,1891,41
STAT,1854,29,25-29,1883,33.45453949726081
STAT,1823,52,20-24,1875,0.001068025803929825
STAT,1879,20,na,1899,2537.028987166744
SIM,1811,75,na,1886,290
STAT,1785,81,na,1866,206.0923324971553
STAT,1836,58,na,1894,1230.9250618661663
STAT,1832,44,na,1876,1665.2082005593934
SIM,1842,26,40-44,1868,5
STAT,1855,46,30-34,1901,0.07525224358405319
SIM,1912,46,50-100,1958,2
STAT,1890,43,20-24,1933,0.1966623663863375
STAT,1936,20,35-39,1956,9.187930908419062
SIM,1882,39,na,1921,2239
SIM,1840,37,25-29,1877,6
STAT,1853,35,40-44,1888,3.7475549460283983
STAT,1861,25,na,1886,2055.7944157660577
SIM,1797,81,na,1878,165
STAT,1834,31,15-19,1865,0.12403782029246883
STAT,1876,16,30-34,1892,1.6831526314068033
STAT,1897,27,30-34,1924,34.349032606830704
SIM,1812,60,na,1872,1003
SIM,1912,28,25-29,1940,76
STAT,1871,51,35-39,1922,0.008741290952367139
STAT,1852,16,45-49,1868,0.06402373299685585
SIM,1888,29,20-24,1917,20
SIM,1944,6,na,1950,4311
SIM,1889,13,na,1902,3360
STAT,1880,39,na,1919,2500.2574733694805
SIM,1833,43,40-44,1876,6
STAT,1931,20,20-24,1951,147.9585226146114
STAT,1867,25,40-44,1892,2.8884104102110544
STAT,1940,30,15-19,1970,0.1358329041824025
SIM,1883,36,30-34,1919,6
STAT,1855,19,15-19,1874,5.4075128529563905
SIM,1856,27,35-39,1883,1
STAT,1914,32,50-100,1946,0.8491373671417024
SIM,1924,39,45-49,1963,1
STAT,1923,26,30-34,1949,46.056878926946766
SIM,1826,41,na,1867,1627
SIM,1899,22,25-29,1921,2
STAT,1908,37,45-49,1945,0.6508574873887946
STAT,1825,40,25-29,1865,0.9141165398457398
STAT,1869,21,35-39,1890,5.764765467579257
STAT,1916,31,35-39,1947,9.667289988733797
STAT,1832,38,25-29,1870,2.4187881234719355
STAT,1816,52,50-100,1868,0.02971432119839227
SIM,1922,32,50-100,1954,2
STAT,1855,43,50-100,1898,0.8130437019081316
STAT,1831,54,20-24,1885,5.102640485489075E-4
SIM,1864,23,15-19,1887,3
STAT,1892,39,35-39,1931,8.952152354902198
STAT,1867,34,30-34,1901,16.57856025452643
STAT,1871,23,40-44,1894,2.099233418913639
STAT,1824,39,40-44,1863,5.650837206645801
SIM,1838,36,30-34,1874,9
STAT,1811,82,na,1893,202.10410431666025
STAT,1899,67,na,1966,2486.7758812784505
SIM,1812,46,25-29,1858,1
STAT,1925,22,25-29,1947,112.80408605299462
STAT,1916,39,45-49,1955,0.7052470870372234
STAT,1841,16,30-34,1857,1.5268045253748315
SIM,1897,26,30-34,1923,60
SIM,1909,50,na,1959,3281
STAT,1849,37,40-44,1886,3.477585176559391
SIM,1898,27,na,1925,3653
SIM,1869,39,50-100,1908,1
SIM,1875,34,30-34,1909,24
SIM,1877,21,35-39,1898,7
SIM,1933,22,25-29,1955,5
STAT,1880,28,15-19,1908,0.484670491442303
STAT,1914,46,na,1960,3726.6821207662024
SIM,1869,27,45-49,1896,2
STAT,1830,25,45-49,1855,1.5352080193022923
STAT,1910,32,na,1942,3719.332789507242
SIM,1840,38,25-29,1878,2
STAT,1914,43,30-34,1957,0.12904643696027515
STAT,1895,53,na,1948,2819.9521131210313
STAT,1875,36,30-34,1911,5.606982169884544
SIM,1814,56,na,1870,1137
STAT,1834,106,na,1940,0.00815942856894213
SIM,1832,39,40-44,1871,9
STAT,1889,26,30-34,1915,31.8417091799657
SIM,1877,30,25-29,1907,16
STAT,1888,49,25-29,1937,0.03836688574920328
STAT,1900,16,35-39,1916,0.7777526439794282
STAT,1894,47,20-24,1941,0.008840994324351462
STAT,1813,109,na,1922,3.05947156343914E-4
SIM,1878,50,na,1928,2479
STAT,1831,59,na,1890,1309.5473230627647
SIM,1781,82,na,1863,141
SIM,1809,56,na,1865,905
STAT,1944,20,30-34,1964,31.68272765355931
SIM,1839,37,50-100,1876,4
STAT,1917,20,25-29,1937,100.78102708628707
SIM,1924,31,35-39,1955,19
STAT,1848,50,20-24,1898,5.81852177946842E-4
SIM,1880,91,na,1971,65
STAT,1871,37,25-29,1908,2.909499663652566
STAT,1909,41,45-49,1950,0.15967556714769043
SIM,1825,30,na,1855,1679
SIM,1904,26,25-29,1930,63
STAT,1837,26,20-24,1863,10.111905335183431
SIM,1931,26,30-34,1957,76
STAT,1811,50,25-29,1861,0.009758429084065415
STAT,1840,37,20-24,1877,0.6560758983676127
STAT,1898,17,20-24,1915,24.45743845886792
SIM,1857,37,40-44,1894,4
SIM,1909,28,na,1937,3619
STAT,1915,27,35-39,1942,15.626599740958763
SIM,1929,24,25-29,1953,151
STAT,1867,30,15-19,1897,0.1374846538136589
SIM,1905,14,na,1919,3732
STAT,1881,32,15-19,1913,0.14045347076324094
STAT,1893,24,30-34,1917,22.907395556683724
STAT,1858,20,20-24,1878,64.89464875959546
SIM,1906,20,15-19,1926,5
SIM,1864,26,30-34,1890,26
STAT,1860,21,15-19,1881,2.8352664467757864
SIM,1834,33,30-34,1867,31
SIM,1900,45,45-49,1945,2
SIM,1929,27,na,1956,4879
STAT,1851,30,25-29,1881,8.979840710086417
STAT,1840,63,na,1903,1283.9816753208045
STAT,1810,97,na,1907,2.2903659612739236
STAT,1831,48,35-39,1879,0.11303518312679728
STAT,1889,28,35-39,1917,12.116235901430386
STAT,1824,102,na,1926,0.16142663818415798
SIM,1845,26,20-24,1871,13
STAT,1922,16,25-29,1938,51.29911340116139
STAT,1914,40,15-19,1954,0.0015634138276962746
STAT,1829,88,na,1917,91.3050977324132
STAT,1845,33,40-44,1878,3.9872990002558075
STAT,1853,46,20-24,1899,0.0100905524634963
STAT,1905,30,20-24,1935,4.014549098329512
STAT,1846,36,na,1882,1777.7799560431868
STAT,1885,50,25-29,1935,0.003656790765528291
SIM,1813,82,na,1895,190
SIM,1902,0,na,1902,4014
STAT,1806,48,25-29,1854,0.20227352838095472
STAT,1877,51,40-44,1928,0.011192454805888147
STAT,1913,39,30-34,1952,1.8164183336464161
STAT,1926,31,na,1957,4668.05208332015
SIM,1930,16,25-29,1946,76
STAT,1827,45,40-44,1872,0.1975321044064356
SIM,1897,28,35-39,1925,24
SIM,1910,47,na,1957,3461
SIM,1849,37,45-49,1886,4
STAT,1847,48,25-29,1895,0.044352842657374714
STAT,1830,50,35-39,1880,0.007183400073589305
SIM,1866,20,20-24,1886,1
SIM,1942,27,45-49,1969,1
STAT,1880,19,25-29,1899,6.042322255338803
STAT,1856,26,30-34,1882,21.04745833663843
SIM,1867,87,na,1954,65
STAT,1861,19,15-19,1880,5.6824186686385625
STAT,1825,43,40-44,1868,3.0077355900840237
STAT,1872,30,45-49,1902,1.7972670059829754
SIM,1863,73,na,1936,878
STAT,1852,42,35-39,1894,1.456998533385281
STAT,1879,9,na,1888,2801.90942552917
STAT,1932,39,40-44,1971,2.0468560520389665
SIM,1834,27,45-49,1861,1
STAT,1888,30,35-39,1918,12.31161960889902
STAT,1847,40,15-19,1887,0.011110211964877506
SIM,1846,88,na,1934,52
SIM,1856,25,30-34,1881,35
STAT,1883,68,na,1951,1529.6729247544022
SIM,1879,38,30-34,1917,7
SIM,1912,26,20-24,1938,17
STAT,1864,17,na,1881,2369.919018026311
STAT,1892,34,40-44,1926,5.497288403279309
STAT,1851,38,35-39,1889,5.836848256769072
STAT,1869,49,15-19,1918,3.857373933983304E-4
SIM,1928,42,na,1970,4976
SIM,1899,71,na,1970,2284
SIM,1842,74,na,1916,896
STAT,1803,51,40-44,1854,0.04339063886530819
STAT,1863,91,na,1954,51.83152453463191
STAT,1830,36,25-29,1866,2.637898626547406
STAT,1853,49,25-29,1902,0.04728910847139007
STAT,1934,27,45-49,1961,2.3700786711844737
SIM,1844,22,na,1866,2117
SIM,1848,36,na,1884,1924
SIM,1866,45,45-49,1911,2
SIM,1907,32,25-29,1939,3
STAT,1870,42,40-44,1912,2.24035724514865
SIM,1880,30,45-49,1910,6
STAT,1826,33,30-34,1859,17.85119395736201
STAT,1893,18,45-49,1911,0.0843154021241882
STAT,1848,25,30-34,1873,23.707742712465727
STAT,1856,17,50-100,1873,0.046390304570590575
STAT,1904,26,20-24,1930,17.21101574106422
SIM,1913,30,20-24,1943,6
SIM,1868,8,na,1876,2741
STAT,1896,49,20-24,1945,0.008929811405934449
SIM,1843,18,35-39,1861,1
SIM,1896,30,35-39,1926,23
SIM,1917,29,15-19,1946,1
SIM,1919,37,25-29,1956,3
STAT,1841,32,20-24,1873,2.4215140289322474
STAT,1866,45,30-34,1911,0.09199400130753542
STAT,1868,53,40-44,1921,0.010093097995030074
SIM,1941,29,na,1970,3720
STAT,1923,34,30-34,1957,18.40471558844367
SIM,1944,21,35-39,1965,12
STAT,1880,46,50-100,1926,0.2640380030012764
STAT,1883,89,na,1972,329.66409643492653
STAT,1921,26,20-24,1947,20.831081451914436
SIM,1893,18,na,1911,3294
STAT,1906,37,35-39,1943,2.2668070285724427
STAT,1884,36,35-39,1920,7.172935023963319
STAT,1886,44,45-49,1930,1.5942759920394076
STAT,1860,19,45-49,1879,0.06162574327731338
SIM,1871,40,45-49,1911,5
STAT,1864,32,15-19,1896,0.1291754820586377
STAT,1766,116,na,1882,1.6435547481699977E-4
STAT,1869,17,50-100,1886,0.048920692068803825
SIM,1881,22,15-19,1903,2
STAT,1901,28,45-49,1929,1.5783598562360819
SIM,1793,83,na,1876,79
SIM,1802,61,na,1863,923
STAT,1913,18,25-29,1931,9.01518986602988
STAT,1835,21,40-44,1856,2.0795894202983503
SIM,1876,48,na,1924,2557
STAT,1886,22,25-29,1908,61.81450416440285
STAT,1885,15,45-49,1900,0.0667927540398035
SIM,1840,34,20-24,1874,2
STAT,1908,50,na,1958,3357.4471404665164
STAT,1936,21,35-39,1957,9.184623253292035
STAT,1856,51,na,1907,1732.514172791673
STAT,1891,26,25-29,1917,53.60995339086896
STAT,1941,29,40-44,1970,4.914275399682183
STAT,1824,35,25-29,1859,4.300298668892432
SIM,1843,21,40-44,1864,1
STAT,1812,45,na,1857,1433.0669012914195
STAT,1863,40,45-49,1903,1.352180073046243
STAT,1855,104,na,1959,0.11057600322410284
SIM,1861,72,na,1933,1235
STAT,1819,53,45-49,1872,0.027104858670582647
STAT,1796,81,na,1877,207.85910870166782
STAT,1817,45,35-39,1862,0.3226701352682875
STAT,1882,20,15-19,1902,3.2983868617492806
STAT,1869,40,50-100,1909,1.0510074768416993
SIM,1919,26,30-34,1945,55
SIM,1876,40,35-39,1916,3
SIM,1834,23,40-44,1857,1
SIM,1921,18,25-29,1939,122
SIM,1882,18,35-39,1900,2
STAT,1814,53,50-100,1867,0.042229496015075314
STAT,1854,1,na,1855,2906.4129640878473
STAT,1935,37,50-100,1972,0.598715709194127
STAT,1801,83,na,1884,133.40619890684138
STAT,1826,53,na,1879,1351.9307127335053
STAT,1889,68,na,1957,1983.3540345206447
SIM,1832,35,25-29,1867,6
SIM,1931,21,25-29,1952,174
SIM,1768,94,na,1862,4
STAT,1826,52,35-39,1878,0.006495546932000751
STAT,1836,50,40-44,1886,0.006898587039108996
STAT,1864,70,na,1934,1272.7037938016736
STAT,1851,20,na,1871,2137.13021281093
STAT,1910,26,45-49,1936,1.7073315082468874
SIM,1888,33,na,1921,2760
STAT,1944,17,15-19,1961,49.82882750472803
STAT,1818,105,na,1923,0.014942306547488206
STAT,1850,62,na,1912,1374.8281924380242
STAT,1875,30,25-29,1905,10.810317832864367
SIM,1883,30,25-29,1913,4
SIM,1892,36,35-39,1928,18
STAT,1912,24,50-100,1936,0.6661721941553536
SIM,1842,42,30-34,1884,1
SIM,1909,33,35-39,1942,13
STAT,1877,46,45-49,1923,0.2504172557118915
STAT,1866,41,25-29,1907,0.6069847125928287
STAT,1938,28,40-44,1966,4.7082400804580455
SIM,1886,28,20-24,1914,18
STAT,1927,23,35-39,1950,11.797254276901231
STAT,1859,51,35-39,1910,0.007047488325143563
STAT,1839,37,50-100,1876,1.0125583823169786
SIM,1918,27,na,1945,4180
STAT,1815,42,20-24,1857,0.5017149097473321
SIM,1841,17,35-39,1858,1
SIM,1922,32,na,1954,4316
SIM,1851,78,na,1929,491
SIM,1853,29,20-24,1882,12
STAT,1924,41,50-100,1965,0.14277386381154694
STAT,1845,21,25-29,1866,55.92934721782185
STAT,1827,30,50-100,1857,1.5694378463459169
STAT,1932,27,35-39,1959,20.054416409864785
STAT,1869,26,40-44,1895,2.960480988656547
SIM,1793,61,na,1854,819
SIM,1953,14,na,1967,4766
STAT,1838,42,15-19,1880,0.0118664358537134
STAT,1929,12,na,1941,5157.516251038036
STAT,1834,42,30-34,1876,0.9327009896816034
STAT,1867,32,40-44,1899,4.153410905828527
STAT,1901,18,50-100,1919,0.06970767987057137
SIM,1922,23,25-29,1945,7
STAT,1832,34,20-24,1866,2.31893709709833
SIM,1851,35,35-39,1886,5
STAT,1914,36,30-34,1950,1.8655861520382069
STAT,1895,20,25-29,1915,76.64915568583854
SIM,1834,21,15-19,1855,2
SIM,1935,23,35-39,1958,1
STAT,1770,108,na,1878,0.003112435778892488
SIM,1940,27,35-39,1967,20
STAT,1934,29,na,1963,5134.188273664489
STAT,1851,41,50-100,1892,0.8755349124702246
STAT,1922,42,15-19,1964,0.00179854141255391
STAT,1878,28,20-24,1906,12.413324040413103
STAT,1909,29,15-19,1938,0.6831609467907876
SIM,1900,35,40-44,1935,2
SIM,1837,24,20-24,1861,2
STAT,1845,29,20-24,1874,10.99742324351525
SIM,1848,90,na,1938,82
STAT,1860,112,na,1972,4.63629939861942E-4
SIM,1901,64,na,1965,2857
SIM,1905,31,25-29,1936,7
STAT,1892,31,25-29,1923,13.14932124943802
SIM,1826,89,na,1915,24
STAT,1826,43,na,1869,1562.4431222655342
SIM,1853,21,25-29,1874,87
SIM,1901,54,na,1955,3199
SIM,1922,36,30-34,1958,1
SIM,1869,24,40-44,1893,5
STAT,1882,33,20-24,1915,2.675170385822196
STAT,1896,15,20-24,1911,23.997578516531245
STAT,1891,6,na,1897,3299.401883323798
STAT,1870,30,35-39,1900,10.180525139605226
STAT,1851,42,na,1893,1904.4653745253697
SIM,1903,23,15-19,1926,3
STAT,1845,43,45-49,1888,1.1756577328936897
STAT,1855,20,40-44,1875,1.9145412943950364
STAT,1880,29,15-19,1909,0.482906290853453
SIM,1853,43,45-49,1896,2
STAT,1801,53,50-100,1854,0.04169571990164946
STAT,1865,24,30-34,1889,16.454073144517555
SIM,1873,24,30-34,1897,19
STAT,1933,39,45-49,1972,0.9449361380111821
STAT,1864,92,na,1956,42.945907070855355
SIM,1890,33,20-24,1923,3
STAT,1902,39,30-34,1941,1.6382789376216638
SIM,1819,37,20-24,1856,2
STAT,1871,30,40-44,1901,4.417584860953666
STAT,1821,34,45-49,1855,4.7218801500373
STAT,1916,44,40-44,1960,0.2607012057644385
SIM,1910,39,30-34,1949,2
STAT,1831,33,50-100,1864,0.8283080958282487
STAT,1865,36,25-29,1901,2.678687728015817
SIM,1827,39,20-24,1866,2
SIM,1868,32,25-29,1900,14
SIM,1858,35,45-49,1893,5
STAT,1841,19,35-39,1860,0.5163880909088084
STAT,1937,16,30-34,1953,12.1248441276234
STAT,1899,35,40-44,1934,6.173315947696666
STAT,1901,12,na,1913,3684.1537281505225
SIM,1897,29,35-39,1926,21
STAT,1855,40,na,1895,1809.747670519284
STAT,1946,24,na,1970,4143.295965569743
SIM,1884,35,na,1919,2548
STAT,1918,49,20-24,1967,0.011930592160893734
STAT,1894,30,35-39,1924,13.395738666781336
STAT,1867,35,na,1902,2277.8232887773365
SIM,1905,20,na,1925,3432
STAT,1826,59,na,1885,1200.4986951583849
STAT,1909,15,40-44,1924,0.28104247880910826
SIM,1851,56,na,1907,1656
SIM,1873,33,20-24,1906,5
STAT,1912,0,na,1912,4632.049726983951
STAT,1871,33,45-49,1904,1.7547388967631283
STAT,1801,61,na,1862,908.2937665191749
STAT,1889,46,na,1935,2843.171958449172
STAT,1871,40,na,1911,2359.1313964283718
STAT,1888,46,20-24,1934,0.014513332356354514
STAT,1867,53,35-39,1920,0.0081127839408595
STAT,1914,23,25-29,1937,95.98655853568239
STAT,1843,35,35-39,1878,6.805537086554559
SIM,1955,16,15-19,1971,60
SIM,1813,45,na,1858,1438
STAT,1849,53,30-34,1902,0.004547124208958784
SIM,1950,21,35-39,1971,17
STAT,1839,34,30-34,1873,14.523811558921595
SIM,1804,78,na,1882,390
SIM,1863,20,40-44,1883,1
SIM,1870,35,45-49,1905,4
STAT,1940,29,35-39,1969,15.603065714021183
SIM,1898,33,na,1931,3623
STAT,1819,39,20-24,1858,1.8373636220452254
STAT,1874,70,na,1944,1461.3885694898574
SIM,1890,40,50-100,1930,3
STAT,1937,27,25-29,1964,65.44582682516007
SIM,1783,83,na,1866,98
STAT,1851,37,35-39,1888,5.897772244050106
SIM,1845,27,20-24,1872,11
STAT,1843,55,na,1898,1669.2093565172534
STAT,1835,50,35-39,1885,0.006803885517049184
SIM,1821,74,na,1895,568
STAT,1835,95,na,1930,9.906052026840825
SIM,1818,76,na,1894,368
SIM,1884,22,40-44,1906,5
STAT,1889,29,35-39,1918,12.072132802749172
STAT,1834,29,45-49,1863,0.9657495883071942
SIM,1902,18,15-19,1920,7
STAT,1924,46,40-44,1970,0.19197724429920707
STAT,1860,35,35-39,1895,5.909957477977435
SIM,1856,24,30-34,1880,23
SIM,1905,20,45-49,1925,1
STAT,1894,43,40-44,1937,0.20348044976359952
STAT,1928,29,25-29,1957,82.63127554655193
STAT,1938,26,15-19,1964,0.7137649375120492
STAT,1874,40,20-24,1914,0.1670826787098522
STAT,1782,79,na,1861,259.58729364408174
SIM,1813,55,na,1868,1201
STAT,1866,18,na,1884,2424.9373147356246
SIM,1936,29,25-29,1965,74
STAT,1819,105,na,1924,0.017286207676770356
STAT,1954,16,30-34,1970,15.373848403686168
STAT,1827,52,40-44,1879,0.011406885012473951
STAT,1923,21,25-29,1944,109.98916744714836
SIM,1878,25,20-24,1903,13
STAT,1850,25,25-29,1875,37.98855244416056
SIM,1862,36,50-100,1898,1
STAT,1794,96,na,1890,1.702017358914589
STAT,1880,23,45-49,1903,0.7452394479400468
STAT,1946,14,na,1960,4443.538671511751
STAT,1876,51,35-39,1927,0.009112427809741008
SIM,1866,43,30-34,1909,2
STAT,1944,23,35-39,1967,10.36899126558119
SIM,1901,26,45-49,1927,1
STAT,1919,39,25-29,1958,1.0771279585636753
SIM,1826,37,50-100,1863,2
SIM,1883,43,30-34,1926,1
STAT,1928,26,30-34,1954,49.40784171857495
SIM,1838,74,na,1912,662
SIM,1897,25,30-34,1922,32
STAT,1830,32,45-49,1862,1.6676771099876706
STAT,1887,31,50-100,1918,1.0516711848500595
SIM,1847,34,30-34,1881,15
STAT,1904,21,15-19,1925,4.837952540306998
SIM,1933,16,na,1949,5249
STAT,1901,18,na,1919,3593.5373016954554
STAT,1843,50,50-100,1893,0.012367246836989471
STAT,1900,54,na,1954,2960.8310964913526
STAT,1891,40,20-24,1931,0.20260446182046019
STAT,1899,47,35-39,1946,0.1098066927063766
SIM,1926,27,15-19,1953,1
STAT,1829,30,40-44,1859,4.233705681175294
SIM,1916,23,25-29,1939,112
STAT,1931,39,50-100,1970,0.5658778088011901
STAT,1947,16,15-19,1963,52.173656939422095
SIM,1894,22,25-29,1916,92
STAT,1841,26,na,1867,1998.2167985201843
STAT,1794,64,na,1858,865.7502580511787
STAT,1853,42,40-44,1895,1.883692844362611
STAT,1837,27,20-24,1864,10.039301854876808
STAT,1908,23,25-29,1931,86.32495039292985
STAT,1838,26,50-100,1864,0.6022054364072232
STAT,1923,30,50-100,1953,0.9748575658484266
STAT,1896,21,40-44,1917,2.81610349237394
SIM,1812,49,50-100,1861,2
STAT,1844,72,na,1916,978.6316407787871
STAT,1819,89,na,1908,61.93504212858108
SIM,1882,39,50-100,1921,3
STAT,1828,49,15-19,1877,3.0471218977071537E-4
STAT,1808,52,30-34,1860,0.014205563778342943
STAT,1917,27,na,1944,4009.1595816857725
SIM,1900,29,20-24,1929,22
STAT,1840,35,50-100,1875,1.0668697606951811
SIM,1931,34,30-34,1965,29
STAT,1907,46,40-44,1953,0.14506322281961034
STAT,1828,60,na,1888,1084.3959127431867
STAT,1844,52,40-44,1896,0.00811456626198692
SIM,1856,28,35-39,1884,19
SIM,1861,40,na,1901,2482
STAT,1858,34,40-44,1892,3.478399073578036
SIM,1827,31,25-29,1858,9
STAT,1814,58,na,1872,1177.6822034418474
SIM,1945,16,30-34,1961,18
STAT,1918,27,15-19,1945,0.7666745198632748
STAT,1921,32,na,1953,4294.858104385236
STAT,1850,94,na,1944,15.033624214748745
SIM,1893,41,35-39,1934,4
STAT,1885,41,35-39,1926,1.8513470402072065
STAT,1859,24,30-34,1883,14.841186173431886
SIM,1912,21,15-19,1933,8
STAT,1825,47,35-39,1872,0.18006284187563656
STAT,1894,15,na,1909,3329.54436354258
SIM,1837,30,40-44,1867,5
STAT,1847,45,20-24,1892,0.009451049337050146
STAT,1875,43,30-34,1918,1.195019521879589
SIM,1927,39,25-29,1966,3
STAT,1892,38,35-39,1930,8.998313704204769
SIM,1896,68,na,1964,2265
SIM,1899,36,45-49,1935,2
STAT,1889,25,30-34,1914,31.94809634078049
STAT,1818,50,35-39,1868,0.01950057800875573
SIM,1877,44,45-49,1921,3
STAT,1777,84,na,1861,123.3132964831455
STAT,1863,17,20-24,1880,18.0946884776186
SIM,1922,39,35-39,1961,6
STAT,1875,86,na,1961,373.112396305268
SIM,1813,77,na,1890,397
STAT,1899,46,na,1945,3152.4688534003553
STAT,1897,33,na,1930,3241.2794190712475
STAT,1836,31,25-29,1867,8.143234784606285
SIM,1864,39,25-29,1903,5
SIM,1913,33,25-29,1946,9
STAT,1824,32,20-24,1856,5.416718857813512
STAT,1817,76,na,1893,462.36380465839
STAT,1899,33,15-19,1932,0.198099681784035
STAT,1852,21,40-44,1873,2.008662790941814
STAT,1929,30,45-49,1959,2.0409532361513776
SIM,1862,15,40-44,1877,4
STAT,1913,15,20-24,1928,28.409769127822344
SIM,1831,31,15-19,1862,1
SIM,1921,37,40-44,1958,4
STAT,1918,39,50-100,1957,0.4506371213612694
STAT,1818,40,na,1858,1541.171896006959
STAT,1836,21,na,1857,1769.0382963864
STAT,1866,48,35-39,1914,0.13008056062724827
SIM,1857,40,25-29,1897,2
STAT,1896,32,na,1928,3215.2044207245035
STAT,1883,41,25-29,1924,0.6456854093400827
STAT,1807,50,50-100,1857,0.0649879563920485
STAT,1835,89,na,1924,78.27179505765702
STAT,1901,25,40-44,1926,4.3024012787735995
SIM,1831,58,na,1889,1278
SIM,1832,32,20-24,1864,6
STAT,1926,29,15-19,1955,0.8571614924072155
STAT,1956,16,40-44,1972,1.8881716196528842
STAT,1848,28,35-39,1876,8.88980740902566
STAT,1825,52,30-34,1877,0.007381575963275237
STAT,1862,110,na,1972,0.0044091073521746816
SIM,1909,30,30-34,1939,20
SIM,1892,33,30-34,1925,39
STAT,1885,38,na,1923,2385.970199297516
STAT,1816,75,na,1891,456.78612875862393
STAT,1904,37,15-19,1941,0.01772092330161242
STAT,1843,19,45-49,1862,0.06659775970686958
SIM,1861,56,na,1917,2144
SIM,1854,24,20-24,1878,100
STAT,1914,39,35-39,1953,2.4391749222312717
SIM,1872,31,50-100,1903,1
STAT,1906,33,na,1939,3558.36413459878
STAT,1854,39,15-19,1893,0.04254559714684889
STAT,1873,26,30-34,1899,26.133746711545033
STAT,1905,33,25-29,1938,8.628619809931209
SIM,1844,31,25-29,1875,14
SIM,1901,48,na,1949,3368
SIM,1949,2,na,1951,4850
SIM,1868,35,na,1903,2372
SIM,1920,23,15-19,1943,5
SIM,1914,21,25-29,1935,111
SIM,1830,57,na,1887,1364
SIM,1870,32,50-100,1902,3
STAT,1837,50,45-49,1887,0.010103512863293126
SIM,1891,69,na,1960,1953
SIM,1911,20,45-49,1931,1
STAT,1874,54,50-100,1928,0.01529787082465771
SIM,1945,11,na,1956,4698
SIM,1818,86,na,1904,83
STAT,1851,26,na,1877,2104.789947797435
STAT,1884,33,30-34,1917,17.547425255892353
SIM,1836,21,25-29,1857,4
STAT,1816,107,na,1923,0.0020925319263595775
SIM,1828,34,20-24,1862,2
SIM,1860,21,40-44,1881,3
STAT,1849,40,25-29,1889,0.5072585820553903
SIM,1843,43,na,1886,1778
SIM,1888,71,na,1959,1603
SIM,1940,24,30-34,1964,50
SIM,1834,23,na,1857,1870
SIM,1878,31,40-44,1909,10
STAT,1870,39,na,1909,2325.8811912037913
STAT,1854,15,40-44,1869,0.16944649643327409
STAT,1924,16,35-39,1940,5.110627305788558
STAT,1900,28,40-44,1928,4.220667566364474
SIM,1927,3,na,1930,4968
STAT,1912,23,15-19,1935,5.188105760602676
SIM,1868,29,na,1897,2332
SIM,1905,27,40-44,1932,7
SIM,1848,74,na,1922,784
STAT,1897,47,25-29,1944,0.04411256265735947
SIM,1932,16,35-39,1948,6
STAT,1891,23,20-24,1914,86.76739545240854
STAT,1864,103,na,1967,0.8634381932055237
STAT,1897,20,35-39,1917,8.007301073026253
STAT,1856,30,15-19,1886,0.11785919436201471
STAT,1906,32,50-100,1938,0.7811895618274914
STAT,1908,20,20-24,1928,104.86237763784177
STAT,1852,91,na,1943,46.68285614457855
STAT,1863,109,na,1972,0.012387457617117502
STAT,1862,21,25-29,1883,51.257744207404556
STAT,1878,51,45-49,1929,0.015483901618141711
SIM,1837,43,50-100,1880,5
SIM,1873,41,na,1914,2324
STAT,1790,66,na,1856,803.7688589599998
STAT,1904,33,50-100,1937,0.7659588176030777
STAT,1868,31,30-34,1899,17.08170109782334
STAT,1869,30,25-29,1899,10.169116363743408
SIM,1849,34,40-44,1883,8
STAT,1906,21,25-29,1927,85.2575278723369
SIM,1853,34,50-100,1887,3
STAT,1854,92,na,1946,31.876571187878525
STAT,1832,42,20-24,1874,0.13049184149828633
STAT,1893,40,30-34,1933,1.5028519116327093
STAT,1834,78,na,1912,525.0692830696713
SIM,1916,20,20-24,1936,109
STAT,1846,24,20-24,1870,59.93569375591578
STAT,1825,101,na,1926,0.34218175446720156
STAT,1817,92,na,1909,20.326268898836936
SIM,1895,25,20-24,1920,25
SIM,1829,60,na,1889,992
STAT,1821,38,na,1859,1481.4724136687012
SIM,1908,27,na,1935,3768
SIM,1883,24,na,1907,2437
STAT,1933,36,40-44,1969,2.0813085954524344
SIM,1833,75,na,1908,610
SIM,1836,43,45-49,1879,5
STAT,1887,25,20-24,1912,13.501595667565859
SIM,1864,8,na,1872,2565
STAT,1816,50,25-29,1866,0.007253483160199945
STAT,1903,20,45-49,1923,1.0172646787958555
STAT,1923,17,40-44,1940,1.675775932606209
SIM,1898,30,45-49,1928,2
STAT,1876,25,50-100,1901,0.6784425194908446
STAT,1913,37,40-44,1950,1.5071019473791267
SIM,1926,19,15-19,1945,61
SIM,1947,24,na,1971,4316
SIM,1876,86,na,1962,436
SIM,1906,26,35-39,1932,1
STAT,1836,53,45-49,1889,0.008961176050654919
SIM,1836,89,na,1925,27
SIM,1903,13,na,1916,3687
STAT,1895,16,40-44,1911,0.24404388019501577
SIM,1931,17,40-44,1948,3
STAT,1907,6,na,1913,3913.0159321228293
SIM,1851,32,30-34,1883,18
STAT,1895,34,45-49,1929,2.301174553110762
STAT,1893,67,na,1960,2183.387515919664
STAT,1836,37,na,1873,1636.3117974269003
STAT,1903,38,20-24,1941,0.24008303998731698
SIM,1848,52,na,1900,1736
STAT,1885,16,na,1901,2576.821575376025
SIM,1886,20,25-29,1906,77
STAT,1765,99,na,1864,0.11727434601465694
STAT,1850,42,25-29,1892,0.4824389293857882
STAT,1923,37,25-29,1960,1.164017216167024
SIM,1812,42,45-49,1854,1
STAT,1869,8,na,1877,2694.592850260914
STAT,1927,20,30-34,1947,36.337206412079674
SIM,1843,21,na,1864,2107
STAT,1862,35,45-49,1897,1.7475848035443446
SIM,1870,21,25-29,1891,2
SIM,1937,24,na,1961,4194
STAT,1938,32,25-29,1970,9.480226455724525
STAT,1931,23,25-29,1954,121.80261798973642
STAT,1865,19,50-100,1884,0.04619539724485138
STAT,1893,22,40-44,1915,2.6967538389700234
STAT,1901,41,50-100,1942,0.1051305151117507
STAT,1851,42,30-34,1893,0.9473285198613323
SIM,1928,27,25-29,1955,107
SIM,1921,15,20-24,1936,194
STAT,1849,32,50-100,1881,0.7495715747600337
STAT,1826,31,40-44,1857,5.1004721140628195
STAT,1835,73,na,1908,884.9539839311399
SIM,1935,20,30-34,1955,52
STAT,1906,11,na,1917,3840.3498002664433
STAT,1874,18,35-39,1892,0.5700171441249987
SIM,1938,26,40-44,1964,12
SIM,1857,32,50-100,1889,1
SIM,1881,70,na,1951,1311
STAT,1834,49,15-19,1883,2.7825268710569633E-4
SIM,1863,43,50-100,1906,2
STAT,1843,32,30-34,1875,16.94460635717826
STAT,1848,22,na,1870,2023.7008316934914
STAT,1884,69,na,1953,1481.1660239566818
SIM,1892,38,na,1930,3443
STAT,1914,20,20-24,1934,111.88822256462045
STAT,1867,50,30-34,1917,0.005782870383575806
SIM,1873,36,25-29,1909,6
STAT,1823,88,na,1911,76.40557527853471
SIM,1894,67,na,1961,2261
STAT,1845,40,40-44,1885,1.8361087579406752
STAT,1940,26,30-34,1966,40.77977986171417
STAT,1922,29,30-34,1951,44.91678790856248
SIM,1847,43,20-24,1890,3
SIM,1891,53,na,1944,2717
STAT,1910,37,15-19,1947,0.018731769574482422
STAT,1870,88,na,1958,186.65575024927082
SIM,1936,26,20-24,1962,16
STAT,1897,31,15-19,1928,0.19504310301792246
STAT,1901,33,40-44,1934,6.160561687198826
STAT,1927,34,15-19,1961,0.161041543153271
STAT,1769,97,na,1866,0.44746765967718516
SIM,1930,29,30-34,1959,75
STAT,1877,30,35-39,1907,10.80143755725301
STAT,1847,36,30-34,1883,4.357120859128736
SIM,1885,30,35-39,1915,13
STAT,1860,39,15-19,1899,0.04601213148171825
SIM,1908,21,25-29,1929,5
STAT,1851,54,50-100,1905,0.012117388203771269
SIM,1928,33,50-100,1961,2
STAT,1925,37,45-49,1962,0.8347790235192881
SIM,1817,75,na,1892,407
STAT,1872,20,40-44,1892,2.143260007166164
STAT,1876,20,15-19,1896,3.4960244032033843
STAT,1851,10,na,1861,2424.568730603155
SIM,1897,32,na,1929,3211
STAT,1858,32,15-19,1890,0.11520890040006748
STAT,1919,32,15-19,1951,0.14147958641158395
SIM,1948,6,na,1954,4559
STAT,1905,42,15-19,1947,0.0014111727126614316
SIM,1825,40,na,1865,1579
SIM,1888,65,na,1953,1883
STAT,1862,37,50-100,1899,1.0661718556812323
STAT,1917,17,40-44,1934,0.30715995113704486
SIM,1840,88,na,1928,62
SIM,1858,22,15-19,1880,3
SIM,1853,40,40-44,1893,2
STAT,1879,43,15-19,1922,0.014619802222733402
SIM,1862,33,45-49,1895,2
SIM,1922,20,20-24,1942,1
STAT,1839,43,20-24,1882,0.11404726111411362
STAT,1825,44,30-34,1869,1.5055725373811373
STAT,1869,91,na,1960,101.30517988001365
SIM,1886,2,na,1888,3321
STAT,1839,37,35-39,1876,5.8332625803666485
STAT,1882,73,na,1955,1180.4798431038098
STAT,1851,34,30-34,1885,14.684429185390057
SIM,1836,25,40-44,1861,1
SIM,1867,41,50-100,1908,3
SIM,1870,39,25-29,1909,6
STAT,1842,43,na,1885,1851.3407803734033
SIM,1818,92,na,1910,17
STAT,1918,19,15-19,1937,50.13824982324984
STAT,1899,38,45-49,1937,0.5981019874906982
STAT,1921,39,40-44,1960,1.7020374271109535
STAT,1915,39,40-44,1954,1.527650526084515
STAT,1821,44,na,1865,1409.9745206309983
SIM,1863,41,na,1904,2024
SIM,1923,39,40-44,1962,3
STAT,1938,21,45-49,1959,1.136334379671373
SIM,1851,21,15-19,1872,2
STAT,1762,103,na,1865,0.0485455929586958
STAT,1842,40,25-29,1882,0.5345333299368564
SIM,1933,37,45-49,1970,1
SIM,1871,39,na,1910,2150
SIM,1883,18,na,1901,2584
STAT,1919,48,15-19,1967,4.065937707669524E-4
SIM,1946,21,45-49,1967,2
STAT,1821,38,50-100,1859,2.5261282905132756
STAT,1812,94,na,1906,9.115774160814171
STAT,1845,34,50-100,1879,0.833719687333572
STAT,1854,33,45-49,1887,1.3526357882713786
STAT,1833,23,na,1856,1863.0460915723593
STAT,1899,44,30-34,1943,0.11002211167347048
SIM,1849,42,40-44,1891,4
SIM,1878,71,na,1949,1464
SIM,1888,28,30-34,1916,35
STAT,1905,16,25-29,1921,8.369548936256647
SIM,1901,23,40-44,1924,4
SIM,1847,37,50-100,1884,1
SIM,1861,42,40-44,1903,5
STAT,1891,43,25-29,1934,0.8051842160281621
SIM,1881,35,20-24,1916,1
STAT,1825,95,na,1920,7.9728400678782005
STAT,1889,38,50-100,1927,1.5394584461811052
STAT,1913,48,50-100,1961,0.22458623732543156
STAT,1862,39,25-29,1901,2.475130565928513
STAT,1847,74,na,1921,865.4275722961795
SIM,1842,95,na,1937,8
STAT,1875,4,na,1879,3044.781592991191
SIM,1833,44,30-34,1877,1
STAT,1858,46,35-39,1904,0.11358264316130073
SIM,1913,33,na,1946,3923
STAT,1947,24,15-19,1971,6.133980037174634
STAT,1843,21,15-19,1864,3.367052884155615
STAT,1878,52,50-100,1930,0.015951650839341053
STAT,1884,47,na,1931,2260.1389393190047
STAT,1850,22,20-24,1872,62.216660472571846
SIM,1899,23,15-19,1922,4
SIM,1914,15,15-19,1929,7
STAT,1819,50,40-44,1869,0.0208729130448414
STAT,1830,58,na,1888,1255.2136645562111
SIM,1825,62,na,1887,1147
STAT,1907,49,45-49,1956,0.1962902478093044
STAT,1858,37,45-49,1895,1.6127460347105238
SIM,1871,92,na,1963,115
STAT,1943,18,20-24,1961,146.632388633142
SIM,1879,30,35-39,1909,25
STAT,1794,80,na,1874,268.2833736961124
STAT,1843,52,35-39,1895,0.0069128634556633655
SIM,1907,31,35-39,1938,10
STAT,1892,35,30-34,1927,6.878910260502202
STAT,1928,26,20-24,1954,23.017552073556192
SIM,1915,49,45-49,1964,1
SIM,1859,68,na,1927,1323
SIM,1898,17,na,1915,3892
STAT,1827,35,50-100,1862,1.6780368603102531
STAT,1882,29,25-29,1911,41.74191702647041
STAT,1844,56,na,1900,1580.5356212742097
STAT,1952,19,15-19,1971,55.442380642497696
SIM,1870,4,na,1874,3042
STAT,1828,36,20-24,1864,0.6908589665076762
SIM,1820,41,40-44,1861,5
SIM,1839,91,na,1930,31
STAT,1886,41,40-44,1927,2.4397849938674763
STAT,1873,35,20-24,1908,0.8048217211939623
STAT,1806,55,na,1861,1139.6755725121711
SIM,1908,49,na,1957,3581
STAT,1824,52,25-29,1876,0.003982473747580022
SIM,1849,20,20-24,1869,65
STAT,1871,19,20-24,1890,17.819042543144306
STAT,1928,29,35-39,1957,18.848143833778106
SIM,1904,39,30-34,1943,5
STAT,1836,45,45-49,1881,0.15772982073397215
SIM,1913,16,25-29,1929,11
SIM,1845,60,na,1905,1479
SIM,1877,26,40-44,1903,4
STAT,1915,15,40-44,1930,0.3001168774334816
STAT,1864,21,45-49,1885,0.6473475948268606
SIM,1921,48,50-100,1969,1
STAT,1906,15,15-19,1921,8.852833790168578
STAT,1918,31,45-49,1949,1.7133549574755342
STAT,1890,22,15-19,1912,4.1149942735247675
STAT,1919,21,35-39,1940,10.553399345873027
SIM,1890,29,25-29,1919,59
STAT,1945,22,15-19,1967,5.952354028510966
STAT,1825,36,50-100,1861,1.9437678064777018
SIM,1914,37,35-39,1951,2
STAT,1913,2,na,1915,4251.9345039432455
STAT,1860,38,50-100,1898,1.0111797359288117
SIM,1836,73,na,1909,868
SIM,1936,29,35-39,1965,16
STAT,1823,31,15-19,1854,0.4146611333104424
STAT,1930,27,15-19,1957,0.9155255855376448
SIM,1814,44,20-24,1858,1
STAT,1853,86,na,1939,186.04288866861472
SIM,1877,49,na,1926,2225
STAT,1882,50,20-24,1932,7.439402582528269E-4
STAT,1852,24,45-49,1876,0.6577999131460421
SIM,1843,27,na,1870,2060
STAT,1897,17,na,1914,3445.0191689234944
SIM,1843,35,50-100,1878,4
STAT,1907,29,40-44,1936,4.417449282335832
SIM,1836,36,20-24,1872,1
STAT,1846,17,20-24,1863,15.926202176964821
STAT,1897,35,30-34,1932,7.3387806887564935
STAT,1899,31,25-29,1930,14.367081903320276
SIM,1899,29,45-49,1928,6
STAT,1851,52,35-39,1903,0.007064812550629163
STAT,1916,26,na,1942,3966.288128397309
SIM,1832,29,50-100,1861,1
SIM,1858,67,na,1925,1226
STAT,1876,34,na,1910,2492.287942070286
SIM,1937,31,20-24,1968,4
SIM,1908,25,40-44,1933,5
SIM,1873,20,15-19,1893,3
STAT,1773,106,na,1879,0.012736321954674484
SIM,1846,31,45-49,1877,1
STAT,1834,33,40-44,1867,3.6996664972630255
SIM,1898,45,40-44,1943,1
STAT,1871,15,40-44,1886,0.1882325826565428
SIM,1904,37,40-44,1941,6
STAT,1861,19,na,1880,2197.919384056261
SIM,1838,44,30-34,1882,1
SIM,1877,41,40-44,1918,2
STAT,1839,30,15-19,1869,0.12348527280785312
STAT,1931,39,35-39,1970,3.259973849198271
SIM,1923,11,na,1934,4569
STAT,1811,44,na,1855,1332.9961151152474
SIM,1866,34,50-100,1900,5
SIM,1900,31,25-29,1931,22
STAT,1827,54,na,1881,1452.3997701188928
SIM,1938,15,25-29,1953,65
STAT,1864,49,na,1913,1998.1806169869542
STAT,1840,44,20-24,1884,0.11619647254539052
SIM,1877,40,50-100,1917,1
SIM,1769,95,na,1864,2
STAT,1924,42,25-29,1966,0.08665914471879708
SIM,1828,40,40-44,1868,9
SIM,1889,47,50-100,1936,1
STAT,1865,71,na,1936,1235.8956657623712
STAT,1902,48,20-24,1950,0.009615830128866706
SIM,1915,29,40-44,1944,10
SIM,1840,25,30-34,1865,28
STAT,1929,31,20-24,1960,3.1618947540246998
STAT,1883,48,35-39,1931,0.13837435818937052
STAT,1920,38,20-24,1958,0.2942403812583822
SIM,1871,24,20-24,1895,64
SIM,1920,24,50-100,1944,2
SIM,1921,27,15-19,1948,3
SIM,1883,56,na,1939,2157
STAT,1853,20,30-34,1873,17.903178566882158
STAT,1842,19,50-100,1861,0.04875642317962105
SIM,1854,30,40-44,1884,8
STAT,1837,39,15-19,1876,0.04464747812014558
STAT,1859,111,na,1970,0.0010632335966146657
STAT,1913,27,15-19,1940,0.7175994623889718
STAT,1917,28,20-24,1945,19.46673084386281
STAT,1941,15,na,1956,3869.91088774783
STAT,1797,82,na,1879,174.31271372696125
STAT,1944,21,45-49,1965,1.2398801330231346
SIM,1923,3,na,1926,4668
STAT,1838,31,45-49,1869,1.6087368251214902
STAT,1862,32,40-44,1894,3.766004748625048
STAT,1876,0,na,1876,3857.240720764123
SIM,1891,48,35-39,1939,1
STAT,1919,36,30-34,1955,1.9999061932688147
SIM,1854,41,50-100,1895,3
SIM,1861,20,30-34,1881,27
STAT,1865,53,25-29,1918,0.0032269029058865683
SIM,1940,18,45-49,1958,2
STAT,1878,20,25-29,1898,61.14958476606943
STAT,1832,25,30-34,1857,23.659637253974623
SIM,1849,36,30-34,1885,6
SIM,1808,92,na,1900,6
STAT,1932,18,45-49,1950,0.6728105315234655
SIM,1849,15,na,1864,2209
SIM,1925,28,20-24,1953,35
SIM,1911,16,na,1927,4024
SIM,1918,20,30-34,1938,48
STAT,1907,16,35-39,1923,0.8239228812186474
SIM,1945,19,25-29,1964,60
STAT,1892,46,35-39,1938,0.1012568265864858
STAT,1826,75,na,1901,600.4241640218028
STAT,1924,30,na,1954,4522.134023283139
STAT,1815,69,na,1884,887.5176176618817
STAT,1817,49,15-19,1866,8.663905080239693E-4
STAT,1949,21,20-24,1970,132.41949402296888
STAT,1841,23,30-34,1864,16.541021053730915
STAT,1867,46,50-100,1913,0.23588673759823534
STAT,1869,37,20-24,1906,0.7592155687925005
STAT,1857,18,35-39,1875,0.5107954164341753
STAT,1880,20,40-44,1900,2.247233529714248
STAT,1867,26,30-34,1893,24.200268803119272
STAT,1841,28,25-29,1869,38.51481135852099
STAT,1867,19,na,1886,2443.7497920498936
STAT,1945,13,na,1958,4377.221001263361
SIM,1929,39,45-49,1968,3
STAT,1916,11,na,1927,4282.290765830756
STAT,1940,15,15-19,1955,47.03376087263731
STAT,1856,46,25-29,1902,0.04625724227884306
SIM,1866,71,na,1937,1540
STAT,1826,34,45-49,1860,1.6823651859424436
STAT,1823,47,25-29,1870,0.0865926289221407
SIM,1845,17,na,1862,2223
SIM,1835,30,30-34,1865,28
SIM,1937,31,50-100,1968,2
SIM,1929,11,na,1940,5427
SIM,1858,57,na,1915,1627
STAT,1947,22,25-29,1969,106.51099698082173
SIM,1927,36,30-34,1963,1
SIM,1858,52,na,1910,1785
SIM,1811,81,na,1892,140
SIM,1833,91,na,1924,29
SIM,1906,63,na,1969,2840
SIM,1911,48,na,1959,3561
STAT,1837,19,20-24,1856,16.80696162811663
STAT,1863,16,45-49,1879,0.06706666910493424
SIM,1931,30,na,1961,4912
STAT,1890,38,25-29,1928,3.573515776530383
STAT,1939,27,35-39,1966,15.396980220416914
STAT,1937,31,50-100,1968,0.8348542058979697
STAT,1808,62,na,1870,824.5581187944871
SIM,1872,93,na,1965,70
STAT,1845,57,na,1902,1570.219038590671
STAT,1937,19,25-29,1956,42.87450502019189
SIM,1933,21,35-39,1954,16
STAT,1936,28,30-34,1964,38.22787994079403
STAT,1833,50,25-29,1883,0.0025121331844050842
STAT,1851,45,35-39,1896,0.11665394314644055
STAT,1929,36,15-19,1965,0.02516842660684888
STAT,1821,38,25-29,1859,5.924059713181112
SIM,1803,62,na,1865,780
STAT,1864,31,50-100,1895,0.8345065763583489
STAT,1930,29,40-44,1959,6.03876049760251
STAT,1954,16,20-24,1970,171.0025593189936
SIM,1922,27,40-44,1949,12
SIM,1845,19,20-24,1864,22
SIM,1934,15,40-44,1949,4
SIM,1896,37,30-34,1933,11
SIM,1829,46,30-34,1875,1
SIM,1834,34,45-49,1868,7
SIM,1866,86,na,1952,256
STAT,1914,27,40-44,1941,4.794137887257142
STAT,1910,20,50-100,1930,0.6339864027566945
SIM,1886,24,40-44,1910,3
SIM,1915,16,35-39,1931,1
STAT,1891,23,na,1914,2977.8215248159086
STAT,1827,30,30-34,1857,29.906765911841667
SIM,1853,25,40-44,1878,5
SIM,1883,34,na,1917,2455
SIM,1929,21,45-49,1950,6
STAT,1865,20,15-19,1885,3.1365863162286476
STAT,1843,26,45-49,1869,1.1110564249486499
STAT,1905,49,35-39,1954,0.1139231139299357
SIM,1851,26,45-49,1877,1
STAT,1820,81,na,1901,297.8284939247054
STAT,1839,27,30-34,1866,21.893836571887366
STAT,1863,29,15-19,1892,0.40291458237707783
SIM,1935,32,50-100,1967,1
STAT,1837,34,20-24,1871,2.213182710334135
SIM,1847,27,30-34,1874,36
STAT,1894,21,30-34,1915,23.44416924106125
SIM,1782,77,na,1859,324
STAT,1860,23,40-44,1883,1.7652544292232022
STAT,1925,21,35-39,1946,11.533693844772117
SIM,1798,60,na,1858,986
STAT,1878,24,40-44,1902,2.198863828664734
STAT,1888,37,30-34,1925,6.427578473297565
STAT,1845,25,40-44,1870,2.8902520427901206
STAT,1930,15,30-34,1945,16.146686565502623
STAT,1925,34,40-44,1959,4.73503420723166
SIM,1860,15,30-34,1875,2
SIM,1828,38,na,1866,1823
SIM,1828,54,na,1882,1427
STAT,1883,41,15-19,1924,0.013885708655137278
STAT,1901,36,45-49,1937,0.6167779908072495
STAT,1860,56,na,1916,1688.2341518145045
STAT,1913,18,35-39,1931,0.8729405604749731
SIM,1849,37,na,1886,1886
STAT,1927,30,35-39,1957,11.479936455405927
SIM,1866,39,35-39,1905,16
STAT,1949,15,35-39,1964,4.981642738347112
SIM,1881,28,20-24,1909,12
SIM,1919,29,25-29,1948,7
STAT,1878,35,20-24,1913,0.8263082688241177
SIM,1928,40,45-49,1968,1
SIM,1844,42,40-44,1886,5
SIM,1920,39,25-29,1959,1
SIM,1874,39,50-100,1913,2
STAT,1922,23,50-100,1945,0.7675534462457668
SIM,1803,77,na,1880,307
SIM,1868,19,na,1887,2533
SIM,1914,28,45-49,1942,2
SIM,1845,26,45-49,1871,1
STAT,1907,43,50-100,1950,0.10909445406609368
SIM,1881,26,30-34,1907,25
SIM,1934,16,45-49,1950,4
SIM,1890,36,25-29,1926,5
STAT,1894,47,50-100,1941,0.18094567667428038
STAT,1828,43,45-49,1871,1.2040765220476755
STAT,1865,17,30-34,1882,1.5207522661915904
STAT,1830,109,na,1939,4.5006385786748755E-4
STAT,1862,32,50-100,1894,0.7956676679381
STAT,1867,99,na,1966,8.322764328126727
SIM,1954,17,25-29,1971,65
STAT,1931,15,na,1946,4936.2496334827
STAT,1882,40,50-100,1922,1.060577757658058
STAT,1906,37,25-29,1943,0.9227565196175186
STAT,1872,41,na,1913,2373.772441697471
SIM,1933,34,40-44,1967,8
STAT,1893,25,45-49,1918,1.4466432258015642
STAT,1856,34,30-34,1890,13.862096187484434
SIM,1926,1,na,1927,5390
STAT,1896,54,na,1950,2821.3775019970753
SIM,1839,75,na,1914,787
SIM,1858,34,30-34,1892,29
STAT,1879,32,45-49,1911,1.8595335163871143
STAT,1954,1,na,1955,4965.07520573717
STAT,1832,45,25-29,1877,0.0469168718028037
STAT,1882,36,25-29,1918,2.8753402343501904
SIM,1905,23,25-29,1928,94
STAT,1931,32,15-19,1963,0.17172698295950528
SIM,1859,15,na,1874,2581
SIM,1873,17,30-34,1890,3
SIM,1828,27,20-24,1855,1
SIM,1784,84,na,1868,148
SIM,1859,40,35-39,1899,1
STAT,1812,44,45-49,1856,3.7589753879106844
STAT,1815,107,na,1922,0.002438503869912006
STAT,1849,44,40-44,1893,1.7226779197977033
SIM,1895,18,20-24,1913,24
STAT,1950,1,na,1951,4926.08319103927
SIM,1937,17,25-29,1954,59
STAT,1840,48,50-100,1888,0.17595262553380356
STAT,1929,17,25-29,1946,56.40752124178664
STAT,1932,24,30-34,1956,38.326251342099546
SIM,1866,37,45-49,1903,1
SIM,1864,34,30-34,1898,21
SIM,1798,82,na,1880,93
SIM,1859,49,45-49,1908,3
SIM,1935,30,35-39,1965,22
STAT,1887,18,20-24,1905,20.21297904748943
STAT,1926,18,45-49,1944,0.6231704585316195
STAT,1846,30,40-44,1876,3.7418472441105455
SIM,1820,44,45-49,1864,5
STAT,1902,17,20-24,1919,25.505071953044986
SIM,1892,20,25-29,1912,94
STAT,1866,31,20-24,1897,2.553892022244953
STAT,1785,97,na,1882,0.9890122191145247
STAT,1940,17,40-44,1957,1.4488139453348945
SIM,1929,32,25-29,1961,20
STAT,1879,16,50-100,1895,0.05237104394457642
STAT,1893,16,30-34,1909,2.0677665334307096
STAT,1817,42,30-34,1859,2.890594765174208
STAT,1892,31,15-19,1923,0.18282110605181678
STAT,1921,17,30-34,1938,14.177569595811727
STAT,1874,51,25-29,1925,0.0037068770501280817
SIM,1910,17,20-24,1927,29
STAT,1764,98,na,1862,0.9073836049785222
STAT,1916,48,na,1964,3834.621100158013
STAT,1926,25,50-100,1951,1.225502499365506
STAT,1928,11,na,1939,5100.1145717762865
STAT,1945,26,30-34,1971,43.87792290503147
STAT,1842,47,35-39,1889,0.10980698986104902
SIM,1848,89,na,1937,116
STAT,1906,28,45-49,1934,1.6428256904699783
STAT,1884,27,45-49,1911,1.1206096368791696
STAT,1876,18,45-49,1894,0.0686323570185617
STAT,1836,49,25-29,1885,0.03657362839464838
STAT,1927,17,15-19,1944,57.56158075611308
STAT,1873,22,15-19,1895,3.41201422460806
SIM,1862,19,na,1881,2371
SIM,1895,31,40-44,1926,5
STAT,1863,27,25-29,1890,37.83657876103312
STAT,1827,38,na,1865,1794.581162563309
SIM,1918,17,15-19,1935,51
SIM,1815,62,na,1877,985
STAT,1856,39,25-29,1895,2.2824656219875568
STAT,1880,60,na,1940,2044.5530862605117
STAT,1912,39,25-29,1951,0.9704653824207782
STAT,1852,15,30-34,1867,1.5714351557980109
STAT,1910,16,na,1926,3912.8242204064363
STAT,1835,57,na,1892,1497.3074964697064
SIM,1844,49,25-29,1893,1
SIM,1848,6,na,1854,2433
STAT,1884,20,25-29,1904,58.12173100150232
SIM,1938,28,30-34,1966,45
SIM,1854,17,20-24,1871,15
STAT,1842,40,15-19,1882,0.011495341196496192
STAT,1887,31,40-44,1918,4.977704682158297
SIM,1876,31,30-34,1907,31
SIM,1935,17,15-19,1952,53
STAT,1946,17,25-29,1963,49.03911149494627
SIM,1835,39,na,1874,1730
STAT,1865,93,na,1958,39.75146449076664
STAT,1915,9,na,1924,4237.720239532771
SIM,1839,28,35-39,1867,13
SIM,1949,22,25-29,1971,189
SIM,1809,72,na,1881,383
STAT,1869,44,45-49,1913,1.4541565756910932
SIM,1908,26,45-49,1934,3
STAT,1857,51,25-29,1908,0.002835490724582125
STAT,1929,38,40-44,1967,1.9582277969156492
SIM,1849,23,25-29,1872,4
STAT,1836,42,40-44,1878,1.6656296829395991
SIM,1871,27,25-29,1898,3
SIM,1919,15,15-19,1934,10
STAT,1837,26,45-49,1863,0.9570239678193156
SIM,1869,35,20-24,1904,1
STAT,1848,37,na,1885,1887.2721459403194
STAT,1892,16,50-100,1908,0.06279299168935149
STAT,1818,37,50-100,1855,4.616200374108155
STAT,1898,19,35-39,1917,0.7529135368743965
SIM,1923,33,na,1956,4212
STAT,1841,35,25-29,1876,2.5572442338008483
SIM,1942,9,na,1951,4689
STAT,1864,48,25-29,1912,0.05159144353097072
STAT,1839,23,na,1862,1882.38069140752
SIM,1923,17,30-34,1940,18
STAT,1906,34,30-34,1940,14.758679350236948
STAT,1924,29,40-44,1953,5.497349460991639
SIM,1853,36,20-24,1889,1
SIM,1903,26,50-100,1929,1
SIM,1842,42,na,1884,1750
STAT,1871,29,25-29,1900,42.441109538213794
STAT,1865,50,20-24,1915,6.930601173217757E-4
STAT,1881,23,na,1904,2325.3862820181835
SIM,1868,36,40-44,1904,10
STAT,1776,83,na,1859,121.47324849057571
SIM,1858,43,50-100,1901,3
STAT,1874,85,na,1959,390.9280794869428
SIM,1908,28,45-49,1936,3
STAT,1884,37,na,1921,2377.8467943255487
SIM,1933,26,na,1959,4848
SIM,1870,86,na,1956,184
STAT,1832,27,20-24,1859,10.685331957454382
STAT,1835,24,45-49,1859,0.6810270724486721
SIM,1835,24,na,1859,1892
STAT,1837,40,40-44,1877,1.8155598855664665
SIM,1818,48,45-49,1866,1
STAT,1883,45,30-34,1928,0.09785944054069391
SIM,1840,49,40-44,1889,1
SIM,1818,54,na,1872,1206
STAT,1900,16,25-29,1916,8.032147974045598
SIM,1885,39,45-49,1924,4
STAT,1816,54,30-34,1870,0.011251909468479981
STAT,1882,53,25-29,1935,0.0034638019432410715
SIM,1937,34,25-29,1971,14
STAT,1850,18,25-29,1868,5.178076970665002
STAT,1877,39,45-49,1916,2.0880513347743297
STAT,1932,15,40-44,1947,1.8975943781613254
SIM,1837,68,na,1905,957
STAT,1817,38,35-39,1855,23.170018782073853
SIM,1856,93,na,1949,8
SIM,1789,83,na,1872,72
SIM,1940,15,40-44,1955,2
SIM,1867,24,30-34,1891,22
STAT,1927,38,30-34,1965,2.3091629032106615
SIM,1897,18,30-34,1915,2
SIM,1936,26,30-34,1962,48
STAT,1914,52,na,1966,3654.888554884487
STAT,1940,22,15-19,1962,5.532068768775524
STAT,1855,31,45-49,1886,1.3907862131036641
STAT,1905,25,15-19,1930,0.6729952230512374
STAT,1897,38,35-39,1935,9.599870959643793
STAT,1951,15,50-100,1966,0.4553733705849781
SIM,1914,34,30-34,1948,25
SIM,1837,17,20-24,1854,18
SIM,1824,61,na,1885,1007
SIM,1891,45,30-34,1936,1
STAT,1876,22,40-44,1898,2.195145461024502
SIM,1851,23,40-44,1874,2
STAT,1825,40,15-19,1865,0.019658421524675725
STAT,1916,47,45-49,1963,0.22748574323645393
SIM,1939,1,na,1940,4070
STAT,1832,49,40-44,1881,0.1205493751093709
SIM,1906,40,50-100,1946,1
STAT,1837,37,25-29,1874,2.3372355711047823
STAT,1861,49,50-100,1910,0.2027103085800479
STAT,1834,36,45-49,1870,1.686103317934695
STAT,1933,32,25-29,1965,12.702505103425109
SIM,1863,31,45-49,1894,1
STAT,1823,44,20-24,1867,0.24434608497223975
SIM,1872,39,35-39,1911,1
STAT,1911,29,30-34,1940,38.69843376441407
STAT,1860,26,45-49,1886,0.9355781144649277
STAT,1854,32,50-100,1886,0.7181251682005542
STAT,1886,70,na,1956,1545.4188035955508
STAT,1937,16,20-24,1953,134.86404462465882
STAT,1765,101,na,1866,0.044990525039802165
STAT,1884,29,35-39,1913,9.668892863787267
SIM,1931,37,35-39,1968,1
SIM,1871,6,na,1877,2628
STAT,1845,36,20-24,1881,0.6394369236786269
STAT,1879,47,30-34,1926,0.10274193254423705
STAT,1820,50,50-100,1870,0.027559176947208427
STAT,1931,36,30-34,1967,2.4639336826082046
STAT,1768,114,na,1882,4.111655370791463E-4
STAT,1890,35,20-24,1925,0.9706397910172647
STAT,1923,37,35-39,1960,2.8594784765979595
SIM,1945,16,20-24,1961,149
STAT,1858,43,30-34,1901,0.9233716526487271
STAT,1863,48,50-100,1911,0.2169170892739571
STAT,1847,32,15-19,1879,0.13038844305174402
SIM,1867,34,na,1901,2148
STAT,1896,22,na,1918,3186.556391798675
SIM,1862,19,20-24,1881,27
SIM,1849,75,na,1924,1029
STAT,1854,19,20-24,1873,16.040657181230632
SIM,1902,49,na,1951,3237
SIM,1840,27,20-24,1867,10
SIM,1843,24,45-49,1867,1
SIM,1888,35,30-34,1923,8
SIM,1880,20,40-44,1900,2
SIM,1842,36,45-49,1878,3
SIM,1919,33,na,1952,4174
STAT,1906,25,40-44,1931,4.4781266601239205
STAT,1885,48,na,1933,2261.068309243466
STAT,1832,44,50-100,1876,0.8458149333424766
STAT,1834,28,50-100,1862,0.5604329182990356
SIM,1840,44,50-100,1884,2
STAT,1843,23,40-44,1866,2.0963479548610087
STAT,1863,30,40-44,1893,3.9101633640704097
SIM,1892,29,35-39,1921,22
STAT,1908,21,35-39,1929,8.853683094988877
SIM,1849,20,30-34,1869,21
SIM,1845,37,25-29,1882,1
SIM,1864,42,na,1906,2100
STAT,1901,40,40-44,1941,0.22507194653473828
STAT,1902,67,na,1969,2616.7130486319747
SIM,1932,15,na,1947,5171
STAT,1877,43,40-44,1920,2.362735132640592
SIM,1834,25,30-34,1859,28
SIM,1885,43,40-44,1928,9
STAT,1854,50,45-49,1904,0.011266757412098288
SIM,1844,42,50-100,1886,2
STAT,1878,27,45-49,1905,1.1789878380987284
STAT,1932,27,25-29,1959,87.91963935032534
STAT,1881,52,20-24,1933,7.239187988534036E-4
STAT,1908,48,15-19,1956,3.38768155745973E-4
STAT,1928,38,15-19,1966,0.024729834470073812
SIM,1838,90,na,1928,33
STAT,1937,10,na,1947,3943.7251844679463
SIM,1843,53,na,1896,1574
SIM,1875,26,30-34,1901,28
STAT,1926,16,45-49,1942,0.6263419919415169
SIM,1844,38,45-49,1882,4
STAT,1862,21,35-39,1883,5.22509125500179
STAT,1858,15,na,1873,2195.039692393377
SIM,1907,48,na,1955,3416
STAT,1841,42,na,1883,1773.2775023293266
STAT,1854,30,40-44,1884,3.4703117360880467
STAT,1844,30,30-34,1874,16.518817494897753
STAT,1886,20,35-39,1906,6.338818672565127
SIM,1825,38,35-39,1863,9
SIM,1881,60,na,1941,1769
STAT,1867,22,15-19,1889,3.1725960597173817
STAT,1838,46,30-34,1884,0.07411555200422733
SIM,1862,32,50-100,1894,1
SIM,1914,34,na,1948,3849
STAT,1815,45,25-29,1860,0.16021285111242375
SIM,1836,29,20-24,1865,16
STAT,1950,19,40-44,1969,1.6861204181544005
STAT,1915,17,30-34,1932,2.6032092236705084
STAT,1873,28,20-24,1901,12.090539568435782
STAT,1876,25,45-49,1901,1.177561060616867
SIM,1889,18,na,1907,3320
STAT,1908,38,20-24,1946,0.2504276919283929
SIM,1875,22,15-19,1897,3
SIM,1880,5,na,1885,2738
STAT,1871,26,20-24,1897,11.895603446147256
STAT,1905,46,30-34,1951,0.08067782920264822
STAT,1834,45,35-39,1879,0.11264771147653181
SIM,1897,69,na,1966,2208
STAT,1889,18,30-34,1907,2.003242145024518
STAT,1936,24,15-19,1960,5.1871824511871125
SIM,1903,27,30-34,1930,42
STAT,1856,43,20-24,1899,0.12625932604150575
SIM,1918,23,35-39,1941,17
STAT,1836,38,45-49,1874,1.507408019175195
SIM,1904,18,25-29,1922,16
SIM,1862,30,40-44,1892,7
STAT,1948,17,35-39,1965,4.899395770449027
SIM,1906,39,40-44,1945,3
SIM,1852,30,30-34,1882,15
STAT,1828,29,20-24,1857,13.302854918327082
SIM,1823,39,na,1862,1610
SIM,1905,20,50-100,1925,1
SIM,1819,36,45-49,1855,4
STAT,1888,33,15-19,1921,0.17102176120443904
SIM,1859,20,15-19,1879,3
STAT,1856,37,35-39,1893,5.664020267619664
STAT,1931,19,30-34,1950,16.183497323640818
STAT,1914,32,15-19,1946,0.13197736878555003
SIM,1868,20,40-44,1888,2
STAT,1836,42,50-100,1878,0.7823218437564694
SIM,1841,94,na,1935,12
STAT,1879,84,na,1963,581.9244508642146
STAT,1896,32,45-49,1928,2.349544841756288
STAT,1866,56,na,1922,1919.2347936941503
STAT,1829,41,45-49,1870,1.273104804971743
STAT,1858,36,30-34,1894,4.332421602983577
STAT,1885,5,na,1890,2667.2303103087543
SIM,1832,23,30-34,1855,21
SIM,1944,24,15-19,1968,4
SIM,1908,12,na,1920,4167
STAT,1811,76,na,1887,402.4212755189387
STAT,1921,48,30-34,1969,0.10226410780971887
STAT,1840,47,25-29,1887,0.04179784866253584
SIM,1812,92,na,1904,11
STAT,1931,15,15-19,1946,60.8633576563429
STAT,1880,16,45-49,1896,0.07019964880949539
STAT,1795,75,na,1870,368.67655838371843
STAT,1849,47,45-49,1896,0.18236690100752162
STAT,1802,62,na,1864,823.0107221617396
SIM,1921,15,30-34,1936,25
STAT,1892,8,na,1900,3323.680741070066
SIM,1845,23,40-44,1868,2
SIM,1942,17,40-44,1959,1
STAT,1878,38,25-29,1916,3.042143606976825
SIM,1869,41,40-44,1910,4
STAT,1866,41,15-19,1907,0.013053435551223692
STAT,1889,0,na,1889,3635.7247263596005
SIM,1831,38,35-39,1869,11
SIM,1886,48,na,1934,2502
STAT,1922,27,40-44,1949,5.381631028368305
STAT,1819,35,40-44,1854,14.565841821145334
STAT,1823,61,na,1884,1103.4572657865365
STAT,1819,44,50-100,1863,2.1513331305895957
STAT,1905,29,30-34,1934,36.83644285385926
SIM,1919,26,20-24,1945,24
STAT,1911,17,50-100,1928,0.07647421852290187
STAT,1839,36,20-24,1875,0.6423792950318119
STAT,1843,39,15-19,1882,0.0471684525094588
STAT,1854,7,na,1861,2266.0942755370947
SIM,1905,47,35-39,1952,1
STAT,1764,101,na,1865,0.21310228508493972
SIM,1884,25,45-49,1909,2
SIM,1884,19,na,1903,2718
STAT,1871,89,na,1960,177.50247630063265
STAT,1893,23,50-100,1916,0.5261097974951904
STAT,1909,27,50-100,1936,0.9701483157685036
SIM,1851,72,na,1923,911
SIM,1940,27,25-29,1967,71
STAT,1823,38,35-39,1861,12.75859419607879
SIM,1858,32,40-44,1890,5
STAT,1792,100,na,1892,0.17610029695707557
SIM,1875,85,na,1960,412
SIM,1872,45,20-24,1917,1
STAT,1864,45,20-24,1909,0.010993506818660861
SIM,1866,34,40-44,1900,8
STAT,1798,101,na,1899,0.19642476534426892
SIM,1862,1,na,1863,3054
STAT,1865,42,50-100,1907,0.9769675023382296
STAT,1926,15,40-44,1941,1.7575895491234206
STAT,1860,32,30-34,1892,14.451656995852517
STAT,1830,25,20-24,1855,16.22099203677427
STAT,1856,56,na,1912,1633.3460585358637
STAT,1930,18,35-39,1948,5.518491775536453
STAT,1867,1,na,1868,3415.526432922972
SIM,1913,29,30-34,1942,48
SIM,1873,56,na,1929,2031
STAT,1906,30,15-19,1936,0.12239252927045473
SIM,1858,37,35-39,1895,14
SIM,1869,28,20-24,1897,2
STAT,1884,50,30-34,1934,0.006094139389127518
SIM,1849,27,40-44,1876,4
SIM,1886,38,25-29,1924,4
STAT,1847,38,20-24,1885,0.6172439799267898
SIM,1936,22,15-19,1958,5
STAT,1861,40,35-39,1901,1.5418610245514808
STAT,1810,51,35-39,1861,0.026304632366571833
SIM,1930,27,40-44,1957,18
STAT,1935,19,15-19,1954,62.93093240727048
SIM,1908,59,na,1967,3370
STAT,1838,41,50-100,1879,0.9194873504453899
STAT,1913,15,30-34,1928,2.5541575839230815
SIM,1832,28,25-29,1860,46
STAT,1861,16,35-39,1877,0.5347911946520982
STAT,1820,43,na,1863,1479.4328269593266
STAT,1821,47,15-19,1868,6.30251477654848E-4
STAT,1851,20,20-24,1871,68.88034206558986
STAT,1813,95,na,1908,5.717445111638341
SIM,1846,41,50-100,1887,6
STAT,1848,6,na,1854,2404.0
SIM,1836,40,40-44,1876,5
STAT,1900,2,na,1902,3769.109175965798
STAT,1911,25,15-19,1936,0.7070134639856199
STAT,1825,30,20-24,1855,6.564230484734422
SIM,1916,21,35-39,1937,11
SIM,1817,91,na,1908,27
STAT,1862,28,45-49,1890,0.9607933281005884
STAT,1886,26,40-44,1912,3.2457466025356356
SIM,1894,37,20-24,1931,2
STAT,1837,23,40-44,1860,1.8057185869598957
STAT,1834,94,na,1928,13.430994804427513
STAT,1856,41,na,1897,1859.2235427602172
STAT,1866,34,na,1900,2226.2229219297374
SIM,1914,25,40-44,1939,11
STAT,1954,18,20-24,1972,170.89997310523157
STAT,1851,26,50-100,1877,0.6223993406476155
STAT,1895,31,40-44,1926,5.7958060615446625
STAT,1841,52,25-29,1893,0.0026013323172090178
STAT,1919,17,15-19,1936,51.17889429365384
STAT,1876,18,na,1894,2653.5770754464916
STAT,1934,17,40-44,1951,1.929363050916271
SIM,1927,17,15-19,1944,71
STAT,1870,52,45-49,1922,0.014395643621128742
STAT,1828,40,40-44,1868,1.9000425737250581
STAT,1853,45,45-49,1898,0.19985852544056465
STAT,1890,29,35-39,1919,11.949444393093396
STAT,1891,19,25-29,1910,7.118684467261318
SIM,1866,30,25-29,1896,2
STAT,1875,46,35-39,1921,0.14699766397969974
STAT,1897,44,20-24,1941,0.014839956073855748
STAT,1849,71,na,1920,1036.2865238463573
STAT,1865,26,20-24,1891,10.899460102135572
SIM,1943,19,15-19,1962,48
SIM,1871,49,na,1920,2019
STAT,1892,21,20-24,1913,88.37489664626683
SIM,1887,70,na,1957,1698
SIM,1891,37,50-100,1928,5
STAT,1825,49,50-100,1874,0.30734527208137247
SIM,1858,89,na,1947,62
SIM,1847,30,15-19,1877,2
STAT,1888,39,20-24,1927,0.9203027229783862
SIM,1927,39,35-39,1966,9
STAT,1906,48,na,1954,3299.3042204069457
STAT,1908,27,40-44,1935,4.5312369532396435
STAT,1923,15,15-19,1938,54.625566497301655
SIM,1840,21,15-19,1861,3
STAT,1854,49,na,1903,1685.973523473542
STAT,1899,20,45-49,1919,0.9799493639680504
STAT,1859,15,40-44,1874,0.17502964391291478
STAT,1762,113,na,1875,4.534598669711199E-4
STAT,1894,46,45-49,1940,0.17518325250915556
SIM,1873,29,25-29,1902,44
SIM,1901,27,50-100,1928,1
SIM,1931,15,15-19,1946,53
SIM,1940,20,15-19,1960,6
STAT,1819,46,20-24,1865,0.024121913597922946
STAT,1904,39,40-44,1943,1.3675229132546447
STAT,1928,22,15-19,1950,6.779308142760979
SIM,1834,76,na,1910,665
SIM,1912,39,40-44,1951,4
SIM,1894,26,40-44,1920,3
STAT,1816,91,na,1907,25.712223395151508
STAT,1892,66,na,1958,2175.167263110814
STAT,1927,21,45-49,1948,1.4183737870390953
SIM,1833,49,50-100,1882,1
STAT,1863,24,20-24,1887,61.96776220270097
STAT,1886,37,20-24,1923,0.8323719565984009
STAT,1883,37,50-100,1920,1.228928071629043
STAT,1864,39,35-39,1903,6.35115057105177
SIM,1899,33,40-44,1932,12
STAT,1910,23,40-44,1933,3.210504005928405
STAT,1919,39,35-39,1958,2.6460297762578606
SIM,1923,48,na,1971,4176
STAT,1853,25,50-100,1878,0.6303936533170309
STAT,1855,93,na,1948,22.655474856384355
SIM,1916,27,40-44,1943,5
STAT,1841,26,35-39,1867,8.912732476076906
SIM,1852,57,na,1909,1686
SIM,1932,29,40-44,1961,10
SIM,1798,97,na,1895,1
STAT,1858,30,25-29,1888,8.460231051745774
STAT,1884,24,40-44,1908,2.0899859328153543
SIM,1825,33,40-44,1858,6
SIM,1832,80,na,1912,213
SIM,1938,25,na,1963,3694
STAT,1869,41,40-44,1910,2.225354587173103
SIM,1830,26,25-29,1856,45
SIM,1935,21,45-49,1956,2
STAT,1934,28,20-24,1962,25.030206431695674
SIM,1827,35,40-44,1862,9
STAT,1848,49,50-100,1897,0.18692689403356919
SIM,1905,20,20-24,1925,97
SIM,1861,25,50-100,1886,1
SIM,1917,26,na,1943,4081
STAT,1834,72,na,1906,848.6875285046727
STAT,1836,31,35-39,1867,8.051377712228563
STAT,1859,20,15-19,1879,3.1089307075222563
SIM,1917,27,50-100,1944,2
STAT,1870,20,30-34,1890,17.8695128346157
STAT,1929,34,25-29,1963,11.958864287424912
STAT,1880,40,45-49,1920,1.6206319954674862
SIM,1870,32,40-44,1902,8
STAT,1838,60,na,1898,1401.3043710104835
SIM,1848,15,30-34,1863,2
SIM,1873,26,20-24,1899,1
SIM,1888,55,na,1943,2366
SIM,1896,39,20-24,1935,1
STAT,1869,48,na,1917,2188.044450126373
STAT,1843,28,35-39,1871,9.517320054505792
STAT,1912,36,20-24,1948,0.2637280262346301
SIM,1892,24,40-44,1916,4
SIM,1844,31,35-39,1875,14
SIM,1849,53,na,1902,1681
STAT,1840,103,na,1943,0.10327311439693054
STAT,1907,42,25-29,1949,0.06671259118056085
SIM,1851,28,35-39,1879,11
STAT,1842,44,30-34,1886,0.9091799278442251
STAT,1951,20,25-29,1971,112.65894652619227
SIM,1861,71,na,1932,1235
STAT,1870,23,35-39,1893,5.801524319828586
SIM,1928,38,40-44,1966,1
STAT,1831,28,30-34,1859,24.226814111005833
SIM,1870,37,20-24,1907,3
STAT,1911,32,35-39,1943,9.076905383614074
STAT,1914,33,15-19,1947,0.13142042428927508
SIM,1916,22,35-39,1938,9
STAT,1873,24,15-19,1897,3.3906544225539395
SIM,1898,64,na,1962,2929
STAT,1860,18,na,1878,2178.3681481114722
STAT,1801,82,na,1883,164.84146658450678
SIM,1840,43,50-100,1883,6
STAT,1828,32,40-44,1860,4.279211435432866
STAT,1871,37,15-19,1908,0.05674556778212244
STAT,1849,22,30-34,1871,16.719378649558454
STAT,1833,49,45-49,1882,0.16219043399523575
STAT,1881,21,45-49,1902,0.6898288948376894
STAT,1857,41,20-24,1898,0.12710185800970225
STAT,1863,38,na,1901,2096.855590189242
SIM,1841,49,45-49,1890,1
STAT,1946,26,15-19,1972,0.8026868314102061
SIM,1939,17,35-39,1956,5
STAT,1889,26,20-24,1915,14.834046047499195
STAT,1958,5,na,1963,5266.389064894558
SIM,1897,26,20-24,1923,23
STAT,1923,48,40-44,1971,0.18765987307631057
STAT,1929,9,na,1938,5181.728972406904
STAT,1793,109,na,1902,1.4251650768165748E-4
SIM,1876,49,na,1925,2530
STAT,1927,42,40-44,1969,0.3199908619263291
STAT,1889,4,na,1893,3315.044401375303
SIM,1848,26,25-29,1874,51
SIM,1869,51,na,1920,2143
STAT,1838,36,15-19,1874,0.050305787426508757
SIM,1817,38,na,1855,1446
SIM,1895,30,50-100,1925,6
SIM,1922,47,na,1969,4262
STAT,1860,93,na,1953,24.190274988966728
STAT,1782,112,na,1894,1.1388831840490908E-4
STAT,1932,33,35-39,1965,12.381265299905023
SIM,1940,17,30-34,1957,14
STAT,1861,22,50-100,1883,0.3531522378074802
STAT,1813,44,15-19,1857,0.042171470649598204
STAT,1898,24,20-24,1922,94.47325325461004
SIM,1869,25,50-100,1894,1
SIM,1875,91,na,1966,174
STAT,1936,35,45-49,1971,0.6837867796830798
SIM,1862,22,40-44,1884,3
SIM,1839,53,na,1892,1521
SIM,1926,20,50-100,1946,1
STAT,1887,40,na,1927,2668.714630376694
SIM,1876,20,15-19,1896,6
STAT,1863,20,40-44,1883,1.9286066172736354
STAT,1920,30,35-39,1950,10.296933262946387
SIM,1859,30,40-44,1889,2
STAT,1932,17,30-34,1949,16.459704733232602
SIM,1886,79,na,1965,1025
STAT,1859,21,na,1880,2000.459378244087
SIM,1826,74,na,1900,640
SIM,1854,23,45-49,1877,1
STAT,1883,52,30-34,1935,0.0059265772341836
STAT,1856,88,na,1944,109.93717960179123
STAT,1846,23,45-49,1869,0.6108719072658136
STAT,1854,40,40-44,1894,1.738864142449451
STAT,1906,27,30-34,1933,37.391236624802126
SIM,1914,28,na,1942,3809
SIM,1861,39,20-24,1900,1
STAT,1905,35,15-19,1940,0.018027222870186054
STAT,1875,53,35-39,1928,0.008869050846382955
SIM,1845,25,45-49,1870,2
STAT,1868,20,15-19,1888,3.2611229066740375
SIM,1903,40,na,1943,3310
STAT,1850,16,50-100,1866,0.045299281025624534
SIM,1833,30,20-24,1863,3
SIM,1871,20,40-44,1891,6
STAT,1839,17,na,1856,2072.347566439817
SIM,1889,27,25-29,1916,63
STAT,1857,23,20-24,1880,62.92828672537959
STAT,1844,49,20-24,1893,0.009104782270294211
STAT,1846,41,45-49,1887,1.0972042751529456
STAT,1854,22,40-44,1876,1.8738958884816412
STAT,1950,15,25-29,1965,52.302356251129154
SIM,1822,40,50-100,1862,2
STAT,1837,25,45-49,1862,0.9639450935913011
STAT,1847,36,na,1883,1926.0957779437938
SIM,1912,19,20-24,1931,37
SIM,1922,15,15-19,1937,45
SIM,1899,18,na,1917,3497
SIM,1830,95,na,1925,11
STAT,1843,22,na,1865,2166.549580167729
STAT,1851,41,na,1892,1915.4408505993033
STAT,1916,21,30-34,1937,30.826548612696737
STAT,1940,23,15-19,1963,5.530243186081826
STAT,1906,64,na,1970,2914.3046253665584
SIM,1845,30,40-44,1875,1
SIM,1864,20,na,1884,2260
SIM,1953,15,na,1968,4461
STAT,1839,72,na,1911,871.5803979658557
SIM,1793,82,na,1875,105
SIM,1906,32,20-24,1938,2
SIM,1905,38,45-49,1943,1
SIM,1865,23,20-24,1888,71
STAT,1880,35,15-19,1915,0.06077107365766859
STAT,1904,19,20-24,1923,25.78127482890145
STAT,1914,15,15-19,1929,9.622852561856009
STAT,1937,28,15-19,1965,0.7016001976666586
SIM,1907,24,35-39,1931,12
STAT,1850,46,40-44,1896,0.1291430900751239
STAT,1899,16,35-39,1915,0.7684126573075132
STAT,1900,48,45-49,1948,0.185865037304043
STAT,1927,10,na,1937,5040.729746626185
SIM,1854,41,45-49,1895,2
STAT,1945,23,50-100,1968,0.7355241578132313
SIM,1930,19,40-44,1949,2
SIM,1905,45,35-39,1950,1
STAT,1833,54,40-44,1887,0.006897924512235914
STAT,1874,17,50-100,1891,0.05102807198739196
STAT,1887,24,45-49,1911,0.7921413896644631
SIM,1857,22,30-34,1879,22
STAT,1822,44,na,1866,1563.6807853268283
SIM,1843,58,na,1901,1454
SIM,1895,24,45-49,1919,1
STAT,1922,37,40-44,1959,1.7380582371489905
SIM,1893,17,na,1910,3310
STAT,1766,115,na,1881,2.622679796655333E-4
STAT,1901,17,na,1918,3602.9771017019148
SIM,1874,31,20-24,1905,4
SIM,1940,24,20-24,1964,127
STAT,1914,42,30-34,1956,0.12925065299200253
SIM,1873,18,30-34,1891,5
SIM,1948,22,50-100,1970,1
SIM,1924,21,30-34,1945,54
STAT,1866,0,na,1866,3571.4123819197102
SIM,1858,20,na,1878,2065
STAT,1922,19,40-44,1941,1.6428495696672247
STAT,1913,46,na,1959,3667.1737044928436
STAT,1865,18,30-34,1883,1.5117950353437222
STAT,1915,49,45-49,1964,0.22217165702848887
SIM,1880,54,na,1934,1978
STAT,1837,30,40-44,1867,3.701358868029535
SIM,1855,87,na,1942,165
SIM,1899,21,25-29,1920,102
SIM,1856,0,na,1856,3639
SIM,1789,77,na,1866,360
SIM,1884,68,na,1952,1449
STAT,1872,29,30-34,1901,25.562704350415295
SIM,1819,92,na,1911,9
STAT,1894,48,20-24,1942,0.00877079682941611
STAT,1942,27,na,1969,4011.38311232866
STAT,1798,61,na,1859,1145.4619834585903
STAT,1868,85,na,1953,267.107638324098
STAT,1932,24,20-24,1956,148.27731754331865
SIM,1925,1,na,1926,5161
STAT,1923,3,na,1926,4859.501080726636
SIM,1898,23,30-34,1921,46
SIM,1877,33,40-44,1910,8
STAT,1860,52,35-39,1912,0.007087906511355083
STAT,1945,15,15-19,1960,50.6070346750645
SIM,1880,29,30-34,1909,29
SIM,1886,41,40-44,1927,6
STAT,1924,25,25-29,1949,78.71931178800513
SIM,1821,75,na,1896,524
STAT,1880,15,45-49,1895,0.07035301838958466
SIM,1927,43,45-49,1970,3
STAT,1866,48,45-49,1914,0.21927865903738103
STAT,1839,28,30-34,1867,21.736638825301206
STAT,1889,19,30-34,1908,1.9977332291257002
STAT,1891,7,na,1898,3290.55948627649
STAT,1866,50,na,1916,2055.1820265949746
STAT,1898,5,na,1903,3615.3082159935725
STAT,1904,24,45-49,1928,1.0131476084486601
SIM,1900,9,na,1909,3741
STAT,1863,15,45-49,1878,0.06746403225491567
SIM,1842,80,na,1922,533
SIM,1880,31,50-100,1911,2
STAT,1842,51,30-34,1893,0.0046903514169935245
SIM,1829,39,na,1868,1443
STAT,1895,41,40-44,1936,0.20883704312701262
STAT,1841,27,na,1868,1983.8696019068097
STAT,1865,25,20-24,1890,10.935876571117406
SIM,1832,74,na,1906,580
SIM,1847,28,30-34,1875,41
SIM,1873,72,na,1945,1210
SIM,1912,24,45-49,1936,3
SIM,1904,17,20-24,1921,27
STAT,1854,105,na,1959,0.04977017623486679
STAT,1869,33,40-44,1902,4.253243892897287
SIM,1874,48,45-49,1922,1
SIM,1953,15,15-19,1968,54
SIM,1828,33,45-49,1861,2
STAT,1922,41,25-29,1963,0.08375277409285574
STAT,1936,21,50-100,1957,0.6418325875814701
SIM,1852,33,35-39,1885,14
STAT,1878,41,40-44,1919,2.3992258376970694
STAT,1914,38,45-49,1952,0.6910207982459466
SIM,1830,48,50-100,1878,1
SIM,1799,83,na,1882,198
STAT,1816,44,na,1860,1356.5847912021977
STAT,1869,18,15-19,1887,5.891023984270315
SIM,1929,38,30-34,1967,5
SIM,1877,86,na,1963,354
STAT,1887,42,45-49,1929,1.7087530092048213
SIM,1874,29,50-100,1903,1
STAT,1872,19,na,1891,2568.4064943515555
STAT,1874,18,25-29,1892,5.886784294205457
STAT,1821,39,25-29,1860,5.549590835641124
SIM,1936,15,15-19,1951,38
STAT,1788,95,na,1883,2.8752787738665253
SIM,1846,23,na,1869,2022
STAT,1778,102,na,1880,0.055085453669625584
SIM,1935,22,50-100,1957,1
STAT,1848,25,20-24,1873,11.044688119325349
SIM,1952,9,na,1961,4885
SIM,1869,67,na,1936,1444
STAT,1877,20,40-44,1897,2.218004267273764
SIM,1873,25,na,1898,2415
SIM,1896,69,na,1965,2213
STAT,1919,43,45-49,1962,0.18375803417476774
STAT,1928,15,15-19,1943,58.59996174658484
STAT,1844,33,35-39,1877,9.287452438350027
STAT,1881,55,na,1936,2039.3391662441934
SIM,1820,89,na,1909,64
STAT,1830,36,15-19,1866,0.05144838378403346
STAT,1840,20,45-49,1860,0.6473922503363262
STAT,1940,28,45-49,1968,1.7963624144002364
SIM,1823,38,na,1861,1643
STAT,1874,23,20-24,1897,71.55483510384093
STAT,1905,9,na,1914,3822.788560316957
SIM,1869,34,45-49,1903,1
SIM,1911,30,35-39,1941,17
STAT,1891,47,40-44,1938,0.12140042034596336
STAT,1858,15,35-39,1873,0.5247086142595838
SIM,1877,18,15-19,1895,10
SIM,1878,42,45-49,1920,3
STAT,1881,30,50-100,1911,0.9109361308756722
SIM,1911,49,25-29,1960,1
STAT,1765,98,na,1863,0.191568404741509
STAT,1874,47,40-44,1921,0.17748407364546295
SIM,1941,14,na,1955,3949
STAT,1919,25,15-19,1944,0.7836712342724135
SIM,1831,42,50-100,1873,1
STAT,1846,54,50-100,1900,0.010503303620850345
SIM,1907,7,na,1914,3962
STAT,1875,15,35-39,1890,0.5771735502005697
SIM,1922,38,45-49,1960,1
SIM,1939,32,30-34,1971,23
STAT,1923,35,35-39,1958,2.864431806183645
SIM,1856,25,20-24,1881,14
SIM,1931,35,35-39,1966,5
STAT,1913,43,25-29,1956,0.07092900417102559
STAT,1828,50,40-44,1878,0.008273634981218185
STAT,1903,49,25-29,1952,0.04613380569308757
SIM,1867,72,na,1939,1009
STAT,1913,22,45-49,1935,1.1122820327474374
STAT,1954,12,na,1966,4953.221010767879
SIM,1919,9,na,1928,4542
STAT,1850,44,50-100,1894,0.7839416843902199
SIM,1884,4,na,1888,2896
STAT,1890,32,na,1922,2976.5337343710485
STAT,1923,40,30-34,1963,0.15288278650858214
STAT,1839,35,20-24,1874,0.6490843362250163
STAT,1786,76,na,1862,306.40694530624705
SIM,1885,35,50-100,1920,1
SIM,1897,19,30-34,1916,5
STAT,1859,32,40-44,1891,3.5331878225420446
STAT,1870,24,na,1894,2343.8096649969452
STAT,1895,46,15-19,1941,3.011728195901747E-4
SIM,1905,51,na,1956,3132
SIM,1932,25,25-29,1957,97
SIM,1837,58,na,1895,1219
STAT,1920,49,25-29,1969,0.059488083598366576
SIM,1909,13,na,1922,3795
SIM,1838,75,na,1913,593
STAT,1875,55,na,1930,2164.9181349704727
SIM,1931,28,45-49,1959,3
SIM,1872,26,15-19,1898,1
SIM,1882,47,40-44,1929,1
STAT,1831,30,45-49,1861,1.6386981337200552
STAT,1923,28,45-49,1951,2.0166397750058986
SIM,1836,32,40-44,1868,7
STAT,1834,52,35-39,1886,0.005940408940011955
SIM,1867,32,40-44,1899,6
STAT,1859,92,na,1951,33.93240064982919
SIM,1869,54,50-100,1923,1
STAT,1794,95,na,1889,2.780256393404863
STAT,1908,22,35-39,1930,8.827033508872956
STAT,1930,22,45-49,1952,1.4701247329830844
SIM,1852,35,na,1887,2068
STAT,1895,23,40-44,1918,2.765002034464937
STAT,1866,19,na,1885,2410.6544339518323
STAT,1850,63,na,1913,1342.1622745856969
STAT,1864,26,15-19,1890,0.4129578646903424
SIM,1901,27,20-24,1928,17
STAT,1900,38,45-49,1938,0.6053718633034975
SIM,1917,32,na,1949,3977
SIM,1857,66,na,1923,1295
SIM,1836,46,50-100,1882,1
SIM,1889,71,na,1960,1937
SIM,1927,25,15-19,1952,1
SIM,1884,48,50-100,1932,1
STAT,1807,71,na,1878,742.7717794811771
STAT,1870,23,50-100,1893,0.40541754010190484
SIM,1845,40,40-44,1885,7
STAT,1864,108,na,1972,0.032196255940750665
SIM,1853,52,na,1905,1791
STAT,1882,48,30-34,1930,0.09499842916266353
STAT,1856,29,na,1885,1952.0385390026097
STAT,1914,29,30-34,1943,40.01338507809637
STAT,1910,27,20-24,1937,17.977951445964926
STAT,1889,29,25-29,1918,52.92487901492097
STAT,1875,50,30-34,1925,0.006321944704044741
STAT,1853,23,35-39,1876,5.739825581901015
SIM,1840,23,15-19,1863,3
SIM,1923,33,35-39,1956,18
STAT,1917,46,15-19,1963,3.9362628706855063E-4
STAT,1837,52,50-100,1889,0.0101061677585762
STAT,1929,26,15-19,1955,0.901543853815211
SIM,1914,32,50-100,1946,1
STAT,1904,32,45-49,1936,1.4639705530742264
STAT,1845,47,15-19,1892,3.1108144366642185E-4
STAT,1949,23,35-39,1972,11.205825763237414
SIM,1888,29,30-34,1917,42
STAT,1931,27,40-44,1958,6.137110508809392
SIM,1818,55,na,1873,1188
SIM,1912,32,45-49,1944,3
STAT,1849,25,35-39,1874,9.008836188872106
STAT,1883,31,20-24,1914,2.7167254488990324
SIM,1902,32,35-39,1934,3
STAT,1797,102,na,1899,0.07382600128494676
SIM,1902,1,na,1903,3912
STAT,1921,44,15-19,1965,0.0017591519584234483
SIM,1858,48,50-100,1906,2
STAT,1885,23,50-100,1908,0.4137579558699771
SIM,1869,26,50-100,1895,5
STAT,1816,40,20-24,1856,0.4057979065544924
SIM,1861,23,35-39,1884,8
STAT,1828,35,45-49,1863,1.82758614405343
STAT,1905,19,40-44,1924,0.2680340644625394
SIM,1853,80,na,1933,416
STAT,1907,31,30-34,1938,15.078239904700853
STAT,1906,40,30-34,1946,0.11973927905969826
STAT,1892,67,na,1959,2133.621568385397
STAT,1840,49,50-100,1889,0.17371274861075814
SIM,1903,34,45-49,1937,4
STAT,1824,52,50-100,1876,0.016980825682391173
SIM,1924,24,35-39,1948,21
STAT,1868,14,na,1882,2578.798997005484
STAT,1845,72,na,1917,986.7590738429643
STAT,1855,36,15-19,1891,0.04374043627374146
STAT,1854,43,45-49,1897,1.1371859202082018
STAT,1881,19,30-34,1900,1.5635671168002883
STAT,1836,47,20-24,1883,0.007817267080037903
STAT,1915,33,35-39,1948,9.457287314829342
STAT,1833,56,na,1889,1346.113324657124
STAT,1873,84,na,1957,402.2052084645467
STAT,1870,4,na,1874,2948.8326214247613
STAT,1887,16,45-49,1903,0.07485573292108455
SIM,1881,7,na,1888,2407
STAT,1833,46,40-44,1879,0.13436307524387686
STAT,1878,23,40-44,1901,2.2058785223658584
STAT,1930,40,20-24,1970,0.023765061421728524
SIM,1890,48,30-34,1938,1
SIM,1920,31,40-44,1951,6
SIM,1915,31,30-34,1946,21
SIM,1886,23,40-44,1909,3
STAT,1830,36,50-100,1866,1.1248486123799126
STAT,1913,25,25-29,1938,67.36003374832991
SIM,1919,28,20-24,1947,30
SIM,1893,5,na,1898,3439
SIM,1944,24,50-100,1968,4
SIM,1918,47,50-100,1965,2
STAT,1824,79,na,1903,384.93805624582416
STAT,1860,28,50-100,1888,0.5313133286001852
SIM,1950,8,na,1958,4744
STAT,1892,38,45-49,1930,2.536154094534968
SIM,1817,42,na,1859,1434
STAT,1842,44,40-44,1886,1.778770942192939
SIM,1841,95,na,1936,6
SIM,1894,34,na,1928,3131
SIM,1921,25,25-29,1946,94
STAT,1955,16,15-19,1971,61.46542706223258
STAT,1910,53,na,1963,3421.55618154857
SIM,1850,44,40-44,1894,1
STAT,1868,69,na,1937,1429.9263600740694
STAT,1864,55,na,1919,1875.5864020243116
SIM,1892,9,na,1901,3809
STAT,1825,47,45-49,1872,0.30353450445291813
SIM,1895,42,45-49,1937,1
STAT,1877,48,20-24,1925,0.012537493401740289
SIM,1856,28,25-29,1884,57
SIM,1931,32,30-34,1963,23
STAT,1854,18,na,1872,2089.206336410356
SIM,1834,38,na,1872,1745
STAT,1902,42,35-39,1944,0.1806820912418783
STAT,1874,15,20-24,1889,18.620387358271625
SIM,1941,30,na,1971,3900
STAT,1916,24,35-39,1940,10.00565216852162
STAT,1933,21,30-34,1954,38.99681683156541
STAT,1852,51,50-100,1903,0.01222501325824868
STAT,1773,97,na,1870,0.9165859377785519
SIM,1849,30,25-29,1879,6
SIM,1904,22,45-49,1926,2
STAT,1827,33,35-39,1860,14.88175436368708
STAT,1830,29,25-29,1859,42.75154083791684
SIM,1900,48,na,1948,3088
SIM,1930,14,na,1944,5732
SIM,1879,38,50-100,1917,2
SIM,1871,77,na,1948,884
SIM,1891,31,20-24,1922,3
SIM,1941,21,30-34,1962,40
SIM,1888,36,20-24,1924,2
SIM,1907,21,30-34,1928,36
STAT,1848,18,30-34,1866,1.5268373328077878
STAT,1815,90,na,1905,40.76652094445715
SIM,1830,24,na,1854,2055
SIM,1882,49,na,1931,2112
STAT,1894,24,35-39,1918,7.6094864122867385
STAT,1939,33,20-24,1972,2.5372449470400302
STAT,1827,91,na,1918,37.4527941407777
STAT,1918,45,na,1963,4008.319600242054
SIM,1884,25,50-100,1909,1
SIM,1882,15,20-24,1897,12
SIM,1936,33,45-49,1969,3
SIM,1805,57,na,1862,1015
STAT,1905,45,40-44,1950,0.1437009370234486
SIM,1910,42,35-39,1952,1
STAT,1816,54,40-44,1870,0.01990007125448767
SIM,1885,20,40-44,1905,5
STAT,1880,38,na,1918,2513.149932523324
STAT,1822,38,30-34,1860,9.599177398215977
STAT,1829,46,15-19,1875,3.2791480410527266E-4
SIM,1835,23,na,1858,1875
SIM,1835,33,35-39,1868,14
STAT,1925,15,50-100,1940,0.4638913900260474
SIM,1824,40,20-24,1864,1
STAT,1835,105,na,1940,0.021845831666527423
SIM,1849,15,35-39,1864,4
STAT,1841,47,30-34,1888,0.07179655147346391
STAT,1941,23,35-39,1964,9.92396882792571
SIM,1862,25,45-49,1887,1
SIM,1875,20,na,1895,2376
STAT,1870,39,20-24,1909,0.7610018263199455
SIM,1921,18,35-39,1939,16
SIM,1857,25,35-39,1882,11
SIM,1787,82,na,1869,134
STAT,1897,66,na,1963,2435.8400808197375
SIM,1840,20,50-100,1860,1
STAT,1885,85,na,1970,599.655225364446
STAT,1928,33,45-49,1961,2.005728779316094
STAT,1845,41,na,1886,1862.6730210765738
STAT,1883,45,40-44,1928,0.17307372096615198
STAT,1854,25,45-49,1879,0.9931576777388689
SIM,1878,27,50-100,1905,2
STAT,1819,104,na,1923,0.03932347796075968
STAT,1911,48,20-24,1959,0.010642055392656372
STAT,1832,23,15-19,1855,3.4700020048696856
SIM,1868,32,35-39,1900,19
STAT,1888,27,15-19,1915,0.5471744286213467
STAT,1893,52,na,1945,2771.7562678563754
STAT,1886,48,15-19,1934,4.2649733083556377E-4
SIM,1905,35,40-44,1940,2
SIM,1837,39,30-34,1876,2
SIM,1864,52,na,1916,1987
STAT,1821,36,20-24,1857,1.7875795887356798
STAT,1900,22,35-39,1922,8.251075522997402
STAT,1835,48,50-100,1883,0.1905068353538118
STAT,1875,23,na,1898,2468.5795359995163
STAT,1896,37,15-19,1933,0.07566004236828787
SIM,1921,29,40-44,1950,13
STAT,1825,54,35-39,1879,0.01026007064643365
STAT,1921,24,45-49,1945,1.288719425501575
STAT,1875,28,50-100,1903,0.6674071748486279
SIM,1840,15,15-19,1855,6
STAT,1844,21,40-44,1865,2.030722668054272
SIM,1860,4,na,1864,2505
STAT,1904,53,na,1957,3135.8876188884747
STAT,1922,17,15-19,1939,53.59200196011363
STAT,1914,25,15-19,1939,0.7310373893185853
SIM,1851,41,na,1892,1854
STAT,1886,22,35-39,1908,6.301221993593608
SIM,1865,27,50-100,1892,1
SIM,1913,37,40-44,1950,3
SIM,1944,17,15-19,1961,56
STAT,1911,38,20-24,1949,0.2584253538331192
STAT,1892,45,35-39,1937,0.10197678267215118
SIM,1842,64,na,1906,1291
SIM,1830,38,30-34,1868,4
STAT,1906,34,20-24,1940,2.2848924959974695
SIM,1928,32,na,1960,4981
STAT,1937,18,20-24,1955,134.1811496107143
SIM,1945,18,20-24,1963,171
STAT,1931,35,40-44,1966,2.0254378003731586
SIM,1852,21,40-44,1873,4
STAT,1905,27,40-44,1932,4.413497782624265
SIM,1848,18,25-29,1866,6
STAT,1870,24,50-100,1894,0.4041283123243807
STAT,1804,59,na,1863,1018.1164953273706
SIM,1827,31,35-39,1858,10
STAT,1874,38,na,1912,2441.7246228399304
SIM,1832,24,20-24,1856,67
STAT,1878,31,40-44,1909,4.623810019522555
SIM,1894,22,35-39,1916,13
SIM,1835,35,50-100,1870,2
STAT,1829,39,30-34,1868,4.538029328388477
STAT,1955,8,na,1963,5321.304016270022
SIM,1852,67,na,1919,1285
SIM,1908,23,40-44,1931,4
STAT,1848,28,25-29,1876,38.97339345716001
STAT,1857,42,na,1899,1839.1413052535502
SIM,1833,60,na,1893,1264
STAT,1797,76,na,1873,388.8351095858244
STAT,1876,49,na,1925,2320.5635794665836
STAT,1913,29,40-44,1942,4.704076252800583
STAT,1850,108,na,1958,0.0026516884446894265
SIM,1877,36,45-49,1913,2
STAT,1924,22,20-24,1946,133.8653536935974
STAT,1903,46,20-24,1949,0.009844033895637545
STAT,1913,47,40-44,1960,0.1569883978526825
SIM,1916,47,na,1963,3818
SIM,1863,35,na,1898,2076
STAT,1927,26,na,1953,4661.616497964411
STAT,1879,85,na,1964,523.6738133327068
SIM,1898,26,35-39,1924,21
STAT,1898,42,20-24,1940,0.015195390694907298
SIM,1912,33,na,1945,3884
STAT,1869,36,45-49,1905,1.9728518255195082
SIM,1861,87,na,1948,57
STAT,1904,21,40-44,1925,3.0558638477652322
SIM,1841,17,25-29,1858,9
STAT,1909,43,35-39,1952,0.1909350144224717
SIM,1912,21,40-44,1933,10
STAT,1785,82,na,1867,166.79052468994783
STAT,1925,38,20-24,1963,0.3224694482323971
STAT,1888,35,15-19,1923,0.06836671454438308
SIM,1914,27,30-34,1941,43
STAT,1912,31,40-44,1943,3.944235347894398
STAT,1945,22,50-100,1967,0.7357669609103318
SIM,1778,77,na,1855,382
STAT,1868,34,35-39,1902,9.783001026377095
STAT,1923,32,30-34,1955,18.428480673321385
SIM,1932,22,20-24,1954,148
STAT,1905,37,40-44,1942,1.392083014757882
SIM,1934,32,na,1966,5437
STAT,1949,21,50-100,1970,0.7835937514485697
STAT,1840,25,15-19,1865,0.4129863532289817
SIM,1853,21,35-39,1874,13
STAT,1886,23,na,1909,2545.9168373350453
SIM,1889,19,25-29,1908,6
STAT,1919,40,40-44,1959,0.2773717416361742
STAT,1868,15,45-49,1883,0.06557066621408783
STAT,1851,44,35-39,1895,1.4737872831680965
STAT,1931,17,40-44,1948,1.8671357841779361
SIM,1836,35,45-49,1871,2
STAT,1837,49,30-34,1886,0.06530176708549816
SIM,1904,66,na,1970,2710
STAT,1810,59,na,1869,1007.6971522818209
SIM,1830,79,na,1909,446
STAT,1923,25,40-44,1948,5.497094666042564
STAT,1834,73,na,1907,798.1906205586445
STAT,1866,26,50-100,1892,0.6039971343650015
SIM,1876,34,35-39,1910,15
SIM,1901,17,na,1918,3740
STAT,1876,40,na,1916,2459.2951614115495
STAT,1936,17,15-19,1953,44.316259624199446
STAT,1847,34,15-19,1881,0.11621476225599363
STAT,1885,22,40-44,1907,2.1208564470935367
STAT,1851,37,45-49,1888,1.6622735900386414
STAT,1923,43,35-39,1966,0.23975589290934646
STAT,1860,42,35-39,1902,1.4969910677015397
STAT,1867,20,25-29,1887,55.850937444560536
SIM,1850,30,20-24,1880,6
STAT,1922,35,15-19,1957,0.022334415348274766
SIM,1937,26,15-19,1963,1
SIM,1931,25,40-44,1956,9
STAT,1903,28,20-24,1931,16.95265189430311
STAT,1934,5,na,1939,5546.183518076939
STAT,1895,26,45-49,1921,1.4828971172575534
STAT,1928,36,25-29,1964,1.2704039105055773
SIM,1911,28,20-24,1939,3
STAT,1939,11,na,1950,4043.217191613926
SIM,1882,33,na,1915,2322
STAT,1897,70,na,1967,2228.8459768920206
STAT,1905,35,50-100,1940,0.3941405956640615
SIM,1874,16,25-29,1890,11
STAT,1899,34,50-100,1933,1.2690087051345658
SIM,1869,16,15-19,1885,5
SIM,1889,12,na,1901,3366
SIM,1914,34,20-24,1948,6
SIM,1886,31,40-44,1917,8
SIM,1819,40,40-44,1859,6
SIM,1871,61,na,1932,1673
SIM,1847,24,15-19,1871,2
SIM,1871,30,40-44,1901,8
STAT,1852,50,35-39,1902,0.007035137839849049
STAT,1920,22,35-39,1942,10.682430540015911
SIM,1888,34,na,1922,2745
SIM,1875,20,25-29,1895,67
STAT,1842,30,20-24,1872,2.6144473552690806
STAT,1828,53,45-49,1881,0.009779454829986364
STAT,1895,44,45-49,1939,0.13646443639204517
STAT,1908,6,na,1914,3951.579843240023
SIM,1865,37,na,1902,2297
SIM,1930,17,15-19,1947,55
STAT,1840,73,na,1913,854.7043758188763
STAT,1840,18,30-34,1858,1.4762351639461735
STAT,1911,11,na,1922,4037.201257947055
SIM,1897,29,25-29,1926,77
STAT,1866,16,25-29,1882,5.505520827899526
STAT,1915,25,na,1940,3925.5679292272735
SIM,1843,48,50-100,1891,1
SIM,1798,98,na,1896,1
SIM,1931,6,na,1937,5223
STAT,1901,19,20-24,1920,25.155522377844417
STAT,1811,45,na,1856,1338.240677014209
STAT,1833,40,20-24,1873,0.13065759130979704
SIM,1875,36,na,1911,2362
STAT,1894,20,40-44,1914,2.750726962843395
STAT,1909,25,35-39,1934,14.85776242782814
STAT,1924,31,30-34,1955,18.764302364322692
STAT,1813,42,45-49,1855,5.447333721775415
SIM,1915,39,45-49,1954,3
SIM,1869,26,45-49,1895,1
STAT,1828,47,15-19,1875,3.1283487950087047E-4
STAT,1865,48,30-34,1913,0.08850122268619648
SIM,1868,28,15-19,1896,4
STAT,1942,22,35-39,1964,10.072360603497067
STAT,1858,50,30-34,1908,0.004884861228163143
STAT,1828,46,50-100,1874,0.1946242915335942
STAT,1859,22,40-44,1881,1.7614319291142042
SIM,1858,15,25-29,1873,7
STAT,1814,89,na,1903,48.953596586586734
SIM,1930,33,25-29,1963,17
STAT,1822,45,50-100,1867,0.3606156236561691
SIM,1904,25,25-29,1929,83
STAT,1886,54,na,1940,2261.1420744516063
STAT,1882,40,na,1922,2320.266083420566
SIM,1858,24,40-44,1882,2
STAT,1865,33,20-24,1898,2.4922080515013243
SIM,1884,13,na,1897,2826
STAT,1795,81,na,1876,185.7529432199015
STAT,1928,30,40-44,1958,4.9967920473073235
SIM,1853,21,na,1874,1986
STAT,1931,29,30-34,1960,51.539925647912135
STAT,1878,52,45-49,1930,0.015328133567863205
SIM,1864,35,20-24,1899,1
STAT,1869,26,15-19,1895,0.44838894721244776
STAT,1910,41,35-39,1951,0.1952164310949473
STAT,1935,33,35-39,1968,12.88522156527861
STAT,1825,44,40-44,1869,2.9455871152009285
SIM,1913,48,45-49,1961,2
STAT,1821,37,50-100,1858,2.6882174582400387
SIM,1836,40,na,1876,1917
STAT,1848,36,25-29,1884,2.330475035118985
SIM,1857,35,na,1892,2001
STAT,1922,33,25-29,1955,10.610681202417526
STAT,1910,22,na,1932,3655.1016448242117
STAT,1892,35,40-44,1927,5.650062769655583
SIM,1839,85,na,1924,156
STAT,1856,35,20-24,1891,0.6231610454750521
SIM,1852,63,na,1915,1505
SIM,1784,78,na,1862,361
SIM,1821,42,45-49,1863,1
SIM,1917,25,35-39,1942,25
STAT,1841,17,30-34,1858,1.517811646720374
STAT,1916,41,50-100,1957,0.12303347444357379
SIM,1920,34,45-49,1954,1
STAT,1842,37,na,1879,1970.3137006026743
STAT,1829,55,na,1884,1424.295175452496
STAT,1905,48,45-49,1953,0.19367254317052057
SIM,1788,67,na,1855,859
SIM,1923,35,25-29,1958,1
SIM,1773,90,na,1863,2
STAT,1851,41,30-34,1892,0.9527879950731013
STAT,1895,38,15-19,1933,0.07437161440475892
STAT,1826,101,na,1927,0.33281089309150697
SIM,1853,35,45-49,1888,4
STAT,1852,48,20-24,1900,0.009545751074442948
SIM,1892,40,30-34,1932,2
STAT,1836,23,35-39,1859,4.759537744572056
SIM,1869,20,na,1889,2366
SIM,1936,30,40-44,1966,5
STAT,1861,48,50-100,1909,0.2044316228443978
SIM,1845,15,15-19,1860,9
STAT,1855,62,na,1917,1416.8540316669846
STAT,1915,35,25-29,1950,1.0246303090157391
STAT,1861,49,20-24,1910,0.009904412863479454
SIM,1948,22,30-34,1970,41
STAT,1918,20,50-100,1938,0.7285187118137774
STAT,1845,35,45-49,1880,1.836157810689238
STAT,1845,21,35-39,1866,5.701303238459408
STAT,1893,36,50-100,1929,1.5965263169528998
SIM,1900,20,30-34,1920,26
SIM,1840,78,na,1918,434
STAT,1853,76,na,1929,794.3967200329728
STAT,1915,19,50-100,1934,0.07958754774101603
SIM,1833,39,45-49,1872,4
STAT,1807,50,20-24,1857,0.0031753074412911287
STAT,1831,23,50-100,1854,0.9382814397884713
STAT,1857,15,20-24,1872,16.79864406204537
STAT,1909,24,45-49,1933,1.0598482178574056
SIM,1917,18,45-49,1935,1
SIM,1886,1,na,1887,3531
SIM,1870,92,na,1962,56
SIM,1922,19,30-34,1941,17
STAT,1768,108,na,1876,0.0067886478085150154
SIM,1856,36,25-29,1892,6
SIM,1935,27,15-19,1962,1
SIM,1866,87,na,1953,185
SIM,1910,29,50-100,1939,3
SIM,1809,78,na,1887,186
STAT,1900,27,40-44,1927,4.235576796688817
STAT,1859,40,40-44,1899,1.8510094579950769
STAT,1940,27,30-34,1967,40.7614289607764
SIM,1868,43,40-44,1911,1
SIM,1796,63,na,1859,720
STAT,1891,17,na,1908,3189.8353359514954
STAT,1916,48,20-24,1964,0.011534915668444301
STAT,1924,46,na,1970,4473.374830773872
STAT,1871,25,45-49,1896,1.1296005916257152
SIM,1832,47,30-34,1879,1
STAT,1884,75,na,1959,1170.9590368493775
STAT,1924,36,40-44,1960,1.8026057189407036
STAT,1854,22,na,1876,1922.7429982532742
STAT,1844,23,50-100,1867,0.3917155234436582
SIM,1801,82,na,1883,162
STAT,1814,40,50-100,1854,3.9998050617052447
STAT,1943,16,45-49,1959,0.5406056677656679
STAT,1870,53,35-39,1923,0.00844764428170877
STAT,1869,54,45-49,1923,0.013900339910087364
STAT,1885,20,15-19,1905,3.377710510022309
STAT,1914,19,30-34,1933,2.5587055114491744
SIM,1885,53,na,1938,2089
STAT,1912,34,45-49,1946,1.5660244524530522
SIM,1879,39,30-34,1918,12
STAT,1820,96,na,1916,4.729140421318935
STAT,1844,47,50-100,1891,0.1894309625998351
SIM,1928,24,20-24,1952,146
STAT,1943,12,na,1955,4249.869763230096
SIM,1892,39,na,1931,3407
STAT,1878,68,na,1946,1622.733725291319
STAT,1887,12,na,1899,2952.1524046913632
STAT,1820,48,20-24,1868,0.021569757734128007
STAT,1902,35,15-19,1937,0.0176026597963023
SIM,1814,43,50-100,1857,5
STAT,1825,39,45-49,1864,2.8584264590547233
STAT,1861,53,40-44,1914,0.008731984977836716
SIM,1833,44,40-44,1877,4
STAT,1909,18,45-49,1927,0.09964634261377056
SIM,1913,18,na,1931,4127
SIM,1932,31,30-34,1963,25
STAT,1907,39,45-49,1946,0.6380190329778667
SIM,1874,14,na,1888,2658
SIM,1882,23,20-24,1905,2
SIM,1932,36,40-44,1968,5
STAT,1888,41,50-100,1929,1.279867329607105
STAT,1891,38,30-34,1929,6.697858774262195
SIM,1867,22,40-44,1889,3
SIM,1951,16,45-49,1967,1
STAT,1874,41,20-24,1915,0.16616205315016092
SIM,1858,88,na,1946,87
SIM,1930,15,25-29,1945,112
SIM,1885,24,35-39,1909,9
STAT,1799,95,na,1894,4.3142545141384225
STAT,1924,45,na,1969,4483.282885951832
SIM,1893,20,15-19,1913,1
STAT,1880,33,45-49,1913,1.8615400388944463
STAT,1858,102,na,1960,0.55858939428132
STAT,1877,24,35-39,1901,6.135786489244009
STAT,1839,52,50-100,1891,0.010367597158286605
STAT,1857,27,50-100,1884,0.5249525994722107
STAT,1825,51,30-34,1876,0.007529650320033968
STAT,1874,69,na,1943,1528.5372090849594
STAT,1895,16,na,1911,3369.8655756073026
STAT,1837,51,45-49,1888,0.009905382976043941
STAT,1870,55,na,1925,2062.0536086687894
STAT,1845,88,na,1933,107.2661136474109
STAT,1791,82,na,1873,150.3672273994115
SIM,1900,39,20-24,1939,3
SIM,1903,28,na,1931,3361
SIM,1824,55,na,1879,1202
STAT,1922,15,25-29,1937,51.41118979491431
STAT,1846,15,45-49,1861,0.05937907241089282
SIM,1808,93,na,1901,3
STAT,1902,29,15-19,1931,0.648052026483717
SIM,1894,33,40-44,1927,14
STAT,1841,24,20-24,1865,63.534732980771395
SIM,1862,43,45-49,1905,1
STAT,1861,21,40-44,1882,1.81765859259902
SIM,1851,42,35-39,1893,6
STAT,1808,89,na,1897,34.97333126692918
STAT,1941,25,25-29,1966,69.52545416387318
STAT,1856,28,30-34,1884,20.74630188191546
STAT,1888,34,na,1922,2853.2995679359515
STAT,1885,17,na,1902,2570.508362516355
STAT,1897,40,50-100,1937,0.10107843581718598
STAT,1889,37,25-29,1926,3.6282019807733343
STAT,1941,20,30-34,1961,30.32294979949135
SIM,1840,49,30-34,1889,1
SIM,1844,39,20-24,1883,4
SIM,1859,34,35-39,1893,2
STAT,1832,49,30-34,1881,0.06816109539841929
SIM,1928,18,20-24,1946,171
STAT,1830,39,50-100,1869,1.077819162158543
STAT,1911,40,35-39,1951,0.1982656664628776
STAT,1836,39,20-24,1875,0.5768689093278252
STAT,1916,16,50-100,1932,0.08131602247266147
STAT,1790,102,na,1892,0.06603183687631084
STAT,1811,47,20-24,1858,0.03333554176624548
STAT,1896,53,na,1949,2854.5762234761028
STAT,1902,0,na,1902,4224.347295831101
SIM,1866,21,50-100,1887,1
STAT,1814,96,na,1910,4.001272508811885
STAT,1843,42,35-39,1885,1.5051100772400836
SIM,1885,21,30-34,1906,30
STAT,1877,35,50-100,1912,1.311394690904781
STAT,1886,33,40-44,1919,4.663077374258507
SIM,1864,28,30-34,1892,28
SIM,1923,29,50-100,1952,1
STAT,1916,10,na,1926,4288.852710477787
STAT,1800,60,na,1860,1180.9857037534225
STAT,1869,48,15-19,1917,3.8901288186362216E-4
SIM,1876,30,40-44,1906,11
SIM,1891,54,na,1945,2676
STAT,1851,29,45-49,1880,1.0571851486201405
STAT,1887,3,na,1890,3022.0349644714192
STAT,1946,18,15-19,1964,51.340375984050546
STAT,1801,53,35-39,1854,0.023767918582881777
SIM,1830,40,45-49,1870,1
SIM,1880,31,45-49,1911,6
SIM,1848,15,20-24,1863,27
STAT,1908,28,na,1936,3598.4584516104405
STAT,1934,16,50-100,1950,0.5180628025475171
STAT,1872,31,50-100,1903,0.9406249653614339
STAT,1850,37,30-34,1887,4.0724178526853985
STAT,1826,81,na,1907,315.3958589525654
SIM,1913,39,30-34,1952,2
STAT,1905,39,30-34,1944,1.6777930082044386
STAT,1917,26,45-49,1943,1.8552485020388045
STAT,1932,38,40-44,1970,2.049151101272391
SIM,1809,71,na,1880,418
STAT,1886,34,50-100,1920,0.9809024186644454
STAT,1831,24,15-19,1855,4.133224477545188
SIM,1827,42,40-44,1869,3
SIM,1838,45,20-24,1883,2
STAT,1906,23,15-19,1929,4.883405289747805
SIM,1923,32,na,1955,4275
STAT,1872,31,45-49,1903,1.7902217193195225
STAT,1877,22,30-34,1899,18.84692676689389
SIM,1819,77,na,1896,504
STAT,1878,34,45-49,1912,1.8358436846156516
STAT,1819,42,40-44,1861,4.855278866567521
STAT,1900,48,50-100,1948,0.19342564867331757
SIM,1897,37,25-29,1934,6
STAT,1935,15,35-39,1950,5.877152172355459
SIM,1904,18,35-39,1922,1
STAT,1907,42,50-100,1949,0.1097529718974786
STAT,1836,36,na,1872,1653.3913298643977
SIM,1923,38,40-44,1961,2
STAT,1950,21,30-34,1971,34.79621599977328
STAT,1820,52,40-44,1872,0.018460295820532973
STAT,1851,34,40-44,1885,3.647378985491641
STAT,1904,17,30-34,1921,2.3303420517843656
STAT,1916,32,35-39,1948,9.62794411847965
STAT,1897,36,20-24,1933,1.0565268498825278
STAT,1833,25,25-29,1858,38.138178004940926
STAT,1912,16,15-19,1928,9.384703724230995
STAT,1873,91,na,1964,149.3804172986332
STAT,1853,22,45-49,1875,0.6908514750062913
SIM,1914,23,15-19,1937,7
STAT,1884,43,35-39,1927,1.8144205249340923
STAT,1870,47,50-100,1917,0.2437858525248875
STAT,1893,8,na,1901,3364.193570302012
SIM,1886,34,45-49,1920,1
SIM,1839,18,30-34,1857,3
STAT,1835,21,50-100,1856,0.4069646911147497
STAT,1876,48,50-100,1924,0.25547140220920556
STAT,1915,30,30-34,1945,16.50569129620691
STAT,1936,30,na,1966,3751.054334384132
SIM,1912,17,30-34,1929,2
STAT,1932,35,25-29,1967,1.3514795311735424
STAT,1815,42,50-100,1857,3.337494770784637
STAT,1922,43,15-19,1965,0.0017956997171220746
SIM,1819,43,45-49,1862,6
SIM,1849,17,25-29,1866,12
STAT,1806,82,na,1888,180.4772154941704
SIM,1919,27,na,1946,4132
STAT,1852,9,na,1861,2373.81697624243
SIM,1925,26,45-49,1951,3
STAT,1847,38,30-34,1885,4.267567685753183
STAT,1880,27,15-19,1907,0.48638255804662694
SIM,1920,16,15-19,1936,49
STAT,1871,34,50-100,1905,0.9179616094244749
STAT,1822,40,45-49,1862,2.4706035668697446
STAT,1857,73,na,1930,946.3049813287876
STAT,1869,54,na,1923,2062.3559056037407
SIM,1915,13,na,1928,4557
STAT,1823,42,50-100,1865,1.7089765954175578
SIM,1931,31,na,1962,4883
SIM,1892,43,35-39,1935,1
STAT,1915,38,40-44,1953,1.5355277836144572
SIM,1869,36,na,1905,2330
STAT,1867,24,40-44,1891,1.9832361850027045
SIM,1918,42,na,1960,4160
STAT,1868,1,na,1869,3460.597357062152
SIM,1838,38,30-34,1876,10
STAT,1898,16,20-24,1914,24.517506349424007
SIM,1853,32,40-44,1885,6
SIM,1964,2,na,1966,5239
STAT,1865,61,na,1926,1730.1749636904672
STAT,1817,52,35-39,1869,0.018440059735198
STAT,1897,29,30-34,1926,34.103533640650774
SIM,1924,32,35-39,1956,2
STAT,1825,102,na,1927,0.17580614181015883
STAT,1931,38,45-49,1969,0.9198463859016375
STAT,1906,48,40-44,1954,0.1415913837537497
STAT,1874,39,50-100,1913,1.2658997768304912
STAT,1936,31,na,1967,3748.9912545002185
SIM,1903,16,15-19,1919,7
STAT,1796,59,na,1855,981.3703899999997
SIM,1947,4,na,1951,4731
SIM,1861,22,45-49,1883,1
SIM,1895,31,50-100,1926,1
STAT,1936,32,40-44,1968,3.8768683954733345
SIM,1886,16,15-19,1902,12
SIM,1900,28,45-49,1928,1
SIM,1952,0,na,1952,5095
SIM,1848,58,na,1906,1591
SIM,1923,30,30-34,1953,28
SIM,1863,1,na,1864,3134
STAT,1812,49,25-29,1861,0.13172555051419566
STAT,1901,37,20-24,1938,0.237355612343625
SIM,1841,25,25-29,1866,6
SIM,1839,25,20-24,1864,3
STAT,1845,50,40-44,1895,0.0083439541947733
STAT,1887,36,15-19,1923,0.06450111478209501
STAT,1900,21,20-24,1921,97.73297906587892
STAT,1835,58,na,1893,1473.4404149759791
STAT,1837,22,na,1859,1866.1358371526312
STAT,1868,30,40-44,1898,4.259520574732023
STAT,1914,45,35-39,1959,0.13107562662124786
STAT,1930,23,50-100,1953,0.8570655575444666
SIM,1913,43,na,1956,3794
STAT,1827,32,45-49,1859,2.693003827836536
SIM,1894,18,15-19,1912,9
STAT,1856,24,15-19,1880,3.024382488678611
STAT,1877,50,na,1927,2310.9757294681453
STAT,1945,19,30-34,1964,13.575459948921226
SIM,1890,25,20-24,1915,13
SIM,1854,20,40-44,1874,2
SIM,1862,25,na,1887,2208
STAT,1908,16,50-100,1924,0.07428952918794593
STAT,1848,53,25-29,1901,0.0027091163333257643
STAT,1863,23,45-49,1886,0.6315829969353115
STAT,1919,22,50-100,1941,0.7352644895408026
STAT,1830,42,45-49,1872,1.2910680174389029
STAT,1858,53,35-39,1911,0.006852967660787212
SIM,1919,34,20-24,1953,3
STAT,1870,3,na,1873,3125.750075709944
SIM,1903,20,35-39,1923,1
SIM,1889,33,50-100,1922,1
STAT,1850,49,45-49,1899,0.17381385081633705
STAT,1937,26,25-29,1963,65.47529070597777
SIM,1919,29,35-39,1948,4
SIM,1875,24,40-44,1899,2
STAT,1862,51,35-39,1913,0.007511877610648704
STAT,1833,43,25-29,1876,0.5082496773880312
SIM,1899,49,na,1948,3118
SIM,1940,30,30-34,1970,28
STAT,1859,25,45-49,1884,0.9335522039869163
STAT,1796,66,na,1862,769.2573862199336
SIM,1832,59,na,1891,1226
SIM,1855,38,30-34,1893,7
SIM,1864,9,na,1873,2546
STAT,1845,32,40-44,1877,4.028917720306574
STAT,1960,12,na,1972,5217.322333155562
STAT,1815,52,20-24,1867,0.0018965135811218662
SIM,1915,36,40-44,1951,3
STAT,1901,21,35-39,1922,8.349907545758805
STAT,1924,39,45-49,1963,0.8184020813321176
SIM,1884,72,na,1956,1117
STAT,1882,49,45-49,1931,0.22965760312927175
STAT,1862,29,20-24,1891,10.114780051109241
STAT,1874,26,25-29,1900,44.210747076213444
SIM,1890,68,na,1958,1978
STAT,1836,20,30-34,1856,15.572204376591307
STAT,1846,20,40-44,1866,1.8653630771825245
SIM,1887,17,na,1904,2979
SIM,1922,45,35-39,1967,1
STAT,1861,105,na,1966,0.16704540940713056
STAT,1882,25,20-24,1907,11.738720259906236
STAT,1886,18,15-19,1904,6.391410257220804
SIM,1881,39,na,1920,2134
STAT,1885,45,50-100,1930,0.2524585299760901
SIM,1859,32,30-34,1891,26
SIM,1823,34,20-24,1857,4
STAT,1846,35,15-19,1881,0.042815553678717665
SIM,1892,32,na,1924,3467
STAT,1894,23,45-49,1917,0.9122105985504224
STAT,1909,49,20-24,1958,0.010295849991368062
STAT,1878,16,15-19,1894,6.31714638905959
SIM,1870,29,20-24,1899,17
STAT,1880,30,40-44,1910,4.686458543233218
STAT,1932,30,30-34,1962,21.383502234860366
STAT,1825,37,na,1862,1709.2258230292205
STAT,1839,88,na,1927,94.74556099794172
SIM,1845,88,na,1933,91
SIM,1864,24,15-19,1888,6
STAT,1813,46,50-100,1859,0.6277180464051765
STAT,1808,56,na,1864,961.6399497763432
STAT,1903,47,na,1950,3248.0327620882813
SIM,1844,44,na,1888,1841
STAT,1887,21,40-44,1908,2.3892631387648464
STAT,1871,22,40-44,1893,2.1057401559956657
SIM,1849,43,na,1892,1798
STAT,1835,31,40-44,1866,4.158341625442894
STAT,1915,32,20-24,1947,2.534982859365415
SIM,1906,49,45-49,1955,1
STAT,1864,76,na,1940,859.3730974711507
STAT,1860,62,na,1922,1512.8391200148276
SIM,1796,59,na,1855,877
SIM,1849,47,na,1896,1799
STAT,1859,30,15-19,1889,0.11771176317508329
STAT,1837,33,45-49,1870,1.4426918533192439
STAT,1830,24,45-49,1854,1.640985908931594
SIM,1931,27,30-34,1958,4
STAT,1870,50,30-34,1920,0.006021562053642174
SIM,1788,92,na,1880,19
STAT,1869,9,na,1878,2673.3864045293603
SIM,1879,13,na,1892,3162
STAT,1858,17,25-29,1875,5.355219590410139
SIM,1814,93,na,1907,17
SIM,1905,47,na,1952,3244
STAT,1846,51,na,1897,1547.144328596929
STAT,1923,27,30-34,1950,45.89936440101664
SIM,1882,26,25-29,1908,50
STAT,1907,36,40-44,1943,1.4220835697163137
SIM,1931,23,15-19,1954,6
STAT,1902,15,45-49,1917,0.0944125537400639
STAT,1923,23,15-19,1946,6.299991279721807
STAT,1918,15,35-39,1933,0.9394335488041625
SIM,1937,28,40-44,1965,2
SIM,1893,24,na,1917,3050
SIM,1927,28,30-34,1955,72
STAT,1793,105,na,1898,0.005873388558892374
SIM,1917,21,40-44,1938,9
SIM,1897,38,na,1935,3221
STAT,1848,51,20-24,1899,5.763536748652444E-4
SIM,1870,21,na,1891,2765
SIM,1919,0,na,1919,4787
STAT,1909,21,40-44,1930,3.1967225960569143
SIM,1926,33,35-39,1959,20
STAT,1818,55,na,1873,1247.0328919176234
SIM,1874,10,na,1884,2724
STAT,1887,49,na,1936,2518.6376578814084
STAT,1890,48,40-44,1938,0.11894309756566286
SIM,1867,30,15-19,1897,1
STAT,1807,53,25-29,1860,0.014340798303693548
STAT,1926,16,na,1942,4615.06429407625
STAT,1857,69,na,1926,1169.2195397711657
STAT,1929,28,40-44,1957,5.946894676024524
STAT,1841,42,50-100,1883,0.8105530182785637
STAT,1839,46,25-29,1885,0.041024740734382406
SIM,1926,15,35-39,1941,7
SIM,1822,60,na,1882,1060
SIM,1923,32,20-24,1955,1
STAT,1847,43,na,1890,1789.3151788691302
STAT,1919,28,30-34,1947,43.05100810840622
SIM,1845,33,45-49,1878,1
SIM,1891,48,45-49,1939,1
SIM,1945,24,20-24,1969,135
STAT,1857,18,25-29,1875,5.275178941560833
STAT,1848,33,20-24,1881,2.2067809653100117
STAT,1778,96,na,1874,0.9987173005999864
STAT,1815,108,na,1923,9.471392881125222E-4
STAT,1859,18,50-100,1877,0.046059377400695156
STAT,1918,33,35-39,1951,9.867815026610174
STAT,1841,42,20-24,1883,0.12184784167180907
STAT,1853,47,20-24,1900,0.010015075131069348
STAT,1779,101,na,1880,0.10984831518560079
STAT,1947,3,na,1950,4593.497403626059
SIM,1898,17,25-29,1915,12
STAT,1869,51,40-44,1920,0.010418381385143428
SIM,1876,76,na,1952,1005
STAT,1830,44,15-19,1874,0.011577010172122234
SIM,1872,87,na,1959,154
SIM,1778,78,na,1856,344
SIM,1865,18,25-29,1883,7
STAT,1774,82,na,1856,110.68933681000006
STAT,1904,46,50-100,1950,0.20312800863179475
STAT,1883,48,45-49,1931,0.2332596320511821
SIM,1827,45,45-49,1872,2
SIM,1841,42,25-29,1883,1
STAT,1849,16,25-29,1865,5.447427154239618
STAT,1871,45,15-19,1916,4.082393073584909E-4
STAT,1905,17,15-19,1922,8.743638111043424
STAT,1882,18,30-34,1900,1.579959538083544
STAT,1892,42,30-34,1934,1.4681122700883311
SIM,1827,96,na,1923,1
STAT,1870,17,na,1887,2542.6858641936665
STAT,1931,25,15-19,1956,0.9303245557322948
STAT,1890,31,50-100,1921,1.147537328212175
STAT,1879,37,15-19,1916,0.059880697799294856
STAT,1849,108,na,1957,0.0021823699621276857
SIM,1854,39,30-34,1893,5
STAT,1941,22,20-24,1963,117.23306222699212
SIM,1806,97,na,1903,2
SIM,1843,22,na,1865,2098
SIM,1900,25,40-44,1925,2
STAT,1917,23,40-44,1940,3.6355226934421956
STAT,1866,87,na,1953,165.78086436018944
STAT,1925,4,na,1929,4974.420832460063
STAT,1886,36,45-49,1922,2.162951606350964
STAT,1879,29,50-100,1908,0.6772638015767306
STAT,1921,21,40-44,1942,3.8870457468020576
STAT,1937,24,20-24,1961,110.37501652357935
STAT,1900,45,40-44,1945,0.13790793255073364
STAT,1889,34,20-24,1923,3.3770793694895653
SIM,1864,21,na,1885,2218
SIM,1897,34,20-24,1931,3
SIM,1890,18,30-34,1908,4
STAT,1900,24,25-29,1924,80.43570404240506
SIM,1911,47,na,1958,3577
STAT,1846,39,30-34,1885,3.8982613289878754
SIM,1859,31,30-34,1890,19
SIM,1894,36,45-49,1930,3
SIM,1930,37,40-44,1967,3
SIM,1904,29,40-44,1933,7
SIM,1858,20,25-29,1878,69
SIM,1862,40,40-44,1902,5
STAT,1824,47,30-34,1871,0.11281353666697162
STAT,1848,21,na,1869,2038.3360847822257
STAT,1931,31,na,1962,5057.076790197649
SIM,1858,51,na,1909,1813
STAT,1833,42,25-29,1875,0.5148507950150291
STAT,1868,33,45-49,1901,1.691953107705907
STAT,1884,68,na,1952,1542.383213708784
STAT,1888,28,50-100,1916,0.7687663271286163
STAT,1872,25,15-19,1897,0.4670260368068682
STAT,1927,27,15-19,1954,0.8754659756153766
SIM,1913,17,15-19,1930,6
STAT,1945,26,20-24,1971,20.441337654430445
STAT,1845,53,45-49,1898,0.01115716684506131
STAT,1863,69,na,1932,1312.6467095024982
STAT,1860,25,na,1885,2025.5065107011321
SIM,1818,82,na,1900,219
SIM,1945,19,35-39,1964,5
SIM,1867,65,na,1932,1437
SIM,1922,35,40-44,1957,6
SIM,1857,16,25-29,1873,5
STAT,1817,70,na,1887,770.3115343661514
STAT,1836,21,30-34,1857,14.738956610623582
SIM,1931,34,20-24,1965,3
STAT,1884,40,30-34,1924,1.1720484098852673
SIM,1953,18,30-34,1971,24
STAT,1945,18,30-34,1963,13.580213023479441
STAT,1784,96,na,1880,1.3326950669261504
STAT,1898,19,25-29,1917,7.775625048208965
STAT,1923,34,20-24,1957,2.8493604028552495
STAT,1856,53,20-24,1909,5.814404372929343E-4
STAT,1866,45,40-44,1911,0.1627001342424322
STAT,1780,82,na,1862,146.49842070374814
STAT,1800,97,na,1897,2.589247664015492
SIM,1828,30,40-44,1858,6
SIM,1816,39,45-49,1855,2
STAT,1937,19,35-39,1956,4.151537016812212
STAT,1889,15,50-100,1904,0.06202364203469914
SIM,1852,53,40-44,1905,1
SIM,1844,21,30-34,1865,24
STAT,1842,54,35-39,1896,0.006565608566302546
SIM,1918,31,35-39,1949,17
STAT,1914,35,40-44,1949,1.539461223448651
STAT,1938,16,15-19,1954,45.77964708369258
STAT,1856,40,50-100,1896,0.8545469190699683
STAT,1913,35,50-100,1948,0.4267059169382864
STAT,1854,37,15-19,1891,0.04297815314153595
SIM,1921,35,50-100,1956,3
SIM,1884,32,40-44,1916,11
STAT,1920,28,20-24,1948,20.362611710226606
STAT,1914,17,40-44,1931,0.29520507996878836
STAT,1868,40,35-39,1908,1.782201235459635
STAT,1901,47,15-19,1948,3.203828745344749E-4
STAT,1940,25,40-44,1965,4.853079623904393
STAT,1783,96,na,1879,1.6382040679561358
STAT,1848,54,25-29,1902,0.002677609310369185
SIM,1843,59,na,1902,1432
STAT,1842,92,na,1934,32.66166216799685
SIM,1908,28,na,1936,3833
STAT,1843,77,na,1920,697.8004508221312
STAT,1874,43,25-29,1917,0.6640146740109542
SIM,1922,17,40-44,1939,1
STAT,1882,43,20-24,1925,0.1567003869632508
STAT,1812,46,20-24,1858,0.028891121391606434
STAT,1925,31,na,1956,4584.7632087051325
STAT,1890,16,15-19,1906,7.4205643126722896
STAT,1940,32,30-34,1972,16.634812577187816
STAT,1833,22,20-24,1855,70.95838062605284
SIM,1841,22,20-24,1863,65
STAT,1866,52,30-34,1918,0.005571353676439377
SIM,1839,28,25-29,1867,49
SIM,1817,41,40-44,1858,4
SIM,1926,13,na,1939,5263
SIM,1948,5,na,1953,4571
STAT,1903,22,35-39,1925,8.462406942943442
SIM,1857,73,na,1930,807
STAT,1919,29,30-34,1948,42.89430243889162
SIM,1896,53,na,1949,2875
SIM,1882,43,25-29,1925,4
STAT,1865,65,na,1930,1564.7410745088164
STAT,1826,74,na,1900,647.273844916887
SIM,1925,23,40-44,1948,6
STAT,1876,32,40-44,1908,4.568424591255291
STAT,1897,25,15-19,1922,0.6230654604838037
STAT,1831,37,na,1868,1814.418653975895
SIM,1864,2,na,1866,3061
STAT,1819,45,45-49,1864,0.481353811742058
SIM,1879,50,na,1929,2698
STAT,1807,52,25-29,1859,0.014634940455131357
STAT,1825,96,na,1921,5.149099301037775
STAT,1953,17,15-19,1970,56.001440229163734
STAT,1920,46,20-24,1966,0.012497415727662445
STAT,1919,36,20-24,1955,0.2892584603483831
SIM,1927,29,30-34,1956,66
SIM,1946,16,15-19,1962,48
STAT,1842,47,45-49,1889,0.18510321122200324
STAT,1895,31,na,1926,3189.1861177729666
STAT,1927,45,45-49,1972,0.2796021795580149
STAT,1900,31,50-100,1931,1.3008194963052235
SIM,1945,26,25-29,1971,8
SIM,1878,72,na,1950,1365
STAT,1845,17,15-19,1862,5.8606912997992495
STAT,1938,34,15-19,1972,0.13163800352198482
SIM,1853,17,15-19,1870,8
STAT,1878,35,na,1913,2525.479958291405
SIM,1903,31,40-44,1934,15
STAT,1906,17,na,1923,3750.135510267078
STAT,1832,43,50-100,1875,0.8568626671097409
STAT,1906,43,35-39,1949,0.18536555634932755
SIM,1828,85,na,1913,192
SIM,1831,25,15-19,1856,1
SIM,1920,4,na,1924,4457
SIM,1887,18,25-29,1905,8
SIM,1877,30,50-100,1907,1
SIM,1918,17,na,1935,4180
STAT,1930,15,20-24,1945,179.59880016512506
SIM,1853,89,na,1942,77
SIM,1832,81,na,1913,213
SIM,1851,88,na,1939,19
SIM,1936,34,20-24,1970,3
STAT,1812,45,45-49,1857,0.5779991275885706
STAT,1934,31,40-44,1965,5.45197667590659
SIM,1834,34,35-39,1868,13
SIM,1877,93,na,1970,84
STAT,1877,21,30-34,1898,18.90382728702784
STAT,1858,52,na,1910,1732.6559940269578
SIM,1839,54,na,1893,1521
STAT,1855,48,20-24,1903,0.009185494965036478
SIM,1881,39,25-29,1920,5
STAT,1882,46,40-44,1928,0.17063480492529842
STAT,1911,48,na,1959,3537.8022111915657
STAT,1950,18,40-44,1968,1.6867107669228232
STAT,1952,17,50-100,1969,0.4580038621173308
STAT,1881,88,na,1969,356.3533985164476
SIM,1912,18,30-34,1930,3
STAT,1910,45,15-19,1955,3.521847361074628E-4
SIM,1823,37,25-29,1860,5
SIM,1889,40,45-49,1929,1
SIM,1885,22,30-34,1907,18
STAT,1880,17,20-24,1897,19.00551065571717
STAT,1867,23,50-100,1890,0.38934699414405155
STAT,1824,42,na,1866,1513.8834533951367
STAT,1826,41,40-44,1867,1.8761165594528637
SIM,1912,26,na,1938,3844
SIM,1938,31,na,1969,3810
SIM,1879,19,na,1898,3086
STAT,1882,28,25-29,1910,41.89441268865713
STAT,1896,28,50-100,1924,0.8588578858720078
STAT,1900,41,25-29,1941,0.0633371337568691
STAT,1918,30,30-34,1948,17.222180438771872
SIM,1860,31,40-44,1891,6
SIM,1875,28,45-49,1903,1
SIM,1892,25,40-44,1917,7
STAT,1829,42,20-24,1871,0.13326566903431875
SIM,1928,26,25-29,1954,96
STAT,1873,39,25-29,1912,2.947838161247219
SIM,1904,7,na,1911,4057
SIM,1858,21,50-100,1879,1
SIM,1909,22,40-44,1931,2
STAT,1893,25,35-39,1918,12.571843390415252
STAT,1844,32,45-49,1876,1.6159382334882173
SIM,1890,28,25-29,1918,87
SIM,1903,18,20-24,1921,31
SIM,1852,32,45-49,1884,2
STAT,1858,38,45-49,1896,1.6047468143783596
STAT,1883,53,na,1936,2120.6997635353964
STAT,1832,52,20-24,1884,5.153984980618084E-4
STAT,1871,20,50-100,1891,0.4145409696876653
SIM,1822,97,na,1919,2
STAT,1846,67,na,1913,1133.6237741072996
SIM,1854,21,na,1875,2164
STAT,1787,108,na,1895,8.331830738856419E-4
SIM,1832,39,50-100,1871,4
STAT,1920,44,45-49,1964,0.18695457892131911
STAT,1923,45,25-29,1968,0.06361190459813043
STAT,1854,51,45-49,1905,0.011160286554553957
STAT,1885,54,na,1939,2131.2434380825453
SIM,1823,45,na,1868,1542
SIM,1949,19,na,1968,4460
STAT,1826,34,35-39,1860,9.770160837752625
STAT,1854,86,na,1940,169.81396175163874
SIM,1928,11,na,1939,5230
STAT,1861,45,40-44,1906,0.14575493295657918
STAT,1896,16,na,1912,3411.241667431236
STAT,1935,37,15-19,1972,0.027384089952315886
SIM,1831,64,na,1895,1118
STAT,1842,19,40-44,1861,0.18202402413427546
STAT,1835,32,35-39,1867,9.610216679950378
SIM,1851,31,30-34,1882,22
STAT,1914,47,25-29,1961,0.05367562930910939
SIM,1926,30,30-34,1956,28
STAT,1855,32,20-24,1887,2.1335560976034644
SIM,1804,62,na,1866,1094
SIM,1863,32,20-24,1895,6
STAT,1867,27,45-49,1894,1.063372507071251
STAT,1871,49,30-34,1920,0.0957764027306464
SIM,1827,69,na,1896,836
SIM,1866,35,40-44,1901,3
SIM,1843,32,35-39,1875,15
STAT,1873,69,na,1942,1517.8061344327596
STAT,1920,20,45-49,1940,1.284133384900602
SIM,1910,20,40-44,1930,5
SIM,1907,43,40-44,1950,1
STAT,1808,93,na,1901,9.729415608248221
STAT,1857,43,25-29,1900,0.5079228212005111
STAT,1867,35,35-39,1902,6.838294298655092
SIM,1890,75,na,1965,1544
STAT,1922,37,50-100,1959,0.4874670593790697
STAT,1851,26,40-44,1877,2.9145836807891197
STAT,1855,34,na,1889,1844.830397831578
STAT,1873,46,15-19,1919,4.148740545367229E-4
SIM,1904,49,30-34,1953,1
STAT,1884,25,40-44,1909,3.043882100976442
STAT,1911,19,15-19,1930,9.21390020378978
SIM,1842,36,na,1878,1904
STAT,1902,29,50-100,1931,0.9137130881386716
STAT,1852,31,40-44,1883,3.6550303557890964
STAT,1899,39,45-49,1938,0.5950337242948711
SIM,1797,75,na,1872,313
SIM,1835,30,na,1865,1842
STAT,1853,50,30-34,1903,0.005062930645053702
STAT,1912,24,15-19,1936,5.389332430279999
SIM,1825,41,30-34,1866,1
SIM,1868,29,50-100,1897,1
SIM,1909,15,35-39,1924,1
STAT,1870,43,40-44,1913,2.226915101677758
SIM,1942,26,45-49,1968,3
STAT,1837,19,30-34,1856,1.511016450433534
SIM,1845,19,30-34,1864,7
STAT,1919,20,35-39,1939,10.584411672072195
SIM,1943,27,50-100,1970,1
STAT,1909,47,15-19,1956,3.452181629499721E-4
STAT,1821,52,45-49,1873,0.02196121464546671
STAT,1861,22,35-39,1883,5.053607931533988
SIM,1804,72,na,1876,731
STAT,1904,25,20-24,1929,17.26851991237243
SIM,1920,24,15-19,1944,10
STAT,1873,59,na,1932,2010.0269847217587
STAT,1803,52,40-44,1855,0.042523699087382336
STAT,1863,16,20-24,1879,18.201897654805414
SIM,1825,34,40-44,1859,1
SIM,1875,35,35-39,1910,14
STAT,1870,38,45-49,1908,1.9781693014025516
SIM,1924,26,40-44,1950,12
STAT,1849,45,40-44,1894,0.13423800892195475
STAT,1841,43,15-19,1884,0.010460584795187581
STAT,1930,15,na,1945,4875.955426839562
SIM,1898,32,50-100,1930,2
SIM,1856,22,na,1878,2387
STAT,1928,34,20-24,1962,3.106951078448426
STAT,1796,91,na,1887,18.9510842032881
SIM,1826,42,45-49,1868,1
SIM,1872,56,na,1928,2140
STAT,1830,48,30-34,1878,0.07930004814674907
STAT,1896,33,20-24,1929,3.6266063793586865
SIM,1811,47,45-49,1858,1
SIM,1848,21,15-19,1869,3
STAT,1847,15,50-100,1862,0.048249692100559245
STAT,1881,38,20-24,1919,0.7564998954297023
SIM,1907,29,45-49,1936,1
STAT,1846,19,25-29,1865,5.030842835432315
SIM,1929,18,40-44,1947,2
STAT,1889,78,na,1967,1385.4635034420453
STAT,1847,15,na,1862,2260.6682409429163
STAT,1895,17,50-100,1912,0.06520872682729452
STAT,1885,33,45-49,1918,1.7673354860852757
SIM,1902,29,50-100,1931,1
SIM,1892,32,30-34,1924,36
STAT,1895,5,na,1900,3488.0985516485516
STAT,1818,42,45-49,1860,3.8320939854604057
STAT,1884,32,30-34,1916,17.621789206343127
SIM,1855,49,25-29,1904,1
SIM,1880,75,na,1955,768
SIM,1925,34,45-49,1959,3
STAT,1893,73,na,1966,1861.3789913194332
STAT,1904,18,30-34,1922,2.324236555608691
SIM,1905,39,35-39,1944,4
SIM,1854,19,25-29,1873,1
STAT,1864,46,20-24,1910,0.010915892660521115
SIM,1951,13,na,1964,5311
STAT,1882,50,50-100,1932,0.015225976682738264
STAT,1917,34,45-49,1951,1.6671503655294098
SIM,1858,42,40-44,1900,1
SIM,1893,33,45-49,1926,6
STAT,1820,44,40-44,1864,4.219819649942116
STAT,1817,41,30-34,1858,3.009293763114351
STAT,1900,49,20-24,1949,0.009371189526314343
SIM,1822,43,50-100,1865,4
SIM,1868,24,35-39,1892,7
STAT,1916,26,40-44,1942,4.934943680963685
SIM,1909,34,na,1943,3467
STAT,1933,26,40-44,1959,6.31441693453533
STAT,1839,16,15-19,1855,5.389514221077322
STAT,1859,19,35-39,1878,0.5128266768939915
SIM,1894,34,50-100,1928,2
STAT,1903,26,15-19,1929,0.6602012756695804
STAT,1813,50,45-49,1863,0.03625584680689303
STAT,1790,72,na,1862,572.8355988847354
SIM,1888,37,50-100,1925,2
SIM,1884,33,35-39,1917,18
STAT,1894,47,45-49,1941,0.17387288178038707
STAT,1910,22,40-44,1932,3.2204552125351387
STAT,1913,23,20-24,1936,114.19449012444441
STAT,1882,44,15-19,1926,0.013540004254580665
STAT,1860,24,40-44,1884,1.7525799024213795
SIM,1889,22,15-19,1911,8
STAT,1830,50,45-49,1880,0.012109160107169264
SIM,1811,44,na,1855,1289
STAT,1905,15,25-29,1920,8.387834415281963
SIM,1904,23,20-24,1927,116
STAT,1876,30,15-19,1906,0.151222281552046
SIM,1893,30,40-44,1923,12
STAT,1804,50,35-39,1854,0.026305098107987826
STAT,1840,21,20-24,1861,63.51888701149098
STAT,1825,36,40-44,1861,6.930481931347191
SIM,1915,28,40-44,1943,9
STAT,1770,102,na,1872,0.051388621915204435
STAT,1938,15,20-24,1953,137.05823883131373
SIM,1841,88,na,1929,60
STAT,1805,75,na,1880,509.7794204482408
STAT,1838,17,25-29,1855,5.499703046833174
SIM,1880,85,na,1965,281
STAT,1814,47,20-24,1861,0.03577991697538458
SIM,1929,15,20-24,1944,211
SIM,1837,19,25-29,1856,6
SIM,1935,29,20-24,1964,1
STAT,1871,44,50-100,1915,1.0531604536527839
STAT,1934,26,45-49,1960,2.3711456867435077
STAT,1920,26,15-19,1946,0.7929981875917339
STAT,1913,49,30-34,1962,0.08824418318594901
STAT,1932,32,50-100,1964,1.1208890192773668
STAT,1926,35,50-100,1961,0.5243677877351641
SIM,1867,19,35-39,1886,1
STAT,1875,27,40-44,1902,3.1363873214185265
STAT,1902,20,40-44,1922,3.0157491639623806
SIM,1941,26,40-44,1967,1
STAT,1876,40,40-44,1916,2.393361901849532
STAT,1915,29,50-100,1944,1.0285880074247804
SIM,1867,93,na,1960,20
STAT,1880,41,45-49,1921,1.6117023131724604
STAT,1918,45,15-19,1963,4.019135718403469E-4
STAT,1924,28,40-44,1952,5.517432916808823
SIM,1822,81,na,1903,265
SIM,1912,25,20-24,1937,21
SIM,1847,16,15-19,1863,8
SIM,1814,62,na,1876,1003
SIM,1833,36,40-44,1869,13
STAT,1927,29,20-24,1956,22.545861948655496
SIM,1898,20,15-19,1918,9
STAT,1810,66,na,1876,789.8938926265997
STAT,1929,42,25-29,1971,0.09432158973663214
STAT,1828,37,20-24,1865,0.6757968511787124
STAT,1804,52,45-49,1856,0.04256720593255242
SIM,1852,36,na,1888,2032
STAT,1838,32,na,1870,1978.712685139291
SIM,1817,69,na,1886,674
SIM,1927,20,35-39,1947,15
STAT,1875,54,na,1929,2192.395290464963
STAT,1911,4,na,1915,4106.390583799579
STAT,1925,24,na,1949,4431.757841372697
STAT,1824,53,25-29,1877,0.0039042060494293715
STAT,1810,48,15-19,1858,0.0012355986461445641
STAT,1895,28,20-24,1923,15.559726375776421
SIM,1921,23,20-24,1944,163
STAT,1821,50,35-39,1871,0.013557912524537166
SIM,1867,33,35-39,1900,13
STAT,1871,43,45-49,1914,1.5014665824177769
SIM,1932,28,40-44,1960,9
SIM,1918,11,na,1929,4573
SIM,1833,69,na,1902,975
STAT,1865,51,20-24,1916,6.865106992130847E-4
STAT,1891,44,25-29,1935,0.8000954517828641
STAT,1778,78,na,1856,190.28304452699996
SIM,1901,22,40-44,1923,3
SIM,1883,27,40-44,1910,4
SIM,1861,19,na,1880,2820
SIM,1909,44,na,1953,3364
STAT,1874,17,na,1891,2630.575002076755
SIM,1828,29,25-29,1857,6
STAT,1869,22,35-39,1891,5.7474135235218435
STAT,1870,22,45-49,1892,0.6954127926883221
STAT,1885,49,45-49,1934,0.23518069053454738
SIM,1884,40,40-44,1924,6
SIM,1810,96,na,1906,28
STAT,1951,18,50-100,1969,0.45498641231724024
SIM,1844,37,na,1881,2015
SIM,1906,38,40-44,1944,4
STAT,1834,34,40-44,1868,3.6614489423462997
STAT,1908,41,40-44,1949,0.23733625957996518
STAT,1788,108,na,1896,6.065777504942801E-4
STAT,1807,51,50-100,1858,0.06368171225091852
SIM,1911,44,45-49,1955,2
STAT,1907,28,40-44,1935,4.471221806655916
SIM,1888,27,na,1915,2724
STAT,1843,31,30-34,1874,17.121471154201146
STAT,1786,97,na,1883,0.8145026082327655
STAT,1848,86,na,1934,172.47170448742565
STAT,1865,18,50-100,1883,0.046469100245296165
STAT,1881,22,20-24,1903,67.96683552784047
SIM,1893,23,35-39,1916,8
STAT,1823,45,20-24,1868,0.018558794167286126
STAT,1871,41,35-39,1912,1.838151663018285
STAT,1881,54,25-29,1935,0.0033973408765066754
STAT,1943,24,45-49,1967,1.2205183587627364
SIM,1931,29,35-39,1960,30
SIM,1869,29,na,1898,2335
SIM,1911,26,15-19,1937,1
STAT,1858,21,50-100,1879,0.3812575419249801
SIM,1902,30,45-49,1932,7
STAT,1908,36,45-49,1944,0.6539900999676398
STAT,1846,57,na,1903,1437.1308675229077
SIM,1859,74,na,1933,932
STAT,1890,36,20-24,1926,0.9661360223869446
SIM,1826,32,35-39,1858,12
SIM,1862,27,20-24,1889,15
SIM,1831,29,30-34,1860,25
STAT,1899,43,30-34,1942,0.11072187391662357
STAT,1866,71,na,1937,1256.0075786095072
STAT,1922,39,30-34,1961,2.111568399411535
STAT,1923,29,35-39,1952,17.461523680898097
STAT,1850,43,25-29,1893,0.4795442958094736
STAT,1909,7,na,1916,3984.7858092924444
SIM,1950,16,40-44,1966,2
STAT,1953,19,20-24,1972,167.18337227223859
STAT,1841,58,na,1899,1460.1643734998975
STAT,1866,37,40-44,1903,4.119099623645162
STAT,1942,16,40-44,1958,1.491718312654883
STAT,1854,27,20-24,1881,9.412626117604766
SIM,1851,24,40-44,1875,3
SIM,1924,11,na,1935,4914
SIM,1853,73,na,1926,979
SIM,1863,17,25-29,1880,6
STAT,1855,17,25-29,1872,5.224842783439188
STAT,1862,53,45-49,1915,0.012400232870649385
STAT,1865,44,15-19,1909,0.012613965749421596
SIM,1874,41,na,1915,2389
SIM,1946,15,20-24,1961,150
STAT,1840,45,20-24,1885,0.008933894740776075
STAT,1843,24,40-44,1867,2.0812961765451066
SIM,1898,46,40-44,1944,1
STAT,1940,21,25-29,1961,96.0257332438403
SIM,1864,38,25-29,1902,3
STAT,1823,94,na,1917,11.123308786127247
STAT,1876,33,35-39,1909,10.623129322186232
SIM,1843,21,50-100,1864,4
STAT,1860,31,30-34,1891,14.510715608378625
STAT,1853,39,na,1892,1955.6013962485094
STAT,1927,35,15-19,1962,0.024397050430238546
SIM,1858,27,45-49,1885,1
SIM,1892,28,45-49,1920,2
STAT,1872,48,20-24,1920,0.012114993913464371
STAT,1815,75,na,1890,532.3095569862392
SIM,1882,70,na,1952,1194
STAT,1935,24,na,1959,5067.856509883162
STAT,1944,26,50-100,1970,1.0980667417078647
STAT,1850,40,20-24,1890,0.12066532358372976
SIM,1838,37,na,1875,1690
SIM,1877,38,20-24,1915,1
STAT,1911,30,45-49,1941,1.575554147123059
STAT,1914,31,25-29,1945,9.531201577554894
SIM,1835,31,30-34,1866,22
STAT,1856,38,25-29,1894,2.294235047782681
SIM,1881,36,20-24,1917,4
SIM,1851,34,35-39,1885,12
STAT,1891,19,50-100,1910,0.06154481006204391
STAT,1851,49,15-19,1900,3.231163868835256E-4
SIM,1865,37,50-100,1902,5
STAT,1894,22,30-34,1916,23.373602291645664
STAT,1934,34,45-49,1968,2.188178630410637
SIM,1868,21,30-34,1889,24
STAT,1924,34,35-39,1958,10.86341744912962
STAT,1932,10,na,1942,5366.830100872412
SIM,1862,56,na,1918,1838
SIM,1930,30,20-24,1960,7
SIM,1907,49,na,1956,3406
STAT,1846,42,20-24,1888,0.11494555152173387
STAT,1898,40,45-49,1938,0.14482327950871995
STAT,1932,7,na,1939,5397.9707408923705
SIM,1916,33,40-44,1949,6
STAT,1936,19,20-24,1955,131.6778446860194
STAT,1840,46,35-39,1886,0.10290193594676722
SIM,1869,23,40-44,1892,1
SIM,1834,31,30-34,1865,7
SIM,1848,21,na,1869,2065
STAT,1812,61,na,1873,1064.0283238645093
STAT,1869,38,20-24,1907,0.7554498595712897
STAT,1831,108,na,1939,0.0012342541743272705
SIM,1865,21,15-19,1886,7
STAT,1884,28,45-49,1912,1.116665090957355
STAT,1912,51,na,1963,3555.8518897360377
STAT,1916,43,40-44,1959,0.2611582326716139
STAT,1834,41,30-34,1875,0.9447273690901209
SIM,1934,24,45-49,1958,2
STAT,1881,24,na,1905,2317.991553641365
SIM,1792,66,na,1858,740
SIM,1885,21,50-100,1906,4
STAT,1908,12,na,1920,3906.430029735414
STAT,1893,22,30-34,1915,23.051703225259857
STAT,1877,54,35-39,1931,0.008858629769220548
STAT,1831,53,30-34,1884,0.004198475761206293
STAT,1881,46,20-24,1927,0.011868931984733854
STAT,1925,36,45-49,1961,0.8355393643408378
SIM,1811,44,40-44,1855,4
SIM,1944,19,20-24,1963,133
STAT,1921,18,30-34,1939,14.140424363470705
STAT,1898,44,25-29,1942,0.06068759275681719
STAT,1903,44,45-49,1947,0.14868089773790585
STAT,1812,42,40-44,1854,6.490104661915076
STAT,1811,54,40-44,1865,0.02676290608553602
SIM,1833,26,50-100,1859,1
STAT,1800,76,na,1876,460.6041288150043
STAT,1840,102,na,1942,0.21096812060167214
STAT,1899,36,40-44,1935,6.144671761699354
STAT,1920,41,40-44,1961,0.2823154647978445
STAT,1855,53,50-100,1908,0.011519646922712418
STAT,1922,30,20-24,1952,2.834666166095187
SIM,1908,34,45-49,1942,2
SIM,1870,36,45-49,1906,7
STAT,1865,34,na,1899,2190.575365221747
SIM,1842,34,40-44,1876,9
STAT,1922,47,30-34,1969,0.10449654481064259
SIM,1820,42,40-44,1862,3
STAT,1866,9,na,1875,2585.7925959780337
STAT,1827,60,na,1887,1289.7220608853465
STAT,1873,36,20-24,1909,0.8010873484076219
STAT,1857,21,15-19,1878,3.05627469062317
SIM,1842,41,30-34,1883,2
SIM,1847,89,na,1936,43
SIM,1889,19,na,1908,3270
STAT,1884,35,35-39,1919,7.206372592793882
SIM,1866,38,45-49,1904,3
SIM,1825,44,35-39,1869,3
SIM,1922,16,na,1938,4361
STAT,1912,42,45-49,1954,0.16374660903442056
STAT,1926,24,45-49,1950,1.3857749412458764
STAT,1864,49,25-29,1913,0.051157043576439944
SIM,1802,67,na,1869,714
SIM,1875,40,30-34,1915,2
STAT,1881,47,35-39,1928,0.13743510599992326
STAT,1824,50,20-24,1874,8.632808336187464E-4
SIM,1875,32,30-34,1907,4
STAT,1826,31,30-34,1857,20.5346145462086
STAT,1885,30,40-44,1915,4.449296987693326
SIM,1932,34,35-39,1966,21
STAT,1844,53,40-44,1897,0.008027010092020084
SIM,1837,89,na,1926,96
SIM,1850,32,25-29,1882,10
STAT,1817,44,35-39,1861,4.207516652568846
STAT,1846,16,20-24,1862,16.020563294771033
SIM,1827,90,na,1917,32
STAT,1879,78,na,1957,914.2298301500736
SIM,1836,37,20-24,1873,1
SIM,1845,54,na,1899,1645
STAT,1938,18,40-44,1956,1.407023121682665
STAT,1928,18,30-34,1946,15.624630669304834
SIM,1789,84,na,1873,56
STAT,1830,42,na,1872,1622.0434826722615
SIM,1861,21,30-34,1882,38
STAT,1858,35,40-44,1893,3.5750667714475344
STAT,1865,54,25-29,1919,0.0031893740250911067
STAT,1867,40,30-34,1907,1.112183953280562
SIM,1816,44,40-44,1860,3
SIM,1883,31,25-29,1914,16
SIM,1872,49,25-29,1921,1
STAT,1870,35,40-44,1905,4.4069801381605505
SIM,1892,35,35-39,1927,14
SIM,1922,31,25-29,1953,1
STAT,1885,40,35-39,1925,1.8616044808969487
STAT,1875,35,40-44,1910,4.6268201667742925
STAT,1891,41,20-24,1932,0.20148811123582946
STAT,1906,45,25-29,1951,0.04872539106335852
SIM,1901,25,45-49,1926,2
STAT,1876,17,45-49,1893,0.06881264615147856
SIM,1920,42,45-49,1962,1
STAT,1892,27,40-44,1919,3.830013831793492
STAT,1891,54,na,1945,2644.7358535940966
STAT,1858,112,na,1970,3.3554514210876033E-4
STAT,1918,37,15-19,1955,0.02065523616098544
STAT,1853,21,30-34,1874,17.77463374477195
STAT,1928,37,25-29,1965,1.2692478429470178
SIM,1772,83,na,1855,114
SIM,1870,85,na,1955,207
STAT,1842,32,25-29,1874,9.70321433643868
STAT,1875,31,25-29,1906,10.76794138695954
SIM,1827,47,50-100,1874,1
SIM,1861,43,40-44,1904,8
STAT,1831,47,20-24,1878,0.009814224038137006
STAT,1857,112,na,1969,2.820267054088274E-4
STAT,1863,41,45-49,1904,1.3447295608437586
SIM,1918,29,20-24,1947,2
STAT,1840,53,25-29,1893,0.0025079010837440676
SIM,1871,41,45-49,1912,1
SIM,1885,84,na,1969,631
STAT,1921,25,20-24,1946,20.900680718707736
STAT,1941,28,40-44,1969,4.916782958991271
SIM,1882,18,na,1900,2445
SIM,1883,35,40-44,1918,13
SIM,1875,25,40-44,1900,3
SIM,1925,36,50-100,1961,1
STAT,1882,36,na,1918,2352.821126045647
STAT,1920,25,na,1945,4222.116823143945
STAT,1933,18,40-44,1951,1.904488953896962
SIM,1888,17,15-19,1905,12
STAT,1862,20,na,1882,2132.9802936620576
SIM,1897,48,na,1945,2989
STAT,1819,47,50-100,1866,0.4865687514474565
STAT,1935,30,30-34,1965,22.253877730890693
STAT,1934,35,na,1969,5303.694216129473
SIM,1941,18,40-44,1959,3
STAT,1871,51,45-49,1922,0.014735319013447924
STAT,1875,42,30-34,1917,1.202232919395965
SIM,1871,19,25-29,1890,7
STAT,1853,22,50-100,1875,0.4040067259238072
STAT,1872,54,30-34,1926,0.005918700384531505
STAT,1841,45,50-100,1886,0.1868894164673287
STAT,1913,26,25-29,1939,67.13572483594797
SIM,1813,41,50-100,1854,2
SIM,1905,9,na,1914,3767
SIM,1875,42,40-44,1917,5
STAT,1859,16,30-34,1875,1.5162744935435664
SIM,1824,42,25-29,1866,1
SIM,1866,22,na,1888,2348
SIM,1857,45,40-44,1902,1
STAT,1873,53,20-24,1926,7.509389377141412E-4
STAT,1861,72,na,1933,1064.580296792117
STAT,1883,33,25-29,1916,10.209227394992807
STAT,1873,53,na,1926,2191.1573133462743
STAT,1886,30,25-29,1916,11.148990658909058
SIM,1891,33,25-29,1924,19
STAT,1948,24,50-100,1972,0.770286708105819
SIM,1867,16,30-34,1883,3
SIM,1829,54,na,1883,1155
SIM,1870,43,35-39,1913,4
SIM,1936,18,30-34,1954,16
STAT,1862,43,35-39,1905,1.5611512787875077
STAT,1877,47,45-49,1924,0.24854413463916636
SIM,1779,84,na,1863,56
SIM,1782,83,na,1865,66
STAT,1906,27,na,1933,3543.6188722603624
STAT,1843,27,45-49,1870,1.1030790398175188
STAT,1864,86,na,1950,201.25996176191643
SIM,1854,16,20-24,1870,21
STAT,1903,13,na,1916,3739.258606148771
SIM,1851,27,45-49,1878,2
SIM,1939,15,30-34,1954,22
STAT,1908,44,45-49,1952,0.15508723171912583
SIM,1944,7,na,1951,4311
STAT,1802,61,na,1863,854.2772702530001
STAT,1863,19,25-29,1882,5.201409253299424
STAT,1870,46,45-49,1916,0.2360222103449545
STAT,1939,25,50-100,1964,1.0216580657544418
SIM,1842,30,25-29,1872,17
SIM,1883,42,30-34,1925,2
STAT,1817,60,na,1877,1118.407269052971
STAT,1896,26,na,1922,3226.525028862777
SIM,1942,23,40-44,1965,5
STAT,1808,51,30-34,1859,0.014507326637295617
STAT,1927,15,45-49,1942,0.6365328404298932
SIM,1815,39,40-44,1854,2
SIM,1868,7,na,1875,2741
STAT,1871,5,na,1876,2810.3578760223236
SIM,1922,37,30-34,1959,4
STAT,1825,58,na,1883,1270.4373159714548
STAT,1873,28,50-100,1901,0.6592727483548418
STAT,1934,23,40-44,1957,4.606561962318623
SIM,1883,28,50-100,1911,1
STAT,1936,29,30-34,1965,38.20838372202423
STAT,1946,16,25-29,1962,49.052846291908
SIM,1812,91,na,1903,16
SIM,1876,32,30-34,1908,4
SIM,1848,37,na,1885,1931
SIM,1918,20,50-100,1938,1
STAT,1899,46,35-39,1945,0.1106342367976228
STAT,1921,26,50-100,1947,1.1358768764845093
STAT,1867,42,40-44,1909,2.1515506186244964
STAT,1868,32,30-34,1900,17.012178574355207
SIM,1899,28,45-49,1927,2
STAT,1914,37,30-34,1951,1.8566499943699444
STAT,1841,27,25-29,1868,38.79334759424769
STAT,1834,30,25-29,1864,9.014480919358666
STAT,1925,19,45-49,1944,0.6123597348307558
SIM,1927,36,50-100,1963,1
SIM,1954,16,25-29,1970,63
STAT,1831,58,na,1889,1335.7412081546772
STAT,1833,29,40-44,1862,2.5890823946682575
SIM,1906,34,25-29,1940,9
STAT,1841,17,50-100,1858,0.04665403703279861
STAT,1888,52,na,1940,2583.0106150527427
STAT,1918,12,na,1930,4401.012588201866
STAT,1885,46,40-44,1931,0.17473843976752954
STAT,1817,37,45-49,1854,7.050745692800719
STAT,1821,75,na,1896,542.4639751658964
STAT,1858,86,na,1944,179.4995344288679
STAT,1886,20,50-100,1906,0.44296431967026645
STAT,1801,105,na,1906,0.010461562198979622
STAT,1900,70,na,1970,2365.83315547849
STAT,1849,52,30-34,1901,0.004596722848494035
STAT,1821,35,45-49,1856,4.86588011075784
STAT,1890,46,15-19,1936,2.8223957155720667E-4
STAT,1936,36,20-24,1972,0.2641924111194037
SIM,1851,19,na,1870,2203
SIM,1918,39,30-34,1957,3
STAT,1926,10,na,1936,4970.8644828270135
STAT,1894,21,na,1915,3112.8294659890457
STAT,1859,43,45-49,1902,1.2105269425126506
SIM,1892,60,na,1952,2727
SIM,1852,48,45-49,1900,1
SIM,1935,31,35-39,1966,27
SIM,1838,48,25-29,1886,1
STAT,1816,42,25-29,1858,1.5234732244004607
STAT,1856,57,na,1913,1609.3195380148013
STAT,1887,17,20-24,1904,20.266076167047096
STAT,1944,27,15-19,1971,0.7784545985407553
SIM,1941,29,45-49,1970,2
STAT,1827,31,30-34,1858,28.37535246874452
SIM,1867,43,45-49,1910,6
STAT,1908,33,40-44,1941,3.7508166097760025
SIM,1820,96,na,1916,6
SIM,1928,19,35-39,1947,7
SIM,1921,26,25-29,1947,97
STAT,1893,30,30-34,1923,22.777056819484947
SIM,1841,29,40-44,1870,4
STAT,1893,32,40-44,1925,5.612346322035034
STAT,1914,44,20-24,1958,0.017795038924788016
STAT,1890,39,25-29,1929,3.5551836405967823
STAT,1926,41,45-49,1967,0.20961117513524388
STAT,1871,40,40-44,1911,2.295883509333627
STAT,1764,102,na,1866,0.1335448089941792
STAT,1901,15,40-44,1916,0.2621379922765616
SIM,1936,30,na,1966,3323
SIM,1887,26,50-100,1913,1
SIM,1904,35,na,1939,3728
STAT,1933,29,45-49,1962,2.337064468699043
SIM,1849,74,na,1923,1029
STAT,1885,20,30-34,1905,18.237131775266704
SIM,1828,26,20-24,1854,12
SIM,1834,41,40-44,1875,2
SIM,1867,35,na,1902,2169
SIM,1923,4,na,1927,4652
SIM,1919,34,na,1953,4174
STAT,1927,31,35-39,1958,11.473622490355458
STAT,1859,50,35-39,1909,0.007114722452317969
SIM,1893,20,30-34,1913,2
STAT,1876,71,na,1947,1406.1181890104401
SIM,1854,37,na,1891,2022
SIM,1859,32,50-100,1891,5
STAT,1821,42,35-39,1863,3.1420146317195994
SIM,1929,18,25-29,1947,78
SIM,1866,18,na,1884,2575
STAT,1926,41,na,1967,4677.531964175366
STAT,1823,48,25-29,1871,0.0853744807683102
SIM,1850,62,na,1912,1359
STAT,1843,34,35-39,1877,9.626285239142618
STAT,1897,39,25-29,1936,0.8391482215269492
SIM,1852,31,30-34,1883,7
SIM,1873,35,na,1908,2386
SIM,1899,40,na,1939,3253
SIM,1840,19,30-34,1859,2
STAT,1869,52,35-39,1921,0.008433996196886935
STAT,1921,32,45-49,1953,1.7869342919558162
STAT,1840,35,na,1875,1861.1615224957638
STAT,1763,102,na,1865,0.028453866721675904
STAT,1903,41,40-44,1944,0.22753238773398085
STAT,1906,42,20-24,1948,0.016355167664307668
STAT,1941,14,na,1955,4126.2969013265465
STAT,1838,93,na,1931,21.473420932759343
STAT,1783,86,na,1869,72.55294009577607
SIM,1920,20,35-39,1940,20
SIM,1837,20,40-44,1857,3
SIM,1883,55,na,1938,2188
STAT,1876,50,35-39,1926,0.009199361778548288
SIM,1919,31,50-100,1950,1
SIM,1913,30,50-100,1943,2
STAT,1949,20,30-34,1969,34.23969764237136
STAT,1931,31,25-29,1962,12.358549672315679
SIM,1908,31,40-44,1939,8
STAT,1839,38,25-29,1877,2.3500359377776423
STAT,1883,37,40-44,1920,4.381729014631742
STAT,1808,47,45-49,1855,0.6257744140243255
STAT,1802,95,na,1897,4.21874745396677
STAT,1874,21,15-19,1895,3.4465115815481933
SIM,1891,37,40-44,1928,11
STAT,1860,20,25-29,1880,54.45511652969668
STAT,1860,34,35-39,1894,8.310550856572673
SIM,1870,33,40-44,1903,5
STAT,1879,26,50-100,1905,0.684480099919921
SIM,1891,16,25-29,1907,7
STAT,1913,45,30-34,1958,0.08918224404373819
STAT,1839,24,15-19,1863,2.883565358687839
STAT,1897,17,15-19,1914,8.094944390929564
SIM,1906,64,na,1970,2781
STAT,1816,46,40-44,1862,0.3578023331178217
STAT,1814,53,30-34,1867,0.016644198798123528
STAT,1892,23,25-29,1915,72.96589373844704
STAT,1844,31,30-34,1875,16.34817811017546
STAT,1869,85,na,1954,269.9973117637279
STAT,1913,45,15-19,1958,3.6852135907703364E-4
SIM,1889,1,na,1890,3446
STAT,1840,48,25-29,1888,0.04126576204906175
STAT,1945,14,na,1959,4376.345557063109
STAT,1872,32,20-24,1904,2.7636874103868276
STAT,1922,45,40-44,1967,0.18568190107565333
STAT,1824,39,50-100,1863,1.5848703669860607
STAT,1891,42,50-100,1933,1.3326538183718377
SIM,1944,25,15-19,1969,1
SIM,1887,55,na,1942,2462
SIM,1941,24,35-39,1965,13
STAT,1841,102,na,1943,0.2164665349325408
STAT,1936,25,15-19,1961,0.6896827491422897
STAT,1924,24,25-29,1948,110.50581146254262
STAT,1933,3,na,1936,5537.242416716989
SIM,1932,24,25-29,1956,164
STAT,1825,32,25-29,1857,20.306211461726438
STAT,1834,44,35-39,1878,1.4319095243956763
SIM,1875,43,35-39,1918,1
STAT,1830,26,20-24,1856,14.437548622852248
SIM,1871,39,30-34,1910,4
STAT,1846,26,na,1872,1885.0242139252978
SIM,1902,64,na,1966,2690
STAT,1861,50,50-100,1911,0.012914089991247001
STAT,1856,20,na,1876,2017.4501985163326
SIM,1782,76,na,1858,363
STAT,1853,43,40-44,1896,1.872390687296435
SIM,1833,32,25-29,1865,15
SIM,1906,30,na,1936,3622
STAT,1932,32,20-24,1964,3.3067869792515254
SIM,1798,61,na,1859,947
SIM,1927,25,na,1952,4546
STAT,1827,53,na,1880,1481.4453810281263
SIM,1906,5,na,1911,3897
STAT,1867,43,35-39,1910,1.721745770323711
SIM,1851,44,45-49,1895,3
STAT,1798,102,na,1900,0.1009191159385785
STAT,1864,48,na,1912,2015.1481645323165
SIM,1851,23,na,1874,2027
STAT,1858,52,40-44,1910,0.00847160909658914
SIM,1769,94,na,1863,5
STAT,1851,75,na,1926,849.3241060195243
STAT,1912,28,30-34,1940,39.251254335539784
SIM,1884,43,45-49,1927,6
STAT,1814,80,na,1894,288.2579539824998
STAT,1926,40,30-34,1966,0.16123063345110383
STAT,1848,90,na,1938,61.28538335704802
SIM,1930,38,35-39,1968,4
STAT,1840,50,20-24,1890,5.386360451565972E-4
SIM,1862,94,na,1956,19
SIM,1883,38,45-49,1921,3
SIM,1913,49,na,1962,3744
STAT,1848,31,15-19,1879,0.1304412461825905
STAT,1926,21,40-44,1947,4.179785362743468
STAT,1922,38,35-39,1960,2.805419862849778
SIM,1813,83,na,1896,145
STAT,1773,105,na,1878,0.020323809907406586
SIM,1937,18,15-19,1955,52
STAT,1919,47,25-29,1966,0.058712773271098584
SIM,1794,61,na,1855,1000
STAT,1851,22,25-29,1873,56.40018941769823
STAT,1876,43,45-49,1919,1.5652157004699019
STAT,1912,20,35-39,1932,9.260352698898224
SIM,1880,32,20-24,1912,2
STAT,1827,53,40-44,1880,0.01118270613963764
STAT,1904,33,20-24,1937,2.259690835695473
SIM,1882,18,25-29,1900,9
SIM,1920,27,50-100,1947,4
STAT,1904,47,30-34,1951,0.07946137462349241
STAT,1843,44,45-49,1887,1.212505600927291
STAT,1875,38,45-49,1913,2.0768493004471322
STAT,1894,44,40-44,1938,0.2021944533210936
SIM,1813,41,20-24,1854,1
SIM,1912,33,20-24,1945,1
SIM,1837,80,na,1917,465
STAT,1837,52,20-24,1889,4.937867178520765E-4
STAT,1870,21,30-34,1891,17.817155162010277
STAT,1880,36,50-100,1916,1.3225114290419004
STAT,1840,43,30-34,1883,0.8520074616151502
STAT,1882,27,50-100,1909,0.6357754413695441
SIM,1861,39,50-100,1900,2
SIM,1807,76,na,1883,285
SIM,1895,74,na,1969,1910
STAT,1834,25,50-100,1859,0.5726800903206554
STAT,1846,51,50-100,1897,0.010851980236444733
SIM,1915,34,35-39,1949,14
STAT,1840,32,na,1872,1899.5216913953204
STAT,1852,20,na,1872,2075.9280520785783
STAT,1882,67,na,1949,1575.5112687778628
STAT,1916,47,na,1963,3845.3110649184873
SIM,1919,18,30-34,1937,20
SIM,1934,21,40-44,1955,7
STAT,1891,15,20-24,1906,22.495130927068466
STAT,1842,36,40-44,1878,4.069034410987743
STAT,1837,53,na,1890,1412.524390322242
STAT,1853,39,20-24,1892,0.6398504961161429
SIM,1920,28,30-34,1948,65
STAT,1895,37,na,1932,3135.8314006618325
SIM,1921,37,na,1958,4907
STAT,1795,71,na,1866,538.6429918068051
STAT,1907,34,35-39,1941,8.635582347383727
STAT,1833,60,na,1893,1252.4366965810455
STAT,1874,48,na,1922,2313.904074002391
SIM,1894,38,20-24,1932,1
SIM,1816,47,45-49,1863,1
SIM,1782,73,na,1855,446
SIM,1850,36,40-44,1886,7
STAT,1935,27,50-100,1962,1.3836587290522986
STAT,1886,38,20-24,1924,0.8282433916936728
STAT,1905,41,25-29,1946,0.06599769354016877
STAT,1865,28,25-29,1893,39.029137422026665
STAT,1863,35,15-19,1898,0.05070456158297752
SIM,1868,88,na,1956,101
SIM,1889,44,25-29,1933,2
STAT,1819,47,20-24,1866,0.023773718438696433
STAT,1839,15,50-100,1854,0.0447560163247953
STAT,1862,40,30-34,1902,1.0084458639816782
STAT,1918,39,20-24,1957,0.28293640484286625
SIM,1849,16,na,1865,2203
SIM,1868,82,na,1950,455
STAT,1930,23,20-24,1953,144.8354932192193
STAT,1873,16,15-19,1889,6.174172538103729
STAT,1887,43,20-24,1930,0.1802330423491854
STAT,1808,54,35-39,1862,0.019699824174435967
SIM,1834,42,35-39,1876,8
STAT,1937,18,50-100,1955,0.3708026601838532
SIM,1850,15,25-29,1865,8
SIM,1858,40,30-34,1898,4
STAT,1954,0,na,1954,5356.299307129941
SIM,1887,48,na,1935,2651
STAT,1884,45,45-49,1929,0.24056535582414054
STAT,1879,15,20-24,1894,18.99274309242998
STAT,1893,33,35-39,1926,13.050599739349558
SIM,1889,40,na,1929,3063
STAT,1929,18,15-19,1947,58.918695036939056
SIM,1946,18,40-44,1964,5
STAT,1850,35,na,1885,1838.0181428091198
STAT,1845,37,20-24,1882,0.6328315402570266
STAT,1895,40,50-100,1935,1.4203375775372282
STAT,1898,22,15-19,1920,4.551176592553185
STAT,1910,25,45-49,1935,1.7275769296728463
SIM,1843,42,45-49,1885,2
SIM,1890,37,na,1927,3080
SIM,1848,68,na,1916,1138
SIM,1837,90,na,1927,61
SIM,1821,40,35-39,1861,2
SIM,1881,16,15-19,1897,4
SIM,1843,80,na,1923,397
STAT,1840,42,na,1882,1734.9218901154752
STAT,1846,20,na,1866,1913.9877609523967
STAT,1833,54,50-100,1887,0.009895620671541457
STAT,1815,68,na,1883,921.2348117727646
STAT,1912,35,20-24,1947,0.2649574287038157
SIM,1909,45,50-100,1954,1
SIM,1879,29,na,1908,2862
STAT,1878,46,15-19,1924,4.2595006168038544E-4
SIM,1899,43,na,1942,3201
SIM,1944,21,50-100,1965,1
STAT,1880,31,35-39,1911,10.900881239111795
SIM,1857,48,45-49,1905,1
STAT,1862,47,15-19,1909,3.457403117449062E-4
STAT,1920,22,na,1942,4142.992838248248
STAT,1927,22,50-100,1949,0.8269617168547003
SIM,1866,0,na,1866,3544
STAT,1890,30,15-19,1920,0.17905815871511385
SIM,1907,46,45-49,1953,1
STAT,1842,53,50-100,1895,0.011653483289135708
STAT,1820,80,na,1900,340.69470123396275
SIM,1914,29,35-39,1943,21
SIM,1907,32,35-39,1939,3
STAT,1820,105,na,1925,0.016148492010299366
STAT,1863,39,30-34,1902,4.719071790513293
SIM,1905,17,25-29,1922,10
STAT,1858,45,35-39,1903,0.1143902382432984
STAT,1906,29,35-39,1935,14.224771351465288
SIM,1919,37,na,1956,4193
STAT,1822,48,50-100,1870,0.34509377380537576
SIM,1885,44,40-44,1929,8
SIM,1874,30,20-24,1904,5
STAT,1812,50,45-49,1862,0.03410190279319175
STAT,1871,27,20-24,1898,11.854920482361436
SIM,1868,41,na,1909,2331
STAT,1842,15,25-29,1857,5.774340312481665
STAT,1877,44,40-44,1921,2.3478026466023034
SIM,1903,28,30-34,1931,45
STAT,1832,51,25-29,1883,0.0025233990870652733
SIM,1877,55,na,1932,2103
STAT,1915,19,35-39,1934,0.8913806998510027
STAT,1909,40,30-34,1949,0.1233369425499679
STAT,1877,51,30-34,1928,0.00632844408421438
STAT,1844,93,na,1937,22.64709031468608
STAT,1900,45,50-100,1945,0.19783988440259576
SIM,1831,95,na,1926,6
SIM,1862,41,35-39,1903,4
SIM,1856,56,na,1912,1972
STAT,1852,33,30-34,1885,14.412787289604987
STAT,1878,53,20-24,1931,7.709869618015086E-4
STAT,1906,46,50-100,1952,0.20629287186298875
STAT,1925,16,40-44,1941,1.7280861522649515
STAT,1865,92,na,1957,49.60376412035068
STAT,1827,49,20-24,1876,0.013118094909915015
STAT,1889,32,15-19,1921,0.17945412299534855
STAT,1921,47,30-34,1968,0.10254919457062513
STAT,1864,40,15-19,1904,0.012653050607355616
STAT,1857,47,40-44,1904,0.13576237835171043
STAT,1837,22,40-44,1859,1.818777408754755
STAT,1847,26,15-19,1873,0.42832872189366694
STAT,1806,61,na,1867,994.4483826104216
SIM,1900,23,35-39,1923,10
STAT,1853,51,45-49,1904,0.012226862429694675
SIM,1939,10,na,1949,4008
STAT,1852,42,45-49,1894,1.2042113708456974
SIM,1860,33,30-34,1893,27
SIM,1934,35,50-100,1969,2
STAT,1763,112,na,1875,2.6578492159737684E-4
STAT,1932,19,35-39,1951,5.6360675857480675
STAT,1902,40,45-49,1942,0.15102677946253024
SIM,1859,54,40-44,1913,1
STAT,1838,16,50-100,1854,0.04782957153806911
STAT,1826,42,35-39,1868,1.48399439299469
SIM,1940,19,35-39,1959,7
SIM,1844,75,na,1919,674
STAT,1837,45,15-19,1882,2.840308020096032E-4
STAT,1841,53,25-29,1894,0.0025732639415063326
SIM,1923,19,35-39,1942,4
SIM,1843,90,na,1933,74
SIM,1864,16,15-19,1880,9
STAT,1870,51,45-49,1921,0.014541935492180077
STAT,1862,37,20-24,1899,0.6694051987547197
SIM,1899,33,na,1932,3226
STAT,1868,54,40-44,1922,0.009975715265347875
STAT,1817,54,45-49,1871,0.029867114061762033
STAT,1876,33,na,1909,2503.201902364595
STAT,1909,62,na,1971,3133.957798969834
STAT,1930,37,30-34,1967,2.4246415689607823
SIM,1874,37,40-44,1911,9
STAT,1950,2,na,1952,4824.359573144308
STAT,1861,32,45-49,1893,1.4699867261497694
SIM,1921,21,50-100,1942,2
SIM,1869,27,20-24,1896,12
SIM,1876,70,na,1946,1549
SIM,1825,95,na,1920,6
STAT,1916,46,45-49,1962,0.22805131048646032
STAT,1905,43,15-19,1948,0.0014027056763854624
STAT,1831,31,20-24,1862,2.507736510024637
STAT,1856,16,15-19,1872,5.6527078131247395
STAT,1907,33,na,1940,3589.616807633753
STAT,1820,40,50-100,1860,2.220316544572663
STAT,1931,33,15-19,1964,0.1716205122300703
STAT,1826,43,30-34,1869,0.9259501487625176
STAT,1854,49,30-34,1903,0.07253946105020687
SIM,1949,1,na,1950,4850
STAT,1826,46,50-100,1872,0.1944702127318258
STAT,1912,18,20-24,1930,27.893358317807206
SIM,1885,40,25-29,1925,2
SIM,1834,46,50-100,1880,1
SIM,1838,68,na,1906,937
STAT,1821,46,15-19,1867,6.397433514266598E-4
SIM,1873,28,25-29,1901,45
SIM,1927,2,na,1929,5002
STAT,1923,42,20-24,1965,0.021060484810476055
SIM,1966,0,na,1966,5199
STAT,1925,22,35-39,1947,11.498977426299353
SIM,1825,61,na,1886,1147
SIM,1851,20,25-29,1871,64
SIM,1920,18,20-24,1938,139
STAT,1922,48,45-49,1970,0.2540560584612881
STAT,1920,15,na,1935,4457.207203297241
SIM,1878,21,40-44,1899,3
STAT,1853,46,45-49,1899,0.19844752425095427
STAT,1893,34,30-34,1927,22.401978465110947
STAT,1868,43,50-100,1911,1.0219362708315944
SIM,1903,12,na,1915,3699
STAT,1917,31,40-44,1948,4.198934053472766
STAT,1923,29,na,1952,4356.961268039678
STAT,1800,66,na,1866,944.2445617124789
SIM,1889,41,20-24,1930,4
STAT,1877,40,25-29,1917,0.6863133138698375
STAT,1790,65,na,1855,834.3044
STAT,1867,40,15-19,1907,0.013359567953287592
STAT,1943,18,50-100,1961,0.40521101460245734
STAT,1903,30,35-39,1933,14.803960647651708
SIM,1822,91,na,1913,28
STAT,1919,44,20-24,1963,0.01946499927787784
STAT,1892,20,20-24,1912,88.63459601258367
SIM,1922,2,na,1924,4825
SIM,1951,18,50-100,1969,4
SIM,1876,43,50-100,1919,3
SIM,1925,31,40-44,1956,13
STAT,1904,1,na,1905,3979.547975614878
STAT,1823,39,na,1862,1562.635731485334
SIM,1865,26,25-29,1891,49
STAT,1833,87,na,1920,115.69716366453818
SIM,1813,76,na,1889,440
SIM,1912,36,25-29,1948,1
STAT,1860,89,na,1949,86.95429763633767
SIM,1938,23,15-19,1961,6
STAT,1821,105,na,1926,0.015450212413233352
SIM,1903,24,15-19,1927,5
STAT,1816,49,45-49,1865,0.46986163893952887
STAT,1843,41,40-44,1884,1.893656708602652
STAT,1901,18,45-49,1919,0.09294357316076185
STAT,1836,32,50-100,1868,0.7209229409580575
SIM,1829,61,na,1890,992
STAT,1904,36,25-29,1940,0.9129730970577691
STAT,1913,48,35-39,1961,0.12802147117684018
SIM,1852,94,na,1946,8
STAT,1852,23,50-100,1875,0.3874602913304085
STAT,1815,65,na,1880,1030.2684838442904
STAT,1853,53,35-39,1906,0.007102781094235579
STAT,1905,48,na,1953,3273.748774886592
STAT,1943,21,40-44,1964,3.650966116336304
SIM,1814,40,50-100,1854,4
STAT,1806,54,na,1860,1162.287782696535
STAT,1895,47,na,1942,2981.1560664815115
STAT,1926,0,na,1926,5634.862482026942
STAT,1772,84,na,1856,55.67215165000001
STAT,1830,40,35-39,1870,1.6071753542052651
STAT,1835,42,45-49,1877,1.336674633148828
STAT,1854,45,15-19,1899,3.091936895831962E-4
SIM,1839,16,na,1855,2272
SIM,1937,25,na,1962,4359
STAT,1884,21,25-29,1905,57.951434329667926
STAT,1861,48,45-49,1909,0.19644081054769424
SIM,1860,32,35-39,1892,14
SIM,1817,76,na,1893,407
SIM,1839,36,25-29,1875,5
SIM,1873,25,20-24,1898,11
STAT,1882,51,20-24,1933,7.36910022812338E-4
STAT,1820,47,45-49,1867,0.43045559502409925
SIM,1918,48,na,1966,4098
STAT,1896,7,na,1903,3510.3356317974285
STAT,1842,39,45-49,1881,1.6345224275924224
STAT,1816,54,na,1870,1176.2440890844605
STAT,1872,74,na,1946,1134.6807450779918
STAT,1828,38,na,1866,1513.7753543895517
SIM,1903,49,na,1952,3096
SIM,1893,55,na,1948,2748
STAT,1777,83,na,1860,152.37031568410418
STAT,1898,35,50-100,1933,1.7098211157987464
SIM,1832,27,25-29,1859,7
SIM,1848,23,20-24,1871,3
STAT,1813,48,30-34,1861,0.2392367570693956
STAT,1873,52,25-29,1925,0.003643823589417463
STAT,1893,30,15-19,1923,0.18577778810291498
SIM,1858,43,35-39,1901,4
SIM,1825,30,25-29,1855,12
SIM,1907,26,40-44,1933,8
STAT,1852,32,35-39,1884,8.447029334004801
STAT,1926,43,35-39,1969,0.25284726534755403
STAT,1849,48,45-49,1897,0.1809189078135219
SIM,1837,23,45-49,1860,1
STAT,1822,34,15-19,1856,0.3259139021471909
SIM,1834,43,30-34,1877,1
STAT,1875,45,35-39,1920,0.14804284647581897
SIM,1900,38,na,1938,3374
SIM,1902,19,15-19,1921,9
STAT,1787,83,na,1870,157.79854281405682
SIM,1820,62,na,1882,1187
STAT,1801,55,na,1856,1040.9391140540522
STAT,1880,39,30-34,1919,5.655961720678554
SIM,1832,43,na,1875,1642
SIM,1830,34,15-19,1864,1
STAT,1951,14,na,1965,4770.150732005096
STAT,1938,28,na,1966,3784.0830501876108
STAT,1865,102,na,1967,1.6783845050243604
STAT,1898,27,25-29,1925,58.35702765927241
STAT,1918,41,35-39,1959,0.21879579935059487
SIM,1823,76,na,1899,491
SIM,1791,87,na,1878,38
STAT,1858,42,30-34,1900,0.9289453245963049
SIM,1853,42,na,1895,1930
STAT,1860,27,45-49,1887,0.9288606636030695
STAT,1883,16,25-29,1899,5.686130334815102
SIM,1943,25,na,1968,3877
STAT,1886,33,na,1919,2565.893591015532
STAT,1938,18,25-29,1956,43.59258955686316
SIM,1922,26,na,1948,4288
SIM,1884,30,30-34,1914,22
SIM,1870,82,na,1952,350
SIM,1802,77,na,1879,313
SIM,1848,40,20-24,1888,3
SIM,1874,33,25-29,1907,18
STAT,1887,18,na,1905,2879.5404777731715
STAT,1931,37,30-34,1968,2.4616915029570303
STAT,1855,54,30-34,1909,0.0044875129917524795
SIM,1870,40,30-34,1910,2
STAT,1859,42,30-34,1901,0.9354987400438083
STAT,1849,46,50-100,1895,0.19121550730774792
SIM,1892,42,40-44,1934,7
STAT,1774,105,na,1879,0.014553518489596035
SIM,1892,21,25-29,1913,91
STAT,1817,39,na,1856,1496.6009083252957
STAT,1889,47,na,1936,2822.429699958558
STAT,1948,15,30-34,1963,14.239124186084945
SIM,1861,46,45-49,1907,1
SIM,1912,23,na,1935,3791
STAT,1884,42,40-44,1926,2.2673600656692536
STAT,1831,47,50-100,1878,0.2008644440277883
SIM,1899,43,50-100,1942,1
SIM,1770,88,na,1858,26
SIM,1820,58,na,1878,1307
STAT,1891,18,25-29,1909,7.13831483305221
STAT,1930,26,25-29,1956,85.39839469151767
SIM,1955,10,na,1965,5089
SIM,1946,18,25-29,1964,55
STAT,1893,33,50-100,1926,1.1807520523034576
STAT,1809,52,45-49,1861,0.06164335320776329
STAT,1876,30,30-34,1906,18.54042151355045
STAT,1879,18,25-29,1897,6.026912231655586
STAT,1812,52,35-39,1864,0.019433467199367487
SIM,1888,39,25-29,1927,7
SIM,1855,16,na,1871,2136
STAT,1870,31,25-29,1901,10.256310405574181
STAT,1922,35,30-34,1957,2.119738808103255
SIM,1792,76,na,1868,356
STAT,1845,31,50-100,1876,0.8600997869141059
SIM,1851,57,na,1908,1622
STAT,1834,79,na,1913,469.81099171941935
STAT,1859,17,45-49,1876,0.061776365996647147
SIM,1876,15,na,1891,3007
SIM,1871,71,na,1942,1284
STAT,1838,38,na,1876,1879.2898275063887
STAT,1933,29,na,1962,5067.686952489569
STAT,1898,48,40-44,1946,0.13155086143605443
SIM,1833,28,na,1861,1890
STAT,1907,17,35-39,1924,0.8219042701596618
STAT,1852,28,50-100,1880,0.5959248173320318
SIM,1915,17,35-39,1932,1
STAT,1884,34,50-100,1918,0.9168333599343753
STAT,1916,29,45-49,1945,1.809848454488765
SIM,1819,42,50-100,1861,3
STAT,1841,50,20-24,1891,5.526743943695728E-4
STAT,1866,23,30-34,1889,16.77635586544348
SIM,1892,70,na,1962,2296
SIM,1930,35,30-34,1965,3
STAT,1935,14,na,1949,5506.039846740345
SIM,1875,44,30-34,1919,1
STAT,1924,44,50-100,1968,0.1420939113116626
STAT,1875,92,na,1967,141.31972731697235
STAT,1867,44,30-34,1911,1.0862112939256552
STAT,1850,17,25-29,1867,5.208756546725213
STAT,1885,32,30-34,1917,17.77013012544059
STAT,1856,19,na,1875,2148.0203708390486
SIM,1819,61,na,1880,1049
STAT,1830,80,na,1910,391.31915407848726
SIM,1923,16,30-34,1939,23
STAT,1881,44,30-34,1925,1.1185863888101162
SIM,1884,41,na,1925,2475
STAT,1845,54,20-24,1899,5.607157328718574E-4
SIM,1844,32,50-100,1876,2
STAT,1871,34,na,1905,2390.780425763601
SIM,1886,26,45-49,1912,1
STAT,1915,16,30-34,1931,2.60960275040901
STAT,1899,32,25-29,1931,14.308607879973769
STAT,1905,47,30-34,1952,0.08007435904021241
SIM,1776,80,na,1856,192
SIM,1886,70,na,1956,1526
SIM,1937,16,25-29,1953,80
STAT,1796,97,na,1893,1.1686904389632848
STAT,1881,49,25-29,1930,0.0556234372791868
STAT,1910,2,na,1912,4119.6861669831
SIM,1945,6,na,1951,4732
SIM,1830,31,50-100,1861,2
STAT,1825,68,na,1893,916.4032560432936
STAT,1902,23,45-49,1925,1.0000986601346955
STAT,1902,34,na,1936,3432.615650904792
STAT,1857,26,25-29,1883,34.96498491605841
SIM,1910,23,45-49,1933,2
SIM,1819,35,45-49,1854,2
STAT,1914,15,na,1929,4095.2611820859797
STAT,1907,24,25-29,1931,85.21066117934244
STAT,1854,93,na,1947,22.36779000253436
SIM,1881,23,na,1904,2306
STAT,1904,63,na,1967,2878.564483442057
SIM,1828,41,50-100,1869,4
STAT,1835,45,50-100,1880,0.21755100739554298
STAT,1864,45,50-100,1909,0.2250004306469031
STAT,1775,98,na,1873,0.5298228840020762
STAT,1928,19,50-100,1947,0.4789444600528441
STAT,1942,19,45-49,1961,0.5322504516877872
SIM,1826,41,30-34,1867,2
STAT,1862,50,40-44,1912,0.009273588583379492
SIM,1889,24,20-24,1913,89
STAT,1933,24,35-39,1957,12.728627896810597
STAT,1894,20,50-100,1914,0.5383027716182421
STAT,1817,51,40-44,1868,0.023004594348548377
SIM,1841,57,na,1898,1518
STAT,1881,51,20-24,1932,7.312754296759432E-4
STAT,1913,40,20-24,1953,0.01776849838987776
STAT,1929,16,25-29,1945,56.54605908654869
STAT,1798,105,na,1903,0.010093003525448487
SIM,1843,45,50-100,1888,2
STAT,1917,33,na,1950,4024.506865675006
STAT,1781,98,na,1879,0.5461554265911086
SIM,1893,32,30-34,1925,36
STAT,1845,51,35-39,1896,0.006758846603604066
SIM,1934,11,na,1945,5649
SIM,1949,10,na,1959,4778
SIM,1915,24,25-29,1939,114
STAT,1818,41,30-34,1859,3.0676744147699155
SIM,1897,15,15-19,1912,9
STAT,1927,39,30-34,1966,2.306576640759063
SIM,1858,53,45-49,1911,1
STAT,1833,94,na,1927,13.124771366245916
SIM,1913,12,na,1925,4248
STAT,1863,60,na,1923,1705.8801438319047
STAT,1925,33,40-44,1958,4.7382088071324375
STAT,1793,79,na,1872,304.6385976613731
SIM,1933,33,40-44,1966,13
STAT,1834,37,45-49,1871,1.66868587066043
SIM,1863,42,na,1905,2008
STAT,1843,20,25-29,1863,58.84860080526439
STAT,1866,29,50-100,1895,0.5976293473095124
STAT,1928,42,50-100,1970,0.15276328232471184
STAT,1878,26,45-49,1904,1.183033813741725
STAT,1910,43,50-100,1953,0.11255972450705033
STAT,1877,18,na,1895,2665.3069489418995
STAT,1889,15,15-19,1904,7.513132025462859
STAT,1946,20,15-19,1966,6.047917054866004
SIM,1861,15,45-49,1876,4
STAT,1824,49,35-39,1873,0.15881312283200932
STAT,1917,26,na,1943,4022.917961112777
SIM,1855,53,na,1908,1665
STAT,1903,2,na,1905,3865.6458264749836
SIM,1902,24,45-49,1926,1
SIM,1860,44,40-44,1904,2
STAT,1777,102,na,1879,0.10058572016015675
STAT,1882,45,35-39,1927,0.1405299495314976
SIM,1903,17,15-19,1920,10
STAT,1845,51,40-44,1896,0.008265103827632693
SIM,1844,28,20-24,1872,11
STAT,1863,31,35-39,1894,9.095189056735075
SIM,1859,43,na,1902,2182
STAT,1780,97,na,1877,0.8686868059581043
STAT,1889,48,25-29,1937,0.04042911697361062
STAT,1913,12,na,1925,4119.302501176078
STAT,1784,87,na,1871,47.76693185406942
SIM,1857,15,25-29,1872,13
SIM,1896,75,na,1971,1844
STAT,1829,47,15-19,1876,3.2371641900826E-4
STAT,1771,101,na,1872,0.12008863518256734
STAT,1849,28,30-34,1877,23.008571006085326
STAT,1841,46,30-34,1887,0.07272230643437347
SIM,1837,40,na,1877,1584
STAT,1937,35,20-24,1972,0.2693415625990697
STAT,1840,28,40-44,1868,2.6684227257458746
STAT,1851,39,50-100,1890,1.002714639098522
STAT,1850,20,15-19,1870,3.02171272463273
STAT,1955,15,15-19,1970,61.48079726154798
STAT,1839,94,na,1933,13.793288346472755
STAT,1840,17,30-34,1857,1.484981706195666
STAT,1878,45,15-19,1923,4.289786509561358E-4
STAT,1815,54,35-39,1869,0.02125647641000941
STAT,1836,28,20-24,1864,9.381451165511027
STAT,1798,95,na,1893,4.576700011076917
STAT,1828,54,45-49,1882,0.009587488927227753
STAT,1804,53,20-24,1857,0.002120656123647711
SIM,1851,43,30-34,1894,2
STAT,1809,72,na,1881,727.6834988449572
SIM,1842,27,na,1869,2001
STAT,1882,8,na,1890,2583.6287655573456
STAT,1850,31,25-29,1881,8.143843235342136
SIM,1855,18,25-29,1873,10
STAT,1911,21,40-44,1932,3.2625563941819347
SIM,1847,58,na,1905,1333
SIM,1900,27,45-49,1927,3
STAT,1824,41,25-29,1865,0.8072166339225957
STAT,1857,34,15-19,1891,0.1124874943995146
STAT,1939,32,20-24,1971,2.5388190148292247
SIM,1880,21,35-39,1901,12
STAT,1893,48,45-49,1941,0.17011678283538664
STAT,1792,82,na,1874,148.44299617523453
STAT,1866,15,50-100,1881,0.04788016735630443
STAT,1905,17,na,1922,3721.0880574332873
STAT,1871,55,na,1926,2089.475487145824
STAT,1929,11,na,1940,5165.2124175401705
SIM,1806,76,na,1882,510
SIM,1857,26,35-39,1883,17
STAT,1915,0,na,1915,4795.812031875204
STAT,1884,42,35-39,1926,1.82537276150311
SIM,1848,22,20-24,1870,2
STAT,1843,54,40-44,1897,0.008264979013929101
STAT,1849,15,25-29,1864,5.479702602568747
SIM,1878,39,30-34,1917,13
STAT,1842,25,40-44,1867,2.9472269472352965
SIM,1874,23,30-34,1897,24
SIM,1850,25,40-44,1875,3
SIM,1892,42,35-39,1934,7
STAT,1876,48,15-19,1924,4.160768527733318E-4
STAT,1875,18,30-34,1893,1.6644260395331796
STAT,1953,18,15-19,1971,55.98351976829041
SIM,1825,55,na,1880,1256
STAT,1843,43,30-34,1886,0.9434153634773428
STAT,1892,19,45-49,1911,0.08307097059387125
SIM,1850,22,na,1872,1935
STAT,1817,51,35-39,1868,0.01881216831906511
STAT,1824,30,15-19,1854,0.4026028094865492
STAT,1910,33,50-100,1943,0.8096510453029481
SIM,1837,49,40-44,1886,1
STAT,1921,43,15-19,1964,0.0017622358711980447
STAT,1860,50,25-29,1910,0.0029739053949502533
STAT,1909,48,20-24,1957,0.010327762778353174
STAT,1834,63,na,1897,1199.0837524709525
SIM,1821,65,na,1886,887
STAT,1847,18,25-29,1865,5.482847688425514
STAT,1853,17,40-44,1870,0.18448687909389558
SIM,1884,31,20-24,1915,2
STAT,1885,63,na,1948,1816.0270258324792
STAT,1897,42,45-49,1939,0.14158946649858437
SIM,1814,71,na,1885,639
STAT,1882,47,30-34,1929,0.0957587536667777
SIM,1772,90,na,1862,18
SIM,1872,15,20-24,1887,19
STAT,1829,38,30-34,1867,4.597857103895905
STAT,1801,92,na,1893,14.86043525357253
STAT,1850,33,20-24,1883,2.105015529965848
SIM,1872,49,na,1921,2315
STAT,1833,36,25-29,1869,2.4096766954074513
STAT,1855,37,15-19,1892,0.043530919583990246
STAT,1948,17,50-100,1965,0.4374459698846097
STAT,1939,30,25-29,1969,9.631136677933634
STAT,1831,39,25-29,1870,2.4726047630038805
STAT,1851,18,45-49,1869,0.06513712173665441
SIM,1867,34,25-29,1901,16
STAT,1880,49,50-100,1929,0.2577931682488278
SIM,1897,17,na,1914,3425
SIM,1857,28,30-34,1885,36
STAT,1896,29,30-34,1925,33.686423080263566
SIM,1910,39,50-100,1949,5
STAT,1761,110,na,1871,9.029511597057792E-4
STAT,1843,41,35-39,1884,1.5245171809536233
STAT,1895,45,45-49,1940,0.1789555392255753
SIM,1893,37,50-100,1930,1
STAT,1927,28,15-19,1955,0.8723843353812103
STAT,1877,21,50-100,1898,0.43277997566850673
STAT,1932,35,50-100,1967,0.5762957909000959
STAT,1895,30,50-100,1925,1.2293356388376322
STAT,1949,17,40-44,1966,1.6596677015630406
STAT,1864,15,20-24,1879,18.498238272666676
STAT,1817,53,30-34,1870,0.012497787161050895
STAT,1829,49,40-44,1878,0.13502579514123547
SIM,1868,20,na,1888,2376
STAT,1862,18,20-24,1880,17.52857247232153
SIM,1797,82,na,1879,139
STAT,1884,44,30-34,1928,1.1446777451605894
STAT,1832,51,30-34,1883,0.0042407123955227385
SIM,1818,61,na,1879,1028
SIM,1827,33,50-100,1860,1
STAT,1830,43,20-24,1873,0.1350549387230562
STAT,1853,15,45-49,1868,0.0666712291976047
STAT,1855,41,na,1896,1799.7759608547215
STAT,1900,46,35-39,1946,0.11197898598586237
STAT,1839,54,20-24,1893,4.952666304844585E-4
SIM,1862,41,40-44,1903,4
SIM,1939,24,40-44,1963,5
STAT,1805,82,na,1887,207.86531068565654
SIM,1956,8,na,1964,5511
STAT,1901,27,na,1928,3404.5643467970494
STAT,1826,68,na,1894,891.3069796799081
SIM,1843,68,na,1911,1123
SIM,1851,63,na,1914,1414
SIM,1836,18,15-19,1854,4
STAT,1889,53,na,1942,2669.8087651370033
STAT,1898,37,40-44,1935,6.038994611979871
SIM,1869,42,35-39,1911,5
SIM,1870,18,20-24,1888,31
SIM,1837,38,30-34,1875,5
SIM,1851,41,35-39,1892,2
STAT,1837,44,15-19,1881,0.009636989210040955
STAT,1861,23,25-29,1884,49.219553831994496
SIM,1869,30,40-44,1899,3
STAT,1933,25,35-39,1958,20.34774066716962
STAT,1950,22,30-34,1972,34.78473324849334
STAT,1856,66,na,1922,1312.5250605997333
STAT,1893,26,50-100,1919,0.8306966250813966
STAT,1917,42,40-44,1959,0.2663755426970586
SIM,1936,1,na,1937,3572
SIM,1941,22,30-34,1963,2
STAT,1841,30,45-49,1871,1.5949713796251392
SIM,1922,28,35-39,1950,23
SIM,1904,28,na,1932,3680
SIM,1826,32,40-44,1858,5
STAT,1824,43,20-24,1867,0.1918374214164264
SIM,1898,29,30-34,1927,57
SIM,1919,32,45-49,1951,4
STAT,1851,35,na,1886,2005.7621303406663
SIM,1922,17,25-29,1939,65
STAT,1868,91,na,1959,90.36352564281415
STAT,1918,22,35-39,1940,10.363268384782268
SIM,1863,88,na,1951,53
SIM,1866,31,50-100,1897,2
STAT,1805,49,25-29,1854,0.205579083479784
STAT,1846,88,na,1934,98.1744834149219
STAT,1842,74,na,1916,870.3013113734062
STAT,1885,23,40-44,1908,2.1143030006720176
STAT,1914,17,25-29,1931,9.146085581586295
SIM,1867,19,na,1886,2349
STAT,1864,61,na,1925,1695.0062748603755
SIM,1771,89,na,1860,11
STAT,1839,52,25-29,1891,0.0024314885672006696
STAT,1891,21,45-49,1912,0.88337466655425
STAT,1834,54,45-49,1888,0.009624940540551321
STAT,1855,25,na,1880,1948.712531054223
STAT,1857,36,40-44,1893,3.504425385964998
SIM,1872,29,40-44,1901,3
SIM,1873,47,30-34,1920,1
STAT,1854,44,15-19,1898,0.010426749568879701
STAT,1859,36,45-49,1895,1.6319404426076112
SIM,1926,31,na,1957,4921
STAT,1874,34,20-24,1908,2.7912985197464875
SIM,1808,83,na,1891,120
SIM,1874,29,45-49,1903,3
SIM,1800,63,na,1863,815
STAT,1843,56,na,1899,1646.5414934557489
SIM,1888,40,na,1928,2711
STAT,1935,22,35-39,1957,13.076019977447263
STAT,1933,22,30-34,1955,38.87943641290239
SIM,1848,83,na,1931,273
SIM,1887,26,20-24,1913,21
STAT,1824,30,45-49,1854,4.92998512512271
SIM,1843,33,25-29,1876,14
SIM,1855,25,50-100,1880,4
STAT,1840,26,15-19,1866,0.4100211112127975
STAT,1902,52,na,1954,3081.2391003846756
SIM,1842,15,35-39,1857,3
STAT,1808,48,50-100,1856,0.6270911571048858
STAT,1833,38,na,1871,1739.9104126525763
STAT,1929,25,15-19,1954,0.9045560253797255
SIM,1859,39,20-24,1898,5
STAT,1928,32,45-49,1960,2.0069731026397295
SIM,1880,20,na,1900,2357
SIM,1943,22,35-39,1965,10
STAT,1903,27,20-24,1930,17.012536021097368
SIM,1890,27,50-100,1917,2
STAT,1859,45,35-39,1904,0.1151972251934432
SIM,1884,34,na,1918,2534
STAT,1873,38,na,1911,2424.5825283903628
STAT,1860,71,na,1931,1104.8334972424032
STAT,1869,52,40-44,1921,0.010313572468408885
SIM,1916,13,na,1929,4310
STAT,1868,28,40-44,1896,2.908505555306954
SIM,1882,34,20-24,1916,3
SIM,1917,54,na,1971,3600
SIM,1863,29,na,1892,2071
STAT,1811,46,45-49,1857,0.6672070496295192
STAT,1879,26,20-24,1905,12.552822413090881
STAT,1827,109,na,1936,4.5983019822439875E-4
STAT,1839,41,15-19,1880,0.0111808219398495
SIM,1888,42,45-49,1930,2
SIM,1926,22,35-39,1948,19
SIM,1834,91,na,1925,17
SIM,1911,27,20-24,1938,19
STAT,1819,74,na,1893,654.2836536081571
STAT,1891,21,15-19,1912,4.179240059648268
STAT,1930,36,50-100,1966,0.5590588316765094
STAT,1864,16,50-100,1880,0.050817833323060134
STAT,1810,50,40-44,1860,0.03282013914692002
STAT,1905,38,35-39,1943,2.2380927292568367
SIM,1936,32,45-49,1968,3
SIM,1900,14,na,1914,3718
STAT,1849,26,35-39,1875,8.944152745036007
STAT,1890,17,15-19,1907,7.402383930106242
SIM,1893,23,40-44,1916,7
STAT,1820,49,20-24,1869,0.021256621636932316
STAT,1850,39,35-39,1889,5.293454385913027
STAT,1891,32,25-29,1923,12.936388150855768
STAT,1913,49,25-29,1962,0.052508934943416775
SIM,1821,40,40-44,1861,5
STAT,1892,17,na,1909,3229.143738419859
STAT,1905,27,25-29,1932,62.32456839373932
STAT,1867,10,na,1877,2600.6628172723545
STAT,1907,21,20-24,1928,103.53476561652244
SIM,1872,65,na,1937,1722
STAT,1868,20,30-34,1888,17.60764518092533
SIM,1854,12,na,1866,2468
STAT,1791,107,na,1898,8.320737171426341E-4
STAT,1863,34,15-19,1897,0.12628623997560126
STAT,1818,44,35-39,1862,4.279947089719423
STAT,1868,26,45-49,1894,1.085555711439791
STAT,1871,44,20-24,1915,0.1583182411487774
SIM,1810,81,na,1891,421
SIM,1835,22,40-44,1857,2
SIM,1842,17,30-34,1859,2
SIM,1822,39,25-29,1861,5
SIM,1884,34,25-29,1918,14
STAT,1871,47,50-100,1918,0.24702779831827262
STAT,1924,38,45-49,1962,0.8193197194178656
STAT,1815,40,45-49,1855,5.257071476417919
SIM,1898,16,25-29,1914,18
STAT,1818,92,na,1910,21.225241007470117
STAT,1926,32,40-44,1958,4.827278156096934
STAT,1838,53,na,1891,1556.6431745489353
STAT,1880,31,40-44,1911,4.668087625743748
STAT,1876,34,25-29,1910,10.697481892207525
STAT,1835,33,25-29,1868,9.619452197334647
STAT,1924,32,30-34,1956,18.753419068951395
STAT,1907,38,45-49,1945,0.6413089478804934
SIM,1936,21,50-100,1957,3
STAT,1833,33,20-24,1866,2.2842886392470905
STAT,1851,51,40-44,1902,0.008727050599592445
STAT,1792,109,na,1901,1.1801333882181656E-4
SIM,1898,27,35-39,1925,20
STAT,1790,99,na,1889,0.3905949811264068
SIM,1884,35,50-100,1919,2
STAT,1862,1,na,1863,3157.3022265475824
SIM,1836,40,50-100,1876,1
SIM,1841,33,20-24,1874,5
STAT,1924,21,20-24,1945,134.2695049033565
SIM,1915,38,45-49,1953,2
STAT,1896,38,15-19,1934,0.0752847685581411
SIM,1932,32,30-34,1964,41
STAT,1913,48,40-44,1961,0.15655197010665206
STAT,1926,38,50-100,1964,0.5229323271126524
STAT,1844,22,40-44,1866,2.016142079297641
STAT,1848,47,25-29,1895,0.04456564638948043
STAT,1885,24,25-29,1909,57.89863076994538
SIM,1932,21,20-24,1953,2
STAT,1860,41,40-44,1901,1.870181690895253
STAT,1809,56,na,1865,1382.3192640800958
STAT,1882,31,45-49,1913,1.740227191796157
STAT,1881,29,40-44,1910,2.933340927516241
STAT,1879,38,15-19,1917,0.05958368953821036
SIM,1822,38,40-44,1860,3
SIM,1876,20,30-34,1896,29
SIM,1934,22,50-100,1956,1
SIM,1826,44,35-39,1870,6
SIM,1826,33,25-29,1859,13
STAT,1813,61,na,1874,1009.4718608416434
STAT,1922,29,na,1951,4294.3837273711415
SIM,1930,38,40-44,1968,3
SIM,1893,35,35-39,1928,14
SIM,1837,22,45-49,1859,1
SIM,1915,21,20-24,1936,115
STAT,1922,38,40-44,1960,1.736302798329471
SIM,1846,25,20-24,1871,13
STAT,1885,35,35-39,1920,7.267036122544259
SIM,1832,30,45-49,1862,2
STAT,1830,40,40-44,1870,1.9963293489994631
SIM,1909,35,50-100,1944,4
STAT,1887,70,na,1957,1664.5971207337413
STAT,1918,9,na,1927,4421.673791454026
SIM,1932,38,45-49,1970,2
STAT,1812,46,50-100,1858,0.5913049277369024
STAT,1820,36,15-19,1856,0.14444213129751637
STAT,1869,50,45-49,1919,0.014498801107004853
STAT,1874,20,na,1894,2478.0421253114137
STAT,1907,32,30-34,1939,15.01687146828872
STAT,1937,22,45-49,1959,1.1176383256361406
SIM,1915,32,30-34,1947,26
SIM,1945,22,45-49,1967,2
STAT,1889,13,na,1902,3249.2882057736683
SIM,1917,32,35-39,1949,2
STAT,1883,4,na,1887,2808.362403195043
STAT,1854,44,45-49,1898,1.1299989051924866
STAT,1859,38,40-44,1897,3.5487276134262267
STAT,1880,91,na,1971,226.09481102678234
SIM,1930,7,na,1937,5784
STAT,1838,25,20-24,1863,11.123839474676194
STAT,1909,32,35-39,1941,8.893746202767304
SIM,1893,24,25-29,1917,97
STAT,1891,34,20-24,1925,3.3847286788809265
STAT,1935,25,45-49,1960,2.4036835068603692
STAT,1834,51,35-39,1885,0.00605923044911918
STAT,1855,25,20-24,1880,10.567900104509196
STAT,1828,51,40-44,1879,0.008111211547791479
SIM,1890,31,45-49,1921,5
STAT,1846,31,35-39,1877,8.647669200422536
STAT,1865,45,35-39,1910,0.1309187158902525
SIM,1859,83,na,1942,296
STAT,1936,18,15-19,1954,44.200151023984056
SIM,1810,53,40-44,1863,1
STAT,1807,49,35-39,1856,0.5884019368886726
STAT,1948,24,40-44,1972,3.9361647920498117
SIM,1860,24,na,1884,2091
STAT,1918,38,20-24,1956,0.28325364892966753
STAT,1795,107,na,1902,8.4368604172035E-4
SIM,1841,31,25-29,1872,11
SIM,1899,5,na,1904,3664
SIM,1937,15,na,1952,4299
SIM,1841,20,15-19,1861,3
STAT,1844,34,35-39,1878,9.191513054661872
STAT,1940,18,35-39,1958,4.345050723043894
SIM,1852,34,35-39,1886,11
SIM,1934,26,na,1960,5458
STAT,1862,35,na,1897,2065.3611011677585
SIM,1847,41,45-49,1888,2
SIM,1874,15,25-29,1889,10
SIM,1930,36,na,1966,5468
SIM,1815,49,35-39,1864,1
STAT,1889,45,20-24,1934,0.015272481227440887
STAT,1866,25,na,1891,2260.882418281425
SIM,1819,86,na,1905,84
STAT,1822,38,na,1860,1651.2686597754034
SIM,1867,33,40-44,1900,6
STAT,1844,23,25-29,1867,54.989019436940076
SIM,1823,40,45-49,1863,2
SIM,1877,40,na,1917,2398
STAT,1798,79,na,1877,348.95193231523984
SIM,1863,25,20-24,1888,13
STAT,1861,20,20-24,1881,60.54550249187773
STAT,1867,42,35-39,1909,1.7321386019353227
STAT,1900,49,15-19,1949,3.123727094367996E-4
STAT,1839,41,45-49,1880,1.211721492658767
SIM,1873,50,na,1923,2214
SIM,1847,98,na,1945,1
STAT,1793,64,na,1857,894.1696521040002
STAT,1799,104,na,1903,0.021643422439450725
STAT,1902,46,15-19,1948,3.255276925543044E-4
SIM,1854,31,35-39,1885,13
STAT,1867,66,na,1933,1569.7319877476189
STAT,1822,49,30-34,1871,0.13403534088490499
STAT,1942,15,35-39,1957,4.4762737472953384
STAT,1821,53,20-24,1874,0.0010946251140925459
STAT,1873,18,50-100,1891,0.05053707514832017
SIM,1878,2,na,1880,3487
STAT,1847,51,45-49,1898,0.011371116726683788
SIM,1845,42,50-100,1887,2
SIM,1891,44,na,1935,2946
STAT,1915,42,50-100,1957,0.12069380840397426
STAT,1872,35,25-29,1907,2.9717339703934114
SIM,1852,23,25-29,1875,72
SIM,1862,44,45-49,1906,4
STAT,1881,18,30-34,1899,1.567878783454789
STAT,1887,41,50-100,1928,1.2131298251746059
STAT,1804,50,40-44,1854,0.03216737704072916
STAT,1895,45,15-19,1940,3.0331421796903605E-4
SIM,1876,23,35-39,1899,11
SIM,1871,31,40-44,1902,10
STAT,1889,37,na,1926,2968.8696203471577
STAT,1882,42,30-34,1924,1.141221852387281
SIM,1827,81,na,1908,258
SIM,1890,22,na,1912,2996
SIM,1957,4,na,1961,5612
SIM,1942,21,na,1963,4204
SIM,1926,38,20-24,1964,1
STAT,1830,33,na,1863,1752.9641925073813
STAT,1805,66,na,1871,950.550276649161
STAT,1861,22,40-44,1883,1.8046078039041589
SIM,1898,24,30-34,1922,46
STAT,1933,28,45-49,1961,2.3382569797587185
STAT,1844,41,na,1885,1857.9405554227665
SIM,1813,44,25-29,1857,1
SIM,1865,55,na,1920,1939
STAT,1815,51,30-34,1866,0.01560830884004753
SIM,1941,28,45-49,1969,1
STAT,1846,47,15-19,1893,2.847148926482645E-4
STAT,1868,23,35-39,1891,5.668331816193057
STAT,1923,14,na,1937,4731.760071613904
STAT,1871,41,40-44,1912,2.2832331911971964
SIM,1786,82,na,1868,103
SIM,1939,27,45-49,1966,1
STAT,1885,23,na,1908,2399.6583915630963
STAT,1863,47,20-24,1910,0.01068338131780698
SIM,1883,49,na,1932,2302
SIM,1817,43,25-29,1860,1
SIM,1950,15,35-39,1965,6
STAT,1938,17,35-39,1955,4.2224202951475585
SIM,1864,41,45-49,1905,5
STAT,1881,33,na,1914,2343.6326238808233
STAT,1893,32,35-39,1925,13.105906665477875
STAT,1866,26,35-39,1892,9.11051191603727
STAT,1875,52,40-44,1927,0.010963882444426786
STAT,1849,22,50-100,1871,0.38276969924041815
SIM,1815,41,25-29,1856,3
STAT,1838,37,15-19,1875,0.049786128642392936
SIM,1814,55,na,1869,1160
STAT,1874,32,25-29,1906,10.668305947727642
SIM,1875,33,50-100,1908,2
SIM,1935,5,na,1940,5627
STAT,1801,76,na,1877,367.7078301016713
SIM,1858,41,20-24,1899,1
STAT,1888,12,na,1900,3114.5581753722936
SIM,1878,23,45-49,1901,2
STAT,1881,27,15-19,1908,0.4474765627653305
SIM,1858,35,50-100,1893,2
STAT,1847,15,15-19,1862,5.844647219146365
SIM,1839,23,na,1862,2011
STAT,1891,35,35-39,1926,9.017923827579112
STAT,1908,16,40-44,1924,0.2773476430790085
STAT,1865,44,20-24,1909,0.14506059828349932
STAT,1867,33,50-100,1900,0.8738142961459933
STAT,1917,36,50-100,1953,0.44716793141727723
SIM,1882,32,25-29,1914,11
STAT,1866,15,25-29,1881,5.538140475299035
STAT,1926,19,na,1945,4579.068379461931
SIM,1834,41,35-39,1875,1
STAT,1872,21,35-39,1893,5.984380841410466
SIM,1946,11,na,1957,4330
STAT,1777,93,na,1870,7.948854750442548
STAT,1914,28,35-39,1942,15.38790883977355
SIM,1915,47,na,1962,4114
STAT,1823,79,na,1902,389.0890293762213
SIM,1944,18,15-19,1962,44
STAT,1873,3,na,1876,3211.090303035949
STAT,1824,44,35-39,1868,2.1448576588328128
STAT,1842,98,na,1940,2.5475209616141212
SIM,1894,7,na,1901,3532
STAT,1895,42,40-44,1937,0.20764040686989477
SIM,1882,21,15-19,1903,3
SIM,1921,16,na,1937,4804
STAT,1826,41,35-39,1867,1.5103962166764857
STAT,1893,48,15-19,1941,2.883332875440238E-4
STAT,1944,28,15-19,1972,0.7780809403334559
STAT,1909,47,na,1956,3442.89127280727
STAT,1931,25,30-34,1956,51.63590157183603
SIM,1825,71,na,1896,759
SIM,1874,24,15-19,1898,5
SIM,1876,55,na,1931,2385
STAT,1832,54,35-39,1886,0.005779453458414081
SIM,1832,44,35-39,1876,3
STAT,1850,20,45-49,1870,0.6387057054506282
STAT,1881,15,20-24,1896,17.566488936317935
STAT,1866,24,15-19,1890,3.084849892183183
STAT,1848,31,na,1879,1985.1397059000747
STAT,1885,38,15-19,1923,0.056869443689661826
SIM,1840,54,35-39,1894,1
SIM,1918,37,50-100,1955,2
SIM,1865,36,40-44,1901,10
STAT,1821,48,50-100,1869,0.38123496619542036
SIM,1855,15,15-19,1870,6
SIM,1894,12,na,1906,3494
STAT,1861,5,na,1866,2436.333809383712
SIM,1871,24,na,1895,2188
SIM,1895,32,35-39,1927,23
STAT,1850,10,na,1860,2221.7995084887666
STAT,1768,97,na,1865,1.2440408183290081
STAT,1906,42,na,1948,3439.4467888896156
STAT,1927,16,20-24,1943,172.37844162347574
STAT,1948,20,25-29,1968,108.28110574496908
STAT,1921,47,na,1968,4226.162503723679
SIM,1905,0,na,1905,4028
SIM,1924,25,35-39,1949,23
SIM,1945,26,na,1971,4649
STAT,1803,59,na,1862,1148.7778209320772
SIM,1901,39,na,1940,3522
SIM,1866,77,na,1943,888
STAT,1813,43,15-19,1856,0.04795803769365012
STAT,1898,23,20-24,1921,94.77463659899482
STAT,1806,54,50-100,1860,0.047056791975113914
STAT,1928,26,na,1954,4723.762347225415
SIM,1904,44,na,1948,3524
SIM,1824,35,40-44,1859,2
STAT,1855,28,30-34,1883,20.20125675439272
SIM,1888,80,na,1968,1100
SIM,1863,28,30-34,1891,3
STAT,1865,31,45-49,1896,1.6212082197908197
SIM,1827,38,na,1865,1639
SIM,1844,93,na,1937,2
STAT,1916,25,35-39,1941,15.948921189453573
STAT,1900,30,25-29,1930,14.59894033655341
SIM,1927,32,na,1959,4618
STAT,1834,105,na,1939,0.0197040052377255
STAT,1844,27,40-44,1871,2.841658872571251
STAT,1852,107,na,1959,0.009198465700968694
SIM,1872,27,15-19,1899,1
SIM,1889,65,na,1954,2338
STAT,1887,46,25-29,1933,0.06603142728528875
SIM,1963,0,na,1963,5161
SIM,1891,26,40-44,1917,4
SIM,1900,21,30-34,1921,41
STAT,1864,27,15-19,1891,0.41154554879310135
STAT,1868,51,na,1919,2108.014317502486
STAT,1905,35,30-34,1940,1.710947133577494
SIM,1828,41,35-39,1869,8
SIM,1885,29,20-24,1914,9
STAT,1902,39,50-100,1941,0.3774004606372265
STAT,1876,31,20-24,1907,2.8591181187161836
SIM,1843,38,50-100,1881,5
STAT,1924,5,na,1929,4885.037851495723
SIM,1917,35,45-49,1952,1
STAT,1887,35,15-19,1922,0.06480179511141193
STAT,1920,39,15-19,1959,0.02141072555701926
SIM,1831,31,50-100,1862,1
SIM,1898,25,50-100,1923,5
STAT,1859,55,na,1914,1684.5971815348605
SIM,1893,27,na,1920,3112
STAT,1918,38,15-19,1956,0.020634374372462863
SIM,1875,14,na,1889,2609
STAT,1863,20,na,1883,2188.8996287163245
SIM,1929,19,30-34,1948,20
SIM,1918,28,15-19,1946,1
STAT,1860,44,45-49,1904,1.2220690667580685
STAT,1848,44,20-24,1892,0.12178427662479219
SIM,1832,68,na,1900,901
SIM,1900,54,na,1954,2899
SIM,1862,63,na,1925,1583
STAT,1852,47,15-19,1899,3.2073808296818207E-4
STAT,1865,31,15-19,1896,0.1323945138747706
SIM,1876,26,45-49,1902,1
SIM,1880,24,15-19,1904,2
STAT,1901,31,50-100,1932,1.312438446706443
STAT,1889,45,15-19,1934,5.090822597752615E-4
SIM,1841,36,25-29,1877,2
SIM,1876,46,50-100,1922,2
STAT,1917,45,45-49,1962,0.2327540913846279
SIM,1818,38,20-24,1856,1
SIM,1848,39,45-49,1887,2
STAT,1880,34,15-19,1914,0.15135818458755332
STAT,1900,49,45-49,1949,0.184300053689943
STAT,1854,41,35-39,1895,1.3921856236225325
STAT,1870,24,35-39,1894,5.783075472491528
SIM,1863,37,20-24,1900,3
STAT,1897,48,na,1945,3030.8681519091674
STAT,1852,76,na,1928,763.2299365403759
SIM,1880,35,25-29,1915,2
STAT,1968,0,na,1968,5045.956426435764
SIM,1932,35,40-44,1967,6
STAT,1909,35,45-49,1944,0.6643404286341561
STAT,1835,30,20-24,1865,2.6189319367384805
STAT,1931,22,50-100,1953,0.8703530946747241
STAT,1880,34,45-49,1914,1.8534237243248664
STAT,1939,15,50-100,1954,0.3835135521368697
STAT,1929,39,35-39,1968,3.160450051359129
STAT,1834,23,na,1857,1907.647491968563
SIM,1843,12,na,1855,2404
STAT,1873,51,50-100,1924,0.01569474819241041
SIM,1882,37,25-29,1919,5
STAT,1937,30,15-19,1967,0.12982881104053354
SIM,1913,24,20-24,1937,122
STAT,1866,29,45-49,1895,1.037295021841644
STAT,1818,37,40-44,1855,16.459009752923265
STAT,1813,43,45-49,1856,5.19745197014714
STAT,1877,29,20-24,1906,12.32416674490079
SIM,1876,23,40-44,1899,3
STAT,1842,42,50-100,1884,0.8571466860855907
SIM,1822,66,na,1888,888
STAT,1848,44,15-19,1892,0.010589937669779722
STAT,1944,28,20-24,1972,20.118949867308153
STAT,1856,52,30-34,1908,0.004741446225350017
STAT,1895,42,35-39,1937,0.16716407271460612
STAT,1849,23,30-34,1872,16.59933351085462
STAT,1852,47,45-49,1899,0.189235628227648
STAT,1901,70,na,1971,2404.200370597331
SIM,1815,46,25-29,1861,1
STAT,1831,34,25-29,1865,9.140030898201305
SIM,1926,33,50-100,1959,4
STAT,1802,53,40-44,1855,0.027341822407442474
STAT,1854,41,40-44,1895,1.7292830010245546
STAT,1894,16,45-49,1910,0.08592790389122136
SIM,1775,79,na,1854,169
STAT,1868,23,40-44,1891,2.0241213741160267
STAT,1905,24,20-24,1929,100.89624112153442
SIM,1829,28,25-29,1857,49
STAT,1874,37,25-29,1911,2.9988619485139894
STAT,1887,32,35-39,1919,11.576587277301398
STAT,1794,89,na,1883,39.95578085945027
STAT,1828,51,35-39,1879,0.006633000112789491
STAT,1876,27,na,1903,2514.0337066435013
SIM,1846,17,na,1863,2318
STAT,1822,46,20-24,1868,0.017363039903527614
STAT,1884,78,na,1962,1014.7474467159664
STAT,1855,39,40-44,1894,3.35927925159156
STAT,1875,52,35-39,1927,0.008965791739249454
STAT,1806,101,na,1907,0.20276193873097378
STAT,1831,23,15-19,1854,7.590695974024063
STAT,1790,75,na,1865,431.0606531401866
STAT,1885,28,40-44,1913,3.0380895640422327
STAT,1834,51,40-44,1885,0.007409573217835558
STAT,1924,35,40-44,1959,1.8040850686970349
SIM,1843,30,20-24,1873,4
STAT,1883,26,40-44,1909,3.00874583898609
SIM,1845,91,na,1936,27
SIM,1856,6,na,1862,2929
SIM,1875,42,35-39,1917,4
STAT,1822,34,50-100,1856,2.096917640734511
STAT,1840,43,50-100,1883,0.7829257738201938
STAT,1939,29,na,1968,3838.0184287478355
SIM,1937,20,15-19,1957,5
SIM,1935,16,20-24,1951,170
STAT,1889,28,50-100,1917,0.8032668011631809
SIM,1895,34,na,1929,3250
SIM,1939,22,15-19,1961,6
SIM,1826,40,na,1866,1658
SIM,1874,27,25-29,1901,39
STAT,1850,34,35-39,1884,7.8050172388852594
STAT,1859,34,25-29,1893,8.27335813439052
SIM,1857,23,30-34,1880,19
SIM,1821,43,45-49,1864,2
STAT,1858,54,30-34,1912,0.0046832307708717475
SIM,1908,18,na,1926,4107
STAT,1857,22,20-24,1879,63.38337938939543
STAT,1881,73,na,1954,1171.4536073142338
STAT,1867,100,na,1967,5.534222139987867
SIM,1937,28,25-29,1965,14
SIM,1904,21,45-49,1925,1
STAT,1929,28,25-29,1957,83.97821007760281
SIM,1835,25,45-49,1860,1
STAT,1888,19,25-29,1907,6.797538630680314
SIM,1829,45,na,1874,1317
STAT,1929,20,15-19,1949,6.9068047166233635
STAT,1843,40,20-24,1883,0.13542808230175973
SIM,1865,22,20-24,1887,82
SIM,1826,37,40-44,1863,7
SIM,1850,23,20-24,1873,66
STAT,1874,37,30-34,1911,5.551084913891424
STAT,1877,16,45-49,1893,0.06928657772402456
STAT,1894,25,35-39,1919,12.747399383418346
STAT,1919,19,20-24,1938,152.06893702558713
SIM,1937,31,na,1968,4443
STAT,1851,108,na,1959,0.003602727863814885
STAT,1940,15,30-34,1955,12.632072277244076
SIM,1893,28,40-44,1921,5
STAT,1856,27,50-100,1883,0.5308268335838461
STAT,1857,51,na,1908,1723.6772458783214
SIM,1835,34,35-39,1869,15
SIM,1915,23,40-44,1938,2
STAT,1871,31,50-100,1902,0.9296724657849988
SIM,1941,25,40-44,1966,7
STAT,1918,27,na,1945,4068.370223298468
SIM,1882,6,na,1888,2562
SIM,1934,32,35-39,1966,6
STAT,1821,53,na,1874,1242.4216619050765
SIM,1899,64,na,1963,2598
STAT,1871,44,45-49,1915,1.4919773136168966
STAT,1907,23,40-44,1930,3.1116652367235305
STAT,1915,16,50-100,1931,0.08021318298719365
SIM,1852,88,na,1940,75
SIM,1895,35,45-49,1930,6
STAT,1892,18,30-34,1910,2.032521528790695
STAT,1884,40,15-19,1924,0.014078660576084551
STAT,1910,47,na,1957,3495.9157606150056
STAT,1804,53,45-49,1857,0.04170623551564156
STAT,1874,48,40-44,1922,0.17607485010071797
STAT,1930,21,45-49,1951,1.474563168119122
STAT,1867,44,25-29,1911,0.6067126171075025
STAT,1795,104,na,1899,0.011932664399554788
STAT,1907,35,40-44,1942,1.4287127970948343
SIM,1886,40,45-49,1926,2
SIM,1927,19,20-24,1946,194
SIM,1937,25,20-24,1962,24
STAT,1842,23,20-24,1865,67.67284188607876
STAT,1925,1,na,1926,5146.832557660145
SIM,1840,33,50-100,1873,1
STAT,1766,93,na,1859,9.015872102843856
SIM,1835,23,25-29,1858,65
SIM,1865,39,45-49,1904,3
STAT,1874,34,15-19,1908,0.14705648930571724
STAT,1808,71,na,1879,556.5581359370116
SIM,1835,22,35-39,1857,11
STAT,1887,35,45-49,1922,2.30046345287376
STAT,1844,37,15-19,1881,0.04598319029054474
SIM,1826,56,na,1882,1359
SIM,1895,50,na,1945,3005
SIM,1917,20,40-44,1937,9
STAT,1882,44,20-24,1926,0.15571004051764306
STAT,1874,22,20-24,1896,71.77662487470377
STAT,1926,32,35-39,1958,11.272621704350987
STAT,1845,66,na,1911,1280.6355668330427
SIM,1837,96,na,1933,4
STAT,1856,52,25-29,1908,0.002821356404421408
SIM,1880,28,30-34,1908,35
SIM,1925,46,na,1971,4709
SIM,1863,28,25-29,1891,4
STAT,1846,45,25-29,1891,0.04160167004105419
STAT,1855,28,25-29,1883,33.934765556804756
STAT,1827,34,35-39,1861,14.18067808856347
STAT,1941,21,20-24,1962,117.27176190842187
SIM,1854,52,na,1906,1831
STAT,1924,47,35-39,1971,0.1566014004935491
STAT,1943,29,50-100,1972,1.0804546171019576
STAT,1922,32,na,1954,4360.255191903083
SIM,1826,47,45-49,1873,1
SIM,1929,15,15-19,1944,65
STAT,1870,33,na,1903,2369.736329032324
SIM,1864,73,na,1937,1035
STAT,1909,20,40-44,1929,3.206116517453052
SIM,1915,35,40-44,1950,2
STAT,1881,18,25-29,1899,5.5743231255381325
SIM,1933,15,35-39,1948,6
SIM,1882,35,35-39,1917,3
SIM,1824,30,na,1854,1708
STAT,1846,34,15-19,1880,0.11787454704176939
SIM,1883,65,na,1948,1725
SIM,1884,10,na,1894,2839
SIM,1895,53,na,1948,2904
STAT,1860,54,40-44,1914,0.00847425946494696
SIM,1828,32,45-49,1860,2
SIM,1861,24,35-39,1885,13
STAT,1941,24,na,1965,3847.4897076101606
SIM,1952,15,45-49,1967,4
STAT,1953,12,na,1965,4847.198699231917
STAT,1860,43,30-34,1903,0.9447226632810275
STAT,1884,51,25-29,1935,0.003591996523866963
SIM,1894,19,15-19,1913,8
SIM,1850,78,na,1928,395
STAT,1829,33,na,1862,1878.717861638171
STAT,1919,42,45-49,1961,0.18404883132826635
STAT,1856,54,20-24,1910,5.746782850072177E-4
SIM,1899,67,na,1966,2474
STAT,1880,46,15-19,1926,4.300289596068455E-4
STAT,1839,54,na,1893,1445.1336119894918
STAT,1914,25,30-34,1939,40.574845034025444
STAT,1944,15,45-49,1959,0.548764306080639
STAT,1876,33,40-44,1909,4.549145839480191
SIM,1878,38,50-100,1916,2
STAT,1853,24,35-39,1877,5.698613634222966
STAT,1888,68,na,1956,1871.6185941519836
SIM,1815,44,35-39,1859,6
STAT,1882,31,15-19,1913,0.14211409137762507
SIM,1915,27,50-100,1942,4
SIM,1828,44,45-49,1872,4
STAT,1898,35,20-24,1933,1.0735259402668762
SIM,1852,27,40-44,1879,5
STAT,1885,37,50-100,1922,1.2495705498087075
STAT,1925,15,35-39,1940,5.195584530909855
STAT,1874,35,35-39,1909,7.436849395984832
SIM,1884,33,40-44,1917,7
STAT,1920,46,na,1966,4154.590759414221
STAT,1781,82,na,1863,150.4550723030396
SIM,1890,42,25-29,1932,4
STAT,1831,23,45-49,1854,1.60446120090372
STAT,1899,15,na,1914,3544.5877439818405
SIM,1833,27,30-34,1860,29
SIM,1862,87,na,1949,87
SIM,1882,37,30-34,1919,8
SIM,1874,91,na,1965,126
SIM,1831,27,na,1858,1893
SIM,1876,39,20-24,1915,1
STAT,1818,47,15-19,1865,9.084007748059564E-4
STAT,1819,58,na,1877,1306.8986995733476
STAT,1815,44,na,1859,1609.8954130151697
STAT,1877,12,na,1889,2740.7241432854084
STAT,1809,54,40-44,1863,0.042959084904181565
STAT,1833,33,15-19,1866,0.12034523196720659
SIM,1887,79,na,1966,1143
STAT,1880,33,50-100,1913,0.9780973025338919
STAT,1938,19,30-34,1957,12.256909579809113
SIM,1946,19,30-34,1965,25
SIM,1884,45,40-44,1929,1
STAT,1859,48,45-49,1907,0.18985681774691998
STAT,1870,28,20-24,1898,11.65815709056925
STAT,1917,15,50-100,1932,0.08265722839972317
STAT,1844,25,na,1869,2081.9156951240416
STAT,1766,90,na,1856,39.2979894
SIM,1908,22,50-100,1930,3
STAT,1896,63,na,1959,2501.7791334792973
STAT,1876,45,40-44,1921,0.1821450937151156
SIM,1815,46,30-34,1861,1
SIM,1927,16,na,1943,4550
STAT,1841,43,20-24,1884,0.12029671864732691
STAT,1883,29,45-49,1912,1.103431844145204
SIM,1876,24,25-29,1900,81
STAT,1846,34,45-49,1880,1.4434071244749094
STAT,1869,76,na,1945,933.1058478005571
STAT,1946,24,30-34,1970,32.60955345937673
STAT,1822,49,25-29,1871,0.07975656570828597
SIM,1856,38,50-100,1894,1
STAT,1862,54,20-24,1916,6.231873878381228E-4
SIM,1948,15,na,1963,4196
SIM,1848,38,30-34,1886,7
STAT,1868,35,na,1903,2317.388700986434
STAT,1911,21,35-39,1932,9.136434429156658
SIM,1915,21,15-19,1936,6
STAT,1852,32,40-44,1884,3.617273892213795
STAT,1854,40,na,1894,1786.7670445381868
STAT,1928,42,na,1970,4829.353420453174
SIM,1874,72,na,1946,1252
STAT,1858,16,35-39,1874,0.5216180805215948
SIM,1905,29,na,1934,3541
STAT,1815,40,15-19,1855,0.048508160050803883
STAT,1867,50,na,1917,2091.7910368047214
SIM,1871,31,35-39,1902,12
STAT,1835,32,40-44,1867,4.11538595645207
STAT,1820,90,na,1910,43.421798429085676
SIM,1904,47,50-100,1951,1
STAT,1906,40,50-100,1946,0.11003068862421733
SIM,1876,35,35-39,1911,9
STAT,1840,22,50-100,1862,0.3731749102691738
SIM,1885,35,na,1920,2421
SIM,1923,42,na,1965,4236
STAT,1807,49,na,1856,1459.9234483032983
STAT,1907,43,na,1950,3448.837095400212
STAT,1815,51,25-29,1866,0.009287588641755511
STAT,1869,17,na,1886,2521.9363504912862
STAT,1846,47,20-24,1893,0.00854145429279555
STAT,1882,42,25-29,1924,0.637439235473047
SIM,1883,49,50-100,1932,1
STAT,1794,105,na,1899,0.005811841322774179
SIM,1885,75,na,1960,1226
SIM,1848,36,40-44,1884,7
STAT,1858,31,50-100,1889,0.7489867125701615
SIM,1843,32,40-44,1875,4
STAT,1777,77,na,1854,382.0
SIM,1859,26,45-49,1885,3
STAT,1907,21,15-19,1928,4.956484088896524
STAT,1835,44,40-44,1879,1.95804606834055
SIM,1840,63,na,1903,1177
SIM,1935,19,25-29,1954,83
STAT,1861,34,40-44,1895,3.6244155130933127
STAT,1831,27,30-34,1858,24.9184222779051
STAT,1852,33,25-29,1885,8.45514701634826
STAT,1799,80,na,1879,254.83693472317543
STAT,1847,51,50-100,1898,0.011833670607995403
STAT,1809,96,na,1905,4.380836586721407
SIM,1813,86,na,1899,49
STAT,1847,15,20-24,1862,17.45995875867225
STAT,1898,38,25-29,1936,0.8530697303081218
SIM,1818,45,na,1863,1447
STAT,1887,23,45-49,1910,0.7946684352886808
SIM,1860,33,25-29,1893,13
STAT,1863,22,45-49,1885,0.6361505579413304
STAT,1937,35,15-19,1972,0.01962091100232687
SIM,1897,60,na,1957,2610
STAT,1927,19,25-29,1946,54.669104979765336
SIM,1836,58,na,1894,1551
STAT,1844,22,na,1866,2068.697140690329
SIM,1871,22,45-49,1893,1
STAT,1955,15,20-24,1970,183.66415360715303
STAT,1826,42,40-44,1868,1.8433219204950384
STAT,1962,3,na,1965,5139.9035146669385
STAT,1862,101,na,1963,1.7328304515310207
STAT,1929,25,20-24,1954,23.389234182997644
SIM,1895,23,45-49,1918,1
SIM,1939,24,35-39,1963,13
STAT,1933,13,na,1946,5400.813092271829
STAT,1862,18,15-19,1880,5.867615369084086
STAT,1878,40,45-49,1918,1.6052600249566846
SIM,1851,43,25-29,1894,1
SIM,1824,33,20-24,1857,5
STAT,1883,24,20-24,1907,68.54720387913423
STAT,1815,53,20-24,1868,0.0018588750828725856
STAT,1831,38,40-44,1869,3.8047237158389393
STAT,1900,46,40-44,1946,0.13693430254692548
STAT,1911,47,25-29,1958,0.051224266964083665
STAT,1841,30,15-19,1871,0.1302519058760315
SIM,1950,13,na,1963,4737
STAT,1946,25,20-24,1971,20.763908744578334
STAT,1870,17,40-44,1887,0.18413996359573204
SIM,1817,60,na,1877,1028
SIM,1843,44,40-44,1887,2
STAT,1851,51,na,1902,1784.9001717570336
SIM,1842,67,na,1909,1201
STAT,1832,53,20-24,1885,5.052910115521296E-4
STAT,1850,31,50-100,1881,0.728502235369818
STAT,1872,28,30-34,1900,25.65609252721435
STAT,1855,65,na,1920,1310.0560312351197
SIM,1820,46,50-100,1866,1
SIM,1845,32,45-49,1877,6
SIM,1910,34,45-49,1944,1
STAT,1891,32,na,1923,3013.905938537232
STAT,1818,89,na,1907,53.53703963423401
STAT,1833,78,na,1911,513.097830211084
STAT,1928,21,50-100,1949,0.8405162236993599
SIM,1867,30,30-34,1897,1
SIM,1923,31,20-24,1954,2
STAT,1902,34,45-49,1936,1.4281865590490788
STAT,1857,37,25-29,1894,2.2939107837471675
STAT,1873,30,50-100,1903,0.9552437379229308
STAT,1796,69,na,1865,687.8466094147107
SIM,1851,47,na,1898,1805
STAT,1896,43,50-100,1939,0.09813076199808102
SIM,1870,18,15-19,1888,5
STAT,1890,53,na,1943,2642.675648161591
SIM,1889,39,30-34,1928,11
STAT,1868,35,35-39,1903,6.957074334870551
SIM,1848,43,na,1891,1831
SIM,1857,17,na,1874,2256
STAT,1872,39,40-44,1911,4.4306428604631325
SIM,1894,49,na,1943,2980
STAT,1846,22,45-49,1868,0.6152896872200533
STAT,1859,48,15-19,1907,3.217909456739909E-4
STAT,1843,43,25-29,1886,0.5269527277019275
STAT,1899,48,50-100,1947,0.19110281120744707
SIM,1855,15,20-24,1870,21
STAT,1899,17,35-39,1916,0.76653004629711
STAT,1902,46,45-49,1948,0.19206150026194888
SIM,1812,45,na,1857,1373
SIM,1885,25,35-39,1910,16
STAT,1907,64,na,1971,2955.703332414199
STAT,1826,43,25-29,1869,0.5171973825059849
STAT,1903,50,na,1953,3167.4053723130587
STAT,1866,26,40-44,1892,2.8284094729790454
SIM,1896,16,na,1912,3437
STAT,1776,92,na,1868,10.351557588267315
STAT,1911,36,15-19,1947,0.019010592006965518
STAT,1929,36,30-34,1965,2.388712208737408
STAT,1837,32,45-49,1869,1.4577504151073024
SIM,1887,39,na,1926,2802
SIM,1861,22,na,1883,2582
STAT,1842,15,na,1857,2339.0330305015214
STAT,1859,30,30-34,1889,14.431905695181214
STAT,1915,31,20-24,1946,2.545342402945403
STAT,1893,34,25-29,1927,13.141942469115003
STAT,1872,24,15-19,1896,3.3519042974764064
STAT,1841,41,25-29,1882,0.49904189597462095
SIM,1860,32,40-44,1892,7
SIM,1907,22,30-34,1929,41
SIM,1794,77,na,1871,319
SIM,1872,25,na,1897,2474
STAT,1816,38,45-49,1854,6.103944208835056
STAT,1881,40,50-100,1921,1.0524683223553513
STAT,1853,36,50-100,1889,1.0402060228482717
STAT,1926,22,50-100,1948,0.815499904497364
STAT,1827,69,na,1896,948.5016586328245
SIM,1931,21,na,1952,4604
STAT,1841,49,35-39,1890,0.10121109979509794
SIM,1891,24,20-24,1915,133
STAT,1915,42,30-34,1957,0.13134326237489757
STAT,1897,17,50-100,1914,0.06682671507597791
SIM,1854,34,45-49,1888,2
SIM,1891,29,45-49,1920,2
STAT,1851,17,30-34,1868,1.5987628064346113
SIM,1861,28,20-24,1889,15
STAT,1833,21,20-24,1854,90.40263576234574
STAT,1930,34,20-24,1964,3.206373647575877
STAT,1859,45,40-44,1904,0.14086974934026297
STAT,1913,21,45-49,1934,1.1156401094769632
SIM,1878,20,35-39,1898,8
SIM,1928,23,20-24,1951,185
SIM,1920,17,15-19,1937,59
STAT,1908,19,15-19,1927,8.928751484591798
SIM,1938,16,na,1954,3906
STAT,1891,37,30-34,1928,6.731245753198056
STAT,1861,10,na,1871,2341.961234528733
STAT,1831,74,na,1905,747.7990560706763
STAT,1822,110,na,1932,1.6067512423659753E-4
SIM,1863,24,15-19,1887,3
SIM,1913,9,na,1922,4268
STAT,1857,91,na,1948,46.168120350516006
STAT,1897,42,15-19,1939,0.0013064772912505993
SIM,1840,60,na,1900,1281
STAT,1878,50,na,1928,2319.2213225721944
SIM,1879,35,50-100,1914,2
SIM,1916,32,na,1948,3944
STAT,1876,48,45-49,1924,0.24548554975729187
STAT,1865,24,na,1889,2184.710543297321
SIM,1878,65,na,1943,1888
STAT,1915,45,35-39,1960,0.13319778291049644
STAT,1879,75,na,1954,1097.7720343891629
STAT,1875,61,na,1936,1956.4813539773204
SIM,1874,51,na,1925,2226
STAT,1838,28,25-29,1866,39.25269486263458
STAT,1840,19,20-24,1859,16.323376753422473
STAT,1917,42,na,1959,3955.2265125727477
STAT,1909,23,45-49,1932,1.0632292869900348
STAT,1855,24,15-19,1879,2.9449261620232896
SIM,1876,28,40-44,1904,5
SIM,1863,35,25-29,1898,3
STAT,1868,24,25-29,1892,55.429073333504704
STAT,1888,16,20-24,1904,21.433479045719626
STAT,1876,86,na,1962,397.98722793414254
STAT,1892,16,40-44,1908,0.23442722598041718
STAT,1904,36,50-100,1940,0.38930856213748727
STAT,1912,17,15-19,1929,9.361711200106635
SIM,1867,45,40-44,1912,1
SIM,1900,24,40-44,1924,4
STAT,1905,57,na,1962,3104.7256506521926
STAT,1824,43,15-19,1867,0.016681515806759303
STAT,1887,27,na,1914,2728.1143961299836
STAT,1831,36,20-24,1867,0.686268826300437
SIM,1921,21,45-49,1942,1
STAT,1891,48,40-44,1939,0.12043650100841642
SIM,1854,38,30-34,1892,10
STAT,1833,40,50-100,1873,0.8691570038836838
SIM,1889,37,40-44,1926,2
STAT,1885,23,35-39,1908,5.920875655500423
SIM,1913,27,25-29,1940,4
STAT,1845,54,45-49,1899,0.011027408994653242
SIM,1841,21,20-24,1862,71
SIM,1896,16,20-24,1912,30
STAT,1787,92,na,1879,13.447081753239715
STAT,1850,33,15-19,1883,0.11090042558361195
SIM,1912,36,50-100,1948,1
STAT,1824,46,30-34,1870,0.11434757072012759
STAT,1853,28,20-24,1881,10.295449936162923
SIM,1829,25,20-24,1854,1
SIM,1873,87,na,1960,169
STAT,1856,8,na,1864,2325.247438213749
SIM,1913,38,35-39,1951,4
SIM,1928,34,30-34,1962,3
SIM,1906,31,20-24,1937,4
SIM,1861,25,na,1886,2559
SIM,1863,39,40-44,1902,5
STAT,1889,33,20-24,1922,3.391867913592831
SIM,1826,44,40-44,1870,3
STAT,1851,15,40-44,1866,0.18564504993026784
STAT,1940,24,50-100,1964,0.6833508328062752
STAT,1896,36,25-29,1932,3.897967505915033
STAT,1846,38,30-34,1884,3.938950689611561
STAT,1911,49,15-19,1960,3.536387369770864E-4
STAT,1864,21,na,1885,2195.555948269982
STAT,1845,18,15-19,1863,5.82617182804343
STAT,1878,53,na,1931,2249.6552449236356
STAT,1765,110,na,1875,6.70611818528097E-4
STAT,1862,45,50-100,1907,0.21540534820412466
SIM,1893,35,40-44,1928,8
STAT,1885,35,40-44,1920,4.497642339467027
SIM,1815,93,na,1908,2
STAT,1834,53,30-34,1887,0.004026822969629408
STAT,1820,36,45-49,1856,5.127695051253489
SIM,1946,15,15-19,1961,45
STAT,1803,56,na,1859,1219.100259839701
STAT,1877,48,50-100,1925,0.2566006881294586
SIM,1906,33,40-44,1939,6
SIM,1895,20,40-44,1915,3
STAT,1784,111,na,1895,1.0021501125596739E-4
STAT,1865,47,30-34,1912,0.08920954648528963
STAT,1922,24,15-19,1946,6.189760434074862
SIM,1884,48,45-49,1932,1
STAT,1899,12,na,1911,3607.6869931281094
STAT,1839,29,50-100,1868,0.5482082907989343
STAT,1848,45,35-39,1893,0.10991159074210641
STAT,1872,24,45-49,1896,0.7084989851849238
SIM,1850,28,45-49,1878,1
SIM,1895,39,30-34,1934,13
SIM,1853,18,15-19,1871,9
STAT,1823,52,50-100,1875,0.02185892725497828
STAT,1842,28,45-49,1870,1.0690255966116706
STAT,1860,51,50-100,1911,0.012560572458237215
STAT,1870,34,50-100,1904,0.9059144560335509
STAT,1877,28,na,1905,2516.2582260244913
SIM,1886,17,na,1903,2841
STAT,1891,34,15-19,1925,0.1783207038757768
STAT,1895,40,45-49,1935,2.0121449072771327
STAT,1810,53,45-49,1863,0.042594293355995926
STAT,1856,41,15-19,1897,0.011108999054203681
SIM,1930,26,50-100,1956,1
STAT,1890,21,50-100,1911,0.510187673209808
SIM,1838,19,30-34,1857,1
SIM,1839,49,45-49,1888,1
SIM,1884,50,na,1934,2295
SIM,1839,47,na,1886,1667
SIM,1916,19,15-19,1935,42
SIM,1835,33,na,1868,1787
STAT,1887,39,30-34,1926,6.031100826785388
STAT,1887,48,20-24,1935,0.013545239040650619
STAT,1920,27,20-24,1947,20.434541295587078
STAT,1941,24,25-29,1965,97.31929889794849
SIM,1837,34,15-19,1871,3
STAT,1829,45,25-29,1874,0.0478321974284015
SIM,1906,14,na,1920,3831
SIM,1830,30,35-39,1860,18
SIM,1883,18,30-34,1901,2
STAT,1830,89,na,1919,66.45603266345823
STAT,1866,28,30-34,1894,23.612008948467324
SIM,1897,33,20-24,1930,4
SIM,1878,35,45-49,1913,3
STAT,1842,26,25-29,1868,41.320014341946546
STAT,1938,15,15-19,1953,45.879664752853785
SIM,1862,66,na,1928,1396
SIM,1850,26,25-29,1876,53
STAT,1863,76,na,1939,847.4068308683005
STAT,1831,36,50-100,1867,1.0930308121210415
STAT,1871,44,15-19,1915,0.013766804321711576
SIM,1864,14,na,1878,2481
STAT,1896,25,15-19,1921,0.6154449251422538
SIM,1911,54,na,1965,3482
STAT,1892,57,na,1949,2569.4376017614263
STAT,1867,41,20-24,1908,0.15278849418720797
STAT,1865,42,25-29,1907,0.5938429953501901
SIM,1905,18,30-34,1923,3
STAT,1864,18,25-29,1882,5.286092117751478
STAT,1829,34,15-19,1863,0.12752749707986435
STAT,1844,22,35-39,1866,5.645986668679564
STAT,1897,46,30-34,1943,0.07469231144773615
SIM,1887,29,25-29,1916,61
STAT,1857,39,45-49,1896,1.5722635037141344
STAT,1852,35,45-49,1887,1.6485533537592547
SIM,1915,1,na,1916,4737
STAT,1948,22,15-19,1970,6.235858414652949
STAT,1840,24,25-29,1864,51.636721968404906
STAT,1842,16,50-100,1858,0.04962819846813152
STAT,1830,43,15-19,1873,0.011743908349347031
SIM,1827,41,na,1868,1563
STAT,1875,16,35-39,1891,0.5759153118611323
SIM,1856,32,20-24,1888,4
SIM,1829,85,na,1914,73
SIM,1871,42,50-100,1913,1
STAT,1932,31,na,1963,5130.328045014316
SIM,1874,26,40-44,1900,1
SIM,1879,16,15-19,1895,7
SIM,1913,23,30-34,1936,41
SIM,1796,81,na,1877,155
SIM,1804,93,na,1897,24
SIM,1888,24,na,1912,2761
SIM,1902,21,35-39,1923,11
STAT,1850,47,40-44,1897,0.12817709976136193
STAT,1826,40,20-24,1866,0.13485909495609205
STAT,1887,20,40-44,1907,2.3962842516221
SIM,1918,16,20-24,1934,29
SIM,1849,84,na,1933,331
STAT,1849,24,15-19,1873,3.052298878372592
SIM,1866,40,na,1906,2320
SIM,1860,30,20-24,1890,3
SIM,1891,27,25-29,1918,73
STAT,1835,47,15-19,1882,3.142721425510813E-4
STAT,1832,37,na,1869,1795.5532460718446
STAT,1863,42,50-100,1905,0.9437818282085
SIM,1907,25,35-39,1932,25
STAT,1886,19,15-19,1905,6.37383387901345
STAT,1868,39,20-24,1907,0.7435306010124284
STAT,1790,96,na,1886,1.7025083378408894
STAT,1931,17,25-29,1948,57.84786520726258
SIM,1860,35,45-49,1895,1
SIM,1888,26,50-100,1914,1
SIM,1835,27,40-44,1862,8
SIM,1840,19,25-29,1859,7
SIM,1838,22,na,1860,1871
STAT,1861,37,45-49,1898,1.6804459819706226
STAT,1935,4,na,1939,5626.975757544489
STAT,1894,18,40-44,1912,0.23937990098238732
SIM,1935,28,15-19,1963,1
SIM,1900,33,30-34,1933,33
STAT,1931,28,35-39,1959,19.75858909029956
STAT,1848,32,20-24,1880,2.450346131339154
SIM,1859,23,40-44,1882,2
STAT,1879,29,25-29,1908,44.7859340183607
SIM,1797,66,na,1863,768
SIM,1922,25,30-34,1947,57
STAT,1766,109,na,1875,0.004330238759911828
STAT,1910,40,35-39,1950,0.19629803325820006
SIM,1904,34,15-19,1938,1
STAT,1879,52,50-100,1931,0.016019157857771592
STAT,1819,55,na,1874,1386.9005087000521
STAT,1815,41,na,1856,1669.6014439382168
STAT,1833,34,35-39,1867,8.466169556698922
SIM,1834,40,20-24,1874,2
SIM,1876,39,na,1915,2689
STAT,1849,19,40-44,1868,0.17273618539984398
SIM,1841,34,35-39,1875,14
STAT,1875,22,50-100,1897,0.42696090313953733
STAT,1846,44,50-100,1890,0.7452940184498168
SIM,1857,24,15-19,1881,3
STAT,1846,49,40-44,1895,0.1198726251738566
STAT,1878,42,35-39,1920,1.9204656242313836
SIM,1930,4,na,1934,5853
STAT,1914,19,50-100,1933,0.07864871899297528
STAT,1862,50,35-39,1912,0.007583542083336232
STAT,1827,27,40-44,1854,9.993242529688514
SIM,1865,37,25-29,1902,5
STAT,1875,54,30-34,1929,0.006060996328623485
STAT,1905,23,30-34,1928,26.162537666914396
STAT,1841,34,30-34,1875,15.319674104599512
STAT,1930,24,na,1954,4741.486010895379
SIM,1875,54,na,1929,2051
SIM,1923,34,25-29,1957,16
SIM,1871,40,na,1911,2134
SIM,1910,31,40-44,1941,4
SIM,1858,43,40-44,1901,4
STAT,1830,43,45-49,1873,1.2727459780036596
STAT,1894,29,20-24,1923,15.284198619439476
STAT,1873,52,30-34,1925,0.006123648035678739
STAT,1866,65,na,1931,1590.2043372992416
STAT,1857,34,20-24,1891,2.135139891410077
STAT,1921,29,50-100,1950,1.123901617564926
STAT,1852,30,20-24,1882,2.301945484699123
STAT,1911,44,20-24,1955,0.016982340705689734
STAT,1908,19,45-49,1927,0.09828012853942325
STAT,1827,38,20-24,1865,0.9759984414503186
STAT,1851,54,45-49,1905,0.011643744384310296
SIM,1939,21,30-34,1960,1
SIM,1835,38,20-24,1873,1
SIM,1873,10,na,1883,2650
SIM,1815,56,na,1871,1196
SIM,1849,33,50-100,1882,1
STAT,1837,41,35-39,1878,1.443037413901365
STAT,1877,68,na,1945,1616.9643742230362
STAT,1883,27,25-29,1910,42.34226021580579
STAT,1899,21,50-100,1920,0.5713907307374839
STAT,1826,45,45-49,1871,0.18935913763638565
STAT,1845,47,50-100,1892,0.1910041668624602
STAT,1933,25,40-44,1958,6.317070103979004
SIM,1843,47,45-49,1890,1
STAT,1822,78,na,1900,454.301218038341
STAT,1856,10,na,1866,2288.7920621543203
SIM,1929,17,35-39,1946,8
STAT,1904,44,20-24,1948,0.015906459457833134
STAT,1893,31,20-24,1924,3.5124495846020602
STAT,1913,45,50-100,1958,0.22627230455124747
STAT,1856,41,45-49,1897,1.2039376879733863
STAT,1858,52,35-39,1910,0.006927717735149474
SIM,1822,34,25-29,1856,1
STAT,1893,36,45-49,1929,2.5922807959468606
SIM,1906,54,na,1960,3188
STAT,1902,31,40-44,1933,6.264494174056724
SIM,1865,34,20-24,1899,5
SIM,1902,40,na,1942,3417
STAT,1850,36,30-34,1886,4.114925028226985
STAT,1915,34,25-29,1949,9.52348001530026
SIM,1846,28,25-29,1874,60
SIM,1926,25,45-49,1951,2
SIM,1833,25,40-44,1858,6
SIM,1824,36,25-29,1860,4
STAT,1908,46,na,1954,3413.516477506513
STAT,1904,32,na,1936,3518.621710242297
SIM,1899,27,na,1926,3275
SIM,1948,17,45-49,1965,2
STAT,1859,33,35-39,1892,8.215854373580553
STAT,1880,32,na,1912,2558.196112171184
STAT,1788,77,na,1865,368.70623850503665
SIM,1845,41,35-39,1886,2
STAT,1911,32,na,1943,3756.614277122832
STAT,1924,23,40-44,1947,4.035376409768777
SIM,1932,23,40-44,1955,4
STAT,1872,37,20-24,1909,0.7881387594923741
STAT,1856,110,na,1966,0.0016474067084064831
STAT,1835,47,45-49,1882,0.18542072017061514
STAT,1841,45,40-44,1886,0.13027470733946803
SIM,1930,34,25-29,1964,15
SIM,1838,81,na,1919,264
STAT,1889,46,35-39,1935,0.17692099781548565
SIM,1897,46,35-39,1943,1
STAT,1817,48,na,1865,1396.6366619981834
STAT,1922,34,25-29,1956,10.60357204601191
STAT,1918,25,45-49,1943,1.8889385380712953
STAT,1861,37,15-19,1898,0.04733651216385201
STAT,1913,46,20-24,1959,0.01103121750963044
STAT,1940,7,na,1947,4123.537660750445
SIM,1836,55,na,1891,1612
SIM,1873,4,na,1877,2759
STAT,1859,22,25-29,1881,48.389394592835686
STAT,1881,25,25-29,1906,42.00398404579763
STAT,1852,36,na,1888,1928.1958623061741
STAT,1941,21,50-100,1962,0.6939568870189488
SIM,1867,22,25-29,1889,84
SIM,1915,28,na,1943,4202
STAT,1849,27,25-29,1876,38.930106710321986
STAT,1842,24,35-39,1866,5.689361834894567
SIM,1899,33,25-29,1932,23
SIM,1874,26,50-100,1900,1
STAT,1864,42,50-100,1906,0.9571090101002214
SIM,1885,32,50-100,1917,2
SIM,1893,8,na,1901,3427
SIM,1799,86,na,1885,150
SIM,1945,23,20-24,1968,9
STAT,1924,26,45-49,1950,2.0592983927430106
SIM,1957,14,na,1971,5607
STAT,1817,52,40-44,1869,0.022549558709897395
STAT,1898,49,40-44,1947,0.1304432031827629
STAT,1854,62,na,1916,1398.8624668196012
STAT,1880,38,30-34,1918,5.685126419209097
STAT,1896,26,15-19,1922,0.6133954935415302
STAT,1943,20,40-44,1963,3.652280937473793
SIM,1846,35,25-29,1881,1
SIM,1860,37,40-44,1897,8
SIM,1874,24,20-24,1898,93
SIM,1914,15,30-34,1929,2
STAT,1930,37,25-29,1967,1.309863828914934
STAT,1828,108,na,1936,0.001008669261207608
SIM,1919,6,na,1925,4565
STAT,1833,106,na,1939,0.007973395567935018
STAT,1833,24,25-29,1857,51.94965714916053
SIM,1872,5,na,1877,2917
SIM,1897,36,25-29,1933,4
STAT,1878,90,na,1968,247.56291368489104
STAT,1850,72,na,1922,949.9556484883141
SIM,1781,88,na,1869,32
SIM,1928,37,35-39,1965,8
SIM,1874,35,na,1909,2439
SIM,1879,1,na,1880,3506
STAT,1889,49,30-34,1938,0.06737129455003471
STAT,1897,30,45-49,1927,2.397757097979984
SIM,1932,26,45-49,1958,2
STAT,1911,33,40-44,1944,3.8706027359852317
STAT,1925,19,15-19,1944,55.63289316701617
STAT,1815,44,30-34,1859,3.2614153723215766
SIM,1885,13,na,1898,2620
STAT,1866,24,20-24,1890,64.43866354072104
STAT,1906,15,30-34,1921,2.3776460614889277
STAT,1848,68,na,1916,1187.91855512878
SIM,1844,90,na,1934,26
STAT,1845,50,35-39,1895,0.0068233270441714865
SIM,1851,42,40-44,1893,2
SIM,1838,29,40-44,1867,7
STAT,1887,67,na,1954,1812.115430792478
SIM,1835,43,50-100,1878,5
STAT,1820,37,20-24,1857,1.8752443282756706
SIM,1939,29,35-39,1968,25
STAT,1882,35,30-34,1917,5.347249573374835
SIM,1910,31,35-39,1941,6
STAT,1829,73,na,1902,789.955101761308
SIM,1824,76,na,1900,498
STAT,1836,27,15-19,1863,0.3654424329398982
STAT,1865,49,45-49,1914,0.2139506816614814
STAT,1908,27,50-100,1935,0.9676300977746805
STAT,1829,35,15-19,1864,0.05048835724257796
STAT,1891,72,na,1963,1835.9566124582525
STAT,1844,21,35-39,1865,5.686818022078084
STAT,1939,31,30-34,1970,16.40836968175232
SIM,1929,17,50-100,1946,6
STAT,1919,33,50-100,1952,0.9064329162176467
SIM,1902,18,na,1920,3668
STAT,1809,45,50-100,1854,1.1295936578096673
SIM,1862,40,35-39,1902,5
STAT,1866,101,na,1967,3.108365410172924
STAT,1849,16,na,1865,2206.609128574431
STAT,1944,15,50-100,1959,0.4115732295604793
SIM,1852,21,35-39,1873,10
STAT,1909,36,20-24,1945,0.255697671082565
SIM,1829,29,30-34,1858,21
SIM,1894,15,35-39,1909,1
STAT,1900,30,30-34,1930,24.885601789956137
STAT,1855,24,45-49,1879,0.6224751699530646
STAT,1813,47,30-34,1860,0.2432859028361632
SIM,1877,18,na,1895,2625
STAT,1932,34,25-29,1966,12.51413138100777
SIM,1907,25,40-44,1932,8
STAT,1838,35,25-29,1873,2.606237030845764
SIM,1882,30,na,1912,2363
STAT,1835,21,25-29,1856,57.1296973709955
STAT,1931,16,35-39,1947,5.615164180461131
STAT,1871,58,na,1929,1998.4109639282353
SIM,1928,20,40-44,1948,8
STAT,1822,75,na,1897,598.5745539258589
STAT,1900,23,25-29,1923,80.69230557413081
SIM,1922,29,25-29,1951,92
STAT,1813,80,na,1893,266.0133230437472
STAT,1902,31,35-39,1933,14.628797162653932
SIM,1833,53,na,1886,1436
STAT,1875,17,25-29,1892,5.933125062890933
STAT,1840,29,30-34,1869,22.270760636837874
SIM,1831,40,na,1871,1636
STAT,1950,16,45-49,1966,0.6027581568716166
SIM,1839,44,na,1883,1731
STAT,1879,36,25-29,1915,3.0850235731694746
SIM,1889,22,45-49,1911,1
STAT,1898,30,20-24,1928,3.75898556233333
STAT,1886,15,35-39,1901,0.5952556270078229
SIM,1909,26,45-49,1935,2
STAT,1901,26,35-39,1927,13.81219806429275
STAT,1942,16,50-100,1958,0.3995673080106153
STAT,1862,91,na,1953,50.32188596753049
STAT,1856,17,15-19,1873,5.619413364105436
STAT,1873,35,na,1908,2459.8097387617727
STAT,1831,29,20-24,1860,11.029039629705995
STAT,1833,37,30-34,1870,4.413201792773927
SIM,1864,17,15-19,1881,9
SIM,1952,19,25-29,1971,93
STAT,1913,47,35-39,1960,0.1283783630260526
STAT,1889,36,25-29,1925,3.645664714757019
STAT,1880,30,35-39,1910,10.943780860083317
SIM,1808,86,na,1894,69
STAT,1854,48,30-34,1902,0.0731554297688607
STAT,1857,22,15-19,1879,3.0343306383444952
SIM,1841,24,25-29,1865,97
SIM,1844,13,na,1857,2439
STAT,1852,37,40-44,1889,3.545658534629989
SIM,1874,38,40-44,1912,8
SIM,1824,37,50-100,1861,2
SIM,1827,59,na,1886,1131
SIM,1848,80,na,1928,387
STAT,1792,106,na,1898,0.0020140019624260144
STAT,1847,19,30-34,1866,1.5330664075652998
SIM,1890,35,30-34,1925,9
SIM,1865,22,15-19,1887,3
STAT,1811,49,50-100,1860,0.6587511538968629
STAT,1844,78,na,1922,605.4636091075597
STAT,1857,11,na,1868,2245.6503787578363
SIM,1887,36,25-29,1923,4
SIM,1800,82,na,1882,147
SIM,1905,33,50-100,1938,1
STAT,1898,21,50-100,1919,0.5642666895214763
STAT,1820,74,na,1894,611.2210700186868
STAT,1876,49,20-24,1925,0.01237721545760027
STAT,1947,19,35-39,1966,4.819400069555655
SIM,1852,47,50-100,1899,1
STAT,1869,30,na,1899,2369.1899037781213
SIM,1823,44,30-34,1867,3
STAT,1855,25,15-19,1880,0.40870332223590894
STAT,1907,27,50-100,1934,0.9581868870677676
SIM,1825,58,na,1883,1171
STAT,1863,0,na,1863,3434.4665306524757
STAT,1915,44,35-39,1959,0.20618717565358752
SIM,1806,73,na,1879,655
STAT,1874,25,50-100,1899,0.6707994467117296
SIM,1924,15,30-34,1939,20
STAT,1913,15,na,1928,4047.2549828282663
SIM,1855,56,na,1911,1566
STAT,1851,53,30-34,1904,0.004832106112142508
STAT,1929,26,20-24,1955,23.31134803316826
SIM,1933,19,15-19,1952,53
STAT,1940,29,na,1969,3893.2428934043432
SIM,1824,34,35-39,1858,13
SIM,1841,37,30-34,1878,7
STAT,1842,77,na,1919,677.8603027331106
STAT,1884,43,40-44,1927,2.2537559052752387
STAT,1875,38,50-100,1913,1.279083874591585
SIM,1894,71,na,1965,2053
STAT,1885,22,35-39,1907,5.939227869617544
STAT,1890,41,15-19,1931,0.01730345084738603
STAT,1819,71,na,1890,786.9410834983286
SIM,1907,55,na,1962,3308
STAT,1877,28,15-19,1905,0.4783664910773175
SIM,1962,1,na,1963,5411
STAT,1867,46,45-49,1913,0.22666640946502878
STAT,1920,26,45-49,1946,1.9406291264825148
STAT,1967,1,na,1968,5016.483981199739
SIM,1900,17,na,1917,3629
SIM,1886,20,na,1906,2646
SIM,1919,33,20-24,1952,4
SIM,1858,48,40-44,1906,1
STAT,1919,12,na,1931,4468.266213288774
STAT,1920,15,20-24,1935,31.28743509806049
SIM,1867,41,na,1908,2098
STAT,1922,31,20-24,1953,2.823554274724095
SIM,1911,15,20-24,1926,36
STAT,1881,46,50-100,1927,0.24291746500314806
STAT,1891,33,15-19,1924,0.17910158679419957
STAT,1924,20,30-34,1944,34.80754240256224
STAT,1825,89,na,1914,62.99669153054672
SIM,1821,43,50-100,1864,4
STAT,1859,32,35-39,1891,8.250672210308052
STAT,1876,41,25-29,1917,0.6795279418400716
STAT,1794,86,na,1880,75.37910929336532
STAT,1862,97,na,1959,8.33746595184178
STAT,1807,92,na,1899,17.60117980776688
SIM,1890,81,na,1971,976
SIM,1920,37,na,1957,4007
SIM,1929,26,30-34,1955,53
STAT,1794,108,na,1902,3.630778745668698E-4
SIM,1882,44,25-29,1926,1
STAT,1920,37,25-29,1957,1.1001281860009158
STAT,1875,49,50-100,1924,0.251776807966914
SIM,1913,26,35-39,1939,24
SIM,1925,30,40-44,1955,9
STAT,1944,19,25-29,1963,47.548212348554934
SIM,1856,35,25-29,1891,3
SIM,1867,32,35-39,1899,12
SIM,1914,40,50-100,1954,2
STAT,1908,18,45-49,1926,0.09855114418593455
SIM,1895,30,45-49,1925,2
STAT,1896,25,45-49,1921,1.506119895562493
STAT,1887,30,45-49,1917,2.009444774780938
STAT,1897,18,15-19,1915,8.073735636625333
STAT,1866,28,na,1894,2237.742532063477
STAT,1916,15,30-34,1931,2.6512615524818854
STAT,1761,113,na,1874,2.222188900181908E-4
SIM,1849,68,na,1917,1280
SIM,1852,26,na,1878,2156
STAT,1798,76,na,1874,463.7214917984606
STAT,1829,34,45-49,1863,1.5616102243540502
STAT,1874,44,25-29,1918,0.6598181012712047
STAT,1946,4,na,1950,4508.6659445268015
STAT,1832,53,na,1885,1459.0028666502426
SIM,1854,103,na,1957,1
STAT,1907,20,30-34,1927,26.83997939018512
STAT,1905,26,35-39,1931,14.264982488971453
SIM,1884,22,25-29,1906,99
STAT,1864,25,25-29,1889,38.78099691771873
STAT,1895,49,30-34,1944,0.07116008716089467
STAT,1902,9,na,1911,3732.757229719721
STAT,1903,37,na,1940,3443.51394746075
STAT,1850,38,45-49,1888,1.5075206753187267
SIM,1932,20,30-34,1952,55
STAT,1914,29,25-29,1943,67.21585979862807
STAT,1938,26,30-34,1964,39.61617032648262
SIM,1856,32,na,1888,2349
SIM,1861,62,na,1923,1903
SIM,1930,31,20-24,1961,6
STAT,1918,26,45-49,1944,1.8826483727395174
SIM,1819,46,na,1865,1423
SIM,1888,18,15-19,1906,8
STAT,1915,22,na,1937,3852.001377056905
STAT,1807,100,na,1907,0.44865469892273546
STAT,1903,15,20-24,1918,25.828738744266918
STAT,1927,16,45-49,1943,0.6351451988377562
STAT,1948,24,35-39,1972,11.022801502848978
SIM,1822,39,30-34,1861,7
SIM,1907,29,15-19,1936,1
STAT,1921,10,na,1931,4622.720060730547
STAT,1848,48,30-34,1896,0.07430037868852554
STAT,1824,42,15-19,1866,0.017015560972639864
STAT,1925,18,45-49,1943,0.6140483678423218
SIM,1837,34,45-49,1871,3
SIM,1887,25,45-49,1912,2
STAT,1887,15,50-100,1902,0.05626445620534105
SIM,1941,15,30-34,1956,22
SIM,1836,18,na,1854,2304
SIM,1879,40,45-49,1919,2
STAT,1917,30,40-44,1947,4.215458651386201
STAT,1933,34,30-34,1967,21.624982809616164
SIM,1936,12,na,1948,3465
SIM,1869,82,na,1951,290
STAT,1926,44,40-44,1970,0.3135209073982129
SIM,1878,30,45-49,1908,2
STAT,1856,45,30-34,1901,0.07829059786655322
STAT,1933,15,30-34,1948,16.71716784750843
STAT,1770,98,na,1868,0.34916514808395827
STAT,1879,25,45-49,1904,1.1920097781161754
SIM,1889,33,25-29,1922,18
SIM,1899,32,50-100,1931,1
STAT,1837,74,na,1911,739.9255101389464
SIM,1851,8,na,1859,2369
STAT,1906,41,20-24,1947,0.01644942285727988
STAT,1820,68,na,1888,832.5789455893475
STAT,1894,37,na,1931,3091.556144202582
SIM,1898,28,25-29,1926,93
SIM,1874,29,na,1903,2397
SIM,1906,36,45-49,1942,1
SIM,1843,21,25-29,1864,78
STAT,1874,2,na,1876,3415.986361926459
SIM,1895,37,na,1932,3240
STAT,1899,52,na,1951,2991.979367321892
STAT,1843,42,40-44,1885,1.8695504587021405
SIM,1920,15,na,1935,3938
STAT,1814,40,na,1854,1535.9999108218633
SIM,1887,33,20-24,1920,2
SIM,1840,23,na,1863,1807
SIM,1865,35,35-39,1900,5
STAT,1841,48,45-49,1889,0.17281290483819076
SIM,1802,83,na,1885,215
SIM,1863,24,45-49,1887,2
STAT,1833,28,50-100,1861,0.5581745986851908
SIM,1956,5,na,1961,5512
STAT,1862,75,na,1937,893.9849008653073
SIM,1946,19,25-29,1965,85
SIM,1902,36,45-49,1938,3
STAT,1938,19,25-29,1957,43.57733215051826
STAT,1940,23,na,1963,3793.8437950434486
SIM,1902,25,20-24,1927,3
SIM,1804,56,na,1860,1283
STAT,1892,29,50-100,1921,0.812040720611039
STAT,1869,51,35-39,1920,0.008519704423386204
STAT,1782,83,na,1865,125.15499280762049
SIM,1841,43,25-29,1884,3
SIM,1823,42,50-100,1865,3
SIM,1862,10,na,1872,2518
SIM,1870,45,na,1915,2525
STAT,1855,35,25-29,1890,2.253145780959852
STAT,1907,44,30-34,1951,0.11797012241495164
STAT,1944,16,45-49,1960,0.5486271150041188
SIM,1846,73,na,1919,846
SIM,1915,26,45-49,1941,3
SIM,1876,21,20-24,1897,1
STAT,1923,41,20-24,1964,0.021090855642601398
STAT,1886,44,50-100,1930,1.1253712852735092
STAT,1829,95,na,1924,8.84264772972056
STAT,1854,45,20-24,1899,0.009275818846815014
SIM,1872,25,25-29,1897,54
STAT,1856,104,na,1960,0.1354980951970688
STAT,1937,23,20-24,1960,110.4136613050361
STAT,1879,38,na,1917,2499.8469895039425
STAT,1883,43,na,1926,2296.759118042293
STAT,1838,24,45-49,1862,0.6552213589315773
STAT,1918,29,25-29,1947,70.97079091456472
SIM,1857,27,25-29,1884,48
STAT,1860,53,40-44,1913,0.00857397479177531
STAT,1899,18,25-29,1917,7.895507361008471
STAT,1848,35,25-29,1883,2.3548001203623277
STAT,1891,39,45-49,1930,2.4924293687682084
SIM,1844,47,na,1891,1784
SIM,1940,31,20-24,1971,3
SIM,1865,15,na,1880,2588
STAT,1878,13,na,1891,2738.0158006209253
STAT,1850,32,15-19,1882,0.11205798456415975
STAT,1903,37,25-29,1940,0.90120397813111
STAT,1868,21,20-24,1889,67.63167952911404
SIM,1833,21,25-29,1854,61
SIM,1869,40,45-49,1909,1
SIM,1824,70,na,1894,730
STAT,1824,48,45-49,1872,0.2713523042271944
SIM,1926,29,25-29,1955,125
SIM,1787,67,na,1854,612
SIM,1846,24,45-49,1870,1
SIM,1951,20,40-44,1971,4
STAT,1904,47,25-29,1951,0.047282800973150164
STAT,1881,17,na,1898,2490.9482553952043
STAT,1913,24,50-100,1937,0.6735982230317246
STAT,1917,42,35-39,1959,0.2144496885748485
STAT,1876,9,na,1885,2792.7395187266484
STAT,1851,18,50-100,1869,0.04885284130249078
SIM,1837,37,na,1874,1643
STAT,1821,53,45-49,1874,0.02152762642684057
STAT,1877,25,35-39,1902,10.278659645608204
STAT,1895,46,20-24,1941,0.009035192535361452
STAT,1924,45,45-49,1969,0.2652276817744643
STAT,1933,35,na,1968,5234.997344553967
STAT,1871,40,35-39,1911,1.848335994347139
STAT,1941,31,30-34,1972,16.8857333462568
STAT,1858,92,na,1950,33.694695232311446
STAT,1834,52,40-44,1886,0.007264271487033806
SIM,1926,22,40-44,1948,4
STAT,1923,15,30-34,1938,14.671038236722342
SIM,1856,48,30-34,1904,1
STAT,1851,27,40-44,1878,2.8936569699610555
STAT,1854,46,na,1900,1726.814893020362
SIM,1919,30,40-44,1949,8
STAT,1910,16,35-39,1926,0.8500939238289809
STAT,1926,42,45-49,1968,0.209309335043049
STAT,1905,39,25-29,1944,0.9063939189969885
SIM,1909,29,25-29,1938,74
SIM,1913,39,25-29,1952,1
STAT,1850,56,na,1906,1534.222559850599
STAT,1936,24,na,1960,3558.498115548026
STAT,1932,31,20-24,1963,3.3087060287481993
SIM,1833,23,20-24,1856,2
STAT,1869,14,na,1883,2595.794693466288
STAT,1832,99,na,1931,1.2655348786687612
STAT,1924,2,na,1926,4968.960662469739
SIM,1906,30,30-34,1936,26
STAT,1900,33,35-39,1933,14.258735481387026
SIM,1870,61,na,1931,2020
STAT,1909,39,25-29,1948,0.9409153122409406
STAT,1874,60,na,1934,1986.445595155249
STAT,1912,29,15-19,1941,0.7046160699662334
STAT,1837,42,50-100,1879,0.8311692434232903
SIM,1902,24,na,1926,3434
STAT,1835,40,25-29,1875,0.588406781476598
STAT,1874,25,25-29,1899,44.35846075051265
SIM,1911,26,45-49,1937,3
SIM,1834,42,40-44,1876,6
STAT,1918,22,40-44,1940,3.700650160143028
STAT,1947,16,30-34,1963,14.012517672392582
STAT,1922,36,20-24,1958,0.30633916784688825
SIM,1920,29,15-19,1949,4
SIM,1908,6,na,1914,4218
SIM,1846,21,35-39,1867,7
STAT,1893,33,40-44,1926,5.588662220556044
SIM,1955,16,30-34,1971,24
STAT,1857,32,25-29,1889,8.210857312457644
STAT,1862,41,na,1903,2016.1622480747278
STAT,1832,44,30-34,1876,0.920445664774874
STAT,1911,36,45-49,1947,0.6748759359880224
STAT,1828,50,35-39,1878,0.006765823014262493
STAT,1801,79,na,1880,276.70133929696823
STAT,1895,41,35-39,1936,0.16812744296278287
STAT,1879,33,20-24,1912,2.8702563974560293
STAT,1893,49,20-24,1942,0.008577173182654236
SIM,1840,44,30-34,1884,2
STAT,1857,29,na,1886,1930.4368967200992
SIM,1917,22,30-34,1939,2
SIM,1865,32,25-29,1897,12
STAT,1909,22,30-34,1931,27.243159132799065
STAT,1925,25,50-100,1950,1.2075633548086302
STAT,1903,26,45-49,1929,1.615647860175078
STAT,1813,64,na,1877,902.6391026175496
STAT,1893,21,na,1914,3069.959869492224
STAT,1920,23,40-44,1943,3.8028335401585576
STAT,1913,44,30-34,1957,0.1267635721252768
SIM,1844,24,35-39,1868,9
SIM,1831,24,na,1855,1795
STAT,1838,21,35-39,1859,5.602991754678789
STAT,1884,46,45-49,1930,0.23886696441202213
SIM,1891,47,na,1938,2881
SIM,1871,30,35-39,1901,11
SIM,1929,19,25-29,1948,73
STAT,1915,41,30-34,1956,0.13153266941886066
STAT,1828,91,na,1919,31.909935268413474
SIM,1806,57,na,1863,1230
STAT,1877,65,na,1942,1788.1256165334103
SIM,1839,31,45-49,1870,6
SIM,1933,25,50-100,1958,5
STAT,1875,64,na,1939,1820.0797805069099
STAT,1918,48,25-29,1966,0.05744434271995554
STAT,1900,20,20-24,1920,98.02017818796966
STAT,1838,32,20-24,1870,2.4679064476902166
SIM,1889,35,20-24,1924,1
SIM,1921,34,15-19,1955,2
STAT,1896,20,45-49,1916,0.9451444471680243
STAT,1836,43,na,1879,1536.9434893140692
SIM,1886,14,na,1900,2900
STAT,1865,43,15-19,1908,0.012694193049494398
STAT,1873,54,20-24,1927,7.422055178685254E-4
SIM,1875,43,40-44,1918,3
SIM,1778,84,na,1862,118
SIM,1842,52,40-44,1894,1
STAT,1873,19,40-44,1892,0.18815294566962995
SIM,1849,22,na,1871,1897
STAT,1880,69,na,1949,1573.2499676410405
STAT,1867,43,40-44,1910,2.1386413149127503
SIM,1859,16,35-39,1875,2
SIM,1846,32,20-24,1878,4
SIM,1868,57,na,1925,1953
SIM,1910,3,na,1913,4065
STAT,1930,21,na,1951,4785.760665350857
STAT,1924,30,50-100,1954,0.9885823951315562
STAT,1806,54,30-34,1860,0.01854681382311883
STAT,1857,35,35-39,1892,5.688647666827949
SIM,1820,80,na,1900,360
STAT,1893,47,50-100,1940,0.17845370972535962
STAT,1873,45,30-34,1918,0.1011134668731251
STAT,1880,22,50-100,1902,0.437163394148623
STAT,1933,37,35-39,1970,3.3598005143706358
SIM,1928,23,45-49,1951,1
STAT,1809,50,25-29,1859,0.01566100706668253
STAT,1937,20,40-44,1957,3.342148753490097
STAT,1836,24,35-39,1860,4.7253642635660285
STAT,1859,49,20-24,1908,0.009572452397590359
STAT,1895,68,na,1963,2242.34424556223
STAT,1913,34,15-19,1947,0.1293135882005184
STAT,1945,20,na,1965,4086.2382533519017
STAT,1866,19,40-44,1885,0.17457831734576018
STAT,1835,67,na,1902,1181.0917248425787
STAT,1854,40,35-39,1894,1.3998990674843719
STAT,1898,33,25-29,1931,14.070580135138842
SIM,1893,22,35-39,1915,8
SIM,1948,19,35-39,1967,7
STAT,1901,23,30-34,1924,25.33211326402381
STAT,1888,15,50-100,1903,0.059359713874779396
STAT,1838,105,na,1943,0.021543426162595823
STAT,1924,39,na,1963,4516.515817437347
STAT,1895,46,50-100,1941,0.18492026656892044
STAT,1906,18,35-39,1924,0.8126137943060304
SIM,1914,18,35-39,1932,1
SIM,1945,20,40-44,1965,4
SIM,1931,15,30-34,1946,21
SIM,1940,8,na,1948,4141
STAT,1931,29,25-29,1960,86.57853889692926
SIM,1850,25,na,1875,1973
STAT,1865,46,40-44,1911,0.15896461659225739
SIM,1937,26,20-24,1963,28
STAT,1945,8,na,1953,4394.73506781859
STAT,1863,46,15-19,1909,3.587961928676176E-4
SIM,1924,27,na,1951,4656
STAT,1813,44,20-24,1857,0.484971886276626
STAT,1903,53,na,1956,3091.8716941760604
SIM,1769,88,na,1857,69
STAT,1824,58,na,1882,1174.3358765885273
STAT,1908,15,40-44,1923,0.27795358188752334
STAT,1864,22,20-24,1886,63.51450563643017
SIM,1865,44,25-29,1909,2
SIM,1908,33,45-49,1941,5
STAT,1889,50,na,1939,2752.367247945167
SIM,1944,18,20-24,1962,137
SIM,1891,25,35-39,1916,4
STAT,1878,21,45-49,1899,0.7426942520561619
STAT,1879,22,40-44,1901,2.222079976521828
STAT,1878,30,35-39,1908,10.839977234628329
STAT,1911,37,15-19,1948,0.018919531271252153
SIM,1826,31,35-39,1857,5
STAT,1870,92,na,1962,92.18555801594498
SIM,1861,49,50-100,1910,1
STAT,1927,41,na,1968,4758.175140922984
SIM,1929,29,35-39,1958,26
STAT,1867,48,40-44,1915,0.1619034593103847
STAT,1900,48,na,1948,3141.7744002701693
STAT,1924,18,50-100,1942,0.4539953828912417
STAT,1865,86,na,1951,205.43578640288644
STAT,1930,15,50-100,1945,0.49631198614905164
SIM,1887,22,40-44,1909,7
STAT,1906,44,25-29,1950,0.06531952844184664
SIM,1829,39,40-44,1868,6
SIM,1933,27,35-39,1960,27
STAT,1772,100,na,1872,0.11563428495938011
STAT,1857,44,25-29,1901,0.5047127489705239
STAT,1853,49,50-100,1902,0.20163550559908047
STAT,1889,40,20-24,1929,0.2021465863569986
SIM,1905,25,30-34,1930,46
STAT,1907,27,na,1934,3574.742039476018
STAT,1942,15,40-44,1957,1.4920913354887546
SIM,1845,78,na,1923,582
SIM,1774,94,na,1868,7
SIM,1831,24,25-29,1855,59
STAT,1875,53,40-44,1928,0.010845582152851424
STAT,1850,35,40-44,1885,3.4151135652932316
SIM,1939,23,20-24,1962,175
STAT,1862,54,45-49,1916,0.012256018162363732
STAT,1936,18,20-24,1954,132.04095731864575
SIM,1886,30,35-39,1916,14
STAT,1883,25,35-39,1908,9.723768571096414
STAT,1886,85,na,1971,648.953794548927
SIM,1859,46,na,1905,2129
SIM,1915,23,35-39,1938,12
STAT,1866,38,40-44,1904,4.098668889511882
SIM,1870,17,15-19,1887,8
SIM,1950,15,40-44,1965,3
STAT,1877,71,na,1948,1412.333794590281
STAT,1822,45,15-19,1867,5.873213692579189E-4
SIM,1922,26,20-24,1948,23
SIM,1864,11,na,1875,2529
SIM,1882,86,na,1968,416
SIM,1850,42,50-100,1892,1
STAT,1914,26,20-24,1940,18.839592606229548
STAT,1885,39,20-24,1924,0.7766574677363857
STAT,1890,15,25-29,1905,7.101159711271007
SIM,1893,39,20-24,1932,1
STAT,1807,47,30-34,1854,0.424274691831723
STAT,1907,23,35-39,1930,8.713880149783371
SIM,1874,28,30-34,1902,6
STAT,1862,17,15-19,1879,5.902380389578706
SIM,1858,32,25-29,1890,11
STAT,1841,73,na,1914,876.980342326308
STAT,1843,50,25-29,1893,0.002900461778441454
STAT,1898,22,45-49,1920,0.9619916653494519
STAT,1818,48,20-24,1866,0.026828982622658894
SIM,1857,63,na,1920,1461
SIM,1907,33,na,1940,3598
STAT,1874,38,30-34,1912,5.523551532718523
STAT,1857,21,45-49,1878,0.6460111401101619
STAT,1810,52,30-34,1862,0.01782572258264363
STAT,1882,18,na,1900,2503.5648361813214
STAT,1804,81,na,1885,215.64211578995443
SIM,1891,15,25-29,1906,7
SIM,1947,15,50-100,1962,1
STAT,1891,36,40-44,1927,5.555387332977309
STAT,1898,36,35-39,1934,9.80442916715141
STAT,1844,38,20-24,1882,0.6247031735989733
STAT,1876,22,25-29,1898,60.304209402860124
STAT,1893,38,40-44,1931,5.637030740920884
STAT,1900,26,na,1926,3386.0040467121025
STAT,1904,31,45-49,1935,2.56000204862399
SIM,1882,64,na,1946,1621
SIM,1907,37,35-39,1944,5
STAT,1868,46,50-100,1914,0.2399840510525824
SIM,1882,38,30-34,1920,8
SIM,1918,28,20-24,1946,21
STAT,1935,26,20-24,1961,25.386628182407613
SIM,1846,21,40-44,1867,1
STAT,1769,107,na,1876,0.0038964705304271076
STAT,1842,21,na,1863,2130.1445193984396
SIM,1815,47,30-34,1862,1
STAT,1915,56,na,1971,3636.859460536401
STAT,1810,50,na,1860,1204.131261864722
STAT,1881,15,15-19,1896,5.880307744760306
STAT,1939,9,na,1948,4056.145995540099
STAT,1955,16,20-24,1971,183.61823756875117
SIM,1819,40,na,1859,1557
STAT,1933,18,35-39,1951,5.7134665308879695
SIM,1889,30,20-24,1919,6
STAT,1807,86,na,1893,93.76560788308429
SIM,1941,18,35-39,1959,2
SIM,1837,43,na,1880,1551
SIM,1848,33,50-100,1881,2
STAT,1824,45,40-44,1869,0.20498531226976982
STAT,1855,40,50-100,1895,0.8272232827265509
STAT,1861,30,25-29,1891,8.703593001450304
STAT,1845,26,na,1871,2072.232430563195
SIM,1850,24,35-39,1874,7
STAT,1826,84,na,1910,194.0227072103522
SIM,1904,22,20-24,1926,111
SIM,1943,26,20-24,1969,21
STAT,1826,47,40-44,1873,0.13377659742955028
STAT,1774,88,na,1862,31.10018896087866
STAT,1918,33,50-100,1951,0.8927898393274575
STAT,1918,37,45-49,1955,0.7332607965123421
SIM,1859,35,35-39,1894,15
STAT,1900,34,50-100,1934,1.2844333917008062
SIM,1855,29,40-44,1884,4
STAT,1879,22,35-39,1901,6.222693357281945
SIM,1924,25,40-44,1949,10
SIM,1865,92,na,1957,10
SIM,1872,22,20-24,1894,5
STAT,1838,21,40-44,1859,2.000788898286143
SIM,1887,22,35-39,1909,12
STAT,1898,23,15-19,1921,4.537113456882196
STAT,1926,23,45-49,1949,1.3901957637746805
SIM,1902,33,40-44,1935,4
STAT,1907,47,35-39,1954,0.11773914155544958
SIM,1833,37,40-44,1870,10
STAT,1948,21,30-34,1969,33.68012524094962
STAT,1870,70,na,1940,1399.233566602272
SIM,1824,92,na,1916,17
STAT,1843,45,45-49,1888,0.19454994751640073
SIM,1835,20,20-24,1855,62
SIM,1851,45,45-49,1896,1
STAT,1833,47,40-44,1880,0.13265132983352246
STAT,1848,39,40-44,1887,3.434556758218875
STAT,1892,28,40-44,1920,3.816532183105579
STAT,1890,47,na,1937,2793.7455049690607
STAT,1916,25,40-44,1941,4.951431949355035
SIM,1852,38,20-24,1890,3
SIM,1921,34,20-24,1955,5
SIM,1848,29,40-44,1877,4
STAT,1911,31,45-49,1942,1.569377974866337
STAT,1880,35,20-24,1915,0.8342209970698351
STAT,1920,34,20-24,1954,2.703139827952046
STAT,1847,29,40-44,1876,2.7675541495605445
STAT,1882,12,na,1894,2566.6959740566062
SIM,1885,69,na,1954,1551
STAT,1912,41,45-49,1953,0.16469028436382532
STAT,1825,37,40-44,1862,6.706659085279562
SIM,1897,63,na,1960,2494
SIM,1934,23,45-49,1957,1
SIM,1791,66,na,1857,782
STAT,1863,100,na,1963,3.174960857227603
STAT,1907,45,45-49,1952,0.20139215934974677
STAT,1854,49,50-100,1903,0.1840464007015332
STAT,1865,32,15-19,1897,0.13185566820330036
SIM,1878,19,na,1897,2770
STAT,1877,32,50-100,1909,0.9694665591982028
STAT,1855,9,na,1864,2246.339800589053
STAT,1892,17,25-29,1909,7.245263013738782
SIM,1897,32,45-49,1929,3
SIM,1878,81,na,1959,649
SIM,1869,0,na,1869,3449
SIM,1943,22,40-44,1965,5
STAT,1899,15,20-24,1914,24.88128864800651
STAT,1837,48,30-34,1885,0.06614377737143655
SIM,1946,22,15-19,1968,9
STAT,1829,31,35-39,1860,9.659622374269476
STAT,1859,52,na,1911,1744.8793340404284
STAT,1876,44,35-39,1920,1.8818159067133802
STAT,1913,34,20-24,1947,2.454518185707705
SIM,1810,59,na,1869,1372
SIM,1891,22,25-29,1913,77
STAT,1926,22,30-34,1948,35.62103196524509
SIM,1833,26,25-29,1859,62
SIM,1871,46,na,1917,2071
STAT,1837,19,50-100,1856,0.04644516833693878
SIM,1884,44,35-39,1928,5
STAT,1922,39,25-29,1961,1.1407323474431894
STAT,1928,19,30-34,1947,15.581662934964243
SIM,1924,28,45-49,1952,5
STAT,1785,75,na,1860,409.04553401543933
SIM,1956,13,na,1969,5507
STAT,1864,29,40-44,1893,2.697802527023138
SIM,1934,22,30-34,1956,50
STAT,1923,18,35-39,1941,5.014155908674682
SIM,1930,34,30-34,1964,28
STAT,1901,18,15-19,1919,8.443925330332995
SIM,1852,20,20-24,1872,73
STAT,1879,91,na,1970,216.12877077905088
STAT,1922,34,30-34,1956,18.07502910519189
STAT,1896,22,35-39,1918,7.862454185735278
SIM,1894,4,na,1898,3578
STAT,1880,88,na,1968,374.0305564622696
STAT,1821,50,40-44,1871,0.01657939013462862
SIM,1833,21,30-34,1854,20
SIM,1921,22,20-24,1943,159
STAT,1853,61,na,1914,1566.8484726211627
STAT,1859,21,35-39,1880,5.459748920536575
STAT,1881,26,15-19,1907,0.44901218443610186
SIM,1829,32,20-24,1861,3
STAT,1916,28,45-49,1944,1.8164603702364253
SIM,1909,38,20-24,1947,3
SIM,1867,21,35-39,1888,5
STAT,1883,22,25-29,1905,57.300878647871414
SIM,1909,5,na,1914,3841
SIM,1909,26,20-24,1935,18
STAT,1922,47,50-100,1969,0.2651275964793014
SIM,1822,69,na,1891,762
SIM,1910,22,45-49,1932,2
STAT,1789,65,na,1854,632.0
STAT,1809,53,35-39,1862,0.035841881334240454
SIM,1893,73,na,1966,1816
SIM,1824,43,25-29,1867,1
STAT,1860,49,na,1909,1823.3434394869196
SIM,1830,61,na,1891,1226
SIM,1931,18,35-39,1949,4
SIM,1932,35,35-39,1967,11
STAT,1848,15,na,1863,2238.2215789354987
STAT,1857,25,25-29,1882,35.217849072398224
SIM,1809,87,na,1896,32
SIM,1875,32,25-29,1907,2
STAT,1888,28,15-19,1916,0.5452483746325996
STAT,1913,44,25-29,1957,0.07080487841372625
SIM,1822,44,na,1866,1382
STAT,1822,94,na,1916,11.620785096103992
SIM,1948,18,na,1966,4087
STAT,1883,34,25-29,1917,10.164715163550639
SIM,1902,28,25-29,1930,70
STAT,1805,49,30-34,1854,0.3454870741777249
STAT,1870,27,15-19,1897,0.45246061877206545
SIM,1882,36,40-44,1918,9
SIM,1856,46,40-44,1902,1
STAT,1861,2,na,1863,2901.6777280449337
STAT,1833,51,50-100,1884,0.010501399166457294
STAT,1842,12,na,1854,2404.0
SIM,1824,31,25-29,1855,9
STAT,1848,49,45-49,1897,0.17962030563669987
SIM,1874,25,35-39,1899,16
SIM,1889,59,na,1948,2588
STAT,1844,20,20-24,1864,67.64258417923686
SIM,1882,22,15-19,1904,4
SIM,1916,27,50-100,1943,1
SIM,1911,38,na,1949,3752
STAT,1892,73,na,1965,1818.9525834793328
SIM,1891,34,25-29,1925,22
STAT,1863,103,na,1966,0.7489887138948251
STAT,1912,11,na,1923,4079.968738888066
SIM,1817,41,35-39,1858,1
STAT,1866,25,35-39,1891,9.140951283812365
STAT,1816,43,25-29,1859,1.4509423783603042
SIM,1884,32,35-39,1916,14
STAT,1902,22,45-49,1924,1.0031985436345257
STAT,1904,44,15-19,1948,0.0013831704623438977
SIM,1936,19,30-34,1955,12
SIM,1919,33,45-49,1952,4
STAT,1874,36,40-44,1910,4.581384775657956
STAT,1942,29,50-100,1971,1.0647670900118422
SIM,1948,16,30-34,1964,21
STAT,1873,15,25-29,1888,5.930466688729479
STAT,1884,3,na,1887,2985.9672654272526
STAT,1912,17,20-24,1929,27.966630890740944
STAT,1924,35,35-39,1959,2.9149386218019444
STAT,1903,27,15-19,1930,0.6579433873067906
STAT,1855,21,35-39,1876,5.322969401404254
STAT,1937,23,45-49,1960,1.1172695049886807
SIM,1863,29,30-34,1892,27
STAT,1918,45,20-24,1963,0.012057417761316563
SIM,1929,16,20-24,1945,1
STAT,1889,20,45-49,1909,0.8839683132710301
SIM,1889,38,25-29,1927,2
SIM,1796,87,na,1883,25
SIM,1841,21,15-19,1862,4
SIM,1855,37,na,1892,1822
STAT,1876,32,35-39,1908,10.668148910588917
STAT,1922,27,25-29,1949,75.99592151555964
STAT,1848,42,25-29,1890,0.4985553656416237
SIM,1932,23,35-39,1955,18
STAT,1955,13,na,1968,5317.73969124224
SIM,1857,5,na,1862,2526
SIM,1942,15,na,1957,4653
SIM,1905,16,35-39,1921,1
STAT,1857,50,50-100,1907,0.012205560022598495
STAT,1909,32,40-44,1941,3.808571590220011
SIM,1917,32,40-44,1949,3
SIM,1897,54,na,1951,2848
SIM,1963,3,na,1966,5154
STAT,1919,46,50-100,1965,0.25096714186439695
SIM,1897,20,45-49,1917,1
SIM,1930,27,25-29,1957,152
SIM,1815,45,40-44,1860,1
STAT,1836,27,na,1863,1742.2730312876101
STAT,1930,34,15-19,1964,0.16892426541955827
STAT,1833,21,15-19,1854,4.327814170266191
STAT,1912,33,na,1945,3780.388554640585
STAT,1855,29,30-34,1884,20.056211730896187
STAT,1892,70,na,1962,1990.3247514591433
SIM,1929,36,na,1965,5153
SIM,1920,17,20-24,1937,200
STAT,1822,39,20-24,1861,1.3136343905409509
STAT,1885,31,50-100,1916,0.9363462235031429
STAT,1942,18,45-49,1960,0.5324368045693864
STAT,1888,23,20-24,1911,82.85305033307236
SIM,1863,21,35-39,1884,7
STAT,1823,54,30-34,1877,0.00827939104281124
STAT,1883,15,25-29,1898,5.6985531807491325
SIM,1891,60,na,1951,2418
STAT,1823,57,na,1880,1215.4924296548484
STAT,1909,44,40-44,1953,0.2356682379919127
SIM,1950,10,na,1960,4742
SIM,1939,20,25-29,1959,128
STAT,1877,23,45-49,1900,0.7355462856065303
STAT,1830,36,na,1866,1720.9112899343268
STAT,1835,43,35-39,1878,1.5966805594303823
STAT,1889,32,45-49,1921,2.197466426370198
STAT,1862,51,40-44,1913,0.009185953171266557
STAT,1882,43,15-19,1925,0.013626121341458682
SIM,1830,39,20-24,1869,2
SIM,1896,23,20-24,1919,98
STAT,1859,77,na,1936,704.233215647307
STAT,1903,39,15-19,1942,0.017399774069390958
STAT,1955,17,35-39,1972,5.681508110317827
SIM,1858,42,na,1900,1911
STAT,1884,44,na,1928,2301.207115528648
SIM,1843,43,35-39,1886,4
STAT,1942,24,30-34,1966,30.724080535957864
SIM,1883,38,50-100,1921,6
SIM,1843,31,35-39,1874,2
STAT,1868,38,15-19,1906,0.054443784296642955
SIM,1869,41,50-100,1910,2
STAT,1898,26,25-29,1924,58.55729360339601
STAT,1929,24,30-34,1953,36.83837249024522
STAT,1930,30,na,1960,4983.705788726718
STAT,1898,45,25-29,1943,0.04527017815816558
SIM,1841,38,45-49,1879,5
STAT,1847,27,15-19,1874,0.4252533216704702
STAT,1893,22,25-29,1915,74.08420585363659
SIM,1866,93,na,1959,49
STAT,1861,27,40-44,1888,2.54351109884829
STAT,1919,43,20-24,1962,0.019499122742677528
STAT,1904,38,na,1942,3454.554090295076
SIM,1924,22,30-34,1946,1
STAT,1929,29,25-29,1958,83.93538119046325
SIM,1929,33,na,1962,5074
STAT,1773,87,na,1860,53.664935238740824
SIM,1845,94,na,1939,10
STAT,1901,17,45-49,1918,0.09318772500026254
STAT,1847,25,25-29,1872,40.224478727350345
STAT,1847,25,50-100,1872,0.6082843637504378
STAT,1948,23,20-24,1971,130.21631271626003
STAT,1936,3,na,1939,3960.7000116813106
STAT,1791,97,na,1888,0.8916275401665742
STAT,1833,38,45-49,1871,1.6332286978880675
SIM,1848,32,30-34,1880,5
SIM,1924,29,15-19,1953,1
SIM,1777,83,na,1860,73
SIM,1855,31,na,1886,1858
STAT,1846,46,15-19,1892,2.868606100111478E-4
STAT,1841,42,15-19,1883,0.010595465065471031
SIM,1860,40,25-29,1900,1
STAT,1900,23,na,1923,3333.7267154655538
SIM,1846,54,na,1900,1688
SIM,1889,26,25-29,1915,80
SIM,1937,29,25-29,1966,94
STAT,1920,18,25-29,1938,49.48607495880282
STAT,1838,25,15-19,1863,0.4302037400390674
STAT,1916,34,30-34,1950,16.457083230541095
SIM,1848,37,25-29,1885,3
SIM,1903,29,20-24,1932,17
STAT,1857,38,30-34,1895,4.225114274354905
STAT,1883,19,40-44,1902,0.18209782107874106
STAT,1889,43,25-29,1932,0.8033645419066091
STAT,1811,54,na,1865,1161.8456616202236
STAT,1835,31,35-39,1866,9.71052641784673
STAT,1851,16,25-29,1867,5.717803817462701
STAT,1945,5,na,1950,4430.393206655355
STAT,1910,19,45-49,1929,0.10041230086336841
STAT,1859,31,20-24,1890,2.2112220785243624
STAT,1878,49,30-34,1927,0.10064202857552129
SIM,1881,15,25-29,1896,6
SIM,1933,24,30-34,1957,39
STAT,1916,22,30-34,1938,30.73376070137252
STAT,1872,37,na,1909,2408.820916536554
SIM,1903,17,20-24,1920,28
STAT,1852,31,35-39,1883,8.535197928607314
STAT,1861,96,na,1957,9.67462694944582
SIM,1839,23,25-29,1862,63
STAT,1836,104,na,1940,0.04151641214775194
STAT,1842,21,25-29,1863,57.03187016953662
SIM,1867,31,20-24,1898,2
STAT,1838,102,na,1940,0.21541095444337555
STAT,1891,16,50-100,1907,0.062028611906516054
STAT,1924,36,na,1960,4530.273949230548
STAT,1832,40,15-19,1872,0.011645403443546178
SIM,1908,34,na,1942,3875
SIM,1877,34,na,1911,2418
SIM,1907,21,25-29,1928,124
SIM,1878,20,40-44,1898,2
SIM,1905,28,35-39,1933,16
STAT,1888,16,15-19,1904,7.174766300004903
SIM,1860,31,35-39,1891,13
SIM,1841,20,45-49,1861,1
STAT,1893,36,na,1929,3063.654426608765
STAT,1800,91,na,1891,27.92898035932278
SIM,1839,35,25-29,1874,2
SIM,1917,39,25-29,1956,4
STAT,1842,33,25-29,1875,9.60298013234327
SIM,1830,37,30-34,1867,2
STAT,1893,58,na,1951,2559.300787169085
STAT,1884,22,na,1906,2387.002438175349
SIM,1865,25,25-29,1890,48
STAT,1936,31,50-100,1967,0.819565880758735
SIM,1900,34,45-49,1934,2
SIM,1896,16,15-19,1912,13
STAT,1797,60,na,1857,996.9704499168513
STAT,1872,59,na,1931,1987.0553729440785
STAT,1916,16,45-49,1932,0.10842136329688196
STAT,1898,39,30-34,1937,1.5709858168252584
STAT,1952,15,35-39,1967,5.1323639997694555
SIM,1848,25,25-29,1873,45
SIM,1834,54,na,1888,1423
SIM,1879,44,na,1923,2808
SIM,1892,23,na,1915,3387
STAT,1888,15,45-49,1903,0.07914628516637255
SIM,1850,21,25-29,1871,65
STAT,1904,16,na,1920,3701.671517301362
STAT,1836,22,45-49,1858,0.5728629945749504
SIM,1900,60,na,1960,2722
STAT,1807,48,45-49,1855,1.01283489199639
STAT,1817,54,na,1871,1259.4034187529626
SIM,1907,34,30-34,1941,18
STAT,1930,41,20-24,1971,0.023733453890037635
SIM,1850,9,na,1859,2332
STAT,1827,43,50-100,1870,1.2284819360147923
SIM,1809,62,na,1871,722
SIM,1829,25,15-19,1854,2
STAT,1949,10,na,1959,4662.2646167565745
SIM,1869,30,35-39,1899,2
SIM,1924,34,30-34,1958,25
STAT,1861,33,35-39,1894,8.500769746595868
STAT,1901,24,45-49,1925,0.988556908280544
SIM,1889,33,30-34,1922,24
STAT,1874,39,45-49,1913,2.0554422725296724
SIM,1844,22,45-49,1866,4
SIM,1855,25,25-29,1880,44
STAT,1891,29,50-100,1920,0.8021557399312699
STAT,1897,11,na,1908,3527.893496399863
STAT,1943,28,na,1971,4068.5301686755683
SIM,1937,24,30-34,1961,44
STAT,1861,21,35-39,1882,5.090155246201715
STAT,1822,37,30-34,1859,10.10321888885536
STAT,1802,77,na,1879,314.5658141127465
STAT,1847,67,na,1914,1236.1734949651307
STAT,1898,73,na,1971,2077.1265033133222
STAT,1937,2,na,1939,4058.419758057512
SIM,1879,19,25-29,1898,6
STAT,1859,71,na,1930,1087.4820330790342
STAT,1860,31,na,1891,1983.255526406429
SIM,1850,33,25-29,1883,14
STAT,1826,31,25-29,1857,12.046468280112652
STAT,1935,34,40-44,1969,5.514145321401637
SIM,1859,20,30-34,1879,29
SIM,1895,6,na,1901,3621
STAT,1877,74,na,1951,1174.251712886666
STAT,1831,39,30-34,1870,4.576949267280649
SIM,1834,69,na,1903,1077
SIM,1810,44,45-49,1854,6
SIM,1841,28,50-100,1869,1
STAT,1873,81,na,1954,559.2854638158266
STAT,1841,76,na,1917,699.5180146364409
SIM,1868,22,30-34,1890,2
STAT,1935,22,40-44,1957,4.6693546501826235
SIM,1860,83,na,1943,461
SIM,1910,53,na,1963,3382
SIM,1935,14,na,1949,5510
SIM,1834,31,25-29,1865,3
STAT,1852,44,40-44,1896,1.787561430203669
SIM,1821,81,na,1902,238
SIM,1908,32,30-34,1940,8
STAT,1833,31,25-29,1864,8.844805732089545
STAT,1907,26,45-49,1933,1.6688159183581897
STAT,1937,25,na,1962,3728.0829747931402
STAT,1851,57,na,1908,1657.980503089352
STAT,1902,41,45-49,1943,0.15019462190769164
STAT,1914,1,na,1915,4393.085713354656
SIM,1879,66,na,1945,1953
STAT,1890,19,40-44,1909,0.22691824916594014
STAT,1926,20,40-44,1946,4.192068122341931
SIM,1929,22,15-19,1951,8
SIM,1896,26,25-29,1922,73
STAT,1860,34,na,1894,1958.272942269822
STAT,1863,23,na,1886,2142.0884495884834
STAT,1879,26,15-19,1905,0.4854682740120292
STAT,1862,24,50-100,1886,0.3573270127035496
SIM,1865,48,40-44,1913,2
SIM,1839,39,40-44,1878,11
STAT,1848,32,15-19,1880,0.12909378810952438
STAT,1926,25,35-39,1951,18.48511274037901
SIM,1955,9,na,1964,5091
STAT,1761,99,na,1860,0.1579050708800395
STAT,1779,97,na,1876,0.7640417392465492
STAT,1842,27,30-34,1869,24.421060312867496
SIM,1849,42,25-29,1891,1
STAT,1893,45,40-44,1938,0.12622306030925579
STAT,1922,37,35-39,1959,2.8082562016134056
SIM,1879,41,na,1920,2824
STAT,1892,15,35-39,1907,0.7048181407689578
SIM,1919,19,30-34,1938,17
SIM,1939,26,30-34,1965,47
STAT,1808,108,na,1916,6.097984645022797E-4
STAT,1873,41,15-19,1914,0.014347436837504059
SIM,1843,37,40-44,1880,6
SIM,1856,19,na,1875,2605
SIM,1857,24,20-24,1881,73
SIM,1828,28,50-100,1856,4
SIM,1926,26,20-24,1952,26
STAT,1809,47,40-44,1856,0.7614831661287722
SIM,1891,24,15-19,1915,3
STAT,1853,106,na,1959,0.023526118518712686
STAT,1863,38,30-34,1901,4.74340546052579
STAT,1826,54,40-44,1880,0.007634245850545132
STAT,1866,22,30-34,1888,16.897681216578512
STAT,1888,26,25-29,1914,51.19144286270071
STAT,1911,24,45-49,1935,1.0816748955002045
SIM,1904,34,20-24,1938,4
SIM,1905,23,na,1928,3398
SIM,1950,19,15-19,1969,50
STAT,1826,36,50-100,1862,1.1255468332564378
STAT,1928,29,na,1957,4702.947701410921
STAT,1938,16,20-24,1954,136.75945187066148
SIM,1883,17,25-29,1900,7
STAT,1871,45,20-24,1916,0.012247189993790859
SIM,1834,36,50-100,1870,2
SIM,1934,20,40-44,1954,7
STAT,1827,37,15-19,1864,0.07299539494688081
STAT,1935,29,25-29,1964,91.40768309919729
SIM,1899,30,20-24,1929,6
STAT,1943,23,45-49,1966,1.2209456897541506
SIM,1921,37,25-29,1958,5
SIM,1882,39,45-49,1921,2
STAT,1889,47,40-44,1936,0.12112606175962784
STAT,1802,55,na,1857,979.0341601280808
STAT,1864,19,30-34,1883,1.4780513181367756
STAT,1900,45,35-39,1945,0.11277517874782196
SIM,1936,32,50-100,1968,1
STAT,1913,37,25-29,1950,0.9912600537439278
STAT,1928,33,20-24,1961,3.1090341313164083
SIM,1872,19,30-34,1891,2
STAT,1847,52,na,1899,1670.1296450318225
SIM,1831,28,40-44,1859,2
SIM,1880,38,na,1918,2301
STAT,1804,54,20-24,1858,0.00207776413492339
SIM,1930,24,20-24,1954,186
STAT,1905,49,50-100,1954,0.1998536906873891
STAT,1942,19,15-19,1961,48.354963320745696
STAT,1835,37,40-44,1872,4.0339088315112255
SIM,1918,7,na,1925,4619
STAT,1934,11,na,1945,5473.644178552277
STAT,1861,38,20-24,1899,0.6465781170676748
SIM,1930,37,35-39,1967,5
STAT,1866,27,25-29,1893,39.80437574683507
SIM,1876,52,na,1928,2450
SIM,1833,24,35-39,1857,7
STAT,1867,51,25-29,1918,0.003408528914326554
STAT,1887,47,15-19,1934,4.551212334538679E-4
SIM,1850,27,30-34,1877,33
STAT,1918,34,40-44,1952,4.207273332759461
STAT,1871,74,na,1945,1121.4686883736686
SIM,1924,18,35-39,1942,6
STAT,1811,51,na,1862,1232.9679044995678
STAT,1848,46,40-44,1894,0.13345726592682636
SIM,1922,16,35-39,1938,5
STAT,1792,79,na,1871,249.17502071534372
SIM,1839,20,20-24,1859,88
STAT,1896,47,na,1943,3017.7594811818076
SIM,1926,34,40-44,1960,8
SIM,1880,23,na,1903,2344
STAT,1894,28,15-19,1922,0.5932610791342307
STAT,1874,22,15-19,1896,3.4361375816877326
STAT,1879,29,na,1908,2526.6922517803746
STAT,1913,41,20-24,1954,0.01767059396374953
SIM,1859,33,45-49,1892,4
STAT,1776,98,na,1874,0.5448544782313869
SIM,1946,16,20-24,1962,146
STAT,1802,104,na,1906,0.021164289916677445
SIM,1941,16,45-49,1957,4
SIM,1852,34,50-100,1886,2
STAT,1916,29,15-19,1945,0.7395573552102012
STAT,1933,16,45-49,1949,0.6836361077966673
STAT,1865,89,na,1954,97.26935310740542
SIM,1874,34,25-29,1908,15
STAT,1942,27,35-39,1969,16.076539794579542
SIM,1864,67,na,1931,1433
STAT,1852,21,25-29,1873,55.18122772062464
SIM,1826,43,35-39,1869,4
SIM,1860,21,25-29,1881,57
STAT,1868,33,50-100,1901,0.8889923053408035
SIM,1846,29,30-34,1875,3
STAT,1922,26,na,1948,4340.1407191145445
SIM,1800,66,na,1866,693
SIM,1893,34,35-39,1927,4
STAT,1842,18,40-44,1860,0.1831024978465919
SIM,1907,15,30-34,1922,1
SIM,1874,22,30-34,1896,28
SIM,1934,25,35-39,1959,25
STAT,1866,34,25-29,1900,9.555468689375488
STAT,1883,28,30-34,1911,25.117485410971018
SIM,1888,30,45-49,1918,1
SIM,1823,91,na,1914,30
STAT,1883,24,15-19,1907,3.2815366253270963
SIM,1932,22,na,1954,5010
SIM,1871,38,30-34,1909,2
SIM,1856,16,na,1872,2694
STAT,1902,18,50-100,1920,0.07029728320700089
STAT,1935,24,50-100,1959,0.9131468430162937
STAT,1838,56,na,1894,1498.6254844770265
STAT,1871,71,na,1942,1348.8488973725166
SIM,1868,41,50-100,1909,1
SIM,1899,49,40-44,1948,1
SIM,1877,19,15-19,1896,7
STAT,1838,29,30-34,1867,23.19922787901492
STAT,1885,34,35-39,1919,10.218867648033077
STAT,1882,53,50-100,1935,0.014769266723288694
STAT,1914,16,35-39,1930,0.8877902748035678
SIM,1941,25,35-39,1966,28
STAT,1921,19,20-24,1940,156.85071548857837
STAT,1934,14,na,1948,5447.794582999351
SIM,1790,65,na,1855,632
STAT,1844,34,50-100,1878,0.8316014681181951
SIM,1889,23,20-24,1912,2
STAT,1805,69,na,1874,849.9532101787412
SIM,1793,76,na,1869,294
STAT,1807,95,na,1902,5.618738405811699
SIM,1829,35,25-29,1864,4
SIM,1908,45,45-49,1953,1
SIM,1900,24,35-39,1924,17
SIM,1827,44,50-100,1871,4
STAT,1857,48,40-44,1905,0.13468442506759787
SIM,1839,60,na,1899,1431
SIM,1842,16,25-29,1858,10
SIM,1852,26,50-100,1878,5
SIM,1908,30,40-44,1938,5
STAT,1869,19,15-19,1888,5.856325853002964
STAT,1842,23,15-19,1865,3.2396785955077516
SIM,1893,70,na,1963,2016
STAT,1836,19,50-100,1855,0.0466984507955299
SIM,1902,27,na,1929,3420
SIM,1848,35,35-39,1883,16
SIM,1901,19,45-49,1920,1
STAT,1849,93,na,1942,22.68944238364619
STAT,1835,48,20-24,1883,0.009308151933052568
SIM,1878,32,35-39,1910,13
SIM,1768,91,na,1859,11
SIM,1872,71,na,1943,1243
SIM,1915,22,20-24,1937,128
STAT,1925,15,40-44,1940,1.7318616105760067
STAT,1816,47,40-44,1863,0.3520494286966428
STAT,1903,18,25-29,1921,8.196158959687287
SIM,1849,49,50-100,1898,1
STAT,1848,31,45-49,1879,1.5972899051617895
STAT,1847,22,20-24,1869,65.8786022274571
STAT,1929,16,50-100,1945,0.48887072916965685
STAT,1796,106,na,1902,0.002641332262358275
SIM,1891,28,30-34,1919,39
SIM,1846,79,na,1925,431
SIM,1911,18,25-29,1929,14
STAT,1919,46,25-29,1965,0.058858742953623575
SIM,1911,34,20-24,1945,3
STAT,1822,91,na,1913,33.693410723791125
STAT,1931,26,20-24,1957,24.045431423606008
SIM,1908,35,35-39,1943,2
STAT,1924,23,35-39,1947,11.300632850535814
STAT,1826,50,25-29,1876,0.0027805806370147664
SIM,1956,10,na,1966,5511
STAT,1929,27,35-39,1956,19.16457778068866
SIM,1852,42,na,1894,1939
SIM,1853,27,na,1880,1976
SIM,1898,25,20-24,1923,28
SIM,1893,21,20-24,1914,101
STAT,1835,42,na,1877,1876.8696613305622
STAT,1899,4,na,1903,3674.991064592089
SIM,1923,26,na,1949,4136
SIM,1948,22,25-29,1970,106
STAT,1830,44,20-24,1874,0.13313560978863576
STAT,1907,22,20-24,1929,103.22312597201675
SIM,1938,19,40-44,1957,1
SIM,1824,37,30-34,1861,4
STAT,1893,41,25-29,1934,0.834805537209981
STAT,1828,94,na,1922,11.00566823657853
STAT,1818,43,35-39,1861,4.4528809360649415
STAT,1903,34,20-24,1937,2.2315249615883044
SIM,1920,12,na,1932,4384
STAT,1890,45,30-34,1935,0.12194595619159289
STAT,1923,47,50-100,1970,0.26996349380414464
STAT,1953,18,20-24,1971,167.24190693966762
STAT,1857,29,40-44,1886,2.4230843362711
SIM,1850,23,15-19,1873,3
STAT,1916,18,35-39,1934,0.9061280165942113
STAT,1916,37,35-39,1953,2.5276673509539522
STAT,1883,38,40-44,1921,4.359995638719168
STAT,1889,33,15-19,1922,0.17869682659630817
SIM,1869,21,45-49,1890,1
SIM,1933,15,40-44,1948,4
SIM,1881,85,na,1966,490
SIM,1914,12,na,1926,4145
SIM,1917,48,na,1965,3742
STAT,1911,40,50-100,1951,0.11567072210340093
SIM,1872,15,15-19,1887,6
STAT,1917,33,45-49,1950,1.6744509717663114
STAT,1814,65,na,1879,939.4184117910403
STAT,1829,79,na,1908,464.963606704055
STAT,1779,94,na,1873,3.330271750482979
STAT,1887,33,na,1920,2716.3602175319597
STAT,1838,39,40-44,1877,3.8012861178358954
STAT,1872,36,15-19,1908,0.057690426182335816
STAT,1858,53,40-44,1911,0.008380200434436942
SIM,1831,43,na,1874,1579
STAT,1855,19,na,1874,2091.5877572769214
STAT,1857,45,na,1902,1810.361010632383
SIM,1944,25,na,1969,4077
STAT,1909,44,na,1953,3499.2749470884874
STAT,1909,47,45-49,1956,0.20367888757355068
SIM,1790,87,na,1877,35
SIM,1855,22,20-24,1877,62
STAT,1922,24,20-24,1946,129.29636901286625
STAT,1938,29,35-39,1967,15.15784810604863
STAT,1920,16,50-100,1936,0.4300108092996314
SIM,1952,16,20-24,1968,162
SIM,1824,47,40-44,1871,1
STAT,1926,36,15-19,1962,0.02396389437037015
STAT,1874,21,45-49,1895,0.7284963236550076
SIM,1840,57,na,1897,1369
SIM,1846,39,40-44,1885,5
SIM,1860,86,na,1946,246
STAT,1938,15,50-100,1953,0.37875334729362725
STAT,1944,16,20-24,1960,148.89742894986614
SIM,1935,11,na,1946,5550
STAT,1864,15,15-19,1879,6.192206887415914
STAT,1907,35,35-39,1942,2.308433334976951
STAT,1898,35,15-19,1933,0.07820388628256368
SIM,1865,29,40-44,1894,3
SIM,1924,37,35-39,1961,6
SIM,1865,38,30-34,1903,5
STAT,1790,108,na,1898,4.12559319605098E-4
STAT,1799,101,na,1900,0.18516101744140517
STAT,1872,34,na,1906,2418.94628262634
STAT,1785,72,na,1857,543.579753201594
STAT,1895,62,na,1957,2481.3806150878827
STAT,1918,26,20-24,1944,19.89204321387833
STAT,1875,48,na,1923,2326.008975827457
STAT,1789,107,na,1896,9.381171159164728E-4
STAT,1920,27,15-19,1947,0.7902861337901704
STAT,1873,17,15-19,1890,6.137806661854298
STAT,1860,25,50-100,1885,0.5429241485935848
STAT,1903,23,40-44,1926,3.012528359772329
STAT,1880,47,20-24,1927,0.01280438155282997
SIM,1867,56,na,1923,1768
SIM,1781,73,na,1854,436
SIM,1881,17,15-19,1898,4
SIM,1892,48,na,1940,3217
STAT,1837,90,na,1927,52.56509948652368
STAT,1926,35,45-49,1961,0.8514163103514358
SIM,1891,38,40-44,1929,2
STAT,1842,37,40-44,1879,4.027001285522239
STAT,1853,2,na,1855,3020.7668
STAT,1921,31,45-49,1952,1.7942368358778378
STAT,1835,64,na,1899,1295.191547151292
STAT,1897,38,50-100,1935,1.666379607539918
SIM,1884,38,40-44,1922,7
STAT,1772,106,na,1878,0.007003579243049106
STAT,1933,35,45-49,1968,0.9485924318055385
STAT,1802,52,50-100,1854,0.040023259536018894
STAT,1876,38,40-44,1914,4.588517596887575
STAT,1894,30,50-100,1924,1.2119784713979096
STAT,1946,7,na,1953,4465.250851560624
STAT,1913,22,20-24,1935,109.92077658174055
SIM,1868,25,35-39,1893,14
STAT,1885,21,20-24,1906,70.34942674212125
SIM,1846,57,na,1903,1599
SIM,1856,31,45-49,1887,4
STAT,1822,33,15-19,1855,0.3797544301478257
SIM,1850,37,40-44,1887,6
STAT,1862,4,na,1866,2650.9636430793976
SIM,1905,18,25-29,1923,12
SIM,1937,27,35-39,1964,23
SIM,1838,18,25-29,1856,8
SIM,1911,23,40-44,1934,9
STAT,1880,85,na,1965,547.8212430411381
SIM,1858,42,35-39,1900,1
STAT,1905,63,na,1968,2917.4332793349226
STAT,1853,27,15-19,1880,0.44070998863129557
STAT,1905,36,20-24,1941,0.24631633809736694
STAT,1909,48,15-19,1957,3.4425845645697124E-4
SIM,1915,35,35-39,1950,4
SIM,1833,50,na,1883,1544
SIM,1934,35,45-49,1969,4
SIM,1812,51,na,1863,1299
STAT,1833,35,40-44,1868,3.7028551332356185
STAT,1852,40,25-29,1892,0.5225427318963236
SIM,1837,31,35-39,1868,14
STAT,1935,37,45-49,1972,0.9721350776965787
SIM,1879,16,20-24,1895,22
STAT,1814,43,na,1857,1481.2944526332103
SIM,1832,28,na,1860,1886
SIM,1902,21,40-44,1923,5
STAT,1923,44,25-29,1967,0.08487427202130678
SIM,1906,33,35-39,1939,15
SIM,1895,20,35-39,1915,11
STAT,1811,43,40-44,1854,6.947254546918982
SIM,1859,23,35-39,1882,6
STAT,1859,44,35-39,1903,1.4553833412490902
STAT,1887,20,35-39,1907,6.710533487668863
STAT,1927,28,20-24,1955,22.55736620542026
STAT,1849,24,20-24,1873,63.75871349447564
SIM,1935,28,20-24,1963,39
SIM,1889,36,35-39,1925,16
STAT,1820,65,na,1885,931.1196635115851
STAT,1831,35,15-19,1866,0.050592147338182375
SIM,1841,35,40-44,1876,8
STAT,1884,24,50-100,1908,0.4089992338296987
STAT,1867,32,25-29,1899,9.809666950905523
SIM,1867,44,35-39,1911,3
SIM,1913,36,20-24,1949,2
STAT,1901,21,40-44,1922,2.9816931829891047
STAT,1840,94,na,1934,14.381940523067527
STAT,1899,37,50-100,1936,0.37019346282134463
STAT,1890,42,20-24,1932,0.1978494631653294
STAT,1858,28,40-44,1886,2.4630461145409486
STAT,1878,45,50-100,1923,0.26339311294800666
STAT,1898,24,50-100,1922,0.5590464717867749
SIM,1885,21,25-29,1906,83
SIM,1867,31,50-100,1898,1
STAT,1887,18,50-100,1905,0.05585752114059317
SIM,1910,21,30-34,1931,33
STAT,1819,80,na,1899,364.6977907379431
STAT,1873,45,25-29,1918,0.06016669045206431
STAT,1879,18,30-34,1897,1.6951776215600554
STAT,1837,93,na,1930,19.485345985930074
SIM,1858,36,na,1894,1961
STAT,1808,51,25-29,1859,0.008632458742299821
SIM,1832,38,40-44,1870,11
STAT,1854,43,50-100,1897,0.8027194707878469
STAT,1844,15,35-39,1859,0.5469271702372316
SIM,1888,31,20-24,1919,4
STAT,1941,28,35-39,1969,15.837314280127508
STAT,1898,48,35-39,1946,0.10757663927289496
SIM,1840,26,na,1866,1802
SIM,1919,41,50-100,1960,1
SIM,1852,15,35-39,1867,1
SIM,1928,27,30-34,1955,71
SIM,1897,37,30-34,1934,6
SIM,1911,39,50-100,1950,1
STAT,1869,39,na,1908,2297.0677657514475
STAT,1902,21,30-34,1923,25.702926805734094
STAT,1782,86,na,1868,66.34020371115615
SIM,1867,41,30-34,1908,1
SIM,1909,32,45-49,1941,1
SIM,1941,7,na,1948,3993
STAT,1843,37,50-100,1880,1.1570490316068889
SIM,1868,23,45-49,1891,1
STAT,1805,60,na,1865,1188.872388510876
STAT,1824,38,40-44,1862,5.843884465458683
STAT,1900,42,30-34,1942,0.11274415324562866
STAT,1809,48,50-100,1857,1.0742621166368713
STAT,1868,31,25-29,1899,10.0208440719569
STAT,1902,38,25-29,1940,0.889610941434643
STAT,1904,17,25-29,1921,8.285130028389181
SIM,1883,24,25-29,1907,53
STAT,1869,18,45-49,1887,0.06484339892335811
STAT,1875,42,25-29,1917,0.6715174892569683
SIM,1907,37,40-44,1944,2
STAT,1930,38,30-34,1968,2.4221926809761336
STAT,1823,51,20-24,1874,0.0010894830400211063
STAT,1833,25,30-34,1858,22.70353466072654
SIM,1827,44,na,1871,1483
STAT,1873,44,na,1917,2358.132862931403
SIM,1836,30,45-49,1866,2
SIM,1899,34,30-34,1933,4
SIM,1910,38,25-29,1948,3
SIM,1912,17,25-29,1929,25
SIM,1931,23,50-100,1954,1
STAT,1918,48,30-34,1966,0.0965384102236819
STAT,1900,24,30-34,1924,25.028006400764298
STAT,1794,71,na,1865,629.6056392956402
STAT,1838,18,15-19,1856,5.7257071494920435
STAT,1903,28,na,1931,3448.6694534824423
STAT,1934,30,35-39,1964,12.7384188688001
STAT,1943,25,35-39,1968,16.32760211752337
STAT,1806,54,25-29,1860,0.011036120515656582
STAT,1836,39,15-19,1875,0.0420235682183932
STAT,1919,15,na,1934,4390.115241882106
SIM,1845,69,na,1914,1262
STAT,1867,39,50-100,1906,1.16401378670414
STAT,1891,29,40-44,1920,3.7563504270784263
STAT,1913,40,45-49,1953,0.16744878102721833
STAT,1832,62,na,1894,1221.3410304984634
STAT,1861,30,30-34,1891,14.836292537864843
SIM,1804,87,na,1891,78
STAT,1883,19,35-39,1902,0.5462934316064834
STAT,1927,38,50-100,1965,0.5319479627951814
STAT,1947,17,50-100,1964,0.43059194629160624
SIM,1870,36,na,1906,2606
SIM,1887,19,15-19,1906,7
SIM,1905,21,20-24,1926,1
STAT,1924,40,20-24,1964,0.02149132156397761
SIM,1897,24,25-29,1921,95
SIM,1863,82,na,1945,280
STAT,1899,40,15-19,1939,0.0013531878056190854
STAT,1831,80,na,1911,416.8232878216213
SIM,1871,18,na,1889,2442
STAT,1809,50,na,1859,1556.475647411905
STAT,1946,17,30-34,1963,13.793133397694369
STAT,1811,54,35-39,1865,0.021885554092380896
STAT,1872,47,50-100,1919,0.24993804031857117
STAT,1827,75,na,1902,665.3612402101916
STAT,1857,7,na,1864,2317.756536816968
SIM,1841,25,30-34,1866,4
STAT,1934,32,30-34,1966,21.937048883616683
STAT,1823,85,na,1908,152.57030209070217
STAT,1876,80,na,1956,690.8565340052394
STAT,1917,35,35-39,1952,2.588105166493212
STAT,1872,90,na,1962,164.70439332813902
STAT,1907,43,25-29,1950,0.0663123156334774
STAT,1852,15,50-100,1867,0.0483023002963876
SIM,1923,38,35-39,1961,1
STAT,1909,40,25-29,1949,0.06889090512959661
STAT,1930,25,25-29,1955,85.43427708789456
STAT,1872,48,15-19,1920,4.0383277522374394E-4
STAT,1856,72,na,1928,1011.3306601314497
STAT,1916,32,40-44,1948,4.1229773827431595
STAT,1833,109,na,1942,4.672125699349475E-4
SIM,1893,31,50-100,1924,4
STAT,1830,49,20-24,1879,0.009703848731305828
STAT,1786,109,na,1895,3.0740416817958327E-4
STAT,1902,26,50-100,1928,0.9234487719722619
SIM,1877,31,45-49,1908,3
STAT,1932,35,30-34,1967,2.5016748905857504
STAT,1940,1,na,1941,4307.940320954661
STAT,1910,16,40-44,1926,0.2833646576828027
STAT,1872,18,50-100,1890,0.04995951172279858
SIM,1877,15,na,1892,2652
STAT,1833,43,30-34,1876,0.9099308703104326
STAT,1835,22,30-34,1857,17.648582550711836
STAT,1904,49,50-100,1953,0.19832377275256272
STAT,1900,40,35-39,1940,0.17959346619826053
STAT,1849,35,50-100,1884,0.9958132807379348
STAT,1822,104,na,1926,0.03878233903759672
STAT,1869,31,45-49,1900,1.7245239934314007
STAT,1885,16,35-39,1901,0.5598361287466797
STAT,1913,22,15-19,1935,5.262199387058857
SIM,1913,3,na,1916,4325
SIM,1893,16,35-39,1909,1
STAT,1877,34,na,1911,2503.3048529959665
SIM,1907,35,45-49,1942,1
SIM,1843,22,30-34,1865,25
STAT,1816,46,35-39,1862,0.29259536654213614
STAT,1864,52,20-24,1916,6.657903098089347E-4
SIM,1954,17,30-34,1971,15
STAT,1915,38,35-39,1953,2.481018949145454
STAT,1917,17,35-39,1934,0.9214798000585505
STAT,1881,79,na,1960,859.8410305623792
STAT,1907,25,25-29,1932,63.79262036864927
STAT,1835,40,30-34,1875,1.0534379431721606
STAT,1912,27,30-34,1939,39.38990680750217
STAT,1944,22,45-49,1966,1.2394709725792368
STAT,1825,80,na,1905,370.9491983115639
STAT,1892,11,na,1903,3306.8249072389267
SIM,1906,17,na,1923,3745
STAT,1917,49,25-29,1966,0.05621024677300495
STAT,1851,23,25-29,1874,55.99523605767917
STAT,1927,22,45-49,1949,1.4141044819401083
SIM,1864,36,na,1900,2153
SIM,1872,31,na,1903,2498
STAT,1820,53,50-100,1873,0.025960423542790177
SIM,1821,59,na,1880,1175
SIM,1872,2,na,1874,3239
STAT,1871,20,45-49,1891,0.7088650311561204
SIM,1795,65,na,1860,842
SIM,1867,26,35-39,1893,14
SIM,1842,23,25-29,1865,63
STAT,1922,30,15-19,1952,0.14934126600601488
STAT,1807,109,na,1916,3.006652453906693E-4
STAT,1839,17,20-24,1856,16.00549005305713
STAT,1860,47,40-44,1907,0.14104404599469458
STAT,1871,49,na,1920,2226.0501641395676
STAT,1839,33,25-29,1872,8.609211677423596
STAT,1852,39,50-100,1891,0.979117016486597
STAT,1834,23,25-29,1857,51.15222838728933
STAT,1944,10,na,1954,4320.18578240397
STAT,1814,49,35-39,1863,0.4041468840257749
STAT,1927,35,20-24,1962,0.33490492286058854
STAT,1860,31,25-29,1891,8.512595885582048
STAT,1866,37,35-39,1903,6.65540821125741
STAT,1877,2,na,1879,3438.289207320009
SIM,1929,25,25-29,1954,12
SIM,1895,28,na,1923,3259
STAT,1818,39,na,1857,1510.305094336577
SIM,1843,40,30-34,1883,1
STAT,1920,6,na,1926,4588.985172906687
SIM,1873,23,25-29,1896,84
SIM,1915,25,25-29,1940,93
STAT,1899,29,40-44,1928,4.1548030790403905
SIM,1920,27,30-34,1947,66
SIM,1882,61,na,1943,1796
STAT,1889,24,25-29,1913,71.68609830609856
SIM,1906,38,35-39,1944,3
STAT,1869,30,30-34,1899,17.33444856612038
STAT,1910,32,45-49,1942,1.5474791351034634
SIM,1916,0,na,1916,4558
STAT,1904,48,30-34,1952,0.07883045130898186
STAT,1822,60,na,1882,1197.3862317949931
SIM,1802,92,na,1894,31
SIM,1874,37,35-39,1911,8
SIM,1884,23,30-34,1907,27
STAT,1830,47,25-29,1877,0.04780308360159464
STAT,1854,20,45-49,1874,0.6361794686416915
STAT,1784,81,na,1865,170.0082920726419
STAT,1891,40,15-19,1931,0.017617780240287238
SIM,1856,36,30-34,1892,7
SIM,1925,32,30-34,1957,22
SIM,1911,19,30-34,1930,3
SIM,1893,31,30-34,1924,34
SIM,1907,58,na,1965,3226
STAT,1855,111,na,1966,5.300162860185966E-4
SIM,1802,52,na,1854,1109
SIM,1935,22,45-49,1957,4
STAT,1922,43,20-24,1965,0.020650545631549947
SIM,1878,56,na,1934,2297
STAT,1885,69,na,1954,1493.6345381783017
STAT,1885,31,30-34,1916,17.842750118422575
SIM,1847,33,25-29,1880,13
SIM,1886,23,na,1909,2584
SIM,1946,25,25-29,1971,106
STAT,1848,77,na,1925,671.920637456727
STAT,1818,40,30-34,1858,3.1984372423457326
STAT,1892,26,50-100,1918,0.8206930774815908
STAT,1848,36,30-34,1884,4.313858067411215
STAT,1903,19,30-34,1922,2.2989777134955633
SIM,1856,41,na,1897,2260
SIM,1858,36,35-39,1894,5
STAT,1865,23,25-29,1888,53.26298679032427
STAT,1917,32,30-34,1949,16.836198837871397
STAT,1834,41,25-29,1875,0.52768555966882
STAT,1848,23,25-29,1871,53.7929512153772
STAT,1883,74,na,1957,1178.2563313434875
STAT,1908,24,30-34,1932,26.775061086773043
SIM,1831,39,35-39,1870,4
SIM,1859,42,50-100,1901,1
SIM,1870,76,na,1946,901
STAT,1809,50,30-34,1859,0.02631919268516874
STAT,1851,41,25-29,1892,0.5321878913173747
STAT,1825,33,25-29,1858,18.789292402015615
STAT,1865,39,40-44,1904,4.012349167046555
STAT,1925,15,na,1940,4557.443309423438
STAT,1854,77,na,1931,661.5665205392116
STAT,1855,47,30-34,1902,0.0746893568020445
STAT,1932,25,na,1957,5008.290467282965
SIM,1944,25,20-24,1969,21
STAT,1810,75,na,1885,423.61951880996094
SIM,1912,35,25-29,1947,1
SIM,1961,2,na,1963,5333
SIM,1816,72,na,1888,728
STAT,1828,57,na,1885,1150.7772128832669
STAT,1928,33,15-19,1961,0.16379604017579805
STAT,1936,25,20-24,1961,17.83322522769211
STAT,1828,30,45-49,1858,1.846758017750071
STAT,1855,18,15-19,1873,5.43955181313576
STAT,1933,15,25-29,1948,59.43501264844808
STAT,1878,16,50-100,1894,0.052150344887848046
SIM,1815,59,na,1874,1112
STAT,1938,25,25-29,1963,66.57656696189702
SIM,1833,33,25-29,1866,12
SIM,1941,15,25-29,1956,91
SIM,1847,17,20-24,1864,18
SIM,1938,10,na,1948,3956
STAT,1895,21,45-49,1916,0.9309447900685934
SIM,1926,37,na,1963,4919
STAT,1894,46,na,1940,2961.2145784523914
SIM,1873,39,40-44,1912,3
STAT,1904,35,25-29,1939,0.9172290398024525
STAT,1908,40,35-39,1948,0.1921298065553033
SIM,1874,38,na,1912,2387
STAT,1771,107,na,1878,0.007273364236101504
STAT,1865,49,na,1914,2039.639692028385
SIM,1866,28,40-44,1894,3
SIM,1842,41,25-29,1883,4
STAT,1857,14,na,1871,2215.2032698007242
STAT,1859,41,30-34,1900,0.9408900399728527
SIM,1833,44,na,1877,1658
STAT,1923,46,45-49,1969,0.26005611441788284
STAT,1876,41,30-34,1917,1.216574213478005
STAT,1790,81,na,1871,217.18436718112437
SIM,1916,24,30-34,1940,39
STAT,1840,39,35-39,1879,5.896095120837287
STAT,1942,22,40-44,1964,3.5967690400727643
STAT,1838,29,50-100,1867,0.5893268438095584
SIM,1847,15,25-29,1862,13
SIM,1853,30,45-49,1883,5
STAT,1941,19,50-100,1960,0.3934366093591516
SIM,1844,16,na,1860,2390
STAT,1900,27,35-39,1927,13.643099857419529
STAT,1870,95,na,1965,44.47468442372706
STAT,1889,37,30-34,1926,6.716033490638654
STAT,1871,48,25-29,1919,0.0574748550576419
SIM,1925,30,35-39,1955,20
STAT,1892,24,25-29,1916,72.73386219635879
STAT,1840,51,20-24,1891,5.335459345298672E-4
STAT,1803,65,na,1868,934.6911375892375
STAT,1879,69,na,1948,1564.922229449251
SIM,1843,101,na,1944,1
SIM,1912,17,na,1929,4081
SIM,1841,79,na,1920,473
SIM,1856,23,25-29,1879,93
STAT,1818,102,na,1920,0.14940689984438849
STAT,1845,30,45-49,1875,1.6540504619553906
STAT,1908,42,30-34,1950,0.12061414488994314
STAT,1839,15,25-29,1854,5.176780266388452
SIM,1778,93,na,1871,7
STAT,1933,33,25-29,1966,12.694629550260982
SIM,1901,32,45-49,1933,6
STAT,1858,37,50-100,1895,0.9932533122964851
SIM,1818,42,50-100,1860,1
STAT,1902,35,20-24,1937,0.24163648134755955
SIM,1888,18,20-24,1906,30
STAT,1919,43,na,1962,4100.611897108649
STAT,1947,15,25-29,1962,49.831552407714774
SIM,1884,41,30-34,1925,1
STAT,1930,40,45-49,1970,0.22395986868380446
STAT,1943,22,30-34,1965,31.197958470527457
SIM,1898,48,na,1946,3409
STAT,1882,80,na,1962,838.2509942495242
SIM,1932,25,na,1957,5130
SIM,1814,77,na,1891,459
STAT,1842,52,na,1894,1679.535141662152
SIM,1882,29,40-44,1911,3
STAT,1884,18,40-44,1902,0.18411722240410924
SIM,1863,18,15-19,1881,6
SIM,1810,87,na,1897,166
STAT,1874,29,40-44,1903,3.097765399092409
STAT,1775,104,na,1879,0.03062277933321981
STAT,1859,49,na,1908,1794.707741504612
STAT,1853,39,15-19,1892,0.04661163140936235
SIM,1857,94,na,1951,10
SIM,1850,16,na,1866,2223
SIM,1876,21,na,1897,2949
SIM,1931,12,na,1943,5167
SIM,1944,10,na,1954,4272
STAT,1920,15,15-19,1935,10.473336338739873
STAT,1819,40,na,1859,1720.956264765538
SIM,1899,37,35-39,1936,6
STAT,1840,36,30-34,1876,4.583394436363996
SIM,1771,83,na,1854,81
STAT,1791,101,na,1892,0.10067971764649608
STAT,1842,33,30-34,1875,16.369403125238982
SIM,1854,8,na,1862,2528
STAT,1894,21,25-29,1915,75.34552406605074
STAT,1820,37,na,1857,1546.1370060588285
STAT,1807,55,na,1862,1309.056777454007
STAT,1879,19,15-19,1898,6.294400321029792
STAT,1857,103,na,1960,0.2789745665964039
STAT,1901,33,na,1934,3389.8956593558346
STAT,1924,43,25-29,1967,0.08652222327014139
STAT,1930,22,20-24,1952,145.28442208345732
SIM,1910,24,35-39,1934,12
SIM,1950,19,na,1969,4438
STAT,1833,28,35-39,1861,8.419338508777889
STAT,1843,35,40-44,1878,4.212015906779945
STAT,1883,24,50-100,1907,0.40562880137303575
SIM,1851,35,40-44,1886,8
STAT,1902,24,35-39,1926,8.342631819159337
SIM,1835,30,25-29,1865,18
STAT,1825,36,35-39,1861,11.197880742937986
SIM,1926,39,50-100,1965,1
STAT,1829,70,na,1899,933.1619834275507
STAT,1854,48,25-29,1902,0.04353050324457471
STAT,1921,35,25-29,1956,1.1238058200235093
STAT,1939,24,30-34,1963,29.425365554230694
STAT,1903,68,na,1971,2598.588334993449
STAT,1962,9,na,1971,5134.560282747508
SIM,1856,20,15-19,1876,2
STAT,1813,49,20-24,1862,0.029164224068638608
SIM,1879,23,20-24,1902,82
STAT,1901,22,25-29,1923,81.66539722686173
STAT,1929,42,50-100,1971,0.1551742273009859
SIM,1831,49,na,1880,1472
STAT,1835,25,35-39,1860,9.509515425045329
STAT,1925,24,30-34,1949,34.87987472972679
SIM,1924,35,45-49,1959,2
STAT,1909,34,50-100,1943,0.7977718475234258
SIM,1876,31,25-29,1907,18
STAT,1918,32,45-49,1950,1.7063816027986083
STAT,1848,20,15-19,1868,3.1677952150133284
STAT,1922,49,35-39,1971,0.15024552365729502
STAT,1938,22,20-24,1960,112.26068080198456
SIM,1833,36,35-39,1869,11
SIM,1850,33,30-34,1883,24
STAT,1883,34,na,1917,2368.1645168429877
STAT,1893,20,50-100,1913,0.5308893161544803
STAT,1961,4,na,1965,5181.274827275498
STAT,1914,31,na,1945,3900.135497980042
SIM,1901,31,30-34,1932,31
STAT,1843,93,na,1936,23.592871560280404
STAT,1898,48,50-100,1946,0.18872016089427227
SIM,1907,32,40-44,1939,1
SIM,1919,43,na,1962,4172
STAT,1890,56,na,1946,2544.1106892481357
SIM,1856,39,35-39,1895,4
SIM,1913,16,30-34,1929,2
STAT,1896,19,15-19,1915,7.953056869315353
STAT,1905,43,20-24,1948,0.016131114407177308
SIM,1843,25,35-39,1868,14
STAT,1843,17,40-44,1860,0.18868999460932842
SIM,1916,43,45-49,1959,2
SIM,1856,72,na,1928,1177
SIM,1883,21,20-24,1904,95
SIM,1889,28,na,1917,3021
STAT,1908,43,45-49,1951,0.15607361697842947
SIM,1918,38,25-29,1956,1
STAT,1795,65,na,1860,713.5619375038654
STAT,1905,16,30-34,1921,2.35408639017075
SIM,1839,69,na,1908,1111
SIM,1841,28,40-44,1869,5
STAT,1830,67,na,1897,1002.7963481208055
STAT,1921,17,25-29,1938,50.405908221882996
STAT,1869,15,35-39,1884,0.5544237301027485
SIM,1897,21,20-24,1918,88
STAT,1841,38,40-44,1879,3.768759730639433
SIM,1915,53,na,1968,4009
SIM,1838,22,20-24,1860,61
STAT,1829,28,15-19,1857,0.5263241662838402
SIM,1935,35,20-24,1970,1
STAT,1867,44,na,1911,2183.6688702274205
SIM,1926,32,45-49,1958,3
STAT,1827,49,15-19,1876,4.372694456933974E-4
STAT,1881,37,30-34,1918,5.256442135613747
STAT,1897,31,20-24,1928,3.70213873125232
SIM,1918,22,45-49,1940,2
STAT,1889,21,20-24,1910,87.10181664315274
SIM,1869,20,25-29,1889,73
STAT,1859,26,35-39,1885,8.054649569266209
SIM,1897,23,na,1920,3178
SIM,1891,78,na,1969,1362
STAT,1899,47,40-44,1946,0.13427789819985173
STAT,1951,17,40-44,1968,1.699160083605465
SIM,1891,16,30-34,1907,3
STAT,1838,17,30-34,1855,1.5468905422663242
STAT,1816,60,na,1876,1044.5563480384503
SIM,1868,44,50-100,1912,3
SIM,1862,41,na,1903,2123
STAT,1814,46,30-34,1860,0.2933351428365339
SIM,1937,3,na,1940,4696
STAT,1876,23,30-34,1899,18.706001743271845
SIM,1868,66,na,1934,1619
STAT,1906,45,30-34,1951,0.08188572743734698
SIM,1916,25,45-49,1941,2
STAT,1856,30,20-24,1886,2.2371008332538445
SIM,1842,20,20-24,1862,3
SIM,1904,22,15-19,1926,3
SIM,1943,26,15-19,1969,1
STAT,1947,19,40-44,1966,1.606466782864396
SIM,1825,49,na,1874,1410
SIM,1903,68,na,1971,2507
STAT,1904,13,na,1917,3769.945858180266
SIM,1824,43,30-34,1867,5
SIM,1911,21,45-49,1932,3
STAT,1853,52,45-49,1905,0.012103860193651941
SIM,1859,35,40-44,1894,10
SIM,1925,35,35-39,1960,3
STAT,1833,46,35-39,1879,0.10987634683132412
STAT,1853,20,25-29,1873,57.537733911562654
STAT,1788,71,na,1859,651.1240239812662
STAT,1883,34,30-34,1917,17.326946205478432
SIM,1878,29,15-19,1907,3
SIM,1922,36,25-29,1958,2
STAT,1871,18,na,1889,2553.5406993539054
STAT,1964,1,na,1965,5057.584497933313
SIM,1886,51,na,1937,2465
SIM,1912,49,50-100,1961,1
SIM,1892,36,40-44,1928,8
STAT,1848,39,35-39,1887,5.549362564445868
STAT,1816,43,30-34,1859,2.597654892565155
SIM,1832,90,na,1922,15
STAT,1942,25,45-49,1967,1.8515394668663194
SIM,1891,34,30-34,1925,34
STAT,1834,35,50-100,1869,1.0492713544886887
STAT,1853,24,na,1877,2087.979731941702
STAT,1869,43,50-100,1912,1.0329919715122071
STAT,1935,30,25-29,1965,13.055060351457964
STAT,1840,54,30-34,1894,0.004165650560855649
SIM,1933,19,na,1952,4910
SIM,1864,30,20-24,1894,1
SIM,1887,18,30-34,1905,6
STAT,1908,25,45-49,1933,1.6908932595919586
SIM,1879,69,na,1948,1685
STAT,1920,33,15-19,1953,0.14303558082323997
STAT,1876,26,35-39,1902,10.199346512318403
SIM,1946,22,20-24,1968,176
SIM,1838,28,na,1866,1837
STAT,1917,46,20-24,1963,0.011808798999469333
STAT,1862,72,na,1934,1096.6979765383107
STAT,1849,52,25-29,1901,0.0027352400157172464
STAT,1936,15,na,1951,3610.916348169076
STAT,1923,43,40-44,1966,0.2978092741144479
STAT,1884,16,na,1900,2555.3108673427637
STAT,1919,30,50-100,1949,0.9175911876247378
STAT,1916,35,45-49,1951,0.7191831627201456
SIM,1927,30,50-100,1957,1
SIM,1910,50,na,1960,3426
SIM,1869,23,35-39,1892,6
STAT,1789,96,na,1885,1.2896794857074263
STAT,1808,49,40-44,1857,0.4217201714316197
SIM,1837,34,na,1871,1658
STAT,1853,52,na,1905,1795.8170600465012
STAT,1812,70,na,1882,760.6992124045549
STAT,1894,74,na,1968,1837.3208797863138
STAT,1921,16,50-100,1937,0.4368561596824075
SIM,1874,66,na,1940,1601
SIM,1898,32,20-24,1930,4
STAT,1817,45,40-44,1862,0.3945794787895599
SIM,1819,49,na,1868,1384
SIM,1842,39,40-44,1881,1
STAT,1861,59,na,1920,1638.2785550176097
SIM,1841,28,35-39,1869,18
STAT,1892,27,35-39,1919,12.336752152223003
STAT,1936,28,25-29,1964,64.21650688848544
SIM,1886,20,30-34,1906,27
STAT,1831,47,15-19,1878,3.27140513507291E-4
STAT,1871,50,45-49,1921,0.014875896232848346
STAT,1925,27,40-44,1952,5.6166955470588755
SIM,1830,64,na,1894,1139
STAT,1869,15,40-44,1884,0.1848079207344077
SIM,1897,21,15-19,1918,5
STAT,1838,87,na,1925,129.4492101670397
STAT,1922,46,25-29,1968,0.06233435079205882
STAT,1851,53,25-29,1904,0.002875302782819325
SIM,1858,33,30-34,1891,2
STAT,1850,87,na,1937,132.5240366257486
STAT,1933,19,40-44,1952,1.899251609273745
STAT,1889,21,15-19,1910,4.169795196183588
SIM,1905,24,25-29,1929,111
STAT,1863,45,50-100,1908,0.22186743154930513
STAT,1827,30,25-29,1857,17.544566327604784
SIM,1885,38,na,1923,2388
STAT,1909,36,15-19,1945,0.018626985005212066
STAT,1785,110,na,1895,2.0668094227008812E-4
SIM,1912,32,20-24,1944,5
STAT,1832,44,25-29,1876,0.5141228058516587
SIM,1861,20,25-29,1881,81
SIM,1868,97,na,1965,6
SIM,1763,91,na,1854,21
STAT,1846,18,50-100,1864,0.04375200901667724
SIM,1906,35,30-34,1941,2
STAT,1896,48,30-34,1944,0.07264548431991935
SIM,1856,20,20-24,1876,87
STAT,1890,16,na,1906,3158.018766630468
SIM,1941,19,40-44,1960,1
STAT,1834,39,40-44,1873,3.58895894114183
STAT,1855,6,na,1861,2300.2217515574303
SIM,1865,44,30-34,1909,3
STAT,1834,20,20-24,1854,111.86461832195867
STAT,1918,21,na,1939,4031.345759428406
STAT,1907,58,na,1965,3166.0984528259232
STAT,1813,55,na,1868,1156.893048505593
STAT,1812,51,45-49,1863,0.03342384645382654
STAT,1851,26,35-39,1877,9.388085285313911
STAT,1874,15,15-19,1889,6.233095776294169
STAT,1920,33,45-49,1953,1.75151109035025
STAT,1904,32,20-24,1936,2.2692671430390976
SIM,1891,38,na,1929,3025
STAT,1884,36,40-44,1920,4.439402215428699
STAT,1912,42,20-24,1954,0.01737564968301028
SIM,1866,31,na,1897,2349
STAT,1848,20,20-24,1868,66.17128779698449
STAT,1913,32,50-100,1945,0.8391834580180333
SIM,1853,44,50-100,1897,1
STAT,1912,24,20-24,1936,112.57642715903245
STAT,1914,36,25-29,1950,1.0078453869479829
SIM,1795,93,na,1888,8
STAT,1857,44,30-34,1901,0.9035986275243526
SIM,1856,39,40-44,1895,1
STAT,1923,44,50-100,1967,0.1396318659960515
SIM,1816,44,na,1860,1606
SIM,1933,27,40-44,1960,7
STAT,1903,36,50-100,1939,0.38613960151742716
SIM,1808,77,na,1885,417
STAT,1844,87,na,1931,136.52449523518982
STAT,1934,33,45-49,1967,2.1896456930249637
STAT,1836,52,na,1888,1356.012604061384
STAT,1897,26,na,1923,3266.476366518477
STAT,1903,21,45-49,1924,1.0142840932869839
SIM,1833,36,50-100,1869,1
STAT,1962,0,na,1962,5175.479994066967
SIM,1920,24,20-24,1944,178
SIM,1882,15,15-19,1897,5
STAT,1912,36,na,1948,3763.8923061165474
SIM,1879,26,25-29,1905,64
SIM,1817,82,na,1899,184
STAT,1840,54,25-29,1894,0.002478734194140125
SIM,1932,25,30-34,1957,65
SIM,1814,49,na,1863,1277
SIM,1835,70,na,1905,839
STAT,1855,87,na,1942,136.57504015320046
SIM,1854,77,na,1931,827
STAT,1903,15,15-19,1918,8.64606086201417
STAT,1815,59,na,1874,1266.2467164268387
STAT,1951,17,35-39,1968,5.097479955678369
SIM,1901,16,35-39,1917,2
STAT,1821,39,30-34,1860,10.27264692236428
SIM,1842,27,40-44,1869,6
SIM,1875,39,50-100,1914,3
STAT,1933,37,40-44,1970,2.0794146046305735
STAT,1834,27,40-44,1861,2.643385627474652
SIM,1898,20,20-24,1918,103
SIM,1917,17,na,1934,4172
STAT,1860,35,40-44,1895,3.657732606411604
STAT,1859,31,50-100,1890,0.7495295471263279
STAT,1920,31,na,1951,4244.835985424813
STAT,1897,34,25-29,1931,13.85167047865614
STAT,1900,25,45-49,1925,1.580563614287431
SIM,1852,30,25-29,1882,9
SIM,1838,27,20-24,1865,12
STAT,1923,23,50-100,1946,0.7787381959204588
STAT,1868,16,35-39,1884,0.5475495233646208
STAT,1830,27,na,1857,1788.7819415394888
SIM,1908,30,35-39,1938,12
STAT,1909,42,45-49,1951,0.1587606261479341
STAT,1941,9,na,1950,4159.133107654052
STAT,1847,52,20-24,1899,5.72375782353009E-4
STAT,1914,45,50-100,1959,0.22994409857449508
STAT,1906,41,15-19,1947,0.001430384673541522
STAT,1818,40,25-29,1858,1.7865145030341592
SIM,1911,15,15-19,1926,12
SIM,1951,18,20-24,1969,206
STAT,1924,21,na,1945,4409.609337139286
SIM,1827,75,na,1902,544
STAT,1912,27,25-29,1939,66.16851956630434
STAT,1883,16,30-34,1899,1.599326574929153
STAT,1920,37,30-34,1957,2.036407504414315
SIM,1930,28,30-34,1958,72
SIM,1929,29,40-44,1958,7
SIM,1908,40,na,1948,3820
STAT,1922,28,30-34,1950,45.08088232020802
SIM,1866,62,na,1928,1959
SIM,1881,79,na,1960,788
STAT,1826,50,30-34,1876,0.004672920282242305
STAT,1774,114,na,1888,2.169292643652418E-4
STAT,1836,52,45-49,1888,0.009140419680591316
SIM,1904,38,30-34,1942,2
SIM,1906,17,30-34,1923,4
SIM,1786,88,na,1874,27
STAT,1868,54,50-100,1922,0.014310956001052276
STAT,1935,32,45-49,1967,2.220137110812884
STAT,1895,49,25-29,1944,0.04234319195210421
SIM,1906,23,30-34,1929,28
STAT,1893,41,30-34,1934,1.4945711975996128
SIM,1890,28,na,1918,3072
STAT,1828,85,na,1913,150.9567125978753
SIM,1853,36,na,1889,1928
SIM,1841,48,na,1889,1717
STAT,1828,88,na,1916,75.59750692071277
SIM,1877,3,na,1880,3045
STAT,1844,47,na,1891,1735.299284593768
SIM,1887,20,45-49,1907,1
SIM,1833,33,30-34,1866,18
SIM,1904,50,na,1954,3328
STAT,1764,111,na,1875,0.0019905686171776144
STAT,1898,64,na,1962,2567.9454915395995
STAT,1904,32,15-19,1936,0.11955384097808827
STAT,1899,43,25-29,1942,0.06184465054880878
STAT,1911,25,20-24,1936,18.28134799361946
STAT,1930,40,15-19,1970,0.0020665271917652294
SIM,1898,39,40-44,1937,1
STAT,1872,43,15-19,1915,0.014017582583791726
SIM,1913,19,35-39,1932,2
STAT,1849,31,20-24,1880,2.455415088112737
STAT,1858,36,na,1894,1915.1772988568782
SIM,1917,8,na,1925,4270
STAT,1876,24,na,1900,2475.8150264745545
SIM,1879,28,20-24,1907,16
STAT,1892,24,30-34,1916,22.631536458524497
STAT,1909,53,na,1962,3369.6595466021686
SIM,1893,31,25-29,1924,22
STAT,1841,22,25-29,1863,53.544443260050755
STAT,1857,32,30-34,1889,13.996366908929371
STAT,1848,25,15-19,1873,0.4271426378738832
SIM,1865,26,30-34,1891,32
SIM,1908,43,na,1951,3740
STAT,1893,39,50-100,1932,1.5728875959369761
STAT,1861,42,30-34,1903,0.967940645700271
STAT,1885,31,25-29,1916,10.467307426096264
SIM,1857,35,50-100,1892,1
SIM,1876,16,35-39,1892,1
STAT,1832,93,na,1925,19.529224880684108
STAT,1841,67,na,1908,1170.4498131869088
STAT,1845,17,45-49,1862,0.06450952244198148
STAT,1867,72,na,1939,1209.5144961825454
STAT,1825,40,na,1865,1679.79939105161
STAT,1831,42,15-19,1873,0.011703876877311632
STAT,1873,13,na,1886,2700.8681433376823
SIM,1907,33,25-29,1940,12
STAT,1874,54,na,1928,2180.985734427729
STAT,1908,40,40-44,1948,0.23865122784539328
STAT,1924,25,30-34,1949,46.86135303621411
STAT,1860,17,40-44,1877,0.17460288781444816
SIM,1901,34,35-39,1935,11
STAT,1847,109,na,1956,6.335533794228744E-4
STAT,1840,26,na,1866,1954.9957975530099
STAT,1922,46,30-34,1968,0.10475634053516977
SIM,1823,85,na,1908,136
SIM,1929,22,20-24,1951,161
STAT,1825,33,30-34,1858,32.02854713097611
STAT,1899,25,25-29,1924,59.49471491989651
SIM,1857,31,20-24,1888,3
STAT,1925,27,35-39,1952,18.0917834560698
STAT,1903,33,15-19,1936,0.11808026566060562
STAT,1858,46,40-44,1904,0.138895346174082
SIM,1939,32,25-29,1971,10
STAT,1928,20,na,1948,4678.473126419136
STAT,1935,26,15-19,1961,0.9818033077442322
SIM,1854,74,na,1928,903
STAT,1857,26,30-34,1883,20.814543024332977
STAT,1907,28,35-39,1935,14.402129514111623
STAT,1842,101,na,1943,0.44748564919085343
SIM,1915,28,35-39,1943,27
SIM,1911,33,15-19,1944,1
SIM,1900,51,na,1951,2967
STAT,1932,31,15-19,1963,0.17431553425413024
STAT,1795,96,na,1891,1.5361565162697937
SIM,1837,74,na,1911,647
SIM,1828,69,na,1897,858
SIM,1902,29,30-34,1931,38
SIM,1939,26,25-29,1965,75
STAT,1860,29,40-44,1889,2.470180181967108
SIM,1925,43,na,1968,4730
STAT,1916,33,25-29,1949,9.696694556932036
SIM,1860,39,50-100,1899,1
STAT,1877,50,40-44,1927,0.011299232553518905
SIM,1831,29,50-100,1860,3
SIM,1863,40,50-100,1903,4
STAT,1859,41,25-29,1900,0.5255421866395945
SIM,1842,89,na,1931,66
STAT,1826,32,30-34,1858,19.033600118872386
STAT,1845,20,50-100,1865,0.40129526969109014
SIM,1847,95,na,1942,6
STAT,1827,47,na,1874,1632.724878551229
STAT,1912,29,20-24,1941,18.219358234472356
STAT,1804,75,na,1879,427.9996414264401
STAT,1813,43,50-100,1856,3.668789615472828
STAT,1912,45,25-29,1957,0.05224974784683048
SIM,1922,33,20-24,1955,4
STAT,1852,11,na,1863,2336.6001239010498
STAT,1875,21,20-24,1896,72.36994892084478
STAT,1843,62,na,1905,1475.478020243953
STAT,1920,19,30-34,1939,13.880573085297899
SIM,1887,64,na,1951,2069
STAT,1930,22,15-19,1952,6.955150978834755
STAT,1771,86,na,1857,60.427339360698
STAT,1797,91,na,1888,19.637424317383797
STAT,1833,28,40-44,1861,2.613830815865128
STAT,1893,23,30-34,1916,22.9804734622938
STAT,1796,103,na,1899,0.031220600940064222
SIM,1920,29,20-24,1949,22
SIM,1933,10,na,1943,5297
STAT,1906,18,40-44,1924,0.27087128045180087
SIM,1869,20,30-34,1889,24
SIM,1851,31,25-29,1882,13
SIM,1916,22,40-44,1938,4
STAT,1813,47,25-29,1860,0.14476516392877212
SIM,1839,24,30-34,1863,32
SIM,1850,56,na,1906,1503
SIM,1876,61,na,1937,2120
SIM,1865,32,30-34,1897,24
SIM,1902,55,na,1957,3037
SIM,1924,21,25-29,1945,143
STAT,1898,27,30-34,1925,34.73975080790752
STAT,1848,46,na,1894,1753.8411144843278
SIM,1830,37,25-29,1867,2
STAT,1898,15,30-34,1913,2.209042522833792
STAT,1905,43,50-100,1948,0.10730697640218835
SIM,1918,31,50-100,1949,1
STAT,1901,26,40-44,1927,4.288074282515279
SIM,1860,25,35-39,1885,1
STAT,1925,40,40-44,1965,0.3098125203343145
STAT,1926,20,35-39,1946,11.73943095378695
STAT,1914,33,20-24,1947,2.4945083179600087
SIM,1895,68,na,1963,2200
STAT,1852,43,35-39,1895,1.4482565421849694
SIM,1810,56,na,1866,1462
SIM,1834,32,30-34,1866,21
SIM,1913,31,20-24,1944,2
SIM,1878,87,na,1965,339
SIM,1924,33,25-29,1957,14
STAT,1880,38,25-29,1918,3.0712751751271843
SIM,1934,6,na,1940,5700
STAT,1897,16,25-29,1913,7.748609029299843
STAT,1921,47,25-29,1968,0.06102100775143386
SIM,1868,21,25-29,1889,76
SIM,1864,17,20-24,1881,27
STAT,1856,17,20-24,1873,16.78710825587566
STAT,1925,22,40-44,1947,4.1062038609945555
STAT,1817,45,na,1862,1451.3436008656765
STAT,1831,49,35-39,1880,0.11158982124362185
STAT,1849,38,40-44,1887,3.4416617216855325
SIM,1856,9,na,1865,2875
STAT,1843,31,25-29,1874,10.044174859178412
STAT,1786,100,na,1886,0.18686582838915788
STAT,1820,41,30-34,1861,2.352134856727953
STAT,1879,60,na,1939,2033.7305830526316
STAT,1905,31,20-24,1936,2.2961180233884844
STAT,1905,19,35-39,1924,0.8041021468310601
SIM,1838,25,25-29,1863,4
SIM,1848,26,30-34,1874,34
STAT,1861,28,na,1889,2011.8297865140187
STAT,1834,26,na,1860,1919.9172980057197
SIM,1857,38,40-44,1895,10
SIM,1907,15,25-29,1922,12
SIM,1841,70,na,1911,942
STAT,1889,26,15-19,1915,0.5736923931771916
SIM,1859,38,45-49,1897,5
SIM,1867,41,25-29,1908,1
SIM,1911,32,na,1943,3827
STAT,1880,57,na,1937,2154.3839419282504
STAT,1832,22,na,1854,1810.7726260178365
STAT,1856,15,25-29,1871,5.429585127394754
STAT,1906,17,50-100,1923,0.0727453825225698
SIM,1893,64,na,1957,2362
SIM,1839,42,30-34,1881,5
SIM,1871,38,25-29,1909,2
STAT,1846,11,na,1857,2154.3251631040525
STAT,1852,25,35-39,1877,9.185183194207337
SIM,1920,27,25-29,1947,89
SIM,1903,27,25-29,1930,69
SIM,1822,41,na,1863,1447
SIM,1934,20,35-39,1954,16
SIM,1924,15,25-29,1939,70
STAT,1861,87,na,1948,148.5148053676365
STAT,1878,23,35-39,1901,6.177322946576715
STAT,1942,23,25-29,1965,98.7764775103626
SIM,1886,23,35-39,1909,11
STAT,1898,33,30-34,1931,23.984950011748506
STAT,1931,21,20-24,1952,147.52500414335054
SIM,1868,28,45-49,1896,1
STAT,1884,32,25-29,1916,10.337682464667353
STAT,1916,21,25-29,1937,99.07122050216384
SIM,1913,58,na,1971,3470
SIM,1947,24,30-34,1971,46
SIM,1889,68,na,1957,2149
STAT,1867,51,30-34,1918,0.005728222258451017
STAT,1817,41,25-29,1858,1.6808667934816683
STAT,1934,30,40-44,1964,5.454976913208859
STAT,1842,15,30-34,1857,1.624137219981071
SIM,1864,15,25-29,1879,11
STAT,1865,40,na,1905,2161.5766402665727
STAT,1839,32,na,1871,1840.6538078094375
STAT,1867,33,30-34,1900,16.65115930911417
SIM,1826,34,na,1860,1710
STAT,1898,45,30-34,1943,0.07607905013793385
STAT,1847,27,20-24,1874,10.995835800743087
STAT,1856,50,50-100,1906,0.012268135334835256
SIM,1828,29,na,1857,1959
SIM,1938,19,na,1957,3584
STAT,1864,39,na,1903,2115.556606582206
STAT,1919,43,15-19,1962,0.0016955759822471384
SIM,1944,19,na,1963,3998
STAT,1837,20,45-49,1857,0.6430043647257783
SIM,1840,29,35-39,1869,2
STAT,1858,34,50-100,1892,0.7349033959774857
SIM,1848,44,30-34,1892,4
SIM,1769,85,na,1854,112
STAT,1886,15,40-44,1901,0.19841855382413853
STAT,1933,32,50-100,1965,1.1362943877016987
SIM,1923,36,45-49,1959,1
SIM,1847,33,na,1880,1756
STAT,1950,15,30-34,1965,14.710979762753327
SIM,1839,36,30-34,1875,7
SIM,1889,27,30-34,1916,37
SIM,1900,17,35-39,1917,1
STAT,1886,79,na,1965,1069.102267896783
STAT,1851,23,30-34,1874,17.423221977706177
STAT,1863,14,na,1877,2414.4687080817766
STAT,1910,45,20-24,1955,0.01056555137703469
SIM,1933,23,25-29,1956,137
STAT,1832,29,35-39,1861,8.578886586147942
STAT,1783,71,na,1854,606.0
STAT,1925,23,25-29,1948,112.45552142709084
STAT,1897,18,20-24,1915,24.119007693417224
SIM,1828,30,50-100,1858,1
STAT,1916,15,25-29,1931,9.426104071186359
STAT,1856,33,25-29,1889,8.216969759398431
STAT,1848,25,50-100,1873,0.6022445772527036
STAT,1915,36,45-49,1951,0.7061375692367314
SIM,1875,33,30-34,1908,25
SIM,1942,24,na,1966,4631
SIM,1864,76,na,1940,802
STAT,1868,30,50-100,1898,0.8999358812462338
STAT,1926,39,25-29,1965,1.224962609847414
STAT,1863,38,25-29,1901,2.5625293726541787
SIM,1864,33,25-29,1897,15
SIM,1920,45,25-29,1965,1
STAT,1876,53,30-34,1929,0.00616990949006552
STAT,1832,41,20-24,1873,0.13219604747734073
STAT,1931,33,20-24,1964,3.257551462078218
SIM,1915,25,30-34,1940,59
STAT,1915,18,45-49,1933,0.10640935605049354
STAT,1923,41,15-19,1964,0.0018339875462379863
STAT,1883,7,na,1890,2607.8714882650606
STAT,1916,37,40-44,1953,1.5643989524795048
SIM,1849,43,30-34,1892,3
STAT,1941,26,45-49,1967,1.8240972910336872
STAT,1805,54,50-100,1859,0.051128639477387286
STAT,1823,54,25-29,1877,0.0049265797465878275
STAT,1830,47,30-34,1877,0.08033573849361084
STAT,1838,47,na,1885,1700.67651129206
SIM,1855,27,20-24,1882,8
SIM,1875,76,na,1951,979
STAT,1924,28,35-39,1952,17.772051329463032
SIM,1835,48,na,1883,1580
STAT,1834,88,na,1922,92.2569807533486
STAT,1842,21,30-34,1863,17.74577631468496
STAT,1915,53,na,1968,3697.274806852816
SIM,1784,93,na,1877,3
SIM,1919,18,25-29,1937,77
STAT,1853,40,45-49,1893,1.2675935286257116
SIM,1831,89,na,1920,60
STAT,1873,42,20-24,1915,0.16405009042040145
SIM,1857,34,25-29,1891,14
SIM,1892,32,25-29,1924,20
STAT,1893,44,35-39,1937,0.16053793768921906
STAT,1799,55,na,1854,1053.9992731489997
STAT,1867,36,35-39,1903,6.806564613109335
STAT,1917,30,35-39,1947,9.84390564430032
SIM,1875,36,35-39,1911,11
SIM,1832,34,na,1866,1795
STAT,1934,17,35-39,1951,5.788088817625353
STAT,1860,3,na,1863,2697.112176210004
SIM,1932,28,35-39,1960,21
STAT,1926,36,20-24,1962,0.3289588722414112
SIM,1940,20,na,1960,3700
SIM,1858,32,50-100,1890,1
STAT,1892,42,na,1934,2951.424902428078
SIM,1843,74,na,1917,736
SIM,1942,17,35-39,1959,7
SIM,1886,21,45-49,1907,4
SIM,1924,37,40-44,1961,5
SIM,1793,67,na,1860,626
STAT,1863,53,20-24,1916,6.494357238819275E-4
SIM,1871,21,na,1892,2242
STAT,1852,14,na,1866,2304.919894763614
STAT,1899,40,20-24,1939,0.015561658924120767
STAT,1806,51,20-24,1857,0.0024504100225417615
SIM,1825,41,25-29,1866,4
STAT,1843,47,40-44,1890,0.13756081991679953
STAT,1951,15,45-49,1966,0.6071644941133043
SIM,1929,42,na,1971,5117
STAT,1863,54,na,1917,1872.9434460298583
STAT,1876,38,50-100,1914,1.286925335443845
STAT,1926,40,25-29,1966,0.09005675058439859
STAT,1843,29,40-44,1872,2.933490554687685
STAT,1857,47,35-39,1904,0.11102063675859328
STAT,1846,73,na,1919,849.3877774895271
STAT,1921,29,25-29,1950,74.32108961117855
STAT,1887,44,50-100,1931,1.1913642093240118
STAT,1939,18,30-34,1957,12.44230820619225
SIM,1947,18,30-34,1965,22
SIM,1850,21,30-34,1871,21
SIM,1902,31,45-49,1933,1
STAT,1867,13,na,1880,2556.8206068038926
STAT,1843,100,na,1943,0.8570373872954015
STAT,1849,34,25-29,1883,8.207151239516127
SIM,1923,17,na,1940,4138
STAT,1862,42,45-49,1904,1.2980822573671569
STAT,1896,17,50-100,1913,0.0660093766480048
SIM,1816,41,na,1857,1676
STAT,1827,49,50-100,1876,0.26848366519295636
STAT,1865,25,15-19,1890,0.4229344564177351
SIM,1938,19,35-39,1957,5
STAT,1879,20,45-49,1899,0.748029042094109
SIM,1914,43,na,1957,3771
SIM,1851,29,40-44,1880,5
STAT,1821,59,na,1880,1103.2980439926994
STAT,1841,53,30-34,1894,0.004324513054488288
STAT,1857,29,35-39,1886,7.804930272670135
STAT,1911,28,25-29,1939,65.24444917267031
STAT,1913,40,15-19,1953,0.0015450868999625903
STAT,1851,29,na,1880,2059.777514161725
STAT,1944,6,na,1950,4356.929917322514
SIM,1812,42,na,1854,1371
STAT,1857,24,50-100,1881,0.33643165785196033
STAT,1917,23,50-100,1940,0.7114526336478015
SIM,1847,17,15-19,1864,6
SIM,1803,51,45-49,1854,1
SIM,1896,13,na,1909,3524
STAT,1852,22,30-34,1874,17.04665869928978
STAT,1932,22,50-100,1954,0.8804604208855754
STAT,1849,87,na,1936,136.77980815868693
STAT,1861,45,35-39,1906,0.11919211834683965
SIM,1901,33,na,1934,3543
STAT,1901,29,45-49,1930,1.572614626359383
STAT,1848,24,30-34,1872,16.61779046379108
STAT,1799,58,na,1857,993.2005005325076
STAT,1827,50,45-49,1877,0.016361217276640787
STAT,1851,50,20-24,1901,6.175449779914879E-4
STAT,1961,1,na,1962,5187.756951700894
STAT,1871,48,30-34,1919,0.0965896879027879
STAT,1919,49,50-100,1968,0.24887737022050793
STAT,1835,52,30-34,1887,0.00452170332732027
SIM,1898,35,25-29,1933,3
STAT,1929,17,30-34,1946,15.865631358378563
SIM,1810,49,45-49,1859,2
SIM,1934,3,na,1937,5750
SIM,1908,28,20-24,1936,20
SIM,1937,17,30-34,1954,22
STAT,1868,54,na,1922,2040.283333678645
SIM,1896,5,na,1901,3588
STAT,1847,28,50-100,1875,0.5952757689575896
SIM,1952,16,15-19,1968,51
STAT,1903,37,30-34,1940,1.6681860963361403
STAT,1878,20,30-34,1898,19.027025587075393
STAT,1908,22,40-44,1930,3.1520715044074294
STAT,1826,53,35-39,1879,0.006368000211787478
SIM,1951,20,35-39,1971,16
STAT,1872,47,30-34,1919,0.09850978161782105
STAT,1944,16,15-19,1960,49.84278348410356
STAT,1858,42,25-29,1900,0.5188703636091798
SIM,1896,22,45-49,1918,1
STAT,1913,38,30-34,1951,1.825784608688991
STAT,1939,3,na,1942,4132.760142896128
SIM,1865,29,35-39,1894,11
STAT,1907,25,30-34,1932,37.975541659346256
STAT,1893,26,35-39,1919,12.529979151925161
SIM,1872,62,na,1934,1922
SIM,1887,61,na,1948,2216
STAT,1817,85,na,1902,133.78652015617578
STAT,1922,26,50-100,1948,1.153172684098062
STAT,1858,39,na,1897,1886.820521155828
STAT,1873,17,20-24,1890,18.335726206642093
SIM,1926,44,45-49,1970,1
SIM,1824,31,30-34,1855,20
SIM,1834,35,35-39,1869,2
SIM,1829,31,45-49,1860,5
SIM,1881,17,20-24,1898,15
SIM,1824,46,35-39,1870,1
STAT,1934,35,35-39,1969,3.409786279723287
STAT,1943,20,35-39,1963,10.227815636104937
SIM,1891,22,30-34,1913,30
STAT,1899,22,20-24,1921,96.26866583244781
STAT,1888,40,45-49,1928,1.8231911721644931
STAT,1837,22,35-39,1859,5.09328836919183
SIM,1845,22,35-39,1867,10
STAT,1902,43,na,1945,3312.4355216457793
STAT,1761,104,na,1865,0.014908392991975848
STAT,1883,37,35-39,1920,7.079749927892763
STAT,1814,42,15-19,1856,0.047337710630369234
STAT,1888,22,45-49,1910,0.8409839038099735
SIM,1921,38,30-34,1959,2
STAT,1826,35,35-39,1861,6.628523346472467
SIM,1888,34,25-29,1922,16
SIM,1820,49,na,1869,1563
SIM,1907,30,20-24,1937,3
STAT,1853,55,na,1908,1733.7751091941475
STAT,1912,38,50-100,1950,0.41595819822563274
STAT,1918,44,45-49,1962,0.17997382424906233
SIM,1891,37,35-39,1928,19
STAT,1905,54,na,1959,3162.5623290602252
SIM,1921,22,15-19,1943,7
STAT,1839,17,15-19,1856,5.357769982315178
STAT,1881,33,15-19,1914,0.13986075711662002
STAT,1883,22,30-34,1905,17.829479764512087
STAT,1866,34,30-34,1900,16.288414312153563
SIM,1829,70,na,1899,664
SIM,1837,31,40-44,1868,5
STAT,1871,80,na,1951,625.106787822334
SIM,1848,36,50-100,1884,3
STAT,1875,24,25-29,1899,59.561550753888206
SIM,1806,82,na,1888,313
SIM,1933,25,45-49,1958,3
SIM,1807,67,na,1874,777
STAT,1884,48,40-44,1932,0.17061808119055963
SIM,1823,82,na,1905,284
SIM,1926,26,15-19,1952,1
STAT,1923,45,30-34,1968,0.10690334070217704
STAT,1945,23,na,1968,4082.07170605484
STAT,1901,36,na,1937,3403.812887173857
STAT,1822,52,20-24,1874,0.0010114214086587893
SIM,1847,36,na,1883,1731
STAT,1852,40,30-34,1892,0.9355200484383234
STAT,1832,107,na,1939,0.003151332110456779
STAT,1870,20,25-29,1890,57.42953804355803
STAT,1914,42,50-100,1956,0.11877087005634446
STAT,1931,36,25-29,1967,1.331090602837824
STAT,1908,24,50-100,1932,0.6129822342170953
STAT,1920,21,45-49,1941,1.280370874082844
STAT,1934,20,na,1954,5021.121943936726
STAT,1877,53,45-49,1930,0.01510883447798981
SIM,1938,29,45-49,1967,1
SIM,1865,21,na,1886,2323
STAT,1850,28,40-44,1878,2.63261850694473
STAT,1820,44,35-39,1864,3.39723009330956
STAT,1875,79,na,1954,731.970646931712
STAT,1875,46,40-44,1921,0.1797571429663494
STAT,1917,7,na,1924,4375.329121344047
STAT,1908,45,35-39,1953,0.12064733609595345
STAT,1880,54,na,1934,2244.783912174479
STAT,1844,49,15-19,1893,3.034924753808183E-4
STAT,1918,26,15-19,1944,0.7693055448265816
STAT,1875,39,na,1914,2441.906626217395
SIM,1847,30,20-24,1877,2
SIM,1883,28,40-44,1911,4
SIM,1907,25,50-100,1932,4
SIM,1839,39,35-39,1878,19
SIM,1863,51,na,1914,1838
STAT,1831,46,30-34,1877,0.08019350597559037
SIM,1870,42,45-49,1912,3
STAT,1939,20,15-19,1959,5.457362990351722
SIM,1881,17,na,1898,2321
STAT,1908,27,35-39,1935,14.595442651165257
SIM,1874,34,30-34,1908,27
STAT,1861,38,50-100,1899,1.0298148150019282
STAT,1942,27,40-44,1969,4.991051860397713
STAT,1829,31,40-44,1860,4.136542971672525
STAT,1896,22,40-44,1918,2.807627020861893
SIM,1878,8,na,1886,2884
STAT,1927,38,25-29,1965,1.2474788029326094
SIM,1832,22,25-29,1854,51
STAT,1839,30,20-24,1869,2.343890166468505
STAT,1868,51,45-49,1919,0.014208078959115151
SIM,1916,27,35-39,1943,26
STAT,1820,34,na,1854,1511.6040862840134
STAT,1905,46,25-29,1951,0.04800664170748974
SIM,1881,76,na,1957,884
STAT,1887,64,na,1951,1987.1755419653502
STAT,1900,42,25-29,1942,0.06297421198044223
SIM,1851,47,40-44,1898,1
STAT,1834,45,40-44,1879,0.13775205828791542
STAT,1941,16,35-39,1957,4.410679665621377
STAT,1856,19,40-44,1875,0.1711563366176549
SIM,1920,43,na,1963,3986
SIM,1855,21,45-49,1876,1
SIM,1933,20,20-24,1953,210
STAT,1839,49,40-44,1888,0.11733699089758261
SIM,1911,2,na,1913,4169
STAT,1909,13,na,1922,3943.719913951445
SIM,1868,25,40-44,1893,5
SIM,1863,21,40-44,1884,2
SIM,1852,11,na,1863,2508
STAT,1809,59,na,1868,1302.5817189401364
STAT,1925,43,45-49,1968,0.20524996296861103
SIM,1874,22,25-29,1896,77
STAT,1776,106,na,1882,0.012367223987532316
STAT,1822,34,20-24,1856,6.186214541930366
STAT,1822,63,na,1885,1070.6664303182476
STAT,1921,19,15-19,1940,52.505112456013066
SIM,1911,33,45-49,1944,3
SIM,1906,28,50-100,1934,1
SIM,1903,24,20-24,1927,115
SIM,1947,20,15-19,1967,5
STAT,1842,36,35-39,1878,6.574515672143808
STAT,1865,20,20-24,1885,65.5193728583165
SIM,1825,89,na,1914,64
SIM,1850,36,35-39,1886,5
SIM,1902,58,na,1960,2955
STAT,1881,17,50-100,1898,0.04831958290215142
STAT,1938,29,40-44,1967,4.705838878017011
STAT,1821,41,45-49,1862,2.6823038126941445
SIM,1825,39,40-44,1864,5
SIM,1878,28,na,1906,2589
STAT,1847,21,45-49,1868,0.671442755874007
STAT,1940,20,na,1960,3797.7161497564407
STAT,1918,44,15-19,1962,0.0016606582411501428
SIM,1860,77,na,1937,842
STAT,1803,93,na,1896,11.340474529335912
SIM,1812,82,na,1894,188
SIM,1830,34,20-24,1864,3
SIM,1799,55,na,1854,1326
STAT,1875,28,40-44,1903,3.1253472380471337
STAT,1811,60,na,1871,1031.8052825465736
STAT,1866,22,25-29,1888,54.30623852238229
STAT,1869,79,na,1948,688.5546566322226
STAT,1921,32,20-24,1953,2.769885819759087
STAT,1827,44,na,1871,1688.0336907555957
SIM,1821,56,na,1877,1217
STAT,1815,50,50-100,1865,0.04040310088158473
STAT,1855,21,40-44,1876,1.9007948879012804
STAT,1925,20,20-24,1945,136.60422973511285
SIM,1839,20,15-19,1859,4
STAT,1925,25,45-49,1950,2.095947031618353
STAT,1817,39,40-44,1856,12.79414147036599
SIM,1859,21,na,1880,2351
SIM,1934,18,20-24,1952,195
STAT,1950,18,35-39,1968,5.060132007792846
STAT,1903,39,50-100,1942,0.3804222849805522
STAT,1886,18,45-49,1904,0.07035122690018138
SIM,1884,28,na,1912,2703
STAT,1898,67,na,1965,2436.4581836745824
STAT,1903,33,45-49,1936,1.4459262070717671
SIM,1820,100,na,1920,1
SIM,1873,20,20-24,1893,71
SIM,1957,7,na,1964,5610
STAT,1862,69,na,1931,1274.414723940899
STAT,1916,2,na,1918,4413.584559125366
SIM,1924,19,40-44,1943,3
STAT,1844,30,25-29,1874,9.690632883780946
STAT,1889,25,50-100,1914,0.8115731644356489
STAT,1916,19,40-44,1935,0.3012120722893453
SIM,1850,18,35-39,1868,1
STAT,1919,47,30-34,1966,0.09867007825378644
STAT,1926,18,20-24,1944,169.12849645094698
SIM,1882,25,25-29,1907,3
SIM,1800,57,na,1857,1005
STAT,1842,18,35-39,1860,0.5493074617355268
STAT,1890,45,25-29,1935,0.07256288232374601
STAT,1922,35,na,1957,4375.621021365093
STAT,1867,54,35-39,1921,0.008018432263627303
STAT,1886,33,35-39,1919,10.8891813395389
STAT,1889,43,30-34,1932,1.4382816739803366
STAT,1857,40,15-19,1897,0.011113571856982758
STAT,1872,44,50-100,1916,1.065567768967658
SIM,1855,7,na,1862,2294
STAT,1849,38,50-100,1887,0.9652707158993413
SIM,1834,94,na,1928,13
STAT,1883,50,50-100,1933,0.01533457264422537
STAT,1884,21,50-100,1905,0.4128183529220583
STAT,1913,29,35-39,1942,15.152170562471174
SIM,1939,18,40-44,1957,2
SIM,1838,84,na,1922,166
STAT,1941,23,40-44,1964,3.543779382018707
SIM,1836,42,45-49,1878,5
SIM,1876,24,na,1900,2728
SIM,1857,16,30-34,1873,1
STAT,1878,46,20-24,1924,0.012778513090817184
STAT,1850,53,40-44,1903,0.00779180159280261
STAT,1852,50,40-44,1902,0.008602968538604545
STAT,1915,26,35-39,1941,15.680226114269562
SIM,1834,29,40-44,1863,4
STAT,1870,24,40-44,1894,2.065095525734051
STAT,1855,43,15-19,1898,0.010628023023792213
SIM,1919,15,20-24,1934,35
SIM,1827,42,35-39,1869,3
SIM,1949,21,25-29,1970,126
STAT,1798,70,na,1868,818.918076815467
SIM,1848,16,20-24,1864,22
STAT,1850,21,20-24,1871,62.666606708740616
STAT,1904,29,25-29,1933,61.40542660465098
SIM,1881,33,25-29,1914,13
SIM,1878,25,na,1903,2620
STAT,1819,42,35-39,1861,3.9088162161478563
SIM,1860,43,35-39,1903,4
STAT,1932,23,30-34,1955,38.33967022667887
SIM,1814,42,25-29,1856,1
SIM,1899,22,30-34,1921,2
STAT,1860,40,20-24,1900,0.1327782067248691
SIM,1865,86,na,1951,87
SIM,1894,33,35-39,1927,25
SIM,1917,18,20-24,1935,132
SIM,1878,32,40-44,1910,6
STAT,1853,27,45-49,1880,1.0785076859595402
SIM,1921,29,35-39,1950,23
STAT,1923,45,na,1968,4405.601544604935
STAT,1929,39,40-44,1968,1.9560345817831035
STAT,1832,33,50-100,1865,0.7947951122011544
STAT,1828,42,45-49,1870,1.2237270444368744
STAT,1874,17,35-39,1891,0.5715145121468234
SIM,1903,65,na,1968,2702
SIM,1872,34,na,1906,2432
SIM,1864,39,na,1903,2116
STAT,1921,37,15-19,1958,0.02188029917530227
SIM,1783,77,na,1860,286
SIM,1778,90,na,1868,32
STAT,1895,33,45-49,1928,2.311251610130933
SIM,1829,48,na,1877,1272
SIM,1895,39,25-29,1934,11
SIM,1900,39,45-49,1939,1
SIM,1913,0,na,1913,4371
STAT,1929,36,na,1965,4930.843042825354
STAT,1810,44,40-44,1854,7.508272524957856
STAT,1901,20,35-39,1921,8.374444668637913
SIM,1872,27,20-24,1899,14
SIM,1873,81,na,1954,371
STAT,1918,0,na,1918,5003.991573643964
SIM,1832,24,15-19,1856,6
STAT,1841,36,na,1877,1882.6571954962264
STAT,1821,81,na,1902,284.9500430699828
STAT,1864,27,20-24,1891,10.641391962041629
STAT,1931,40,na,1971,5074.095249166015
SIM,1890,17,30-34,1907,5
STAT,1872,21,40-44,1893,2.1369802553451667
SIM,1874,49,35-39,1923,1
STAT,1899,17,40-44,1916,0.255510030226096
SIM,1935,34,45-49,1969,3
STAT,1920,3,na,1923,4643.940571590205
SIM,1853,32,35-39,1885,13
STAT,1930,19,25-29,1949,56.83484098044582
SIM,1879,72,na,1951,1511
STAT,1949,16,35-39,1965,4.9803973276625255
SIM,1935,16,15-19,1951,50
STAT,1892,20,15-19,1912,4.243173413743014
SIM,1855,37,30-34,1892,2
SIM,1924,33,na,1957,4510
STAT,1886,40,40-44,1926,2.4533026916987355
STAT,1866,49,35-39,1915,0.1289852823067668
SIM,1915,31,25-29,1946,14
STAT,1929,31,45-49,1960,2.0398307118714945
STAT,1950,18,50-100,1968,0.4517974169884687
SIM,1861,27,45-49,1888,2
STAT,1839,42,20-24,1881,0.11551780274303244
STAT,1851,48,45-49,1899,0.19225763803097162
STAT,1932,16,25-29,1948,58.66337212612724
STAT,1838,53,25-29,1891,0.0025607156406293736
STAT,1937,31,na,1968,3818.925592408336
SIM,1899,15,25-29,1914,16
SIM,1915,50,na,1965,4082
STAT,1883,46,30-34,1929,0.0971685528904766
STAT,1915,16,na,1931,4135.1120233438505
SIM,1911,60,na,1971,3274
STAT,1869,43,45-49,1912,1.463405297169203
SIM,1857,57,na,1914,1653
STAT,1875,54,25-29,1929,0.003606543235165374
SIM,1894,40,40-44,1934,4
STAT,1833,31,30-34,1864,15.077006158261089
STAT,1849,16,30-34,1865,1.5321870058839253
STAT,1813,100,na,1913,0.45653640192896594
STAT,1848,27,35-39,1875,8.954097831455508
STAT,1843,53,35-39,1896,0.006838273658976757
SIM,1830,39,na,1869,1763
STAT,1927,16,15-19,1943,57.70295299094089
SIM,1785,78,na,1863,260
STAT,1864,40,20-24,1904,0.1455100741254641
SIM,1937,31,45-49,1968,3
STAT,1909,16,na,1925,3872.298496279943
SIM,1929,37,25-29,1966,2
STAT,1913,21,na,1934,3783.8254101273783
SIM,1841,31,30-34,1872,25
STAT,1843,37,na,1880,2018.479871305488
STAT,1927,35,50-100,1962,0.5334081715339181
STAT,1949,23,40-44,1972,4.001521466543655
SIM,1923,26,35-39,1949,34
SIM,1940,23,30-34,1963,44
STAT,1766,100,na,1866,0.2905104114981722
STAT,1868,35,40-44,1903,4.305803846256117
STAT,1923,11,na,1934,4754.212108349356
STAT,1940,18,40-44,1958,1.4483503248723872
SIM,1910,13,na,1923,3970
STAT,1852,73,na,1925,956.8554876585112
SIM,1849,21,20-24,1870,100
SIM,1876,35,40-44,1911,13
STAT,1822,69,na,1891,853.2943052629953
SIM,1877,71,na,1948,1332
STAT,1831,27,25-29,1858,41.85882236570727
STAT,1852,19,40-44,1871,0.17611747776321496
STAT,1935,30,na,1965,5342.0866079358475
STAT,1845,32,35-39,1877,9.408296739977667
SIM,1865,52,na,1917,2034
STAT,1847,37,30-34,1884,4.312111800653937
STAT,1812,79,na,1891,318.86624640570784
STAT,1898,27,50-100,1925,0.8824891847747136
STAT,1809,81,na,1890,275.8932589253922
STAT,1881,51,45-49,1932,0.014381749571168757
STAT,1878,19,50-100,1897,0.05174359012950161
STAT,1878,1,na,1879,3646.6227351118914
STAT,1879,38,20-24,1917,0.8179214534807391
STAT,1889,18,25-29,1907,7.1221826157103445
STAT,1890,49,40-44,1939,0.11794159668415996
SIM,1931,18,40-44,1949,3
STAT,1847,21,na,1868,2058.7781364464736
SIM,1853,47,50-100,1900,2
STAT,1923,18,40-44,1941,1.6713853996627817
STAT,1830,64,na,1894,1099.6718766896486
STAT,1870,46,20-24,1916,0.012001129795020207
STAT,1792,85,na,1877,78.68434478596221
STAT,1864,51,45-49,1915,0.013226938598291584
STAT,1905,26,na,1931,3528.2376095277714
STAT,1861,56,na,1917,1719.3466986695903
SIM,1880,28,25-29,1908,54
STAT,1827,78,na,1905,504.99043081679673
STAT,1882,5,na,1887,2645.6011165034247
STAT,1892,48,na,1940,2840.9446899454997
SIM,1905,33,20-24,1938,2
STAT,1854,38,15-19,1892,0.042764981501953944
STAT,1942,18,na,1960,3923.1444118944974
STAT,1956,16,50-100,1972,0.5057601322759204
STAT,1776,103,na,1879,0.05025225011685239
SIM,1930,24,15-19,1954,9
STAT,1823,32,15-19,1855,0.3628260643056411
SIM,1882,22,20-24,1904,87
SIM,1905,60,na,1965,2987
STAT,1889,22,na,1911,2980.3009341497304
SIM,1888,49,na,1937,2554
SIM,1880,69,na,1949,1362
STAT,1839,35,15-19,1874,0.04728429534298486
STAT,1894,41,45-49,1935,1.9728047620775255
STAT,1879,51,20-24,1930,7.906489689539952E-4
STAT,1910,44,45-49,1954,0.15845182543896558
STAT,1885,32,na,1917,2428.7367851032764
STAT,1909,20,35-39,1929,8.978380691344592
STAT,1818,44,40-44,1862,5.3162736505480765
STAT,1878,84,na,1962,554.3717449035769
STAT,1950,21,25-29,1971,111.82904811259328
STAT,1919,46,na,1965,4076.4094473852683
SIM,1908,38,50-100,1946,3
STAT,1963,2,na,1965,5098.423458090267
SIM,1874,69,na,1943,1416
SIM,1835,34,40-44,1869,8
SIM,1901,70,na,1971,2397
SIM,1823,51,na,1874,1417
STAT,1867,36,50-100,1903,1.1815075969634785
STAT,1848,42,30-34,1890,0.8925749251580384
STAT,1927,34,45-49,1961,1.9719991852142242
STAT,1872,28,25-29,1900,43.09798620946646
SIM,1859,52,na,1911,2008
STAT,1890,23,15-19,1913,4.102278941219575
STAT,1915,31,15-19,1946,0.13409856208863147
STAT,1840,32,15-19,1872,0.12481538495252874
STAT,1858,21,20-24,1879,64.42870518150157
STAT,1818,47,50-100,1865,0.5577585442707442
SIM,1779,78,na,1857,191
SIM,1858,24,35-39,1882,5
STAT,1851,51,35-39,1902,0.007136606815189974
SIM,1877,40,40-44,1917,3
SIM,1873,1,na,1874,3448
SIM,1897,18,25-29,1915,12
STAT,1929,30,na,1959,4905.387168636177
SIM,1896,28,20-24,1924,13
STAT,1907,31,25-29,1938,8.845529499624549
SIM,1913,46,50-100,1959,2
SIM,1868,43,35-39,1911,1
STAT,1837,45,20-24,1882,0.00852093155558323
STAT,1881,70,na,1951,1383.8203832817535
SIM,1866,21,20-24,1887,74
STAT,1815,81,na,1896,279.616044813676
SIM,1886,54,na,1940,2394
SIM,1840,94,na,1934,2
STAT,1820,48,15-19,1868,7.189912920216951E-4
SIM,1931,20,50-100,1951,3
SIM,1932,31,25-29,1963,17
STAT,1901,29,50-100,1930,0.9060495162233888
STAT,1839,45,25-29,1884,0.041553719584695566
STAT,1914,28,40-44,1942,4.777262521893993
STAT,1811,52,45-49,1863,0.038406562064416026
STAT,1921,37,50-100,1958,0.47838284423298477
SIM,1799,92,na,1891,21
SIM,1856,17,25-29,1873,8
SIM,1875,2,na,1877,3166
SIM,1856,42,30-34,1898,3
STAT,1823,103,na,1926,0.07987369568797852
SIM,1862,32,45-49,1894,2
SIM,1877,19,20-24,1896,25
STAT,1888,28,20-24,1916,14.09856500245756
STAT,1809,87,na,1896,89.88587474826055
STAT,1824,31,20-24,1855,6.364386674063078
SIM,1917,20,35-39,1937,17
STAT,1835,36,na,1871,1993.3643826219075
STAT,1890,41,45-49,1931,1.875261353927297
STAT,1812,49,50-100,1861,0.5616631151825623
STAT,1840,88,na,1928,98.78898989634456
STAT,1870,39,15-19,1909,0.05543722611076671
STAT,1890,30,20-24,1920,3.398726405952609
STAT,1911,26,na,1937,3739.284485097231
STAT,1827,34,40-44,1861,6.072596009244506
STAT,1891,15,15-19,1906,7.530149769221005
STAT,1879,44,15-19,1923,0.014527405072685724
SIM,1811,66,na,1877,717
STAT,1869,19,20-24,1888,17.494846829388628
STAT,1853,21,na,1874,2133.608470225595
SIM,1898,17,30-34,1915,4
STAT,1903,39,20-24,1942,0.23885141399218204
SIM,1791,72,na,1863,503
SIM,1905,28,40-44,1933,9
STAT,1824,64,na,1888,972.3366202448037
STAT,1803,96,na,1899,3.3319233287690504
STAT,1863,35,20-24,1898,0.6960352577941128
STAT,1928,15,20-24,1943,175.0581133457322
STAT,1863,28,15-19,1891,0.40438654941695545
STAT,1863,19,50-100,1882,0.04496894700439312
STAT,1894,25,40-44,1919,3.9575015656848174
SIM,1912,48,na,1960,3670
SIM,1916,9,na,1925,4335
SIM,1877,33,35-39,1910,15
STAT,1925,46,na,1971,4553.177181493864
SIM,1922,28,40-44,1950,5
STAT,1891,22,20-24,1913,87.03633773601284
STAT,1924,31,25-29,1955,11.007928720629016
STAT,1889,49,50-100,1938,0.17093377994571338
SIM,1859,45,50-100,1904,1
STAT,1848,17,25-29,1865,5.460570070204467
STAT,1845,42,45-49,1887,1.190816831154284
STAT,1840,50,45-49,1890,0.010593175152732422
STAT,1854,32,45-49,1886,1.3667543608186352
SIM,1776,95,na,1871,3
SIM,1920,20,40-44,1940,8
SIM,1785,72,na,1857,422
SIM,1912,29,25-29,1941,96
STAT,1838,37,20-24,1875,0.6834276799232294
STAT,1933,21,25-29,1954,125.32905605953046
STAT,1916,29,50-100,1945,1.042729915607725
SIM,1854,43,na,1897,1986
STAT,1858,16,40-44,1874,0.17387270357422038
STAT,1830,29,30-34,1859,25.44985471218276
STAT,1834,53,25-29,1887,0.002396126041479353
STAT,1839,52,30-34,1891,0.004086251659261606
STAT,1902,47,20-24,1949,0.009692790888521567
SIM,1852,34,40-44,1886,4
STAT,1896,44,15-19,1940,0.0012746481399698707
STAT,1923,23,20-24,1946,131.59895378123744
STAT,1900,15,35-39,1915,0.7794518490102703
SIM,1931,23,20-24,1954,165
STAT,1884,51,30-34,1935,0.006036549771900265
STAT,1844,34,40-44,1878,3.9360843780576085
STAT,1810,44,na,1854,1271.90960283665
STAT,1936,18,na,1954,3584.8002426018497
SIM,1871,86,na,1957,393
STAT,1892,49,45-49,1941,0.16665304130114791
SIM,1899,25,35-39,1924,1
SIM,1941,21,25-29,1962,119
SIM,1892,54,na,1946,3039
SIM,1832,31,20-24,1863,2
SIM,1909,32,50-100,1941,1
STAT,1912,20,40-44,1932,3.306806735651153
STAT,1869,33,35-39,1902,9.932141440910469
STAT,1914,20,45-49,1934,1.1321905057878465
SIM,1884,36,45-49,1920,2
SIM,1819,42,45-49,1861,1
STAT,1883,30,15-19,1913,0.14369095772702498
STAT,1859,18,na,1877,2158.044272496995
STAT,1915,23,30-34,1938,30.223258162776126
SIM,1874,16,30-34,1890,5
STAT,1878,49,25-29,1927,0.059886165186772325
STAT,1938,13,na,1951,3980.902818066775
STAT,1836,110,na,1946,1.7200238163126526E-4
STAT,1878,33,45-49,1911,1.8438830145591303
STAT,1941,30,na,1971,4055.683739488733
SIM,1921,26,30-34,1947,68
SIM,1883,71,na,1954,1494
SIM,1886,33,45-49,1919,2
STAT,1843,16,50-100,1859,0.050841406435146105
STAT,1892,30,25-29,1922,13.201069441649285
STAT,1884,44,25-29,1928,0.6393695539669368
STAT,1898,33,na,1931,3278.1487795071766
STAT,1857,17,35-39,1874,0.5138218269951768
STAT,1836,42,35-39,1878,1.3409405502127762
STAT,1897,57,na,1954,2741.2102118911616
STAT,1920,42,50-100,1962,0.13240849185232484
STAT,1939,19,45-49,1958,0.5097520848178986
SIM,1841,42,na,1883,1796
STAT,1831,24,20-24,1855,86.3378999807071
STAT,1866,16,30-34,1882,1.5485268979807834
SIM,1817,45,45-49,1862,1
STAT,1836,89,na,1925,65.38894494440275
STAT,1913,26,30-34,1939,39.96568099263881
SIM,1845,32,na,1877,2025
SIM,1900,23,na,1923,3391
SIM,1939,29,50-100,1968,1
STAT,1823,50,45-49,1873,0.021856969519383724
STAT,1849,26,40-44,1875,2.7767623361865845
STAT,1858,19,45-49,1877,0.061006568522292075
STAT,1897,36,15-19,1933,0.07696554179412578
STAT,1900,22,40-44,1922,2.946400963654488
SIM,1810,50,na,1860,1586
SIM,1870,30,45-49,1900,6
SIM,1863,57,na,1920,1674
STAT,1864,43,25-29,1907,0.5782815141689038
STAT,1876,36,45-49,1912,2.110104875236628
STAT,1894,43,na,1937,3021.340703979361
SIM,1912,19,15-19,1931,12
STAT,1929,29,30-34,1958,49.9664623693375
SIM,1881,30,20-24,1911,2
STAT,1836,27,45-49,1863,0.8943125476358805
STAT,1852,53,45-49,1905,0.01150350938025877
SIM,1867,16,na,1883,2398
SIM,1860,36,50-100,1896,2
STAT,1921,16,na,1937,4291.8390488196255
STAT,1940,23,20-24,1963,115.51987695391264
STAT,1938,18,50-100,1956,0.37688110165977623
STAT,1852,36,50-100,1888,1.004818106009129
STAT,1932,26,35-39,1958,20.06344496009683
SIM,1828,60,na,1888,1196
SIM,1904,44,50-100,1948,1
SIM,1860,40,30-34,1900,3
STAT,1766,99,na,1865,0.4745506411483097
SIM,1844,42,35-39,1886,4
STAT,1818,95,na,1913,6.775629709132123
STAT,1811,91,na,1902,25.100584257305897
SIM,1848,39,50-100,1887,2
SIM,1940,26,35-39,1966,1
STAT,1791,66,na,1857,687.6164624679761
STAT,1904,19,15-19,1923,8.630172517443317
SIM,1937,29,30-34,1966,53
STAT,1817,103,na,1920,0.07003999894917425
STAT,1873,30,20-24,1903,2.818109108260836
STAT,1817,53,25-29,1870,0.007436699726637433
STAT,1860,50,30-34,1910,0.004997813281348492
STAT,1886,43,45-49,1929,1.6044159005307614
SIM,1882,24,na,1906,2265
STAT,1872,99,na,1971,14.344593760445447
STAT,1853,92,na,1945,34.922978790855666
STAT,1883,49,35-39,1932,0.1372092460934161
SIM,1949,16,45-49,1965,2
SIM,1872,43,25-29,1915,3
STAT,1887,32,40-44,1919,4.957445424101914
STAT,1822,37,25-29,1859,5.458060749075534
STAT,1862,17,45-49,1879,0.06496840060756671
STAT,1920,39,20-24,1959,0.2939108320313727
STAT,1844,19,na,1863,2234.557078179405
STAT,1866,40,25-29,1906,0.6103477285772896
STAT,1859,46,na,1905,1838.1831111227016
SIM,1836,32,35-39,1868,13
STAT,1809,45,45-49,1854,1.0854401615671903
STAT,1810,47,45-49,1857,0.7419455933671236
STAT,1802,52,35-39,1854,0.022814561694041193
SIM,1878,39,25-29,1917,4
SIM,1838,59,na,1897,1236
STAT,1858,54,25-29,1912,0.002786715803743404
STAT,1923,33,30-34,1956,18.417055015303927
STAT,1895,23,35-39,1918,7.743087546141257
STAT,1862,32,35-39,1894,8.794344451525145
SIM,1904,13,na,1917,4028
STAT,1831,77,na,1908,582.4457436834931
SIM,1822,32,50-100,1854,1
STAT,1829,53,50-100,1882,0.010540294795995607
SIM,1907,27,na,1934,3551
STAT,1843,50,30-34,1893,0.004874387202414973
STAT,1861,50,na,1911,1841.135042049607
SIM,1868,40,30-34,1908,3
STAT,1912,35,50-100,1947,0.4220017322291277
STAT,1857,21,50-100,1878,0.37778430685674597
STAT,1887,36,20-24,1923,0.8854242824265987
STAT,1906,36,35-39,1942,2.2777172944126796
STAT,1908,15,35-39,1923,0.8338606973830274
SIM,1894,43,45-49,1937,1
SIM,1898,23,25-29,1921,99
SIM,1923,23,30-34,1946,41
SIM,1895,32,40-44,1927,10
SIM,1899,2,na,1901,3711
SIM,1817,51,na,1868,1258
STAT,1870,27,45-49,1897,1.1072638867460185
SIM,1863,26,na,1889,2123
SIM,1860,15,na,1875,2278
STAT,1873,27,30-34,1900,26.044369297791555
SIM,1881,27,30-34,1908,21
SIM,1915,22,na,1937,4167
STAT,1850,24,25-29,1874,50.94387354012077
STAT,1923,48,35-39,1971,0.15346017693499192
SIM,1935,31,40-44,1966,8
STAT,1903,49,30-34,1952,0.07753042420366588
STAT,1933,31,35-39,1964,12.56650726117843
SIM,1864,35,15-19,1899,1
SIM,1908,20,25-29,1928,130
SIM,1911,49,30-34,1960,1
STAT,1837,38,15-19,1875,0.04511350058114885
STAT,1885,60,na,1945,1941.087028501063
SIM,1874,40,25-29,1914,1
STAT,1838,50,20-24,1888,5.610917632857965E-4
STAT,1819,52,45-49,1871,0.02765000323834312
STAT,1903,45,15-19,1948,3.304672735008338E-4
SIM,1844,84,na,1928,198
STAT,1924,21,15-19,1945,6.427837651581032
SIM,1828,41,40-44,1869,14
SIM,1834,33,50-100,1867,2
STAT,1847,92,na,1939,32.47875491834084
STAT,1914,18,30-34,1932,2.565761355175909
SIM,1829,47,30-34,1876,1
SIM,1887,40,35-39,1927,1
SIM,1875,21,30-34,1896,21
SIM,1852,37,45-49,1889,2
STAT,1856,35,15-19,1891,0.045395843461350734
STAT,1901,41,30-34,1942,0.11440673728442993
SIM,1854,31,40-44,1885,4
STAT,1867,75,na,1942,985.9484745088641
STAT,1845,63,na,1908,1394.160669631979
SIM,1885,41,45-49,1926,4
SIM,1877,9,na,1886,2744
STAT,1835,35,45-49,1870,1.8755652491620676
STAT,1858,24,25-29,1882,47.662473688526994
STAT,1830,31,45-49,1861,1.6967124635083588
SIM,1847,67,na,1914,1113
SIM,1818,37,45-49,1855,2
STAT,1888,38,30-34,1926,6.395697684070011
STAT,1950,13,na,1963,4737.664324888378
SIM,1924,30,20-24,1954,3
STAT,1877,28,45-49,1905,1.1706608668768128
SIM,1885,28,45-49,1913,4
SIM,1910,43,40-44,1953,1
SIM,1837,38,25-29,1875,5
STAT,1898,18,35-39,1916,0.7549897587108514
STAT,1927,31,40-44,1958,4.913352782664343
SIM,1862,22,35-39,1884,4
STAT,1850,19,na,1869,2085.1481805918106
SIM,1813,61,na,1874,1031
SIM,1896,38,30-34,1934,12
SIM,1832,34,25-29,1866,14
STAT,1912,47,15-19,1959,3.611454137529032E-4
SIM,1876,30,50-100,1906,3
STAT,1849,22,na,1871,2006.9391254882676
STAT,1882,23,25-29,1905,56.71928101811577
SIM,1890,53,na,1943,2742
SIM,1931,33,30-34,1964,5
STAT,1867,21,30-34,1888,17.25354632327179
SIM,1914,2,na,1916,4247
STAT,1905,34,25-29,1939,8.590999027559912
SIM,1886,42,50-100,1928,1
STAT,1879,40,35-39,1919,1.9504545189153875
SIM,1922,18,30-34,1940,26
SIM,1948,16,25-29,1964,62
SIM,1815,41,30-34,1856,1
SIM,1854,15,na,1869,2411
STAT,1842,48,35-39,1890,0.10840914688011787
STAT,1899,15,15-19,1914,8.328905956499979
STAT,1910,48,25-29,1958,0.0503367442633428
STAT,1844,37,45-49,1881,1.632403061181693
STAT,1824,34,25-29,1858,16.30748331271655
STAT,1854,22,35-39,1876,5.247641678381377
SIM,1923,33,40-44,1956,10
STAT,1854,46,50-100,1900,0.18850477858241896
SIM,1913,34,25-29,1947,4
STAT,1849,22,25-29,1871,53.733204766469996
STAT,1878,42,50-100,1920,1.1204241737496974
STAT,1874,32,30-34,1906,18.185375614135033
STAT,1925,45,35-39,1970,0.16014528012900958
STAT,1818,47,45-49,1865,0.5359569082413592
STAT,1907,47,40-44,1954,0.14397814991291963
SIM,1822,75,na,1897,467
STAT,1837,37,na,1874,1738.600267643653
STAT,1891,25,25-29,1916,53.789070997289926
STAT,1839,63,na,1902,1231.4283632922156
STAT,1874,23,na,1897,2455.732675458054
STAT,1816,69,na,1885,746.7782327251364
STAT,1916,30,20-24,1946,2.590492679888642
SIM,1850,84,na,1934,179
SIM,1801,76,na,1877,392
SIM,1879,44,25-29,1923,1
SIM,1839,27,35-39,1866,13
STAT,1841,46,25-29,1887,0.04327277696538031
STAT,1879,54,25-29,1933,0.0036731769620450437
STAT,1870,49,25-29,1919,0.05624297883679002
STAT,1918,6,na,1924,4451.878697687055
STAT,1932,28,na,1960,5001.53231272678
STAT,1840,17,25-29,1857,5.279596836949142
STAT,1882,58,na,1940,1965.488309535652
STAT,1888,74,na,1962,1570.5230258613365
SIM,1869,42,na,1911,2246
SIM,1919,12,na,1931,4532
STAT,1851,45,40-44,1896,0.14265110729010608
STAT,1823,31,50-100,1854,2.667913947938738
STAT,1865,29,50-100,1894,0.5880597638510381
SIM,1882,32,30-34,1914,19
STAT,1910,34,35-39,1944,8.909882526114227
STAT,1909,18,20-24,1927,27.04402282292689
STAT,1931,24,25-29,1955,121.4152856645291
STAT,1878,39,15-19,1917,0.05902821914891487
STAT,1885,38,45-49,1923,2.018865010890572
STAT,1915,33,40-44,1948,4.049896968793625
STAT,1865,35,25-29,1900,2.6911747789903306
SIM,1857,22,25-29,1879,64
STAT,1939,32,15-19,1971,0.13375488456795162
STAT,1832,26,30-34,1858,23.26795678532258
STAT,1873,75,na,1948,1064.7207232726169
STAT,1823,42,25-29,1865,1.038789701783533
STAT,1944,13,na,1957,4312.195663865667
STAT,1928,37,30-34,1965,2.349458786011721
STAT,1910,30,50-100,1940,0.8196179231014988
SIM,1895,65,na,1960,2355
STAT,1839,19,40-44,1858,0.16318719111689423
SIM,1914,26,25-29,1940,95
SIM,1815,40,50-100,1855,5
SIM,1836,18,20-24,1854,17
STAT,1889,28,na,1917,2996.776142304232
SIM,1843,32,50-100,1875,4
SIM,1873,35,25-29,1908,4
STAT,1876,89,na,1965,262.30165340851966
STAT,1771,83,na,1854,114.0
SIM,1916,38,na,1954,3856
SIM,1844,27,45-49,1871,1
STAT,1866,46,30-34,1912,0.0913445236583042
STAT,1826,29,40-44,1855,5.047199093043641
SIM,1853,67,na,1920,1244
STAT,1912,23,45-49,1935,1.0966207087673954
SIM,1866,24,25-29,1890,73
SIM,1795,62,na,1857,937
STAT,1907,41,35-39,1948,0.18920648631918524
SIM,1897,28,50-100,1925,1
SIM,1840,26,30-34,1866,37
SIM,1816,75,na,1891,522
STAT,1828,54,na,1882,1221.183060872278
STAT,1847,47,40-44,1894,0.13288158537914366
SIM,1830,27,15-19,1857,4
STAT,1890,33,25-29,1923,12.722063295897279
SIM,1814,46,na,1860,1317
STAT,1892,46,40-44,1938,0.12382263336878199
SIM,1808,46,na,1854,1523
SIM,1870,39,na,1909,2600
STAT,1834,54,na,1888,1426.0120355401712
SIM,1830,33,na,1863,1890
SIM,1900,20,25-29,1920,84
STAT,1898,41,15-19,1939,0.0013289532950435167
STAT,1871,32,45-49,1903,1.7621752764296628
SIM,1843,35,45-49,1878,3
STAT,1837,48,25-29,1885,0.03935828037061627
STAT,1846,31,40-44,1877,3.7031939620788834
STAT,1882,47,25-29,1929,0.05698041485585573
SIM,1874,97,na,1971,22
SIM,1920,23,45-49,1943,7
SIM,1851,32,na,1883,1964
STAT,1829,38,25-29,1867,2.4838998011133393
STAT,1942,20,20-24,1962,119.02888288916608
SIM,1890,23,25-29,1913,81
STAT,1902,43,40-44,1945,0.22308502608450298
STAT,1844,19,15-19,1863,5.777140394363097
STAT,1894,33,50-100,1927,1.197240334299605
STAT,1943,7,na,1950,4287.4677007162645
SIM,1849,31,30-34,1880,24
SIM,1834,60,na,1894,1295
STAT,1835,32,50-100,1867,0.8694836478448207
SIM,1894,30,30-34,1924,8
SIM,1777,77,na,1854,318
STAT,1886,30,30-34,1916,19.004758941500892
SIM,1823,32,25-29,1855,10
STAT,1865,54,30-34,1919,0.005359920288269582
STAT,1896,29,25-29,1925,56.58761153201552
STAT,1921,44,20-24,1965,0.02023024642921648
STAT,1862,104,na,1966,0.3626461181021555
STAT,1928,18,25-29,1946,55.55068477677999
STAT,1845,44,50-100,1889,0.8193117223255356
SIM,1880,25,20-24,1905,2
SIM,1950,20,20-24,1970,126
STAT,1906,26,25-29,1932,63.02663577927012
STAT,1865,32,20-24,1897,2.5027697398032953
STAT,1874,28,50-100,1902,0.6639338871645104
SIM,1856,78,na,1934,655
STAT,1860,41,35-39,1901,1.5056182603332495
SIM,1886,30,40-44,1916,6
STAT,1816,110,na,1926,1.2261491489485728E-4
STAT,1872,25,20-24,1897,12.07595885489522
SIM,1857,38,50-100,1895,2
SIM,1851,37,50-100,1888,2
STAT,1836,80,na,1916,385.0357235634134
STAT,1823,36,30-34,1859,10.317824510214583
STAT,1914,37,na,1951,3832.546120128764
SIM,1880,44,50-100,1924,5
SIM,1831,29,25-29,1860,35
STAT,1888,34,15-19,1922,0.17027610632558768
STAT,1920,49,30-34,1969,0.09997303034411394
SIM,1892,21,50-100,1913,4
STAT,1836,40,45-49,1876,1.137054424512071
STAT,1836,24,40-44,1860,1.6873943016257384
STAT,1832,36,40-44,1868,3.758040541536107
SIM,1936,18,25-29,1954,50
SIM,1913,27,na,1940,4076
SIM,1838,53,na,1891,1369
SIM,1873,42,30-34,1915,1
STAT,1919,18,15-19,1937,51.04480559060446
SIM,1914,8,na,1922,4166
STAT,1884,41,20-24,1925,0.161012493601144
SIM,1818,39,na,1857,1508
STAT,1819,49,na,1868,1549.1647569657412
STAT,1919,8,na,1927,4497.743884553376
STAT,1882,89,na,1971,318.26379420378794
STAT,1905,38,40-44,1943,1.3851782830046826
SIM,1862,72,na,1934,1085
SIM,1877,30,30-34,1907,28
SIM,1829,76,na,1905,403
STAT,1863,82,na,1945,417.33545857163756
STAT,1934,15,45-49,1949,0.6922595291702809
STAT,1874,54,40-44,1928,0.010663662406734864
SIM,1904,26,30-34,1930,40
SIM,1935,35,50-100,1970,2
STAT,1878,42,40-44,1920,2.385478273647065
STAT,1865,42,30-34,1907,1.063170519583448
SIM,1939,32,na,1971,3887
STAT,1896,72,na,1968,2062.1629628342407
STAT,1832,90,na,1922,52.68347041356651
STAT,1862,38,na,1900,2035.7828338500638
STAT,1880,53,20-24,1933,7.783699331935396E-4
SIM,1927,18,15-19,1945,54
SIM,1794,83,na,1877,118
STAT,1875,19,45-49,1894,0.06802657911722058
SIM,1868,29,20-24,1897,13
STAT,1810,52,25-29,1862,0.010607041434550537
STAT,1874,47,35-39,1921,0.14513884560552937
SIM,1844,40,45-49,1884,3
SIM,1831,36,30-34,1867,9
STAT,1852,42,na,1894,1859.6461872579612
STAT,1929,19,50-100,1948,0.4850577055792337
SIM,1940,29,na,1969,3844
STAT,1825,43,na,1868,1616.7409489309953
STAT,1888,43,na,1931,2767.266274177319
STAT,1911,37,20-24,1948,0.2597135329565839
STAT,1924,41,35-39,1965,0.24472186865723897
STAT,1846,28,15-19,1874,0.3896891894221447
STAT,1940,26,25-29,1966,68.50327610258509
STAT,1947,24,20-24,1971,128.13118615028034
STAT,1919,25,20-24,1944,20.263498895142206
SIM,1921,22,na,1943,4722
STAT,1869,70,na,1939,1381.8996149738823
STAT,1900,37,45-49,1937,0.6083894750999935
STAT,1881,27,20-24,1908,11.570465315874227
SIM,1849,90,na,1939,63
SIM,1831,80,na,1911,516
STAT,1832,48,40-44,1880,0.13418224791692993
SIM,1876,92,na,1968,180
STAT,1915,41,25-29,1956,0.07346869853455498
SIM,1874,19,35-39,1893,1
SIM,1889,44,50-100,1933,3
STAT,1866,19,35-39,1885,0.5237349217136514
STAT,1806,50,45-49,1856,0.049226559537967424
STAT,1813,58,na,1871,1090.1589632082218
SIM,1913,30,45-49,1943,1
STAT,1873,41,45-49,1914,1.5549033580980014
STAT,1890,27,30-34,1917,31.4103117580899
STAT,1959,12,na,1971,5239.988379950517
STAT,1865,47,25-29,1912,0.053083365992033595
SIM,1842,58,na,1900,1499
SIM,1840,36,40-44,1876,5
SIM,1853,9,na,1862,2408
SIM,1884,26,35-39,1910,1
STAT,1883,40,25-29,1923,0.6492628476305268
STAT,1859,23,30-34,1882,14.94851652206028
SIM,1881,41,45-49,1922,5
STAT,1861,25,45-49,1886,0.9564352529444174
STAT,1888,48,40-44,1936,0.11500323857782065
SIM,1829,79,na,1908,287
STAT,1931,28,40-44,1959,6.134164695765163
STAT,1858,51,20-24,1909,5.998387771034124E-4
SIM,1887,30,na,1917,2856
STAT,1847,40,20-24,1887,0.1277674306952614
STAT,1907,52,na,1959,3281.4006633148197
STAT,1847,45,15-19,1892,3.1503470078641485E-4
STAT,1860,53,35-39,1913,0.007011428000097563
STAT,1891,44,30-34,1935,1.4324289481375778
STAT,1819,41,50-100,1860,2.34798552966888
SIM,1814,50,45-49,1864,2
SIM,1886,42,40-44,1928,2
SIM,1794,86,na,1880,68
SIM,1845,41,40-44,1886,8
SIM,1927,25,20-24,1952,19
STAT,1910,31,30-34,1941,15.557184315676663
STAT,1824,53,30-34,1877,0.006561235229638379
SIM,1807,61,na,1868,994
STAT,1865,52,50-100,1917,0.013909236201613828
SIM,1848,29,35-39,1877,18
SIM,1918,31,40-44,1949,5
SIM,1850,53,na,1903,1579
STAT,1817,50,20-24,1867,0.0016450103163761808
STAT,1852,45,na,1897,1830.545016506411
STAT,1836,45,50-100,1881,0.16414594876543254
STAT,1888,41,20-24,1929,0.19239836040594743
SIM,1832,41,30-34,1873,3
SIM,1845,38,na,1883,1929
SIM,1958,6,na,1964,5142
STAT,1878,30,40-44,1908,4.64200668573062
STAT,1897,46,25-29,1943,0.044445011342199144
SIM,1874,3,na,1877,3041
SIM,1900,30,35-39,1930,19
STAT,1891,32,30-34,1923,22.051587081046087
STAT,1847,33,15-19,1880,0.12904153043501942
STAT,1941,6,na,1947,4187.544571604691
STAT,1890,42,50-100,1932,1.3161290124891412
SIM,1817,48,50-100,1865,1
STAT,1849,56,na,1905,1583.4913631684665
SIM,1887,33,na,1920,2787
STAT,1877,41,45-49,1918,1.5907392627085204
STAT,1824,95,na,1919,7.32072699898793
SIM,1925,12,na,1937,5019
SIM,1913,24,15-19,1937,4
STAT,1923,36,35-39,1959,2.8620829721025736
STAT,1942,30,30-34,1972,17.14199593746897
SIM,1875,24,35-39,1899,7
SIM,1849,93,na,1942,20
STAT,1841,53,50-100,1894,0.010972111605771202
SIM,1834,23,35-39,1857,5
STAT,1870,30,na,1900,2398.9079981646923
SIM,1931,36,35-39,1967,4
STAT,1885,34,50-100,1919,0.9245512994511487
SIM,1867,36,45-49,1903,6
STAT,1840,57,na,1897,1446.1263437609937
STAT,1865,18,na,1883,2395.553049789499
STAT,1905,24,15-19,1929,4.830170916700721
SIM,1898,27,40-44,1925,7
STAT,1840,26,20-24,1866,10.601974362066963
STAT,1882,20,20-24,1902,68.89918428445056
STAT,1915,48,45-49,1963,0.22286029534109292
SIM,1885,25,40-44,1910,9
STAT,1850,52,50-100,1902,0.011299884101055228
SIM,1872,37,30-34,1909,8
SIM,1914,36,35-39,1950,2
STAT,1827,46,50-100,1873,0.27957661160079417
SIM,1805,66,na,1871,778
STAT,1926,25,na,1951,4612.36497553092
STAT,1937,23,15-19,1960,5.285795087248327
STAT,1863,34,45-49,1897,1.5464106804952418
STAT,1882,25,15-19,1907,0.45398366010051017
STAT,1801,54,40-44,1855,0.02848728556798464
STAT,1856,49,40-44,1905,0.1342350666351805
STAT,1839,23,50-100,1862,0.35901352559995137
SIM,1830,30,40-44,1860,6
SIM,1826,65,na,1891,1010
SIM,1880,21,40-44,1901,3
STAT,1850,43,30-34,1893,0.8585389776945757
STAT,1837,106,na,1943,0.008095187032880785
STAT,1906,48,35-39,1954,0.115787346794618
STAT,1856,53,50-100,1909,0.011900147145437428
SIM,1881,37,40-44,1918,3
STAT,1841,41,30-34,1882,0.8934459713958078
STAT,1863,85,na,1948,245.20001331463587
STAT,1903,15,50-100,1918,0.07137638232608484
SIM,1929,34,20-24,1963,8
STAT,1921,19,na,1940,4258.364179978032
STAT,1870,64,na,1934,1733.6000003115857
STAT,1883,52,25-29,1935,0.003526558320236491
STAT,1815,41,20-24,1856,0.5306675176598014
SIM,1814,46,40-44,1860,1
SIM,1869,11,na,1880,2676
SIM,1859,41,35-39,1900,6
SIM,1944,24,45-49,1968,1
STAT,1873,49,40-44,1922,0.17336657700025834
STAT,1947,24,na,1971,4208.017861045109
STAT,1864,37,30-34,1901,4.834365737574554
SIM,1891,40,25-29,1931,1
SIM,1923,48,45-49,1971,1
STAT,1896,26,20-24,1922,15.860654777260008
SIM,1838,50,na,1888,1456
STAT,1906,46,45-49,1952,0.19822930716458706
STAT,1929,35,25-29,1964,1.2915127553371977
STAT,1836,83,na,1919,247.0984343820902
STAT,1877,25,40-44,1902,3.191067481069826
STAT,1931,20,45-49,1951,1.497183802861027
STAT,1811,46,15-19,1857,0.001130858454326534
STAT,1876,55,na,1931,2178.1902284906428
STAT,1828,32,35-39,1860,9.992780640502783
STAT,1819,43,na,1862,1656.9584191799922
STAT,1828,40,50-100,1868,0.8924221420388061
SIM,1840,22,15-19,1862,3
STAT,1905,30,45-49,1935,2.5899029481183615
STAT,1855,56,na,1911,1581.1207766578834
STAT,1830,95,na,1925,8.410653116831128
STAT,1914,21,50-100,1935,0.6601597839878297
STAT,1841,31,20-24,1872,2.44678936305258
STAT,1894,77,na,1971,1611.913032358502
STAT,1925,42,30-34,1967,0.1579155680107677
STAT,1900,20,15-19,1920,4.692486148845276
STAT,1832,34,15-19,1866,0.12217064782130271
STAT,1901,64,na,1965,2716.382648470995
STAT,1829,47,20-24,1876,0.00971150111280755
SIM,1857,26,na,1883,2098
SIM,1837,35,20-24,1872,1
STAT,1849,53,na,1902,1644.7945453787383
STAT,1896,38,20-24,1934,1.0334544201823415
SIM,1832,65,na,1897,1046
STAT,1879,50,45-49,1929,0.015697773088341506
STAT,1882,39,40-44,1921,4.306910758431756
STAT,1923,20,50-100,1943,0.7858127528966334
SIM,1930,19,35-39,1949,8
SIM,1885,31,35-39,1916,14
STAT,1832,22,15-19,1854,5.438903770404938
STAT,1859,8,na,1867,2322.338764082886
STAT,1850,31,30-34,1881,13.882133574250807
SIM,1940,26,na,1966,4077
STAT,1837,44,45-49,1881,1.044408632312451
STAT,1799,86,na,1885,71.60108690240016
STAT,1829,35,20-24,1864,0.6930673622220361
SIM,1840,48,40-44,1888,1
SIM,1890,32,20-24,1922,7
SIM,1857,26,40-44,1883,5
STAT,1867,18,40-44,1885,0.17802362480092065
SIM,1869,42,40-44,1911,5
STAT,1855,37,20-24,1892,0.5975607300158453
STAT,1932,36,45-49,1968,0.9349645419969005
STAT,1922,19,35-39,1941,4.928548423644584
STAT,1916,40,30-34,1956,0.13406767955503365
SIM,1930,30,45-49,1960,5
SIM,1818,36,na,1854,1585
STAT,1832,40,45-49,1872,1.2620705095869955
STAT,1914,21,20-24,1935,111.56039007250614
STAT,1826,28,na,1854,1565.2692963482737
STAT,1826,90,na,1916,45.983026111225314
STAT,1874,40,15-19,1914,0.01452892936818546
SIM,1913,38,40-44,1951,5
SIM,1839,17,25-29,1856,10
STAT,1832,54,50-100,1886,0.01013881260768923
STAT,1821,50,na,1871,1318.476470989751
SIM,1922,21,20-24,1943,132
STAT,1882,32,20-24,1914,2.6865074472495896
SIM,1905,46,35-39,1951,1
STAT,1845,23,50-100,1868,0.39271328424679575
STAT,1862,30,45-49,1892,1.526507690257778
STAT,1876,35,50-100,1911,1.3056233129278585
SIM,1881,48,na,1929,2049
SIM,1904,19,25-29,1923,6
STAT,1936,24,45-49,1960,1.09642554693523
STAT,1768,94,na,1862,5.422470764246976
SIM,1906,48,na,1954,3277
SIM,1897,49,50-100,1946,1
STAT,1877,31,35-39,1908,10.759095922028578
SIM,1909,22,35-39,1931,10
STAT,1873,37,40-44,1910,4.527430456581642
STAT,1901,42,45-49,1943,0.14808149987624034
SIM,1844,24,40-44,1868,3
STAT,1911,49,20-24,1960,0.010609171441493063
STAT,1945,15,20-24,1960,151.18050845408862
SIM,1928,23,15-19,1951,8
SIM,1898,6,na,1904,4032
SIM,1849,34,35-39,1883,10
SIM,1890,20,20-24,1910,5
SIM,1828,91,na,1919,52
STAT,1841,24,15-19,1865,3.0415763365694852
STAT,1877,21,25-29,1898,60.753646638098935
STAT,1815,48,40-44,1863,0.452945498021064
SIM,1880,18,15-19,1898,5
STAT,1941,31,25-29,1972,9.905881149333773
SIM,1863,20,na,1883,2133
SIM,1890,39,40-44,1929,13
STAT,1831,43,na,1874,1704.7323284436882
STAT,1846,42,na,1888,1672.8270087486146
SIM,1854,35,20-24,1889,1
STAT,1872,18,15-19,1890,6.051763411298131
STAT,1769,113,na,1882,2.35996098714477E-4
STAT,1922,30,45-49,1952,1.8287259865762169
SIM,1850,87,na,1937,110
SIM,1894,18,na,1912,3391
STAT,1846,35,20-24,1881,0.5877407083698898
STAT,1884,84,na,1968,645.9058009506421
STAT,1842,51,25-29,1893,0.0027909528823866023
STAT,1888,46,15-19,1934,4.8377731966480327E-4
STAT,1886,48,na,1934,2398.879731842972
SIM,1924,40,30-34,1964,1
SIM,1801,73,na,1874,512
SIM,1953,15,20-24,1968,164
SIM,1823,48,40-44,1871,1
SIM,1848,19,25-29,1867,9
STAT,1789,93,na,1882,5.621398593569383
STAT,1863,16,15-19,1879,6.093008121139179
SIM,1935,2,na,1937,5669
SIM,1818,40,35-39,1858,2
STAT,1848,22,50-100,1870,0.3859665442076856
SIM,1889,15,30-34,1904,2
STAT,1818,64,na,1882,972.9686352157645
STAT,1937,27,30-34,1964,38.95969014388758
SIM,1918,33,na,1951,4233
SIM,1827,28,20-24,1855,17
SIM,1840,38,30-34,1878,5
STAT,1852,52,30-34,1904,0.004769855336782167
SIM,1835,79,na,1914,404
SIM,1871,16,15-19,1887,1
SIM,1839,38,na,1877,1868
STAT,1854,22,50-100,1876,0.36671155084435947
STAT,1830,98,na,1928,2.0550016362125163
STAT,1861,15,35-39,1876,0.5379597777430043
SIM,1936,15,20-24,1951,126
STAT,1825,51,25-29,1876,0.0044804530398134595
STAT,1880,23,na,1903,2527.567748587724
SIM,1842,18,45-49,1860,2
SIM,1953,18,25-29,1971,83
SIM,1814,40,na,1854,1437
STAT,1900,34,40-44,1934,6.079400291547511
SIM,1836,24,na,1860,2022
STAT,1834,57,na,1891,1350.5072822715958
STAT,1945,18,25-29,1963,48.28210975577528
STAT,1849,19,35-39,1868,0.5182085261958747
STAT,1913,52,na,1965,3596.5265528385285
STAT,1872,96,na,1968,40.41806032619038
STAT,1886,31,45-49,1917,1.890695435680273
STAT,1810,50,35-39,1860,0.02683889889699175
STAT,1815,50,na,1865,1513.1541425310684
SIM,1855,93,na,1948,11
STAT,1906,23,20-24,1929,102.00824072393794
STAT,1856,45,25-29,1901,0.04658614043028084
STAT,1941,0,na,1941,4706.875270760441
STAT,1925,28,50-100,1953,1.1952040749074333
STAT,1819,40,45-49,1859,3.422271597484101
STAT,1895,30,40-44,1925,5.8186150324719526
STAT,1870,15,45-49,1885,0.06654585831592541
STAT,1846,15,50-100,1861,0.04453430430816962
SIM,1831,26,20-24,1857,12
STAT,1847,43,25-29,1890,0.497145015804895
SIM,1921,19,25-29,1940,2
STAT,1892,42,25-29,1934,0.8200266767378065
SIM,1908,17,35-39,1925,1
STAT,1899,19,30-34,1918,2.214646586160305
STAT,1875,16,40-44,1891,0.19197178173531465
STAT,1834,50,20-24,1884,5.297510469409314E-4
SIM,1844,30,35-39,1874,19
STAT,1823,39,35-39,1862,12.23710372660977
SIM,1849,28,40-44,1877,4
STAT,1845,97,na,1942,4.197585087066724
STAT,1848,54,30-34,1902,0.004499871245517324
SIM,1914,23,20-24,1937,103
SIM,1882,44,30-34,1926,2
STAT,1923,26,25-29,1949,77.36792852376489
SIM,1845,44,45-49,1889,8
SIM,1861,24,40-44,1885,2
STAT,1832,38,30-34,1870,4.477331231855531
SIM,1824,39,na,1863,1548
STAT,1844,25,45-49,1869,1.0685476166390964
STAT,1867,41,na,1908,2223.5633856092795
STAT,1883,42,15-19,1925,0.013806143544543343
SIM,1835,19,15-19,1854,2
SIM,1888,18,na,1906,2969
SIM,1918,16,15-19,1934,10
STAT,1869,40,40-44,1909,2.2376842272653357
STAT,1874,51,50-100,1925,0.01580571197802141
SIM,1855,43,25-29,1898,5
STAT,1838,43,15-19,1881,0.010660993227463144
STAT,1874,44,30-34,1918,1.1812872409910231
SIM,1893,33,na,1926,3151
STAT,1941,25,30-34,1966,41.388279172847554
STAT,1853,24,40-44,1877,2.034934798084314
STAT,1803,103,na,1906,0.05568884559441018
STAT,1888,44,25-29,1932,0.7640006755093603
STAT,1858,18,30-34,1876,1.4973801436295207
STAT,1913,19,25-29,1932,8.990398093898298
SIM,1890,59,na,1949,2532
STAT,1836,30,35-39,1866,8.135416565348615
STAT,1875,51,20-24,1926,7.763061022749988E-4
STAT,1850,36,25-29,1886,2.2230054628162943
SIM,1923,35,30-34,1958,3
SIM,1873,32,20-24,1905,2
STAT,1908,37,na,1945,3591.8874154183522
STAT,1895,22,na,1917,3147.905582878274
STAT,1868,38,45-49,1906,1.932754112679094
STAT,1905,23,na,1928,3473.7643000794537
SIM,1894,31,45-49,1925,3
STAT,1842,45,30-34,1887,0.07789425483633346
SIM,1873,29,50-100,1902,1
SIM,1903,34,na,1937,3385
STAT,1915,35,30-34,1950,1.8966561143341834
STAT,1818,61,na,1879,1088.12531595805
STAT,1842,41,15-19,1883,0.011349005503064797
STAT,1932,38,35-39,1970,3.310902457233278
STAT,1840,29,25-29,1869,37.411189322093605
STAT,1938,10,na,1948,3999.1511159064357
STAT,1837,26,15-19,1863,0.39106816526975646
SIM,1876,38,45-49,1914,2
SIM,1854,46,na,1900,1941
SIM,1900,20,na,1920,3422
STAT,1890,17,20-24,1907,22.1134506993204
STAT,1780,111,na,1891,7.230695706634561E-4
STAT,1883,27,50-100,1910,0.640309971192099
SIM,1891,27,50-100,1918,2
STAT,1864,33,15-19,1897,0.12863036152435017
STAT,1891,47,35-39,1938,0.09927604490437927
STAT,1837,68,na,1905,1018.8898822487446
STAT,1911,47,30-34,1958,0.08608522725542873
SIM,1887,38,20-24,1925,2
SIM,1855,90,na,1945,61
SIM,1937,32,20-24,1969,1
STAT,1946,25,15-19,1971,0.8030241015328498
STAT,1811,51,30-34,1862,0.016073141879592853
STAT,1861,49,15-19,1910,3.3014680504093644E-4
STAT,1872,20,50-100,1892,0.41942468945136235
STAT,1799,89,na,1888,37.95318576180845
SIM,1827,40,45-49,1867,4
STAT,1834,38,50-100,1872,1.0170891783743055
STAT,1897,43,20-24,1940,0.014934341109668858
SIM,1847,64,na,1911,1223
SIM,1881,39,30-34,1920,11
STAT,1842,83,na,1925,311.31903010245185
STAT,1857,82,na,1939,371.7350367535352
SIM,1933,28,50-100,1961,1
STAT,1942,8,na,1950,4221.62093908518
STAT,1901,44,35-39,1945,0.17696611984034247
STAT,1929,32,20-24,1961,3.160060855067366
STAT,1806,48,30-34,1854,0.3399319051386528
SIM,1874,60,na,1934,1907
SIM,1913,28,30-34,1941,50
STAT,1875,70,na,1945,1469.033642317509
STAT,1905,28,30-34,1933,36.971017357038875
STAT,1911,43,15-19,1954,0.0014861176218851594
STAT,1866,52,25-29,1918,0.0033151856267564462
SIM,1859,31,25-29,1890,10
STAT,1868,29,na,1897,2308.730610777506
SIM,1918,34,45-49,1952,3
STAT,1873,39,30-34,1912,5.456636626304688
SIM,1841,43,30-34,1884,4
SIM,1904,29,35-39,1933,25
STAT,1907,40,20-24,1947,0.016685835059289437
SIM,1869,45,na,1914,2243
STAT,1867,24,35-39,1891,5.553837289715698
STAT,1878,45,45-49,1923,0.2530976170920943
STAT,1806,76,na,1882,402.5861129919746
SIM,1835,37,45-49,1872,4
STAT,1835,19,40-44,1854,0.37526785627829523
STAT,1850,46,35-39,1896,0.10560766736105127
SIM,1906,45,na,1951,3336
SIM,1830,33,45-49,1863,1
SIM,1898,3,na,1901,4060
STAT,1890,19,50-100,1909,0.06078165910315103
STAT,1832,32,25-29,1864,8.98368784011422
STAT,1836,20,25-29,1856,50.04638413729562
STAT,1931,18,30-34,1949,16.228124666473622
STAT,1859,33,40-44,1892,3.518277769930918
STAT,1894,28,45-49,1922,1.4518314767814695
SIM,1925,15,na,1940,4652
STAT,1805,91,na,1896,23.290785384102822
STAT,1902,12,na,1914,3715.3151343839527
SIM,1858,21,30-34,1879,24
SIM,1854,38,25-29,1892,4
STAT,1824,41,30-34,1865,1.445178161271063
STAT,1793,61,na,1854,1000.0
SIM,1805,49,35-39,1854,1
STAT,1824,46,25-29,1870,0.06804152902892964
STAT,1938,34,20-24,1972,2.498638217926051
STAT,1920,45,15-19,1965,4.1750283909170697E-4
SIM,1884,59,na,1943,1938
STAT,1941,21,15-19,1962,5.6141105696693225
SIM,1895,29,15-19,1924,3
SIM,1909,59,na,1968,3066
STAT,1861,111,na,1972,0.0014703918419370977
STAT,1906,43,40-44,1949,0.23024911343091334
STAT,1933,30,20-24,1963,3.356026314381095
STAT,1887,29,15-19,1916,0.5149356862473096
STAT,1857,50,25-29,1907,0.0028625417440635253
SIM,1881,45,na,1926,2083
STAT,1871,22,35-39,1893,5.896896340061752
STAT,1841,34,25-29,1875,8.987164952497006
STAT,1879,0,na,1879,3869.9058969064454
SIM,1877,43,45-49,1920,1
SIM,1826,35,45-49,1861,1
SIM,1849,24,25-29,1873,64
STAT,1841,44,35-39,1885,1.3541830562257837
STAT,1781,76,na,1857,335.61645204108186
STAT,1891,37,25-29,1928,3.636420099582153
SIM,1875,45,na,1920,2295
SIM,1914,33,30-34,1947,35
STAT,1847,100,na,1947,0.8278846173052241
STAT,1943,26,50-100,1969,1.0820119675415505
STAT,1922,16,30-34,1938,14.428799640845645
STAT,1838,47,30-34,1885,0.07317206102721353
STAT,1845,18,20-24,1863,17.404766451144965
STAT,1880,22,45-49,1902,0.747549375510374
SIM,1908,27,45-49,1935,3
SIM,1870,20,35-39,1890,8
SIM,1896,44,na,1940,3119
STAT,1858,30,na,1888,1971.0556231699743
SIM,1840,32,25-29,1872,18
STAT,1844,16,na,1860,2274.5114373075626
SIM,1880,60,na,1940,1724
STAT,1856,42,20-24,1898,0.12702145477012647
STAT,1858,67,na,1925,1282.45338443039
STAT,1796,75,na,1871,412.55217546737475
STAT,1917,11,na,1928,4343.432418140813
SIM,1820,40,na,1860,1697
SIM,1946,14,na,1960,4328
SIM,1860,46,na,1906,1960
SIM,1910,16,na,1926,3893
STAT,1909,37,50-100,1946,0.4053028306062237
STAT,1915,45,40-44,1960,0.16288185986921142
STAT,1803,62,na,1865,1045.317446627595
STAT,1812,76,na,1888,430.7544106950307
STAT,1837,41,40-44,1878,1.7924478082232058
SIM,1852,25,45-49,1877,2
STAT,1881,6,na,1887,2620.4102538957586
STAT,1878,27,15-19,1905,0.4817691366405514
STAT,1887,39,25-29,1926,3.258180888538956
STAT,1936,21,40-44,1957,3.279764283926017
SIM,1930,16,30-34,1946,21
SIM,1853,18,20-24,1871,24
STAT,1906,33,30-34,1939,14.823308977378316
SIM,1944,21,40-44,1965,7
STAT,1895,20,30-34,1915,23.84980130349817
STAT,1865,15,na,1880,2435.3525106801208
SIM,1927,28,25-29,1955,112
STAT,1877,37,na,1914,2492.8263738941455
STAT,1822,33,45-49,1855,4.650200266152839
STAT,1905,22,50-100,1927,0.6008157813944129
SIM,1868,41,45-49,1909,4
SIM,1905,36,25-29,1941,4
STAT,1862,20,35-39,1882,5.262878724241845
SIM,1867,23,30-34,1890,19
STAT,1807,53,30-34,1860,0.024100508492651076
STAT,1879,48,30-34,1927,0.10192616159983582
SIM,1952,14,na,1966,4885
STAT,1882,35,25-29,1917,2.8887440065405388
SIM,1823,54,na,1877,1317
SIM,1942,27,50-100,1969,6
STAT,1919,28,25-29,1947,72.31856338963611
STAT,1914,24,25-29,1938,95.6813212795389
STAT,1858,6,na,1864,2357.619759444625
STAT,1934,27,50-100,1961,1.3655021372968759
SIM,1926,36,50-100,1962,3
SIM,1934,29,na,1963,5449
SIM,1936,4,na,1940,3522
SIM,1904,23,50-100,1927,1
SIM,1833,39,50-100,1872,3
STAT,1924,47,40-44,1971,0.19150114073334498
SIM,1893,26,45-49,1919,2
STAT,1898,36,na,1934,3265.8373732902255
SIM,1825,80,na,1905,386
STAT,1900,37,50-100,1937,0.37469313103464125
SIM,1931,26,25-29,1957,99
SIM,1931,15,na,1946,4803
STAT,1918,36,50-100,1954,0.45377208363132004
SIM,1844,53,na,1897,1695
SIM,1844,20,25-29,1864,2
STAT,1827,37,45-49,1864,2.591336212441021
STAT,1866,96,na,1962,20.515801984313796
SIM,1903,23,45-49,1926,2
STAT,1846,38,25-29,1884,2.127938866614875
SIM,1919,37,30-34,1956,7
STAT,1864,30,na,1894,2181.979751714472
STAT,1873,33,25-29,1906,10.548705064122446
SIM,1773,84,na,1857,46
SIM,1883,74,na,1957,1281
STAT,1850,29,50-100,1879,0.5581501455104033
STAT,1885,26,45-49,1911,1.1339209829233454
SIM,1788,83,na,1871,203
STAT,1843,31,na,1874,2125.2665063111012
STAT,1859,15,na,1874,2196.6305662729674
STAT,1833,53,40-44,1886,0.007035902509205604
STAT,1863,31,40-44,1894,3.8948355236832533
SIM,1878,59,na,1937,2203
STAT,1837,103,na,1940,0.09568527499948132
STAT,1901,67,na,1968,2577.2948669135453
SIM,1894,19,20-24,1913,29
STAT,1860,43,25-29,1903,0.5276829311988649
STAT,1838,16,na,1854,2240.984110917607
STAT,1849,29,45-49,1878,1.0071942426677634
STAT,1825,39,50-100,1864,1.7604393297557372
STAT,1917,15,45-49,1932,0.11020963786629757
SIM,1899,58,na,1957,2790
SIM,1857,29,45-49,1886,4
STAT,1883,37,na,1920,2358.2517160230213
SIM,1922,24,25-29,1946,112
SIM,1904,16,20-24,1920,29
STAT,1863,21,50-100,1884,0.3747082898371052
STAT,1910,41,40-44,1951,0.24248523335183064
SIM,1901,48,25-29,1949,1
SIM,1890,35,25-29,1925,5
STAT,1896,40,35-39,1936,0.17113470796692712
STAT,1851,97,na,1948,4.432193256720206
STAT,1815,44,25-29,1859,1.8216914766781056
STAT,1886,19,20-24,1905,19.04082017091473
SIM,1882,28,50-100,1910,3
SIM,1900,32,25-29,1932,23
STAT,1932,33,40-44,1965,5.302032933829704
SIM,1870,46,na,1916,2506
STAT,1953,16,20-24,1969,167.3422973241922
STAT,1928,42,15-19,1970,0.001996905797224367
SIM,1952,18,20-24,1970,160
SIM,1882,79,na,1961,738
STAT,1950,15,40-44,1965,1.688145285974105
STAT,1837,23,35-39,1860,5.056718558701032
SIM,1838,33,45-49,1871,1
STAT,1900,33,30-34,1933,24.582983039202958
SIM,1905,23,30-34,1928,30
SIM,1823,68,na,1891,860
SIM,1873,40,50-100,1913,1
SIM,1903,15,20-24,1918,29
STAT,1932,39,35-39,1971,3.307194246481178
SIM,1937,29,35-39,1966,27
STAT,1920,32,45-49,1952,1.7589337909480507
SIM,1914,29,40-44,1943,6
STAT,1803,71,na,1874,705.5657039773735
STAT,1839,31,45-49,1870,1.49649192890007
STAT,1906,29,40-44,1935,4.4161599712769375
STAT,1897,24,45-49,1921,0.9452176359903972
STAT,1883,76,na,1959,1083.8998329996484
STAT,1824,65,na,1889,936.7490999438442
SIM,1855,30,40-44,1885,6
STAT,1932,19,na,1951,4943.82457975863
SIM,1868,16,40-44,1884,1
STAT,1894,28,na,1922,3120.6158842559803
STAT,1921,25,15-19,1946,0.8083136254366196
STAT,1807,85,na,1892,115.85011537749645
STAT,1890,14,na,1904,3210.8303823697515
STAT,1898,17,15-19,1915,8.187023901477762
STAT,1902,41,40-44,1943,0.22572502014460671
SIM,1885,12,na,1897,2628
SIM,1919,38,30-34,1957,2
STAT,1915,27,40-44,1942,4.8513654496161704
STAT,1918,28,20-24,1946,19.75423190234704
STAT,1932,31,25-29,1963,12.537562036329218
SIM,1845,23,35-39,1868,7
STAT,1942,19,50-100,1961,0.39918783876584024
STAT,1888,31,40-44,1919,5.2515414813165435
SIM,1922,35,25-29,1957,4
STAT,1906,21,30-34,1927,26.528343087259522
STAT,1930,23,15-19,1953,6.9336595623101545
STAT,1940,30,20-24,1970,2.5782621778015327
SIM,1876,22,25-29,1898,71
SIM,1941,18,45-49,1959,4
STAT,1831,48,40-44,1879,0.13822588076200457
SIM,1862,20,30-34,1882,22
STAT,1854,63,na,1917,1365.6254946079673
STAT,1933,18,45-49,1951,0.6801744609903142
STAT,1858,77,na,1935,699.2998762033102
STAT,1877,20,25-29,1897,60.93217791940278
STAT,1925,41,35-39,1966,0.2490875614798223
STAT,1941,17,40-44,1958,1.4698149768722022
SIM,1888,34,50-100,1922,5
STAT,1923,33,25-29,1956,10.80421882552022
SIM,1907,31,40-44,1938,4
STAT,1854,20,30-34,1874,16.250477915417243
SIM,1861,85,na,1946,153
STAT,1816,46,na,1862,1338.2863379756423
SIM,1931,33,25-29,1964,2
STAT,1845,27,na,1872,2057.353801711751
STAT,1781,104,na,1885,0.03156676998133308
SIM,1849,33,20-24,1882,3
SIM,1787,68,na,1855,583
SIM,1896,31,40-44,1927,6
STAT,1914,35,25-29,1949,1.0125435892018795
STAT,1865,21,45-49,1886,0.6582265304591493
STAT,1922,17,30-34,1939,14.393449081725572
SIM,1783,86,na,1869,47
SIM,1914,21,30-34,1935,33
STAT,1919,44,15-19,1963,0.0016926087242782049
STAT,1847,30,40-44,1877,4.054020383171005
STAT,1947,25,35-39,1972,17.34475112944034
STAT,1824,110,na,1934,1.5215598201720934E-4
STAT,1860,16,na,1876,2204.2578350754206
STAT,1896,19,na,1915,3384.6351553730456
STAT,1912,27,15-19,1939,0.7096883454246414
STAT,1931,32,20-24,1963,3.259572396964336
SIM,1936,21,na,1957,3141
STAT,1909,17,15-19,1926,9.076652888931777
STAT,1796,84,na,1880,110.17870965550783
STAT,1846,21,35-39,1867,5.186239968508669
SIM,1928,34,na,1962,5032
SIM,1905,43,25-29,1948,1
STAT,1929,34,30-34,1963,20.385283291543594
SIM,1924,20,na,1944,4444
SIM,1920,27,15-19,1947,4
STAT,1924,25,40-44,1949,5.5744871882814175
STAT,1841,45,na,1886,1712.0172238104049
SIM,1899,32,20-24,1931,5
SIM,1836,86,na,1922,77
SIM,1887,20,35-39,1907,7
SIM,1854,21,35-39,1875,10
SIM,1842,49,50-100,1891,1
STAT,1786,74,na,1860,370.3619394761
SIM,1907,26,45-49,1933,2
STAT,1858,20,15-19,1878,3.1066791151370867
SIM,1930,17,30-34,1947,18
STAT,1944,18,20-24,1962,148.8081038337059
SIM,1832,72,na,1904,716
SIM,1840,91,na,1931,33
STAT,1903,40,45-49,1943,0.1522360424239568
SIM,1859,18,40-44,1877,1
STAT,1870,26,na,1896,2388.158104518601
SIM,1833,24,50-100,1857,5
SIM,1884,36,50-100,1920,3
SIM,1910,36,45-49,1946,2
STAT,1873,66,na,1939,1695.1455583633349
SIM,1907,40,na,1947,3568
SIM,1873,21,45-49,1894,2
SIM,1953,17,25-29,1970,59
SIM,1802,74,na,1876,469
STAT,1915,47,35-39,1962,0.1325738153390548
STAT,1835,20,20-24,1855,92.71534723894982
STAT,1914,40,20-24,1954,0.017979258047431806
STAT,1857,16,15-19,1873,5.590153837029033
STAT,1875,57,na,1932,2104.105068875653
STAT,1930,36,20-24,1966,0.35100991115065155
STAT,1794,93,na,1887,7.418678899420488
SIM,1937,34,30-34,1971,20
STAT,1850,52,35-39,1902,0.006441302031560703
SIM,1808,79,na,1887,297
STAT,1860,39,20-24,1899,0.6316209981447928
SIM,1898,24,50-100,1922,2
STAT,1913,39,25-29,1952,0.9812834622154669
SIM,1848,24,15-19,1872,4
SIM,1925,39,50-100,1964,3
SIM,1804,65,na,1869,970
SIM,1899,27,25-29,1926,60
STAT,1929,29,35-39,1958,19.145609540174412
STAT,1945,17,25-29,1962,48.2975649765678
STAT,1946,26,30-34,1972,44.55161154709221
SIM,1917,17,15-19,1934,10
STAT,1900,20,25-29,1920,81.42536620517936
STAT,1902,36,45-49,1938,0.6219948386766873
STAT,1887,58,na,1945,2260.657708601863
STAT,1883,44,na,1927,2282.243600416265
STAT,1872,49,40-44,1921,0.17138525548947936
SIM,1856,31,na,1887,2350
STAT,1873,20,40-44,1893,2.1680374429103457
SIM,1906,47,35-39,1953,1
SIM,1849,34,50-100,1883,1
STAT,1855,49,40-44,1904,0.12994297914013
STAT,1891,63,na,1954,2253.5725860749794
SIM,1823,36,na,1859,1679
SIM,1870,78,na,1948,691
STAT,1879,39,na,1918,2487.0227744477893
STAT,1895,77,na,1972,1650.7672318787224
STAT,1933,23,40-44,1956,4.546894797766106
STAT,1931,23,50-100,1954,0.8676637036121793
STAT,1800,104,na,1904,0.032147270400999094
STAT,1916,23,40-44,1939,3.5843461484683643
STAT,1938,32,30-34,1970,16.160155122016562
SIM,1921,36,20-24,1957,3
SIM,1875,23,20-24,1898,80
STAT,1920,29,15-19,1949,0.7846378108504077
STAT,1903,29,15-19,1932,0.6532409427507068
SIM,1935,26,20-24,1961,28
STAT,1919,27,25-29,1946,72.57402395395405
STAT,1859,24,25-29,1883,47.69701747590836
SIM,1871,95,na,1966,55
STAT,1910,30,35-39,1940,9.059061496211237
SIM,1811,67,na,1878,684
STAT,1914,18,35-39,1932,0.8832948768360878
STAT,1832,52,na,1884,1488.1861979503078
SIM,1930,21,15-19,1951,10
STAT,1865,47,na,1912,2073.42226200413
SIM,1862,59,na,1921,1727
SIM,1919,41,na,1960,4194
STAT,1922,34,20-24,1956,2.7983193744720634
STAT,1887,22,35-39,1909,6.670732100960097
STAT,1903,38,na,1941,3426.4341182813455
SIM,1915,25,40-44,1940,11
SIM,1843,20,20-24,1863,70
SIM,1924,23,40-44,1947,6
SIM,1905,18,35-39,1923,1
STAT,1910,38,45-49,1948,0.6616794512175824
SIM,1929,32,30-34,1961,34
SIM,1959,5,na,1964,5722
SIM,1890,66,na,1956,2037
STAT,1904,46,20-24,1950,0.00992482166160411
STAT,1918,48,15-19,1966,3.989187143723303E-4
SIM,1922,18,35-39,1940,10
STAT,1765,103,na,1868,0.017668467038768593
SIM,1836,30,30-34,1866,6
SIM,1886,21,30-34,1907,21
SIM,1930,34,20-24,1964,3
SIM,1932,25,40-44,1957,10
SIM,1895,22,35-39,1917,9
STAT,1858,33,20-24,1891,2.1775669798204076
STAT,1875,25,na,1900,2515.6673649341237
SIM,1848,12,na,1860,2361
SIM,1830,42,50-100,1872,4
STAT,1927,26,20-24,1953,22.714733003422225
STAT,1925,24,45-49,1949,1.3654896974318689
STAT,1870,45,15-19,1915,4.0288165241360074E-4
SIM,1867,24,25-29,1891,64
SIM,1828,31,35-39,1859,15
STAT,1782,92,na,1874,10.665303938157034
STAT,1890,20,50-100,1910,0.5116869158733168
STAT,1932,19,40-44,1951,1.8786893040232258
STAT,1907,45,35-39,1952,0.11946992520453742
SIM,1940,19,40-44,1959,2
SIM,1879,34,45-49,1913,4
SIM,1904,0,na,1904,4120
SIM,1943,23,na,1966,3513
STAT,1906,7,na,1913,3868.5520343484295
SIM,1926,28,20-24,1954,31
STAT,1896,20,35-39,1916,7.909366065089773
STAT,1860,54,45-49,1914,0.011681806282426748
STAT,1837,83,na,1920,264.6817707317977
SIM,1900,31,30-34,1931,38
STAT,1880,52,20-24,1932,7.868601542579832E-4
SIM,1906,35,40-44,1941,2
STAT,1779,110,na,1889,0.0016373576068226124
STAT,1825,82,na,1907,279.79213771871036
STAT,1868,22,25-29,1890,55.77825490346106
STAT,1907,25,40-44,1932,4.517457493907128
STAT,1829,96,na,1925,5.710847183285431
STAT,1915,39,na,1954,3839.261858059527
STAT,1778,87,na,1865,35.7963816503594
STAT,1864,30,40-44,1894,3.965378941253358
STAT,1911,25,na,1936,3751.777905522623
STAT,1828,107,na,1935,0.00259691887749442
SIM,1824,85,na,1909,106
SIM,1902,19,20-24,1921,33
STAT,1852,29,na,1881,2008.6203688369253
STAT,1908,24,45-49,1932,1.0481995805718276
SIM,1828,99,na,1927,12
STAT,1895,21,30-34,1916,23.77992138567893
SIM,1795,87,na,1882,59
SIM,1844,30,50-100,1874,1
SIM,1791,73,na,1864,454
SIM,1939,18,na,1957,3695
SIM,1927,27,25-29,1954,104
SIM,1921,23,15-19,1944,8
SIM,1901,30,35-39,1931,26
STAT,1834,49,20-24,1883,0.008347587955987222
STAT,1867,23,20-24,1890,65.79574156711871
STAT,1828,30,30-34,1858,18.490344506236777
STAT,1933,35,35-39,1968,3.365620526455365
SIM,1925,3,na,1928,5115
STAT,1927,38,15-19,1965,0.024330263327717816
SIM,1847,31,45-49,1878,3
STAT,1817,49,20-24,1866,0.025991738103917406
STAT,1913,19,30-34,1932,2.5287113984578586
STAT,1878,0,na,1878,3865.4046376000542
STAT,1889,22,45-49,1911,0.8787253374719457
SIM,1799,69,na,1868,881
STAT,1898,10,na,1908,3573.4905153915884
STAT,1820,51,na,1871,1340.7513518233118
SIM,1882,47,na,1929,2158
SIM,1884,21,20-24,1905,87
STAT,1911,57,na,1968,3391.9001150836325
STAT,1938,27,35-39,1965,15.17286552860447
SIM,1840,32,50-100,1872,1
STAT,1924,45,35-39,1969,0.1573384555092807
SIM,1815,49,na,1864,1394
STAT,1914,23,30-34,1937,29.86673927975934
SIM,1897,22,45-49,1919,2
STAT,1824,33,na,1857,1597.5580911695906
SIM,1916,24,45-49,1940,2
SIM,1869,81,na,1950,389
SIM,1908,5,na,1913,4228
STAT,1937,28,30-34,1965,38.940989492618506
SIM,1874,28,na,1902,2513
SIM,1909,28,20-24,1937,2
STAT,1923,46,30-34,1969,0.10666708431922524
SIM,1901,38,45-49,1939,2
STAT,1849,22,15-19,1871,3.096606510363954
STAT,1923,5,na,1928,4817.217191443929
SIM,1857,22,15-19,1879,4
STAT,1828,47,na,1875,1372.9476887722885
STAT,1904,33,15-19,1937,0.11904932376916072
STAT,1806,68,na,1874,765.9999470303645
STAT,1802,54,na,1856,998.4668459452018
SIM,1931,30,20-24,1961,2
SIM,1904,47,25-29,1951,1
SIM,1812,52,na,1864,1270
SIM,1868,20,25-29,1888,64
STAT,1836,34,na,1870,1670.0359103159492
STAT,1852,15,25-29,1867,5.586967195223267
STAT,1925,17,na,1942,4536.366688205521
STAT,1938,24,30-34,1962,28.997057104245773
STAT,1928,38,30-34,1966,2.3470858326378488
SIM,1888,24,45-49,1912,1
SIM,1920,15,20-24,1935,209
STAT,1887,26,na,1913,2737.476565985654
STAT,1877,16,40-44,1893,0.1940024648038162
STAT,1787,91,na,1878,21.96589524852121
STAT,1891,31,50-100,1922,1.1619453622361275
STAT,1891,31,na,1922,3026.2226647828984
STAT,1950,18,45-49,1968,0.6023965559846248
STAT,1832,39,45-49,1871,1.6566343090623163
STAT,1895,45,na,1940,3024.9795232103443
SIM,1923,39,35-39,1962,6
STAT,1808,109,na,1917,2.3685182159733064E-4
STAT,1915,39,35-39,1954,2.468291321936337
SIM,1844,30,na,1874,2054
STAT,1935,21,50-100,1956,0.9140697427990547
SIM,1848,44,na,1892,1816
STAT,1915,31,25-29,1946,9.64497540831721
SIM,1878,42,na,1920,2604
STAT,1956,15,35-39,1971,5.665931013743436
STAT,1814,48,40-44,1862,0.502268561202748
STAT,1899,34,20-24,1933,3.743761773490463
STAT,1901,24,35-39,1925,8.272659789931765
STAT,1912,15,20-24,1927,28.096567936517676
STAT,1795,67,na,1862,662.2850627075849
STAT,1816,50,50-100,1866,0.030928046470704375
STAT,1854,23,35-39,1877,5.2099636111306005
SIM,1852,39,50-100,1891,1
STAT,1803,102,na,1905,0.11376214576403453
STAT,1923,30,20-24,1953,2.8759727769040757
STAT,1831,67,na,1898,1068.1533640323496
STAT,1914,0,na,1914,4739.239787428429
SIM,1932,39,na,1971,5277
STAT,1901,15,45-49,1916,0.09362068876112786
SIM,1948,22,na,1970,4226
STAT,1847,33,45-49,1880,1.5801499904559648
STAT,1922,29,25-29,1951,75.45276443805143
STAT,1930,19,30-34,1949,15.98582273173575
STAT,1913,23,15-19,1936,5.466793399985592
STAT,1944,20,na,1964,4025.5355789758814
STAT,1868,12,na,1880,2602.3749221880053
STAT,1930,28,20-24,1958,23.661512684487644
STAT,1906,46,30-34,1952,0.08130761420163936
SIM,1903,27,15-19,1930,4
STAT,1852,49,15-19,1901,3.1551225081121186E-4
STAT,1903,37,15-19,1940,0.01757667549009349
STAT,1910,43,40-44,1953,0.23964921820693635
SIM,1841,97,na,1938,3
SIM,1817,83,na,1900,153
SIM,1855,33,45-49,1888,3
SIM,1930,29,25-29,1959,111
STAT,1861,65,na,1926,1424.5847285223938
SIM,1899,15,30-34,1914,2
STAT,1865,79,na,1944,647.3035303418701
SIM,1852,17,na,1869,2389
STAT,1902,44,45-49,1946,0.14749987450685392
SIM,1935,34,50-100,1969,2
SIM,1946,24,30-34,1970,49
STAT,1848,26,15-19,1874,0.4240757537339488
SIM,1816,66,na,1882,985
STAT,1893,6,na,1899,3380.7729606874655
STAT,1928,17,25-29,1945,55.696609894704096
SIM,1817,37,50-100,1854,2
SIM,1865,24,na,1889,2234
STAT,1908,49,45-49,1957,0.1992557713755889
STAT,1874,51,na,1925,2253.3875950223623
STAT,1907,20,na,1927,3563.712488731587
SIM,1912,16,25-29,1928,12
STAT,1844,85,na,1929,212.42989115323616
STAT,1888,34,45-49,1922,2.085079019740436
SIM,1844,49,30-34,1893,1
STAT,1848,99,na,1947,1.4721655498791544
SIM,1866,32,50-100,1898,2
STAT,1840,71,na,1911,960.519783197035
SIM,1906,27,40-44,1933,7
STAT,1905,25,30-34,1930,37.35332458083499
STAT,1907,33,40-44,1940,3.7142119695828537
SIM,1909,36,20-24,1945,2
SIM,1866,33,20-24,1899,4
SIM,1866,8,na,1874,2776
STAT,1816,78,na,1894,346.6877990669902
STAT,1913,44,20-24,1957,0.01751088413250346
STAT,1923,16,35-39,1939,5.039674709781312
SIM,1846,40,40-44,1886,3
SIM,1873,11,na,1884,2636
SIM,1899,24,20-24,1923,101
SIM,1931,16,35-39,1947,7
SIM,1842,82,na,1924,455
STAT,1881,39,40-44,1920,4.273979072001562
STAT,1931,40,20-24,1971,0.024128205388392925
STAT,1889,81,na,1970,1143.396706290297
STAT,1900,41,na,1941,3294.100866939668
STAT,1922,21,15-19,1943,6.247558665209813
STAT,1847,61,na,1908,1457.1863368586519
STAT,1871,49,25-29,1920,0.05699091677805655
STAT,1925,46,40-44,1971,0.19540200434265964
SIM,1898,23,15-19,1921,4
SIM,1849,36,25-29,1885,5
SIM,1849,61,na,1910,1425
SIM,1829,43,45-49,1872,5
SIM,1860,15,25-29,1875,7
STAT,1924,28,45-49,1952,2.045031652555145
SIM,1878,30,35-39,1908,16
SIM,1913,25,30-34,1938,55
SIM,1840,39,45-49,1879,4
STAT,1874,16,15-19,1890,6.196382842171796
STAT,1936,33,na,1969,3744.4938131320737
STAT,1935,16,50-100,1951,0.5236016869729586
SIM,1920,38,na,1958,4004
STAT,1897,21,40-44,1918,2.850972926359665
STAT,1908,41,35-39,1949,0.1910711713211836
SIM,1882,16,15-19,1898,8
STAT,1941,21,25-29,1962,97.4176576235996
SIM,1915,33,40-44,1948,10
SIM,1907,23,40-44,1930,4
SIM,1852,49,na,1901,1836
SIM,1871,63,na,1934,1637
STAT,1846,44,na,1890,1630.5079195738406
STAT,1904,16,25-29,1920,8.305478450593135
STAT,1842,30,na,1872,2096.2059365506257
SIM,1875,77,na,1952,869
STAT,1936,36,15-19,1972,0.019245807204958557
SIM,1878,10,na,1888,2860
STAT,1869,17,45-49,1886,0.06522758942507179
STAT,1916,18,45-49,1934,0.10787236294169776
STAT,1838,40,40-44,1878,1.982909135577163
STAT,1904,55,na,1959,3103.4837705547584
SIM,1924,18,45-49,1942,1
STAT,1941,29,35-39,1970,15.82923724984464
SIM,1834,20,na,1854,1924
SIM,1902,26,50-100,1928,2
STAT,1919,49,20-24,1968,0.01216013257691601
STAT,1852,26,50-100,1878,0.6045753520774839
SIM,1841,43,50-100,1884,3
SIM,1932,28,45-49,1960,3
SIM,1911,40,45-49,1951,2
STAT,1841,30,50-100,1871,0.8380358044603771
SIM,1801,89,na,1890,16
STAT,1924,42,30-34,1966,0.1551478229746728
STAT,1931,15,30-34,1946,16.346350338272877
SIM,1849,20,15-19,1869,3
STAT,1940,25,25-29,1965,68.53205956760347
STAT,1916,26,45-49,1942,1.8291325301667312
STAT,1839,23,45-49,1862,0.6139131053840701
SIM,1863,33,na,1896,2069
SIM,1939,27,50-100,1966,2
SIM,1904,39,25-29,1943,3
STAT,1852,52,45-49,1904,0.011628986140717102
STAT,1873,23,45-49,1896,0.7189760234991265
STAT,1920,24,45-49,1944,1.2685257397376801
SIM,1896,39,na,1935,3186
SIM,1892,25,na,1917,3484
STAT,1920,18,na,1938,4203.196212428687
STAT,1882,27,na,1909,2371.910144674512
SIM,1887,41,40-44,1928,4
STAT,1899,3,na,1902,3693.0871918320663
STAT,1900,28,35-39,1928,13.595076145921405
STAT,1892,80,na,1972,1291.6262996793987
STAT,1879,41,40-44,1920,2.4093793061045523
SIM,1918,29,25-29,1947,6
STAT,1912,48,20-24,1960,0.010804252388860274
SIM,1914,37,40-44,1951,2
STAT,1876,21,20-24,1897,72.8136149951466
STAT,1901,32,35-39,1933,14.447061442069675
SIM,1841,15,15-19,1856,7
STAT,1956,6,na,1962,5305.334654552928
STAT,1853,37,50-100,1890,1.0294606946322493
SIM,1938,25,35-39,1963,21
STAT,1807,53,na,1860,1361.7097501128192
STAT,1913,27,30-34,1940,39.828998363644
STAT,1775,90,na,1865,26.85948096304029
STAT,1887,5,na,1892,2995.7393860316934
SIM,1825,32,20-24,1857,2
SIM,1859,26,40-44,1885,3
SIM,1913,17,30-34,1930,5
SIM,1925,19,15-19,1944,60
STAT,1857,105,na,1962,0.08652194121708882
SIM,1883,64,na,1947,1782
STAT,1906,37,40-44,1943,1.402949853996239
STAT,1880,7,na,1887,2843.514592808512
STAT,1884,23,20-24,1907,69.33726570456108
STAT,1849,30,15-19,1879,0.1307110860349833
SIM,1921,27,30-34,1948,81
STAT,1862,21,50-100,1883,0.3651356999695193
SIM,1897,30,45-49,1927,4
STAT,1889,30,45-49,1919,2.2151299737911363
STAT,1901,1,na,1902,3882.9580313097013
SIM,1887,78,na,1965,1226
STAT,1858,16,30-34,1874,1.5151763564589307
STAT,1917,19,15-19,1936,49.40854289432504
STAT,1905,17,30-34,1922,2.3483188785148323
SIM,1848,16,15-19,1864,6
SIM,1889,20,45-49,1909,2
STAT,1866,51,50-100,1917,0.014279232335547532
SIM,1847,23,45-49,1870,2
SIM,1924,26,45-49,1950,2
STAT,1836,98,na,1934,2.022004375907404
SIM,1857,48,na,1905,1842
STAT,1928,34,15-19,1962,0.1636862968288803
SIM,1892,23,20-24,1915,121
STAT,1911,43,50-100,1954,0.11368798976663198
STAT,1832,84,na,1916,222.2948426698114
SIM,1895,4,na,1899,3648
STAT,1936,32,50-100,1968,0.819090532547895
STAT,1923,49,35-39,1972,0.15298598498826282
SIM,1906,55,na,1961,3162
SIM,1902,41,na,1943,3393
STAT,1943,17,15-19,1960,49.100282925264366
SIM,1928,36,30-34,1964,4
STAT,1830,48,25-29,1878,0.04718680505402974
STAT,1821,38,30-34,1859,10.965812720764601
STAT,1912,42,na,1954,3654.051351458917
STAT,1916,43,35-39,1959,0.21024941365911612
SIM,1906,38,45-49,1944,1
SIM,1870,39,30-34,1909,9
STAT,1935,3,na,1938,5654.683707712279
SIM,1835,21,25-29,1856,73
SIM,1879,31,40-44,1910,7
SIM,1933,21,40-44,1954,4
STAT,1878,20,40-44,1898,2.2259181369253467
STAT,1899,17,30-34,1916,2.2265873174936233
SIM,1937,1,na,1938,4765
SIM,1865,99,na,1964,1
STAT,1908,16,45-49,1924,0.09905270558392792
STAT,1811,48,15-19,1859,0.00109186069642936
SIM,1923,31,25-29,1954,18
STAT,1889,27,15-19,1916,0.5717303651925257
SIM,1832,29,na,1861,1884
STAT,1877,80,na,1957,731.8259038652418
STAT,1942,16,45-49,1958,0.5327564106808206
STAT,1916,56,na,1972,3702.021881199936
SIM,1882,5,na,1887,2562
STAT,1873,17,50-100,1890,0.050669830103190504
STAT,1890,20,40-44,1910,2.6147199498818527
SIM,1918,36,50-100,1954,1
SIM,1951,17,15-19,1968,56
STAT,1862,50,na,1912,1896.6808621518846
SIM,1898,30,na,1928,3694
STAT,1904,38,20-24,1942,0.24205334734837058
STAT,1853,46,na,1899,1891.8446256106656
STAT,1866,64,na,1930,1635.743434516172
STAT,1862,39,30-34,1901,4.581624689741272
STAT,1856,11,na,1867,2270.7792686251655
STAT,1868,30,25-29,1898,10.060280371011261
STAT,1925,21,40-44,1946,4.118600849551707
STAT,1919,21,na,1940,4092.9503585670464
STAT,1843,22,20-24,1865,69.8285370210223
SIM,1950,16,45-49,1966,1
STAT,1861,33,na,1894,2003.0955433067204
SIM,1851,22,20-24,1873,3
SIM,1853,98,na,1951,4
STAT,1895,24,35-39,1919,7.718464527744529
SIM,1890,28,50-100,1918,1
SIM,1879,19,20-24,1898,19
STAT,1934,31,35-39,1965,12.731412738422256
SIM,1932,17,40-44,1949,2
STAT,1867,26,25-29,1893,40.65244347072284
SIM,1840,16,na,1856,2107
SIM,1935,34,20-24,1969,9
STAT,1806,49,45-49,1855,0.795772317761333
STAT,1924,17,40-44,1941,1.6993688546878896
SIM,1927,24,20-24,1951,185
STAT,1837,41,50-100,1878,0.841886458034064
STAT,1923,41,25-29,1964,0.08528041520438918
STAT,1924,43,na,1967,4499.934142548875
SIM,1905,26,35-39,1931,23
STAT,1890,78,na,1968,1389.5249367228964
STAT,1932,27,40-44,1959,6.22600594472412
SIM,1861,2,na,1863,3311
STAT,1927,34,20-24,1961,3.0567506618964218
STAT,1824,97,na,1921,2.9580388629242775
STAT,1879,20,35-39,1899,6.259821489687021
STAT,1922,37,25-29,1959,1.1431659978692739
SIM,1827,32,50-100,1859,1
SIM,1845,41,50-100,1886,2
SIM,1944,19,25-29,1963,58
STAT,1910,35,40-44,1945,1.4740943544505345
STAT,1932,34,50-100,1966,1.1194435380597976
STAT,1820,83,na,1903,218.6423807590448
STAT,1936,19,25-29,1955,42.08936269438014
SIM,1903,26,na,1929,3351
SIM,1829,84,na,1913,98
SIM,1930,37,25-29,1967,1
SIM,1836,33,35-39,1869,19
STAT,1914,27,25-29,1941,67.69972238792259
SIM,1858,31,20-24,1889,3
STAT,1905,42,20-24,1947,0.016228485319091865
SIM,1922,27,25-29,1949,120
STAT,1828,33,35-39,1861,9.664556959294027
SIM,1790,88,na,1878,19
SIM,1828,67,na,1895,939
SIM,1940,27,40-44,1967,7
STAT,1919,24,20-24,1943,123.47449171963542
SIM,1914,42,na,1956,3770
SIM,1824,53,na,1877,1266
SIM,1868,0,na,1868,3652
STAT,1840,38,40-44,1878,3.687242265625805
STAT,1866,2,na,1868,3178.5697341366217
STAT,1896,40,50-100,1936,0.09984217439480617
STAT,1919,16,20-24,1935,30.749302103427294
SIM,1849,24,30-34,1873,23
STAT,1860,48,na,1908,1838.826357416366
SIM,1777,90,na,1867,1
SIM,1849,29,na,1878,2023
SIM,1938,2,na,1940,4067
STAT,1914,26,35-39,1940,15.495259401891902
SIM,1914,30,20-24,1944,1
STAT,1882,52,50-100,1934,0.014930365365583344
STAT,1940,17,25-29,1957,44.887358771839715
STAT,1851,52,50-100,1903,0.012393699694042604
STAT,1926,42,40-44,1968,0.31456754755229305
STAT,1894,60,na,1954,2502.635897416767
SIM,1906,39,35-39,1945,5
STAT,1871,46,50-100,1917,0.2488894917163105
STAT,1874,53,35-39,1927,0.00882289496698064
STAT,1834,22,50-100,1856,0.3670192538817357
SIM,1826,33,na,1859,1753
SIM,1955,0,na,1955,5106
STAT,1898,74,na,1972,2001.5190985927172
SIM,1834,52,na,1886,1505
STAT,1870,49,30-34,1919,0.09451945145612586
SIM,1809,64,na,1873,644
SIM,1805,50,na,1855,1217
STAT,1829,32,na,1861,1897.8538311990071
SIM,1946,6,na,1952,4343
SIM,1921,28,20-24,1949,4
SIM,1925,44,40-44,1969,3
STAT,1827,30,na,1857,1900.9835565897195
STAT,1830,28,30-34,1858,26.73805715078967
SIM,1845,15,na,1860,2273
SIM,1918,37,25-29,1955,3
SIM,1877,25,na,1902,2508
STAT,1906,43,50-100,1949,0.10814463310035562
SIM,1942,17,na,1959,4328
STAT,1887,30,35-39,1917,11.669641531005286
STAT,1905,61,na,1966,2991.3973214952516
SIM,1922,26,35-39,1948,28
STAT,1854,54,20-24,1908,5.4923920658279E-4
STAT,1888,16,50-100,1904,0.05923030969853239
STAT,1914,30,50-100,1944,0.8559628539711752
STAT,1826,35,50-100,1861,1.1506025632113102
STAT,1851,109,na,1960,0.0015979539167164543
STAT,1920,37,15-19,1957,0.021456403424830593
STAT,1855,40,40-44,1895,1.7612286619942477
STAT,1876,24,25-29,1900,59.92669457112663
SIM,1930,25,30-34,1955,67
SIM,1831,38,40-44,1869,8
STAT,1926,34,na,1960,4659.328256545061
SIM,1872,80,na,1952,404
STAT,1901,41,25-29,1942,0.06390286252843712
STAT,1901,21,30-34,1922,25.48734903787016
STAT,1913,47,25-29,1960,0.05281852596915393
SIM,1823,39,45-49,1862,5
STAT,1902,28,45-49,1930,1.5917099812015247
SIM,1889,3,na,1892,3423
SIM,1904,35,30-34,1939,2
STAT,1842,41,50-100,1883,0.8681988575421018
SIM,1834,63,na,1897,1238
SIM,1879,27,na,1906,2930
SIM,1910,28,45-49,1938,2
SIM,1927,16,20-24,1943,152
STAT,1825,109,na,1934,4.26635970984106E-4
STAT,1936,28,15-19,1964,0.6887520957299351
STAT,1823,38,40-44,1861,7.896423312159304
STAT,1856,43,na,1899,1837.47877070904
STAT,1859,15,35-39,1874,0.5250889013367216
STAT,1924,21,25-29,1945,111.53768345511705
SIM,1875,26,25-29,1901,50
SIM,1884,24,25-29,1908,69
SIM,1918,18,20-24,1936,178
STAT,1881,10,na,1891,2554.780004298485
SIM,1798,84,na,1882,93
STAT,1815,39,45-49,1854,7.585577627978729
SIM,1794,70,na,1864,700
STAT,1851,53,40-44,1904,0.008546038893243197
STAT,1929,43,20-24,1972,0.023289988656404137
STAT,1921,16,25-29,1937,50.52970600158686
SIM,1876,94,na,1970,139
STAT,1851,98,na,1949,2.680102940406142
SIM,1870,14,na,1884,2826
STAT,1907,41,40-44,1948,0.2350200683900069
SIM,1932,29,35-39,1961,33
STAT,1919,48,30-34,1967,0.0983957754362409
STAT,1785,89,na,1874,37.92609753875598
STAT,1922,25,30-34,1947,45.54705144938504
STAT,1848,24,na,1872,1994.744814385129
STAT,1907,17,50-100,1924,0.07338429623931854
SIM,1917,39,na,1956,3811
SIM,1920,22,45-49,1942,2
SIM,1780,89,na,1869,32
STAT,1900,24,40-44,1924,2.927955981537524
STAT,1940,16,35-39,1956,4.347658928850963
SIM,1913,25,na,1938,3950
STAT,1781,75,na,1856,368.9836428654
STAT,1859,62,na,1921,1489.079907571144
SIM,1839,62,na,1901,1347
SIM,1872,39,40-44,1911,1
STAT,1834,49,50-100,1883,0.17084729340158034
SIM,1925,31,35-39,1956,14
STAT,1830,29,na,1859,1773.004210354613
STAT,1929,30,15-19,1959,0.16667261382147824
SIM,1876,83,na,1959,601
STAT,1909,54,na,1963,3353.04712503742
STAT,1939,28,40-44,1967,4.777784345028346
SIM,1847,81,na,1928,331
STAT,1907,36,45-49,1943,0.6476077371944764
STAT,1905,40,na,1945,3451.4916344643307
SIM,1902,31,40-44,1933,14
STAT,1841,29,45-49,1870,1.0036560300610706
STAT,1929,38,25-29,1967,1.2879772298012653
STAT,1822,51,20-24,1873,0.001031773716722499
STAT,1921,46,20-24,1967,0.01274431644601412
SIM,1901,22,35-39,1923,11
SIM,1913,21,15-19,1934,4
STAT,1819,49,30-34,1868,0.1862855504592632
STAT,1854,49,25-29,1903,0.043163976407255396
SIM,1860,29,20-24,1889,9
SIM,1898,19,na,1917,3928
STAT,1865,26,15-19,1891,0.42152608467786373
SIM,1925,27,15-19,1952,1
STAT,1876,36,50-100,1912,1.2995652207558732
STAT,1910,46,45-49,1956,0.20732995513210137
STAT,1912,22,45-49,1934,1.1000197698562513
SIM,1895,30,35-39,1925,25
SIM,1892,14,na,1906,3776
STAT,1810,52,40-44,1862,0.03152648450923405
STAT,1905,29,25-29,1934,61.879123036270066
SIM,1903,30,45-49,1933,5
STAT,1926,37,50-100,1963,0.5234610227456252
STAT,1899,37,25-29,1936,0.868146003280514
STAT,1876,31,na,1907,2524.08319995362
SIM,1929,19,35-39,1948,6
STAT,1852,29,20-24,1881,9.873791141773301
SIM,1809,53,na,1862,968
STAT,1811,51,45-49,1862,0.039186585537342666
STAT,1938,16,30-34,1954,12.295249200970485
STAT,1940,22,20-24,1962,115.55801109757486
SIM,1843,23,25-29,1866,66
SIM,1923,35,na,1958,4263
SIM,1946,16,30-34,1962,19
STAT,1917,27,15-19,1944,0.7555164177885805
STAT,1906,30,20-24,1936,2.3231486579991873
STAT,1884,61,na,1945,1885.9813936269377
STAT,1864,39,40-44,1903,3.9307914851387435
SIM,1872,30,40-44,1902,6
SIM,1913,29,25-29,1942,70
STAT,1918,36,20-24,1954,0.2849047179532614
STAT,1905,21,15-19,1926,4.875273685707403
STAT,1888,75,na,1963,1508.675829102917
STAT,1903,24,50-100,1927,0.5876612011867224
SIM,1877,57,na,1934,2103
SIM,1873,43,na,1916,2300
SIM,1931,36,50-100,1967,3
SIM,1952,16,na,1968,4575
SIM,1933,30,30-34,1963,31
STAT,1902,33,40-44,1935,6.212669112547032
SIM,1853,39,30-34,1892,6
STAT,1838,52,50-100,1890,0.011037703869461533
STAT,1856,19,50-100,1875,0.04584543615983422
SIM,1829,49,50-100,1878,1
SIM,1939,29,45-49,1968,1
STAT,1835,23,25-29,1858,56.31226008975877
STAT,1926,38,20-24,1964,0.3283275735528073
SIM,1903,23,20-24,1926,97
STAT,1846,33,na,1879,1812.6158281843675
STAT,1866,32,na,1898,2245.447547448329
STAT,1884,23,50-100,1907,0.4103040005514525
STAT,1836,40,30-34,1876,0.8734466507690114
STAT,1873,54,30-34,1927,0.005987124289226428
STAT,1845,59,na,1904,1518.5197720803217
STAT,1876,42,na,1918,2431.7303294019093
STAT,1830,101,na,1931,0.36097200185005385
STAT,1858,13,na,1871,2245.7649539811114
SIM,1847,20,40-44,1867,2
STAT,1901,16,35-39,1917,0.7846995489270255
SIM,1897,56,na,1953,2747
SIM,1893,42,na,1935,3059
STAT,1856,20,40-44,1876,1.9661970609960016
SIM,1885,76,na,1961,1169
SIM,1881,62,na,1943,1720
STAT,1898,25,15-19,1923,0.6301527930052129
SIM,1868,24,40-44,1892,6
STAT,1921,17,15-19,1938,52.78820477664825
SIM,1927,17,na,1944,4408
STAT,1889,27,50-100,1916,0.8061042882578486
STAT,1929,37,35-39,1966,3.1671925888451122
STAT,1946,18,30-34,1964,13.78871959500711
STAT,1915,35,40-44,1950,1.5578377522920093
SIM,1913,36,na,1949,3892
STAT,1893,16,25-29,1909,7.35158797169156
STAT,1935,36,20-24,1971,0.37625121247169835
SIM,1876,30,25-29,1906,15
STAT,1925,30,30-34,1955,19.1095566325288
STAT,1841,51,30-34,1892,0.004416109582061012
SIM,1908,57,na,1965,3448
STAT,1875,39,50-100,1914,1.2725221743149302
SIM,1910,33,40-44,1943,6
STAT,1920,40,45-49,1960,0.18809937234179322
STAT,1941,28,45-49,1969,1.822401274558041
STAT,1895,13,na,1908,3432.0200239287547
STAT,1922,39,50-100,1961,0.4864293059653301
SIM,1864,20,40-44,1884,2
SIM,1904,43,na,1947,3567
STAT,1936,27,25-29,1963,64.24734561438038
STAT,1911,31,40-44,1942,3.902890665897177
STAT,1941,23,na,1964,3848.836800490332
SIM,1825,70,na,1895,802
SIM,1944,27,25-29,1971,84
STAT,1843,25,25-29,1868,42.6362492067787
STAT,1847,50,na,1897,1703.197102665875
STAT,1881,8,na,1889,2579.327296587294
STAT,1949,17,45-49,1966,0.5927383207047727
STAT,1839,20,40-44,1859,1.8746497027626472
SIM,1844,40,30-34,1884,5
SIM,1851,25,25-29,1876,7
STAT,1802,86,na,1888,66.50849935627932
SIM,1885,16,40-44,1901,2
STAT,1880,79,na,1959,902.4940423445804
SIM,1845,47,na,1892,1760
STAT,1926,23,na,1949,4511.942483886039
SIM,1841,33,na,1874,1883
SIM,1897,45,na,1942,3045
SIM,1899,35,25-29,1934,5
STAT,1836,49,30-34,1885,0.06146401497783207
SIM,1893,31,na,1924,3166
STAT,1888,42,45-49,1930,1.802756065728009
STAT,1937,32,15-19,1969,0.12968214589944843
STAT,1950,19,35-39,1969,5.058360961590118
STAT,1827,62,na,1889,1197.0420661124188
SIM,1940,23,25-29,1963,110
SIM,1910,16,15-19,1926,9
STAT,1905,46,50-100,1951,0.20469498761347785
STAT,1902,20,35-39,1922,8.445277617411147
STAT,1882,52,30-34,1934,0.005884606559942728
SIM,1825,35,25-29,1860,1
STAT,1949,19,na,1968,4364.537264158837
STAT,1949,22,40-44,1971,4.002842404537151
STAT,1863,52,20-24,1915,6.565195700426881E-4
SIM,1870,7,na,1877,2963
STAT,1822,85,na,1907,159.39382127510007
STAT,1808,70,na,1878,611.8914827193202
STAT,1826,99,na,1925,1.1045802965080813
SIM,1810,100,na,1910,5
SIM,1913,57,na,1970,3528
SIM,1928,28,30-34,1956,6
STAT,1862,30,30-34,1892,15.283893619519121
STAT,1921,20,45-49,1941,1.3045755290694476
SIM,1880,13,na,1893,2609
SIM,1940,20,50-100,1960,1
STAT,1894,20,25-29,1914,75.5669351861462
SIM,1765,89,na,1854,46
STAT,1826,39,20-24,1865,0.6536952387060452
STAT,1919,6,na,1925,4519.909628039147
STAT,1931,19,25-29,1950,57.5376389649684
STAT,1939,32,25-29,1971,9.620256565820167
STAT,1822,42,50-100,1864,1.644961063826042
STAT,1919,34,50-100,1953,0.9024808687029374
STAT,1847,41,45-49,1888,1.1887413370424065
STAT,1884,26,25-29,1910,42.840603469659996
STAT,1910,32,50-100,1942,0.8130822524081103
SIM,1862,70,na,1932,1254
SIM,1862,3,na,1865,2653
SIM,1907,40,30-34,1947,1
STAT,1867,17,35-39,1884,0.5372351585646413
STAT,1813,49,na,1862,1291.4552041668016
STAT,1944,26,20-24,1970,20.13767355397587
SIM,1892,26,25-29,1918,74
SIM,1919,17,25-29,1936,55
STAT,1914,54,na,1968,3620.431302115431
STAT,1927,37,25-29,1964,1.2487400303632759
SIM,1923,35,40-44,1958,4
STAT,1912,19,15-19,1931,9.311506262091257
SIM,1890,27,40-44,1917,6
SIM,1910,20,35-39,1930,12
STAT,1901,40,35-39,1941,0.1811975992713484
STAT,1932,23,25-29,1955,123.21709999811955
STAT,1802,53,45-49,1855,0.03769082998855962
STAT,1902,16,15-19,1918,8.558683549678706
STAT,1910,40,na,1950,3620.4444532813345
STAT,1863,32,50-100,1895,0.8195374131795645
STAT,1845,39,30-34,1884,4.285411024995558
STAT,1929,18,30-34,1947,15.824063404219613
SIM,1866,84,na,1950,342
SIM,1834,25,25-29,1859,41
SIM,1938,17,35-39,1955,4
STAT,1898,42,na,1940,3195.548881200321
SIM,1827,82,na,1909,204
SIM,1938,22,30-34,1960,38
SIM,1858,65,na,1923,1328
SIM,1922,23,30-34,1945,2
STAT,1879,82,na,1961,698.1884344611948
SIM,1855,41,45-49,1896,5
SIM,1854,51,na,1905,1854
STAT,1862,48,20-24,1910,0.010289863061395737
STAT,1846,29,50-100,1875,0.5454925806963664
STAT,1899,59,na,1958,2783.0372710181005
SIM,1937,18,30-34,1955,19
STAT,1920,21,40-44,1941,3.826137391726824
STAT,1879,37,50-100,1916,1.309209636411965
STAT,1901,48,45-49,1949,0.18752518819806818
STAT,1859,43,50-100,1902,0.8544896040308685
SIM,1912,37,30-34,1949,2
STAT,1923,17,25-29,1940,51.91912719387978
SIM,1864,16,20-24,1880,19
SIM,1914,33,25-29,1947,16
STAT,1880,25,50-100,1905,0.6904216669116094
SIM,1789,70,na,1859,698
SIM,1858,34,25-29,1892,13
STAT,1821,47,20-24,1868,0.018907560961365658
SIM,1911,32,45-49,1943,3
STAT,1905,26,20-24,1931,17.343785712577855
SIM,1885,41,30-34,1926,2
SIM,1867,58,na,1925,1768
SIM,1863,44,na,1907,1979
STAT,1768,101,na,1869,0.17885906082869132
SIM,1867,43,50-100,1910,2
STAT,1882,27,40-44,1909,2.977221544184283
STAT,1872,28,na,1900,2431.463141488865
SIM,1823,36,40-44,1859,6
STAT,1837,20,30-34,1857,16.424812090844615
SIM,1930,28,35-39,1958,24
STAT,1934,27,15-19,1961,0.9684839133099793
STAT,1919,19,25-29,1938,48.60714921542416
STAT,1873,98,na,1971,22.765124402006393
SIM,1801,68,na,1869,885
STAT,1905,45,25-29,1950,0.04834797843524256
SIM,1892,46,na,1938,3266
SIM,1820,71,na,1891,896
STAT,1900,36,35-39,1936,2.1689645478511625
STAT,1856,16,20-24,1872,16.886570154083202
STAT,1906,33,25-29,1939,8.695976298969141
STAT,1948,18,40-44,1966,1.6326094157936333
STAT,1911,27,20-24,1938,18.158157093622286
SIM,1935,18,20-24,1953,190
STAT,1951,20,30-34,1971,35.05444340083624
SIM,1952,7,na,1959,4887
STAT,1849,84,na,1933,258.2665751330985
STAT,1845,16,45-49,1861,0.06489173475971617
SIM,1912,20,45-49,1932,2
STAT,1861,42,45-49,1903,1.260066877455605
STAT,1950,16,na,1966,4441.291951571965
SIM,1924,28,50-100,1952,2
STAT,1879,16,15-19,1895,6.343880406874407
SIM,1942,27,15-19,1969,1
STAT,1845,70,na,1915,1096.2877413387712
STAT,1922,28,35-39,1950,17.273605728767922
SIM,1886,20,40-44,1906,1
STAT,1825,38,50-100,1863,1.8196377066101956
STAT,1843,39,20-24,1882,0.6474941302557773
STAT,1881,30,40-44,1911,4.311586272522509
STAT,1910,22,35-39,1932,9.018534647809766
STAT,1904,21,50-100,1925,0.5980164520725874
SIM,1886,61,na,1947,2101
SIM,1865,24,15-19,1889,4
STAT,1853,15,40-44,1868,0.18667948714907553
SIM,1931,17,25-29,1948,66
SIM,1933,24,45-49,1957,5
STAT,1947,22,30-34,1969,33.141475491809295
SIM,1898,27,30-34,1925,48
SIM,1856,21,45-49,1877,1
SIM,1912,21,50-100,1933,2
STAT,1924,15,50-100,1939,0.4573028451050957
STAT,1857,24,15-19,1881,2.7217317986880794
SIM,1893,10,na,1903,3417
STAT,1957,7,na,1964,5285.235618655399
STAT,1897,27,50-100,1924,0.872563823229908
STAT,1902,21,na,1923,3412.738881910024
SIM,1897,24,na,1921,3159
SIM,1892,57,na,1949,2873
SIM,1918,34,20-24,1952,3
STAT,1872,43,50-100,1915,1.0723449893000336
STAT,1903,32,45-49,1935,2.5288293085012055
STAT,1915,40,15-19,1955,0.0015820762784687634
STAT,1906,35,na,1941,3559.352114161268
SIM,1851,39,20-24,1890,1
SIM,1901,46,45-49,1947,1
STAT,1871,54,20-24,1925,7.251798494715176E-4
STAT,1873,49,35-39,1922,0.14177173385519054
SIM,1904,19,30-34,1923,3
STAT,1876,20,30-34,1896,18.875939054453532
STAT,1897,17,20-24,1914,24.182365491003647
STAT,1919,53,na,1972,3979.808064424653
SIM,1923,19,40-44,1942,7
STAT,1931,35,25-29,1966,1.3321829928919962
STAT,1865,52,30-34,1917,0.0054821419698466755
STAT,1921,49,25-29,1970,0.060663338618593736
SIM,1835,26,na,1861,1915
STAT,1885,20,50-100,1905,0.4175167983776157
STAT,1900,27,45-49,1927,1.5699128102977693
STAT,1806,100,na,1906,0.37723853230938953
STAT,1912,35,15-19,1947,0.019301536969775084
STAT,1928,39,20-24,1967,0.33909292964363
STAT,1832,100,na,1932,0.7094208869353474
SIM,1838,66,na,1904,1029
STAT,1889,60,na,1949,2403.3203150988993
SIM,1857,80,na,1937,446
STAT,1843,28,50-100,1871,0.6309671830445736
STAT,1820,41,45-49,1861,3.062013396624582
SIM,1933,24,na,1957,4828
STAT,1827,108,na,1935,0.0011838783713714858
STAT,1848,21,45-49,1869,0.664775856093902
SIM,1914,24,35-39,1938,12
SIM,1880,43,50-100,1923,3
STAT,1832,48,35-39,1880,0.10972847401689101
STAT,1902,49,15-19,1951,3.178285483999013E-4
SIM,1904,38,35-39,1942,5
STAT,1908,37,15-19,1945,0.01833401590962442
STAT,1836,66,na,1902,1020.1765946704205
STAT,1901,58,na,1959,2909.7422621175265
STAT,1916,27,35-39,1943,15.841447607308629
SIM,1843,99,na,1942,3
STAT,1838,25,na,1863,2051.2273170038507
STAT,1838,49,40-44,1887,0.1261378926010172
STAT,1851,15,50-100,1866,0.04972634056768786
STAT,1847,26,50-100,1873,0.6039168820187099
SIM,1854,29,na,1883,2117
SIM,1850,15,na,1865,2205
SIM,1820,36,15-19,1856,1
SIM,1946,19,35-39,1965,7
STAT,1915,19,40-44,1934,0.2971269171536282
STAT,1916,28,50-100,1944,1.0465393187278946
STAT,1925,38,na,1963,4602.242289106367
SIM,1913,26,20-24,1939,25
STAT,1926,45,45-49,1971,0.2748633863616083
SIM,1859,22,25-29,1881,94
STAT,1921,41,15-19,1962,0.0017675699107534593
STAT,1936,31,45-49,1967,1.5598189439759873
STAT,1817,52,na,1869,1310.289038263427
SIM,1905,47,40-44,1952,1
STAT,1842,51,na,1893,1696.6029675153563
STAT,1930,27,30-34,1957,50.8145127741019
STAT,1927,18,20-24,1945,171.50558942166154
SIM,1788,85,na,1873,142
SIM,1915,42,30-34,1957,1
STAT,1921,24,na,1945,4182.596492699557
SIM,1838,77,na,1915,465
SIM,1867,47,na,1914,2023
STAT,1855,80,na,1935,479.5347791140333
STAT,1906,24,35-39,1930,8.61054465983902
STAT,1941,25,40-44,1966,4.9234265987957215
STAT,1859,94,na,1953,16.282956575438796
STAT,1811,90,na,1901,34.15045477184475
STAT,1817,63,na,1880,1000.0458386796804
SIM,1871,84,na,1955,516
SIM,1784,71,na,1855,606
SIM,1842,15,30-34,1857,2
STAT,1822,54,25-29,1876,0.0046651836120508924
STAT,1866,30,15-19,1896,0.1350784970768771
STAT,1931,39,40-44,1970,2.0176308693751293
STAT,1832,30,45-49,1862,1.563531493388331
SIM,1837,21,35-39,1858,5
STAT,1854,48,50-100,1902,0.1856092304216837
STAT,1891,16,15-19,1907,7.513734042724103
STAT,1877,41,30-34,1918,1.2219519587690353
SIM,1849,27,35-39,1876,13
STAT,1841,26,40-44,1867,2.767007737632025
STAT,1880,30,50-100,1910,0.9901377690360992
STAT,1772,115,na,1887,1.0439271398214931E-4
STAT,1955,15,na,1970,4986.326332210041
STAT,1850,15,15-19,1865,5.519765437039492
SIM,1883,16,30-34,1899,2
STAT,1936,24,20-24,1960,108.35376643231834
SIM,1912,17,15-19,1929,9
STAT,1859,40,25-29,1899,0.5284539680032925
STAT,1830,24,50-100,1854,0.9596409189812021
SIM,1819,63,na,1882,996
STAT,1920,17,50-100,1937,0.4289572828168473
SIM,1788,74,na,1862,582
STAT,1850,81,na,1931,406.76567317195054
SIM,1858,38,40-44,1896,4
SIM,1897,15,20-24,1912,29
STAT,1789,109,na,1898,1.415265321376167E-4
STAT,1841,54,35-39,1895,0.006181721650250193
STAT,1942,17,35-39,1959,4.473901635548438
SIM,1886,24,35-39,1910,10
STAT,1859,21,20-24,1880,64.47540043923394
STAT,1896,41,40-44,1937,0.21140119901952306
STAT,1925,33,35-39,1958,11.064627666331559
SIM,1931,37,40-44,1968,1
STAT,1867,25,50-100,1892,0.6168101285561073
SIM,1933,33,35-39,1966,15
STAT,1875,16,30-34,1891,1.672896888432405
SIM,1855,14,na,1869,2201
STAT,1904,17,15-19,1921,8.676703901744071
SIM,1859,28,na,1887,2339
SIM,1881,31,45-49,1912,4
STAT,1905,49,40-44,1954,0.1393116932844812
STAT,1923,37,40-44,1960,1.7697602224989264
STAT,1941,30,15-19,1971,0.13780184651190167
STAT,1932,20,20-24,1952,149.6767506106874
SIM,1903,26,25-29,1929,77
STAT,1854,95,na,1949,10.175801664152617
SIM,1944,24,20-24,1968,126
SIM,1848,15,25-29,1863,9
STAT,1820,38,15-19,1858,0.12908931771330906
SIM,1821,34,na,1855,1608
SIM,1774,93,na,1867,7
SIM,1953,8,na,1961,4773
STAT,1822,37,50-100,1859,2.3274177400511054
STAT,1878,24,35-39,1902,6.157679059606599
STAT,1889,15,20-24,1904,22.44429311033771
SIM,1825,48,na,1873,1435
STAT,1907,42,30-34,1949,0.11943705791523114
SIM,1863,45,50-100,1908,3
SIM,1905,27,25-29,1932,74
STAT,1829,50,40-44,1879,0.008568316814824749
STAT,1833,52,35-39,1885,0.005868748050439445
STAT,1924,29,35-39,1953,17.70736106262379
SIM,1914,10,na,1924,4150
SIM,1918,24,na,1942,4383
STAT,1901,45,40-44,1946,0.13913972945475678
SIM,1868,43,na,1911,2311
SIM,1867,21,20-24,1888,62
SIM,1805,71,na,1876,549
SIM,1839,51,na,1890,1534
STAT,1855,45,50-100,1900,0.19228679036497626
STAT,1915,44,30-34,1959,0.13090625247530963
SIM,1809,85,na,1894,52
STAT,1938,19,35-39,1957,4.2195917464608845
SIM,1925,39,45-49,1964,2
STAT,1917,39,45-49,1956,0.7181996673700337
STAT,1890,46,na,1936,2814.8002105439314
STAT,1795,99,na,1894,0.3388135794701525
STAT,1915,38,45-49,1953,0.6992695046354983
SIM,1813,90,na,1903,10
SIM,1869,40,35-39,1909,2
SIM,1940,20,20-24,1960,160
SIM,1868,27,45-49,1895,2
SIM,1838,26,20-24,1864,13
STAT,1935,16,na,1951,5144.059701051462
STAT,1917,31,35-39,1948,9.805317534174662
STAT,1897,38,40-44,1935,5.941457473641578
SIM,1914,21,na,1935,3769
STAT,1854,107,na,1961,0.01276748128593675
STAT,1868,26,40-44,1894,2.9287961425165356
SIM,1903,58,na,1961,2899
SIM,1918,35,na,1953,4240
STAT,1813,48,25-29,1861,0.142355754900694
STAT,1911,34,45-49,1945,1.5496089048815547
STAT,1924,41,40-44,1965,0.3039776882243317
SIM,1960,0,na,1960,5256
STAT,1933,32,30-34,1965,21.652906063821302
STAT,1931,16,20-24,1947,181.4232836470702
STAT,1874,83,na,1957,478.07016865371
SIM,1887,46,na,1933,2675
SIM,1916,21,40-44,1937,6
STAT,1823,48,na,1871,1431.0566981953202
STAT,1903,25,20-24,1928,17.127954651571137
SIM,1906,31,25-29,1937,13
STAT,1829,41,50-100,1870,0.8986622126989395
STAT,1880,39,25-29,1919,3.0555195334787815
SIM,1814,86,na,1900,140
SIM,1900,34,35-39,1934,17
SIM,1870,30,30-34,1900,35
STAT,1914,32,20-24,1946,2.5050797545240986
STAT,1830,53,20-24,1883,5.279695932351728E-4
SIM,1840,48,na,1888,1564
STAT,1858,36,25-29,1894,2.340503611752451
STAT,1918,43,45-49,1961,0.18028933057757304
STAT,1943,29,45-49,1972,1.8753265727180612
SIM,1793,85,na,1878,46
STAT,1849,26,30-34,1875,23.342566901444126
STAT,1873,31,45-49,1904,1.8109178100737775
STAT,1907,17,40-44,1924,0.2739681059156472
SIM,1853,66,na,1919,1291
SIM,1927,19,25-29,1946,82
STAT,1937,19,50-100,1956,0.3706728792527889
SIM,1911,25,20-24,1936,23
STAT,1839,95,na,1934,9.175847139607535
STAT,1835,81,na,1916,402.9051839406946
STAT,1890,29,40-44,1919,3.7097719677823036
SIM,1948,16,40-44,1964,2
SIM,1922,32,20-24,1954,6
STAT,1892,37,50-100,1929,1.5697451039134571
SIM,1852,81,na,1933,385
SIM,1908,19,15-19,1927,10
STAT,1913,28,20-24,1941,18.489757812166918
STAT,1804,101,na,1905,0.19253971383485688
STAT,1837,51,na,1888,1469.596841910253
STAT,1908,21,40-44,1929,3.161587883938082
SIM,1858,30,30-34,1888,16
SIM,1879,27,20-24,1906,16
STAT,1851,66,na,1917,1352.211856555807
STAT,1871,29,30-34,1900,25.265055958249903
STAT,1904,37,30-34,1941,1.6818765233875144
STAT,1943,21,35-39,1964,10.22413362247594
SIM,1834,22,20-24,1856,75
SIM,1864,23,45-49,1887,2
STAT,1965,0,na,1965,5043.157694446845
SIM,1868,40,50-100,1908,2
STAT,1868,48,15-19,1916,3.848494322905428E-4
SIM,1814,40,45-49,1854,3
STAT,1839,36,15-19,1875,0.04679584857209181
SIM,1813,44,50-100,1857,3
STAT,1923,42,15-19,1965,0.0018313466041714032
STAT,1772,93,na,1865,3.588662859004387
STAT,1861,17,40-44,1878,0.17721376843233158
STAT,1861,39,15-19,1900,0.04686009122420344
STAT,1869,30,40-44,1899,4.305601710964549
STAT,1889,38,na,1927,2954.144027030236
SIM,1857,26,30-34,1883,33
SIM,1883,32,na,1915,2437
STAT,1893,75,na,1968,1722.9918515675317
STAT,1916,24,na,1940,3880.516247768307
SIM,1859,39,na,1898,2192
SIM,1888,40,45-49,1928,4
STAT,1878,21,30-34,1899,18.971276402105264
STAT,1869,61,na,1930,1840.434930747818
STAT,1857,28,na,1885,1944.3976720050975
STAT,1856,23,45-49,1879,0.6438931720066091
STAT,1912,10,na,1922,4086.2206564925
STAT,1933,26,45-49,1959,2.340433076986772
SIM,1929,35,35-39,1964,1
STAT,1868,22,50-100,1890,0.39733766013665917
STAT,1878,15,45-49,1893,0.06968570802729691
STAT,1885,24,na,1909,2392.027477877926
SIM,1950,17,35-39,1967,11
STAT,1852,31,25-29,1883,8.632574839976837
STAT,1853,14,na,1867,2386.0950975878754
SIM,1881,16,20-24,1897,21
STAT,1900,21,15-19,1921,4.678737164429162
STAT,1835,27,40-44,1862,2.910039770796598
SIM,1894,22,40-44,1916,1
SIM,1909,42,na,1951,3363
SIM,1933,22,30-34,1955,1
STAT,1864,94,na,1958,27.008293103784993
STAT,1850,23,15-19,1873,2.957091243697759
STAT,1875,36,25-29,1911,3.0290593165284156
SIM,1802,85,na,1887,172
SIM,1897,23,20-24,1920,103
STAT,1822,38,25-29,1860,5.185762474017968
STAT,1805,83,na,1888,168.2253959379018
SIM,1847,59,na,1906,1333
SIM,1866,30,na,1896,2427
SIM,1830,38,25-29,1868,4
STAT,1858,27,35-39,1885,7.991025620871257
STAT,1822,53,na,1875,1375.3623001702024
STAT,1905,18,na,1923,3711.338806722812
STAT,1913,37,na,1950,3787.6195661126035
STAT,1854,29,30-34,1883,19.915379726223545
STAT,1856,37,40-44,1893,3.5055195732709
STAT,1898,21,20-24,1919,95.35541775610204
STAT,1814,42,45-49,1856,5.13022402938401
SIM,1855,78,na,1933,561
SIM,1858,11,na,1869,2372
SIM,1866,27,35-39,1893,12
SIM,1890,39,35-39,1929,16
STAT,1849,21,25-29,1870,54.12179928533871
SIM,1935,30,40-44,1965,7
SIM,1823,48,35-39,1871,1
SIM,1909,35,45-49,1944,1
STAT,1889,23,20-24,1912,86.57130568691598
SIM,1842,22,50-100,1864,1
SIM,1885,44,35-39,1929,6
STAT,1856,75,na,1931,824.3968342072314
SIM,1857,21,25-29,1878,56
STAT,1881,64,na,1945,1714.5036212316174
STAT,1864,48,30-34,1912,0.08670228788072769
SIM,1848,23,25-29,1871,2
STAT,1861,37,50-100,1898,1.034948157864938
STAT,1877,44,35-39,1921,1.890134286733933
SIM,1848,36,30-34,1884,10
SIM,1929,33,20-24,1962,6
STAT,1942,29,15-19,1971,0.7551872457261134
STAT,1873,16,20-24,1889,18.444363507702466
SIM,1787,89,na,1876,19
STAT,1817,43,25-29,1860,1.5516043066835876
STAT,1945,21,45-49,1966,1.2585767855563479
SIM,1846,15,15-19,1861,8
STAT,1867,25,35-39,1892,9.30377928373912
STAT,1883,65,na,1948,1691.594066805113
SIM,1918,33,45-49,1951,1
SIM,1845,22,45-49,1867,1
SIM,1883,36,25-29,1919,3
STAT,1882,26,15-19,1908,0.45247189451237557
SIM,1839,30,20-24,1869,2
SIM,1872,48,na,1920,2347
SIM,1822,42,45-49,1864,5
STAT,1892,33,20-24,1925,3.441443449217881
SIM,1830,92,na,1922,22
SIM,1920,39,30-34,1959,3
STAT,1871,38,20-24,1909,0.7750981365399175
STAT,1869,52,50-100,1921,0.01479563899761293
SIM,1823,35,15-19,1858,1
SIM,1901,31,25-29,1932,15
STAT,1894,38,15-19,1932,0.0733215508393632
STAT,1871,32,na,1903,2411.4260933334267
STAT,1818,49,15-19,1867,8.804233765348195E-4
STAT,1845,48,na,1893,1735.8180595652107
STAT,1864,19,50-100,1883,0.04543189603382578
STAT,1884,34,25-29,1918,10.249175354207713
SIM,1926,22,na,1948,4758
STAT,1848,42,15-19,1890,0.01072162148255822
STAT,1856,65,na,1921,1353.3278966847795
STAT,1827,47,15-19,1874,4.492321940365684E-4
SIM,1832,83,na,1915,166
STAT,1825,42,20-24,1867,0.21684912017492944
SIM,1938,31,20-24,1969,3
SIM,1910,39,na,1949,3606
STAT,1865,17,25-29,1882,5.406772905598637
STAT,1875,24,30-34,1899,18.53290017480139
STAT,1890,25,na,1915,2996.993982383779
SIM,1879,80,na,1959,952
SIM,1889,24,25-29,1913,84
SIM,1909,52,na,1961,3260
STAT,1880,19,30-34,1899,1.6995119682854476
STAT,1944,27,50-100,1971,1.0975726116740963
SIM,1887,16,15-19,1903,7
SIM,1832,26,40-44,1858,9
SIM,1925,23,35-39,1948,15
SIM,1927,31,45-49,1958,4
STAT,1916,24,30-34,1940,30.541362017854308
STAT,1918,32,40-44,1950,4.243605388044627
STAT,1870,15,na,1885,2572.9054306745206
STAT,1930,39,50-100,1969,0.5573610082838057
STAT,1790,90,na,1880,32.34554143864612
STAT,1837,22,45-49,1859,0.6086319915340143
STAT,1912,39,30-34,1951,1.7963933773207912
SIM,1879,36,50-100,1915,1
STAT,1855,106,na,1961,0.03126924252455054
STAT,1861,19,20-24,1880,16.97532663373125
STAT,1950,16,30-34,1966,14.707302017812632
SIM,1902,23,40-44,1925,5
SIM,1905,24,20-24,1929,110
STAT,1815,48,35-39,1863,0.37039935671253044
STAT,1778,111,na,1889,8.210830219730035E-4
STAT,1830,37,20-24,1867,0.6964495734296389
SIM,1942,20,30-34,1962,35
STAT,1889,43,15-19,1932,0.01727665796906293
STAT,1788,86,na,1874,77.95538334460971
STAT,1858,46,50-100,1904,0.19925640768365452
STAT,1900,62,na,1962,2747.530239923888
STAT,1835,28,na,1863,2085.415463824601
SIM,1825,37,50-100,1862,2
SIM,1855,26,20-24,1881,13
STAT,1899,28,35-39,1927,13.43181366010473
STAT,1837,29,na,1866,1824.7017168968343
STAT,1856,97,na,1953,4.302110423498071
STAT,1925,42,25-29,1967,0.08820509240294108
SIM,1865,20,20-24,1885,72
STAT,1939,24,25-29,1963,94.56805936358566
STAT,1863,39,25-29,1902,2.5493835969724623
STAT,1849,34,30-34,1883,13.9900494740128
STAT,1853,37,15-19,1890,0.047085526287807045
STAT,1866,43,20-24,1909,0.1483588185742153
STAT,1876,23,35-39,1899,6.128271122863516
SIM,1926,32,40-44,1958,10
STAT,1919,31,45-49,1950,1.7395374165441033
STAT,1934,15,35-39,1949,5.814981122407927
SIM,1907,32,30-34,1939,4
STAT,1891,17,40-44,1908,0.23100618558901528
STAT,1841,25,15-19,1866,0.4221166457823884
SIM,1888,25,20-24,1913,19
STAT,1886,22,40-44,1908,2.250121999535466
STAT,1847,39,40-44,1886,3.4690012186881085
SIM,1906,20,20-24,1926,138
STAT,1850,49,40-44,1899,0.12608869166363512
STAT,1870,15,40-44,1885,0.18632844859500974
STAT,1915,15,25-29,1930,9.298263586030707
SIM,1849,50,na,1899,1767
STAT,1836,26,45-49,1862,0.9007801491064651
STAT,1935,27,45-49,1962,2.4015927565055826
STAT,1777,111,na,1888,0.001499292854548505
SIM,1785,88,na,1873,22
STAT,1853,23,40-44,1876,2.0496512943779472
SIM,1876,26,40-44,1902,3
SIM,1929,20,15-19,1949,10
SIM,1843,27,40-44,1870,7
STAT,1843,47,na,1890,1807.76835218952
STAT,1917,23,35-39,1940,10.180885995895332
STAT,1882,39,35-39,1921,6.958862820961202
STAT,1859,30,na,1889,1972.484162670643
STAT,1847,26,20-24,1873,11.075356863019577
STAT,1765,91,na,1856,5.945247287999999
STAT,1873,45,na,1918,2350.0950454638337
SIM,1860,47,na,1907,1944
SIM,1947,24,25-29,1971,128
STAT,1843,33,25-29,1876,9.837734009438421
SIM,1877,25,45-49,1902,1
STAT,1848,78,na,1926,607.35578340351
STAT,1934,20,30-34,1954,39.51842827967978
SIM,1827,31,40-44,1858,4
SIM,1851,33,25-29,1884,13
SIM,1889,37,30-34,1926,5
SIM,1923,15,25-29,1938,67
SIM,1830,70,na,1900,963
SIM,1804,86,na,1890,100
STAT,1798,86,na,1884,89.17825657112
SIM,1924,24,30-34,1948,55
STAT,1805,51,na,1856,1420.6285259560002
STAT,1900,23,50-100,1923,0.5748134634787215
STAT,1944,25,45-49,1969,1.9066964482417317
STAT,1871,64,na,1935,1756.6539928637103
STAT,1927,25,45-49,1952,2.156979757726894
SIM,1838,21,15-19,1859,1
SIM,1868,11,na,1879,2696
STAT,1938,20,15-19,1958,5.3779269446348135
SIM,1849,32,30-34,1881,5
STAT,1813,70,na,1883,721.6954965050171
STAT,1880,21,35-39,1901,6.274694267812433
SIM,1933,7,na,1940,5318
STAT,1868,21,35-39,1889,5.72702126373243
SIM,1881,4,na,1885,2476
STAT,1886,17,45-49,1903,0.0705360313021931
SIM,1911,21,40-44,1932,5
SIM,1866,32,30-34,1898,26
SIM,1890,77,na,1967,1352
SIM,1843,77,na,1920,553
SIM,1916,30,30-34,1946,24
STAT,1767,102,na,1869,0.05539879285778622
STAT,1924,30,15-19,1954,0.15365064403697018
SIM,1867,23,35-39,1890,5
SIM,1882,24,15-19,1906,4
SIM,1842,48,45-49,1890,1
STAT,1896,44,45-49,1940,0.13813998247071657
SIM,1819,39,30-34,1858,7
STAT,1850,19,45-49,1869,0.0593380640735579
SIM,1943,27,45-49,1970,4
STAT,1839,27,25-29,1866,36.77801932023065
STAT,1865,22,20-24,1887,64.58189234498842
SIM,1847,27,25-29,1874,43
STAT,1930,39,na,1969,4994.354372023155
STAT,1820,72,na,1892,695.5450736005008
STAT,1829,53,45-49,1882,0.010128296318975107
STAT,1835,29,20-24,1864,11.233448860325279
STAT,1909,37,45-49,1946,0.6580904637567666
STAT,1947,23,20-24,1970,128.17604776699878
STAT,1808,48,na,1856,1108.6350939009772
STAT,1868,76,na,1944,923.1191884255476
STAT,1873,77,na,1950,893.9972166886273
STAT,1844,39,15-19,1883,0.0450380843947965
STAT,1915,18,na,1933,4114.173548669577
SIM,1946,20,15-19,1966,8
SIM,1893,26,40-44,1919,13
SIM,1935,25,45-49,1960,3
SIM,1856,22,20-24,1878,88
STAT,1796,73,na,1869,498.66240364906656
STAT,1851,35,25-29,1886,2.4512056994308806
STAT,1847,29,na,1876,1998.6113942705451
STAT,1917,36,40-44,1953,1.5943721563025557
SIM,1826,29,20-24,1855,15
STAT,1903,21,40-44,1924,3.0309892029830467
SIM,1817,37,40-44,1854,7
STAT,1860,27,na,1887,1996.5246569293056
SIM,1932,26,30-34,1958,90
STAT,1859,39,45-49,1898,1.607777367794643
SIM,1870,67,na,1937,1654
SIM,1855,46,na,1901,1746
SIM,1882,15,25-29,1897,7
SIM,1772,91,na,1863,9
SIM,1826,35,40-44,1861,6
STAT,1876,28,40-44,1904,3.1445072700854464
SIM,1878,25,50-100,1903,1
STAT,1828,39,30-34,1867,4.47886117484312
SIM,1889,80,na,1969,1262
STAT,1839,44,15-19,1883,0.009790908309696391
STAT,1858,32,30-34,1890,14.125045288347605
SIM,1843,29,20-24,1872,15
SIM,1892,23,50-100,1915,1
SIM,1898,22,25-29,1920,85
SIM,1903,22,45-49,1925,1
SIM,1857,34,30-34,1891,29
STAT,1834,48,45-49,1882,0.1662860449226793
STAT,1924,26,30-34,1950,46.705304730603515
STAT,1848,22,20-24,1870,65.22447939291679
SIM,1919,52,na,1971,4059
STAT,1857,20,20-24,1877,64.30346210745856
STAT,1899,45,25-29,1944,0.045841728138066536
STAT,1891,24,15-19,1915,4.1405765278784745
SIM,1833,25,30-34,1858,30
STAT,1929,22,15-19,1951,6.865839209789457
SIM,1858,4,na,1862,2513
STAT,1771,116,na,1887,1.084140274618742E-4
STAT,1865,58,na,1923,1831.0631039117852
STAT,1874,15,25-29,1889,5.9518003115930025
STAT,1876,95,na,1971,72.72474947028438
SIM,1836,39,30-34,1875,7
SIM,1890,26,15-19,1916,1
STAT,1812,53,na,1865,1268.5562927104247
STAT,1885,26,40-44,1911,3.059284167276613
STAT,1824,33,15-19,1857,0.25205472256142425
SIM,1862,48,na,1910,1996
STAT,1923,37,na,1960,4447.727280640611
SIM,1850,47,na,1897,1650
SIM,1883,10,na,1893,2662
SIM,1877,42,35-39,1919,2
SIM,1886,31,50-100,1917,1
SIM,1946,20,na,1966,4013
STAT,1894,16,40-44,1910,0.24059818940288213
STAT,1845,81,na,1926,422.52469319908624
SIM,1858,33,35-39,1891,4
STAT,1828,30,50-100,1858,0.9703304779127584
SIM,1869,60,na,1929,1912
STAT,1899,25,30-34,1924,35.4170123737668
STAT,1860,70,na,1930,1161.3445216667046
STAT,1814,42,50-100,1856,3.6213345985995478
STAT,1904,20,45-49,1924,1.0256131405817328
STAT,1954,16,15-19,1970,57.242382218929755
STAT,1868,98,na,1966,13.771128370528269
STAT,1877,27,45-49,1904,1.1747961493224277
SIM,1886,44,50-100,1930,1
STAT,1880,25,na,1905,2575.780769894301
STAT,1938,33,20-24,1971,2.500313427922761
SIM,1916,22,na,1938,3918
STAT,1855,15,15-19,1870,5.536812164531804
STAT,1915,1,na,1916,4445.525921067039
STAT,1886,4,na,1890,2840.6484598908637
SIM,1873,17,25-29,1890,10
SIM,1917,37,45-49,1954,2
SIM,1852,25,40-44,1877,6
STAT,1805,73,na,1878,616.1834702327271
STAT,1903,59,na,1962,2970.6127520085624
STAT,1800,54,50-100,1854,0.06149152266098683
STAT,1835,49,15-19,1884,3.063217025138203E-4
STAT,1855,26,na,1881,1942.2920440321043
STAT,1875,49,45-49,1924,0.24193536961636034
SIM,1862,29,30-34,1891,27
SIM,1883,49,45-49,1932,1
STAT,1840,32,45-49,1872,1.5283996452662347
SIM,1836,43,50-100,1879,5
STAT,1850,41,50-100,1891,0.7982638987207868
STAT,1953,15,45-49,1968,0.6167432192531009
STAT,1881,33,45-49,1914,1.7126344772722524
STAT,1929,20,na,1949,4738.189142149351
SIM,1835,25,40-44,1860,5
STAT,1844,25,40-44,1869,2.882908822392024
STAT,1932,20,50-100,1952,0.8857137491804392
SIM,1818,36,45-49,1854,7
STAT,1917,40,25-29,1957,0.07625998294202599
STAT,1908,30,30-34,1938,15.286764465045055
SIM,1868,32,40-44,1900,8
SIM,1842,28,na,1870,1992
STAT,1895,15,45-49,1910,0.08734892810958164
SIM,1910,1,na,1911,4131
SIM,1911,28,25-29,1939,7
STAT,1890,38,30-34,1928,6.614805835420493
STAT,1856,49,35-39,1905,0.10977166689406466
SIM,1863,37,25-29,1900,1
SIM,1863,15,15-19,1878,8
STAT,1949,21,15-19,1970,6.339272719422021
STAT,1930,17,na,1947,4853.4057956912275
SIM,1856,10,na,1866,2842
SIM,1916,25,35-39,1941,18
SIM,1845,29,30-34,1874,1
STAT,1834,35,25-29,1869,2.460661314259071
STAT,1927,30,40-44,1957,4.916056613801934
STAT,1884,31,20-24,1915,2.7392991408997425
STAT,1948,22,25-29,1970,108.20640464580039
STAT,1869,42,35-39,1911,1.7812899974825855
SIM,1873,27,40-44,1900,7
STAT,1869,6,na,1875,2737.5117319311207
STAT,1823,47,30-34,1870,0.14552372500780097
STAT,1880,48,15-19,1928,4.2342345298565384E-4
STAT,1903,28,25-29,1931,61.128094442831284
SIM,1842,18,na,1860,2176
STAT,1845,24,45-49,1869,0.6667180354968295
STAT,1855,16,na,1871,2128.985794327908
STAT,1867,22,30-34,1889,17.129665860670713
SIM,1862,38,20-24,1900,2
SIM,1898,35,30-34,1933,2
STAT,1943,26,40-44,1969,5.0668665871878185
STAT,1910,31,25-29,1941,9.126498428540847
STAT,1837,29,30-34,1866,21.241309930722085
SIM,1842,35,25-29,1877,2
STAT,1908,25,35-39,1933,14.694462926559044
STAT,1839,32,20-24,1871,2.29571550957065
SIM,1892,31,20-24,1923,7
SIM,1918,22,50-100,1940,1
SIM,1904,34,50-100,1938,1
SIM,1870,33,35-39,1903,9
SIM,1875,22,30-34,1897,19
SIM,1847,32,20-24,1879,5
SIM,1918,30,40-44,1948,10
STAT,1849,46,25-29,1895,0.04484533038773113
STAT,1927,33,45-49,1960,1.9733213104922542
STAT,1902,25,40-44,1927,4.3387919627460585
SIM,1882,26,na,1908,2300
STAT,1860,38,45-49,1898,1.6418531801603908
STAT,1892,36,25-29,1928,3.6989497439938996
STAT,1817,40,20-24,1857,0.4311778907750384
STAT,1880,47,na,1927,2400.6515513023073
SIM,1906,36,30-34,1942,2
STAT,1886,25,45-49,1911,1.2070526055497481
STAT,1839,37,40-44,1876,3.610265356641749
SIM,1833,45,25-29,1878,1
STAT,1852,27,40-44,1879,2.810789740852488
STAT,1849,17,40-44,1866,0.17478913763898934
SIM,1916,22,30-34,1938,38
SIM,1922,18,na,1940,4153
SIM,1846,32,na,1878,2038
SIM,1908,25,na,1933,3845
STAT,1870,18,45-49,1888,0.06537690524845113
STAT,1966,1,na,1967,5015.829262405569
SIM,1933,25,35-39,1958,34
STAT,1874,50,30-34,1924,0.006289044349496994
STAT,1920,16,45-49,1936,0.573347745732842
STAT,1942,22,30-34,1964,30.74498357374241
SIM,1894,25,45-49,1919,1
SIM,1884,15,35-39,1899,2
STAT,1815,51,na,1866,1483.4812271086107
STAT,1825,45,25-29,1870,0.07614145556986823
STAT,1835,31,25-29,1866,9.82131249196609
STAT,1917,41,na,1958,3960.9302521358222
STAT,1898,33,15-19,1931,0.19562979520382046
STAT,1877,38,15-19,1915,0.059121648510229274
STAT,1897,45,15-19,1942,3.1084018671908187E-4
STAT,1845,48,20-24,1893,0.009258351854065896
STAT,1893,43,na,1936,2979.7310821628766
SIM,1857,17,40-44,1874,3
STAT,1868,34,40-44,1902,4.189377448679581
SIM,1881,29,40-44,1910,6
STAT,1925,25,35-39,1950,18.21452405551587
STAT,1929,2,na,1931,5323.576332686346
STAT,1873,29,40-44,1902,3.0760175793107982
STAT,1878,76,na,1954,1006.011209293713
SIM,1917,42,40-44,1959,1
STAT,1825,71,na,1896,800.4303054632343
SIM,1851,30,20-24,1881,3
STAT,1895,32,35-39,1927,13.47923571164774
SIM,1871,19,30-34,1890,2
STAT,1768,88,na,1856,58.946984099999995
STAT,1844,39,50-100,1883,0.9846961752656339
STAT,1932,15,25-29,1947,58.79153767826586
SIM,1885,27,45-49,1912,1
SIM,1892,0,na,1892,3988
SIM,1948,20,25-29,1968,120
STAT,1925,29,15-19,1954,0.8446141953361436
STAT,1812,49,20-24,1861,0.027442824303922225
STAT,1832,31,na,1863,1890.1306662564184
SIM,1814,64,na,1878,935
STAT,1863,77,na,1940,773.15704434762
SIM,1909,32,40-44,1941,3
SIM,1840,15,20-24,1855,18
SIM,1843,31,25-29,1874,3
STAT,1908,22,30-34,1930,26.943733541564125
STAT,1886,31,50-100,1917,0.9934162397335766
SIM,1876,34,40-44,1910,7
SIM,1961,1,na,1962,5333
STAT,1885,2,na,1887,3176.6758549999504
SIM,1865,23,25-29,1888,59
STAT,1838,46,na,1884,1722.6052764614146
SIM,1822,73,na,1895,565
STAT,1856,36,15-19,1892,0.04518520674769004
SIM,1842,71,na,1913,1048
SIM,1792,68,na,1860,683
SIM,1827,29,na,1856,1733
STAT,1889,39,30-34,1928,6.648439600847072
SIM,1842,23,30-34,1865,22
STAT,1900,30,na,1930,3401.2455767090128
STAT,1940,21,50-100,1961,0.6840414822236937
STAT,1909,42,40-44,1951,0.23859872664040832
STAT,1884,17,35-39,1901,0.5538025980386863
STAT,1834,23,30-34,1857,15.916293824139379
STAT,1868,44,na,1912,2221.5988358241334
SIM,1872,43,50-100,1915,5
STAT,1855,43,45-49,1898,1.1518119143371846
SIM,1822,36,25-29,1858,4
SIM,1892,17,35-39,1909,1
SIM,1836,41,35-39,1877,3
STAT,1865,27,40-44,1892,2.7736010920436502
SIM,1848,76,na,1924,639
SIM,1860,27,40-44,1887,7
STAT,1856,6,na,1862,2362.283467476939
SIM,1872,33,45-49,1905,2
STAT,1843,30,20-24,1873,2.678359978710156
STAT,1935,24,40-44,1959,4.66618002833096
SIM,1940,15,25-29,1955,58
STAT,1935,32,40-44,1967,5.521265460311765
SIM,1775,88,na,1863,12
SIM,1875,25,50-100,1900,1
STAT,1863,19,30-34,1882,1.4629900399837874
SIM,1929,19,na,1948,4942
SIM,1850,21,15-19,1871,2
STAT,1844,19,20-24,1863,17.258292801352606
SIM,1883,24,30-34,1907,18
STAT,1828,41,35-39,1869,1.5048807215388806
SIM,1866,49,45-49,1915,1
STAT,1826,37,40-44,1863,3.9113897715909633
SIM,1840,70,na,1910,886
SIM,1942,23,35-39,1965,15
STAT,1863,13,na,1876,2425.480389048055
STAT,1857,15,25-29,1872,5.369500270809731
STAT,1793,87,na,1880,63.00686018849137
SIM,1916,28,50-100,1944,1
STAT,1892,16,30-34,1908,2.0428657449624383
STAT,1857,16,50-100,1873,0.046148756514820914
SIM,1834,49,50-100,1883,1
SIM,1839,33,25-29,1872,1
STAT,1840,26,25-29,1866,38.22873814230153
STAT,1934,21,na,1955,5006.4100566409925
SIM,1883,20,15-19,1903,3
STAT,1780,90,na,1870,26.959340629330548
SIM,1926,39,25-29,1965,4
STAT,1881,27,25-29,1908,41.720935520061204
STAT,1918,39,25-29,1957,1.0567955815806076
SIM,1865,46,na,1911,2172
SIM,1876,62,na,1938,2062
STAT,1842,21,15-19,1863,3.2867062598027306
STAT,1898,38,50-100,1936,0.3637646620470509
SIM,1873,22,20-24,1895,68
STAT,1876,15,35-39,1891,0.5807119294177283
SIM,1873,97,na,1970,6
SIM,1923,20,20-24,1943,9
STAT,1839,26,50-100,1865,0.5601883173496055
SIM,1879,7,na,1886,3275
STAT,1910,62,na,1972,3182.2243557484157
STAT,1934,23,35-39,1957,12.900175882821646
SIM,1862,31,35-39,1893,14
STAT,1882,17,25-29,1899,5.632030087913193
STAT,1893,28,40-44,1921,3.863052450435046
SIM,1869,27,na,1896,2328
STAT,1868,41,50-100,1909,1.0340298915113526
SIM,1876,41,50-100,1917,2
STAT,1909,39,50-100,1948,0.4012236378948711
SIM,1888,28,25-29,1916,47
STAT,1946,22,15-19,1968,6.0437447105906905
SIM,1917,39,50-100,1956,2
STAT,1764,104,na,1868,0.05244508824524441
STAT,1848,38,30-34,1886,4.22519408678763
SIM,1863,65,na,1928,1355
SIM,1864,29,na,1893,2137
STAT,1838,78,na,1916,574.0858872896013
STAT,1860,25,25-29,1885,35.90235450245327
STAT,1858,24,30-34,1882,14.83043768627708
SIM,1817,41,25-29,1858,3
SIM,1943,16,50-100,1959,3
STAT,1837,49,25-29,1886,0.03885724946149832
STAT,1836,37,15-19,1873,0.04290541571739941
STAT,1951,19,15-19,1970,55.094741986844795
SIM,1936,26,15-19,1962,1
STAT,1826,49,50-100,1875,0.18690099083197292
STAT,1908,28,50-100,1936,0.9561081678719294
STAT,1884,82,na,1966,774.9527611452098
SIM,1860,26,50-100,1886,1
STAT,1930,26,50-100,1956,1.29141532280238
STAT,1951,15,35-39,1966,5.100182695494191
SIM,1908,31,35-39,1939,18
SIM,1848,98,na,1946,10
SIM,1856,38,30-34,1894,7
STAT,1866,46,25-29,1912,0.05435376561993056
SIM,1884,32,25-29,1916,14
STAT,1876,32,25-29,1908,10.789860369377877
SIM,1844,26,45-49,1870,1
STAT,1898,24,25-29,1922,78.47893551162107
STAT,1929,35,20-24,1964,0.34577735010707816
SIM,1866,24,30-34,1890,29
SIM,1903,39,30-34,1942,4
SIM,1848,20,20-24,1868,69
SIM,1902,26,45-49,1928,3
STAT,1780,105,na,1885,0.019261724171934835
STAT,1928,26,15-19,1954,0.8901815790429779
STAT,1833,47,na,1880,1574.6191956309867
SIM,1931,22,20-24,1953,145
STAT,1899,42,20-24,1941,0.015387237195177702
SIM,1919,33,50-100,1952,2
STAT,1854,31,35-39,1885,8.020131757988695
SIM,1888,38,40-44,1926,10
STAT,1833,27,30-34,1860,22.195611449888474
STAT,1883,22,15-19,1905,3.3022090277648313
STAT,1807,64,na,1871,1021.3613405343181
STAT,1833,43,50-100,1876,0.83615268980176
STAT,1858,44,25-29,1902,0.5124975562937026
STAT,1886,49,20-24,1935,0.012687197859379554
SIM,1939,26,40-44,1965,5
STAT,1841,38,35-39,1879,6.0893488260323485
STAT,1859,36,40-44,1895,3.5835824016582625
SIM,1847,24,20-24,1871,76
STAT,1915,20,20-24,1935,113.2238308396927
SIM,1934,21,35-39,1955,23
STAT,1843,16,35-39,1859,0.5694238575743212
STAT,1810,52,na,1862,1157.3683918689053
STAT,1830,40,na,1870,1664.1213567723514
SIM,1867,9,na,1876,2501
STAT,1896,38,25-29,1934,3.8600549322035533
STAT,1927,22,40-44,1949,4.225774065686422
SIM,1804,54,na,1858,1283
SIM,1899,26,35-39,1925,21
SIM,1935,22,40-44,1957,6
STAT,1910,18,15-19,1928,9.147615321554417
SIM,1857,59,na,1916,1612
STAT,1831,49,30-34,1880,0.07715639065348168
STAT,1845,21,40-44,1866,2.0358952368164553
STAT,1897,37,15-19,1934,0.07659687684893195
STAT,1818,38,45-49,1856,6.669758773265792
STAT,1829,47,25-29,1876,0.046615203167006486
STAT,1932,32,15-19,1964,0.17421443124426284
STAT,1872,3,na,1875,3184.834093048866
STAT,1888,27,20-24,1915,14.148367255195849
STAT,1923,22,20-24,1945,132.00685496307338
SIM,1859,92,na,1951,66
SIM,1922,39,40-44,1961,2
STAT,1850,16,40-44,1866,0.16911735695410982
SIM,1909,30,50-100,1939,1
SIM,1853,21,40-44,1874,3
SIM,1943,24,40-44,1967,5
SIM,1826,38,45-49,1864,4
STAT,1869,93,na,1962,66.32971862603601
STAT,1876,10,na,1886,2770.7606587142695
STAT,1846,65,na,1911,1208.5289765416744
SIM,1868,35,45-49,1903,3
SIM,1852,71,na,1923,1068
STAT,1879,24,15-19,1903,3.4959079146284355
SIM,1858,33,na,1891,1997
STAT,1906,42,15-19,1948,0.0014221885693621293
STAT,1827,33,40-44,1860,6.372818111735161
SIM,1822,83,na,1905,218
STAT,1862,33,35-39,1895,8.75723231793971
STAT,1869,25,45-49,1894,1.1009658881709166
STAT,1939,20,na,1959,3743.8467028634705
STAT,1851,15,30-34,1866,1.617763942043429
SIM,1897,39,30-34,1936,3
STAT,1866,48,40-44,1914,0.15906994234305857
STAT,1847,34,20-24,1881,2.2058876516728687
SIM,1900,39,na,1939,3357
SIM,1924,32,30-34,1956,2
SIM,1850,69,na,1919,1005
SIM,1909,20,na,1929,3381
SIM,1930,27,na,1957,5151
SIM,1899,57,na,1956,2790
SIM,1797,89,na,1886,5
SIM,1866,44,25-29,1910,1
SIM,1874,48,40-44,1922,2
SIM,1859,50,na,1909,2043
SIM,1928,24,15-19,1952,7
SIM,1916,33,35-39,1949,13
STAT,1839,24,20-24,1863,60.23408089223498
STAT,1866,26,30-34,1892,23.77673324335069
STAT,1894,24,40-44,1918,2.7172940104095127
STAT,1908,33,35-39,1941,8.758877230018093
STAT,1898,16,25-29,1914,7.836748995727123
STAT,1800,74,na,1874,556.7440330313766
SIM,1890,9,na,1899,3418
SIM,1908,23,35-39,1931,8
SIM,1915,38,na,1953,4230
STAT,1844,28,45-49,1872,1.0456959640402719
SIM,1858,25,35-39,1883,12
SIM,1899,21,50-100,1920,1
SIM,1905,32,20-24,1937,3
STAT,1838,23,15-19,1861,3.1222660488812854
STAT,1950,20,15-19,1970,6.446949692192583
SIM,1892,34,25-29,1926,21
SIM,1891,51,na,1942,2750
SIM,1835,33,40-44,1868,7
SIM,1797,67,na,1864,742
SIM,1844,43,35-39,1887,6
STAT,1865,54,50-100,1919,0.013599136564033342
STAT,1861,21,25-29,1882,49.93403231685694
STAT,1916,32,30-34,1948,16.599198945512352
SIM,1852,28,na,1880,2249
STAT,1857,23,25-29,1880,52.274530469150285
STAT,1919,23,45-49,1942,1.2534171653197057
STAT,1879,1,na,1880,3650.869223141541
SIM,1889,21,20-24,1910,93
STAT,1922,4,na,1926,4766.236174959999
SIM,1846,10,na,1856,2406
SIM,1917,34,40-44,1951,9
STAT,1893,65,na,1958,2265.13437627014
SIM,1839,25,25-29,1864,8
SIM,1893,29,45-49,1922,2
SIM,1924,2,na,1926,5057
STAT,1850,17,na,1867,2109.929957591152
STAT,1907,21,25-29,1928,86.00633421749318
STAT,1881,42,na,1923,2276.7170826625115
SIM,1847,37,40-44,1884,2
SIM,1932,22,15-19,1954,7
STAT,1908,20,15-19,1928,5.020040400833999
SIM,1921,15,15-19,1936,56
SIM,1837,82,na,1919,388
STAT,1873,24,20-24,1897,70.8265384553878
STAT,1917,44,40-44,1961,0.2654892486682529
STAT,1878,23,45-49,1901,0.7381707248435881
STAT,1836,43,35-39,1879,1.3238703770085685
SIM,1915,21,25-29,1936,106
SIM,1859,37,45-49,1896,1
SIM,1891,22,15-19,1913,2
STAT,1885,29,45-49,1914,1.121966344488516
SIM,1910,25,40-44,1935,5
STAT,1863,99,na,1962,4.774736231637871
SIM,1834,21,30-34,1855,16
SIM,1899,43,25-29,1942,2
STAT,1887,42,50-100,1929,1.2061785912763554
STAT,1913,15,15-19,1928,9.51004984745703
STAT,1862,16,45-49,1878,0.06535333173146507
SIM,1941,21,na,1962,3626
STAT,1851,32,20-24,1883,2.321103636833123
SIM,1808,90,na,1898,26
SIM,1945,5,na,1950,4732
STAT,1855,48,na,1903,1722.158360113902
SIM,1811,89,na,1900,11
SIM,1916,20,15-19,1936,7
STAT,1926,21,35-39,1947,11.705034421092355
STAT,1815,53,50-100,1868,0.03804497518982547
SIM,1841,27,30-34,1868,25
STAT,1909,34,40-44,1943,3.7759641206463246
SIM,1935,33,45-49,1968,1
STAT,1835,71,na,1906,994.5143991693116
SIM,1927,23,45-49,1950,1
STAT,1919,20,50-100,1939,0.7396514962199083
STAT,1775,113,na,1888,4.5645161328673967E-4
SIM,1905,32,50-100,1937,2
STAT,1858,35,35-39,1893,5.776390697108115
SIM,1886,23,45-49,1909,1
STAT,1920,40,na,1960,4197.490071807369
SIM,1840,28,40-44,1868,2
SIM,1846,23,15-19,1869,5
SIM,1880,77,na,1957,699
STAT,1832,28,40-44,1860,2.6940633106503493
STAT,1858,41,20-24,1899,0.1290623067541451
SIM,1892,36,50-100,1928,2
SIM,1853,34,na,1887,1952
STAT,1843,79,na,1922,564.3688012115355
STAT,1886,41,na,1927,2506.9971347275236
STAT,1866,17,40-44,1883,0.17665316313832868
SIM,1824,32,na,1856,1665
STAT,1945,26,15-19,1971,0.7905489763994802
STAT,1883,26,30-34,1909,25.292712350897872
STAT,1912,49,50-100,1961,0.22044374096781938
SIM,1824,35,30-34,1859,1
SIM,1919,21,45-49,1940,1
SIM,1869,23,45-49,1892,1
SIM,1868,41,30-34,1909,2
STAT,1888,49,30-34,1937,0.06447768361661547
STAT,1942,25,35-39,1967,16.090535519370174
SIM,1887,56,na,1943,2419
SIM,1925,32,25-29,1957,13
STAT,1878,22,na,1900,2511.353420052905
STAT,1900,42,50-100,1942,0.10360273518755617
SIM,1826,31,25-29,1857,1
SIM,1924,15,40-44,1939,4
SIM,1880,26,20-24,1906,12
STAT,1842,110,na,1952,2.1670560057841665E-4
STAT,1926,30,25-29,1956,11.414123829786234
SIM,1872,16,na,1888,2660
STAT,1825,47,40-44,1872,0.22019113184299238
STAT,1874,24,15-19,1898,3.414626763225658
SIM,1882,28,30-34,1910,35
SIM,1947,15,35-39,1962,5
SIM,1847,49,35-39,1896,1
SIM,1929,8,na,1937,5441
SIM,1832,51,na,1883,1435
SIM,1842,26,35-39,1868,14
STAT,1843,38,45-49,1881,1.6919577889086057
STAT,1812,47,50-100,1859,0.5812680672335524
SIM,1847,35,25-29,1882,2
SIM,1886,32,35-39,1918,22
STAT,1922,26,20-24,1948,21.148272852350043
STAT,1882,21,45-49,1903,0.695144135851409
SIM,1944,18,na,1962,4008
STAT,1899,49,40-44,1948,0.13209008890733068
SIM,1851,38,45-49,1889,4
STAT,1911,39,15-19,1950,0.01872911460441451
SIM,1913,28,35-39,1941,22
SIM,1958,4,na,1962,5144
STAT,1816,49,40-44,1865,0.34084878183510126
STAT,1909,45,45-49,1954,0.20563706471267093
STAT,1783,87,na,1870,58.71709441951158
STAT,1878,32,35-39,1910,10.753538761856444
SIM,1874,1,na,1875,3489
STAT,1916,15,40-44,1931,0.30424314110190875
STAT,1849,48,50-100,1897,0.1882783207035001
STAT,1903,60,na,1963,2941.7681021865596
SIM,1941,27,35-39,1968,34
STAT,1839,49,35-39,1888,0.0959531469833208
SIM,1911,3,na,1914,4169
SIM,1854,39,25-29,1893,3
SIM,1893,22,25-29,1915,85
STAT,1854,31,na,1885,1889.839468666132
STAT,1889,28,40-44,1917,3.7615533261231398
STAT,1839,35,25-29,1874,2.4243944817802174
STAT,1811,69,na,1880,737.6621920526843
STAT,1905,28,35-39,1933,14.166155238063181
SIM,1904,53,na,1957,3236
STAT,1857,39,35-39,1896,5.578415074453924
STAT,1933,27,35-39,1960,20.33004197851216
STAT,1823,39,30-34,1862,9.220885094844514
SIM,1796,72,na,1868,472
STAT,1854,38,20-24,1892,0.5870464903943863
STAT,1893,21,20-24,1914,89.45211114884522
SIM,1858,22,30-34,1880,19
SIM,1835,36,45-49,1871,3
STAT,1863,48,15-19,1911,3.532848649100488E-4
STAT,1935,35,45-49,1970,0.9738190580031432
STAT,1943,25,na,1968,4074.0276350473155
STAT,1890,16,20-24,1906,22.167761715523433
SIM,1897,28,40-44,1925,8
SIM,1920,18,25-29,1938,59
STAT,1867,81,na,1948,517.9073139191697
STAT,1846,25,15-19,1871,0.3982050891524884
STAT,1855,37,25-29,1892,2.2319486937622695
STAT,1885,22,25-29,1907,58.26336958975085
STAT,1837,27,15-19,1864,0.38826029584311983
STAT,1846,39,25-29,1885,2.1059572581227437
STAT,1912,18,25-29,1930,8.91580263788401
STAT,1897,28,25-29,1925,57.49757937934937
STAT,1940,29,40-44,1969,4.844059179085928
SIM,1885,66,na,1951,1694
SIM,1846,43,45-49,1889,1
STAT,1914,39,40-44,1953,1.5096300910848743
STAT,1933,20,15-19,1953,7.243849158964633
SIM,1868,64,na,1932,1666
STAT,1911,26,45-49,1937,1.7244452923804237
SIM,1850,25,30-34,1875,24
STAT,1875,27,35-39,1902,10.10253088814464
STAT,1809,45,40-44,1854,0.7874040486899329
SIM,1894,31,30-34,1925,3
STAT,1860,51,40-44,1911,0.008755578202038483
STAT,1900,19,45-49,1919,0.09186741640592369
STAT,1853,29,15-19,1882,0.39530773929858326
SIM,1915,37,35-39,1952,5
SIM,1917,45,45-49,1962,1
STAT,1886,63,na,1949,1926.7133181864087
STAT,1919,36,15-19,1955,0.021071811020915654
SIM,1919,20,40-44,1939,4
STAT,1904,49,25-29,1953,0.04651241543143192
STAT,1861,28,45-49,1889,0.9359812031732913
SIM,1900,23,30-34,1923,30
STAT,1858,18,45-49,1876,0.06136802619659
STAT,1952,20,25-29,1972,113.36980573535213
SIM,1921,23,na,1944,4692
STAT,1886,28,15-19,1914,0.48818899727291876
SIM,1849,82,na,1931,509
STAT,1869,34,35-39,1903,9.888837304228097
SIM,1877,22,40-44,1899,1
SIM,1879,38,25-29,1917,5
STAT,1800,84,na,1884,135.24166198771758
SIM,1877,34,35-39,1911,18
STAT,1843,37,40-44,1880,4.125445117730067
STAT,1857,48,50-100,1905,0.1932155068483904
SIM,1861,31,na,1892,2517
SIM,1884,37,45-49,1921,6
SIM,1838,37,25-29,1875,6
STAT,1838,43,45-49,1881,1.1553850599091589
SIM,1942,19,15-19,1961,71
STAT,1827,36,45-49,1863,2.658029426677045
STAT,1874,28,30-34,1902,26.136181826306025
STAT,1878,44,na,1922,2421.0885868430823
SIM,1864,38,30-34,1902,7
STAT,1859,20,30-34,1879,16.785920174337868
STAT,1894,27,45-49,1921,1.4569599758966252
STAT,1892,38,40-44,1930,5.569147588834113
SIM,1831,25,20-24,1856,11
SIM,1827,40,30-34,1867,2
SIM,1831,39,30-34,1870,7
STAT,1863,17,15-19,1880,6.05712030330567
SIM,1929,24,30-34,1953,49
SIM,1865,37,35-39,1902,10
SIM,1883,27,35-39,1910,17
SIM,1911,23,na,1934,3722
SIM,1817,45,40-44,1862,1
STAT,1917,32,25-29,1949,9.876822124013724
STAT,1919,40,35-39,1959,0.2233023460452914
STAT,1839,48,30-34,1887,0.06720020593423016
STAT,1865,25,25-29,1890,39.43272710501737
SIM,1941,20,15-19,1961,8
STAT,1882,48,25-29,1930,0.05652799036190023
STAT,1857,35,50-100,1892,0.9874556133443448
STAT,1846,12,na,1858,2144.5445268635603
SIM,1910,26,50-100,1936,1
STAT,1842,39,40-44,1881,3.5892521894221643
STAT,1890,17,25-29,1907,7.068319269101842
STAT,1842,25,30-34,1867,24.77556011655588
STAT,1899,49,50-100,1948,0.18949372553708022
STAT,1932,40,na,1972,5147.593014669829
STAT,1862,48,50-100,1910,0.21059918898505975
SIM,1882,29,35-39,1911,15
SIM,1932,34,30-34,1966,30
STAT,1907,41,na,1948,3489.650724203215
SIM,1831,26,25-29,1857,47
SIM,1902,27,20-24,1929,24
SIM,1930,26,20-24,1956,31
SIM,1874,81,na,1955,461
SIM,1845,31,35-39,1876,14
SIM,1851,37,40-44,1888,7
STAT,1875,15,40-44,1890,0.19239119453941061
STAT,1876,36,40-44,1912,4.633584963718832
SIM,1879,42,45-49,1921,6
STAT,1908,46,40-44,1954,0.14649286310940962
STAT,1923,25,25-29,1948,77.62642451740787
SIM,1850,39,40-44,1889,4
STAT,1939,15,35-39,1954,4.295352579759516
STAT,1785,101,na,1886,0.1421929200816151
STAT,1871,23,35-39,1894,5.87867493037096
STAT,1874,29,35-39,1903,9.978126877009096
SIM,1919,19,na,1938,4216
SIM,1860,20,20-24,1880,59
STAT,1871,11,na,1882,2680.2365133365347
STAT,1907,37,35-39,1944,2.2867161149440474
STAT,1924,34,30-34,1958,18.72923494852273
SIM,1884,36,40-44,1920,6
STAT,1848,37,50-100,1885,0.983492009436961
SIM,1836,32,na,1868,2031
SIM,1867,39,45-49,1906,3
STAT,1848,34,15-19,1882,0.11506084084400235
STAT,1849,43,20-24,1892,0.12240550694163009
STAT,1841,16,25-29,1857,5.4282906713104415
SIM,1873,25,25-29,1898,43
SIM,1902,63,na,1965,2747
STAT,1833,69,na,1902,963.7294358408841
SIM,1892,39,45-49,1931,5
STAT,1841,98,na,1939,2.398569047156095
STAT,1852,23,25-29,1875,54.391670015280425
STAT,1827,39,15-19,1866,0.06920948098147395
STAT,1891,26,30-34,1917,31.913832769143898
STAT,1832,22,45-49,1854,1.1496324058988074
STAT,1907,30,15-19,1937,0.12346748774983589
STAT,1944,8,na,1952,4335.563430184418
STAT,1905,34,20-24,1939,2.2671943870021933
SIM,1822,51,na,1873,1312
SIM,1914,25,25-29,1939,82
SIM,1839,49,35-39,1888,1
SIM,1912,29,30-34,1941,61
STAT,1819,40,30-34,1859,2.628872990074423
SIM,1875,25,35-39,1900,11
STAT,1846,107,na,1953,0.003372481178987403
SIM,1838,45,na,1883,1577
STAT,1931,18,35-39,1949,5.586731341805068
STAT,1861,24,50-100,1885,0.3480991775179891
STAT,1925,26,50-100,1951,1.2035421688371175
SIM,1901,18,15-19,1919,13
STAT,1833,79,na,1912,459.0994145596693
SIM,1843,35,40-44,1878,8
SIM,1854,38,20-24,1892,2
STAT,1941,26,30-34,1967,41.37089609559494
SIM,1787,90,na,1877,19
STAT,1921,29,30-34,1950,44.243105525170904
SIM,1904,36,20-24,1940,1
STAT,1906,25,25-29,1931,63.23721570757637
SIM,1854,61,na,1915,1614
STAT,1838,39,25-29,1877,2.50020450707716
SIM,1834,37,40-44,1871,2
STAT,1809,108,na,1917,9.345291505992251E-4
STAT,1885,14,na,1899,2619.913817988837
STAT,1839,15,30-34,1854,1.4560626937991377
STAT,1835,35,40-44,1870,4.118558768798805
STAT,1936,20,40-44,1956,3.2809454242787566
SIM,1838,41,45-49,1879,5
SIM,1875,39,45-49,1914,4
STAT,1845,27,15-19,1872,0.4314886471835766
STAT,1873,36,15-19,1909,0.05835736384879153
SIM,1932,18,na,1950,5096
SIM,1848,27,40-44,1875,4
STAT,1873,38,30-34,1911,5.4847735144337335
SIM,1860,23,25-29,1883,66
STAT,1886,31,30-34,1917,18.93026028645021
STAT,1862,27,15-19,1889,0.39544775169693785
STAT,1910,30,na,1940,3749.2293150301484
STAT,1856,15,30-34,1871,1.5271686144642154
STAT,1926,37,45-49,1963,0.8499439954613782
STAT,1937,18,na,1955,3642.9046520488914
SIM,1915,30,15-19,1945,1
SIM,1887,44,45-49,1931,3
STAT,1869,22,40-44,1891,2.0523608948950502
SIM,1807,84,na,1891,41
STAT,1915,23,25-29,1938,97.13234885156595
SIM,1907,35,35-39,1942,5
STAT,1930,39,25-29,1969,1.3070753006773086
SIM,1859,21,35-39,1880,9
STAT,1842,26,35-39,1868,9.425070209548291
STAT,1875,20,15-19,1895,3.4747225158745363
STAT,1900,19,na,1919,3551.929159147575
STAT,1911,19,20-24,1930,27.525068927631153
STAT,1887,37,20-24,1924,0.8811831001137751
STAT,1841,20,45-49,1861,0.6617047829325345
STAT,1856,29,40-44,1885,2.4501987170319603
STAT,1934,36,40-44,1970,2.108620813564549
STAT,1955,16,30-34,1971,16.508050872315017
STAT,1899,19,45-49,1918,0.0907641858975395
STAT,1847,17,30-34,1864,1.551286748062483
SIM,1865,36,30-34,1901,12
SIM,1872,26,na,1898,2445
STAT,1817,37,50-100,1854,4.342392641375497
SIM,1814,47,30-34,1861,1
STAT,1858,49,45-49,1907,0.1869394248266924
STAT,1817,47,40-44,1864,0.38251224302491726
STAT,1870,35,50-100,1905,1.2360101651225253
STAT,1904,29,30-34,1933,36.55445289218533
STAT,1893,48,50-100,1941,0.17703678727014033
SIM,1853,12,na,1865,2377
STAT,1826,30,20-24,1856,3.4887087838968087
STAT,1879,44,45-49,1923,1.574407414216476
SIM,1895,37,20-24,1932,5
STAT,1950,9,na,1959,4740.270941621668
SIM,1850,26,35-39,1876,14
SIM,1794,91,na,1885,1
SIM,1864,29,40-44,1893,4
STAT,1884,38,40-44,1922,4.396223516921864
STAT,1917,51,na,1968,3866.048204260188
SIM,1864,15,30-34,1879,2
SIM,1935,36,na,1971,5395
STAT,1814,87,na,1901,82.09799029045489
STAT,1878,31,50-100,1909,0.9769016187686765
STAT,1878,28,15-19,1906,0.4800733092795764
SIM,1934,37,45-49,1971,1
STAT,1920,17,20-24,1937,155.22537328538633
SIM,1822,42,50-100,1864,1
STAT,1845,30,30-34,1875,16.56089351084345
STAT,1840,17,na,1857,2138.6254915841723
STAT,1851,37,40-44,1888,3.650191041583291
STAT,1830,72,na,1902,798.8973965224505
SIM,1923,23,25-29,1946,111
STAT,1931,24,20-24,1955,146.16020154691503
STAT,1864,43,50-100,1907,0.9513663560396205
SIM,1875,38,40-44,1913,9
STAT,1866,22,15-19,1888,3.1296300396123633
SIM,1892,38,40-44,1930,8
STAT,1817,48,45-49,1865,0.5191695525270263
SIM,1881,38,30-34,1919,7
STAT,1916,35,35-39,1951,2.5516729140721335
SIM,1854,83,na,1937,341
STAT,1832,37,30-34,1869,4.526145180896138
STAT,1883,27,35-39,1910,9.658243873352264
SIM,1944,20,40-44,1964,4
STAT,1841,47,25-29,1888,0.04272191451461103
STAT,1889,35,15-19,1924,0.07143485628880203
SIM,1900,26,35-39,1926,25
STAT,1914,24,20-24,1938,115.18155334356004
SIM,1891,27,35-39,1918,19
STAT,1822,47,15-19,1869,5.703417125769444E-4
SIM,1922,24,20-24,1946,123
SIM,1875,31,20-24,1906,2
SIM,1927,20,40-44,1947,9
STAT,1860,5,na,1865,2400.4394385462506
SIM,1874,22,15-19,1896,3
SIM,1912,41,na,1953,3730
SIM,1829,27,30-34,1856,25
STAT,1900,40,40-44,1940,0.22307939611071226
SIM,1840,37,30-34,1877,7
SIM,1917,30,25-29,1947,3
STAT,1872,15,15-19,1887,6.159970237185367
SIM,1908,20,30-34,1928,46
STAT,1947,17,35-39,1964,4.8226306919846476
SIM,1828,43,50-100,1871,2
STAT,1867,38,40-44,1905,4.1716785836804835
STAT,1828,43,50-100,1871,0.8499363660686399
SIM,1824,36,35-39,1860,5
STAT,1847,37,25-29,1884,2.3295316496346015
STAT,1840,49,na,1889,1591.3111787635937
STAT,1951,0,na,1951,5332.421380665112
SIM,1874,26,30-34,1900,37
STAT,1915,36,30-34,1951,1.8878556299636735
SIM,1910,21,25-29,1931,104
SIM,1924,35,35-39,1959,1
SIM,1893,63,na,1956,2362
STAT,1884,39,45-49,1923,1.991741673137146
SIM,1831,32,45-49,1863,1
SIM,1903,18,25-29,1921,15
STAT,1873,5,na,1878,2857.8818011834737
SIM,1891,26,30-34,1917,39
SIM,1853,30,30-34,1883,31
STAT,1897,32,45-49,1929,2.3786372735429686
STAT,1858,104,na,1962,0.18904151508858053
SIM,1819,41,35-39,1860,4
STAT,1836,30,50-100,1866,0.7360512158621821
STAT,1831,25,20-24,1856,12.588867442359067
STAT,1890,23,45-49,1913,0.867107234829998
SIM,1823,37,30-34,1860,7
STAT,1855,32,50-100,1887,0.7232034046406255
STAT,1867,39,45-49,1906,1.890009925579914
SIM,1896,18,30-34,1914,2
SIM,1905,38,na,1943,3403
SIM,1880,15,15-19,1895,8
STAT,1846,38,20-24,1884,0.5697141274426238
SIM,1859,34,40-44,1893,1
STAT,1834,97,na,1931,3.6102410483611793
STAT,1856,27,25-29,1883,35.10238623223986
STAT,1783,103,na,1886,0.0566240934477944
STAT,1877,20,50-100,1897,0.4340517472880606
SIM,1934,30,25-29,1964,16
SIM,1885,20,25-29,1905,67
STAT,1868,37,45-49,1905,1.9423883589394333
SIM,1904,23,15-19,1927,6
STAT,1774,113,na,1887,3.4616187844518145E-4
SIM,1808,47,40-44,1855,1
STAT,1871,17,15-19,1888,6.035740626677202
STAT,1888,18,30-34,1906,1.9172024835953587
STAT,1909,38,20-24,1947,0.25321069375705874
STAT,1882,28,30-34,1910,24.93960908264896
STAT,1919,20,40-44,1939,3.7796188707021177
SIM,1876,37,45-49,1913,4
SIM,1885,44,na,1929,2302
SIM,1890,28,30-34,1918,48
STAT,1823,32,45-49,1855,4.44290764467054
SIM,1917,38,20-24,1955,2
SIM,1923,36,30-34,1959,1
STAT,1902,21,25-29,1923,82.60478203755345
STAT,1857,32,15-19,1889,0.11415935370514348
SIM,1889,37,na,1926,3112
SIM,1839,22,20-24,1861,74
STAT,1878,44,50-100,1922,1.1066630344137698
STAT,1918,36,na,1954,4066.123313441669
SIM,1857,27,na,1884,2098
SIM,1864,27,25-29,1891,59
STAT,1928,0,na,1928,5790.236597798439
STAT,1816,38,35-39,1854,21.656887861197966
STAT,1849,30,na,1879,1989.246304241442
SIM,1884,39,45-49,1923,4
SIM,1939,22,25-29,1961,111
SIM,1872,27,25-29,1899,58
STAT,1856,31,45-49,1887,1.4283106729971358
STAT,1857,36,30-34,1893,4.266612377148601
SIM,1799,90,na,1889,46
SIM,1883,33,20-24,1916,2
STAT,1872,29,25-29,1901,42.94110953966401
SIM,1908,44,40-44,1952,3
STAT,1909,30,25-29,1939,9.067518548980098
SIM,1869,32,35-39,1901,16
STAT,1889,26,25-29,1915,53.488797706367045
STAT,1933,15,40-44,1948,1.9183635999596642
SIM,1912,25,15-19,1937,1
STAT,1907,34,30-34,1941,14.888303009512319
STAT,1833,23,15-19,1856,3.1150934313006644
SIM,1797,57,na,1854,1035
SIM,1886,26,15-19,1912,4
STAT,1808,47,40-44,1855,0.45395160840363213
STAT,1923,29,40-44,1952,5.42102786834202
SIM,1867,36,40-44,1903,4
STAT,1829,25,15-19,1854,1.420006920067155
STAT,1917,47,45-49,1964,0.231663750374658
STAT,1917,20,30-34,1937,31.358564222443203
STAT,1819,64,na,1883,1082.0971153815233
STAT,1859,32,25-29,1891,8.344803006486702
STAT,1864,27,25-29,1891,38.37087064103882
STAT,1927,18,na,1945,4656.2316045820335
STAT,1854,27,15-19,1881,0.364024217411754
SIM,1869,59,na,1928,1957
SIM,1838,39,40-44,1877,6
STAT,1878,26,15-19,1904,0.4834224413901054
SIM,1910,29,20-24,1939,19
SIM,1930,37,na,1967,5463
STAT,1846,36,20-24,1882,0.5816693468524288
STAT,1936,16,20-24,1952,132.7129601420749
STAT,1871,96,na,1967,36.8388815716557
STAT,1875,33,20-24,1908,2.81818815167344
SIM,1841,23,15-19,1864,4
SIM,1929,40,na,1969,5124
SIM,1808,47,na,1855,1497
SIM,1860,79,na,1939,666
STAT,1902,29,20-24,1931,16.75677369329432
STAT,1924,37,35-39,1961,2.9098979531134264
STAT,1831,27,20-24,1858,11.608705469053346
STAT,1832,32,50-100,1864,0.8036299919165752
STAT,1840,39,30-34,1879,4.442817257427637
STAT,1871,20,30-34,1891,18.107147592186816
STAT,1928,20,40-44,1948,4.307659031585997
SIM,1915,34,30-34,1949,25
STAT,1903,38,50-100,1941,0.3823839144617409
STAT,1932,36,30-34,1968,2.4996235171754697
SIM,1834,33,25-29,1867,15
STAT,1893,15,35-39,1908,0.7134092718675953
STAT,1840,50,na,1890,1571.6807989334422
SIM,1864,31,45-49,1895,3
SIM,1944,16,20-24,1960,154
SIM,1859,82,na,1941,296
SIM,1933,20,15-19,1953,10
SIM,1941,24,30-34,1965,30
STAT,1876,39,45-49,1915,2.078861932398541
SIM,1934,17,15-19,1951,60
STAT,1865,39,35-39,1904,6.482926860885722
STAT,1888,47,15-19,1935,4.8015866531371076E-4
SIM,1932,5,na,1937,5593
STAT,1953,19,25-29,1972,53.43831081693675
STAT,1941,22,15-19,1963,5.612257913181332
SIM,1863,12,na,1875,2409
SIM,1834,24,35-39,1858,8
SIM,1880,29,25-29,1909,52
SIM,1814,54,na,1868,1192
STAT,1937,5,na,1942,3989.8754452032854
SIM,1824,38,35-39,1862,6
STAT,1863,67,na,1930,1417.9008204650797
SIM,1881,20,40-44,1901,3
SIM,1925,20,30-34,1945,50
STAT,1841,18,40-44,1859,0.17314922252301546
STAT,1861,25,40-44,1886,2.5804330905091484
STAT,1880,15,na,1895,2720.10411556429
SIM,1891,29,35-39,1920,20
SIM,1846,64,na,1910,1306
STAT,1833,49,40-44,1882,0.11765678929940776
SIM,1937,26,30-34,1963,73
STAT,1850,27,na,1877,1914.9156335131668
SIM,1883,6,na,1889,2708
SIM,1782,91,na,1873,3
STAT,1910,19,na,1929,3882.3055369030685
SIM,1873,39,35-39,1912,7
STAT,1883,29,35-39,1912,9.589214596366164
STAT,1934,32,25-29,1966,12.869195228432524
SIM,1832,37,30-34,1869,5
SIM,1874,27,35-39,1901,13
STAT,1851,39,40-44,1890,3.5751676025350174
STAT,1904,25,15-19,1929,0.6678433168829937
SIM,1890,45,na,1935,2984
STAT,1928,32,50-100,1960,1.0545112847080178
SIM,1929,27,35-39,1956,39
STAT,1895,19,50-100,1914,0.0648590257931087
STAT,1849,37,35-39,1886,5.6188854492765765
SIM,1876,30,na,1906,2782
STAT,1897,25,20-24,1922,16.110692491905425
SIM,1936,20,40-44,1956,3
SIM,1861,53,na,1914,2259
SIM,1827,43,35-39,1870,5
STAT,1925,20,15-19,1945,6.539607127386032
STAT,1933,24,30-34,1957,38.853002886716524
STAT,1875,18,45-49,1893,0.06821416807943903
SIM,1883,38,40-44,1921,4
STAT,1842,28,35-39,1870,9.29021208632865
STAT,1926,17,15-19,1943,56.76376868794677
SIM,1873,38,30-34,1911,8
STAT,1898,20,45-49,1918,0.9677314554809836
SIM,1831,87,na,1918,136
SIM,1943,28,20-24,1971,21
STAT,1880,28,20-24,1908,12.53219403538193
SIM,1895,39,20-24,1934,2
STAT,1848,24,50-100,1872,0.380443962134537
STAT,1904,23,na,1927,3447.171975035207
SIM,1924,41,na,1965,4555
SIM,1947,21,20-24,1968,154
STAT,1900,16,40-44,1916,0.25925089633679366
SIM,1856,25,25-29,1881,49
STAT,1809,48,45-49,1857,1.0322714167047058
SIM,1850,28,35-39,1878,13
STAT,1918,35,45-49,1953,0.7402246631485597
STAT,1836,23,40-44,1859,1.699597411036984
SIM,1932,37,35-39,1969,5
STAT,1943,16,50-100,1959,0.40545425082425113
SIM,1872,26,20-24,1898,17
SIM,1936,30,35-39,1966,8
STAT,1867,38,50-100,1905,1.170015968623177
STAT,1929,26,30-34,1955,50.03848324916354
STAT,1913,36,20-24,1949,0.2666678846608886
SIM,1841,87,na,1928,74
STAT,1894,7,na,1901,3418.7958257624264
STAT,1864,26,20-24,1890,10.677910415663197
STAT,1876,63,na,1939,1879.6385244824535
STAT,1844,31,na,1875,2029.2786212029973
SIM,1911,17,20-24,1928,32
STAT,1896,16,15-19,1912,8.01557560288018
STAT,1801,69,na,1870,674.0303768431586
STAT,1826,33,25-29,1859,10.47226093704323
STAT,1935,28,20-24,1963,25.363024101709662
SIM,1786,72,na,1858,477
STAT,1903,17,20-24,1920,25.709289635174592
STAT,1908,42,25-29,1950,0.06737006318714402
STAT,1875,25,50-100,1900,0.6743086507180605
SIM,1827,72,na,1899,662
SIM,1906,23,25-29,1929,104
STAT,1804,99,na,1903,0.6390282848669016
STAT,1887,39,20-24,1926,0.872314384161373
SIM,1889,28,40-44,1917,5
SIM,1839,47,35-39,1886,1
SIM,1857,37,35-39,1894,9
STAT,1814,49,30-34,1863,0.27943870254261505
STAT,1869,31,30-34,1900,17.26649752774118
STAT,1893,24,25-29,1917,73.62042584915784
STAT,1875,38,40-44,1913,4.560558957707091
STAT,1865,38,30-34,1903,4.91019518159617
SIM,1833,46,na,1879,1609
SIM,1867,32,25-29,1899,12
STAT,1858,15,40-44,1873,0.1749028815465295
STAT,1909,22,na,1931,3617.245193174807
STAT,1865,48,25-29,1913,0.05266188406605686
STAT,1939,21,20-24,1960,113.95646153860348
SIM,1854,36,20-24,1890,3
SIM,1868,44,35-39,1912,2
SIM,1832,38,35-39,1870,16
STAT,1898,38,35-39,1936,2.0956172288290995
STAT,1928,21,45-49,1949,1.4372826877613207
STAT,1952,17,na,1969,4499.602023179437
SIM,1899,25,na,1924,3451
STAT,1846,97,na,1943,3.8418073844600658
STAT,1810,84,na,1894,141.82540769563434
STAT,1831,35,na,1866,1852.4265735037363
STAT,1832,35,15-19,1867,0.048730571297536836
STAT,1921,28,50-100,1949,1.1280075651018977
SIM,1878,74,na,1952,1170
SIM,1875,38,50-100,1913,1
STAT,1844,26,50-100,1870,0.6112150220271604
SIM,1926,35,45-49,1961,1
STAT,1911,23,40-44,1934,3.2426851448881897
SIM,1899,23,30-34,1922,41
SIM,1844,20,na,1864,2344
SIM,1931,25,25-29,1956,98
STAT,1859,23,35-39,1882,4.8972818130277265
STAT,1786,101,na,1887,0.11710320867663357
SIM,1941,15,40-44,1956,2
SIM,1918,26,20-24,1944,19
SIM,1848,37,50-100,1885,2
SIM,1931,29,40-44,1960,9
STAT,1837,31,35-39,1868,8.554097747616183
STAT,1870,29,15-19,1899,0.4492267980290737
SIM,1884,81,na,1965,666
SIM,1838,34,20-24,1872,5
SIM,1877,31,30-34,1908,33
SIM,1935,29,25-29,1964,10
STAT,1874,26,30-34,1900,26.318515490996656
SIM,1913,32,50-100,1945,1
STAT,1824,38,35-39,1862,9.442218011380596
STAT,1830,49,15-19,1879,3.234613398492454E-4
STAT,1899,16,40-44,1915,0.2561375672658975
STAT,1905,32,50-100,1937,0.7751386959616295
SIM,1902,31,na,1933,3441
STAT,1893,11,na,1904,3347.132278254287
SIM,1929,29,na,1958,4962
STAT,1917,39,50-100,1956,0.4423227111722904
STAT,1850,27,30-34,1877,22.290885186305676
STAT,1764,95,na,1859,3.955064011936476
STAT,1874,17,40-44,1891,0.1905048484122779
SIM,1878,26,15-19,1904,1
SIM,1914,22,20-24,1936,119
STAT,1829,64,na,1893,1156.1540927645553
SIM,1861,26,45-49,1887,1
STAT,1863,45,na,1908,2032.4364610629962
STAT,1900,25,30-34,1925,35.84750297069307
STAT,1944,22,40-44,1966,3.7039160528721817
SIM,1887,1,na,1888,3278
STAT,1837,25,15-19,1862,0.3938963409981231
STAT,1869,49,20-24,1918,0.011572131981182539
SIM,1850,79,na,1929,395
SIM,1894,26,na,1920,3354
SIM,1880,45,na,1925,2203
STAT,1834,32,20-24,1866,2.3300574165624406
STAT,1825,49,40-44,1874,0.21424067841513889
STAT,1905,37,25-29,1942,0.9156091175017076
STAT,1852,20,20-24,1872,66.9077782315627
STAT,1843,90,na,1933,63.64586195361411
SIM,1847,49,na,1896,1484
SIM,1852,8,na,1860,2565
STAT,1934,19,15-19,1953,62.26522186801637
SIM,1860,90,na,1950,61
SIM,1865,39,35-39,1904,7
STAT,1926,34,40-44,1960,4.821052972526913
SIM,1864,24,20-24,1888,95
SIM,1828,49,25-29,1877,1
STAT,1877,26,na,1903,2533.812380900978
STAT,1882,19,40-44,1901,0.18080824565831372
STAT,1848,25,25-29,1873,39.82508121202063
SIM,1890,17,25-29,1907,12
STAT,1891,29,35-39,1920,12.099476986500406
SIM,1841,65,na,1906,1225
SIM,1853,33,35-39,1886,4
STAT,1819,43,35-39,1862,3.796158039300189
STAT,1881,41,50-100,1922,1.046669221899173
STAT,1927,29,25-29,1956,81.29616458151806
SIM,1857,48,50-100,1905,1
STAT,1831,28,25-29,1859,40.69703519146157
SIM,1865,78,na,1943,666
SIM,1871,15,15-19,1886,7
STAT,1898,37,30-34,1935,7.352431945105301
STAT,1906,22,20-24,1928,102.3244231916
SIM,1871,31,na,1902,2217
SIM,1879,59,na,1938,2367
STAT,1819,37,15-19,1856,0.15918643838521238
SIM,1905,39,40-44,1944,2
STAT,1907,28,45-49,1935,1.6572544257583353
STAT,1865,34,15-19,1899,0.13072677260892643
SIM,1901,35,40-44,1936,2
SIM,1868,28,20-24,1896,18
SIM,1949,17,na,1966,4411
STAT,1822,101,na,1923,0.33178566721821934
SIM,1887,38,25-29,1925,2
STAT,1880,17,15-19,1897,6.362014168402375
SIM,1876,3,na,1879,3430
SIM,1882,26,30-34,1908,34
STAT,1864,0,na,1864,3469.823883957394
STAT,1863,9,na,1872,2486.640347402813
STAT,1867,36,40-44,1903,4.212651853383174
STAT,1914,15,30-34,1929,2.584453524858269
STAT,1780,80,na,1860,223.67315418495394
SIM,1913,37,25-29,1950,1
STAT,1830,50,na,1880,1470.6595124378475
STAT,1860,16,35-39,1876,0.5269121456533458
SIM,1871,21,35-39,1892,6
SIM,1875,36,40-44,1911,5
SIM,1922,15,30-34,1937,22
SIM,1917,21,35-39,1938,12
SIM,1915,28,45-49,1943,3
STAT,1815,83,na,1898,205.27222540347614
STAT,1860,22,20-24,1882,58.799940141954465
STAT,1853,26,45-49,1879,1.0863073728969408
STAT,1936,23,45-49,1959,1.0968094302358127
STAT,1909,21,35-39,1930,8.952074035918953
SIM,1844,83,na,1927,198
SIM,1812,73,na,1885,428
SIM,1849,35,35-39,1884,11
STAT,1879,38,25-29,1917,3.055017888555133
STAT,1838,36,20-24,1874,0.6905611768804036
STAT,1847,48,30-34,1895,0.07453741685091342
SIM,1875,34,25-29,1909,15
SIM,1833,21,15-19,1854,5
STAT,1848,27,40-44,1875,2.779849843990511
STAT,1925,16,45-49,1941,0.6171734757277209
STAT,1841,13,na,1854,2263.0
STAT,1862,29,15-19,1891,0.3911793421296571
STAT,1811,47,na,1858,1304.4113441163452
SIM,1898,62,na,1960,2929
STAT,1913,59,na,1972,3439.856992997684
STAT,1824,37,30-34,1861,7.371045453052782
STAT,1906,49,35-39,1955,0.1148124173346073
STAT,1931,27,25-29,1958,86.66431535370506
SIM,1944,23,45-49,1967,2
STAT,1877,24,40-44,1901,2.191046145959804
STAT,1898,25,50-100,1923,0.8884762811716466
STAT,1863,21,35-39,1884,5.362074999973912
STAT,1886,34,35-39,1920,10.841704508898511
SIM,1945,24,15-19,1969,7
SIM,1885,24,40-44,1909,6
STAT,1906,16,35-39,1922,0.8167494714112282
SIM,1894,34,35-39,1928,15
STAT,1850,49,na,1899,1657.0063081651165
STAT,1928,36,na,1964,4854.232438927599
STAT,1867,31,20-24,1898,2.599384566412368
SIM,1859,30,25-29,1889,4
STAT,1856,18,35-39,1874,0.5165112312759365
STAT,1857,8,na,1865,2299.5157928722183
STAT,1809,98,na,1907,1.6573769285145097
STAT,1841,110,na,1951,2.0403496329365816E-4
STAT,1845,33,35-39,1878,9.311109034653699
STAT,1838,37,25-29,1875,2.5526702824751912
SIM,1914,16,35-39,1930,1
STAT,1824,87,na,1911,97.0078372609075
SIM,1931,22,50-100,1953,1
SIM,1864,18,35-39,1882,2
STAT,1891,28,30-34,1919,31.69273496121045
SIM,1859,60,na,1919,1728
SIM,1880,67,na,1947,1486
STAT,1846,53,50-100,1899,0.010626894402754375
SIM,1934,34,40-44,1968,10
SIM,1870,29,15-19,1899,1
SIM,1917,20,30-34,1937,43
STAT,1899,21,15-19,1920,4.62255047950377
SIM,1910,60,na,1970,3224
STAT,1921,38,20-24,1959,0.30005343597976436
SIM,1911,45,na,1956,3588
SIM,1868,96,na,1964,6
SIM,1842,32,20-24,1874,2
STAT,1857,37,35-39,1894,5.635130152937344
STAT,1865,26,na,1891,2217.271689883347
SIM,1898,38,35-39,1936,2
SIM,1935,20,50-100,1955,1
STAT,1930,15,15-19,1945,60.11993742114349
STAT,1873,54,50-100,1927,0.015190472330945275
STAT,1823,53,50-100,1876,0.021428418524783183
STAT,1864,33,45-49,1897,1.5751151110021975
STAT,1946,22,50-100,1968,0.7470637090686636
SIM,1827,50,na,1877,1381
STAT,1834,26,35-39,1860,8.576113191826968
STAT,1915,32,15-19,1947,0.13355278094093073
STAT,1856,24,20-24,1880,63.17557496079189
STAT,1879,37,20-24,1916,0.821998566369934
SIM,1895,44,na,1939,3163
SIM,1869,20,40-44,1889,1
SIM,1879,37,na,1916,2893
STAT,1908,29,15-19,1937,0.6756524243979065
STAT,1862,82,na,1944,405.1801976694093
SIM,1847,27,na,1874,1799
STAT,1937,24,15-19,1961,5.283945058967792
STAT,1782,103,na,1885,0.05177535037625468
STAT,1821,39,20-24,1860,1.485794705005068
STAT,1761,106,na,1867,0.005854753860878532
SIM,1846,37,25-29,1883,3
STAT,1872,28,20-24,1900,11.952362726403358
STAT,1828,48,20-24,1876,0.009262409524180178
STAT,1829,42,na,1871,1735.0828669050309
SIM,1904,27,30-34,1931,3
STAT,1844,21,25-29,1865,55.787248356801555
STAT,1867,34,25-29,1901,9.725680498490917
STAT,1909,20,30-34,1929,27.40570733521554
STAT,1835,38,45-49,1873,1.8180398331633019
STAT,1960,5,na,1965,5222.177027577573
SIM,1843,38,45-49,1881,1
SIM,1907,19,na,1926,3797
STAT,1903,24,45-49,1927,1.0049006157397053
SIM,1852,21,25-29,1873,111
STAT,1882,59,na,1941,1931.5639813130667
STAT,1895,39,20-24,1934,1.015681989615933
STAT,1925,22,30-34,1947,35.09960435328962
STAT,1847,46,15-19,1893,3.1281055579886283E-4
SIM,1897,26,25-29,1923,79
STAT,1850,28,35-39,1878,8.479855023480154
SIM,1880,28,20-24,1908,16
SIM,1916,29,15-19,1945,3
STAT,1872,26,20-24,1898,12.035745911908421
STAT,1824,32,25-29,1856,20.52538004982115
STAT,1833,91,na,1924,38.054082288040576
STAT,1893,26,40-44,1919,3.890002236553806
STAT,1939,23,20-24,1962,113.88126268384663
STAT,1834,54,30-34,1888,0.003947856971194974
STAT,1884,20,30-34,1904,18.084892434859643
SIM,1783,76,na,1859,316
SIM,1855,27,25-29,1882,34
SIM,1821,67,na,1888,810
STAT,1919,25,45-49,1944,1.9178041597221431
STAT,1835,46,45-49,1881,0.1878115613465568
STAT,1838,47,25-29,1885,0.043540399530441365
STAT,1829,86,na,1915,147.566264842587
STAT,1852,43,40-44,1895,1.798930672051032
STAT,1855,44,20-24,1899,0.12144981350063126
STAT,1870,48,50-100,1918,0.24185019285584003
STAT,1878,49,20-24,1927,0.012476284995894918
SIM,1902,19,na,1921,3647
STAT,1868,50,40-44,1918,0.010405206812779443
STAT,1931,8,na,1939,5324.104950886665
STAT,1936,22,40-44,1958,3.2786819617123215
STAT,1875,48,40-44,1923,0.17699596381423754
SIM,1872,34,20-24,1906,3
SIM,1883,22,30-34,1905,28
STAT,1876,29,45-49,1905,1.1612663987236842
STAT,1916,30,15-19,1946,0.13647725471913405
STAT,1881,54,50-100,1935,0.014485884117297048
STAT,1841,31,15-19,1872,0.12890640368833212
SIM,1944,22,40-44,1966,4
STAT,1827,33,50-100,1860,1.3464256323652464
STAT,1889,42,25-29,1931,0.8082138248557438
SIM,1823,34,25-29,1857,16
SIM,1853,17,20-24,1870,24
STAT,1885,77,na,1962,1103.2777504785288
STAT,1898,35,30-34,1933,7.422258882207505
STAT,1845,17,20-24,1862,17.507887910940415
STAT,1891,23,25-29,1914,72.07767910637303
SIM,1837,36,20-24,1873,1
STAT,1826,35,40-44,1861,4.102460308233963
SIM,1950,20,15-19,1970,5
SIM,1813,48,na,1861,1377
SIM,1857,35,35-39,1892,11
STAT,1868,52,35-39,1920,0.00834373050260694
SIM,1840,31,20-24,1871,3
SIM,1852,26,45-49,1878,1
SIM,1892,28,40-44,1920,5
STAT,1858,33,35-39,1891,8.158300146448466
SIM,1890,25,25-29,1915,62
STAT,1850,37,25-29,1887,2.2000418163854016
STAT,1893,39,45-49,1932,2.5538985896032274
STAT,1806,49,30-34,1855,0.3264015272532903
SIM,1883,11,na,1894,2655
SIM,1909,41,na,1950,3366
SIM,1927,25,45-49,1952,2
STAT,1870,31,40-44,1901,4.342519649776913
STAT,1842,16,40-44,1858,0.18527865266949217
SIM,1947,23,20-24,1970,170
STAT,1849,35,35-39,1884,5.736795476690153
STAT,1866,32,30-34,1898,16.42907348081012
STAT,1884,28,40-44,1912,3.012728297971072
STAT,1829,49,25-29,1878,0.04542923913310797
STAT,1873,34,15-19,1907,0.14602408122598526
STAT,1855,31,50-100,1886,0.7307520735605056
STAT,1912,45,30-34,1957,0.08780860486665458
STAT,1919,48,50-100,1967,0.24964878496605303
SIM,1839,44,30-34,1883,2
SIM,1832,32,25-29,1864,16
STAT,1843,52,30-34,1895,0.0047797513014640304
STAT,1874,5,na,1879,2868.162437722725
STAT,1846,46,20-24,1892,0.008605825870305431
STAT,1844,44,45-49,1888,1.1577426580355992
STAT,1911,35,na,1946,3741.7999870145723
SIM,1928,24,na,1952,4722
STAT,1867,44,50-100,1911,0.9981401057413645
STAT,1943,6,na,1949,4298.988991212715
STAT,1815,41,15-19,1856,0.046145004027966514
STAT,1819,50,45-49,1869,0.02877340819553273
STAT,1960,4,na,1964,5223.273915099745
SIM,1834,48,45-49,1882,1
SIM,1853,76,na,1929,748
STAT,1886,41,45-49,1927,1.623402600452668
SIM,1880,78,na,1958,658
STAT,1847,27,25-29,1874,39.64892888124271
SIM,1885,43,45-49,1928,4
STAT,1824,55,na,1879,1246.222851975486
SIM,1800,73,na,1873,481
STAT,1824,47,25-29,1871,0.06712871538626244
SIM,1938,25,20-24,1963,20
SIM,1866,38,40-44,1904,11
SIM,1846,29,25-29,1875,7
STAT,1798,85,na,1883,110.19184056730509
STAT,1877,43,45-49,1920,1.5721345807728015
STAT,1895,8,na,1903,3460.0244966765995
SIM,1862,21,50-100,1883,1
SIM,1892,46,40-44,1938,1
STAT,1817,37,40-44,1854,15.482751406611055
STAT,1885,27,45-49,1912,1.1300429731617474
STAT,1910,45,50-100,1955,0.2162416096217388
STAT,1883,66,na,1949,1640.5925056909389
SIM,1823,46,na,1869,1511
SIM,1870,68,na,1938,1575
STAT,1832,31,20-24,1863,2.3971104521505837
STAT,1829,54,20-24,1883,5.048968784323915E-4
STAT,1942,20,15-19,1962,5.69822861573302
SIM,1865,34,30-34,1899,28
STAT,1835,28,45-49,1863,1.0708593043630306
STAT,1876,51,30-34,1927,0.006300592939879936
SIM,1860,42,30-34,1902,3
STAT,1861,36,45-49,1897,1.688534060118591
STAT,1833,30,25-29,1863,8.940784001623767
STAT,1851,29,40-44,1880,2.8522532308339925
STAT,1849,40,30-34,1889,0.9081564899640943
STAT,1901,20,50-100,1921,0.5852163276597292
SIM,1879,46,25-29,1925,1
SIM,1881,17,25-29,1898,5
SIM,1947,18,25-29,1965,97
STAT,1878,50,50-100,1928,0.016267482930515654
SIM,1837,29,30-34,1866,29
STAT,1886,18,20-24,1904,19.093326819668814
STAT,1835,47,50-100,1882,0.19296325762335712
SIM,1920,22,50-100,1942,1
STAT,1880,53,45-49,1933,0.015307941438532242
SIM,1889,36,40-44,1925,12
STAT,1859,54,35-39,1913,0.006821050907814
STAT,1886,19,na,1905,2712.5547542166396
SIM,1843,28,45-49,1871,3
SIM,1866,33,35-39,1899,15
SIM,1893,27,45-49,1920,2
SIM,1825,37,40-44,1862,5
STAT,1873,17,25-29,1890,5.860811531479658
SIM,1868,10,na,1878,2710
STAT,1877,50,35-39,1927,0.009240026642176827
SIM,1892,20,30-34,1912,35
STAT,1786,84,na,1870,89.96659373073057
STAT,1849,48,40-44,1897,0.13124286859926512
STAT,1832,39,30-34,1871,4.4290044084962
STAT,1852,25,40-44,1877,2.8515915896901687
STAT,1898,28,40-44,1926,4.117990905905221
SIM,1867,54,35-39,1921,1
STAT,1807,63,na,1870,1060.1633179720973
STAT,1865,29,40-44,1894,2.7537776458206897
SIM,1909,21,na,1930,3484
STAT,1875,47,na,1922,2344.6253007151363
STAT,1870,33,35-39,1903,10.056725931301486
SIM,1802,84,na,1886,172
STAT,1882,25,25-29,1907,42.327631403005505
STAT,1818,36,45-49,1854,8.368837260915933
STAT,1882,30,20-24,1912,2.7081019758948246
SIM,1840,39,30-34,1879,10
STAT,1892,15,40-44,1907,0.2349393938590299
STAT,1855,39,25-29,1894,2.2094851229303325
STAT,1827,51,35-39,1878,0.00951505914421586
STAT,1816,68,na,1884,775.1486742008888
STAT,1867,49,45-49,1916,0.22130546045409002
STAT,1835,51,40-44,1886,0.008157021255022158
STAT,1856,42,50-100,1898,0.8449687917113151
STAT,1858,99,na,1957,2.1159209792842604
STAT,1884,46,40-44,1930,0.17327976385610977
STAT,1829,36,20-24,1865,0.6833478675994026
STAT,1767,93,na,1860,4.377927175698918
STAT,1884,36,50-100,1920,1.2451034707017394
STAT,1863,46,50-100,1909,0.220301047482567
STAT,1796,74,na,1870,453.5683624870816
SIM,1862,49,na,1911,1971
STAT,1894,42,35-39,1936,0.1648038590281658
STAT,1894,38,na,1932,3076.2220257273375
STAT,1896,27,20-24,1923,15.80641133792178
SIM,1853,40,45-49,1893,3
SIM,1910,38,na,1948,3597
SIM,1919,30,35-39,1949,16
SIM,1839,37,40-44,1876,8
SIM,1890,30,20-24,1920,5
STAT,1925,39,50-100,1964,0.5130267674485872
SIM,1826,36,45-49,1862,3
SIM,1873,33,25-29,1906,16
STAT,1812,54,na,1866,1243.6799394689915
STAT,1815,82,na,1897,241.25831578613614
STAT,1890,24,na,1914,2931.5447129209547
STAT,1771,115,na,1886,1.7300018743816392E-4
STAT,1849,28,45-49,1877,1.0144781961158755
SIM,1910,2,na,1912,4098
STAT,1885,42,40-44,1927,2.2864467924554983
STAT,1918,37,50-100,1955,0.45159851535072576
SIM,1820,93,na,1913,19
STAT,1834,24,35-39,1858,5.17689629896716
STAT,1843,27,40-44,1870,2.9760735470899675
SIM,1814,85,na,1899,185
STAT,1891,30,15-19,1921,0.1813063435711594
STAT,1923,36,na,1959,4451.778398983679
STAT,1838,52,20-24,1890,5.393015133455918E-4
STAT,1866,27,50-100,1893,0.6019314641654732
STAT,1956,15,20-24,1971,183.0635358816331
STAT,1810,50,25-29,1860,0.011042289720477078
STAT,1850,52,20-24,1902,5.521116228883002E-4
STAT,1929,43,50-100,1972,0.15492905202185028
STAT,1801,90,na,1891,28.13017121151079
STAT,1834,21,30-34,1855,16.14733715165334
SIM,1888,26,25-29,1914,85
STAT,1840,32,50-100,1872,0.803057435775856
STAT,1860,27,40-44,1887,2.506037690951714
SIM,1822,35,20-24,1857,1
STAT,1874,30,15-19,1904,0.14951866942497377
SIM,1847,39,40-44,1886,1
STAT,1848,41,25-29,1889,0.50498380953703
STAT,1852,82,na,1934,375.8795704246368
SIM,1873,96,na,1969,16
STAT,1942,19,na,1961,3921.771311350334
SIM,1849,46,40-44,1895,1
SIM,1842,21,30-34,1863,29
SIM,1951,20,na,1971,4929
SIM,1878,37,20-24,1915,1
STAT,1871,30,45-49,1901,1.7763398917273956
SIM,1872,19,25-29,1891,11
STAT,1864,19,25-29,1883,5.254957035177922
SIM,1873,30,20-24,1903,5
STAT,1888,43,20-24,1931,0.19014814229401644
STAT,1817,38,50-100,1855,4.0219339371409
STAT,1820,73,na,1893,654.1601417212707
STAT,1844,51,35-39,1895,0.006703177418675367
SIM,1906,17,25-29,1923,12
STAT,1930,38,na,1968,4999.954320862518
STAT,1821,90,na,1911,41.54418930672268
SIM,1945,20,35-39,1965,15
SIM,1847,43,25-29,1890,1
STAT,1874,52,50-100,1926,0.015646706515522517
STAT,1885,47,50-100,1932,0.2488011149822556
SIM,1968,0,na,1968,5244
STAT,1834,47,40-44,1881,0.12218323523195646
STAT,1915,17,na,1932,4124.980998886656
SIM,1829,31,na,1860,1602
SIM,1870,32,45-49,1902,7
STAT,1881,29,25-29,1910,41.422748183740204
SIM,1847,7,na,1854,2221
SIM,1857,28,45-49,1885,1
SIM,1898,36,35-39,1934,16
STAT,1820,35,45-49,1855,5.421099420582498
STAT,1856,44,na,1900,1825.865904878158
STAT,1859,47,45-49,1906,0.191376345933633
STAT,1903,37,50-100,1940,0.38428999282615867
SIM,1893,42,40-44,1935,2
STAT,1813,71,na,1884,656.4325727560685
STAT,1835,53,35-39,1888,0.006411410968918027
STAT,1896,45,20-24,1941,0.009211159782941247
SIM,1865,27,40-44,1892,1
STAT,1818,51,40-44,1869,0.023374579637461198
SIM,1894,18,20-24,1912,29
SIM,1851,85,na,1936,82
STAT,1870,16,45-49,1886,0.06615390321044458
STAT,1879,45,20-24,1924,0.012923833729614823
STAT,1899,31,30-34,1930,24.49037196449847
STAT,1825,39,40-44,1864,6.276826339774586
STAT,1922,19,na,1941,4323.2055805999835
STAT,1835,27,na,1862,2100.4970325180802
STAT,1840,35,15-19,1875,0.048796544078668604
STAT,1915,2,na,1917,4353.725810797005
STAT,1900,63,na,1963,2711.7573962000797
SIM,1875,12,na,1887,2642
STAT,1860,41,25-29,1901,0.5339275448712117
STAT,1767,101,na,1868,0.08840185880572904
STAT,1857,34,30-34,1891,13.79139065860714
STAT,1894,40,40-44,1934,2.98132282876184
SIM,1907,20,15-19,1927,4
SIM,1933,6,na,1939,5329
SIM,1806,66,na,1872,971
SIM,1827,27,20-24,1854,11
STAT,1903,47,30-34,1950,0.07881456129471502
STAT,1848,37,40-44,1885,3.5066295358490387
SIM,1857,40,30-34,1897,2
SIM,1811,57,na,1868,983
STAT,1820,34,35-39,1854,30.36801828346688
STAT,1928,30,35-39,1958,11.66846920007356
STAT,1837,17,50-100,1854,0.0596975567592946
STAT,1840,15,20-24,1855,16.71368583528618
SIM,1791,63,na,1854,888
SIM,1833,39,40-44,1872,8
STAT,1882,32,15-19,1914,0.14153568702571814
SIM,1896,25,20-24,1921,17
SIM,1947,15,na,1962,4375
SIM,1852,44,45-49,1896,1
STAT,1837,48,20-24,1885,0.008199642126368905
STAT,1839,39,40-44,1878,3.536062521818446
STAT,1844,63,na,1907,1382.677676646656
STAT,1848,19,40-44,1867,0.17417885655708631
STAT,1948,16,25-29,1964,50.61209878306988
STAT,1843,46,na,1889,1831.0779748088366
STAT,1855,29,25-29,1884,33.69111394010689
SIM,1863,66,na,1929,1355
STAT,1880,20,45-49,1900,0.7520096808154394
STAT,1850,22,25-29,1872,51.68338251056393
STAT,1834,37,40-44,1871,3.664271785825417
STAT,1891,38,25-29,1929,3.618383455888226
STAT,1887,36,na,1923,2706.1586628378413
STAT,1937,20,35-39,1957,9.359324176956173
SIM,1830,48,na,1878,1672
SIM,1855,47,na,1902,1729
STAT,1847,28,na,1875,2013.065202423949
STAT,1838,79,na,1917,513.6690885112438
STAT,1888,25,20-24,1913,14.244354424305108
STAT,1838,29,25-29,1867,38.97086051352085
STAT,1853,41,35-39,1894,1.525235218058584
STAT,1839,46,30-34,1885,0.06894435662086842
STAT,1859,52,40-44,1911,0.008531373619267507
STAT,1855,27,na,1882,1928.3463871559532
STAT,1851,13,na,1864,2383.695130274665
SIM,1944,4,na,1948,4343
SIM,1816,39,40-44,1855,5
SIM,1831,33,20-24,1864,2
SIM,1819,84,na,1903,117
SIM,1888,62,na,1950,2012
STAT,1857,27,40-44,1884,2.4582581948392286
STAT,1928,23,45-49,1951,1.4285286313885273
SIM,1842,49,na,1891,1613
SIM,1863,32,50-100,1895,2
STAT,1876,52,40-44,1928,0.011031096844267617
STAT,1864,83,na,1947,360.099881321692
SIM,1893,37,45-49,1930,4
STAT,1864,63,na,1927,1618.5108220245947
SIM,1842,29,na,1871,2083
STAT,1843,45,40-44,1888,0.14113114823911485
SIM,1879,8,na,1887,3253
SIM,1826,46,45-49,1872,1
SIM,1843,66,na,1909,1226
STAT,1805,52,na,1857,1392.7700548655757
SIM,1850,48,na,1898,1636
SIM,1898,49,40-44,1947,1
STAT,1847,42,20-24,1889,0.12453517699242973
SIM,1891,26,50-100,1917,1
STAT,1797,68,na,1865,739.835935056769
STAT,1876,47,45-49,1923,0.2474503051804245
STAT,1840,33,20-24,1873,2.3446640123471583
STAT,1844,26,45-49,1870,1.060875444751628
STAT,1949,4,na,1953,4697.327119813571
SIM,1863,29,25-29,1892,50
SIM,1875,3,na,1878,2988
STAT,1948,23,15-19,1971,6.233800581376113
SIM,1799,79,na,1878,322
STAT,1818,53,35-39,1871,0.018365778256653757
STAT,1852,50,na,1902,1759.522286130977
STAT,1811,44,35-39,1855,5.340340296966047
STAT,1823,33,20-24,1856,6.13405519676926
STAT,1914,43,50-100,1957,0.11858321208165545
STAT,1861,40,30-34,1901,0.9789127181259967
STAT,1896,47,15-19,1943,3.025902654976934E-4
SIM,1924,42,na,1966,4549
STAT,1929,21,na,1950,4724.306247962859
SIM,1884,29,45-49,1913,3
SIM,1916,23,na,1939,3891
SIM,1888,44,25-29,1932,2
SIM,1851,27,40-44,1878,3
SIM,1792,69,na,1861,654
STAT,1845,36,50-100,1881,1.018440927524592
STAT,1890,24,20-24,1914,85.41898742845419
STAT,1892,59,na,1951,2484.839188361469
SIM,1919,51,na,1970,4073
STAT,1948,12,na,1960,4586.483153708549
STAT,1885,44,35-39,1929,1.8181307202000019
STAT,1850,18,40-44,1868,0.16713102152544956
STAT,1856,64,na,1920,1392.083501362717
SIM,1939,21,20-24,1960,2
SIM,1898,29,45-49,1927,2
STAT,1857,49,50-100,1906,0.1915886322807269
STAT,1840,28,25-29,1868,37.68174424577828
SIM,1858,5,na,1863,2497
STAT,1826,38,45-49,1864,1.7344263240165956
STAT,1829,39,25-29,1868,2.4515790490051343
STAT,1891,22,15-19,1913,4.166660547068727
SIM,1908,30,30-34,1938,18
STAT,1818,46,45-49,1864,0.5444133138489291
STAT,1819,39,15-19,1858,0.13384769791629197
SIM,1883,25,35-39,1908,16
STAT,1885,50,40-44,1935,0.010868794859932866
SIM,1866,45,50-100,1911,1
SIM,1938,28,25-29,1966,71
STAT,1860,19,40-44,1879,0.17255212313683826
STAT,1876,26,40-44,1902,3.166444274427218
SIM,1870,17,20-24,1887,27
SIM,1857,70,na,1927,1027
SIM,1807,49,40-44,1856,1
SIM,1929,41,na,1970,5125
STAT,1820,42,35-39,1862,3.600741039388627
SIM,1841,37,25-29,1878,3
STAT,1936,25,45-49,1961,1.6877950693465265
STAT,1939,26,25-29,1965,67.53157799549004
STAT,1868,53,45-49,1921,0.013913382762847605
SIM,1861,34,45-49,1895,1
STAT,1835,43,40-44,1878,1.98329339323645
SIM,1843,43,40-44,1886,2
SIM,1866,48,40-44,1914,1
SIM,1878,29,20-24,1907,11
SIM,1912,3,na,1915,4306
SIM,1880,51,45-49,1931,1
STAT,1872,51,45-49,1923,0.01490891625461948
STAT,1839,25,25-29,1864,37.31189460910168
SIM,1855,24,20-24,1879,3
SIM,1898,26,40-44,1924,8
STAT,1774,95,na,1869,1.7513695463575083
STAT,1858,48,40-44,1906,0.13676182909736137
STAT,1917,26,50-100,1943,1.0688867950044656
STAT,1856,38,50-100,1894,0.9783041258675654
STAT,1862,17,20-24,1879,17.63242747012055
SIM,1848,38,45-49,1886,2
SIM,1860,78,na,1938,755
STAT,1882,49,na,1931,2189.377286769807
STAT,1830,39,20-24,1869,0.6767180606220204
SIM,1918,34,na,1952,4206
STAT,1850,25,30-34,1875,22.614463045798615
STAT,1840,25,20-24,1865,10.67864704787068
STAT,1891,19,40-44,1910,0.22976734677196953
SIM,1823,31,20-24,1854,3
STAT,1846,49,25-29,1895,0.04033097638003453
STAT,1914,44,50-100,1958,0.11837569146051256
SIM,1938,20,15-19,1958,5
STAT,1878,39,20-24,1917,0.8102963609143127
SIM,1799,91,na,1890,31
STAT,1844,43,35-39,1887,1.4188369368715812
STAT,1898,36,40-44,1934,6.0680606223609805
SIM,1877,78,na,1955,693
STAT,1885,37,45-49,1922,2.0289284962318823
SIM,1831,33,na,1864,1740
STAT,1882,22,20-24,1904,68.49053077237689
SIM,1925,26,50-100,1951,2
STAT,1847,83,na,1930,309.5756250280644
STAT,1865,33,25-29,1898,9.443635300824404
STAT,1847,44,15-19,1891,0.010623722415017287
SIM,1922,44,50-100,1966,1
SIM,1855,37,25-29,1892,2
SIM,1875,23,35-39,1898,9
SIM,1835,47,na,1882,1606
SIM,1882,23,25-29,1905,2
STAT,1849,34,50-100,1883,0.7341654119837051
STAT,1902,48,25-29,1950,0.046155982465511794
SIM,1834,38,45-49,1872,1
STAT,1873,35,25-29,1908,3.0060890870166976
STAT,1873,41,50-100,1914,1.0975788378651008
SIM,1894,40,35-39,1934,3
STAT,1886,40,35-39,1926,1.9750687052112794
STAT,1783,102,na,1885,0.09035711530437773
STAT,1823,41,20-24,1864,0.2633664711006638
STAT,1876,54,35-39,1930,0.008819643412854784
SIM,1863,39,25-29,1902,4
SIM,1904,22,na,1926,3632
SIM,1871,85,na,1956,463
SIM,1895,12,na,1907,3609
STAT,1866,54,25-29,1920,0.0032412751800239424
STAT,1894,17,45-49,1911,0.0857173805266879
SIM,1911,55,na,1966,3450
STAT,1919,22,40-44,1941,3.7572012682028544
STAT,1893,29,45-49,1922,1.4266251027225356
SIM,1839,45,40-44,1884,1
SIM,1890,22,20-24,1912,126
STAT,1935,37,na,1972,5364.922151658724
SIM,1927,22,40-44,1949,4
STAT,1849,31,na,1880,1968.697389918629
STAT,1890,32,20-24,1922,3.3716248066096193
STAT,1875,25,35-39,1900,10.17106977487984
SIM,1939,23,15-19,1962,6
STAT,1859,37,45-49,1896,1.624123447887521
STAT,1894,35,45-49,1929,2.640732977555619
STAT,1859,30,50-100,1889,0.7573530036540748
SIM,1863,11,na,1874,2419
SIM,1901,57,na,1958,3129
STAT,1856,105,na,1961,0.07378413275861184
SIM,1843,25,40-44,1868,2
STAT,1880,15,15-19,1895,6.39157301406603
STAT,1880,50,40-44,1930,0.01144813588907869
SIM,1835,44,45-49,1879,1
STAT,1836,27,20-24,1863,9.449297118824182
STAT,1852,28,45-49,1880,1.034336498355171
SIM,1852,43,35-39,1895,3
SIM,1859,61,na,1920,1658
SIM,1885,40,40-44,1925,11
STAT,1846,98,na,1944,2.323102507309157
SIM,1888,47,30-34,1935,1
STAT,1842,84,na,1926,260.8760076549516
STAT,1810,83,na,1893,169.24878897291595
STAT,1815,42,25-29,1857,2.0286733047975902
STAT,1885,19,45-49,1904,0.0661273210149471
SIM,1867,25,na,1892,2284
SIM,1867,48,na,1915,1993
STAT,1857,81,na,1938,430.83729718079695
STAT,1817,53,na,1870,1284.594291732827
SIM,1849,33,35-39,1882,16
SIM,1860,28,45-49,1888,1
STAT,1827,44,45-49,1871,1.7076099333690793
STAT,1910,47,20-24,1957,0.010516056848750384
STAT,1913,33,50-100,1946,0.8356421038251969
SIM,1878,64,na,1942,1942
SIM,1829,29,25-29,1858,35
SIM,1898,33,30-34,1931,39
STAT,1807,47,25-29,1854,0.25246097121875205
SIM,1919,23,45-49,1942,2
SIM,1839,19,40-44,1858,1
STAT,1928,15,45-49,1943,0.6450187109360387
STAT,1840,18,25-29,1858,5.248500011579512
SIM,1888,43,15-19,1931,1
SIM,1930,38,na,1968,5457
STAT,1791,75,na,1866,368.7682075726464
STAT,1831,49,50-100,1880,0.19576042867297028
STAT,1877,40,40-44,1917,2.4039415200551546
STAT,1852,109,na,1961,0.0019121616627239477
STAT,1874,38,25-29,1912,2.98398759324936
STAT,1821,35,na,1856,1520.8035311175663
SIM,1844,52,na,1896,1710
SIM,1876,27,45-49,1903,1
STAT,1832,41,15-19,1873,0.011495309097162098
SIM,1832,24,25-29,1856,60
SIM,1944,25,45-49,1969,4
SIM,1947,15,20-24,1962,159
SIM,1842,24,35-39,1866,10
STAT,1842,24,40-44,1866,2.0316310456970337
STAT,1831,45,na,1876,1667.7924248118184
STAT,1861,11,na,1872,2323.5299996129916
SIM,1894,58,na,1952,2650
STAT,1910,18,na,1928,3893.011318027645
STAT,1933,26,na,1959,5074.991437451971
SIM,1868,43,45-49,1911,5
SIM,1924,20,15-19,1944,6
SIM,1844,27,20-24,1871,14
SIM,1936,15,45-49,1951,1
STAT,1888,38,25-29,1926,3.4551470057609244
SIM,1822,38,25-29,1860,3
SIM,1832,28,40-44,1860,5
STAT,1824,31,15-19,1855,0.3353007047618858
STAT,1814,45,15-19,1859,0.0012319240344305091
STAT,1918,21,35-39,1939,10.39455599833726
SIM,1882,38,25-29,1920,5
STAT,1849,43,35-39,1892,1.395688855929476
STAT,1849,105,na,1954,0.022763411949739187
STAT,1839,43,25-29,1882,0.4611476151346587
STAT,1832,34,25-29,1866,8.787065838005306
SIM,1852,36,45-49,1888,2
SIM,1847,25,25-29,1872,60
SIM,1921,33,50-100,1954,3
SIM,1926,21,35-39,1947,3
STAT,1881,36,15-19,1917,0.055650541450407195
STAT,1947,25,20-24,1972,21.088259102987273
STAT,1861,33,40-44,1894,3.640287165133293
STAT,1856,40,20-24,1896,0.1284613040083518
STAT,1879,53,20-24,1932,7.742497608411971E-4
SIM,1782,90,na,1872,3
SIM,1896,38,25-29,1934,1
STAT,1834,29,40-44,1863,2.605562882737338
STAT,1881,26,20-24,1907,11.610172104471516
STAT,1916,20,15-19,1936,5.726181939576064
SIM,1871,28,20-24,1899,11
STAT,1866,28,45-49,1894,1.0410845696752622
STAT,1844,36,45-49,1880,1.8125733921230138
SIM,1812,74,na,1886,428
SIM,1840,34,25-29,1874,12
SIM,1890,44,na,1934,2981
STAT,1824,35,30-34,1859,7.960127366964994
STAT,1852,46,45-49,1898,0.19066177832955314
STAT,1863,28,20-24,1891,10.456280693942656
STAT,1865,57,na,1922,1860.7230289939484
STAT,1896,48,25-29,1944,0.04322706463325314
SIM,1865,77,na,1942,744
STAT,1845,17,na,1862,2266.873977957853
STAT,1888,45,15-19,1933,4.872170721944965E-4
SIM,1850,24,40-44,1874,2
SIM,1873,29,40-44,1902,5
STAT,1851,65,na,1916,1394.2484472400956
STAT,1855,36,20-24,1891,0.6004368223951181
STAT,1837,30,na,1867,1849.6867626059425
STAT,1834,65,na,1899,1135.6844533365054
STAT,1881,31,na,1912,2363.1828208554925
SIM,1830,27,20-24,1857,16
SIM,1898,72,na,1970,2319
STAT,1859,104,na,1963,0.22181982838752362
STAT,1839,50,50-100,1889,0.010682437689548397
SIM,1850,49,40-44,1899,1
STAT,1874,93,na,1967,105.63919792201524
STAT,1916,34,na,1950,3950.554819914546
SIM,1894,33,45-49,1927,5
STAT,1866,36,25-29,1902,2.72227840935162
STAT,1893,76,na,1969,1649.9886868166152
SIM,1849,49,45-49,1898,1
STAT,1930,25,50-100,1955,1.2919579451393375
STAT,1829,28,20-24,1857,13.609239047648787
STAT,1842,49,40-44,1891,0.1314526691755115
STAT,1871,19,15-19,1890,5.964848994612342
STAT,1892,44,25-29,1936,0.056244939866054375
STAT,1845,40,45-49,1885,1.2217239387270031
STAT,1857,17,40-44,1874,0.1712739522482831
STAT,1910,46,50-100,1956,0.21576371566447472
SIM,1832,35,30-34,1867,8
STAT,1864,42,20-24,1906,0.14387913498000715
STAT,1875,22,30-34,1897,18.64965022652866
STAT,1829,29,30-34,1858,25.87280771701008
STAT,1857,38,na,1895,1867.7413430281408
SIM,1871,46,50-100,1917,1
STAT,1955,14,na,1969,5316.676143303992
SIM,1827,42,45-49,1869,4
STAT,1870,48,na,1918,2215.4903342183034
SIM,1857,25,40-44,1882,3
STAT,1898,43,30-34,1941,0.10934140491202915
SIM,1850,23,30-34,1873,19
SIM,1872,79,na,1951,475
STAT,1844,18,45-49,1862,0.06396662833162592
STAT,1891,15,25-29,1906,7.190319120916455
SIM,1917,40,na,1957,3829
STAT,1912,20,na,1932,3753.1075394399522
STAT,1911,49,30-34,1960,0.08558064646075852
STAT,1808,49,na,1857,1094.577327401464
SIM,1837,28,20-24,1865,12
STAT,1926,20,30-34,1946,35.83356732819421
STAT,1870,26,45-49,1896,1.1110637246844388
STAT,1854,25,15-19,1879,0.40583346281484073
SIM,1874,36,25-29,1910,4
STAT,1863,38,20-24,1901,0.6860672590233727
STAT,1881,16,20-24,1897,17.528193990436748
STAT,1853,42,45-49,1895,1.2533857982071226
SIM,1888,36,25-29,1924,4
SIM,1836,64,na,1900,1395
STAT,1825,53,25-29,1878,0.004305965080694791
STAT,1835,25,40-44,1860,2.952282348074427
STAT,1883,24,30-34,1907,17.717864122422668
SIM,1939,24,25-29,1963,101
SIM,1860,38,45-49,1898,2
STAT,1863,46,na,1909,2018.0874596478927
STAT,1832,26,25-29,1858,39.08631369303746
STAT,1876,44,40-44,1920,2.3374700925796774
SIM,1820,40,35-39,1860,4
STAT,1815,39,30-34,1854,20.280007827632257
STAT,1855,26,20-24,1881,9.547740467356544
STAT,1888,46,25-29,1934,0.06966399206086991
STAT,1852,38,45-49,1890,1.5979906140659654
SIM,1884,44,40-44,1928,4
SIM,1841,30,25-29,1871,14
STAT,1850,48,na,1898,1671.0767746073093
STAT,1868,45,45-49,1913,0.23224320437395948
SIM,1876,45,45-49,1921,1
STAT,1860,37,40-44,1897,3.6233214832349607
STAT,1896,19,20-24,1915,23.758498971286443
STAT,1849,25,40-44,1874,2.796843673764211
STAT,1880,38,50-100,1918,1.3096483633642777
SIM,1962,2,na,1964,5406
STAT,1893,46,35-39,1939,0.1024910608116257
STAT,1777,112,na,1889,9.395618531599116E-4
STAT,1965,1,na,1966,5013.3526324726645
SIM,1816,39,50-100,1855,1
STAT,1831,50,45-49,1881,0.010862656587497327
STAT,1861,43,35-39,1904,1.5154317116139415
STAT,1839,18,35-39,1857,0.49246214705178654
STAT,1850,21,15-19,1871,3.0000168272698677
SIM,1823,39,30-34,1862,8
SIM,1840,26,25-29,1866,50
SIM,1824,33,30-34,1857,23
SIM,1907,18,na,1925,3841
STAT,1840,36,25-29,1876,2.476086635937838
STAT,1900,43,45-49,1943,0.14588991868467666
SIM,1897,6,na,1903,3537
STAT,1809,53,40-44,1862,0.0438295005019382
STAT,1921,25,na,1946,4289.328782439818
SIM,1863,26,20-24,1889,12
STAT,1888,28,25-29,1916,50.83679051229932
SIM,1848,65,na,1913,1289
STAT,1862,29,na,1891,2057.6446215282795
STAT,1804,102,na,1906,0.09892305417407278
STAT,1832,33,15-19,1865,0.12353121142815011
STAT,1887,19,50-100,1906,0.05570391295745654
STAT,1843,53,40-44,1896,0.00836223176940731
STAT,1860,22,35-39,1882,4.979153406270267
STAT,1881,19,25-29,1900,5.558993736942902
SIM,1859,81,na,1940,382
SIM,1891,24,30-34,1915,37
SIM,1886,39,20-24,1925,1
STAT,1855,46,15-19,1901,3.1095942220954296E-4
STAT,1829,46,20-24,1875,0.009837452776509213
STAT,1822,37,20-24,1859,1.4612893095632247
SIM,1805,72,na,1877,466
STAT,1845,29,15-19,1874,0.42531471448535557
STAT,1857,35,40-44,1892,3.5207617203474113
STAT,1865,15,25-29,1880,6.01212295600137
STAT,1813,44,50-100,1857,3.226117268950487
SIM,1899,26,na,1925,3285
STAT,1894,43,45-49,1937,0.13539336134856514
STAT,1904,48,50-100,1952,0.2000078387548788
SIM,1934,20,30-34,1954,42
STAT,1903,39,30-34,1942,1.6513965452856936
STAT,1873,27,25-29,1900,43.75022687651435
STAT,1897,41,20-24,1938,0.015111074494751155
STAT,1827,107,na,1934,0.003048012078400365
SIM,1881,27,25-29,1908,38
STAT,1842,23,30-34,1865,17.491861804164966
SIM,1801,67,na,1868,933
STAT,1826,48,45-49,1874,0.18198736231142856
SIM,1839,27,40-44,1866,4
SIM,1789,69,na,1858,776
STAT,1837,38,20-24,1875,0.6192852482435536
STAT,1839,96,na,1935,5.926037358172736
SIM,1829,37,25-29,1866,3
SIM,1892,37,50-100,1929,2
STAT,1835,82,na,1917,347.63465080771016
STAT,1811,68,na,1879,765.6863110366249
SIM,1834,22,35-39,1856,7
STAT,1865,36,30-34,1901,4.958421991843593
SIM,1810,44,40-44,1854,8
STAT,1847,45,25-29,1892,0.045365034701687845
SIM,1911,39,30-34,1950,3
STAT,1884,37,50-100,1921,1.2391394250770777
SIM,1830,37,20-24,1867,2
SIM,1873,15,25-29,1888,10
SIM,1896,28,25-29,1924,56
STAT,1896,37,20-24,1933,1.0386059054734906
SIM,1873,36,30-34,1909,12
STAT,1886,15,45-49,1901,0.07086375199061025
STAT,1819,42,45-49,1861,3.2306421908982075
STAT,1893,12,na,1905,3342.145051159688
STAT,1857,42,30-34,1899,0.9148347005027027
STAT,1849,32,30-34,1881,14.28362497611002
SIM,1887,25,na,1912,2804
STAT,1827,52,45-49,1879,0.015724444307237392
STAT,1921,38,35-39,1959,2.753139330003741
SIM,1815,40,25-29,1855,3
STAT,1938,22,15-19,1960,5.374216813940736
SIM,1874,29,35-39,1903,14
SIM,1863,19,30-34,1882,2
STAT,1880,14,na,1894,2759.5634835816986
SIM,1857,32,30-34,1889,26
SIM,1948,17,30-34,1965,19
STAT,1852,45,35-39,1897,0.11390863992733376
STAT,1898,18,40-44,1916,0.25166326747462014
STAT,1839,42,15-19,1881,0.010045026868021683
STAT,1874,31,25-29,1905,10.71190339454343
SIM,1882,31,25-29,1913,13
STAT,1850,28,na,1878,1901.1665392645423
SIM,1949,21,30-34,1970,36
STAT,1883,17,40-44,1900,0.1830796396548842
STAT,1886,33,45-49,1919,1.8750540439688694
STAT,1855,19,30-34,1874,1.452320459417288
STAT,1896,61,na,1957,2565.2053302719364
STAT,1876,22,50-100,1898,0.4295783993600123
STAT,1835,50,30-34,1885,0.004704400841084943
SIM,1874,2,na,1876,3288
STAT,1848,14,na,1862,2279.5483834112647
STAT,1885,34,40-44,1919,4.376028742129761
STAT,1949,23,30-34,1972,34.20478501348906
STAT,1862,31,35-39,1893,8.830283706209418
STAT,1883,28,25-29,1911,42.19321545984615
SIM,1839,84,na,1923,156
STAT,1841,28,40-44,1869,2.7274161524093237
SIM,1844,34,45-49,1878,3
STAT,1781,85,na,1866,79.75087467187831
STAT,1888,42,na,1930,2783.9700947457954
SIM,1898,37,50-100,1935,4
STAT,1919,49,35-39,1968,0.14186820821119214
SIM,1891,61,na,1952,2359
STAT,1860,47,35-39,1907,0.1153397575046388
SIM,1815,43,30-34,1858,2
STAT,1858,105,na,1963,0.10294066662633564
SIM,1943,21,35-39,1964,14
STAT,1848,47,35-39,1895,0.10831928051192931
STAT,1868,27,45-49,1895,1.0818431109066668
SIM,1847,28,na,1875,1771
SIM,1843,14,na,1857,2404
SIM,1851,33,na,1884,1937
STAT,1844,40,30-34,1884,0.9361025006829844
STAT,1947,20,15-19,1967,6.142390792373903
SIM,1888,18,25-29,1906,10
SIM,1949,17,45-49,1966,2
STAT,1874,34,30-34,1908,18.029679687728756
SIM,1880,39,25-29,1919,1
SIM,1833,34,35-39,1867,17
SIM,1882,34,30-34,1916,15
STAT,1924,22,15-19,1946,6.408489860249773
SIM,1942,16,na,1958,4338
SIM,1877,40,35-39,1917,4
STAT,1911,43,20-24,1954,0.017090351728614585
SIM,1864,32,20-24,1896,1
SIM,1838,24,20-24,1862,69
SIM,1870,40,45-49,1910,3
STAT,1905,62,na,1967,2955.9193492623176
STAT,1848,33,25-29,1881,8.362076598153505
SIM,1798,74,na,1872,385
SIM,1910,45,20-24,1955,1
SIM,1925,30,30-34,1955,21
STAT,1888,35,20-24,1923,0.9384884179417023
STAT,1840,41,20-24,1881,0.12074943934143757
SIM,1891,0,na,1891,3537
STAT,1818,48,50-100,1866,0.5490998226034532
SIM,1849,38,40-44,1887,8
STAT,1854,48,20-24,1902,0.009068855265656626
STAT,1829,54,50-100,1883,0.010333555702783763
SIM,1858,36,40-44,1894,3
SIM,1931,5,na,1936,5223
SIM,1828,45,na,1873,1707
SIM,1824,31,na,1855,1696
SIM,1918,23,50-100,1941,1
STAT,1935,21,35-39,1956,13.08033648848846
STAT,1852,17,40-44,1869,0.1782106163229771
STAT,1902,45,20-24,1947,0.009835276418501251
STAT,1836,34,45-49,1870,1.3438784118963947
STAT,1865,41,25-29,1906,0.5972653256662575
STAT,1892,26,25-29,1918,54.270589882178584
STAT,1856,32,20-24,1888,2.1911210486079264
SIM,1891,28,25-29,1919,64
STAT,1857,38,45-49,1895,1.5803708059486505
SIM,1849,30,30-34,1879,5
STAT,1870,79,na,1949,697.1915887090809
STAT,1928,35,na,1963,4858.216176192077
STAT,1802,52,40-44,1854,0.027898949664375065
SIM,1874,28,45-49,1902,1
SIM,1818,90,na,1908,24
STAT,1895,26,15-19,1921,0.6059554143154012
SIM,1923,1,na,1924,4735
STAT,1845,32,45-49,1877,1.6200542813167318
SIM,1833,35,25-29,1868,1
STAT,1947,18,na,1965,4228.943367810807
SIM,1824,37,25-29,1861,4
SIM,1873,41,25-29,1914,1
STAT,1830,29,20-24,1859,11.856283045893013
STAT,1828,35,15-19,1863,0.051481305954876565
SIM,1807,52,na,1859,1163
STAT,1928,1,na,1929,5367.317716695241
SIM,1863,31,50-100,1894,3
STAT,1883,20,15-19,1903,3.3219118874387092
SIM,1853,32,45-49,1885,3
STAT,1825,35,25-29,1860,4.704516243480059
STAT,1853,27,20-24,1880,11.395501043239905
SIM,1881,40,20-24,1921,1
SIM,1897,16,25-29,1913,14
SIM,1829,26,20-24,1855,13
SIM,1917,31,35-39,1948,1
SIM,1815,71,na,1886,624
SIM,1852,33,40-44,1885,6
STAT,1877,35,45-49,1912,2.1293123934388736
SIM,1954,9,na,1963,4719
STAT,1872,46,15-19,1918,4.101326626102016E-4
STAT,1843,15,50-100,1858,0.051142636564511075
STAT,1836,41,35-39,1877,1.3582308286616396
STAT,1951,16,50-100,1967,0.455259527242332
STAT,1839,54,30-34,1893,0.0039951506713833025
SIM,1891,20,15-19,1911,4
STAT,1850,26,40-44,1876,2.670833995213541
STAT,1848,48,25-29,1896,0.04421179515714795
STAT,1869,36,15-19,1905,0.05557329746872784
STAT,1843,69,na,1912,1184.708168097867
SIM,1855,34,20-24,1889,2
SIM,1932,15,25-29,1947,74
SIM,1834,62,na,1896,1271
SIM,1889,32,25-29,1921,15
STAT,1841,29,30-34,1870,22.763122087552638
SIM,1835,19,20-24,1854,14
STAT,1859,44,40-44,1903,1.8077831212246085
STAT,1825,34,35-39,1859,17.292800448422327
STAT,1902,47,15-19,1949,3.230927454139982E-4
SIM,1861,27,20-24,1888,12
SIM,1879,25,20-24,1904,13
SIM,1847,80,na,1927,383
SIM,1875,20,30-34,1895,20
STAT,1869,40,35-39,1909,1.8014817757185957
SIM,1818,44,45-49,1862,3
SIM,1946,5,na,1951,4356
STAT,1909,31,35-39,1940,8.93009167588817
STAT,1871,22,45-49,1893,0.7046606245644227
SIM,1847,29,40-44,1876,3
SIM,1927,39,na,1966,4641
SIM,1927,38,na,1965,4657
STAT,1860,58,na,1918,1636.8856278158987
SIM,1923,25,na,1948,4212
STAT,1851,88,na,1939,113.26134806593386
STAT,1924,15,25-29,1939,52.894706426135
STAT,1849,54,25-29,1903,0.0026742591735433854
STAT,1851,25,25-29,1876,41.45552108778649
SIM,1856,33,25-29,1889,2
STAT,1844,33,40-44,1877,3.9771685289617826
SIM,1833,28,35-39,1861,10
STAT,1839,47,40-44,1886,0.1203824189643118
STAT,1831,45,15-19,1876,3.356700897695817E-4
STAT,1851,43,25-29,1894,0.525963623971925
SIM,1885,35,45-49,1920,3
SIM,1877,58,na,1935,2051
STAT,1889,16,25-29,1905,7.158429905369003
SIM,1844,41,35-39,1885,3
SIM,1865,38,25-29,1903,5
STAT,1857,50,na,1907,1740.1213930425738
SIM,1870,6,na,1876,2993
STAT,1862,35,50-100,1897,1.076297418986359
SIM,1838,44,na,1882,1575
STAT,1862,40,45-49,1902,1.3127966436321101
STAT,1892,25,35-39,1917,12.42044872962558
STAT,1810,53,30-34,1863,0.017470879664152207
STAT,1872,39,25-29,1911,2.9141487658618246
STAT,1912,37,30-34,1949,1.8146570938105195
SIM,1833,27,45-49,1860,1
STAT,1773,115,na,1888,1.8984281734492808E-4
STAT,1882,29,40-44,1911,2.9559427844721244
STAT,1892,19,35-39,1911,0.6977962822735575
STAT,1888,17,20-24,1905,21.380967022057618
SIM,1798,85,na,1883,93
STAT,1841,99,na,1940,1.3983417688015323
STAT,1848,40,15-19,1888,0.010999896276670926
SIM,1853,8,na,1861,2421
STAT,1895,24,na,1919,3128.1991468234646
SIM,1912,34,50-100,1946,1
STAT,1860,40,15-19,1900,0.011545931643159596
STAT,1915,17,25-29,1932,9.255262287653196
SIM,1899,37,40-44,1936,4
SIM,1917,49,na,1966,3723
STAT,1841,21,20-24,1862,64.92316106691027
STAT,1852,2,na,1854,2918.0
SIM,1913,35,na,1948,3904
STAT,1827,37,20-24,1864,1.002027568199944
SIM,1938,29,50-100,1967,1
STAT,1831,38,25-29,1869,2.5024655044749613
STAT,1850,18,50-100,1868,0.04476722702232994
STAT,1892,18,45-49,1910,0.08330004571960017
STAT,1950,19,50-100,1969,0.4516392878925226
STAT,1852,35,40-44,1887,3.620062737881939
SIM,1921,13,na,1934,5219
SIM,1850,27,45-49,1877,2
STAT,1857,53,20-24,1910,5.78474720342668E-4
STAT,1932,17,25-29,1949,58.519646864418256
SIM,1901,28,50-100,1929,1
SIM,1948,18,40-44,1966,2
STAT,1826,77,na,1903,504.1486652182387
STAT,1834,96,na,1930,5.770384477521265
STAT,1814,97,na,1911,2.503396145138157
STAT,1858,8,na,1866,2320.6568480902447
SIM,1825,38,50-100,1863,1
SIM,1903,37,30-34,1940,3
STAT,1889,34,25-29,1923,12.796646703787657
STAT,1853,16,45-49,1869,0.0662785356576308
STAT,1839,29,40-44,1868,2.567160396367608
STAT,1872,43,45-49,1915,1.5191554058617163
STAT,1841,35,30-34,1876,4.733622331105286
STAT,1893,18,40-44,1911,0.2360831833572528
SIM,1880,43,45-49,1923,6
SIM,1890,13,na,1903,3384
STAT,1877,28,20-24,1905,12.36919059867999
SIM,1838,17,30-34,1855,3
STAT,1803,51,45-49,1854,0.05981419849037389
SIM,1920,37,30-34,1957,2
STAT,1856,39,40-44,1895,3.4702380780210342
STAT,1891,10,na,1901,3271.5764029392403
STAT,1898,31,15-19,1929,0.19726170670367663
STAT,1844,32,na,1876,2008.3161730459701
STAT,1821,49,20-24,1870,0.018350911479064865
SIM,1844,51,na,1895,1710
SIM,1894,27,na,1921,3216
STAT,1810,46,40-44,1856,0.5477910900058048
STAT,1762,94,na,1856,3.7476435239999994
SIM,1856,44,30-34,1900,4
SIM,1880,14,na,1894,2601
SIM,1928,20,35-39,1948,18
STAT,1811,50,40-44,1861,0.02900422000343431
STAT,1870,23,40-44,1893,2.0716834791979
STAT,1899,37,na,1936,3317.1989286246135
SIM,1919,16,20-24,1935,1
SIM,1923,17,25-29,1940,80
STAT,1873,40,20-24,1913,0.16590967704023732
STAT,1889,48,35-39,1937,0.09826521585801208
SIM,1891,46,25-29,1937,1
STAT,1861,15,40-44,1876,0.17931993629674517
STAT,1862,24,45-49,1886,0.6110291684411092
STAT,1902,11,na,1913,3720.859214613727
STAT,1842,27,25-29,1869,41.023336638971365
STAT,1917,15,35-39,1932,0.9257611295983981
SIM,1912,35,30-34,1947,4
STAT,1851,18,35-39,1869,0.5471519239621226
STAT,1893,7,na,1900,3371.712489152823
STAT,1894,28,20-24,1922,15.34003635175988
SIM,1866,94,na,1960,32
STAT,1861,98,na,1959,4.9969129405255055
SIM,1826,66,na,1892,974
SIM,1841,29,45-49,1870,2
STAT,1895,23,na,1918,3138.178554627179
STAT,1898,46,35-39,1944,0.10925486044366875
STAT,1884,83,na,1967,710.8176706328321
SIM,1834,27,40-44,1861,5
SIM,1860,45,35-39,1905,1
SIM,1862,80,na,1942,489
STAT,1883,46,25-29,1929,0.05781930364203773
STAT,1889,49,25-29,1938,0.04008870380869281
STAT,1851,24,35-39,1875,5.667036206360537
STAT,1939,33,15-19,1972,0.13367195653951947
SIM,1897,34,25-29,1931,6
SIM,1820,41,45-49,1861,1
STAT,1833,29,45-49,1862,0.9596411099153417
STAT,1842,27,45-49,1869,1.0767567097879485
STAT,1904,35,30-34,1939,1.6978495085289047
STAT,1874,15,50-100,1889,0.05145647645837126
SIM,1841,36,35-39,1877,11
SIM,1881,24,20-24,1905,65
STAT,1876,64,na,1940,1831.2378324770302
STAT,1872,50,na,1922,2233.0984351931347
SIM,1929,38,25-29,1967,4
STAT,1805,101,na,1906,0.2293489617910494
STAT,1897,33,20-24,1930,3.6715115868838026
STAT,1906,24,na,1930,3489.748299259826
SIM,1849,39,na,1888,1846
STAT,1930,25,30-34,1955,50.858750274536916
STAT,1909,21,na,1930,3628.165972752793
SIM,1839,48,45-49,1887,1
SIM,1889,39,45-49,1928,6
SIM,1897,49,25-29,1946,1
STAT,1847,49,40-44,1896,0.13071652641415513
STAT,1902,10,na,1912,3726.5608527183863
STAT,1877,51,45-49,1928,0.015428851265178964
STAT,1833,22,25-29,1855,58.94512981524028
STAT,1879,61,na,1940,1992.6288879691374
SIM,1861,42,45-49,1903,5
STAT,1919,7,na,1926,4507.796270236002
STAT,1870,42,45-49,1912,1.4907058559910338
SIM,1917,38,50-100,1955,1
SIM,1916,54,na,1970,3744
STAT,1832,42,25-29,1874,0.5276409175776139
STAT,1897,47,30-34,1944,0.07413361295810707
SIM,1912,40,na,1952,3770
SIM,1815,39,45-49,1854,1
SIM,1885,28,20-24,1913,14
STAT,1936,5,na,1941,3926.2368439622683
SIM,1850,27,25-29,1877,51
SIM,1925,15,35-39,1940,7
STAT,1832,23,20-24,1855,72.4840104032353
STAT,1802,54,35-39,1856,0.021912471941351708
SIM,1874,32,30-34,1906,30
STAT,1889,41,15-19,1930,0.01748111039340222
STAT,1910,39,20-24,1949,0.2545481170180643
SIM,1873,32,na,1905,2402
STAT,1851,17,45-49,1868,0.06552305251597346
STAT,1852,42,30-34,1894,0.9250343396135016
STAT,1883,26,50-100,1909,0.6425073463165015
STAT,1868,38,20-24,1906,0.7473645813145723
STAT,1922,10,na,1932,4693.1094475355285
STAT,1833,36,35-39,1869,5.919516095102673
SIM,1810,47,45-49,1857,1
STAT,1926,24,na,1950,4497.594506787282
SIM,1840,23,20-24,1863,74
SIM,1848,31,25-29,1879,14
STAT,1949,16,40-44,1965,1.660132538673869
STAT,1859,61,na,1920,1522.405360921721
SIM,1859,42,40-44,1901,2
SIM,1767,90,na,1857,17
STAT,1867,28,na,1895,2277.6034972446582
STAT,1942,6,na,1948,4242.425895799431
SIM,1818,37,20-24,1855,4
SIM,1846,63,na,1909,1344
STAT,1833,37,25-29,1870,2.38414348415826
SIM,1841,22,25-29,1863,63
SIM,1862,81,na,1943,399
SIM,1848,39,35-39,1887,10
SIM,1908,35,na,1943,3907
SIM,1858,44,na,1902,1877
SIM,1904,21,na,1925,3693
STAT,1842,45,25-29,1887,0.046350299951761896
SIM,1860,35,40-44,1895,5
STAT,1867,80,na,1947,592.4492826639479
STAT,1831,42,45-49,1873,1.2684075675264153
STAT,1897,15,20-24,1912,24.29472028783527
SIM,1893,32,na,1925,3158
STAT,1790,89,na,1879,39.96730685610543
STAT,1853,34,45-49,1887,1.474807321924302
SIM,1940,17,25-29,1957,60
STAT,1865,19,40-44,1884,0.17246285831943234
STAT,1898,39,45-49,1937,0.5876149046522774
SIM,1888,15,20-24,1903,26
STAT,1892,48,40-44,1940,0.12192064233701833
STAT,1907,10,na,1917,3880.0155423812635
STAT,1895,49,20-24,1944,0.008821498734853437
STAT,1848,44,30-34,1892,0.8816122485212532
STAT,1858,30,30-34,1888,14.421453622740948
STAT,1879,27,20-24,1906,12.509891760438107
STAT,1850,19,30-34,1869,1.4478490577573602
STAT,1866,21,25-29,1887,54.698977178524075
SIM,1939,20,30-34,1959,43
STAT,1860,44,30-34,1904,0.9387520160490913
STAT,1855,47,na,1902,1735.9417375097296
SIM,1831,34,na,1865,1701
SIM,1864,35,25-29,1899,5
STAT,1890,79,na,1969,1311.2252065385617
SIM,1838,27,25-29,1865,31
STAT,1920,39,na,1959,4194.657409611084
STAT,1878,75,na,1953,1093.1458662961813
STAT,1885,3,na,1888,2996.876001606953
SIM,1824,34,20-24,1858,3
STAT,1889,38,40-44,1927,5.4889215212652385
SIM,1844,31,40-44,1875,9
STAT,1828,32,45-49,1860,1.7206990283497285
STAT,1856,35,25-29,1891,2.3275684153720935
SIM,1790,78,na,1868,209
SIM,1855,53,25-29,1908,1
STAT,1820,40,40-44,1860,4.7272425941788505
SIM,1895,18,15-19,1913,10
STAT,1823,43,15-19,1866,0.02178709615894936
SIM,1903,36,na,1939,3383
SIM,1815,46,35-39,1861,1
STAT,1812,85,na,1897,125.03441595009994
SIM,1869,91,na,1960,78
SIM,1819,85,na,1904,117
SIM,1891,25,20-24,1916,1
STAT,1897,18,25-29,1915,7.709373319842653
STAT,1887,18,15-19,1905,6.766209096679255
STAT,1847,53,25-29,1900,0.002717759141998901
SIM,1833,31,30-34,1864,21
SIM,1883,19,35-39,1902,1
SIM,1886,39,na,1925,2557
SIM,1882,25,na,1907,2416
SIM,1882,37,35-39,1919,10
STAT,1839,51,25-29,1890,0.0024561979182583468
STAT,1840,18,na,1858,2126.0289874387413
SIM,1872,37,25-29,1909,3
SIM,1919,20,na,1939,4108
SIM,1902,20,35-39,1922,13
STAT,1834,43,25-29,1877,0.5143361982948844
SIM,1825,32,35-39,1857,15
STAT,1883,25,20-24,1908,11.822444124707483
STAT,1892,22,30-34,1914,22.774106322241394
SIM,1907,24,30-34,1931,39
STAT,1860,33,25-29,1893,8.442172672929946
STAT,1895,23,45-49,1918,0.9252746854735728
STAT,1855,58,na,1913,1533.0301619421157
STAT,1936,23,na,1959,3559.744025957111
STAT,1861,29,20-24,1890,9.818560605706292
STAT,1919,46,30-34,1965,0.09891538841706077
STAT,1911,46,25-29,1957,0.05135161897915196
STAT,1884,23,35-39,1907,5.871449560677333
STAT,1836,31,40-44,1867,3.44784388016189
SIM,1892,23,35-39,1915,12
SIM,1903,9,na,1912,3718
STAT,1899,39,40-44,1938,1.3066361535651845
SIM,1818,41,40-44,1859,5
SIM,1874,21,25-29,1895,71
STAT,1870,30,30-34,1900,17.55188439842981
STAT,1822,53,20-24,1875,9.914705756742023E-4
STAT,1866,10,na,1876,2565.442408247686
STAT,1864,37,25-29,1901,2.611668832399284
STAT,1933,30,15-19,1963,0.17680855140327753
SIM,1890,36,30-34,1926,10
SIM,1903,25,na,1928,3432
SIM,1833,38,50-100,1871,1
STAT,1884,50,25-29,1934,0.003626264725523156
STAT,1819,96,na,1915,5.062324296497137
STAT,1893,36,40-44,1929,5.692396363232645
SIM,1870,35,50-100,1905,1
STAT,1874,37,35-39,1911,7.366885194620632
SIM,1939,28,40-44,1967,5
STAT,1836,44,na,1880,1517.378198695102
STAT,1832,30,na,1862,1909.8337097004592
STAT,1806,78,na,1884,333.06657071479896
STAT,1825,31,30-34,1856,37.79240223054768
STAT,1925,32,30-34,1957,19.08796892948261
SIM,1846,26,20-24,1872,3
SIM,1875,42,25-29,1917,2
SIM,1864,17,25-29,1881,10
SIM,1885,42,35-39,1927,6
SIM,1877,79,na,1956,654
SIM,1842,43,25-29,1885,2
STAT,1872,18,20-24,1890,18.078685610376272
STAT,1872,36,20-24,1908,0.7919321143199666
STAT,1850,59,na,1909,1461.8831212880807
STAT,1855,52,20-24,1907,5.689886075381403E-4
STAT,1882,36,30-34,1918,5.322438335354378
STAT,1884,49,45-49,1933,0.23321745675169916
SIM,1860,14,na,1874,2330
STAT,1839,39,50-100,1878,0.9917469751294733
STAT,1883,43,20-24,1926,0.1578180183337866
STAT,1895,43,50-100,1938,0.09694050114440116
STAT,1846,43,na,1889,1651.531920927244
STAT,1886,36,15-19,1922,0.060928221509262186
SIM,1880,18,20-24,1898,15
STAT,1893,43,30-34,1936,0.1025722474456447
STAT,1850,29,45-49,1879,0.9687716474845124
SIM,1885,32,40-44,1917,6
STAT,1802,64,na,1866,763.8688095424797
STAT,1826,45,40-44,1871,0.13736561158382618
STAT,1880,6,na,1886,2866.0705681800896
SIM,1917,0,na,1917,4520
SIM,1896,38,na,1934,3179
SIM,1888,33,20-24,1921,2
STAT,1899,36,50-100,1935,1.7233744016762917
STAT,1917,20,na,1937,3984.3481080096876
SIM,1854,17,15-19,1871,5
SIM,1892,49,45-49,1941,1
SIM,1939,19,na,1958,3536
STAT,1866,29,35-39,1895,9.014462122839472
STAT,1849,62,na,1911,1418.9783317865715
SIM,1778,85,na,1863,99
SIM,1882,27,50-100,1909,1
STAT,1867,46,40-44,1913,0.1644291918009391
STAT,1877,32,40-44,1909,4.588618857713411
STAT,1836,50,45-49,1886,0.009509734478472878
SIM,1862,22,45-49,1884,3
SIM,1803,90,na,1893,1
SIM,1889,43,30-34,1932,5
SIM,1886,83,na,1969,769
STAT,1856,17,25-29,1873,5.365812978304246
STAT,1864,44,15-19,1908,0.012357565879082133
STAT,1816,52,20-24,1868,0.0014518398554491856
SIM,1866,30,30-34,1896,6
SIM,1773,86,na,1859,29
SIM,1832,29,30-34,1861,25
SIM,1920,28,na,1948,3940
STAT,1846,17,15-19,1863,5.331228701724538
STAT,1858,38,40-44,1896,3.5238678403818278
STAT,1826,52,30-34,1878,0.004491206733805212
STAT,1873,76,na,1949,979.8518344205564
STAT,1819,45,15-19,1864,8.158532315164638E-4
SIM,1852,59,na,1911,1620
SIM,1842,25,25-29,1867,49
SIM,1933,32,30-34,1965,5
STAT,1826,108,na,1934,0.001068335722726594
STAT,1851,47,40-44,1898,0.1405844934239026
STAT,1907,40,50-100,1947,0.11099707458285198
STAT,1865,16,50-100,1881,0.04702138084115874
SIM,1806,67,na,1873,926
STAT,1906,57,na,1963,3146.3256750800083
STAT,1844,15,40-44,1859,0.18230906730122137
STAT,1853,24,50-100,1877,0.39822601685587905
STAT,1873,43,25-29,1916,0.6593529680383304
SIM,1802,53,na,1855,1083
SIM,1875,28,40-44,1903,3
SIM,1881,43,25-29,1924,2
STAT,1861,41,40-44,1902,1.904647357534543
SIM,1849,51,na,1900,1739
SIM,1873,65,na,1938,1709
STAT,1806,52,25-29,1858,0.011514746763847006
STAT,1823,70,na,1893,780.8849663662265
STAT,1859,51,30-34,1910,0.004872834782605296
STAT,1838,44,20-24,1882,0.1210406994747784
SIM,1847,39,50-100,1886,1
STAT,1834,25,25-29,1859,37.870048095024195
STAT,1850,30,25-29,1880,9.042689365027128
STAT,1931,24,na,1955,4800.117419985551
STAT,1851,51,25-29,1902,0.00293620391719169
SIM,1891,43,20-24,1934,4
STAT,1854,22,45-49,1876,0.6270767280504361
SIM,1926,37,50-100,1963,2
STAT,1802,102,na,1904,0.09302603674962602
SIM,1890,29,40-44,1919,2
STAT,1824,40,25-29,1864,0.8236236112385931
STAT,1828,44,50-100,1872,0.8363461274529104
STAT,1851,21,30-34,1872,17.67614010212773
STAT,1846,28,20-24,1874,10.076248959981074
SIM,1836,44,50-100,1880,3
STAT,1850,109,na,1959,0.0011761298927575486
STAT,1860,26,50-100,1886,0.5390259532066832
SIM,1908,27,50-100,1935,2
SIM,1887,24,na,1911,2689
STAT,1848,23,50-100,1871,0.3831953044202745
SIM,1893,41,30-34,1934,4
STAT,1881,42,20-24,1923,0.15644086289673376
STAT,1808,50,50-100,1858,0.037590000050152846
SIM,1863,43,45-49,1906,3
STAT,1867,53,30-34,1920,0.005609410607995091
STAT,1899,34,35-39,1933,14.026081635135004
STAT,1863,54,20-24,1917,6.418827864131806E-4
STAT,1829,107,na,1936,0.0031365046490416915
SIM,1823,38,40-44,1861,7
SIM,1856,23,50-100,1879,1
STAT,1891,31,25-29,1922,12.989254416330233
STAT,1846,53,45-49,1899,0.010211510924954885
STAT,1883,18,30-34,1901,1.5912282552715469
SIM,1874,25,40-44,1899,4
SIM,1909,10,na,1919,3802
STAT,1854,19,15-19,1873,5.369542029473222
STAT,1900,40,na,1940,3312.351926052216
SIM,1862,19,15-19,1881,5
STAT,1885,41,30-34,1926,1.175402409468743
SIM,1857,58,na,1915,1653
SIM,1897,45,30-34,1942,1
STAT,1866,25,40-44,1891,2.837859545264776
STAT,1831,35,20-24,1866,0.694492116991531
SIM,1867,44,40-44,1911,4
SIM,1864,42,50-100,1906,3
STAT,1877,42,35-39,1919,1.9136377385295726
SIM,1834,85,na,1919,107
SIM,1891,18,30-34,1909,3
STAT,1875,24,na,1899,2460.7294530750382
STAT,1883,40,30-34,1923,1.1623899321309987
STAT,1871,65,na,1936,1707.7487457023853
STAT,1904,38,35-39,1942,2.2209597046200753
STAT,1943,20,30-34,1963,31.21949621403899
STAT,1879,48,25-29,1927,0.060650277392223166
STAT,1894,46,50-100,1940,0.18230935061689485
SIM,1854,28,20-24,1882,10
STAT,1930,7,na,1937,5270.827199835283
SIM,1859,101,na,1960,3
STAT,1838,26,20-24,1864,11.043970307248017
STAT,1847,50,20-24,1897,5.837084426587633E-4
STAT,1889,45,30-34,1934,0.12319801067520948
SIM,1839,29,na,1868,1953
STAT,1907,15,25-29,1922,8.527555681955794
STAT,1861,18,45-49,1879,0.06291783446290437
SIM,1870,31,35-39,1901,24
STAT,1811,53,45-49,1864,0.037642066983547225
STAT,1893,32,25-29,1925,13.255430170668541
STAT,1902,27,50-100,1929,0.9202905771721168
STAT,1941,31,50-100,1972,0.8861241986191327
STAT,1810,49,45-49,1859,0.7163033319650964
STAT,1869,33,45-49,1902,1.7102573089152513
STAT,1898,36,20-24,1934,1.0685447799040382
SIM,1808,78,na,1886,373
SIM,1922,39,na,1961,4300
STAT,1939,28,50-100,1967,1.0202794470107712
STAT,1871,10,na,1881,2701.4972970644317
STAT,1871,25,15-19,1896,0.4615880539139244
STAT,1874,27,40-44,1901,3.1200650883550676
SIM,1867,80,na,1947,384
SIM,1879,28,25-29,1907,57
STAT,1841,24,25-29,1865,52.77830539939315
SIM,1848,42,30-34,1890,5
SIM,1882,27,40-44,1909,4
SIM,1836,33,na,1869,1990
SIM,1877,33,45-49,1910,2
STAT,1815,45,30-34,1860,0.2692465996033388
SIM,1824,52,na,1876,1296
STAT,1930,28,35-39,1958,19.461210470445998
STAT,1945,15,45-49,1960,0.5570393443526075
SIM,1951,20,30-34,1971,49
STAT,1854,21,50-100,1875,0.36936358135851366
SIM,1831,36,25-29,1867,4
SIM,1883,26,25-29,1909,3
STAT,1848,15,25-29,1863,5.525468397828686
STAT,1939,22,30-34,1961,29.445385015098996
SIM,1850,17,30-34,1867,3
SIM,1937,32,15-19,1969,1
STAT,1838,19,30-34,1857,1.528721836559808
SIM,1852,70,na,1922,1116
SIM,1859,6,na,1865,2747
STAT,1926,9,na,1935,4979.129838358689
SIM,1874,35,35-39,1909,11
STAT,1885,16,40-44,1901,0.18661205372017514
STAT,1773,89,na,1862,35.14873426939539
SIM,1941,30,15-19,1971,1
STAT,1807,53,50-100,1860,0.06114757097628751
SIM,1885,33,50-100,1918,1
SIM,1912,38,35-39,1950,4
STAT,1856,42,15-19,1898,0.011045344489623096
SIM,1864,39,40-44,1903,11
STAT,1828,29,15-19,1857,0.5144750562150671
STAT,1843,22,35-39,1865,5.913050202495251
STAT,1866,35,35-39,1901,6.71861542949849
STAT,1819,45,50-100,1864,0.5009343049563215
STAT,1897,43,15-19,1940,0.001298638427503095
STAT,1877,33,50-100,1910,0.9653754103183867
STAT,1920,39,30-34,1959,2.0320722600140817
SIM,1947,22,30-34,1969,40
SIM,1838,45,25-29,1883,1
SIM,1936,20,na,1956,3156
STAT,1929,32,15-19,1961,0.1664843269364238
STAT,1833,26,40-44,1859,2.6690656066668246
STAT,1850,70,na,1920,1055.3991950612628
STAT,1864,34,20-24,1898,2.4309046135173054
SIM,1841,26,40-44,1867,7
SIM,1841,33,30-34,1874,20
STAT,1879,2,na,1881,3444.2300251117304
STAT,1818,50,30-34,1868,0.013483256788515103
STAT,1791,74,na,1865,405.43136600002913
STAT,1890,27,25-29,1917,52.7641214869045
SIM,1909,7,na,1916,3819
STAT,1795,88,na,1883,42.23791642699697
SIM,1852,40,30-34,1892,3
STAT,1887,47,20-24,1934,0.013653649013820355
STAT,1907,40,15-19,1947,0.0014509422574352942
STAT,1949,19,45-49,1968,0.5923412524165924
SIM,1827,45,50-100,1872,2
STAT,1875,26,25-29,1901,44.44203010950042
STAT,1845,35,15-19,1880,0.0517227613817833
SIM,1828,38,20-24,1866,2
STAT,1814,51,20-24,1865,0.0021476166374023936
STAT,1844,25,50-100,1869,0.6156352833616973
STAT,1890,34,15-19,1924,0.17610954072463444
SIM,1893,34,40-44,1927,5
STAT,1842,42,20-24,1884,0.12885211866520904
SIM,1848,35,40-44,1883,7
SIM,1868,65,na,1933,1666
STAT,1842,29,na,1871,2067.8921310389387
STAT,1852,108,na,1960,0.004311136904730006
STAT,1787,70,na,1857,768.091731157336
STAT,1910,49,15-19,1959,3.4848029113418764E-4
STAT,1823,36,25-29,1859,5.573997118598697
SIM,1836,32,45-49,1868,2
SIM,1915,22,15-19,1937,4
STAT,1835,39,20-24,1874,0.6957443786489266
SIM,1864,51,na,1915,2008
STAT,1808,53,25-29,1861,0.008277128402415953
STAT,1889,82,na,1971,1058.0650100998525
STAT,1917,30,30-34,1947,16.9715305967517
STAT,1919,18,20-24,1937,152.48827979502346
SIM,1859,45,45-49,1904,1
STAT,1833,33,30-34,1866,14.754778891826794
SIM,1860,31,25-29,1891,15
STAT,1866,43,na,1909,2159.0973762047465
STAT,1766,102,na,1868,0.1140878801799626
STAT,1901,25,na,1926,3427.6620292225157
STAT,1844,52,45-49,1896,0.011185967520884764
STAT,1856,46,30-34,1902,0.07773786624561538
SIM,1851,48,45-49,1899,2
STAT,1813,47,20-24,1860,0.030159410558680193
SIM,1858,39,45-49,1897,3
STAT,1875,44,25-29,1919,0.663269857732515
STAT,1818,70,na,1888,777.9267264619798
STAT,1842,24,20-24,1866,67.1869508813367
STAT,1862,21,40-44,1883,1.8658432910970646
SIM,1895,29,20-24,1924,18
SIM,1797,88,na,1885,19
SIM,1850,24,20-24,1874,59
SIM,1892,79,na,1971,1509
SIM,1883,44,25-29,1927,3
SIM,1826,43,40-44,1869,1
STAT,1887,29,20-24,1916,13.31476549477958
STAT,1907,22,15-19,1929,4.941565071788948
STAT,1832,85,na,1917,183.18428805048478
SIM,1915,8,na,1923,4604
SIM,1872,16,20-24,1888,18
SIM,1927,18,20-24,1945,163
STAT,1874,23,25-29,1897,59.44060457540123
STAT,1857,50,30-34,1907,0.004810660477360098
STAT,1880,38,20-24,1918,0.8222740248723763
STAT,1818,43,40-44,1861,5.531080897306559
STAT,1843,48,45-49,1891,0.18812258506393065
STAT,1864,16,20-24,1880,18.389283649240664
STAT,1895,30,35-39,1925,13.587583723855582
STAT,1897,36,25-29,1933,3.9462327493601252
STAT,1910,21,30-34,1931,27.611383976489034
SIM,1859,24,40-44,1883,4
STAT,1818,48,na,1866,1410.430057691974
STAT,1824,66,na,1890,902.464082885899
STAT,1860,80,na,1940,512.0209683123442
SIM,1890,37,40-44,1927,9
STAT,1934,33,35-39,1967,12.716139621352172
STAT,1879,52,45-49,1931,0.015393001875582152
STAT,1909,49,25-29,1958,0.04942007765325733
STAT,1824,44,40-44,1868,2.6642035559782187
STAT,1916,42,30-34,1958,0.13369656884908607
STAT,1807,47,45-49,1854,1.0343887105172915
STAT,1834,40,20-24,1874,0.13218560476425634
STAT,1858,76,na,1934,766.4568230378903
STAT,1826,67,na,1893,924.5635298485606
STAT,1862,81,na,1943,469.59991385156724
SIM,1892,16,25-29,1908,13
STAT,1891,37,35-39,1928,8.933085234652872
SIM,1851,64,na,1915,1365
STAT,1915,38,na,1953,3859.058829856694
STAT,1921,31,15-19,1952,0.1465247404759045
SIM,1857,79,na,1936,505
STAT,1885,78,na,1963,1046.8781918740667
STAT,1857,35,20-24,1892,0.6199825268224531
STAT,1841,43,30-34,1884,0.8708436224747284
SIM,1832,44,40-44,1876,3
STAT,1906,48,45-49,1954,0.19518438432453675
STAT,1885,38,20-24,1923,0.7806622651566392
STAT,1923,45,40-44,1968,0.18906871791632746
STAT,1858,33,50-100,1891,0.738121606180432
STAT,1807,84,na,1891,140.58456347534928
STAT,1913,47,50-100,1960,0.22521232759614876
STAT,1850,41,30-34,1891,0.8686989505141887
STAT,1922,25,50-100,1947,1.1570255792770545
STAT,1873,46,30-34,1919,0.10039960579700082
STAT,1824,46,35-39,1870,0.16537871805860135
SIM,1839,38,30-34,1877,7
STAT,1874,38,45-49,1912,2.066041063183805
STAT,1912,33,15-19,1945,0.12844801439759276
SIM,1857,29,35-39,1886,16
STAT,1884,16,25-29,1900,5.733377271345263
STAT,1933,31,50-100,1964,1.1369538209178307
SIM,1839,30,na,1869,2042
SIM,1783,75,na,1858,354
SIM,1841,19,30-34,1860,4
STAT,1842,17,30-34,1859,1.6050612282605436
STAT,1847,39,na,1886,1867.0205413295598
STAT,1882,37,40-44,1919,4.350698604697297
STAT,1836,45,15-19,1881,2.673384541956875E-4
STAT,1900,0,na,1900,4151.832228552533
STAT,1846,20,45-49,1866,0.6242213253445487
STAT,1815,46,40-44,1861,0.46829845968290884
STAT,1891,35,40-44,1926,5.581284493024945
STAT,1892,18,50-100,1910,0.06247503428970012
SIM,1891,29,na,1920,3020
SIM,1881,39,40-44,1920,7
STAT,1869,15,45-49,1884,0.06600281278347976
STAT,1914,21,15-19,1935,5.340692037624367
STAT,1827,84,na,1911,215.00665168720792
STAT,1841,34,na,1875,1901.6117230158625
SIM,1922,21,15-19,1943,4
STAT,1907,19,na,1926,3762.7846454055966
SIM,1888,31,na,1919,2802
SIM,1854,20,45-49,1874,5
STAT,1923,4,na,1927,4835.689525431076
SIM,1900,33,45-49,1933,2
STAT,1859,48,20-24,1907,0.009653736861968127
SIM,1841,44,35-39,1885,3
STAT,1848,52,30-34,1900,0.004602481321960291
SIM,1926,23,50-100,1949,1
STAT,1914,47,40-44,1961,0.15953589946627106
SIM,1891,40,30-34,1931,2
STAT,1833,37,45-49,1870,1.6507234647813258
STAT,1823,40,45-49,1863,2.543192369429577
STAT,1826,41,25-29,1867,0.5356219202431477
SIM,1923,46,45-49,1969,1
STAT,1847,39,50-100,1886,0.9729385281301955
STAT,1879,19,20-24,1898,18.803524985346318
STAT,1882,44,30-34,1926,1.1272052742985124
STAT,1832,45,30-34,1877,0.07884641031739988
SIM,1874,43,35-39,1917,7
STAT,1860,30,20-24,1890,2.25534447673685
STAT,1911,58,na,1969,3365.40937518483
STAT,1850,34,40-44,1884,3.342344861150473
STAT,1784,72,na,1856,448.4061310158
STAT,1792,91,na,1883,16.7230378123933
SIM,1900,15,30-34,1915,2
STAT,1932,38,45-49,1970,0.9331702694021767
STAT,1937,16,15-19,1953,45.14516753865945
STAT,1958,8,na,1966,5264.124840937606
SIM,1945,16,15-19,1961,47
STAT,1769,95,na,1864,1.1939973927925416
STAT,1856,47,40-44,1903,0.13645840321248154
SIM,1864,47,40-44,1911,1
SIM,1828,30,45-49,1858,7
STAT,1866,43,35-39,1909,1.6916130240907752
STAT,1832,51,na,1883,1517.9532613630613
STAT,1833,44,35-39,1877,1.414834162269015
STAT,1851,17,25-29,1868,5.684125952977846
SIM,1774,92,na,1866,10
STAT,1809,49,20-24,1858,0.0516160838627662
STAT,1892,26,na,1918,3061.788973712915
STAT,1911,19,50-100,1930,0.07606410296617835
SIM,1871,32,50-100,1903,1
STAT,1841,14,na,1855,2252.72598
SIM,1867,89,na,1956,38
SIM,1890,44,30-34,1934,3
SIM,1907,27,35-39,1934,24
STAT,1948,20,30-34,1968,33.69225445255256
STAT,1917,29,na,1946,3980.5053676407897
STAT,1904,22,50-100,1926,0.5962164225518488
STAT,1915,46,45-49,1961,0.22403718633925995
STAT,1865,47,35-39,1912,0.12902207142149183
STAT,1898,29,30-34,1927,34.49145930560206
STAT,1933,19,35-39,1952,5.697754497928026
STAT,1880,49,25-29,1929,0.0604596351236948
STAT,1902,37,20-24,1939,0.23936321984423198
SIM,1781,74,na,1855,395
STAT,1815,53,30-34,1868,0.014994925113552847
SIM,1829,40,50-100,1869,1
STAT,1926,46,20-24,1972,0.013945217729788448
STAT,1886,32,50-100,1918,0.9893730356378613
STAT,1877,59,na,1936,2056.35213728762
SIM,1919,19,25-29,1938,52
STAT,1900,34,35-39,1934,14.19656739468818
SIM,1848,38,25-29,1886,5
SIM,1841,37,45-49,1878,2
STAT,1816,47,na,1863,1321.256668303604
STAT,1794,72,na,1866,572.6704013341355
STAT,1872,40,40-44,1912,2.3229313827395446
STAT,1887,21,45-49,1908,0.7995381817728202
SIM,1800,72,na,1872,549
SIM,1941,19,35-39,1960,4
STAT,1822,43,50-100,1865,1.5969125296097164
STAT,1888,11,na,1899,3119.205792002377
SIM,1920,26,25-29,1946,89
STAT,1809,65,na,1874,1059.832081099247
STAT,1928,18,15-19,1946,58.176135038999895
STAT,1860,15,25-29,1875,5.473863603291947
STAT,1875,78,na,1953,818.0636672758193
STAT,1881,45,25-29,1926,0.057375945041180335
SIM,1863,40,40-44,1903,5
STAT,1848,38,50-100,1886,0.9733325369794771
STAT,1923,36,50-100,1959,0.49681050087530915
SIM,1882,46,na,1928,2182
STAT,1912,26,25-29,1938,66.39559249262916
STAT,1891,42,30-34,1933,1.4502409231752906
STAT,1843,15,25-29,1858,5.915499489876645
SIM,1880,40,40-44,1920,5
SIM,1843,33,50-100,1876,1
STAT,1830,24,15-19,1854,7.763494140800189
SIM,1875,13,na,1888,2631
STAT,1844,37,20-24,1881,0.6312237145704862
STAT,1907,26,30-34,1933,37.84908310562063
STAT,1889,49,45-49,1938,0.16425232953355348
SIM,1883,41,20-24,1924,2
STAT,1874,42,30-34,1916,1.1959763178044023
STAT,1864,62,na,1926,1657.9025875036823
SIM,1840,38,40-44,1878,7
SIM,1842,81,na,1923,533
STAT,1854,47,50-100,1901,0.1870947628386224
STAT,1814,54,25-29,1868,0.009707693693230785
STAT,1840,47,30-34,1887,0.0702436074570927
SIM,1799,70,na,1869,804
SIM,1873,45,40-44,1918,2
SIM,1829,30,na,1859,1626
SIM,1879,17,20-24,1896,32
SIM,1882,42,30-34,1924,3
SIM,1888,41,na,1929,2705
STAT,1877,46,15-19,1923,4.244356693897153E-4
STAT,1945,18,15-19,1963,50.56403081990259
STAT,1854,35,50-100,1889,0.9540364173430826
STAT,1915,40,50-100,1955,0.12102882645885688
STAT,1794,62,na,1856,932.7802578000001
SIM,1836,87,na,1923,54
SIM,1851,15,25-29,1866,9
STAT,1875,41,20-24,1916,0.1670313092973939
SIM,1791,74,na,1865,397
SIM,1877,30,40-44,1907,8
STAT,1867,42,25-29,1909,0.6142569703579969
STAT,1865,45,40-44,1910,0.16009488649088302
STAT,1906,8,na,1914,3859.925163311833
SIM,1936,18,15-19,1954,42
STAT,1837,84,na,1921,221.7953834201245
SIM,1842,17,25-29,1859,10
STAT,1929,40,15-19,1969,0.0020340518481354497
SIM,1878,36,45-49,1914,3
STAT,1841,39,45-49,1880,1.6985399517215687
STAT,1846,16,50-100,1862,0.044271997255794504
SIM,1953,18,15-19,1971,65
STAT,1856,54,30-34,1910,0.004635737994159163
SIM,1898,37,25-29,1935,1
STAT,1843,15,na,1858,2396.212891856693
STAT,1851,34,na,1885,2006.9978710927799
STAT,1828,48,na,1876,1355.4703184580828
STAT,1824,32,na,1856,1603.9600852652632
STAT,1865,53,50-100,1918,0.013759155542998416
SIM,1901,8,na,1909,3847
SIM,1849,30,na,1879,1993
SIM,1889,39,25-29,1928,5
STAT,1857,28,30-34,1885,20.516719226151356
STAT,1868,16,40-44,1884,0.18251651835569568
SIM,1865,28,30-34,1893,37
SIM,1874,27,na,1901,2452
SIM,1876,16,40-44,1892,2
SIM,1819,95,na,1914,3
STAT,1915,17,50-100,1932,0.08001666068887506
STAT,1816,67,na,1883,804.5969215288443
STAT,1872,81,na,1953,552.8936647776383
STAT,1850,36,35-39,1886,5.460946956793783
STAT,1920,28,25-29,1948,73.42377225027086
SIM,1897,49,45-49,1946,1
SIM,1837,17,15-19,1854,5
STAT,1849,29,35-39,1878,8.752875661883412
STAT,1853,108,na,1961,0.005446732761886482
SIM,1888,2,na,1890,3147
STAT,1797,69,na,1866,712.757939833691
STAT,1898,11,na,1909,3568.0230749030393
STAT,1852,51,na,1903,1742.894800527038
SIM,1861,36,50-100,1897,1
STAT,1765,102,na,1867,0.028194212326692822
STAT,1899,27,25-29,1926,59.093803155697536
STAT,1903,33,20-24,1936,2.2412970165805963
SIM,1833,27,25-29,1860,44
SIM,1883,18,25-29,1901,10
SIM,1906,21,30-34,1927,30
STAT,1927,44,15-19,1971,0.001958104063404426
STAT,1849,95,na,1944,10.322131312035824
STAT,1920,35,15-19,1955,0.021493571264615506
SIM,1897,14,na,1911,3499
SIM,1851,54,na,1905,1686
STAT,1818,47,20-24,1865,0.027252047215986872
SIM,1841,41,30-34,1882,2
SIM,1911,33,20-24,1944,3
STAT,1908,43,35-39,1951,0.1888364755084561
STAT,1859,26,40-44,1885,2.500611091143644
STAT,1808,50,20-24,1858,0.0018366450263081094
STAT,1821,34,15-19,1855,0.38560810351663427
SIM,1828,78,na,1906,453
STAT,1907,44,45-49,1951,0.1535737180216462
STAT,1874,20,20-24,1894,72.20488509562867
STAT,1807,51,30-34,1858,0.025099306847773083
STAT,1882,15,50-100,1897,0.048918122585825986
STAT,1860,48,45-49,1908,0.1928861034446153
STAT,1824,51,30-34,1875,0.006826938570032269
SIM,1896,60,na,1956,2613
STAT,1924,44,30-34,1968,0.1546316097078976
STAT,1838,51,45-49,1889,0.010818411747657537
SIM,1882,35,40-44,1917,3
SIM,1860,1,na,1861,3085
STAT,1851,44,na,1895,1881.0745784382193
STAT,1849,36,25-29,1885,2.311172410321136
STAT,1800,105,na,1905,0.014131618595575197
STAT,1918,47,25-29,1965,0.05760448318320485
SIM,1823,69,na,1892,860
SIM,1893,30,25-29,1923,21
STAT,1909,38,50-100,1947,0.4032925285664168
STAT,1824,39,45-49,1863,2.5733550225745634
SIM,1866,9,na,1875,2750
SIM,1815,44,40-44,1859,7
STAT,1924,44,45-49,1968,0.20129970826837218
STAT,1864,52,na,1916,1942.7029725395166
STAT,1842,18,50-100,1860,0.049045299996601024
STAT,1919,28,15-19,1947,0.7756504442274683
SIM,1927,28,15-19,1955,1
STAT,1895,20,40-44,1915,2.790121085430377
SIM,1867,26,40-44,1893,3
SIM,1857,36,25-29,1893,6
SIM,1915,26,30-34,1941,54
STAT,1892,18,25-29,1910,7.226280424642789
STAT,1900,35,45-49,1935,2.8454594488699145
STAT,1904,34,50-100,1938,0.7626192371583282
STAT,1885,30,25-29,1915,10.50850074903247
STAT,1917,48,20-24,1965,0.011746766131315945
SIM,1832,39,45-49,1871,3
SIM,1900,30,40-44,1930,12
SIM,1876,38,20-24,1914,1
STAT,1857,38,25-29,1895,2.2825329862597816
STAT,1848,30,20-24,1878,2.5017656489867575
STAT,1844,47,15-19,1891,3.0851922389269317E-4
STAT,1831,99,na,1930,1.276127731051875
STAT,1849,85,na,1934,212.8271539041812
SIM,1901,32,35-39,1933,21
SIM,1823,90,na,1913,30
STAT,1858,45,50-100,1903,0.2006731601946285
SIM,1873,37,40-44,1910,5
SIM,1900,32,35-39,1932,21
STAT,1891,34,30-34,1925,21.862790195451737
SIM,1877,89,na,1966,195
STAT,1869,51,50-100,1920,0.014945995714500811
STAT,1904,31,15-19,1935,0.20906026913046452
SIM,1886,60,na,1946,2157
SIM,1884,27,na,1911,2616
STAT,1841,46,35-39,1887,0.10517688951886493
SIM,1904,11,na,1915,4037
STAT,1824,47,45-49,1871,0.2750412668218427
STAT,1934,30,30-34,1964,21.961858778203105
STAT,1819,65,na,1884,1042.4923609585596
SIM,1860,37,na,1897,2036
STAT,1873,97,na,1970,32.13098531002582
SIM,1871,20,45-49,1891,1
STAT,1851,40,20-24,1891,0.13234558607920308
STAT,1905,31,15-19,1936,0.12096845004659709
STAT,1857,59,na,1916,1548.3946023727926
STAT,1911,42,50-100,1953,0.11437423517769817
SIM,1874,28,25-29,1902,6
SIM,1808,48,na,1856,1500
STAT,1810,54,40-44,1864,0.030283833317450673
STAT,1844,96,na,1940,6.653898684137417
SIM,1811,88,na,1899,15
SIM,1848,35,20-24,1883,2
STAT,1848,48,45-49,1896,0.18114555117761538
STAT,1857,53,35-39,1910,0.006748871490618097
STAT,1897,40,45-49,1937,0.14319445115135557
SIM,1831,88,na,1919,86
STAT,1874,62,na,1936,1903.6950329725287
SIM,1861,54,na,1915,2214
STAT,1927,34,50-100,1961,1.0361351587165264
STAT,1881,48,30-34,1929,0.09427204808443447
SIM,1902,10,na,1912,3798
STAT,1871,48,20-24,1919,0.011973928695559218
SIM,1818,78,na,1896,297
STAT,1887,25,na,1912,2746.6228199761763
STAT,1834,32,na,1866,1865.4951833973737
SIM,1824,37,45-49,1861,5
STAT,1900,42,35-39,1942,0.17758050581698492
STAT,1816,44,35-39,1860,3.9041932846456415
STAT,1869,28,50-100,1897,0.6278206920429305
STAT,1909,46,20-24,1955,0.010382302107696001
SIM,1932,36,45-49,1968,1
STAT,1908,40,30-34,1948,0.1219813641912279
SIM,1857,28,25-29,1885,55
STAT,1761,105,na,1866,0.009342642636281505
STAT,1918,40,40-44,1958,0.2721359414041228
STAT,1832,53,30-34,1885,0.00407601400900315
STAT,1836,44,50-100,1880,0.7625307071379442
SIM,1919,10,na,1929,4537
SIM,1869,21,30-34,1890,41
SIM,1844,62,na,1906,1447
STAT,1863,49,25-29,1912,0.05044471173378546
STAT,1907,19,40-44,1926,0.27249887112708326
STAT,1824,43,30-34,1867,1.3887360924803072
SIM,1857,34,50-100,1891,1
STAT,1853,15,na,1868,2342.8366669810935
SIM,1889,29,30-34,1918,3
STAT,1883,35,35-39,1918,7.146987170835677
STAT,1924,36,45-49,1960,0.8208950834935017
STAT,1817,84,na,1901,162.35046010748698
STAT,1850,37,45-49,1887,1.5232559088572215
SIM,1881,84,na,1965,548
STAT,1920,33,20-24,1953,2.7149771282311335
SIM,1833,45,na,1878,1638
SIM,1934,31,35-39,1965,20
STAT,1924,43,35-39,1967,0.24398336540508964
STAT,1950,15,na,1965,4442.402552210016
SIM,1842,40,na,1882,1806
SIM,1837,35,45-49,1872,4
SIM,1954,0,na,1954,4840
STAT,1884,22,50-100,1906,0.41157576967976295
STAT,1920,49,na,1969,4119.996007700955
STAT,1822,48,25-29,1870,0.08093404410000984
STAT,1865,44,30-34,1909,1.0501125742082824
STAT,1831,34,na,1865,1850.8039118583358
STAT,1896,26,45-49,1922,1.5011045163102692
STAT,1933,16,30-34,1949,16.68072442160086
SIM,1923,43,40-44,1966,3
SIM,1875,23,na,1898,2336
STAT,1927,19,na,1946,4643.426967669436
STAT,1928,44,15-19,1972,0.0019902616223641386
STAT,1883,28,45-49,1911,1.107463009499783
SIM,1900,18,35-39,1918,1
STAT,1871,32,50-100,1903,0.9258886988492541
SIM,1938,32,30-34,1970,26
STAT,1837,30,45-49,1867,1.48834071508033
STAT,1897,35,na,1932,3244.159378837111
SIM,1820,72,na,1892,896
STAT,1938,30,15-19,1968,0.1319570504372176
SIM,1941,16,30-34,1957,14
SIM,1873,44,30-34,1917,2
STAT,1805,52,45-49,1857,0.05114190145544905
STAT,1912,41,15-19,1953,0.0015196336417659469
SIM,1856,30,20-24,1886,5
STAT,1865,37,40-44,1902,4.053142240863175
STAT,1887,59,na,1946,2221.6387565513937
STAT,1900,31,30-34,1931,24.7880502309395
SIM,1903,59,na,1962,2899
STAT,1891,38,45-49,1929,2.5052814626717126
SIM,1867,79,na,1946,480
SIM,1898,29,25-29,1927,92
STAT,1832,38,40-44,1870,3.6775014562664543
STAT,1944,7,na,1951,4345.2533451440895
SIM,1819,64,na,1883,963
STAT,1829,35,45-49,1864,1.7923364689588783
STAT,1926,31,35-39,1957,11.279163619250156
SIM,1937,18,50-100,1955,3
STAT,1846,50,40-44,1896,0.007636739738723748
SIM,1810,72,na,1882,872
STAT,1898,39,25-29,1937,0.8486934825916413
STAT,1814,66,na,1880,905.0356979194884
STAT,1931,21,15-19,1952,7.062413590225217
SIM,1848,28,30-34,1876,36
STAT,1842,34,35-39,1876,9.39657707873246
STAT,1915,43,40-44,1958,0.2565613655640707
SIM,1784,92,na,1876,5
STAT,1878,21,na,1899,2518.9354156540235
SIM,1891,43,35-39,1934,1
STAT,1883,43,35-39,1926,1.7994684631172237
STAT,1873,47,40-44,1920,0.1762380491244069
STAT,1890,45,na,1935,2834.2870274620514
STAT,1957,6,na,1963,5285.975655247134
SIM,1883,5,na,1888,2742
STAT,1840,44,25-29,1884,0.4698379047240056
SIM,1892,56,na,1948,2947
STAT,1850,44,35-39,1894,1.343717041765471
STAT,1804,66,na,1870,798.0612030315405
STAT,1929,18,50-100,1947,0.4863952926339771
SIM,1928,16,15-19,1944,67
STAT,1816,52,35-39,1868,0.016938131027713632
STAT,1849,51,20-24,1900,5.756325600769985E-4
SIM,1850,34,35-39,1884,19
STAT,1861,51,35-39,1912,0.0072918862506272724
STAT,1948,23,35-39,1971,11.026660834140928
STAT,1950,8,na,1958,4740.839842402756
SIM,1859,27,45-49,1886,1
SIM,1865,13,na,1878,2610
STAT,1925,17,35-39,1942,5.171556724148725
STAT,1857,45,35-39,1902,0.11265265734473456
STAT,1891,45,35-39,1936,0.1007354181679909
SIM,1871,30,na,1901,2242
SIM,1897,31,20-24,1928,6
STAT,1875,19,35-39,1894,0.5714233704557998
SIM,1914,11,na,1925,4149
STAT,1824,36,40-44,1860,6.285331110426787
SIM,1873,48,45-49,1921,2
SIM,1855,16,20-24,1871,22
STAT,1861,44,45-49,1905,1.2445906352613452
STAT,1910,31,50-100,1941,0.8164050208429411
SIM,1899,25,25-29,1924,7
SIM,1895,43,na,1938,3195
SIM,1845,19,15-19,1864,6
STAT,1820,50,35-39,1870,0.01570962860067009
SIM,1833,90,na,1923,46
STAT,1888,21,na,1909,2860.9077293859823
STAT,1824,54,35-39,1878,0.009302894564243437
STAT,1764,96,na,1860,2.4212110868272716
STAT,1821,99,na,1920,0.9979528713836705
SIM,1860,39,20-24,1899,4
SIM,1859,29,na,1888,2232
STAT,1875,18,25-29,1893,5.91758027522616
SIM,1832,36,40-44,1868,10
SIM,1808,68,na,1876,898
STAT,1830,47,20-24,1877,0.009958976214890777
SIM,1908,41,35-39,1949,1
SIM,1786,73,na,1859,425
SIM,1841,64,na,1905,1263
SIM,1933,17,35-39,1950,5
SIM,1831,40,45-49,1871,1
STAT,1917,19,na,1936,4007.220619180032
STAT,1847,16,20-24,1863,17.35711960158367
STAT,1866,40,30-34,1906,1.0927193160465496
SIM,1872,70,na,1942,1324
STAT,1889,31,20-24,1920,3.4201623165411053
SIM,1945,13,na,1958,4698
STAT,1789,108,na,1897,3.643740689931173E-4
STAT,1907,29,35-39,1936,14.22892431583546
STAT,1882,71,na,1953,1326.627398953232
SIM,1833,24,20-24,1857,64
STAT,1922,49,40-44,1971,0.18372881136293526
STAT,1846,54,20-24,1900,5.131907509790042E-4
SIM,1915,41,40-44,1956,1
SIM,1898,61,na,1959,2978
SIM,1870,21,50-100,1891,1
STAT,1890,31,45-49,1921,2.1840226704018546
SIM,1907,19,35-39,1926,2
STAT,1901,31,30-34,1932,25.00945767985482
SIM,1902,35,20-24,1937,1
STAT,1839,17,25-29,1856,5.115977388229073
STAT,1837,39,na,1876,1702.8663102362361
STAT,1919,42,15-19,1961,0.0016982592318334345
SIM,1891,35,35-39,1926,8
STAT,1787,69,na,1856,797.2718820400002
STAT,1883,12,na,1895,2585.002373899169
SIM,1793,75,na,1868,317
STAT,1881,15,45-49,1896,0.06472544364166836
STAT,1849,28,25-29,1877,38.650588544141876
SIM,1843,45,na,1888,1741
STAT,1873,39,40-44,1912,4.481863882837216
STAT,1867,28,40-44,1895,2.8588478430901065
STAT,1826,49,20-24,1875,0.009131970597648477
STAT,1859,95,na,1954,10.832074032244908
SIM,1847,17,25-29,1864,10
STAT,1806,48,40-44,1854,0.6012018807014776
STAT,1881,44,15-19,1925,0.01343647409122578
SIM,1911,24,na,1935,3735
STAT,1920,25,20-24,1945,20.573175933466533
SIM,1813,79,na,1892,352
SIM,1922,40,na,1962,4308
SIM,1872,41,45-49,1913,3
SIM,1874,40,30-34,1914,3
STAT,1859,18,40-44,1877,0.17195505077776296
SIM,1824,44,35-39,1868,1
STAT,1900,32,40-44,1932,6.131899164338429
STAT,1911,20,35-39,1931,9.163282847901009
STAT,1843,41,25-29,1884,0.5406295453406524
STAT,1870,27,20-24,1897,11.699338763015065
SIM,1881,46,30-34,1927,1
STAT,1824,86,na,1910,122.16842423135506
STAT,1836,67,na,1903,986.6943988333372
STAT,1842,42,35-39,1884,1.469194242785919
STAT,1885,33,50-100,1918,0.9285999954312293
SIM,1903,23,50-100,1926,1
STAT,1896,30,na,1926,3241.0486907765735
STAT,1832,46,40-44,1878,0.13766976374895734
STAT,1853,31,40-44,1884,3.7837540616038012
STAT,1851,54,30-34,1905,0.004775908718058289
STAT,1877,17,45-49,1894,0.06911682560860073
SIM,1915,29,35-39,1944,23
SIM,1888,48,40-44,1936,1
SIM,1821,44,50-100,1865,2
STAT,1855,25,45-49,1880,1.0001808120518851
STAT,1881,35,50-100,1916,1.2223949605449804
STAT,1852,39,20-24,1891,0.6147470668380687
STAT,1854,108,na,1962,0.005983863129092836
STAT,1850,33,30-34,1883,13.596810041810143
STAT,1904,22,na,1926,3457.856752400124
STAT,1892,15,20-24,1907,22.77233886005915
STAT,1919,52,na,1971,3997.8784751322505
STAT,1862,35,15-19,1897,0.049227746799293426
STAT,1864,41,45-49,1905,1.363718542107106
STAT,1924,40,15-19,1964,0.0018688106717167441
SIM,1898,41,na,1939,3563
STAT,1823,49,na,1872,1412.8412450298854
STAT,1948,2,na,1950,4695.599699800249
STAT,1885,48,15-19,1933,4.01995809097254E-4
STAT,1840,43,15-19,1883,0.010234324588645014
STAT,1891,27,40-44,1918,3.783391031027984
STAT,1863,20,45-49,1883,0.6453850156191424
STAT,1850,80,na,1930,465.3111180442821
STAT,1832,46,50-100,1878,0.1974982123367457
STAT,1795,98,na,1893,0.5811653364039736
SIM,1865,38,45-49,1903,6
STAT,1930,21,15-19,1951,6.976149187890302
STAT,1839,85,na,1924,189.1924615515602
STAT,1865,48,45-49,1913,0.21576744353605493
STAT,1837,19,15-19,1856,5.626059196347239
SIM,1856,63,na,1919,1737
STAT,1820,43,45-49,1863,2.89090089326131
SIM,1893,62,na,1955,2398
STAT,1837,50,na,1887,1498.9920765310246
STAT,1846,13,na,1859,2134.8082947116
STAT,1911,45,15-19,1956,3.57398017702221E-4
STAT,1843,19,40-44,1862,0.18647377252499256
SIM,1835,33,50-100,1868,4
SIM,1854,0,na,1854,3202
STAT,1916,34,45-49,1950,1.6436822144947454
STAT,1877,47,50-100,1924,0.25865440409799656
SIM,1915,22,35-39,1937,14
SIM,1846,25,45-49,1871,1
STAT,1865,30,20-24,1895,2.5228873586447924
STAT,1816,41,30-34,1857,2.858474507944735
STAT,1881,37,25-29,1918,2.8396871151457947
SIM,1845,16,na,1861,2264
SIM,1855,27,50-100,1882,5
STAT,1830,28,na,1858,1781.7020646407482
STAT,1856,33,na,1889,1914.3808662693477
SIM,1879,26,na,1905,2935
STAT,1829,31,na,1860,1917.1323529110982
SIM,1883,42,na,1925,2392
STAT,1799,71,na,1870,598.0496256330297
STAT,1910,32,35-39,1942,8.986824126747248
STAT,1851,29,50-100,1880,0.6090888870106018
STAT,1879,92,na,1971,176.58368958960793
SIM,1832,50,na,1882,1476
STAT,1858,52,25-29,1910,0.0028502609822708526
STAT,1831,43,20-24,1874,0.1328077432887364
STAT,1933,31,40-44,1964,5.381359154180247
STAT,1814,46,25-29,1860,0.17454652959237757
SIM,1850,31,30-34,1881,21
SIM,1899,18,35-39,1917,1
STAT,1951,21,na,1972,4452.334723400477
STAT,1863,46,20-24,1909,0.010763895254309215
STAT,1834,32,35-39,1866,8.729608750929195
SIM,1842,32,35-39,1874,16
SIM,1853,45,na,1898,1901
SIM,1868,75,na,1943,945
STAT,1823,44,25-29,1867,0.9880080700902931
SIM,1853,35,na,1888,1962
STAT,1886,30,na,1916,2597.4799738332904
SIM,1938,3,na,1941,4041
SIM,1851,10,na,1861,2340
SIM,1960,1,na,1961,5253
SIM,1875,44,50-100,1919,1
SIM,1930,25,50-100,1955,3
STAT,1826,98,na,1924,1.8946813779105667
SIM,1917,18,na,1935,3960
STAT,1831,35,50-100,1866,1.106128172452631
STAT,1920,41,50-100,1961,0.13259943503878072
STAT,1833,52,20-24,1885,5.030355655695872E-4
SIM,1895,5,na,1900,3637
STAT,1922,45,25-29,1967,0.06247241482883052
STAT,1860,45,40-44,1905,0.14311741535499214
SIM,1861,31,40-44,1892,5
SIM,1864,38,50-100,1902,3
STAT,1855,51,45-49,1906,0.01130382533983437
STAT,1785,102,na,1887,0.08910803722754575
STAT,1913,33,15-19,1946,0.1298798644093431
SIM,1813,70,na,1883,728
STAT,1893,21,50-100,1914,0.5293338104581476
SIM,1898,26,20-24,1924,20
STAT,1838,25,45-49,1863,1.0527967419155664
STAT,1859,44,50-100,1903,0.8490892297333934
STAT,1881,49,40-44,1930,0.1653252176446261
STAT,1859,29,45-49,1888,0.9070279661059896
STAT,1922,31,15-19,1953,0.14875584824327132
SIM,1868,40,40-44,1908,3
SIM,1857,25,20-24,1882,11
STAT,1839,41,na,1880,1702.2071342605643
STAT,1872,44,20-24,1916,0.1601833931597707
STAT,1883,25,40-44,1908,3.0187984377839103
STAT,1945,25,50-100,1970,1.1150932720985278
SIM,1855,39,50-100,1894,2
SIM,1826,43,na,1869,1595
STAT,1939,33,35-39,1972,9.505841158888021
STAT,1822,45,20-24,1867,0.017619656576574206
STAT,1842,31,30-34,1873,16.71290839664282
STAT,1942,24,45-49,1966,1.2027971935106225
SIM,1864,43,25-29,1907,2
STAT,1912,22,50-100,1934,0.6432864396316688
STAT,1866,51,20-24,1917,6.976823892947739E-4
STAT,1918,23,50-100,1941,0.7219599646873943
SIM,1892,42,25-29,1934,1
STAT,1920,43,15-19,1963,0.00172809537379695
SIM,1835,41,40-44,1876,1
SIM,1925,37,na,1962,4780
SIM,1831,44,25-29,1875,1
STAT,1863,50,40-44,1913,0.009551792921546263
SIM,1892,15,na,1907,3721
SIM,1855,13,na,1868,2201
SIM,1887,26,45-49,1913,2
STAT,1890,34,50-100,1924,1.1330820815380847
SIM,1875,16,25-29,1891,5
STAT,1839,40,20-24,1879,0.1302373670460783
SIM,1921,44,na,1965,4888
STAT,1843,52,50-100,1895,0.012127137568254858
STAT,1879,26,45-49,1905,1.1880403855550483
SIM,1817,73,na,1890,436
STAT,1890,35,25-29,1925,3.6254360516917163
STAT,1811,52,35-39,1863,0.022783553798788846
STAT,1924,33,40-44,1957,4.655163455295892
SIM,1885,77,na,1962,1104
STAT,1873,12,na,1885,2713.186007813154
STAT,1888,65,na,1953,2038.1289330238096
SIM,1890,8,na,1898,3418
SIM,1882,20,20-24,1902,96
SIM,1816,42,35-39,1858,6
SIM,1932,33,40-44,1965,9
STAT,1907,22,35-39,1929,8.740889498333221
STAT,1867,50,25-29,1917,0.0034410468066493898
STAT,1894,32,50-100,1926,1.2023140998007642
SIM,1792,80,na,1872,249
SIM,1880,44,20-24,1924,1
STAT,1840,48,40-44,1888,0.12265101593398375
STAT,1855,47,25-29,1902,0.044443253205936735
SIM,1839,61,na,1900,1393
STAT,1875,33,35-39,1908,10.55840073971592
STAT,1867,16,25-29,1883,5.581104943461449
STAT,1892,30,30-34,1922,22.50276730728804
SIM,1917,9,na,1926,4261
STAT,1805,53,20-24,1858,0.002548775740269117
STAT,1890,49,35-39,1939,0.09644756760432566
STAT,1855,18,20-24,1873,16.249800332154628
STAT,1817,51,25-29,1868,0.007739863458883581
STAT,1811,45,45-49,1856,0.6790258965759163
STAT,1949,23,50-100,1972,0.783076664905973
STAT,1924,40,30-34,1964,0.15557847739315192
SIM,1863,18,20-24,1881,17
STAT,1894,32,40-44,1926,5.690718363512524
STAT,1894,46,15-19,1940,2.969205170514939E-4
SIM,1858,24,25-29,1882,54
STAT,1870,37,15-19,1907,0.056000849754366464
SIM,1888,10,na,1898,3074
STAT,1882,40,15-19,1922,0.01386376255108782
STAT,1884,42,25-29,1926,0.647319989868096
STAT,1800,73,na,1873,612.0958618153372
STAT,1827,41,40-44,1868,2.716154264770525
STAT,1899,22,50-100,1921,0.5696708446379641
STAT,1920,36,25-29,1956,1.101130214496107
STAT,1935,17,na,1952,5131.456754783884
SIM,1883,33,35-39,1916,15
SIM,1838,19,25-29,1857,9
STAT,1839,31,na,1870,1859.8662259232233
STAT,1939,15,20-24,1954,138.78079863693128
SIM,1890,33,25-29,1923,25
STAT,1790,68,na,1858,746.0096750968363
SIM,1859,16,40-44,1875,1
STAT,1868,42,40-44,1910,2.1889226955252923
SIM,1804,96,na,1900,8
SIM,1842,50,na,1892,1616
SIM,1879,24,45-49,1903,1
SIM,1807,83,na,1890,50
SIM,1894,30,40-44,1924,2
STAT,1835,54,45-49,1889,0.010595865950635107
SIM,1923,40,50-100,1963,1
SIM,1865,42,30-34,1907,4
SIM,1954,17,na,1971,4398
STAT,1869,16,40-44,1885,0.18371940208128199
SIM,1855,19,25-29,1874,15
SIM,1866,53,na,1919,2242
STAT,1828,40,45-49,1868,1.2642647048445559
SIM,1862,35,50-100,1897,1
STAT,1808,80,na,1888,237.1568566861074
STAT,1864,45,25-29,1909,0.052768830268052756
SIM,1858,75,na,1933,817
STAT,1921,3,na,1924,4717.867551288926
STAT,1858,19,35-39,1877,0.5124552705330152
STAT,1797,90,na,1887,32.077859971550524
STAT,1949,18,35-39,1967,4.97740953550953
STAT,1927,41,45-49,1968,0.2132249849764531
STAT,1820,36,20-24,1856,1.9827962801624937
STAT,1912,23,20-24,1935,108.37305321347559
STAT,1921,35,30-34,1956,2.08023631656907
SIM,1834,31,na,1865,1866
STAT,1901,20,40-44,1921,2.990455216774253
SIM,1920,23,20-24,1943,162
STAT,1874,53,20-24,1927,7.562481676724631E-4
STAT,1835,33,50-100,1868,0.8605018817625842
STAT,1901,49,20-24,1950,0.009454893212041638
STAT,1893,47,45-49,1940,0.17147832070175856
SIM,1823,42,25-29,1865,2
SIM,1837,28,na,1865,1698
SIM,1876,42,40-44,1918,11
SIM,1897,55,na,1952,2798
SIM,1924,16,30-34,1940,22
STAT,1789,71,na,1860,477.074733011606
SIM,1889,26,na,1915,3052
STAT,1849,25,20-24,1874,10.953208284714854
STAT,1890,42,15-19,1932,0.01720430207403051
STAT,1842,50,20-24,1892,5.869956532096653E-4
SIM,1855,45,25-29,1900,1
STAT,1882,33,25-29,1915,10.136927964762702
SIM,1827,83,na,1910,152
SIM,1803,70,na,1873,540
SIM,1819,40,45-49,1859,1
STAT,1886,30,40-44,1916,4.720480279650957
STAT,1866,25,20-24,1891,11.11383770699506
STAT,1822,52,45-49,1874,0.019891286948742898
SIM,1822,50,na,1872,1349
SIM,1884,22,50-100,1906,1
STAT,1878,31,45-49,1909,1.859264382682086
STAT,1932,35,40-44,1967,2.0547760656567777
STAT,1910,5,na,1915,4050.107100665407
SIM,1825,29,40-44,1854,4
STAT,1866,33,na,1899,2235.971758798097
SIM,1839,41,25-29,1880,2
STAT,1762,105,na,1867,0.01906459656359603
STAT,1932,21,30-34,1953,38.574616609344254
SIM,1821,88,na,1909,24
SIM,1849,19,35-39,1868,1
SIM,1834,21,na,1855,1914
STAT,1898,32,25-29,1930,14.13020961973412
SIM,1874,25,20-24,1899,20
STAT,1934,19,50-100,1953,0.5140220908223755
SIM,1857,18,30-34,1875,3
SIM,1886,31,45-49,1917,3
STAT,1884,62,na,1946,1844.697260920444
STAT,1882,47,35-39,1929,0.13849406528330846
SIM,1889,36,na,1925,3089
STAT,1916,16,30-34,1932,2.6454818022974744
STAT,1873,22,na,1895,2446.050533815413
STAT,1857,31,25-29,1888,8.296560785370524
SIM,1923,21,30-34,1944,40
STAT,1901,16,50-100,1917,0.07006244674472144
SIM,1891,32,30-34,1923,33
SIM,1908,15,35-39,1923,1
SIM,1834,34,50-100,1868,2
STAT,1866,18,30-34,1884,1.5303389727725676
SIM,1904,42,na,1946,3595
STAT,1849,18,30-34,1867,1.514190997739439
STAT,1883,51,20-24,1934,7.421658730033811E-4
SIM,1869,24,35-39,1893,5
STAT,1810,102,na,1912,0.12499027040313135
STAT,1834,86,na,1920,149.10468740008952
SIM,1824,34,40-44,1858,5
STAT,1938,17,50-100,1955,0.3770017422172857
SIM,1866,63,na,1929,1894
SIM,1874,82,na,1956,424
SIM,1881,35,25-29,1916,4
SIM,1929,9,na,1938,5441
STAT,1934,22,na,1956,5004.7579413222975
STAT,1876,48,20-24,1924,0.012482316563061245
STAT,1830,102,na,1932,0.18546019511052064
STAT,1880,24,50-100,1904,0.43442667532225465
STAT,1917,40,na,1957,3966.2053051917287
STAT,1922,41,na,1963,4355.897865649116
STAT,1915,21,30-34,1936,30.408466985275716
STAT,1852,50,30-34,1902,0.004864295304205533
STAT,1887,80,na,1967,1080.2445268964643
SIM,1873,42,na,1915,2323
STAT,1886,40,na,1926,2520.887223328062
SIM,1865,31,25-29,1896,13
STAT,1793,86,na,1879,77.85352797292893
STAT,1883,32,30-34,1915,17.47657365244244
STAT,1830,73,na,1903,751.3630014293648
SIM,1826,34,50-100,1860,1
SIM,1874,18,30-34,1892,1
STAT,1840,28,na,1868,1927.0228426255042
STAT,1916,41,35-39,1957,0.21088580899488799
STAT,1873,42,15-19,1915,0.014265226024425157
STAT,1893,40,25-29,1933,0.8394308009230671
SIM,1939,16,25-29,1955,53
SIM,1907,16,30-34,1923,6
STAT,1821,102,na,1923,0.1544854090138125
SIM,1780,88,na,1868,43
STAT,1821,68,na,1889,802.6844632260883
STAT,1911,38,25-29,1949,0.9652443709070173
STAT,1869,41,45-49,1910,1.480723273905963
SIM,1901,24,na,1925,3491
STAT,1906,45,40-44,1951,0.1448226912324148
SIM,1854,82,na,1936,446
STAT,1812,44,15-19,1856,0.034684896441249884
STAT,1906,31,30-34,1937,14.946962577081282
SIM,1881,30,na,1911,2244
STAT,1914,22,na,1936,3806.562489530911
SIM,1912,30,na,1942,3954
STAT,1892,41,20-24,1933,0.2039710531230745
SIM,1849,26,25-29,1875,37
STAT,1868,45,na,1913,2214.026401628751
SIM,1853,36,50-100,1889,3
STAT,1847,19,25-29,1866,5.450553715540691
STAT,1856,7,na,1863,2343.6922965878957
SIM,1919,18,15-19,1937,64
STAT,1825,50,20-24,1875,9.521523197779202E-4
STAT,1925,43,35-39,1968,0.24833588376817317
STAT,1841,32,25-29,1873,9.175756956282331
STAT,1875,15,20-24,1890,18.648202856826387
STAT,1832,49,45-49,1881,0.16617787705466275
SIM,1824,41,30-34,1865,3
SIM,1860,43,40-44,1903,3
STAT,1931,36,50-100,1967,0.5676015759232438
SIM,1840,49,45-49,1889,2
SIM,1877,41,45-49,1918,5
SIM,1932,22,35-39,1954,16
STAT,1864,49,40-44,1913,0.15205010292478277
STAT,1922,42,20-24,1964,0.020683225127251004
SIM,1833,35,na,1868,1888
SIM,1850,20,25-29,1870,59
STAT,1845,108,na,1953,0.0014312116366327014
STAT,1895,44,na,1939,3045.242042964156
STAT,1817,94,na,1911,9.753856122234614
STAT,1874,35,40-44,1909,4.602741496200327
STAT,1881,34,20-24,1915,2.6431408237972946
SIM,1878,41,na,1919,2597
STAT,1930,33,15-19,1963,0.16903752055833235
SIM,1823,49,45-49,1872,1
STAT,1901,30,35-39,1931,14.563188975038043
STAT,1810,73,na,1883,512.0397856177141
STAT,1831,46,25-29,1877,0.0477184493768114
STAT,1879,51,na,1930,2307.0268214973335
SIM,1899,36,na,1935,3270
SIM,1866,26,25-29,1892,45
STAT,1912,48,35-39,1960,0.12604960659547637
STAT,1922,5,na,1927,4748.029152771651
SIM,1924,31,40-44,1955,11
STAT,1853,49,30-34,1902,0.0794719747248033
STAT,1847,60,na,1907,1487.2435285710735
STAT,1908,59,na,1967,3185.8737714079225
SIM,1782,80,na,1862,185
STAT,1865,1,na,1866,3328.4431856045703
SIM,1844,31,na,1875,2061
STAT,1820,46,15-19,1866,7.403373337024471E-4
SIM,1849,23,20-24,1872,3
STAT,1830,46,25-29,1876,0.048427410723212855
STAT,1861,34,na,1895,1994.3620467379026
SIM,1943,22,na,1965,3621
STAT,1880,48,na,1928,2381.5903779849677
STAT,1787,90,na,1877,35.881432337745785
SIM,1911,36,25-29,1947,3
STAT,1815,49,45-49,1864,0.614091664993978
STAT,1870,21,50-100,1891,0.4079019481302701
SIM,1846,28,50-100,1874,4
STAT,1918,44,20-24,1962,0.019097568741750365
SIM,1900,44,35-39,1944,2
STAT,1844,41,40-44,1885,1.808129504348612
STAT,1890,46,30-34,1936,0.06830203386977458
STAT,1847,50,50-100,1897,0.011946565653420225
STAT,1903,23,50-100,1926,0.5895359254295883
STAT,1880,46,20-24,1926,0.012900880136249114
STAT,1882,81,na,1963,781.493019428889
STAT,1834,108,na,1942,0.0012309503898762617
SIM,1818,68,na,1886,784
SIM,1797,68,na,1865,710
STAT,1900,43,30-34,1943,0.11206768832615487
STAT,1875,52,25-29,1927,0.003688782849781865
STAT,1891,41,na,1932,2932.299249121537
STAT,1876,40,25-29,1916,0.6832928856399478
SIM,1803,69,na,1872,600
STAT,1939,30,30-34,1969,16.41739925134056
STAT,1776,112,na,1888,7.490411104599845E-4
STAT,1833,41,30-34,1874,0.9337206310648961
STAT,1835,47,20-24,1882,0.009428172569866977
STAT,1897,44,25-29,1941,0.06000503901022472
STAT,1902,30,35-39,1932,14.686367724132536
SIM,1940,9,na,1949,4133
SIM,1950,21,40-44,1971,3
STAT,1911,42,45-49,1953,0.16203016696605738
SIM,1940,21,30-34,1961,35
STAT,1912,30,45-49,1942,1.592244541694293
SIM,1899,29,40-44,1928,10
STAT,1858,26,25-29,1884,35.28644245033545
STAT,1923,48,45-49,1971,0.25869001218692017
STAT,1814,43,20-24,1857,0.5191587395077016
STAT,1891,20,20-24,1911,87.55564609430343
STAT,1924,22,35-39,1946,11.33566004005959
STAT,1933,34,45-49,1967,2.159835928091858
STAT,1863,53,45-49,1916,0.012772235418301303
STAT,1903,36,25-29,1939,0.9055415220215934
SIM,1906,32,35-39,1938,13
STAT,1820,52,50-100,1872,0.02648276080731178
STAT,1914,43,25-29,1957,0.0720799921105641
SIM,1852,41,40-44,1893,4
STAT,1875,88,na,1963,286.1417807202439
STAT,1897,48,40-44,1945,0.1300713080502339
STAT,1904,43,15-19,1947,0.0013919676981964998
STAT,1904,56,na,1960,3084.6456240674916
SIM,1910,30,35-39,1940,13
STAT,1931,24,50-100,1955,0.8649045330346927
STAT,1871,47,25-29,1918,0.05793485782880261
STAT,1825,42,35-39,1867,2.47255134191457
STAT,1838,45,na,1883,1744.816794252244
STAT,1825,72,na,1897,757.3111249079303
SIM,1884,37,na,1921,2506
STAT,1861,47,15-19,1908,3.3561502944701914E-4
SIM,1871,64,na,1935,1583
STAT,1840,40,45-49,1880,1.266598631571886
STAT,1882,26,na,1908,2380.0499153851288
STAT,1868,11,na,1879,2614.243588077879
STAT,1920,47,30-34,1967,0.10056246818062005
STAT,1824,50,50-100,1874,0.017668480361855643
STAT,1900,9,na,1909,3668.680788392366
STAT,1926,23,50-100,1949,0.8129800097924673
SIM,1841,34,40-44,1875,6
STAT,1916,19,35-39,1935,0.9036361645485768
STAT,1875,30,30-34,1905,18.427451486868414
STAT,1833,34,40-44,1867,3.6254703154893577
STAT,1848,45,na,1893,1766.311272065107
SIM,1804,55,na,1859,1283
STAT,1838,18,20-24,1856,17.10464412067065
SIM,1836,40,45-49,1876,1
STAT,1815,72,na,1887,707.3850550890212
SIM,1934,23,50-100,1957,1
STAT,1865,40,15-19,1905,0.012915581316628729
STAT,1867,54,40-44,1921,0.009805397145480442
SIM,1898,15,15-19,1913,7
SIM,1927,18,na,1945,4519
SIM,1865,23,na,1888,2282
SIM,1904,1,na,1905,4120
STAT,1838,28,50-100,1866,0.5935888114759557
SIM,1913,56,na,1969,3572
SIM,1837,40,50-100,1877,3
STAT,1823,48,40-44,1871,0.2537519309256933
STAT,1842,20,25-29,1862,57.44432038993634
STAT,1829,40,50-100,1869,0.9110188988622351
SIM,1922,19,na,1941,4293
SIM,1893,45,45-49,1938,1
STAT,1862,32,45-49,1894,1.5143352483269115
SIM,1875,67,na,1942,1553
STAT,1895,31,45-49,1926,2.3305316900272706
SIM,1858,28,40-44,1886,4
STAT,1863,12,na,1875,2436.542291049419
STAT,1878,11,na,1889,2754.7729827483836
STAT,1885,45,45-49,1930,0.2425904445122472
STAT,1892,41,50-100,1933,1.3568508927361353
SIM,1827,28,na,1855,1693
STAT,1865,78,na,1943,723.4381625708236
STAT,1890,39,40-44,1929,5.405265921689165
SIM,1848,34,na,1882,2000
STAT,1933,36,na,1969,5230.704646731434
STAT,1782,91,na,1873,17.421843147696816
SIM,1860,68,na,1928,1527
SIM,1928,30,50-100,1958,4
STAT,1901,23,45-49,1924,0.9917105478226198
SIM,1912,19,na,1931,4046
STAT,1820,39,25-29,1859,6.2465187431519835
STAT,1940,23,30-34,1963,29.859211863949497
STAT,1818,54,45-49,1872,0.030346873370248592
SIM,1849,16,30-34,1865,3
STAT,1843,29,50-100,1872,0.6264368386703131
STAT,1949,15,30-34,1964,14.470486310446017
STAT,1869,92,na,1961,82.76937111736756
SIM,1856,48,45-49,1904,1
SIM,1813,69,na,1882,728
SIM,1851,29,50-100,1880,1
STAT,1897,25,na,1922,3277.390075469789
SIM,1914,41,25-29,1955,1
STAT,1908,15,na,1923,3838.1056983318695
STAT,1867,59,na,1926,1861.3172412167312
STAT,1841,36,40-44,1877,3.847845621812404
SIM,1922,30,na,1952,4349
SIM,1844,42,45-49,1886,4
STAT,1908,17,35-39,1925,0.8300043760041288
STAT,1860,52,30-34,1912,0.004900781071344599
STAT,1885,21,50-100,1906,0.4162934741583694
SIM,1840,17,na,1857,2056
STAT,1874,45,35-39,1919,0.14727240915544895
STAT,1868,19,45-49,1887,0.06403941650774353
SIM,1832,27,50-100,1859,1
STAT,1814,50,45-49,1864,0.04309049758225797
STAT,1909,55,na,1964,3334.8400791484664
SIM,1843,35,na,1878,1931
SIM,1838,16,20-24,1854,22
STAT,1842,20,na,1862,2145.5495652771297
STAT,1936,26,50-100,1962,0.9720014080778193
STAT,1911,35,20-24,1946,0.2621800638494572
STAT,1917,41,35-39,1958,0.21475894145053728
STAT,1939,18,25-29,1957,44.236485052768316
SIM,1883,30,30-34,1913,8
STAT,1889,46,40-44,1935,0.21634910540115374
SIM,1924,19,35-39,1943,8
STAT,1787,79,na,1866,327.2941474499979
SIM,1914,52,na,1966,3658
SIM,1916,17,35-39,1933,2
STAT,1864,15,45-49,1879,0.06815856504553171
STAT,1861,37,20-24,1898,0.6498011306758268
SIM,1812,84,na,1896,140
STAT,1834,51,25-29,1885,0.0024929405024812644
STAT,1869,19,45-49,1888,0.06446147130369953
STAT,1872,4,na,1876,3004.5724833823006
STAT,1856,43,25-29,1899,0.5105268335579899
SIM,1961,10,na,1971,5323
SIM,1891,21,25-29,1912,95
SIM,1915,37,na,1952,4267
SIM,1862,30,45-49,1892,4
STAT,1842,61,na,1903,1465.392622653205
STAT,1857,60,na,1917,1519.486075146493
STAT,1892,33,35-39,1925,12.89343972237488
STAT,1870,41,35-39,1911,1.814028110559433
STAT,1866,74,na,1940,1044.2779576825947
SIM,1860,46,45-49,1906,2
SIM,1835,57,na,1892,1388
STAT,1842,53,25-29,1895,0.0027330644654677476
SIM,1877,19,45-49,1896,3
SIM,1832,50,50-100,1882,1
SIM,1861,3,na,1864,3120
STAT,1872,47,25-29,1919,0.058617390149790546
STAT,1784,102,na,1886,0.07350639897876624
STAT,1775,112,na,1887,7.283763596258631E-4
STAT,1942,21,40-44,1963,3.597956365673436
SIM,1809,54,na,1863,967
SIM,1925,41,35-39,1966,2
SIM,1839,19,25-29,1858,9
STAT,1763,105,na,1868,0.007002578834581332
STAT,1818,79,na,1897,356.27578113968093
SIM,1893,21,50-100,1914,1
SIM,1828,68,na,1896,908
STAT,1844,86,na,1930,171.93438100269475
SIM,1847,18,20-24,1865,16
SIM,1861,64,na,1925,1782
STAT,1876,18,40-44,1894,0.19217064638306774
STAT,1883,21,25-29,1904,57.47387501165651
SIM,1882,38,45-49,1920,2
SIM,1940,31,25-29,1971,14
STAT,1854,30,45-49,1884,1.3954351455768461
STAT,1924,22,na,1946,4396.336413034501
STAT,1881,41,na,1922,2289.8378535634283
SIM,1918,49,50-100,1967,2
STAT,1840,46,50-100,1886,0.1805193956556235
SIM,1881,32,20-24,1913,5
SIM,1811,43,45-49,1854,2
SIM,1852,50,na,1902,1819
SIM,1888,41,20-24,1929,1
SIM,1822,84,na,1906,184
SIM,1785,87,na,1872,39
SIM,1939,27,30-34,1966,50
STAT,1839,18,20-24,1857,15.911217716644625
STAT,1866,28,25-29,1894,39.66426434420621
STAT,1870,34,45-49,1904,1.7241597818038177
STAT,1843,49,20-24,1892,0.009485013558146677
STAT,1903,43,15-19,1946,0.0013806371207343408
SIM,1889,4,na,1893,3423
SIM,1815,47,45-49,1862,1
STAT,1836,42,45-49,1878,1.1082892818309438
STAT,1853,45,15-19,1898,3.3874297834412127E-4
SIM,1906,23,na,1929,3506
STAT,1881,41,45-49,1922,1.4827814019395962
SIM,1824,30,25-29,1854,11
STAT,1956,7,na,1963,5304.59190770129
SIM,1864,82,na,1946,400
SIM,1876,63,na,1939,2011
STAT,1925,40,30-34,1965,0.1583539050483527
SIM,1872,49,40-44,1921,3
SIM,1891,30,na,1921,3098
SIM,1887,19,20-24,1906,20
STAT,1874,52,na,1926,2230.718515816437
STAT,1828,79,na,1907,384.97400855649187
STAT,1912,41,na,1953,3675.1097302130365
STAT,1858,45,na,1903,1838.2844416967173
SIM,1839,20,na,1859,1998
STAT,1873,32,20-24,1905,2.7956373777257886
STAT,1906,41,25-29,1947,0.0665128828774427
SIM,1879,81,na,1960,875
STAT,1905,6,na,1911,3848.9024202394685
SIM,1949,16,35-39,1965,5
STAT,1927,40,na,1967,4764.511941805587
STAT,1896,16,50-100,1912,0.06617149681520207
SIM,1826,87,na,1913,70
STAT,1847,27,50-100,1874,0.5995807588058153
STAT,1916,31,40-44,1947,4.139826476502525
STAT,1807,54,35-39,1861,0.034155567870211075
SIM,1820,48,30-34,1868,1
STAT,1896,40,na,1936,3156.341884525224
SIM,1878,39,50-100,1917,5
STAT,1893,44,40-44,1937,0.19940985020599256
SIM,1822,50,45-49,1872,1
STAT,1848,45,40-44,1893,0.13440617351181977
STAT,1852,53,35-39,1905,0.006824115743565257
SIM,1944,26,50-100,1970,1
STAT,1812,48,30-34,1860,0.22520417674865478
STAT,1851,32,35-39,1883,8.696063228263807
SIM,1882,15,na,1897,2469
STAT,1831,68,na,1899,1029.7318875281057
SIM,1814,41,20-24,1855,1
SIM,1848,75,na,1923,709
STAT,1826,53,40-44,1879,0.007787154526742046
STAT,1867,19,35-39,1886,0.530925166212594
STAT,1929,16,30-34,1945,15.904597622553817
SIM,1839,24,20-24,1863,90
SIM,1896,51,na,1947,2908
STAT,1839,19,na,1858,2048.0072061961664
SIM,1938,32,na,1970,3798
STAT,1954,10,na,1964,4954.558652421977
STAT,1831,90,na,1921,53.124444609163625
STAT,1908,42,45-49,1950,0.15701571124590494
STAT,1898,15,20-24,1913,24.571071284824928
STAT,1950,17,35-39,1967,5.061751768358719
STAT,1909,35,15-19,1944,0.018713817116633235
SIM,1935,19,30-34,1954,20
SIM,1781,75,na,1856,343
STAT,1843,24,na,1867,2135.5496190270974
STAT,1901,25,45-49,1926,1.5946812457440167
STAT,1905,44,15-19,1949,0.0013938405765107067
SIM,1924,30,30-34,1954,22
STAT,1903,22,45-49,1925,1.0112310981661903
SIM,1855,77,na,1932,633
SIM,1868,29,45-49,1897,2
STAT,1904,15,15-19,1919,8.717017133483589
STAT,1913,36,na,1949,3805.849585627761
STAT,1835,80,na,1915,460.89499181026184
SIM,1931,28,30-34,1959,53
STAT,1860,49,20-24,1909,0.009725186934511455
STAT,1923,31,30-34,1954,18.503791103111045
STAT,1932,37,40-44,1969,2.0512228363370903
STAT,1927,19,30-34,1946,15.376670472428337
SIM,1907,33,35-39,1940,12
STAT,1864,54,30-34,1918,0.0052509709780968325
SIM,1876,32,25-29,1908,4
SIM,1851,27,50-100,1878,1
SIM,1945,22,15-19,1967,9
SIM,1903,28,25-29,1931,68
STAT,1868,32,25-29,1900,9.980059236584031
SIM,1909,43,na,1952,3365
STAT,1853,48,20-24,1901,0.009935555434528653
SIM,1920,25,20-24,1945,6
STAT,1911,41,35-39,1952,0.1971732226406671
STAT,1855,105,na,1960,0.06021305679565297
SIM,1883,22,15-19,1905,4
STAT,1903,47,15-19,1950,3.2567973092428453E-4
SIM,1851,87,na,1938,31
STAT,1943,27,45-49,1970,1.877184525863894
STAT,1900,61,na,1961,2780.5070535793398
STAT,1835,29,na,1864,2070.442180794343
STAT,1801,102,na,1903,0.10460430394138409
SIM,1937,16,30-34,1953,26
SIM,1804,85,na,1889,128
SIM,1859,36,40-44,1895,6
STAT,1873,46,na,1919,2333.50337444286
STAT,1866,32,15-19,1898,0.13400137498160664
STAT,1844,65,na,1909,1309.571193927996
SIM,1862,33,50-100,1895,1
SIM,1910,18,15-19,1928,14
SIM,1928,29,40-44,1957,8
SIM,1880,76,na,1956,744
STAT,1848,79,na,1927,543.4376607581246
SIM,1900,16,35-39,1916,1
STAT,1902,18,15-19,1920,8.515345962271537
STAT,1935,22,50-100,1957,0.9137680997839316
SIM,1947,17,na,1964,4357
SIM,1848,17,25-29,1865,6
SIM,1878,50,50-100,1928,1
STAT,1830,25,50-100,1855,0.8844979945348894
STAT,1906,47,40-44,1953,0.14272461721443222
SIM,1905,38,30-34,1943,2
STAT,1886,16,40-44,1902,0.1979860013768019
STAT,1787,109,na,1896,3.236166377279222E-4
STAT,1832,109,na,1941,4.754172987997961E-4
STAT,1912,25,20-24,1937,18.47500868872454
STAT,1934,32,45-49,1966,2.1910041155766216
STAT,1896,39,na,1935,3142.385700252011
SIM,1925,37,45-49,1962,1
STAT,1841,31,50-100,1872,0.8293788946003011
STAT,1900,1,na,1901,3848.5824025790557
SIM,1910,23,40-44,1933,4
STAT,1838,51,50-100,1889,0.011258482715512734
STAT,1766,101,na,1867,0.18205415957355958
STAT,1927,39,25-29,1966,1.246081626673325
STAT,1929,36,25-29,1965,1.2904537148778208
SIM,1867,22,30-34,1889,28
STAT,1930,41,45-49,1971,0.22366200205845516
SIM,1840,31,50-100,1871,3
STAT,1937,22,15-19,1959,5.287539975440224
SIM,1941,9,na,1950,3985
SIM,1884,58,na,1942,1995
STAT,1826,44,na,1870,1542.58250036649
STAT,1913,24,25-29,1937,94.55970867161066
SIM,1813,46,na,1859,1411
STAT,1885,79,na,1964,987.886605761963
STAT,1922,45,50-100,1967,0.2663754373298816
SIM,1921,24,25-29,1945,140
STAT,1829,105,na,1934,0.019500704545712202
STAT,1936,33,50-100,1969,0.8185826964177152
STAT,1849,20,20-24,1869,65.62321089356878
STAT,1930,21,20-24,1951,145.72304845931984
SIM,1880,68,na,1948,1424
STAT,1923,40,15-19,1963,0.0018364299981355064
STAT,1942,17,na,1959,3924.400219964886
SIM,1955,12,na,1967,5089
STAT,1951,9,na,1960,4773.729968436622
SIM,1906,34,30-34,1940,21
SIM,1850,46,na,1896,1673
STAT,1928,37,20-24,1965,0.33981635407755567
STAT,1900,40,20-24,1940,0.01575080948737861
STAT,1818,49,na,1867,1392.4812585780267
STAT,1813,46,25-29,1859,0.14721726065907123
SIM,1923,21,25-29,1944,113
STAT,1933,36,45-49,1969,0.9478145860114582
SIM,1845,21,40-44,1866,5
STAT,1805,50,na,1855,1449.0442278510343
SIM,1900,32,40-44,1932,10
SIM,1835,31,25-29,1866,13
STAT,1914,22,20-24,1936,115.90715226137934
SIM,1868,21,35-39,1889,8
STAT,1822,54,na,1876,1348.3914546232318
SIM,1880,44,na,1924,2210
SIM,1904,26,20-24,1930,18
SIM,1909,18,20-24,1927,23
SIM,1888,19,20-24,1907,27
SIM,1939,19,45-49,1958,2
STAT,1917,10,na,1927,4350.088052861692
STAT,1916,38,40-44,1954,1.5566395336752066
STAT,1838,20,45-49,1858,0.6743820109052723
SIM,1909,29,30-34,1938,47
STAT,1887,15,45-49,1902,0.07501927494045472
STAT,1894,22,25-29,1916,75.11873403861196
STAT,1845,19,50-100,1864,0.0478138786788138
SIM,1905,36,35-39,1941,1
STAT,1948,16,40-44,1964,1.6335894230778674
SIM,1922,22,20-24,1944,140
STAT,1852,52,na,1904,1725.3612788337364
STAT,1827,85,na,1912,177.17838138936048
STAT,1880,37,25-29,1917,3.0865846349163686
SIM,1905,25,25-29,1930,70
STAT,1917,37,45-49,1954,0.7225889943291738
STAT,1837,21,40-44,1858,1.8319306709723366
STAT,1872,80,na,1952,632.4711898895401
STAT,1934,34,40-44,1968,5.441787822129152
STAT,1770,115,na,1885,1.1813340756473888E-4
SIM,1891,38,50-100,1929,2
STAT,1915,21,25-29,1936,97.72757812368906
STAT,1916,30,30-34,1946,16.7326256655774
SIM,1924,38,40-44,1962,4
SIM,1830,26,na,1856,1929
STAT,1844,31,25-29,1875,9.590528646091487
STAT,1917,18,na,1935,4230.287663118844
SIM,1848,42,15-19,1890,1
SIM,1925,29,15-19,1954,5
STAT,1924,44,25-29,1968,0.08637080937941861
SIM,1901,55,na,1956,3178
STAT,1812,47,20-24,1859,0.02840072102186365
STAT,1856,25,50-100,1881,0.538532396155134
STAT,1838,69,na,1907,1078.2806624892828
SIM,1942,29,15-19,1971,1
STAT,1913,26,20-24,1939,18.618747781839588
STAT,1814,67,na,1881,871.9113913756349
STAT,1946,19,40-44,1965,1.5817583384997165
SIM,1921,37,30-34,1958,5
SIM,1897,40,45-49,1937,1
STAT,1845,18,45-49,1863,0.06412956135479815
STAT,1921,23,na,1944,4195.939580565755
STAT,1935,33,45-49,1968,2.2187606258041805
STAT,1906,66,na,1972,2818.9240325852875
STAT,1913,37,30-34,1950,1.8348856414706858
STAT,1896,30,35-39,1926,13.754415634271563
STAT,1918,46,20-24,1964,0.012030770868064054
SIM,1867,8,na,1875,2524
STAT,1867,31,50-100,1898,0.8811035109464975
STAT,1907,15,40-44,1922,0.2752410016912878
STAT,1929,43,na,1972,4897.820575227697
STAT,1942,28,40-44,1970,4.988656155504724
STAT,1851,11,na,1862,2405.487374693308
STAT,1942,20,30-34,1962,30.76620860265266
SIM,1867,0,na,1867,3446
SIM,1889,81,na,1970,1152
STAT,1864,85,na,1949,248.66249275599097
STAT,1922,47,25-29,1969,0.06217976160209451
SIM,1904,37,30-34,1941,6
SIM,1905,61,na,1966,2987
STAT,1946,23,na,1969,4144.74662688915
STAT,1889,40,45-49,1929,1.9050118210087885
STAT,1940,26,35-39,1966,15.625555729672103
STAT,1868,75,na,1943,1003.0742357578018
SIM,1850,38,na,1888,1785
SIM,1915,27,35-39,1942,20
STAT,1875,77,na,1952,905.0277873635862
STAT,1859,39,na,1898,1900.131443147262
STAT,1924,43,40-44,1967,0.30306036721593055
STAT,1917,29,15-19,1946,0.7501166005179722
STAT,1955,6,na,1961,5322.741059482195
SIM,1843,76,na,1919,666
STAT,1809,88,na,1897,70.04087132133955
STAT,1948,19,45-49,1967,0.5828705734383145
SIM,1849,26,30-34,1875,36
SIM,1906,21,25-29,1927,99
STAT,1784,71,na,1855,492.98693999999995
SIM,1884,6,na,1890,2850
SIM,1833,66,na,1899,1034
SIM,1857,20,20-24,1877,2
STAT,1859,25,35-39,1884,8.112900192649432
STAT,1904,31,20-24,1935,3.968200400517655
STAT,1859,31,na,1890,1952.1084012702554
STAT,1863,44,na,1907,2039.3878196133612
SIM,1866,26,30-34,1892,30
SIM,1855,69,na,1924,1191
STAT,1930,41,15-19,1971,0.002063778710600183
SIM,1861,21,25-29,1882,87
SIM,1950,20,30-34,1970,37
SIM,1860,48,na,1908,1945
STAT,1928,35,25-29,1963,1.2714464966328167
STAT,1902,23,40-44,1925,2.9885988164939055
SIM,1921,26,20-24,1947,29
SIM,1926,33,45-49,1959,2
SIM,1858,16,25-29,1874,6
STAT,1869,32,50-100,1901,0.9024179707704543
SIM,1912,31,20-24,1943,1
STAT,1794,73,na,1867,520.8838169414897
STAT,1918,33,45-49,1951,1.6991806724347993
STAT,1819,98,na,1917,1.9152002882517847
SIM,1902,24,15-19,1926,8
STAT,1890,44,30-34,1934,1.4146669382424297
STAT,1909,43,45-49,1952,0.15780806239104647
STAT,1870,21,25-29,1891,57.26126949709041
STAT,1888,17,50-100,1905,0.05908519543977096
STAT,1899,23,50-100,1922,0.5679105617280324
SIM,1818,77,na,1895,330
STAT,1859,42,50-100,1901,0.8596474889646566
SIM,1907,36,50-100,1943,5
STAT,1853,21,25-29,1874,57.12461298207766
STAT,1851,21,15-19,1872,3.2738088935978262
STAT,1920,18,50-100,1938,0.4278334147358672
STAT,1898,3,na,1901,3647.042158278644
STAT,1801,60,na,1861,942.8002558845496
STAT,1892,49,na,1941,2817.0239356561606
SIM,1930,24,50-100,1954,2
STAT,1840,53,30-34,1893,0.004214667139690246
STAT,1885,35,50-100,1920,1.2614378727350146
SIM,1912,15,15-19,1927,10
SIM,1896,4,na,1900,3603
STAT,1852,60,na,1912,1536.4270696145227
SIM,1931,15,25-29,1946,63
STAT,1908,44,40-44,1952,0.2330780427376821
SIM,1951,19,15-19,1970,72
STAT,1903,25,50-100,1928,0.9339528374993195
SIM,1873,74,na,1947,1003
STAT,1808,47,na,1855,1122.8672722067824
STAT,1907,27,35-39,1934,14.453004088503151
STAT,1858,26,30-34,1884,21.005905660231964
SIM,1889,46,50-100,1935,1
STAT,1907,43,40-44,1950,0.23227136297774334
STAT,1817,83,na,1900,193.742568477973
STAT,1940,15,25-29,1955,44.91115854208592
STAT,1919,45,25-29,1964,0.05898910888425779
STAT,1895,48,25-29,1943,0.04270274909952215
STAT,1900,29,45-49,1929,1.558692349554893
SIM,1932,27,35-39,1959,6
STAT,1923,28,30-34,1951,45.737798638325046
STAT,1920,47,15-19,1967,4.1554703902592724E-4
STAT,1869,16,35-39,1885,0.5511581743324434
SIM,1931,26,35-39,1957,24
STAT,1823,53,30-34,1876,0.008445728495754777
STAT,1922,27,30-34,1949,45.240127569251804
SIM,1916,42,45-49,1958,2
STAT,1913,41,15-19,1954,0.0015365734711437968
STAT,1923,15,25-29,1938,52.16035103071714
STAT,1848,55,na,1903,1607.3022216571967
STAT,1922,16,20-24,1938,160.49082843135002
STAT,1944,19,30-34,1963,13.373791158779548
SIM,1930,16,20-24,1946,179
STAT,1826,34,50-100,1860,0.8839545837673699
STAT,1879,18,15-19,1897,6.311757654579886
SIM,1875,16,30-34,1891,2
SIM,1862,44,20-24,1906,3
SIM,1831,67,na,1898,999
SIM,1897,25,na,1922,3260
STAT,1871,31,na,1902,2421.280705806058
SIM,1893,11,na,1904,3417
SIM,1931,31,30-34,1962,34
SIM,1877,16,35-39,1893,2
SIM,1898,21,20-24,1919,6
STAT,1834,21,15-19,1855,2.990658349027342
STAT,1924,27,35-39,1951,17.834829930819513
SIM,1857,49,50-100,1906,1
STAT,1923,26,35-39,1949,17.64757757026099
SIM,1842,21,15-19,1863,4
SIM,1878,40,35-39,1918,2
STAT,1812,52,na,1864,1293.9302280964603
STAT,1868,15,35-39,1883,0.5507936982472977
SIM,1930,27,30-34,1957,101
STAT,1923,38,na,1961,4443.2350760871595
STAT,1934,29,15-19,1963,0.9675253513206641
SIM,1941,30,30-34,1971,3
STAT,1852,39,15-19,1891,0.04478290454312859
SIM,1856,94,na,1950,4
SIM,1852,80,na,1932,448
SIM,1899,17,25-29,1916,2
STAT,1933,17,35-39,1950,5.728475135743617
SIM,1924,33,35-39,1957,15
STAT,1922,44,15-19,1966,0.0017925572426171106
SIM,1863,13,na,1876,2409
STAT,1909,23,na,1932,3606.0679055278965
STAT,1772,94,na,1866,2.196907629025305
STAT,1917,34,40-44,1951,4.1460411095841785
STAT,1867,16,30-34,1883,1.5697862918994476
STAT,1842,82,na,1924,365.8960910423251
STAT,1910,17,40-44,1927,0.2826704142714799
SIM,1858,21,20-24,1879,79
SIM,1905,22,20-24,1927,92
STAT,1877,26,40-44,1903,3.1804412263578636
SIM,1901,23,na,1924,3451
STAT,1872,29,na,1901,2422.6126156538458
SIM,1914,31,30-34,1945,26
STAT,1894,49,20-24,1943,0.008696946720112422
STAT,1848,36,50-100,1884,0.9937575246667686
STAT,1916,33,35-39,1949,9.587314194299669
STAT,1876,62,na,1938,1925.3856884397824
STAT,1946,16,30-34,1962,13.796996556730258
SIM,1914,28,30-34,1942,50
STAT,1880,34,20-24,1914,2.872949562344323
STAT,1907,48,40-44,1955,0.14283496340261106
STAT,1936,29,25-29,1965,64.18375646997234
SIM,1858,32,30-34,1890,20
STAT,1914,53,na,1967,3638.3684586164104
STAT,1934,3,na,1937,5594.8660251136735
SIM,1801,69,na,1870,885
STAT,1931,22,20-24,1953,147.0809538808791
STAT,1887,40,35-39,1927,2.0908887556809828
STAT,1933,30,30-34,1963,21.677394604635662
SIM,1911,19,15-19,1930,13
SIM,1820,48,50-100,1868,1
SIM,1954,16,30-34,1970,14
STAT,1797,78,na,1875,321.69012378687097
STAT,1863,36,na,1899,2117.4504245948738
SIM,1862,79,na,1941,612
STAT,1906,19,40-44,1925,0.2701263844305583
SIM,1928,8,na,1936,5257
STAT,1920,38,na,1958,4199.360693587897
STAT,1921,15,15-19,1936,53.03346647468157
STAT,1813,43,20-24,1856,0.5515174036890419
STAT,1907,40,30-34,1947,0.12079093436993199
SIM,1835,49,na,1884,1556
SIM,1888,3,na,1891,3130
SIM,1931,34,35-39,1965,23
STAT,1843,15,30-34,1858,1.6638407811746385
STAT,1919,47,20-24,1966,0.012231828335392997
SIM,1869,69,na,1938,1299
SIM,1941,17,35-39,1958,5
STAT,1942,26,45-49,1968,1.8507618202902356
STAT,1906,58,na,1964,3121.7528715576336
SIM,1856,36,50-100,1892,1
SIM,1916,45,na,1961,3831
STAT,1842,50,na,1892,1712.7888218821417
STAT,1927,28,na,1955,4629.320997872585
SIM,1907,30,30-34,1937,5
SIM,1895,10,na,1905,3614
STAT,1842,53,40-44,1895,0.008123275002268159
SIM,1851,15,30-34,1866,5
STAT,1789,94,na,1883,3.4413077910113037
STAT,1901,42,35-39,1943,0.17916665908050183
SIM,1879,29,20-24,1908,14
SIM,1894,36,na,1930,3138
STAT,1923,34,35-39,1957,10.675188229487032
STAT,1879,23,40-44,1902,2.2152137493943767
STAT,1902,44,na,1946,3291.5009291489796
STAT,1868,67,na,1935,1544.5844982326605
SIM,1849,35,50-100,1884,1
STAT,1903,19,15-19,1922,8.559923158677755
SIM,1913,32,20-24,1945,6
STAT,1851,67,na,1918,1307.832263423645
STAT,1846,40,50-100,1886,0.7844836095320006
STAT,1943,24,40-44,1967,3.6472798813830303
STAT,1896,41,50-100,1937,0.0992920440138908
SIM,1907,38,40-44,1945,2
SIM,1844,25,40-44,1869,3
SIM,1818,69,na,1887,754
STAT,1838,22,40-44,1860,1.986423233996448
STAT,1933,38,40-44,1971,2.077314395879896
SIM,1904,24,25-29,1928,94
STAT,1855,57,na,1912,1557.862490033246
SIM,1924,40,na,1964,4553
SIM,1888,28,50-100,1916,1
STAT,1837,40,50-100,1877,0.8527418619365159
SIM,1885,26,40-44,1911,4
SIM,1904,21,15-19,1925,5
STAT,1939,26,40-44,1965,4.782230786698125
STAT,1860,4,na,1864,2544.4556270365174
STAT,1870,48,20-24,1918,0.011816785135080882
STAT,1871,95,na,1966,49.21365516218784
SIM,1854,28,na,1882,2144
STAT,1905,32,20-24,1937,2.2867728230332935
STAT,1860,79,na,1939,578.6593828402247
SIM,1869,25,45-49,1894,3
SIM,1845,40,50-100,1885,3
SIM,1916,23,35-39,1939,15
SIM,1933,20,30-34,1953,64
SIM,1870,38,20-24,1908,4
SIM,1906,37,35-39,1943,1
STAT,1877,0,na,1877,3863.230847436171
STAT,1916,36,45-49,1952,0.7158461528451239
STAT,1817,110,na,1927,1.3486197630066893E-4
STAT,1906,42,50-100,1948,0.10879741760599158
STAT,1897,24,na,1921,3205.81743053121
SIM,1875,1,na,1876,3355
SIM,1869,22,35-39,1891,8
SIM,1802,101,na,1903,1
STAT,1884,38,na,1922,2366.0526742256943
STAT,1902,21,45-49,1923,1.0062272877707157
STAT,1913,41,45-49,1954,0.1665261382437584
STAT,1830,49,35-39,1879,0.1132115643933178
SIM,1933,25,na,1958,4893
STAT,1937,27,20-24,1964,18.15008843665821
SIM,1905,33,30-34,1938,22
STAT,1942,18,50-100,1960,0.39932760342703977
STAT,1899,27,30-34,1926,35.178350890431
SIM,1846,22,40-44,1868,3
STAT,1880,24,na,1904,2519.530083147216
SIM,1838,28,20-24,1866,12
STAT,1849,23,25-29,1872,53.34740035624674
STAT,1908,8,na,1916,3932.20120243149
SIM,1901,33,40-44,1934,11
STAT,1880,16,na,1896,2714.174288592359
SIM,1903,8,na,1911,3726
STAT,1850,26,na,1876,1928.7641601832822
STAT,1827,31,25-29,1858,16.646174812901933
STAT,1919,35,50-100,1954,0.46285399800606963
SIM,1928,26,30-34,1954,76
STAT,1885,47,na,1932,2279.1648783777855
SIM,1863,3,na,1866,2684
SIM,1886,22,40-44,1908,2
SIM,1926,30,40-44,1956,9
STAT,1930,6,na,1936,5284.990975650025
STAT,1804,100,na,1904,0.358220085647839
STAT,1924,12,na,1936,4813.962225000055
STAT,1798,63,na,1861,1063.1485813239833
SIM,1859,59,na,1918,1772
SIM,1934,10,na,1944,5652
SIM,1907,5,na,1912,3992
SIM,1941,12,na,1953,3956
SIM,1908,58,na,1966,3421
STAT,1904,34,25-29,1938,8.525233299415815
STAT,1923,23,30-34,1946,34.015280708754055
STAT,1921,18,25-29,1939,50.27384474234166
SIM,1814,87,na,1901,107
STAT,1911,29,20-24,1940,18.028377345667167
STAT,1924,41,20-24,1965,0.02146273810629751
STAT,1857,9,na,1866,2281.418603582314
SIM,1852,9,na,1861,2540
STAT,1843,110,na,1953,2.2308027947586938E-4
STAT,1862,38,20-24,1900,0.6660849489688964
STAT,1875,50,50-100,1925,0.016039975364694772
STAT,1878,22,40-44,1900,2.2127158142318346
SIM,1857,23,25-29,1880,58
STAT,1827,93,na,1920,18.888936878663063
STAT,1830,100,na,1930,0.6715883120617199
SIM,1801,80,na,1881,259
SIM,1912,34,25-29,1946,13
STAT,1791,73,na,1864,445.7395978319746
STAT,1862,22,50-100,1884,0.362514025643738
STAT,1897,19,20-24,1916,24.052680422260323
SIM,1868,95,na,1963,16
STAT,1809,107,na,1916,0.0024060378224021657
STAT,1936,26,15-19,1962,0.6893930823876497
STAT,1891,27,50-100,1918,0.807930168087116
STAT,1932,34,30-34,1966,21.331801015393097
SIM,1876,31,na,1907,2785
STAT,1905,18,40-44,1923,0.2687731907370663
STAT,1908,23,35-39,1931,8.79975797533054
SIM,1914,47,40-44,1961,1
STAT,1918,30,40-44,1948,4.277716091219869
STAT,1940,24,15-19,1964,5.528307600966699
STAT,1842,39,na,1881,1931.7397553978087
STAT,1886,30,50-100,1916,0.9973257566998399
STAT,1855,48,30-34,1903,0.07409632330903629
STAT,1876,22,30-34,1898,18.763982449039375
SIM,1944,26,15-19,1970,1
STAT,1901,35,na,1936,3419.680203317252
SIM,1849,29,35-39,1878,2
STAT,1822,62,na,1884,1111.3415303282627
STAT,1830,49,na,1879,1488.8962932020243
SIM,1802,54,na,1856,1060
STAT,1853,38,50-100,1891,1.024354569586873
STAT,1898,37,50-100,1935,1.693735504476956
SIM,1883,33,na,1916,2456
SIM,1918,39,25-29,1957,2
STAT,1836,25,40-44,1861,2.447852904638216
STAT,1893,74,na,1967,1793.6247960354058
STAT,1832,46,35-39,1878,0.11258041454031276
SIM,1904,29,25-29,1933,85
SIM,1931,23,30-34,1954,58
SIM,1873,66,na,1939,1709
SIM,1825,79,na,1904,386
SIM,1820,48,na,1868,1590
SIM,1900,37,40-44,1937,4
STAT,1893,34,na,1927,3061.7957647599023
STAT,1918,49,25-29,1967,0.057266839700950894
STAT,1829,30,45-49,1859,1.702400865635225
STAT,1877,46,50-100,1923,0.2606037199230207
STAT,1884,16,30-34,1900,1.6126156268374467
SIM,1865,79,na,1944,573
STAT,1935,25,15-19,1960,0.9822158383963586
SIM,1821,57,na,1878,1217
STAT,1827,45,50-100,1872,0.2833754953667661
SIM,1828,36,na,1864,1854
SIM,1911,19,20-24,1930,30
SIM,1939,28,50-100,1967,5
SIM,1874,49,45-49,1923,1
SIM,1835,45,50-100,1880,1
SIM,1885,46,50-100,1931,1
STAT,1856,18,20-24,1874,16.688232188248538
SIM,1936,16,15-19,1952,42
SIM,1868,44,na,1912,2271
SIM,1887,23,40-44,1910,8
STAT,1882,82,na,1964,723.1701953889109
SIM,1847,26,na,1873,1826
SIM,1932,24,30-34,1956,52
STAT,1870,46,na,1916,2250.0525106132923
STAT,1919,42,20-24,1961,0.019529980111253304
SIM,1910,26,45-49,1936,3
STAT,1924,24,30-34,1948,34.38448372563622
STAT,1895,45,20-24,1940,0.009099434543236706
STAT,1902,26,45-49,1928,1.6028142165456871
STAT,1873,47,35-39,1920,0.14411990031726923
SIM,1898,24,25-29,1922,103
STAT,1926,40,40-44,1966,0.31544071419856734
STAT,1911,39,50-100,1950,0.40948649936828707
STAT,1928,16,15-19,1944,58.472213829977285
STAT,1854,47,25-29,1901,0.04387890172426539
STAT,1828,54,20-24,1882,4.874994554784236E-4
SIM,1930,19,25-29,1949,80
STAT,1804,57,na,1861,1059.2530624469434
STAT,1826,49,15-19,1875,3.043987521621018E-4
STAT,1927,33,50-100,1960,1.0368298347057792
STAT,1914,34,15-19,1948,0.13084743123937378
STAT,1922,19,25-29,1941,50.89899795571706
SIM,1909,51,na,1960,3260
SIM,1891,20,na,1911,3083
STAT,1870,36,50-100,1906,1.2302750779563578
STAT,1909,24,50-100,1933,0.619794303064712
SIM,1805,59,na,1864,971
SIM,1864,18,20-24,1882,14
STAT,1903,19,20-24,1922,25.571415985265535
STAT,1862,15,40-44,1877,0.18407356665413402
SIM,1870,49,50-100,1919,1
SIM,1839,39,na,1878,1809
STAT,1866,49,45-49,1915,0.21743233272828624
SIM,1925,14,na,1939,5004
SIM,1917,24,50-100,1941,1
SIM,1892,16,30-34,1908,3
STAT,1918,49,50-100,1967,0.24417944322525525
SIM,1846,41,na,1887,1909
STAT,1856,42,na,1898,1848.5701918602012
STAT,1874,17,25-29,1891,5.9022481844487125
STAT,1885,87,na,1972,470.1554144591689
STAT,1780,81,na,1861,181.01868368188323
STAT,1920,31,35-39,1951,10.256569284555635
SIM,1938,32,25-29,1970,17
STAT,1935,15,na,1950,5155.298251239163
STAT,1877,36,na,1913,2504.8244831685224
STAT,1942,23,35-39,1965,10.069036724497911
STAT,1903,61,na,1964,2910.114677407033
SIM,1911,14,na,1925,4081
SIM,1896,29,20-24,1925,22
SIM,1871,34,20-24,1905,7
SIM,1929,37,35-39,1966,5
STAT,1924,20,na,1944,4422.567459796493
STAT,1910,33,40-44,1943,3.8321900011869645
STAT,1867,21,20-24,1888,66.75084249927544
STAT,1821,77,na,1898,455.48214978059355
SIM,1866,61,na,1927,1959
SIM,1856,54,na,1910,2032
SIM,1946,23,20-24,1969,114
STAT,1894,44,50-100,1938,0.09496777053127568
SIM,1944,26,20-24,1970,21
STAT,1814,43,50-100,1857,3.4535341578481233
STAT,1825,108,na,1933,0.0010984165469068918
SIM,1938,1,na,1939,4124
STAT,1914,13,na,1927,4161.70263335834
SIM,1911,18,30-34,1929,2
STAT,1843,18,35-39,1861,0.5627357990415054
STAT,1912,40,45-49,1952,0.16560275554688866
STAT,1925,26,45-49,1951,2.088967528003065
STAT,1860,39,50-100,1899,1.005992383883497
STAT,1938,23,20-24,1961,112.22363477731992
STAT,1938,29,50-100,1967,1.004915739485202
SIM,1877,24,na,1901,2445
STAT,1867,32,30-34,1899,16.721724988565917
STAT,1883,46,40-44,1929,0.17185182049613096
SIM,1847,18,15-19,1865,8
STAT,1829,32,40-44,1861,4.04601149282016
STAT,1873,14,na,1887,2688.6062019669293
SIM,1844,28,45-49,1872,1
SIM,1828,47,na,1875,1667
SIM,1863,22,40-44,1885,3
STAT,1785,88,na,1873,46.86284139225995
SIM,1940,27,na,1967,3916
STAT,1897,48,35-39,1945,0.10636672411814872
STAT,1860,47,na,1907,1853.543492748791
SIM,1822,42,na,1864,1414
SIM,1926,3,na,1929,5357
SIM,1929,26,25-29,1955,91
STAT,1763,103,na,1866,0.01783118465847264
STAT,1781,74,na,1855,405.66821999999996
STAT,1854,24,45-49,1878,0.6181042335459469
STAT,1854,33,50-100,1887,0.7107069352130426
STAT,1871,21,40-44,1892,2.1120975696804036
SIM,1837,30,45-49,1867,2
STAT,1836,20,35-39,1856,5.1016081207582396
STAT,1836,106,na,1942,0.0075574076609981385
SIM,1921,21,15-19,1942,5
STAT,1839,18,15-19,1857,5.3262127171193425
STAT,1931,37,25-29,1968,1.3298793103892423
STAT,1890,47,40-44,1937,0.11989506437681474
STAT,1882,50,na,1932,2170.7359356346537
STAT,1824,96,na,1920,4.727945117756375
SIM,1858,66,na,1924,1282
STAT,1933,33,35-39,1966,12.551431971381026
STAT,1907,24,30-34,1931,26.51376026106046
STAT,1928,39,40-44,1967,1.9256436345852739
SIM,1849,92,na,1941,20
STAT,1886,64,na,1950,1877.100450243109
STAT,1896,21,45-49,1917,0.9423751739378221
STAT,1785,100,na,1885,0.22690238894731693
STAT,1854,44,20-24,1898,0.11990761356580218
SIM,1889,31,20-24,1920,1
STAT,1840,45,50-100,1885,0.18284703845515757
STAT,1855,22,40-44,1877,1.8871471806061495
STAT,1837,47,25-29,1884,0.03986577164363983
STAT,1855,17,15-19,1872,5.471780600874914
STAT,1926,24,40-44,1950,4.141116786194424
STAT,1937,19,na,1956,3641.629635420674
SIM,1859,33,30-34,1892,29
SIM,1842,59,na,1901,1468
STAT,1856,44,30-34,1900,0.9082311856494487
STAT,1902,39,20-24,1941,0.23695413550525993
SIM,1828,44,na,1872,1723
STAT,1816,41,15-19,1857,0.03433603255917017
STAT,1907,43,35-39,1950,0.18699359915366093
STAT,1937,25,25-29,1962,65.50280188276851
STAT,1900,18,na,1918,3561.723899872223
SIM,1915,24,30-34,1939,42
SIM,1810,49,na,1859,1581
SIM,1875,46,na,1921,2268
STAT,1842,45,40-44,1887,0.13776339259576886
STAT,1864,1,na,1865,3273.431852125406
SIM,1913,33,50-100,1946,1
STAT,1947,16,25-29,1963,49.819094519612854
STAT,1859,102,na,1961,0.6554444060634699
SIM,1824,39,50-100,1863,1
SIM,1847,18,na,1865,2022
STAT,1835,41,25-29,1876,0.580916363148401
SIM,1879,28,na,1907,2908
STAT,1856,21,45-49,1877,0.6532400226407875
SIM,1864,21,45-49,1885,4
SIM,1843,36,na,1879,1901
SIM,1955,16,25-29,1971,76
STAT,1841,19,50-100,1860,0.0461060710030704
SIM,1818,37,na,1855,1574
SIM,1862,2,na,1864,2897
SIM,1864,44,30-34,1908,1
STAT,1866,23,25-29,1889,53.916319729791574
STAT,1841,89,na,1930,77.56654794550306
SIM,1837,32,40-44,1869,8
SIM,1902,7,na,1909,3815
STAT,1800,83,na,1883,167.10943035674995
STAT,1896,23,40-44,1919,2.798951453367432
STAT,1938,34,30-34,1972,16.139315234837596
STAT,1877,29,45-49,1906,1.1663996613213812
STAT,1901,33,50-100,1934,1.3015808736385441
SIM,1818,38,45-49,1856,1
STAT,1896,15,50-100,1911,0.06631606583873048
SIM,1830,33,20-24,1863,1
STAT,1841,36,35-39,1877,6.217131336192036
SIM,1933,26,45-49,1959,5
STAT,1957,15,na,1972,4951.884622346089
STAT,1802,85,na,1887,82.18027845827167
SIM,1875,21,20-24,1896,77
SIM,1885,21,35-39,1906,10
STAT,1905,47,25-29,1952,0.047647552027517734
STAT,1851,99,na,1950,1.5624732132273764
STAT,1888,29,20-24,1917,14.047246225848612
STAT,1910,31,45-49,1941,1.5538031137765336
STAT,1828,34,45-49,1862,1.6117192194451637
STAT,1883,13,na,1896,2580.9956202196254
STAT,1864,44,50-100,1908,0.9453537206694499
STAT,1774,115,na,1889,1.359430620997661E-4
STAT,1832,31,50-100,1863,0.8125394229109847
STAT,1883,38,50-100,1921,1.2228325883937632
SIM,1844,31,50-100,1875,3
SIM,1899,56,na,1955,2815
STAT,1922,32,20-24,1954,2.8120624088259665
SIM,1904,28,40-44,1932,5
STAT,1834,95,na,1929,8.934834983697357
STAT,1762,104,na,1866,0.0304220667394259
SIM,1914,44,30-34,1958,2
SIM,1845,48,na,1893,1739
SIM,1849,17,40-44,1866,1
SIM,1857,25,na,1882,2143
STAT,1822,33,20-24,1855,7.208168668674899
STAT,1920,19,15-19,1939,51.68237965556506
SIM,1853,11,na,1864,2391
SIM,1930,32,20-24,1962,5
STAT,1845,31,40-44,1876,4.070970849178589
SIM,1900,30,na,1930,3433
SIM,1934,24,40-44,1958,6
STAT,1906,44,30-34,1950,0.11694302624806012
STAT,1936,26,20-24,1962,17.825735273096495
STAT,1939,29,45-49,1968,1.769978411084018
SIM,1885,29,45-49,1914,1
SIM,1884,22,30-34,1906,34
STAT,1921,34,25-29,1955,10.40596868404179
SIM,1911,22,na,1933,4007
STAT,1867,45,45-49,1912,0.22827805251579042
STAT,1862,18,45-49,1880,0.06458573672798816
STAT,1895,25,45-49,1920,1.4878516632963301
SIM,1823,43,30-34,1866,4
STAT,1906,26,35-39,1932,14.376337393673447
STAT,1861,31,25-29,1892,8.669474916884619
STAT,1909,31,na,1940,3695.853208541449
STAT,1921,15,20-24,1936,158.42908951699025
STAT,1886,61,na,1947,2017.7753029157022
SIM,1859,20,25-29,1879,74
SIM,1890,34,30-34,1924,6
SIM,1898,30,50-100,1928,5
STAT,1952,17,45-49,1969,0.6106718161564413
SIM,1859,31,35-39,1890,14
STAT,1906,31,25-29,1937,8.76851669962733
STAT,1900,43,25-29,1943,0.06259636670855956
SIM,1881,21,na,1902,2317
STAT,1892,6,na,1898,3340.060476472112
SIM,1874,23,25-29,1897,64
STAT,1858,14,na,1872,2235.569181090037
STAT,1895,18,50-100,1913,0.06503787996300699
STAT,1908,29,50-100,1937,0.9526279341408759
STAT,1928,13,na,1941,5084.62200219269
SIM,1928,29,35-39,1957,27
STAT,1855,20,45-49,1875,0.6406782244340509
SIM,1836,34,45-49,1870,1
SIM,1849,31,20-24,1880,5
SIM,1881,61,na,1942,1720
STAT,1911,32,45-49,1943,1.5629906065086308
STAT,1835,21,30-34,1856,17.776215780012336
STAT,1848,47,na,1895,1740.7223829479847
STAT,1867,90,na,1957,95.5618452756114
SIM,1875,45,45-49,1920,1
SIM,1916,53,na,1969,3759
STAT,1953,1,na,1954,4958.321812393018
SIM,1928,25,25-29,1953,11
SIM,1843,21,30-34,1864,23
SIM,1853,43,na,1896,1907
SIM,1939,16,40-44,1955,1
SIM,1842,51,na,1893,1603
SIM,1945,25,25-29,1970,99
SIM,1932,16,na,1948,5139
STAT,1883,32,15-19,1915,0.14254515947780197
STAT,1835,40,na,1875,1925.5829571163522
STAT,1822,36,25-29,1858,5.716569098716718
STAT,1886,72,na,1958,1460.1145485254096
SIM,1849,42,30-34,1891,3
STAT,1925,44,40-44,1969,0.3079269673394074
SIM,1921,24,na,1945,4719
STAT,1905,44,20-24,1949,0.016029165764123953
SIM,1943,18,20-24,1961,155
STAT,1914,21,na,1935,3828.7069600582986
SIM,1901,15,na,1916,3757
SIM,1914,15,25-29,1929,10
STAT,1925,39,15-19,1964,0.023464844720155476
STAT,1935,18,20-24,1953,188.51461809740215
STAT,1879,30,35-39,1909,10.885851768263434
SIM,1887,30,35-39,1917,13
STAT,1922,24,50-100,1946,0.7651126262867056
SIM,1914,26,35-39,1940,27
SIM,1853,14,na,1867,2349
STAT,1857,83,na,1940,316.28703867137796
SIM,1835,92,na,1927,33
SIM,1914,31,25-29,1945,12
STAT,1906,15,25-29,1921,8.453311292151033
SIM,1857,28,na,1885,2053
STAT,1853,77,na,1930,724.7916794236838
STAT,1920,34,45-49,1954,1.7438745019963229
SIM,1862,28,na,1890,2204
STAT,1783,78,na,1861,312.1228173577651
STAT,1937,27,na,1964,3724.8402472127514
SIM,1893,35,50-100,1928,2
STAT,1836,28,45-49,1864,0.8878913835438551
STAT,1898,43,15-19,1941,0.0013134103623069398
STAT,1926,43,45-49,1969,0.20897862629368102
SIM,1807,85,na,1892,41
SIM,1845,21,35-39,1866,6
STAT,1845,49,50-100,1894,0.18789210823796512
STAT,1836,22,30-34,1858,14.633130902159305
STAT,1901,34,35-39,1935,14.323371469269604
STAT,1914,41,30-34,1955,0.12943704233296197
SIM,1840,17,20-24,1857,15
STAT,1935,29,30-34,1964,54.41469965425389
STAT,1951,16,45-49,1967,0.6070127029897758
SIM,1834,44,45-49,1878,3
STAT,1932,16,35-39,1948,5.680372538363987
STAT,1801,68,na,1869,699.6370945019294
STAT,1847,23,15-19,1870,3.131139413690362
STAT,1844,54,na,1898,1622.6311206017435
STAT,1911,18,50-100,1929,0.07627385607037189
STAT,1901,23,25-29,1924,81.4130511494307
STAT,1872,22,40-44,1894,2.1305479447765787
STAT,1895,46,na,1941,3003.6231677764818
SIM,1891,46,40-44,1937,1
SIM,1937,19,35-39,1956,7
STAT,1914,38,30-34,1952,1.8474410103978691
STAT,1884,19,35-39,1903,0.5508326682349374
STAT,1894,6,na,1900,3427.982819719274
STAT,1941,27,40-44,1968,4.919144148182399
SIM,1874,46,40-44,1920,1
SIM,1922,38,30-34,1960,1
STAT,1837,21,35-39,1858,5.130122649817517
SIM,1894,28,na,1922,3341
SIM,1908,34,40-44,1942,4
STAT,1783,89,na,1872,38.45772923494608
STAT,1948,19,50-100,1967,0.43715293007873585
SIM,1890,35,na,1925,3128
STAT,1869,35,45-49,1904,1.9820485307019655
SIM,1899,33,30-34,1932,42
SIM,1890,46,na,1936,2965
STAT,1875,24,50-100,1899,0.4242880536800788
SIM,1848,30,20-24,1878,5
SIM,1899,20,25-29,1919,121
STAT,1828,70,na,1898,772.6262963657836
STAT,1861,36,50-100,1897,1.039929419785712
STAT,1921,27,50-100,1948,1.1319921775669333
SIM,1807,74,na,1881,396
STAT,1815,43,30-34,1858,3.4372296929592547
STAT,1866,46,40-44,1912,0.16155147129468062
SIM,1844,22,30-34,1866,26
STAT,1878,48,25-29,1926,0.060394688463636145
SIM,1850,31,15-19,1881,2
SIM,1877,35,45-49,1912,3
STAT,1946,19,35-39,1965,4.745274740753387
STAT,1898,30,45-49,1928,2.4250314422290753
SIM,1952,19,30-34,1971,29
STAT,1912,37,15-19,1949,0.019119952464390185
STAT,1832,29,na,1861,1883.0659332038092
SIM,1907,33,40-44,1940,7
STAT,1901,22,35-39,1923,8.324774324046066
SIM,1899,22,20-24,1921,4
STAT,1903,69,na,1972,2539.0027044720487
STAT,1852,21,30-34,1873,17.16993886030677
SIM,1860,21,30-34,1881,28
SIM,1919,35,25-29,1954,2
SIM,1935,35,na,1970,5392
STAT,1840,59,na,1899,1398.5128137907805
STAT,1842,31,15-19,1873,0.136316433650849
SIM,1821,89,na,1910,17
STAT,1882,34,30-34,1916,17.20424070683333
STAT,1831,47,30-34,1878,0.07916807097767829
STAT,1925,42,45-49,1967,0.20557477110695996
SIM,1854,9,na,1863,2502
STAT,1925,23,40-44,1948,4.093515691064084
STAT,1838,77,na,1915,635.1139906512831
SIM,1941,20,na,1961,3661
SIM,1792,67,na,1859,714
STAT,1932,30,15-19,1962,0.17441146055743686
STAT,1863,37,25-29,1900,2.57530287491375
SIM,1852,18,na,1870,2392
STAT,1898,18,25-29,1916,7.797066982410592
SIM,1929,34,30-34,1963,41
SIM,1920,28,25-29,1948,106
STAT,1854,21,40-44,1875,1.8874477634230182
STAT,1821,37,na,1858,1494.315001423075
STAT,1929,19,35-39,1948,5.432647309027633
STAT,1894,9,na,1903,3404.7247961590524
STAT,1837,44,20-24,1881,0.11082536992969648
STAT,1931,34,20-24,1965,3.255368902598626
SIM,1923,37,40-44,1960,1
STAT,1825,31,15-19,1856,0.3082482934090329
SIM,1889,34,25-29,1923,5
STAT,1872,72,na,1944,1291.2211981242958
SIM,1929,23,20-24,1952,10
SIM,1931,13,na,1944,5151
SIM,1934,27,45-49,1961,4
STAT,1804,97,na,1901,1.8127010633291374
STAT,1942,24,25-29,1966,98.74190574323396
SIM,1935,27,na,1962,5179
STAT,1795,66,na,1861,687.4455705912238
STAT,1892,22,15-19,1914,4.218006385484669
STAT,1951,1,na,1952,4942.941323021332
SIM,1855,23,15-19,1878,1
STAT,1802,53,na,1855,1018.438367248021
STAT,1857,29,50-100,1886,0.517441342710179
STAT,1774,96,na,1870,1.0721534088891393
STAT,1823,54,50-100,1877,0.021006388789892666
STAT,1840,70,na,1910,1009.6493190626222
STAT,1912,28,25-29,1940,65.93560637743097
SIM,1920,50,na,1970,3918
SIM,1827,28,45-49,1855,2
STAT,1927,36,20-24,1963,0.334630300823843
STAT,1920,22,45-49,1942,1.2765169577518543
STAT,1813,93,na,1906,12.567718576774439
SIM,1875,24,25-29,1899,61
STAT,1841,33,30-34,1874,15.479578146856545
STAT,1940,28,30-34,1968,40.74186347487524
STAT,1885,32,25-29,1917,10.424705484872053
SIM,1854,92,na,1946,70
SIM,1880,36,na,1916,2358
SIM,1846,33,na,1879,1987
STAT,1826,44,45-49,1870,1.1849501248527738
STAT,1867,24,25-29,1891,54.48271757804828
SIM,1871,37,25-29,1908,2
STAT,1886,19,45-49,1905,0.07015776102620588
STAT,1900,36,50-100,1936,0.37649654950677874
STAT,1881,54,30-34,1935,0.005709420139155841
SIM,1844,85,na,1929,156
SIM,1908,37,45-49,1945,2
SIM,1889,15,20-24,1904,30
SIM,1848,99,na,1947,10
STAT,1845,22,50-100,1867,0.39555335735258745
SIM,1826,41,25-29,1867,1
SIM,1893,32,25-29,1925,15
STAT,1856,47,35-39,1903,0.11158981596848035
STAT,1883,49,45-49,1932,0.23129558594931124
STAT,1865,41,50-100,1906,0.9825977876615302
STAT,1877,21,35-39,1898,6.193080726957597
STAT,1893,35,45-49,1928,2.6043650497778286
SIM,1890,43,na,1933,2996
STAT,1835,34,50-100,1869,0.8516128973239763
STAT,1925,40,25-29,1965,0.08844992930781916
STAT,1940,31,30-34,1971,16.644466367681073
STAT,1827,29,na,1856,1815.228931828575
STAT,1866,20,20-24,1886,66.32304473331081
SIM,1925,4,na,1929,5091
SIM,1873,41,50-100,1914,1
STAT,1937,29,40-44,1966,4.629941821653139
SIM,1882,29,50-100,1911,1
SIM,1859,39,45-49,1898,4
SIM,1901,31,45-49,1932,3
SIM,1924,34,25-29,1958,17
STAT,1818,41,25-29,1859,1.7134758062515307
STAT,1922,35,25-29,1957,1.1451462463673607
SIM,1896,24,15-19,1920,5
SIM,1920,39,na,1959,3998
STAT,1827,47,50-100,1874,0.2758287988458748
SIM,1817,52,na,1869,1244
STAT,1874,29,50-100,1903,0.6615171678152317
STAT,1918,29,30-34,1947,42.24868349031374
STAT,1842,48,45-49,1890,0.18274684734314706
STAT,1793,88,na,1881,50.99145195054608
STAT,1923,44,30-34,1967,0.15195232509385323
STAT,1926,27,45-49,1953,2.1127501071082713
STAT,1828,31,40-44,1859,4.43036859546812
SIM,1833,22,25-29,1855,53
STAT,1896,31,na,1927,3228.343779908729
STAT,1908,39,15-19,1947,0.018149492194464326
STAT,1909,26,50-100,1935,0.9817409207044181
SIM,1885,23,30-34,1908,22
STAT,1932,21,25-29,1953,123.97217722637734
STAT,1857,42,15-19,1899,0.01098900619033501
STAT,1874,27,50-100,1901,0.6662791899130044
STAT,1918,18,20-24,1936,150.19311896306988
SIM,1930,35,25-29,1965,2
SIM,1830,36,25-29,1866,1
SIM,1862,21,40-44,1883,1
STAT,1897,56,na,1953,2782.1354239778757
STAT,1918,25,15-19,1943,0.7718758915454281
SIM,1926,29,30-34,1955,85
STAT,1872,2,na,1874,3375.910634989258
STAT,1893,42,na,1935,2987.4002509582374
SIM,1852,31,25-29,1883,3
STAT,1916,45,35-39,1961,0.1355843172420111
STAT,1863,34,20-24,1897,2.3970556918125805
STAT,1912,43,na,1955,3632.127043350164
SIM,1874,20,20-24,1894,98
STAT,1877,23,30-34,1900,18.78868976318418
STAT,1911,45,20-24,1956,0.010721949962450844
SIM,1849,22,15-19,1871,6
SIM,1933,23,40-44,1956,4
SIM,1926,18,20-24,1944,2
STAT,1852,34,45-49,1886,1.4246342237921552
STAT,1928,32,15-19,1960,0.1638976567229663
STAT,1800,103,na,1903,0.06916961528745832
SIM,1854,84,na,1938,272
SIM,1926,25,15-19,1951,1
STAT,1897,45,30-34,1942,0.07522338857104775
SIM,1822,74,na,1896,527
SIM,1864,34,20-24,1898,6
STAT,1839,62,na,1901,1261.3992084858392
STAT,1906,40,15-19,1946,0.0014383097603208903
STAT,1921,31,20-24,1952,2.781205325433601
STAT,1916,34,25-29,1950,9.654416968663813
SIM,1904,22,50-100,1926,1
STAT,1915,37,40-44,1952,1.5431819661666435
STAT,1825,59,na,1884,1245.524040205254
SIM,1910,51,na,1961,3409
STAT,1888,24,15-19,1912,3.95378233590542
SIM,1903,25,20-24,1928,11
SIM,1860,34,45-49,1894,3
SIM,1839,27,25-29,1866,37
STAT,1839,21,45-49,1860,0.6228247608385106
STAT,1856,34,20-24,1890,2.14608629986055
STAT,1938,26,25-29,1964,66.548604803773
SIM,1907,17,na,1924,3838
STAT,1907,18,45-49,1925,0.09758937251089532
STAT,1946,18,50-100,1964,0.42383350793911306
STAT,1882,37,35-39,1919,7.029612746482803
SIM,1907,36,45-49,1943,2
SIM,1952,15,15-19,1967,62
SIM,1853,34,45-49,1887,4
SIM,1822,82,na,1904,265
SIM,1849,34,25-29,1883,13
SIM,1859,51,na,1910,2027
SIM,1905,29,40-44,1934,2
SIM,1807,82,na,1889,50
SIM,1914,23,30-34,1937,38
STAT,1815,46,35-39,1861,0.3829543487546747
SIM,1879,90,na,1969,378
STAT,1836,31,50-100,1867,0.728447806802326
STAT,1900,26,40-44,1926,4.250112180345599
SIM,1845,70,na,1915,1177
STAT,1906,23,30-34,1929,26.366766931893455
STAT,1893,49,50-100,1942,0.17554613752132572
SIM,1875,37,50-100,1912,3
STAT,1779,81,na,1860,159.21253663325155
SIM,1927,26,15-19,1953,1
STAT,1850,18,na,1868,2097.50247014094
SIM,1929,20,na,1949,4774
SIM,1940,21,25-29,1961,103
STAT,1907,7,na,1914,3902.52904942474
STAT,1911,16,45-49,1927,0.10221605402957497
STAT,1845,34,45-49,1879,1.5867568340750282
SIM,1888,64,na,1952,1947
SIM,1924,3,na,1927,5025
SIM,1930,18,40-44,1948,3
STAT,1895,22,40-44,1917,2.7735723730978092
STAT,1922,18,40-44,1940,1.6473798642940338
STAT,1935,30,40-44,1965,5.527509783091038
STAT,1923,35,na,1958,4455.431853103226
SIM,1855,28,20-24,1883,10
STAT,1904,19,30-34,1923,2.3178449050807677
STAT,1897,35,20-24,1932,1.0614519871026848
STAT,1881,42,50-100,1923,1.0406718072576908
STAT,1913,28,na,1941,3794.548676736715
STAT,1852,24,35-39,1876,5.504746207043394
SIM,1836,31,40-44,1867,9
STAT,1839,104,na,1943,0.04603268889944298
STAT,1775,114,na,1889,2.8604453249840117E-4
STAT,1843,49,15-19,1892,3.1616684049376367E-4
STAT,1919,26,15-19,1945,0.7810616090622859
SIM,1887,18,15-19,1905,9
STAT,1902,65,na,1967,2714.6837820011665
STAT,1847,28,20-24,1875,10.916885699693754
STAT,1830,46,30-34,1876,0.08138495491644249
STAT,1878,45,20-24,1923,0.012869370849011203
SIM,1856,62,na,1918,1782
STAT,1816,39,50-100,1855,3.3797410172476083
STAT,1815,40,50-100,1855,3.7108739727198383
SIM,1930,23,15-19,1953,8
SIM,1867,42,25-29,1909,2
STAT,1913,21,15-19,1934,5.278086427204744
STAT,1834,55,na,1889,1398.086308053504
SIM,1879,68,na,1947,1764
SIM,1953,16,15-19,1969,74
SIM,1848,33,25-29,1881,16
STAT,1869,32,40-44,1901,4.271268646585878
STAT,1943,8,na,1951,4277.906647743667
SIM,1806,89,na,1895,69
SIM,1865,17,25-29,1882,10
SIM,1823,40,50-100,1863,1
SIM,1891,49,45-49,1940,1
SIM,1888,19,15-19,1907,8
STAT,1858,26,50-100,1884,0.533610176539698
STAT,1860,45,35-39,1905,0.11703526983589504
SIM,1928,19,20-24,1947,173
STAT,1815,52,na,1867,1454.3901968008354
SIM,1891,39,na,1930,2988
SIM,1933,27,50-100,1960,1
STAT,1862,51,na,1913,1878.7572280045492
SIM,1832,52,na,1884,1411
SIM,1881,18,20-24,1899,29
STAT,1811,67,na,1878,794.7750789252909
STAT,1871,98,na,1969,19.027160943961505
STAT,1857,17,25-29,1874,5.306433836859936
STAT,1874,39,na,1913,2429.1985755247606
STAT,1873,18,20-24,1891,18.287686603980703
STAT,1896,71,na,1967,2124.2986998034926
SIM,1958,5,na,1963,5143
SIM,1860,24,35-39,1884,5
SIM,1912,19,30-34,1931,4
SIM,1888,22,45-49,1910,1
SIM,1921,29,25-29,1950,97
SIM,1911,25,na,1936,3756
STAT,1871,24,45-49,1895,0.7002493265846326
STAT,1922,23,15-19,1945,6.2095066652704185
STAT,1838,17,15-19,1855,5.759631378310293
STAT,1938,12,na,1950,3987.0827964011974
SIM,1922,17,na,1939,4290
STAT,1903,18,30-34,1921,2.305317336170032
STAT,1923,19,40-44,1942,1.6667890898137083
SIM,1890,37,35-39,1927,16
STAT,1845,15,40-44,1860,0.18277343705560492
STAT,1879,16,na,1895,2699.8072564314257
STAT,1857,80,na,1937,492.847350866866
STAT,1879,21,45-49,1900,0.7458373170007734
STAT,1923,24,15-19,1947,6.279957307452291
SIM,1919,39,40-44,1958,4
STAT,1841,23,20-24,1864,63.99421141875807
STAT,1871,47,30-34,1918,0.09736274812288363
STAT,1913,29,25-29,1942,66.4279300878476
SIM,1887,21,45-49,1908,1
STAT,1859,42,25-29,1901,0.5225308299101497
STAT,1872,25,45-49,1897,1.1429084505294156
SIM,1899,24,40-44,1923,4
STAT,1909,40,40-44,1949,0.24130335788098456
SIM,1878,33,40-44,1911,1
STAT,1914,44,35-39,1958,0.20290212539213015
STAT,1945,16,15-19,1961,50.594382916395716
SIM,1866,26,50-100,1892,1
STAT,1863,47,na,1910,2002.9921654497261
SIM,1843,44,na,1887,1764
STAT,1849,32,na,1881,1952.2178599262322
SIM,1895,13,na,1908,3600
SIM,1877,32,40-44,1909,9
SIM,1928,22,20-24,1950,165
STAT,1910,15,45-49,1925,0.10142274042255146
STAT,1858,29,35-39,1887,7.876686449504763
SIM,1832,41,na,1873,1680
STAT,1925,27,50-100,1952,1.1994260546196949
SIM,1866,29,35-39,1895,12
SIM,1931,24,15-19,1955,7
SIM,1825,36,50-100,1861,4
STAT,1872,48,30-34,1920,0.09772761395177554
STAT,1871,87,na,1958,237.18418377451576
STAT,1901,27,40-44,1928,4.273409068469076
STAT,1930,38,50-100,1968,0.5579859525506623
STAT,1794,70,na,1864,692.2014130805107
STAT,1944,15,15-19,1959,49.855247295927576
STAT,1843,48,50-100,1891,0.19577502888059634
STAT,1811,78,na,1889,332.93019777470585
STAT,1800,75,na,1875,506.3976701243489
STAT,1908,23,40-44,1931,3.14233160345881
SIM,1908,38,20-24,1946,2
SIM,1762,93,na,1855,3
SIM,1848,49,35-39,1897,1
SIM,1903,29,30-34,1932,45
SIM,1879,82,na,1961,788
STAT,1790,80,na,1870,268.36076508232344
SIM,1876,33,30-34,1909,5
STAT,1820,52,na,1872,1314.4592298138737
STAT,1887,35,20-24,1922,0.8895518027915511
STAT,1856,17,30-34,1873,1.509231548872117
STAT,1930,17,15-19,1947,59.84190321146938
STAT,1937,34,15-19,1971,0.12951490980120156
STAT,1823,101,na,1924,0.31758219403926624
SIM,1840,25,na,1865,1842
STAT,1850,54,50-100,1904,0.011047958695975675
STAT,1881,50,20-24,1931,7.382519102275942E-4
SIM,1874,20,15-19,1894,3
SIM,1935,32,35-39,1967,14
STAT,1864,53,25-29,1917,0.003161310727890897
STAT,1840,16,25-29,1856,5.31087790782624
STAT,1866,95,na,1961,27.40739026693447
STAT,1784,74,na,1858,370.9742773663446
SIM,1836,31,35-39,1867,16
SIM,1866,39,45-49,1905,5
STAT,1911,24,na,1935,3668.6283688826693
SIM,1834,20,50-100,1854,4
STAT,1828,56,na,1884,1173.7953394906792
SIM,1843,34,45-49,1877,1
SIM,1937,15,25-29,1952,65
STAT,1868,33,30-34,1901,16.940387180771427
SIM,1872,28,20-24,1900,10
STAT,1906,35,40-44,1941,1.4162738387599143
SIM,1853,65,na,1918,1341
SIM,1905,17,30-34,1922,4
STAT,1824,33,30-34,1857,30.902858711078554
SIM,1950,21,20-24,1971,158
STAT,1871,28,20-24,1899,11.813191162263518
STAT,1886,10,na,1896,2797.0653645489883
SIM,1832,26,25-29,1858,56
STAT,1905,45,50-100,1950,0.20615040950458016
SIM,1896,32,45-49,1928,4
STAT,1808,100,na,1908,0.35343187926485076
SIM,1920,44,25-29,1964,1
STAT,1921,39,25-29,1960,1.119474176518835
STAT,1836,43,50-100,1879,0.7723628866854495
STAT,1890,15,na,1905,3164.918288499397
SIM,1848,38,50-100,1886,2
SIM,1923,28,45-49,1951,2
STAT,1888,32,45-49,1920,2.10308479217963
STAT,1916,31,20-24,1947,2.5803379485834776
SIM,1828,76,na,1904,559
STAT,1825,37,50-100,1862,1.8809930028132307
STAT,1855,38,20-24,1893,0.5945968287949671
SIM,1881,28,30-34,1909,27
STAT,1863,32,40-44,1895,3.878983543101863
SIM,1878,19,25-29,1897,10
SIM,1933,35,35-39,1968,5
STAT,1849,49,45-49,1898,0.179395570609732
STAT,1923,47,35-39,1970,0.1538879855347786
STAT,1942,21,20-24,1963,118.98603249132599
SIM,1931,27,25-29,1958,6
STAT,1843,20,20-24,1863,70.84217862170075
SIM,1870,69,na,1939,1575
SIM,1869,43,40-44,1912,3
STAT,1844,38,45-49,1882,1.615540337559686
SIM,1869,26,20-24,1895,12
SIM,1939,23,35-39,1962,19
SIM,1940,25,40-44,1965,6
STAT,1891,24,30-34,1915,22.356042514726116
STAT,1915,28,45-49,1943,1.7918248290580852
STAT,1813,47,15-19,1860,0.0010053128009819478
STAT,1846,35,45-49,1881,1.519951974835015
STAT,1923,27,25-29,1950,77.10333020821365
STAT,1843,13,na,1856,2451.5870730983997
SIM,1919,50,na,1969,4100
STAT,1833,39,40-44,1872,3.5484089074007454
STAT,1876,16,45-49,1892,0.06898165119691098
STAT,1931,21,45-49,1952,1.492797054318644
SIM,1834,23,25-29,1857,57
STAT,1899,50,na,1949,3051.2185714550474
SIM,1915,29,50-100,1944,2
STAT,1828,31,35-39,1859,10.34576164302268
SIM,1852,38,45-49,1890,4
STAT,1925,35,35-39,1960,2.9669393959432036
STAT,1767,94,na,1861,2.6800794584193635
STAT,1871,3,na,1874,3157.6928479053768
STAT,1876,49,50-100,1925,0.25332033300260404
SIM,1851,20,20-24,1871,73
STAT,1895,22,35-39,1917,7.767087847590312
SIM,1837,37,25-29,1874,2
STAT,1952,0,na,1952,5341.269894421176
SIM,1910,37,na,1947,3607
STAT,1873,28,30-34,1901,25.952693117863333
SIM,1930,18,35-39,1948,4
STAT,1839,25,50-100,1864,0.5642395573715332
STAT,1887,28,15-19,1915,0.5168168997624449
STAT,1932,25,40-44,1957,6.231426107698283
SIM,1916,23,40-44,1939,5
STAT,1922,18,35-39,1940,4.942139306738115
STAT,1900,47,40-44,1947,0.1359100339638745
STAT,1958,11,na,1969,5262.282612011232
STAT,1866,97,na,1963,14.955814488544913
STAT,1903,34,45-49,1937,1.4396219688089342
SIM,1845,56,na,1901,1584
SIM,1854,35,45-49,1889,2
STAT,1943,20,25-29,1963,100.33408644760215
STAT,1882,46,25-29,1928,0.057409840462515356
SIM,1839,23,30-34,1862,18
SIM,1934,28,20-24,1962,40
STAT,1884,21,20-24,1905,69.7621660666372
STAT,1856,37,25-29,1893,2.3056711768197067
STAT,1831,23,20-24,1854,158.56016370504054
STAT,1952,2,na,1954,4848.902427204134
STAT,1896,39,20-24,1935,1.0281527990068058
STAT,1850,51,30-34,1901,0.004498959795344831
SIM,1909,20,30-34,1929,43
STAT,1851,28,35-39,1879,9.253756358944669
SIM,1919,39,35-39,1958,6
STAT,1883,67,na,1950,1586.7482596541627
STAT,1898,47,30-34,1945,0.07497687839227123
SIM,1924,31,20-24,1955,6
STAT,1850,19,50-100,1869,0.04450354805516842
STAT,1896,28,25-29,1924,56.79434294031828
STAT,1835,34,45-49,1869,1.6208116532992431
SIM,1828,98,na,1926,12
STAT,1859,30,25-29,1889,8.466362676901422
SIM,1869,38,15-19,1907,2
STAT,1929,28,30-34,1957,49.9919582680542
SIM,1825,30,20-24,1855,6
SIM,1937,28,30-34,1965,10
STAT,1870,50,45-49,1920,0.014680667802917647
SIM,1858,26,45-49,1884,2
STAT,1912,44,25-29,1956,0.06971429860200908
STAT,1807,108,na,1915,7.740924419831344E-4
STAT,1881,86,na,1967,464.6643007439398
STAT,1890,43,25-29,1933,0.7951999930542379
SIM,1886,30,na,1916,2644
SIM,1880,22,40-44,1902,4
STAT,1903,15,na,1918,3679.5614604460034
STAT,1880,38,15-19,1918,0.05990076431524246
STAT,1869,20,40-44,1889,2.0734444833125196
STAT,1881,47,20-24,1928,0.011780152373488041
STAT,1919,38,15-19,1957,0.02103137251085701
SIM,1841,39,40-44,1880,9
SIM,1938,24,30-34,1962,1
STAT,1917,16,45-49,1933,0.10996938085574907
STAT,1837,42,40-44,1879,1.7696299476245234
STAT,1905,33,50-100,1938,0.7718676106646718
SIM,1951,20,25-29,1971,138
SIM,1925,16,45-49,1941,1
STAT,1921,34,na,1955,4258.087243802847
STAT,1927,32,35-39,1959,11.466967789311054
STAT,1829,48,20-24,1877,0.009587165538917608
STAT,1928,36,30-34,1964,2.351598740865908
SIM,1873,27,25-29,1900,55
SIM,1787,69,na,1856,583
STAT,1841,45,25-29,1886,0.04383074231505091
STAT,1939,31,15-19,1970,0.13383250742225652
SIM,1853,38,20-24,1891,1
SIM,1863,75,na,1938,744
SIM,1892,21,20-24,1913,103
STAT,1926,28,20-24,1954,22.244717755736758
STAT,1854,106,na,1960,0.025846150220528663
STAT,1866,36,30-34,1902,5.039111125823013
STAT,1887,43,50-100,1930,1.1989415197286968
STAT,1874,92,na,1966,131.82160513366347
STAT,1900,45,45-49,1945,0.19010672962415934
SIM,1922,34,20-24,1956,5
STAT,1912,46,20-24,1958,0.010861307986668367
SIM,1892,29,45-49,1921,4
SIM,1855,31,45-49,1886,2
SIM,1933,5,na,1938,5345
SIM,1848,13,na,1861,2361
STAT,1885,39,45-49,1924,2.008508233384703
STAT,1814,56,na,1870,1225.265955625173
STAT,1803,80,na,1883,300.65097199429283
STAT,1833,26,35-39,1859,8.597253773376652
STAT,1929,15,25-29,1944,56.66959881195876
STAT,1884,29,45-49,1913,1.11260043002627
SIM,1841,26,35-39,1867,15
STAT,1823,92,na,1915,23.18010052621317
STAT,1849,27,40-44,1876,2.7568251826127645
STAT,1905,31,45-49,1936,1.4812928407018418
STAT,1870,47,45-49,1917,0.23425676421157424
STAT,1928,16,20-24,1944,174.6764866586385
STAT,1852,54,45-49,1906,0.01136972356616636
SIM,1936,16,20-24,1952,120
STAT,1850,23,30-34,1873,15.966099676922026
STAT,1818,48,45-49,1866,0.5276366382216657
STAT,1914,34,20-24,1948,2.4836322616937023
SIM,1857,27,40-44,1884,2
STAT,1845,38,20-24,1883,0.6262943904461717
STAT,1858,34,25-29,1892,8.215401078245156
SIM,1896,62,na,1958,2550
STAT,1781,105,na,1886,0.019781947744202
SIM,1874,36,30-34,1910,10
STAT,1845,28,na,1873,2042.5820014154624
SIM,1925,2,na,1927,5114
STAT,1839,47,35-39,1886,0.09844356713709021
STAT,1907,16,50-100,1923,0.07356452933619216
SIM,1840,92,na,1932,20
STAT,1865,24,15-19,1889,3.0474691128945364
STAT,1834,38,45-49,1872,1.6514483456165077
STAT,1918,22,50-100,1940,0.7241977356906784
SIM,1959,6,na,1965,5722
STAT,1840,49,25-29,1889,0.040740448898177184
STAT,1864,31,45-49,1895,1.5882544615830418
SIM,1840,27,30-34,1867,24
STAT,1844,109,na,1953,5.513182714042213E-4
STAT,1923,42,50-100,1965,0.14009800498165664
STAT,1937,30,50-100,1967,0.8353136283935864
SIM,1875,4,na,1879,2804
SIM,1873,34,30-34,1907,21
SIM,1893,36,40-44,1929,7
STAT,1840,27,20-24,1867,10.525852186147326
STAT,1911,56,na,1967,3415.466836253784
SIM,1901,24,35-39,1925,8
STAT,1819,48,20-24,1867,0.023430876909319952
STAT,1890,18,20-24,1908,22.055513458488182
STAT,1943,15,50-100,1958,0.4055556397341845
SIM,1842,35,40-44,1877,2
SIM,1886,52,na,1938,2466
STAT,1858,68,na,1926,1236.3235361924292
STAT,1835,26,na,1861,2115.687669988597
STAT,1879,24,50-100,1903,0.43212710965244644
STAT,1900,64,na,1964,2673.0335005823426
STAT,1778,88,na,1866,28.970011669635863
STAT,1900,17,45-49,1917,0.0923627388399609
STAT,1879,30,na,1909,2565.1090209610775
STAT,1844,32,30-34,1876,16.17930143029735
SIM,1873,12,na,1885,2636
SIM,1815,58,na,1873,1154
STAT,1879,49,30-34,1928,0.10106794331916519
SIM,1919,42,na,1961,4182
STAT,1927,1,na,1928,5296.705248658272
SIM,1941,17,40-44,1958,2
STAT,1947,24,30-34,1971,33.11894311631528
SIM,1913,31,45-49,1944,3
STAT,1881,34,15-19,1915,0.13925096421559152
STAT,1910,24,35-39,1934,8.962077053493154
SIM,1811,68,na,1879,639
STAT,1823,49,25-29,1872,0.08417369998854446
STAT,1889,26,50-100,1915,0.8088706257980779
SIM,1795,64,na,1859,885
STAT,1887,36,45-49,1923,2.2897893024524265
STAT,1833,70,na,1903,921.3928017243941
STAT,1886,18,na,1904,2720.0348500542877
STAT,1922,48,30-34,1970,0.10420604441606901
STAT,1814,43,15-19,1857,0.045144240656340574
STAT,1937,29,35-39,1966,14.913378186469803
SIM,1816,38,35-39,1854,6
STAT,1823,52,25-29,1875,0.005126523619725065
STAT,1886,39,20-24,1925,0.8239945030942843
SIM,1943,24,na,1967,3632
STAT,1933,17,40-44,1950,1.909491822471838
STAT,1857,22,50-100,1879,0.37507181553351454
STAT,1897,38,25-29,1935,3.9078507362300177
STAT,1918,45,45-49,1963,0.2371292069734387
SIM,1842,28,35-39,1870,10
STAT,1849,41,20-24,1890,0.12385405692690556
STAT,1885,36,40-44,1921,4.4767732790119
SIM,1835,32,30-34,1867,8
STAT,1840,52,25-29,1892,0.00253525650139411
SIM,1858,45,45-49,1903,1
SIM,1866,31,20-24,1897,4
SIM,1836,19,20-24,1855,17
STAT,1829,37,25-29,1866,2.517461603548672
STAT,1891,62,na,1953,2308.4206609798603
SIM,1877,20,40-44,1897,4
STAT,1883,21,na,1904,2374.4790931976227
STAT,1891,64,na,1955,2195.5430919835485
STAT,1916,17,40-44,1933,0.30283612032122337
SIM,1895,36,45-49,1931,4
SIM,1936,22,na,1958,2987
SIM,1836,38,20-24,1874,3
STAT,1894,23,30-34,1917,23.301377860564475
STAT,1928,19,25-29,1947,55.39792039364385
STAT,1964,0,na,1964,5087.652524352235
SIM,1818,40,50-100,1858,2
STAT,1860,40,35-39,1900,1.5139601809301741
STAT,1907,20,15-19,1927,4.971049263237815
STAT,1824,34,na,1858,1588.6611105341965
STAT,1889,38,35-39,1927,8.868688961508628
SIM,1897,38,35-39,1935,2
SIM,1904,25,30-34,1929,55
SIM,1906,16,35-39,1922,1
SIM,1828,45,45-49,1873,2
STAT,1870,22,30-34,1892,17.763525524972632
STAT,1850,16,25-29,1866,5.239617896133439
SIM,1906,33,25-29,1939,12
STAT,1827,32,30-34,1859,26.96323397798334
STAT,1825,45,40-44,1870,0.2263093280389075
STAT,1943,28,20-24,1971,19.824791794474955
SIM,1912,18,na,1930,4087
SIM,1869,80,na,1949,475
STAT,1820,50,na,1870,1367.569375024945
STAT,1865,46,25-29,1911,0.05348342198850764
SIM,1894,39,20-24,1933,1
SIM,1851,28,45-49,1879,1
SIM,1898,28,40-44,1926,7
STAT,1834,28,35-39,1862,8.453402325610046
STAT,1870,28,45-49,1898,1.1033663178646724
SIM,1817,44,45-49,1861,3
SIM,1896,39,30-34,1935,2
STAT,1893,22,50-100,1915,0.5277405156886684
STAT,1873,21,45-49,1894,0.7233819251395299
SIM,1867,46,40-44,1913,1
SIM,1884,35,45-49,1919,5
STAT,1871,42,na,1913,2332.6892427367047
SIM,1843,34,50-100,1877,5
STAT,1871,21,35-39,1892,5.914699585815055
STAT,1876,35,45-49,1911,2.1199414033481636
STAT,1913,25,30-34,1938,40.099211366489214
STAT,1830,42,15-19,1872,0.011912969855428626
SIM,1831,56,na,1887,1332
SIM,1857,41,20-24,1898,1
SIM,1899,27,45-49,1926,2
STAT,1848,37,35-39,1885,5.665813682378153
SIM,1846,48,30-34,1894,1
SIM,1867,35,45-49,1902,2
STAT,1881,28,20-24,1909,11.52973727796235
STAT,1903,35,15-19,1938,0.017743603307049296
STAT,1873,99,na,1972,15.64282758159467
STAT,1924,20,15-19,1944,6.446726560403017
SIM,1921,25,30-34,1946,61
SIM,1795,86,na,1881,77
SIM,1883,29,35-39,1912,13
SIM,1832,33,30-34,1865,21
STAT,1875,36,40-44,1911,4.605351721200461
STAT,1923,27,na,1950,4388.325451536331
STAT,1831,24,45-49,1855,0.8736482572270888
STAT,1871,43,15-19,1914,0.013854363901569492
STAT,1865,48,na,1913,2056.9592892438186
SIM,1852,32,30-34,1884,28
SIM,1882,48,na,1930,2134
SIM,1888,38,25-29,1926,6
STAT,1853,22,30-34,1875,17.647011874484487
SIM,1873,24,15-19,1897,2
SIM,1883,36,40-44,1919,6
STAT,1830,27,20-24,1857,13.270526626546827
STAT,1892,29,35-39,1921,12.248579075151063
STAT,1895,49,15-19,1944,2.940496991723135E-4
SIM,1861,22,30-34,1883,29
STAT,1841,26,25-29,1867,39.073898183203084
STAT,1870,19,15-19,1889,5.904509429685547
SIM,1848,11,na,1859,2373
SIM,1898,20,45-49,1918,1
SIM,1824,86,na,1910,86
SIM,1878,38,25-29,1916,4
STAT,1875,29,35-39,1904,10.03032620869329
STAT,1952,18,20-24,1970,165.68332859173847
SIM,1869,46,45-49,1915,1
STAT,1869,39,20-24,1908,0.7515744017916888
SIM,1922,17,30-34,1939,23
STAT,1934,38,50-100,1972,0.5902624977770669
SIM,1870,77,na,1947,790
SIM,1816,45,40-44,1861,1
STAT,1842,85,na,1927,214.97748286813942
STAT,1934,25,50-100,1959,1.3666909000753609
STAT,1914,17,30-34,1931,2.5725013086044526
STAT,1891,17,25-29,1908,7.157066346881036
STAT,1860,20,20-24,1880,65.55328485766141
STAT,1940,27,25-29,1967,68.47244962833895
SIM,1856,37,35-39,1893,3
STAT,1854,21,35-39,1875,5.285592230597064
STAT,1929,21,45-49,1950,1.4556281593012677
STAT,1776,113,na,1889,4.694015926919585E-4
SIM,1951,11,na,1962,5316
STAT,1838,48,30-34,1886,0.0722405806903371
SIM,1928,25,na,1953,5034
STAT,1899,32,20-24,1931,3.77609115857459
STAT,1825,38,35-39,1863,10.482777812282855
SIM,1877,39,20-24,1916,1
SIM,1833,38,35-39,1871,10
STAT,1859,46,40-44,1905,0.1398752089099208
STAT,1904,27,15-19,1931,0.6633429802944318
SIM,1873,63,na,1936,1770
SIM,1882,24,30-34,1906,21
SIM,1862,21,35-39,1883,10
SIM,1912,27,15-19,1939,3
STAT,1844,62,na,1906,1416.3296695962629
SIM,1804,88,na,1892,61
STAT,1781,103,na,1884,0.05037223735192857
STAT,1860,28,45-49,1888,0.9221914440383998
STAT,1782,93,na,1875,6.529085764860973
STAT,1906,55,na,1961,3187.5344939594515
SIM,1937,21,45-49,1958,6
SIM,1834,20,20-24,1854,54
SIM,1912,39,25-29,1951,4
STAT,1803,101,na,1904,0.22142190385774949
STAT,1844,35,40-44,1879,4.021779765696982
STAT,1905,18,35-39,1923,0.8063195255262573
SIM,1874,39,35-39,1913,11
STAT,1896,45,15-19,1941,3.0703838934994626E-4
SIM,1773,85,na,1858,39
STAT,1866,12,na,1878,2533.6969307054906
STAT,1843,23,25-29,1866,57.590081521155604
SIM,1857,20,15-19,1877,2
SIM,1879,32,45-49,1911,5
STAT,1876,25,35-39,1901,10.233423813617755
STAT,1942,7,na,1949,4231.056194398689
SIM,1886,84,na,1970,686
STAT,1839,17,30-34,1856,1.4389607891387632
STAT,1908,26,45-49,1934,1.6852625850375176
STAT,1818,39,15-19,1857,0.16832981343024622
STAT,1887,16,20-24,1903,20.31584999954598
STAT,1870,44,40-44,1914,2.2128409982351553
SIM,1940,28,45-49,1968,4
STAT,1860,18,35-39,1878,0.5207234002663975
SIM,1820,70,na,1890,959
SIM,1903,35,na,1938,3405
STAT,1864,50,20-24,1914,6.789725157102915E-4
STAT,1836,65,na,1901,1051.8911116878085
SIM,1954,15,25-29,1969,70
SIM,1884,25,35-39,1909,17
SIM,1924,0,na,1924,5210
STAT,1917,38,20-24,1955,0.2780275214912262
STAT,1883,17,35-39,1900,0.5492388871643742
STAT,1845,31,35-39,1876,9.506498873339263
STAT,1910,36,45-49,1946,0.6681783149405758
STAT,1946,15,25-29,1961,49.065112570050495
SIM,1829,36,50-100,1865,2
SIM,1914,27,25-29,1941,67
SIM,1851,23,25-29,1874,65
STAT,1909,19,15-19,1928,9.027976660202281
SIM,1939,17,na,1956,3712
SIM,1895,16,20-24,1911,22
SIM,1847,17,30-34,1864,1
SIM,1833,77,na,1910,549
STAT,1914,37,25-29,1951,1.0030178075445022
STAT,1832,75,na,1907,687.9153321558147
SIM,1862,26,na,1888,2198
STAT,1904,39,25-29,1943,0.8994553015117593
STAT,1906,47,35-39,1953,0.1167140564024534
STAT,1824,36,35-39,1860,10.155482533774634
STAT,1932,28,45-49,1960,2.306555942920188
STAT,1940,19,40-44,1959,1.4478434022586824
STAT,1866,39,35-39,1905,6.58842448793668
STAT,1888,39,30-34,1927,6.362887754950734
STAT,1844,94,na,1938,15.487439182601218
STAT,1929,0,na,1929,5864.143158852143
SIM,1852,35,40-44,1887,4
STAT,1803,53,40-44,1856,0.041674086781752065
SIM,1906,24,na,1930,3474
SIM,1868,33,na,1901,2400
SIM,1917,19,15-19,1936,51
STAT,1864,47,20-24,1911,0.010834241783420417
SIM,1853,31,35-39,1884,3
STAT,1849,49,50-100,1898,0.18669301724317663
STAT,1857,30,15-19,1887,0.11655494134372452
STAT,1866,27,40-44,1893,2.818736312581457
STAT,1933,37,na,1970,5225.944705502901
STAT,1810,74,na,1884,465.73602780430406
SIM,1833,45,40-44,1878,1
SIM,1920,24,45-49,1944,1
STAT,1843,28,45-49,1871,1.095158932311629
STAT,1911,29,15-19,1940,0.6972300686825023
STAT,1879,39,20-24,1918,0.8137255164243827
STAT,1921,36,20-24,1957,0.3006303699807543
SIM,1842,73,na,1915,981
STAT,1851,25,30-34,1876,24.678338324738693
STAT,1859,93,na,1952,23.81036553598514
STAT,1912,24,45-49,1936,1.13915440860061
STAT,1949,20,na,1969,4350.41839136783
SIM,1832,23,20-24,1855,66
SIM,1949,20,25-29,1969,165
SIM,1848,37,40-44,1885,7
STAT,1900,32,na,1932,3374.1238893835343
SIM,1899,59,na,1958,2790
STAT,1839,34,15-19,1873,0.11846138013458307
SIM,1832,36,35-39,1868,15
STAT,1934,16,45-49,1950,0.6907504033966896
STAT,1849,20,15-19,1869,3.141557318640113
SIM,1846,41,45-49,1887,5
SIM,1822,37,20-24,1859,1
SIM,1881,17,30-34,1898,1
STAT,1812,48,50-100,1860,0.5713858023408022
STAT,1808,58,na,1866,924.2942316082447
STAT,1873,17,30-34,1890,1.6484588078390296
STAT,1790,88,na,1878,49.3850325665457
STAT,1918,20,30-34,1938,31.821693880874776
SIM,1863,38,20-24,1901,1
SIM,1886,38,na,1924,2582
STAT,1898,17,35-39,1915,0.7569730280443274
STAT,1912,41,20-24,1953,0.01747578593642601
STAT,1848,45,20-24,1893,0.00942099383657618
STAT,1840,33,15-19,1873,0.12352604202596915
STAT,1852,51,40-44,1903,0.008521670485914732
STAT,1858,31,20-24,1889,2.2096206369798854
STAT,1858,46,na,1904,1825.3061535383385
STAT,1855,28,50-100,1883,0.5131697893627613
SIM,1828,90,na,1918,52
SIM,1837,59,na,1896,1184
SIM,1854,40,50-100,1894,3
STAT,1819,41,35-39,1860,4.024569981233875
STAT,1892,36,40-44,1928,5.623846478404383
STAT,1915,25,40-44,1940,4.8842787057837445
SIM,1788,84,na,1872,173
STAT,1838,41,45-49,1879,1.302607083530424
STAT,1818,45,40-44,1863,0.40116524587428076
STAT,1890,69,na,1959,1943.5565350978688
STAT,1849,40,na,1889,1825.7157401323486
SIM,1926,20,30-34,1946,59
SIM,1932,23,25-29,1955,147
STAT,1964,8,na,1972,5048.032981125154
STAT,1912,49,25-29,1961,0.05170016038342883
STAT,1875,51,35-39,1926,0.009056904195455738
STAT,1891,27,35-39,1918,12.186576731729238
STAT,1779,111,na,1890,0.0010260828914675265
STAT,1885,20,25-29,1905,58.61100203382149
SIM,1922,37,25-29,1959,1
STAT,1861,74,na,1935,935.516521967097
STAT,1893,45,na,1938,2941.1978649440957
STAT,1872,24,20-24,1896,70.01709671290321
STAT,1928,39,35-39,1967,3.1113460776734114
STAT,1906,27,25-29,1933,62.81108468490501
STAT,1850,26,35-39,1876,8.602949881058711
SIM,1893,20,25-29,1913,4
SIM,1898,21,15-19,1919,1
SIM,1909,23,35-39,1932,1
STAT,1834,30,20-24,1864,2.378952724420595
SIM,1880,24,20-24,1904,82
STAT,1899,68,na,1967,2434.5038522539767
SIM,1839,26,35-39,1865,17
SIM,1917,28,20-24,1945,21
STAT,1868,78,na,1946,761.3050773690113
STAT,1877,22,25-29,1899,60.57077816171826
STAT,1884,24,25-29,1908,57.415306447485705
STAT,1778,86,na,1864,44.23128833604275
SIM,1936,19,25-29,1955,59
STAT,1924,23,25-29,1947,110.85834098688092
STAT,1855,51,50-100,1906,0.011763641944507793
SIM,1886,22,35-39,1908,10
STAT,1851,50,35-39,1901,0.00720469114652463
SIM,1906,46,na,1952,3308
SIM,1923,25,40-44,1948,9
STAT,1832,27,30-34,1859,22.936374310231802
STAT,1899,18,40-44,1917,0.25484059394690367
STAT,1854,42,40-44,1896,1.7193742094286841
STAT,1846,48,20-24,1894,0.008473635145710751
STAT,1868,24,40-44,1892,2.0176846681463383
STAT,1949,21,30-34,1970,34.22737135122011
STAT,1822,37,15-19,1859,0.10645155250053766
SIM,1805,81,na,1886,120
SIM,1934,20,25-29,1954,141
SIM,1941,23,na,1964,3924
STAT,1870,25,35-39,1895,9.687798718356188
STAT,1878,38,15-19,1916,0.059332595363127724
SIM,1825,33,25-29,1858,13
SIM,1850,49,35-39,1899,1
STAT,1909,28,20-24,1937,17.729124065554018
STAT,1838,38,20-24,1876,0.6763678719896223
STAT,1880,54,20-24,1934,7.693174908704987E-4
SIM,1827,41,35-39,1868,4
SIM,1901,26,na,1927,3548
STAT,1908,38,na,1946,3574.071653837877
STAT,1846,32,40-44,1878,3.6649399684506094
SIM,1888,18,30-34,1906,3
STAT,1842,49,35-39,1891,0.10749634186338725
STAT,1823,47,na,1870,1449.506992615842
STAT,1828,42,50-100,1870,0.8638073230095008
SIM,1893,39,45-49,1932,1
SIM,1854,32,40-44,1886,6
SIM,1906,28,45-49,1934,2
SIM,1842,30,20-24,1872,5
SIM,1888,19,na,1907,2966
STAT,1819,52,50-100,1871,0.02877474908552643
STAT,1886,32,35-39,1918,10.935328425494488
SIM,1846,38,20-24,1884,1
STAT,1878,22,35-39,1900,6.196470038997218
STAT,1894,59,na,1953,2550.24904712662
SIM,1888,0,na,1888,3670
SIM,1894,32,35-39,1926,19
STAT,1784,101,na,1885,0.11729682125962024
SIM,1879,20,35-39,1899,11
SIM,1801,58,na,1859,1249
STAT,1844,29,15-19,1873,0.4242341237130699
STAT,1918,46,15-19,1964,4.0102534284657974E-4
STAT,1881,7,na,1888,2599.787625197599
STAT,1890,40,20-24,1930,0.20009218191971176
STAT,1837,45,45-49,1882,0.16757831423349248
STAT,1876,73,na,1949,1251.213551339425
SIM,1959,4,na,1963,5724
SIM,1886,38,15-19,1924,1
STAT,1926,20,25-29,1946,115.16291670383333
SIM,1947,6,na,1953,4694
STAT,1830,47,15-19,1877,3.3196558182145585E-4
STAT,1906,38,45-49,1944,0.6357254497143697
STAT,1900,10,na,1910,3662.590778283635
STAT,1849,5,na,1854,2403.0
STAT,1865,37,35-39,1902,6.548838002457311
STAT,1912,36,50-100,1948,0.4200436441915847
STAT,1896,18,15-19,1914,7.974988086553373
SIM,1920,36,50-100,1956,2
SIM,1863,27,25-29,1890,41
STAT,1792,69,na,1861,606.9776660257215
STAT,1931,38,50-100,1969,0.5665123025800796
STAT,1858,17,40-44,1875,0.17284859335016833
STAT,1890,21,45-49,1911,0.8724208879470383
STAT,1864,31,na,1895,2173.4263910877517
STAT,1902,27,20-24,1929,16.87739962788402
STAT,1817,86,na,1903,108.28279581880403
SIM,1837,27,15-19,1864,3
SIM,1855,15,na,1870,2144
STAT,1892,26,30-34,1918,32.30710754689143
SIM,1826,48,45-49,1874,2
STAT,1944,11,na,1955,4313.5758981568915
STAT,1887,33,40-44,1920,4.936525004412205
STAT,1817,38,45-49,1855,6.530416690979534
STAT,1863,27,15-19,1890,0.4058150182813058
SIM,1875,44,na,1919,2299
SIM,1901,21,30-34,1922,49
SIM,1895,33,40-44,1928,10
STAT,1900,42,40-44,1942,0.22057902682804567
STAT,1871,48,15-19,1919,3.991306054297609E-4
STAT,1890,37,20-24,1927,0.961508230839711
STAT,1934,30,25-29,1964,12.883749755740345
SIM,1833,35,30-34,1868,3
STAT,1864,28,20-24,1892,10.60393426233525
STAT,1930,29,25-29,1959,85.27547994426624
SIM,1892,24,25-29,1916,96
STAT,1829,108,na,1937,0.0012182497707342835
STAT,1862,49,50-100,1911,0.20882594381380556
SIM,1847,44,30-34,1891,3
STAT,1840,19,35-39,1859,0.5052187272075647
SIM,1825,38,45-49,1863,1
STAT,1851,35,40-44,1886,3.7267888170074706
SIM,1832,23,15-19,1855,3
STAT,1818,36,50-100,1854,5.154175022335127
STAT,1878,43,50-100,1921,1.1137016287071992
STAT,1829,27,15-19,1856,0.6454629047025238
STAT,1869,53,50-100,1922,0.014635994052828689
STAT,1924,18,45-49,1942,0.6053271771883223
SIM,1831,30,45-49,1861,4
STAT,1825,35,30-34,1860,8.708359902755788
STAT,1897,22,45-49,1919,0.9511721388935888
STAT,1828,78,na,1906,430.2539324025345
STAT,1855,27,25-29,1882,34.180179243775044
SIM,1909,31,50-100,1940,2
SIM,1828,42,40-44,1870,4
STAT,1924,23,na,1947,4382.751733518223
STAT,1846,15,20-24,1861,16.115483492542097
STAT,1886,32,na,1918,2576.76755007686
STAT,1806,77,na,1883,366.1802507941103
SIM,1910,27,20-24,1937,21
STAT,1846,34,20-24,1880,2.2373922444827925
SIM,1855,27,30-34,1882,24
SIM,1952,15,na,1967,4526
STAT,1807,49,40-44,1856,0.7195315097359689
STAT,1849,39,35-39,1888,5.503398860980042
SIM,1932,18,45-49,1950,1
STAT,1905,23,15-19,1928,4.845579860657612
STAT,1921,19,30-34,1940,14.101538196471159
STAT,1927,15,15-19,1942,57.82902025509701
SIM,1883,31,20-24,1914,1
STAT,1833,25,na,1858,1897.0516878408137
SIM,1899,36,35-39,1935,5
STAT,1839,44,30-34,1883,0.8150930590091382
SIM,1838,31,45-49,1869,6
STAT,1939,17,35-39,1956,4.284788634296524
STAT,1914,29,40-44,1943,4.759873286314302
SIM,1947,17,35-39,1964,7
SIM,1801,91,na,1892,9
SIM,1922,29,40-44,1951,9
SIM,1808,70,na,1878,851
STAT,1875,31,20-24,1906,2.841697012625232
SIM,1815,49,40-44,1864,1
SIM,1826,36,50-100,1862,2
STAT,1820,103,na,1923,0.07904154589727919
STAT,1867,20,30-34,1887,17.37832268011502
SIM,1913,23,15-19,1936,6
SIM,1915,9,na,1924,4593
SIM,1857,39,35-39,1896,8
SIM,1854,34,20-24,1888,2
STAT,1884,60,na,1944,1924.8832848130087
STAT,1834,50,35-39,1884,0.0061804286550446045
STAT,1861,24,45-49,1885,0.5952495708750487
SIM,1861,38,50-100,1899,2
SIM,1810,44,35-39,1854,7
SIM,1854,15,20-24,1869,19
SIM,1935,15,15-19,1950,53
STAT,1812,55,na,1867,1219.4168248192636
STAT,1895,43,40-44,1938,0.20639456442867546
SIM,1891,31,na,1922,3072
STAT,1901,20,20-24,1921,98.89569672987312
STAT,1940,24,20-24,1964,115.4794449969788
SIM,1887,42,45-49,1929,3
STAT,1850,54,35-39,1904,0.006297696344190057
STAT,1861,25,50-100,1886,0.5510426290739895
SIM,1852,35,35-39,1887,4
SIM,1868,42,35-39,1910,1
STAT,1870,25,40-44,1895,3.0076313954519596
STAT,1899,35,25-29,1934,4.060350070367642
SIM,1883,73,na,1956,1333
STAT,1877,89,na,1966,277.8567403541145
STAT,1858,22,15-19,1880,3.062227359808131
SIM,1863,17,15-19,1880,5
STAT,1863,38,15-19,1901,0.04997841588580146
SIM,1884,29,na,1913,2574
STAT,1892,24,50-100,1916,0.5181213121102891
SIM,1840,47,na,1887,1591
SIM,1909,42,35-39,1951,2
STAT,1852,25,50-100,1877,0.6089475958154386
SIM,1846,30,na,1876,2108
SIM,1902,17,20-24,1919,27
SIM,1867,49,45-49,1916,1
STAT,1838,53,50-100,1891,0.010918607044710042
STAT,1859,49,45-49,1908,0.18825822334149095
STAT,1908,40,25-29,1948,0.06813373523242762
STAT,1847,27,30-34,1874,23.60287979670542
STAT,1848,44,na,1892,1772.3524267082666
STAT,1862,59,na,1921,1687.704329779424
STAT,1828,52,40-44,1880,0.007951976745046182
STAT,1837,37,15-19,1874,0.04558438730197826
STAT,1861,110,na,1971,0.0037296870990693428
STAT,1869,38,na,1907,2308.9124868087783
SIM,1812,83,na,1895,140
STAT,1865,34,30-34,1899,16.027594891440543
SIM,1918,20,40-44,1938,4
STAT,1863,35,45-49,1898,1.8000117221302874
SIM,1865,68,na,1933,1359
SIM,1908,30,25-29,1938,10
STAT,1870,15,50-100,1885,0.049909393736944044
SIM,1895,35,20-24,1930,4
SIM,1819,62,na,1881,996
STAT,1844,35,35-39,1879,6.498164288826244
SIM,1920,21,35-39,1941,14
SIM,1921,28,35-39,1949,4
SIM,1913,18,35-39,1931,1
SIM,1873,37,35-39,1910,14
STAT,1889,46,20-24,1935,0.015164657509975149
STAT,1855,44,15-19,1899,0.010560853918281847
SIM,1892,16,na,1908,3707
STAT,1908,36,na,1944,3609.175365418708
STAT,1879,42,45-49,1921,1.5939848638328602
STAT,1835,24,35-39,1859,5.699120840600327
STAT,1913,28,35-39,1941,15.207525956954486
SIM,1843,24,35-39,1867,8
SIM,1860,45,na,1905,1999
STAT,1881,17,25-29,1898,5.58896621702674
STAT,1804,68,na,1872,740.7121738347646
STAT,1865,43,20-24,1908,0.14598321218450547
STAT,1791,84,na,1875,98.48549514082438
SIM,1848,96,na,1944,10
STAT,1857,16,35-39,1873,0.5168661687289904
STAT,1865,16,na,1881,2424.0239575276373
STAT,1912,21,35-39,1933,9.233219865490456
STAT,1876,24,50-100,1900,0.4268891639192929
STAT,1819,95,na,1914,7.838478077043708
STAT,1827,35,40-44,1862,5.983021275359413
SIM,1873,24,20-24,1897,66
SIM,1927,29,25-29,1956,99
STAT,1924,48,40-44,1972,0.19096876756210632
SIM,1876,25,45-49,1901,1
STAT,1844,54,40-44,1898,0.007933655964649889
STAT,1915,30,15-19,1945,0.13462629717355182
STAT,1814,47,30-34,1861,0.28862465291962014
SIM,1865,8,na,1873,2698
STAT,1860,23,25-29,1883,48.49440487625803
STAT,1885,36,35-39,1921,7.233317074935654
SIM,1960,2,na,1962,5254
STAT,1826,97,na,1923,3.133310254693425
SIM,1843,42,30-34,1885,1
STAT,1835,39,15-19,1874,0.05068337170880789
STAT,1889,39,50-100,1928,1.531561024352196
SIM,1780,87,na,1867,69
STAT,1842,46,30-34,1888,0.07690266097226692
STAT,1839,22,20-24,1861,61.10844791717518
SIM,1898,37,30-34,1935,3
STAT,1848,27,25-29,1875,39.2552461243327
STAT,1879,45,15-19,1924,4.307940787126777E-4
SIM,1886,46,45-49,1932,1
STAT,1843,27,50-100,1870,0.6355302905305826
STAT,1920,30,na,1950,4261.541227034786
SIM,1893,22,40-44,1915,4
STAT,1887,30,50-100,1917,1.0558099598928392
SIM,1856,27,25-29,1883,7
STAT,1822,34,45-49,1856,3.990907792485312
STAT,1931,25,25-29,1956,86.73976255331131
SIM,1862,71,na,1933,1204
SIM,1861,44,40-44,1905,5
SIM,1903,24,45-49,1927,2
SIM,1839,38,50-100,1877,2
STAT,1845,79,na,1924,546.2437510860002
SIM,1946,7,na,1953,4337
STAT,1887,19,25-29,1906,6.4430872324761115
SIM,1833,48,45-49,1881,1
SIM,1862,4,na,1866,2652
SIM,1838,23,15-19,1861,4
STAT,1888,41,na,1929,2800.014175974124
SIM,1906,25,40-44,1931,11
STAT,1905,27,30-34,1932,37.10161504198669
SIM,1840,79,na,1919,390
STAT,1865,24,20-24,1889,63.657825722461325
STAT,1894,48,45-49,1942,0.17249233109905077
STAT,1891,33,20-24,1924,3.3995507200202146
SIM,1866,22,15-19,1888,4
STAT,1822,84,na,1906,193.42501914314494
STAT,1859,35,45-49,1894,1.6395479450727495
STAT,1932,33,50-100,1965,1.1201940680854148
SIM,1893,36,35-39,1929,13
STAT,1833,34,20-24,1867,2.2597417282145353
SIM,1847,25,50-100,1872,1
STAT,1907,51,na,1958,3295.042137765168
STAT,1818,45,35-39,1863,0.3280556924761562
SIM,1875,46,35-39,1921,1
STAT,1843,25,40-44,1868,3.0192746806480257
SIM,1925,36,na,1961,4782
STAT,1874,24,30-34,1898,18.436452164720126
STAT,1900,26,35-39,1926,13.689919381704952
STAT,1931,17,30-34,1948,16.27075404206383
STAT,1881,38,30-34,1919,5.2303701826211055
SIM,1855,24,na,1879,2059
SIM,1911,31,35-39,1942,19
STAT,1874,36,25-29,1910,3.013295634603741
SIM,1813,43,50-100,1856,2
STAT,1918,14,na,1932,4386.7648358685665
SIM,1882,36,25-29,1918,3
SIM,1841,34,20-24,1875,6
STAT,1835,42,30-34,1877,1.0267881258126583
STAT,1821,37,20-24,1858,1.6878205256874657
STAT,1867,46,35-39,1913,0.13446312444636938
STAT,1908,32,30-34,1940,15.164867108124323
SIM,1899,24,35-39,1923,9
STAT,1906,24,20-24,1930,101.68385451843584
SIM,1851,31,na,1882,1984
SIM,1879,24,15-19,1903,5
SIM,1915,23,25-29,1938,117
SIM,1826,35,na,1861,1735
SIM,1839,82,na,1921,246
STAT,1855,89,na,1944,81.43730919359658
SIM,1938,4,na,1942,4019
STAT,1888,44,na,1932,2749.777151324519
STAT,1825,48,45-49,1873,0.2994047103884146
STAT,1898,51,na,1949,2984.7017742977387
STAT,1927,36,15-19,1963,0.024377044848885757
STAT,1876,43,30-34,1919,1.2023456237753676
SIM,1946,4,na,1950,4374
SIM,1820,43,40-44,1863,2
STAT,1840,37,30-34,1877,4.536047971836355
STAT,1861,29,15-19,1890,0.37972334138685987
STAT,1897,35,15-19,1932,0.07732432666987402
STAT,1823,33,15-19,1856,0.32316594447458274
STAT,1824,42,20-24,1866,0.1956789406165691
STAT,1837,52,na,1889,1440.7780478403913
STAT,1836,21,25-29,1857,47.36846925969159
STAT,1904,36,20-24,1940,0.24443073977791738
SIM,1883,41,na,1924,2417
STAT,1933,34,25-29,1967,12.686124148462312
SIM,1841,35,25-29,1876,2
SIM,1916,32,30-34,1948,26
STAT,1859,34,40-44,1893,3.5029380788540188
STAT,1890,24,15-19,1914,4.0892336941864995
STAT,1809,52,30-34,1861,0.025284222864940708
STAT,1839,34,20-24,1873,2.24853100041966
STAT,1924,27,40-44,1951,5.5369228853653105
STAT,1929,24,15-19,1953,6.822857863053323
SIM,1851,25,40-44,1876,1
STAT,1927,35,45-49,1962,0.8660951872735696
SIM,1841,24,na,1865,1824
SIM,1877,27,na,1904,2451
STAT,1884,51,na,1935,2183.552434782153
SIM,1798,75,na,1873,344
SIM,1884,43,30-34,1927,3
SIM,1881,63,na,1944,1675
SIM,1857,36,30-34,1893,5
SIM,1836,42,na,1878,1868
SIM,1844,21,25-29,1865,68
STAT,1859,46,35-39,1905,0.11438393278357749
STAT,1889,28,25-29,1917,53.118229369827155
SIM,1873,34,na,1907,2364
STAT,1892,39,45-49,1931,2.5231436240300025
STAT,1899,23,15-19,1922,4.594395915458554
SIM,1835,35,40-44,1870,2
STAT,1860,15,30-34,1875,1.5396227333517385
STAT,1851,64,na,1915,1434.1759044191242
STAT,1874,53,50-100,1927,0.01547787855222003
STAT,1919,29,25-29,1948,72.05532381889785
SIM,1833,37,50-100,1870,3
STAT,1868,20,25-29,1888,56.58794048467799
STAT,1812,43,40-44,1855,6.006275293647367
SIM,1835,24,45-49,1859,3
STAT,1856,34,na,1890,1894.6053119207838
SIM,1847,22,20-24,1869,79
STAT,1907,23,25-29,1930,85.48249551508042
STAT,1823,33,50-100,1856,2.0792373856680015
SIM,1854,1,na,1855,3202
SIM,1827,29,20-24,1856,7
SIM,1928,38,30-34,1966,2
SIM,1835,23,40-44,1858,3
STAT,1921,4,na,1925,4694.75000028761
STAT,1894,26,40-44,1920,3.9443230854710847
STAT,1925,47,45-49,1972,0.2686945571362122
SIM,1826,32,na,1858,1795
SIM,1851,34,na,1885,1902
STAT,1927,23,45-49,1950,1.4097348990909133
SIM,1897,26,50-100,1923,1
STAT,1905,20,50-100,1925,0.604400590511926
SIM,1913,35,25-29,1948,4
SIM,1876,93,na,1969,139
STAT,1823,46,20-24,1869,0.018297591370197756
SIM,1858,35,35-39,1893,12
STAT,1855,24,20-24,1879,61.51583147943235
SIM,1859,37,na,1896,2233
STAT,1823,41,50-100,1864,1.7519595352291468
SIM,1863,24,20-24,1887,87
SIM,1879,49,50-100,1928,1
STAT,1929,19,40-44,1948,1.8108825411904834
SIM,1937,24,15-19,1961,6
STAT,1965,2,na,1967,5010.394754419505
SIM,1819,44,50-100,1863,3
SIM,1903,0,na,1903,3940
SIM,1916,20,30-34,1936,44
STAT,1944,20,40-44,1964,3.7064730789676656
SIM,1900,30,20-24,1930,4
STAT,1874,35,20-24,1909,0.8105119090090698
STAT,1905,35,25-29,1940,0.9243047682381366
SIM,1880,27,25-29,1907,52
STAT,1894,15,45-49,1909,0.08611563597765266
SIM,1828,28,25-29,1856,46
SIM,1914,24,20-24,1938,106
STAT,1924,46,50-100,1970,0.2754066072748327
STAT,1907,44,25-29,1951,0.06589322179867388
STAT,1884,26,40-44,1910,3.0337459735801904
SIM,1876,20,25-29,1896,79
STAT,1891,19,na,1910,3172.728902961032
STAT,1821,69,na,1890,773.3062118720133
SIM,1871,32,40-44,1903,7
STAT,1789,72,na,1861,433.93286490536644
STAT,1922,11,na,1933,4685.928990080799
STAT,1952,15,50-100,1967,0.45824670079148117
STAT,1840,27,na,1867,1940.95892772658
STAT,1930,26,20-24,1956,23.683533254771394
STAT,1867,29,na,1896,2269.313020514689
STAT,1896,49,30-34,1945,0.0720338093419456
STAT,1908,20,30-34,1928,27.104495200379855
STAT,1941,15,40-44,1956,1.4705942889037207
STAT,1851,38,45-49,1889,1.6451023038535415
SIM,1868,42,na,1910,2326
SIM,1871,35,45-49,1906,1
STAT,1849,36,30-34,1885,4.278127676631827
STAT,1878,25,45-49,1903,1.1869864787158484
STAT,1881,18,50-100,1899,0.04819298559494779
STAT,1925,20,30-34,1945,35.30902858215184
STAT,1836,48,20-24,1884,0.007717753270109024
SIM,1858,74,na,1932,927
SIM,1847,82,na,1929,260
SIM,1905,16,na,1921,3648
STAT,1839,30,na,1869,1879.2791798510846
SIM,1817,50,na,1867,1289
STAT,1915,37,35-39,1952,2.4933861444217844
SIM,1913,48,30-34,1961,1
SIM,1874,24,30-34,1898,33
STAT,1944,28,50-100,1972,1.097045776820492
STAT,1850,32,20-24,1882,2.126987308866438
SIM,1938,22,15-19,1960,3
SIM,1876,36,40-44,1912,10
STAT,1841,49,40-44,1890,0.12376671603544237
SIM,1908,29,15-19,1937,1
STAT,1893,36,35-39,1929,9.19745210339539
SIM,1816,57,na,1873,1293
SIM,1848,67,na,1915,1195
SIM,1839,26,50-100,1865,1
STAT,1921,15,50-100,1936,0.43781058676154744
SIM,1870,19,20-24,1889,21
STAT,1880,56,na,1936,2186.54806394894
SIM,1849,60,na,1909,1477
STAT,1771,99,na,1870,0.31302849082932677
STAT,1805,102,na,1907,0.11783490958900539
STAT,1899,39,na,1938,3283.812796898088
SIM,1881,24,15-19,1905,3
SIM,1885,22,na,1907,2394
STAT,1945,19,25-29,1964,48.265211017360784
SIM,1816,43,25-29,1859,1
SIM,1866,64,na,1930,1837
STAT,1872,19,50-100,1891,0.049822123065560886
STAT,1881,21,50-100,1902,0.40340872580242415
SIM,1826,64,na,1890,1044
SIM,1892,26,40-44,1918,4
STAT,1868,36,40-44,1904,4.285824916409486
SIM,1867,46,35-39,1913,1
SIM,1897,28,25-29,1925,79
SIM,1844,29,20-24,1873,11
STAT,1904,15,20-24,1919,26.040709377749604
STAT,1934,22,30-34,1956,39.38963641385634
STAT,1836,29,20-24,1865,9.314092346142658
SIM,1876,24,40-44,1900,3
SIM,1915,44,25-29,1959,2
SIM,1923,37,35-39,1960,3
STAT,1893,28,50-100,1921,0.8249415907615836
SIM,1869,48,25-29,1917,1
SIM,1912,15,20-24,1927,33
STAT,1813,79,na,1892,300.6343780160789
STAT,1924,15,40-44,1939,1.7072643702230208
STAT,1905,48,30-34,1953,0.07943856862943313
SIM,1877,32,50-100,1909,2
SIM,1886,25,45-49,1911,2
SIM,1825,35,40-44,1860,4
SIM,1888,11,na,1899,3066
STAT,1829,42,50-100,1871,0.8865063901552116
STAT,1853,79,na,1932,586.1988348710689
SIM,1809,54,50-100,1863,1
STAT,1931,25,na,1956,4936.781675253313
STAT,1946,24,15-19,1970,6.039635662240004
STAT,1888,76,na,1964,1444.7532342238267
SIM,1942,22,30-34,1964,72
STAT,1843,45,35-39,1888,0.11541098597570754
SIM,1866,34,25-29,1900,19
SIM,1904,41,45-49,1945,2
SIM,1869,22,40-44,1891,3
STAT,1915,16,35-39,1931,0.8983878159064439
STAT,1921,27,15-19,1948,0.8028667140254769
STAT,1941,27,35-39,1968,15.844919841651507
STAT,1821,46,50-100,1867,0.39280274774627094
SIM,1838,35,na,1873,1753
SIM,1908,56,na,1964,3448
STAT,1819,42,na,1861,1678.0216897569696
STAT,1931,41,30-34,1972,0.1744349156108557
STAT,1918,38,50-100,1956,0.4511424008502218
SIM,1917,19,na,1936,3902
SIM,1913,27,30-34,1940,4
SIM,1859,32,25-29,1891,16
STAT,1846,18,25-29,1864,5.060650064311107
SIM,1889,30,45-49,1919,5
STAT,1867,23,35-39,1890,5.571554834088098
SIM,1854,18,25-29,1872,8
STAT,1878,46,45-49,1924,0.25131074791542407
SIM,1899,21,30-34,1920,37
STAT,1858,12,na,1870,2256.0072267907412
STAT,1862,19,20-24,1881,15.857049465400046
SIM,1907,20,20-24,1927,106
STAT,1856,34,15-19,1890,0.11306419387678127
STAT,1931,38,30-34,1969,2.4592051945390447
STAT,1884,46,35-39,1930,0.14170074179789596
SIM,1815,72,na,1887,562
STAT,1900,23,30-34,1923,25.10784936173462
STAT,1839,53,20-24,1892,5.01094357866445E-4
STAT,1831,26,25-29,1857,43.36297278389027
SIM,1837,27,na,1864,1724
SIM,1877,56,na,1933,2103
STAT,1873,11,na,1884,2725.5600504421614
STAT,1866,24,30-34,1890,16.6559016303296
SIM,1911,25,50-100,1936,5
STAT,1880,70,na,1950,1504.1370965625692
STAT,1912,25,15-19,1937,0.7145031041878575
STAT,1883,47,30-34,1930,0.09644173211485585
STAT,1826,45,35-39,1871,0.11233169197479555
STAT,1835,107,na,1942,0.0035136962576724686
SIM,1913,26,na,1939,3892
STAT,1861,32,30-34,1893,14.717987264632969
SIM,1871,31,50-100,1902,1
STAT,1950,17,40-44,1967,1.6872506871427089
SIM,1841,16,25-29,1857,5
SIM,1853,19,20-24,1872,25
SIM,1867,42,50-100,1909,4
STAT,1834,87,na,1921,118.3965770300411
SIM,1866,36,40-44,1902,2
SIM,1867,49,na,1916,1968
SIM,1860,13,na,1873,2345
SIM,1895,38,25-29,1933,2
SIM,1787,80,na,1867,213
STAT,1905,15,30-34,1920,2.3592295105036483
STAT,1926,19,15-19,1945,56.45935623304589
SIM,1934,19,15-19,1953,56
SIM,1909,33,45-49,1942,4
STAT,1802,87,na,1889,53.82532852903683
STAT,1932,37,35-39,1969,3.314249849581355
SIM,1923,16,35-39,1939,6
STAT,1853,28,45-49,1881,0.9743952323316553
SIM,1861,28,45-49,1889,1
STAT,1845,19,20-24,1864,17.302252376747727
STAT,1941,20,15-19,1961,5.61613237732516
STAT,1880,78,na,1958,956.3864169390988
STAT,1877,49,20-24,1926,0.012431927707297638
STAT,1827,54,40-44,1881,0.009976281363406395
SIM,1893,25,45-49,1918,2
STAT,1853,90,na,1943,66.10771191015812
STAT,1865,27,25-29,1892,39.16700528061442
STAT,1881,53,25-29,1934,0.0034373168717248357
SIM,1893,33,30-34,1926,34
SIM,1843,45,35-39,1888,1
SIM,1814,95,na,1909,7
STAT,1904,45,na,1949,3322.827065429641
SIM,1922,25,25-29,1947,86
SIM,1903,21,40-44,1924,3
SIM,1912,2,na,1914,4339
STAT,1849,32,15-19,1881,0.11650233281603047
SIM,1928,22,15-19,1950,5
STAT,1850,39,40-44,1889,3.276172591775207
STAT,1808,46,50-100,1854,0.6775270186572208
STAT,1831,98,na,1929,2.1889358840664075
SIM,1826,34,45-49,1860,2
STAT,1897,58,na,1955,2697.515321113616
STAT,1922,15,30-34,1937,14.460323145302404
STAT,1827,38,45-49,1865,2.524022476906089
STAT,1927,20,40-44,1947,4.250987440348558
SIM,1930,15,30-34,1945,38
STAT,1835,45,35-39,1880,0.12401116094404266
SIM,1904,12,na,1916,4028
STAT,1859,16,45-49,1875,0.06214238464218963
STAT,1891,30,na,1921,3038.132142782607
STAT,1912,29,30-34,1941,39.1083797697584
STAT,1901,41,45-49,1942,0.14893489683510552
STAT,1885,33,30-34,1918,17.69514017631124
SIM,1848,45,na,1893,1833
STAT,1894,45,40-44,1939,0.12798566695367006
SIM,1920,29,30-34,1949,49
STAT,1887,38,25-29,1925,3.274981543858952
STAT,1934,37,45-49,1971,0.9593785652948877
SIM,1841,23,30-34,1864,29
SIM,1905,34,20-24,1939,4
STAT,1837,24,45-49,1861,0.5999234125754663
STAT,1930,9,na,1939,5249.133606727361
SIM,1887,15,na,1902,3045
STAT,1919,44,na,1963,4093.435826288711
SIM,1830,31,40-44,1861,7
STAT,1920,19,20-24,1939,154.39293142965826
STAT,1860,25,40-44,1885,2.54241571295799
SIM,1937,2,na,1939,4721
STAT,1943,19,15-19,1962,49.0673912349361
STAT,1875,39,45-49,1914,2.0661950635358384
STAT,1895,46,45-49,1941,0.17769211311864266
SIM,1815,40,na,1855,1541
STAT,1901,29,20-24,1930,16.616229859640487
STAT,1879,62,na,1941,1949.0102416114937
STAT,1874,33,20-24,1907,2.803521875122019
STAT,1894,29,45-49,1923,1.4465468102059853
STAT,1850,42,50-100,1892,0.7936898465811167
SIM,1889,35,30-34,1924,11
SIM,1784,91,na,1875,9
SIM,1935,20,40-44,1955,6
STAT,1844,23,40-44,1867,2.001666179168285
STAT,1890,40,50-100,1930,1.3310479673969418
STAT,1853,47,45-49,1900,0.1969631367695571
SIM,1852,23,40-44,1875,2
SIM,1875,78,na,1953,765
SIM,1927,26,20-24,1953,17
SIM,1927,40,na,1967,4663
SIM,1932,20,15-19,1952,7
SIM,1871,33,45-49,1904,2
STAT,1914,25,25-29,1939,68.15901953396698
SIM,1883,39,45-49,1922,2
SIM,1878,35,20-24,1913,1
STAT,1853,50,45-49,1903,0.012343508585830772
STAT,1885,25,45-49,1910,1.1377095557439725
SIM,1897,47,na,1944,2989
SIM,1897,22,na,1919,3173
STAT,1888,20,35-39,1908,7.079697817062284
STAT,1899,36,na,1935,3307.069578706835
SIM,1880,17,15-19,1897,6
STAT,1808,48,45-49,1856,0.6025794516278823
STAT,1948,24,25-29,1972,108.13283678848094
SIM,1915,27,40-44,1942,7
STAT,1833,23,30-34,1856,16.81919431233989
STAT,1891,35,20-24,1926,0.9828267681117412
STAT,1804,65,na,1869,828.3799076515888
STAT,1914,55,na,1969,3600.772360144944
SIM,1917,30,na,1947,4011
STAT,1822,32,45-49,1854,5.493566448825535
SIM,1900,33,25-29,1933,20
SIM,1893,24,40-44,1917,5
STAT,1867,43,30-34,1910,1.09311981113201
SIM,1820,46,45-49,1866,1
STAT,1890,28,30-34,1918,31.299747460701433
STAT,1905,39,40-44,1944,1.3780723184128687
SIM,1837,18,25-29,1855,7
SIM,1919,36,30-34,1955,2
STAT,1923,24,20-24,1947,131.18046910821306
STAT,1908,35,35-39,1943,2.331183617494132
SIM,1875,43,30-34,1918,2
STAT,1868,18,50-100,1886,0.04831413262195095
STAT,1853,44,40-44,1897,1.860557178152722
SIM,1826,33,40-44,1859,12
STAT,1889,29,na,1918,2985.8678771462473
STAT,1870,49,na,1919,2196.8359056041863
STAT,1919,26,20-24,1945,20.196021443821376
STAT,1832,52,50-100,1884,0.0105484888426894
SIM,1831,37,30-34,1868,8
STAT,1812,46,45-49,1858,0.5681920324718788
SIM,1931,24,20-24,1955,148
STAT,1944,23,45-49,1967,1.239061947158286
STAT,1823,37,30-34,1860,9.985689381562057
STAT,1918,42,35-39,1960,0.21848073339952997
SIM,1835,38,45-49,1873,3
STAT,1922,31,45-49,1953,1.8215573807088388
STAT,1824,44,20-24,1868,0.18810954026871896
SIM,1879,28,30-34,1907,41
SIM,1854,37,25-29,1891,5
SIM,1883,34,25-29,1917,8
SIM,1897,35,30-34,1932,11
STAT,1872,17,15-19,1889,6.087619490094787
SIM,1841,32,20-24,1873,2
STAT,1824,49,40-44,1873,0.1942057611867107
STAT,1818,42,30-34,1860,2.943684651215154
STAT,1866,41,na,1907,2184.6481912836853
STAT,1933,31,20-24,1964,3.354180499908184
STAT,1818,49,50-100,1867,0.5405804073019318
SIM,1896,20,35-39,1916,13
SIM,1869,29,25-29,1898,43
STAT,1848,24,20-24,1872,64.29121834728595
STAT,1824,45,25-29,1869,0.06896702041367431
SIM,1884,26,na,1910,2726
SIM,1866,7,na,1873,2811
SIM,1871,53,na,1924,1973
STAT,1867,26,na,1893,2293.49272678571
SIM,1852,24,45-49,1876,1
STAT,1875,34,25-29,1909,10.63230026654113
SIM,1847,37,25-29,1884,2
STAT,1846,37,25-29,1883,2.1501499152392967
SIM,1931,19,50-100,1950,1
STAT,1814,54,50-100,1868,0.04139252756731142
SIM,1817,84,na,1901,153
STAT,1891,36,25-29,1927,3.6539223878198106
STAT,1923,19,50-100,1942,0.44646125477472
SIM,1846,86,na,1932,105
SIM,1858,20,30-34,1878,19
STAT,1914,31,50-100,1945,0.8526074795836082
STAT,1869,23,45-49,1892,0.6846756911489147
STAT,1885,24,40-44,1909,2.107579517129881
STAT,1876,46,35-39,1922,0.14789883742920357
SIM,1937,19,40-44,1956,1
SIM,1938,27,35-39,1965,28
STAT,1875,26,na,1901,2507.290192608891
SIM,1848,34,30-34,1882,8
STAT,1890,1,na,1891,3395.084391188818
SIM,1913,39,40-44,1952,1
SIM,1947,14,na,1961,4671
SIM,1856,24,20-24,1880,61
STAT,1806,91,na,1897,20.590827018219414
SIM,1916,35,35-39,1951,3
STAT,1907,27,40-44,1934,4.487016103339671
STAT,1847,31,45-49,1878,1.613308795769607
STAT,1834,35,40-44,1869,3.7411650399445375
STAT,1893,5,na,1898,3391.490069306474
STAT,1839,37,25-29,1876,2.3745651962549554
STAT,1833,32,20-24,1865,2.3091012290637507
SIM,1888,23,20-24,1911,99
STAT,1889,35,30-34,1924,6.779816474504191
STAT,1932,21,50-100,1953,0.8831186078953406
STAT,1934,25,35-39,1959,20.614756299740748
SIM,1853,97,na,1950,7
SIM,1940,21,50-100,1961,4
STAT,1775,91,na,1866,16.442837055954
SIM,1916,47,45-49,1963,1
STAT,1878,44,45-49,1922,1.5677726365788278
STAT,1915,34,30-34,1949,16.233885874714055
SIM,1902,29,20-24,1931,16
STAT,1917,30,25-29,1947,9.956213423858916
SIM,1860,16,na,1876,2251
SIM,1909,30,40-44,1939,4
STAT,1941,18,45-49,1959,0.5247658138470485
SIM,1876,39,45-49,1915,7
STAT,1916,33,na,1949,3967.854666259438
SIM,1845,42,40-44,1887,4
SIM,1848,16,35-39,1864,1
STAT,1841,23,15-19,1864,3.063572789195911
STAT,1843,16,na,1859,2382.099197923657
STAT,1854,45,45-49,1899,0.18242443039763656
STAT,1880,8,na,1888,2821.136132963109
SIM,1930,31,45-49,1961,5
STAT,1840,46,20-24,1886,0.008820166260725995
STAT,1855,71,na,1926,1034.7351375163348
STAT,1872,42,50-100,1914,1.0788178966801143
STAT,1945,16,20-24,1961,151.1427133269751
STAT,1836,68,na,1904,951.2030013073021
STAT,1931,29,40-44,1960,6.13103627177032
SIM,1945,26,30-34,1971,7
SIM,1834,42,30-34,1876,4
STAT,1905,41,na,1946,3432.4739155584316
SIM,1904,28,35-39,1932,18
STAT,1904,18,25-29,1922,8.2634229877148
STAT,1906,26,na,1932,3555.77963862446
SIM,1918,15,15-19,1933,9
STAT,1868,39,45-49,1907,1.92283908408105
STAT,1838,44,15-19,1882,0.010525278783677542
STAT,1875,17,40-44,1892,0.1915014508700631
STAT,1919,22,na,1941,4080.6305779877594
STAT,1844,24,45-49,1868,0.6650241148955963
SIM,1870,23,na,1893,2597
STAT,1829,34,20-24,1863,2.4206161557819867
STAT,1849,36,50-100,1885,0.985526529547912
STAT,1869,52,na,1921,2109.383583859514
STAT,1891,44,50-100,1935,1.316286057562289
STAT,1850,100,na,1950,0.7985745269403123
STAT,1853,23,na,1876,2103.0798452304566
SIM,1897,25,20-24,1922,16
SIM,1883,26,30-34,1909,2
STAT,1872,27,25-29,1899,43.25022700853651
SIM,1842,33,25-29,1875,13
STAT,1854,53,na,1907,1621.4774416343919
SIM,1903,67,na,1970,2579
STAT,1846,75,na,1921,736.1907374770718
STAT,1861,35,35-39,1896,6.018872363242321
SIM,1923,34,30-34,1957,28
SIM,1953,16,20-24,1969,237
STAT,1859,22,30-34,1881,15.056623075744124
STAT,1868,22,na,1890,2304.426143120758
STAT,1939,22,25-29,1961,94.63239846449952
STAT,1925,23,35-39,1948,11.463445586052087
STAT,1908,47,45-49,1955,0.20043057712456647
SIM,1867,43,30-34,1910,1
SIM,1886,44,45-49,1930,6
STAT,1849,44,25-29,1893,0.4918159539253827
STAT,1869,32,35-39,1901,9.974232702916781
SIM,1885,22,25-29,1907,63
STAT,1866,63,na,1929,1678.977094704821
SIM,1912,18,25-29,1930,10
STAT,1950,14,na,1964,4736.716792023401
STAT,1826,46,na,1872,1509.4179516126703
STAT,1907,41,20-24,1948,0.016593896108112745
SIM,1877,32,35-39,1909,18
STAT,1876,37,50-100,1913,1.2933403033484527
STAT,1850,35,25-29,1885,2.2462087997173747
STAT,1877,81,na,1958,682.2739719145262
SIM,1834,61,na,1895,1295
SIM,1895,66,na,1961,2309
SIM,1838,27,30-34,1865,27
SIM,1947,22,25-29,1969,135
STAT,1923,22,50-100,1945,0.7811519554628393
SIM,1896,29,na,1925,3169
STAT,1937,26,30-34,1963,38.97722989734138
STAT,1864,34,15-19,1898,0.12806953314810404
STAT,1866,34,50-100,1900,0.854778278393997
STAT,1840,72,na,1912,908.7765824762109
STAT,1916,27,50-100,1943,1.0502361499758095
STAT,1935,29,50-100,1964,1.3822892456301936
STAT,1897,18,30-34,1915,2.1684001070079373
STAT,1786,83,na,1869,111.1659381326215
SIM,1925,30,25-29,1955,16
SIM,1824,54,na,1878,1224
STAT,1875,26,30-34,1901,26.45619753658333
SIM,1914,41,na,1955,3770
SIM,1835,21,40-44,1856,4
STAT,1834,33,25-29,1867,8.737997995007873
STAT,1863,31,50-100,1894,0.8228865614848077
SIM,1840,20,45-49,1860,3
STAT,1875,22,15-19,1897,3.454113308750526
STAT,1809,49,15-19,1858,0.0017205346153180035
SIM,1893,15,35-39,1908,1
STAT,1807,54,na,1861,1335.0067385127613
SIM,1933,23,35-39,1956,17
STAT,1929,33,20-24,1962,3.158101617337224
STAT,1859,43,30-34,1902,0.9298857476035453
STAT,1889,25,20-24,1914,14.883608463683261
STAT,1817,61,na,1878,1077.473563005632
STAT,1911,17,20-24,1928,27.673476106930018
STAT,1941,24,30-34,1965,30.28142868559544
STAT,1857,104,na,1961,0.15888996440498185
STAT,1868,19,15-19,1887,5.8179821670312935
SIM,1837,34,20-24,1871,3
SIM,1842,25,30-34,1867,27
SIM,1864,38,na,1902,2132
STAT,1811,101,na,1912,0.24717040858962103
STAT,1818,46,na,1864,1447.024594204417
STAT,1849,46,40-44,1895,0.13329028857896574
SIM,1835,46,na,1881,1627
SIM,1861,25,40-44,1886,4
STAT,1903,31,35-39,1934,14.745929121912914
SIM,1845,43,45-49,1888,2
SIM,1949,21,50-100,1970,5
STAT,1874,27,35-39,1901,10.049955792409172
STAT,1904,20,50-100,1924,0.5997737892751636
SIM,1926,23,35-39,1949,16
STAT,1831,76,na,1907,638.3806568354116
STAT,1896,25,20-24,1921,15.913647222510974
STAT,1853,25,40-44,1878,2.9520196029113404
STAT,1853,45,na,1898,1905.2960154799546
SIM,1948,21,20-24,1969,4
SIM,1882,27,35-39,1909,10
STAT,1882,15,25-29,1897,5.658197321077891
STAT,1907,9,na,1916,3886.467077730296
STAT,1918,23,35-39,1941,10.331245885473285
STAT,1834,25,30-34,1859,22.54391778803315
SIM,1856,34,30-34,1890,28
STAT,1885,15,35-39,1900,0.5610592378852695
STAT,1946,21,na,1967,4147.483514347668
STAT,1866,20,15-19,1886,3.175060222431873
STAT,1850,34,20-24,1884,2.083270719541301
STAT,1921,48,50-100,1969,0.25946347947506065
SIM,1837,72,na,1909,760
SIM,1942,25,35-39,1967,28
SIM,1864,17,30-34,1881,1
STAT,1902,39,15-19,1941,0.01726156171189477
SIM,1937,33,20-24,1970,4
STAT,1934,17,50-100,1951,0.5167935486812759
SIM,1902,9,na,1911,3798
STAT,1842,53,na,1895,1661.4129574836174
STAT,1847,107,na,1954,0.0036775621162461443
STAT,1848,34,30-34,1882,14.106892628895686
SIM,1829,41,45-49,1870,2
SIM,1942,17,50-100,1959,1
SIM,1890,24,15-19,1914,7
STAT,1767,91,na,1858,11.681813245210137
STAT,1878,66,na,1944,1740.4013272133425
SIM,1839,31,na,1870,1978
SIM,1872,89,na,1961,111
STAT,1846,27,15-19,1873,0.3925073925002967
STAT,1826,42,30-34,1868,0.9421737509402013
STAT,1839,64,na,1903,1199.719082937441
STAT,1882,24,15-19,1906,3.2582975280760396
SIM,1816,46,50-100,1862,1
STAT,1787,68,na,1855,827.5606
STAT,1858,47,50-100,1905,0.1977659697541808
SIM,1872,38,30-34,1910,9
STAT,1864,38,30-34,1902,4.810387283516186
SIM,1880,42,50-100,1922,3
STAT,1931,34,15-19,1965,0.17150552648687614
STAT,1852,38,50-100,1890,0.9841657869737727
STAT,1893,33,30-34,1926,22.50007880871695
SIM,1926,44,na,1970,4892
SIM,1907,23,25-29,1930,91
SIM,1876,19,15-19,1895,11
STAT,1878,43,40-44,1921,2.3711654040051826
SIM,1860,38,50-100,1898,4
STAT,1888,73,na,1961,1629.849549461744
SIM,1897,5,na,1902,3551
SIM,1854,27,15-19,1881,3
STAT,1854,48,15-19,1902,3.0229490961298497E-4
STAT,1931,22,na,1953,4830.356289876097
SIM,1918,32,40-44,1950,8
STAT,1845,25,na,1870,2087.218660545915
STAT,1892,27,na,1919,3051.3176554228176
STAT,1796,82,na,1878,168.22037667225973
SIM,1866,39,50-100,1905,4
SIM,1835,39,20-24,1874,1
SIM,1825,31,25-29,1856,18
STAT,1870,44,45-49,1914,1.4723968874112838
SIM,1872,47,na,1919,2366
STAT,1826,40,35-39,1866,1.5376868300599185
STAT,1889,31,15-19,1920,0.1801874860636276
STAT,1898,37,25-29,1935,3.9720034427933535
STAT,1896,17,na,1913,3402.8841253460296
SIM,1874,44,25-29,1918,3
STAT,1884,22,25-29,1906,57.77700051233563
SIM,1909,21,35-39,1930,12
STAT,1805,50,45-49,1855,0.05323606385791921
SIM,1832,27,30-34,1859,5
SIM,1832,29,25-29,1861,42
SIM,1898,40,na,1938,3597
STAT,1828,109,na,1937,3.917772277456471E-4
STAT,1876,19,45-49,1895,0.06844361803676065
SIM,1853,19,15-19,1872,10
STAT,1866,44,25-29,1910,0.5960943727402267
STAT,1850,35,30-34,1885,4.157875886130715
STAT,1877,45,40-44,1922,0.18295024798286103
SIM,1826,33,50-100,1859,2
STAT,1887,34,15-19,1921,0.16139721541418264
STAT,1813,45,50-100,1858,0.6383588494680212
STAT,1830,37,50-100,1867,1.1092458431353738
STAT,1871,25,20-24,1896,11.93534815550509
STAT,1833,38,35-39,1871,5.794720520324473
STAT,1850,9,na,1859,2239.4237735868955
SIM,1918,48,50-100,1966,1
STAT,1871,27,15-19,1898,0.4584775913917161
STAT,1845,19,15-19,1864,5.791855675976255
STAT,1859,19,50-100,1878,0.04578808766780507
STAT,1881,63,na,1944,1759.8189594371233
SIM,1858,12,na,1870,2361
SIM,1841,38,35-39,1879,14
STAT,1854,28,25-29,1882,33.69648022527831
SIM,1834,40,35-39,1874,5
SIM,1869,29,20-24,1898,13
SIM,1948,15,35-39,1963,4
STAT,1809,74,na,1883,602.0253548359918
STAT,1820,41,na,1861,1517.2801690306856
STAT,1864,47,25-29,1911,0.052004358134559135
STAT,1854,61,na,1915,1430.1688632358337
STAT,1815,52,25-29,1867,0.009103264764742935
STAT,1820,52,35-39,1872,0.0150960363366509
STAT,1872,27,na,1899,2440.0521249687554
STAT,1872,41,45-49,1913,1.5371331308495428
STAT,1822,76,na,1898,550.8621762324286
STAT,1837,43,45-49,1880,1.1625003201835198
STAT,1908,17,40-44,1925,0.276668141353465
STAT,1893,31,35-39,1924,13.15946569083959
STAT,1879,28,30-34,1907,26.75832272176006
SIM,1957,13,na,1970,5607
STAT,1778,110,na,1888,0.001310231895531944
STAT,1910,37,20-24,1947,0.2571360772615749
SIM,1799,99,na,1898,1
STAT,1801,104,na,1905,0.023798453556676945
SIM,1841,36,40-44,1877,7
STAT,1816,39,45-49,1855,5.487687638626851
STAT,1788,87,na,1875,63.089291740792646
STAT,1792,92,na,1884,10.23750928799093
STAT,1905,19,na,1924,3701.132625004325
SIM,1928,18,15-19,1946,60
SIM,1862,28,25-29,1890,41
SIM,1885,32,35-39,1917,17
SIM,1894,38,45-49,1932,6
STAT,1816,50,20-24,1866,0.0015111423955322485
STAT,1877,58,na,1935,2092.4681373380754
STAT,1841,43,50-100,1884,0.8002346783558776
STAT,1886,38,45-49,1924,2.141914216458488
SIM,1864,25,25-29,1889,45
STAT,1849,46,45-49,1895,0.18374128582549637
STAT,1841,44,20-24,1885,0.11876534141894642
STAT,1765,90,na,1855,9.7116
STAT,1886,3,na,1889,3011.0753231830226
STAT,1915,49,na,1964,3755.48427311739
SIM,1844,44,40-44,1888,1
STAT,1845,37,15-19,1882,0.04610031667979726
STAT,1856,25,25-29,1881,35.61193777786896
STAT,1873,22,20-24,1895,71.27271805762693
SIM,1816,44,35-39,1860,4
SIM,1892,22,25-29,1914,100
STAT,1948,21,20-24,1969,130.30229804304827
STAT,1888,10,na,1898,3123.985489801774
SIM,1887,28,30-34,1915,4
STAT,1833,36,40-44,1869,3.663648531468842
STAT,1883,41,20-24,1924,0.1596856409093185
SIM,1857,43,40-44,1900,2
STAT,1891,18,30-34,1909,2.007779621724516
STAT,1877,32,35-39,1909,10.715306401625922
SIM,1821,43,na,1864,1492
STAT,1845,35,20-24,1880,0.7100123623646337
STAT,1831,40,45-49,1871,1.30277514045312
SIM,1837,18,20-24,1855,21
STAT,1863,15,15-19,1878,6.129108570620129
STAT,1846,66,na,1912,1172.091827898943
SIM,1823,36,20-24,1859,1
SIM,1880,41,45-49,1921,3
SIM,1874,26,25-29,1900,42
SIM,1859,42,35-39,1901,4
STAT,1882,43,25-29,1925,0.6336146000602084
SIM,1843,33,40-44,1876,5
SIM,1888,39,30-34,1927,9
SIM,1855,55,na,1910,1595
STAT,1906,19,50-100,1925,0.07235526394890467
STAT,1913,14,na,1927,4105.966751585169
SIM,1851,21,25-29,1872,65
STAT,1890,32,50-100,1922,1.1428668512863516
SIM,1889,38,35-39,1927,5
SIM,1891,23,20-24,1914,102
SIM,1888,42,na,1930,2694
STAT,1882,27,20-24,1909,11.65961758574142
STAT,1821,33,40-44,1854,13.666602400537144
STAT,1847,32,20-24,1879,2.474920146677487
STAT,1931,35,50-100,1966,0.5680673911840146
SIM,1818,41,35-39,1859,5
STAT,1871,42,40-44,1913,2.2701502650116376
STAT,1850,71,na,1921,1004.0434702295817
SIM,1848,37,35-39,1885,10
STAT,1876,21,50-100,1897,0.43087533411570067
SIM,1858,29,45-49,1887,1
STAT,1814,53,20-24,1867,0.002063330505881998
SIM,1885,14,na,1899,2612
SIM,1913,20,50-100,1933,4
STAT,1841,42,25-29,1883,0.492689092638864
STAT,1881,44,20-24,1925,0.15451944370336704
SIM,1939,22,30-34,1961,36
STAT,1843,21,25-29,1864,58.426067851482586
STAT,1850,17,30-34,1867,1.4650565985988295
STAT,1895,29,25-29,1924,55.90124145357753
SIM,1917,33,35-39,1950,11
STAT,1827,39,20-24,1866,0.9500573012134926
STAT,1867,41,35-39,1908,1.7421209550075156
STAT,1892,34,25-29,1926,12.983682470128226
SIM,1892,26,45-49,1918,3
STAT,1887,49,15-19,1936,2.525433992812329E-4
SIM,1836,38,25-29,1874,4
STAT,1858,43,na,1901,1856.3035984023536
STAT,1920,29,30-34,1949,43.54983486243811
STAT,1835,33,40-44,1868,4.072874019521919
SIM,1838,17,25-29,1855,7
STAT,1857,36,25-29,1893,2.30495150143906
SIM,1880,23,45-49,1903,2
STAT,1927,42,na,1969,4751.323368720058
STAT,1871,33,na,1904,2401.2498752195597
SIM,1872,29,25-29,1901,45
STAT,1820,50,40-44,1870,0.019210631501660382
STAT,1803,53,45-49,1856,0.05744792341976231
STAT,1825,43,25-29,1868,0.8586935093277387
SIM,1890,27,20-24,1917,17
STAT,1867,26,40-44,1893,2.878792003545052
STAT,1863,33,45-49,1896,1.5531825564413264
SIM,1853,37,45-49,1890,2
STAT,1824,31,na,1855,1604.9858210857408
STAT,1866,42,30-34,1908,1.0804716505962488
SIM,1831,65,na,1896,1082
SIM,1869,83,na,1952,225
STAT,1935,5,na,1940,5605.4807101506685
SIM,1894,50,na,1944,2950
STAT,1828,38,25-29,1866,2.470623942274623
STAT,1841,35,na,1876,1902.3080375238483
STAT,1877,34,50-100,1911,0.9611663735293983
STAT,1884,26,45-49,1910,1.1244552739159621
SIM,1926,21,na,1947,5136
STAT,1802,54,40-44,1856,0.026795822769344422
STAT,1851,16,35-39,1867,0.553654769702583
STAT,1852,48,45-49,1900,0.1877330973395206
STAT,1910,39,15-19,1949,0.018543242645606372
SIM,1833,43,25-29,1876,3
SIM,1842,32,40-44,1874,8
SIM,1861,63,na,1924,1857
STAT,1840,46,25-29,1886,0.04233679607659083
STAT,1856,53,25-29,1909,0.0027909139688177004
STAT,1876,34,40-44,1910,4.52931156362006
SIM,1875,41,35-39,1916,6
SIM,1783,84,na,1867,73
SIM,1916,8,na,1924,4335
STAT,1882,45,20-24,1927,0.012045424685891763
SIM,1810,71,na,1881,872
SIM,1921,34,50-100,1955,1
STAT,1864,17,30-34,1881,1.4956178098137614
STAT,1829,94,na,1923,13.292417367747822
STAT,1906,30,50-100,1936,0.7874688745416676
SIM,1883,17,35-39,1900,2
STAT,1949,22,50-100,1971,0.7833351655105915
STAT,1823,46,25-29,1869,0.0878284344799967
STAT,1842,40,20-24,1882,0.1321964166196629
STAT,1819,45,20-24,1864,0.024475618475062952
SIM,1821,44,45-49,1865,2
SIM,1772,92,na,1864,9
SIM,1872,17,30-34,1889,2
SIM,1838,35,25-29,1873,1
STAT,1824,100,na,1924,0.5845580147011644
STAT,1834,41,na,1875,1725.223703240043
STAT,1901,49,na,1950,3143.1467773812915
STAT,1815,54,20-24,1869,0.0018219837588913032
SIM,1934,30,30-34,1964,33
STAT,1888,40,50-100,1928,1.2869584707811093
STAT,1856,96,na,1952,6.876225403177608
STAT,1880,48,20-24,1928,0.012702714763300503
STAT,1886,23,45-49,1909,0.7506495758291594
STAT,1886,38,15-19,1924,0.060335618906604806
STAT,1897,26,25-29,1923,57.89869934510217
SIM,1842,35,45-49,1877,2
SIM,1922,48,45-49,1970,1
STAT,1917,22,30-34,1939,31.172570911547343
SIM,1833,26,35-39,1859,14
SIM,1882,36,30-34,1918,9
STAT,1834,35,45-49,1869,1.7037025654356455
SIM,1925,22,30-34,1947,46
SIM,1842,34,35-39,1876,19
SIM,1817,43,40-44,1860,2
STAT,1840,45,15-19,1885,2.977962294074925E-4
STAT,1854,20,50-100,1874,0.3720347911590353
STAT,1870,29,20-24,1899,11.61572139875958
STAT,1804,51,40-44,1855,0.03151673368329094
STAT,1830,44,45-49,1874,1.2546583893168157
STAT,1947,22,15-19,1969,6.1381532724431915
SIM,1836,88,na,1924,41
STAT,1819,47,15-19,1866,7.924565842180683E-4
STAT,1862,34,40-44,1896,3.7337617193564157
STAT,1851,34,35-39,1885,8.517330509309302
STAT,1899,33,25-29,1932,14.248225554720277
STAT,1865,46,30-34,1911,0.0898818628191771
STAT,1900,48,15-19,1948,3.150252218043926E-4
STAT,1886,36,20-24,1922,0.836378208215754
SIM,1876,22,40-44,1898,3
STAT,1813,44,45-49,1857,4.570332810776731
STAT,1831,37,15-19,1868,0.049397063724152895
STAT,1855,107,na,1962,0.015446380422277473
STAT,1892,17,35-39,1909,0.7015585972108872
STAT,1848,47,40-44,1895,0.1324590055776936
SIM,1880,22,na,1902,2349
SIM,1882,57,na,1939,1952
STAT,1834,34,35-39,1868,8.550186561082242
SIM,1827,32,45-49,1859,3
STAT,1899,35,50-100,1934,1.7314081354246618
STAT,1825,42,40-44,1867,3.07124346939285
SIM,1768,87,na,1855,36
SIM,1873,28,30-34,1901,28
SIM,1836,35,20-24,1871,4
STAT,1868,22,40-44,1890,2.030395295579368
STAT,1902,42,na,1944,3332.4301022593336
STAT,1890,37,25-29,1927,3.5913287672157734
STAT,1917,25,50-100,1942,1.072458080412238
STAT,1949,20,25-29,1969,110.04049391561261
STAT,1926,30,30-34,1956,19.456709450212646
STAT,1865,45,20-24,1910,0.0112216046293836
SIM,1892,55,na,1947,3003
SIM,1910,28,50-100,1938,1
STAT,1881,28,15-19,1909,0.44590144526439657
SIM,1884,34,40-44,1918,6
STAT,1878,12,na,1890,2742.266313406706
SIM,1890,43,25-29,1933,1
STAT,1850,19,25-29,1869,5.147578097307785
SIM,1900,16,na,1916,3616
STAT,1819,47,45-49,1866,0.4675497782173833
STAT,1909,16,45-49,1925,0.1001534778613532
STAT,1874,20,15-19,1894,3.4566395353868757
STAT,1871,40,45-49,1911,1.527652341807566
STAT,1880,35,45-49,1915,2.1573728582828413
STAT,1894,31,50-100,1925,1.2072275157900298
STAT,1880,18,25-29,1898,6.058984462610983
STAT,1833,48,na,1881,1554.6403652180059
STAT,1889,44,20-24,1933,0.19742588847988857
SIM,1816,88,na,1904,39
STAT,1869,38,15-19,1907,0.05503277815103834
STAT,1925,47,na,1972,4541.885302083755
SIM,1834,47,50-100,1881,2
SIM,1833,44,35-39,1877,3
STAT,1838,27,30-34,1865,23.53599137836633
SIM,1816,42,40-44,1858,8
SIM,1894,36,20-24,1930,3
STAT,1892,35,35-39,1927,9.129051877120828
STAT,1824,45,30-34,1869,0.11590291042336916
SIM,1831,28,25-29,1859,41
STAT,1875,35,35-39,1910,7.475754350100105
SIM,1827,29,15-19,1856,2
SIM,1902,39,30-34,1941,3
SIM,1785,79,na,1864,233
SIM,1902,22,35-39,1924,12
STAT,1881,46,15-19,1927,3.9563071814753537E-4
STAT,1800,106,na,1906,0.005851903260427691
STAT,1861,53,35-39,1914,0.007140641937595295
STAT,1895,55,na,1950,2752.1493898056638
SIM,1898,36,50-100,1934,2
STAT,1802,56,na,1858,959.8353002479695
STAT,1839,51,50-100,1890,0.010472955086456355
STAT,1875,33,40-44,1908,4.52142709929454
STAT,1851,33,na,1884,2027.9465590477432
SIM,1873,43,25-29,1916,2
STAT,1828,37,15-19,1865,0.04923024038576674
STAT,1865,43,25-29,1908,0.590279937378089
STAT,1891,36,30-34,1927,6.763643606071141
SIM,1862,57,na,1919,1809
SIM,1883,35,35-39,1918,7
STAT,1865,15,50-100,1880,0.051977997774511515
STAT,1929,29,na,1958,4777.170695063905
STAT,1928,31,50-100,1959,1.055123256196612
STAT,1963,9,na,1972,5091.187960256681
STAT,1895,28,15-19,1923,0.6017573784737121
STAT,1860,111,na,1971,0.0012520049144282952
SIM,1861,29,20-24,1890,10
SIM,1863,41,45-49,1904,4
SIM,1883,33,40-44,1916,4
STAT,1890,19,25-29,1909,7.030413321867098
STAT,1918,20,25-29,1938,102.26944608148621
STAT,1861,51,40-44,1912,0.008916935165917876
STAT,1798,77,na,1875,421.7871572951257
SIM,1882,18,30-34,1900,2
STAT,1809,66,na,1875,1021.042226931014
STAT,1871,73,na,1944,1200.253316038431
STAT,1848,30,15-19,1878,0.13180276878413055
STAT,1830,24,20-24,1854,162.16970171126744
STAT,1933,34,na,1967,5191.1191595942055
STAT,1861,26,45-49,1887,0.9495680478282763
STAT,1853,29,20-24,1882,10.221528605621273
STAT,1847,20,na,1867,2073.667065980213
STAT,1865,30,15-19,1895,0.13291554280255669
SIM,1920,36,na,1956,4018
SIM,1880,23,15-19,1903,5
STAT,1805,84,na,1889,136.14481293254394
STAT,1869,36,20-24,1905,0.7628697147260382
STAT,1874,36,30-34,1910,5.577802588289334
SIM,1926,20,25-29,1946,180
SIM,1846,27,30-34,1873,32
SIM,1851,65,na,1916,1365
SIM,1871,47,50-100,1918,1
STAT,1952,20,30-34,1972,35.275631106578416
STAT,1848,43,20-24,1891,0.12255884854761309
STAT,1873,40,50-100,1913,1.1036600044898401
STAT,1830,26,45-49,1856,1.3664170708314598
SIM,1837,50,na,1887,1402
STAT,1841,29,25-29,1870,38.23827501296681
SIM,1779,79,na,1858,167
STAT,1855,54,20-24,1909,5.563032840288213E-4
SIM,1867,34,40-44,1901,7
STAT,1824,51,50-100,1875,0.01732124078996487
STAT,1872,38,15-19,1910,0.057129315159279485
SIM,1879,36,25-29,1915,6
STAT,1889,48,40-44,1937,0.12016432082925639
SIM,1837,19,30-34,1856,3
STAT,1938,26,na,1964,3787.6047044401225
STAT,1825,44,35-39,1869,2.371389779741594
STAT,1876,96,na,1972,54.43811121598138
STAT,1860,25,45-49,1885,0.9423441454291084
STAT,1848,49,35-39,1897,0.10655441874658896
STAT,1873,68,na,1941,1580.5376747433224
SIM,1933,17,40-44,1950,3
STAT,1856,22,20-24,1878,64.09264115835178
STAT,1893,30,25-29,1923,13.361979202132598
SIM,1839,43,20-24,1882,2
STAT,1912,40,na,1952,3695.471779719291
STAT,1862,52,40-44,1914,0.009093542482363614
STAT,1885,25,na,1910,2445.431558761319
SIM,1810,63,na,1873,1178
STAT,1957,15,35-39,1972,5.645256209663433
STAT,1889,83,na,1972,970.4995498639885
STAT,1851,15,25-29,1866,5.751681219847604
SIM,1862,25,20-24,1887,13
STAT,1858,32,25-29,1890,8.286345460165984
STAT,1883,42,30-34,1925,1.1493613686175
STAT,1898,34,20-24,1932,3.6970849344335246
SIM,1814,53,na,1867,1192
STAT,1871,28,25-29,1899,42.59615955900858
STAT,1847,17,25-29,1864,5.515332999794306
SIM,1859,40,40-44,1899,2
STAT,1907,20,20-24,1927,103.83901392732957
SIM,1843,98,na,1941,3
SIM,1832,42,25-29,1874,4
STAT,1901,57,na,1958,2932.6462291673224
STAT,1859,19,45-49,1878,0.06105078355707344
SIM,1850,91,na,1941,16
STAT,1812,86,na,1898,101.19910523753241
STAT,1820,53,45-49,1873,0.024945683901304992
STAT,1876,16,40-44,1892,0.19314867032027674
SIM,1891,42,30-34,1933,3
SIM,1889,37,25-29,1926,3
STAT,1844,54,45-49,1898,0.010936581830402999
SIM,1818,39,20-24,1857,1
STAT,1850,36,40-44,1886,3.3798354421637526
STAT,1861,35,na,1896,2004.8753449918097
STAT,1789,80,na,1869,203.2879168946351
STAT,1872,40,35-39,1912,1.870111296875974
STAT,1841,27,30-34,1868,23.093555009300943
STAT,1853,107,na,1960,0.011621432025873693
SIM,1861,44,45-49,1905,5
STAT,1855,30,50-100,1885,0.7383795341482569
STAT,1914,2,na,1916,4302.368493373882
SIM,1863,27,30-34,1890,24
STAT,1833,39,45-49,1872,1.6159226589059992
SIM,1918,17,45-49,1935,1
STAT,1816,51,30-34,1867,0.011948300468008167
SIM,1816,45,45-49,1861,2
STAT,1860,22,40-44,1882,1.7780206172550939
SIM,1854,33,45-49,1887,1
SIM,1943,20,25-29,1963,123
SIM,1866,32,25-29,1898,13
SIM,1833,29,45-49,1862,1
SIM,1840,61,na,1901,1245
STAT,1799,79,na,1878,280.1729770365948
STAT,1875,36,45-49,1911,2.0972476376661024
SIM,1929,17,20-24,1946,197
STAT,1849,86,na,1935,172.2559135554271
SIM,1880,40,35-39,1920,1
STAT,1825,110,na,1935,1.6570967748993657E-4
STAT,1909,15,35-39,1924,0.8431273876112516
STAT,1861,63,na,1924,1504.1118128992323
STAT,1874,19,40-44,1893,0.18948320996373688
STAT,1822,47,20-24,1869,0.017110266428068434
STAT,1835,36,45-49,1871,1.8561906601382234
SIM,1915,20,20-24,1935,4
SIM,1841,35,30-34,1876,12
SIM,1890,15,25-29,1905,19
STAT,1848,46,25-29,1894,0.04490150968190106
SIM,1829,63,na,1892,964
SIM,1883,36,45-49,1919,1
STAT,1833,35,30-34,1868,4.508199148860154
STAT,1823,49,30-34,1872,0.14145858051077256
STAT,1832,86,na,1918,148.26386721942086
STAT,1782,90,na,1872,28.45869376277699
STAT,1844,39,20-24,1883,0.6182499898156962
STAT,1855,27,30-34,1882,20.347350732653176
STAT,1901,49,15-19,1950,3.151628298400913E-4
STAT,1846,51,45-49,1897,0.01042779861566403
STAT,1854,25,20-24,1879,10.493693740073706
SIM,1845,45,na,1890,1775
STAT,1867,29,45-49,1896,1.0557723846998788
STAT,1873,29,50-100,1902,0.6568729955508305
STAT,1839,33,na,1872,1821.6398539747652
STAT,1853,48,na,1901,1862.7847404062784
STAT,1885,48,50-100,1933,0.24682563412929656
STAT,1938,32,15-19,1970,0.13180798106452268
SIM,1819,53,na,1872,1291
STAT,1893,49,45-49,1942,0.16868439952391265
STAT,1935,20,25-29,1955,128.36330788113338
STAT,1862,35,20-24,1897,0.6757626210414305
STAT,1857,52,30-34,1909,0.0047172618265064045
STAT,1872,30,50-100,1902,0.9443267261278553
STAT,1845,22,45-49,1867,0.6763962153002923
SIM,1872,41,50-100,1913,5
SIM,1883,32,30-34,1915,27
SIM,1870,34,40-44,1904,7
STAT,1815,39,25-29,1854,10.955866237545681
SIM,1908,36,na,1944,3911
SIM,1891,27,40-44,1918,5
STAT,1842,22,20-24,1864,68.16224681823367
SIM,1843,36,45-49,1879,1
STAT,1826,109,na,1935,4.149522780642363E-4
STAT,1948,22,30-34,1970,33.66901079962011
STAT,1882,25,na,1907,2388.001961918318
SIM,1816,41,30-34,1857,1
SIM,1855,17,25-29,1872,8
STAT,1895,26,20-24,1921,15.668275587384034
SIM,1850,22,20-24,1872,82
STAT,1838,24,20-24,1862,64.75195902319881
STAT,1861,50,30-34,1911,0.005089918218167711
SIM,1874,50,na,1924,2253
SIM,1834,21,25-29,1855,47
STAT,1795,89,na,1884,34.18314576436864
STAT,1868,53,na,1921,2064.291038455888
STAT,1818,49,20-24,1867,0.026412724529556588
SIM,1846,39,25-29,1885,5
STAT,1846,33,45-49,1879,1.4584731521364795
SIM,1841,17,30-34,1858,5
SIM,1833,25,25-29,1858,49
STAT,1865,25,na,1890,2224.67987386331
STAT,1812,43,45-49,1855,3.996500902846105
SIM,1823,39,25-29,1862,2
SIM,1856,29,40-44,1885,2
STAT,1828,35,20-24,1863,0.7066978382850239
STAT,1872,23,15-19,1895,3.3625973570718943
STAT,1897,39,30-34,1936,1.5533169292255393
STAT,1925,17,40-44,1942,1.7238523411919024
STAT,1868,42,35-39,1910,1.7622255617651352
STAT,1883,27,40-44,1910,2.9984559282167575
STAT,1847,35,25-29,1882,2.3784159244874665
STAT,1851,28,50-100,1879,0.6134937722956844
STAT,1881,47,25-29,1928,0.056544728755088064
SIM,1909,29,na,1938,3441
STAT,1821,51,40-44,1872,0.016252056703942874
STAT,1866,66,na,1932,1542.2596765296696
STAT,1891,37,40-44,1928,5.528777027652348
STAT,1832,52,25-29,1884,0.002473912675295525
STAT,1849,94,na,1943,15.51640206848028
STAT,1864,32,20-24,1896,2.451896774906865
SIM,1814,46,25-29,1860,1
SIM,1916,31,na,1947,3959
STAT,1848,29,40-44,1877,2.740074508161904
SIM,1864,22,20-24,1886,77
STAT,1836,76,na,1912,589.6967978878844
STAT,1889,47,30-34,1936,0.06848716588818743
STAT,1894,30,na,1924,3156.531140427187
SIM,1832,46,40-44,1878,1
STAT,1914,48,45-49,1962,0.21930960277664005
STAT,1824,42,25-29,1866,0.7912235323838064
SIM,1890,0,na,1890,3593
STAT,1873,37,25-29,1910,2.977808479059742
SIM,1914,44,na,1958,3757
STAT,1861,43,na,1904,1934.2276192994987
SIM,1930,5,na,1935,5830
SIM,1824,36,40-44,1860,5
STAT,1889,15,na,1904,3197.413422058151
STAT,1891,33,25-29,1924,12.88179659285916
SIM,1878,19,20-24,1897,25
SIM,1833,68,na,1901,1034
STAT,1856,37,20-24,1893,0.6172984869443547
SIM,1876,42,35-39,1918,4
SIM,1880,30,50-100,1910,1
STAT,1834,32,40-44,1866,3.7382829602423286
STAT,1807,49,45-49,1856,0.9918775493724228
STAT,1824,46,40-44,1870,0.20223454618814218
SIM,1882,39,35-39,1921,8
SIM,1865,22,na,1887,2265
SIM,1898,32,na,1930,3665
STAT,1858,36,40-44,1894,3.558478461628017
SIM,1865,37,40-44,1902,5
STAT,1874,53,na,1927,2206.6490630307762
STAT,1909,33,35-39,1942,8.856214593791627
STAT,1917,25,35-39,1942,16.176636551956975
STAT,1885,45,na,1930,2312.668955721628
SIM,1769,92,na,1861,19
SIM,1854,30,na,1884,2150
STAT,1902,45,15-19,1947,3.2784225890215363E-4
SIM,1851,42,30-34,1893,2
STAT,1840,43,20-24,1883,0.1176947264126232
STAT,1866,27,35-39,1893,9.07935396528442
STAT,1910,19,20-24,1929,27.251903933664916
STAT,1883,23,20-24,1906,68.76587937554844
STAT,1859,84,na,1943,271.02568038773603
SIM,1869,44,45-49,1913,1
SIM,1919,28,15-19,1947,1
STAT,1876,37,45-49,1913,2.099997472884243
SIM,1831,41,50-100,1872,1
SIM,1859,43,50-100,1902,2
SIM,1838,32,20-24,1870,1
SIM,1857,50,na,1907,1798
SIM,1861,31,35-39,1892,15
SIM,1908,22,30-34,1930,36
STAT,1853,32,45-49,1885,1.505755554154276
STAT,1845,37,45-49,1882,1.6365610475056704
STAT,1912,29,na,1941,3739.056096998551
STAT,1863,48,20-24,1911,0.010598555270143598
STAT,1881,17,30-34,1898,1.571997416686507
STAT,1833,35,25-29,1868,2.4354638946357676
SIM,1849,83,na,1932,410
SIM,1896,6,na,1902,3588
STAT,1841,43,na,1884,1750.703679724674
SIM,1795,89,na,1884,40
SIM,1897,29,30-34,1926,53
STAT,1880,32,40-44,1912,4.649088509106969
STAT,1883,25,50-100,1908,0.6446540442839671
SIM,1850,71,na,1921,861
STAT,1809,46,45-49,1855,1.067429846312774
SIM,1813,68,na,1881,728
SIM,1939,25,35-39,1964,27
SIM,1821,35,na,1856,1617
STAT,1868,25,45-49,1893,1.0891826897968142
SIM,1953,9,na,1962,4773
SIM,1907,62,na,1969,3092
SIM,1925,25,35-39,1950,37
SIM,1935,32,40-44,1967,6
STAT,1937,21,45-49,1958,1.118007268034592
STAT,1869,39,25-29,1908,2.807205058973065
SIM,1859,5,na,1864,2747
STAT,1816,99,na,1915,0.8403341966874227
STAT,1889,29,30-34,1918,31.506010197297513
STAT,1845,50,45-49,1895,0.011502179858425412
SIM,1922,31,na,1953,4381
SIM,1824,32,20-24,1856,3
STAT,1880,50,35-39,1930,0.009361793388826615
STAT,1821,110,na,1931,1.456133843846207E-4
SIM,1817,46,45-49,1863,1
STAT,1900,32,35-39,1932,14.319162346489211
STAT,1897,38,20-24,1935,1.0462508144836842
SIM,1897,47,50-100,1944,1
STAT,1838,42,20-24,1880,0.1364640049471646
STAT,1850,32,25-29,1882,8.059717334721054
STAT,1887,16,15-19,1903,6.800644712030846
STAT,1856,50,20-24,1906,5.994203169656108E-4
STAT,1892,16,25-29,1908,7.2630575046251185
STAT,1916,15,50-100,1931,0.08149367869221047
SIM,1846,24,20-24,1870,69
STAT,1840,33,50-100,1873,0.7947618524642918
STAT,1861,54,45-49,1915,0.011897090841694437
STAT,1853,31,35-39,1884,8.83579250656811
STAT,1884,43,30-34,1927,1.1519581204820362
SIM,1832,27,na,1859,1999
STAT,1897,23,20-24,1920,93.70870565077283
STAT,1818,71,na,1889,707.5788125880237
STAT,1889,47,50-100,1936,0.17376495763106817
STAT,1875,32,30-34,1907,18.28051014842033
STAT,1836,44,40-44,1880,1.623492671332404
STAT,1851,19,45-49,1870,0.06475346408962548
SIM,1895,16,15-19,1911,8
SIM,1858,26,40-44,1884,4
STAT,1834,36,50-100,1870,1.0384323813968206
STAT,1782,104,na,1886,0.03244605882028752
STAT,1864,29,25-29,1893,38.096626845540335
STAT,1817,52,30-34,1869,0.012749984153987492
STAT,1927,32,40-44,1959,4.910503038050399
SIM,1882,20,15-19,1902,5
SIM,1877,39,25-29,1916,4
STAT,1817,39,50-100,1856,3.588327701878089
STAT,1837,18,50-100,1855,0.05009727874085984
STAT,1846,15,15-19,1861,5.394589820156481
STAT,1925,39,na,1964,4597.087777742566
SIM,1871,22,na,1893,2252
SIM,1895,34,45-49,1929,7
SIM,1850,41,30-34,1891,1
SIM,1848,36,25-29,1884,6
SIM,1867,88,na,1955,48
SIM,1841,39,45-49,1880,4
SIM,1825,39,50-100,1864,2
STAT,1839,53,25-29,1892,0.0024052528055605736
STAT,1846,48,15-19,1894,2.824542564006373E-4
STAT,1849,43,40-44,1892,1.7336344897730696
STAT,1865,47,40-44,1912,0.15777556126014725
SIM,1932,6,na,1938,5573
SIM,1828,43,45-49,1871,1
SIM,1949,18,na,1967,4772
STAT,1912,16,50-100,1928,0.07747414825411
SIM,1887,25,20-24,1912,18
STAT,1807,48,35-39,1855,0.6008342588015778
STAT,1834,31,30-34,1865,15.207504133925553
STAT,1935,23,35-39,1958,13.071704890854708
STAT,1772,92,na,1864,5.862104052736757
SIM,1809,86,na,1895,32
SIM,1951,15,35-39,1966,9
STAT,1852,100,na,1952,0.85526298290053
STAT,1894,32,35-39,1926,13.28892043580674
STAT,1889,47,25-29,1936,0.04075269335888013
SIM,1885,45,40-44,1930,1
SIM,1919,31,45-49,1950,6
STAT,1848,46,30-34,1894,0.075459482276018
STAT,1899,5,na,1904,3660.952598725347
STAT,1882,40,20-24,1922,0.159433260726381
SIM,1892,47,na,1939,3247
STAT,1851,33,25-29,1884,8.704420234749097
STAT,1920,16,na,1936,4224.5877547163045
STAT,1943,15,35-39,1958,4.542224006588841
STAT,1795,80,na,1875,229.5229744469313
STAT,1863,18,20-24,1881,16.369180702175047
SIM,1864,83,na,1947,400
STAT,1843,42,30-34,1885,0.9555798955476649
STAT,1811,47,45-49,1858,0.6555989631893288
SIM,1879,33,20-24,1912,4
STAT,1880,15,20-24,1895,19.09381302999063
STAT,1825,29,45-49,1854,3.762341209320863
STAT,1857,51,20-24,1908,5.907272618437275E-4
SIM,1928,16,20-24,1944,217
SIM,1854,15,15-19,1869,6
STAT,1827,41,35-39,1868,2.1866813683556616
STAT,1852,30,35-39,1882,8.624286811368753
SIM,1856,28,30-34,1884,36
STAT,1842,41,30-34,1883,0.9448046411632138
STAT,1854,43,15-19,1897,0.010493065744384208
STAT,1874,39,35-39,1913,7.292740771927308
STAT,1875,50,25-29,1925,0.003761818300035223
STAT,1871,27,45-49,1898,1.12198865220154
STAT,1841,26,20-24,1867,10.83636256112622
STAT,1920,29,50-100,1949,1.1062905568130443
SIM,1891,62,na,1953,2304
SIM,1945,18,15-19,1963,51
SIM,1899,27,40-44,1926,5
STAT,1923,21,15-19,1944,6.338597771463723
SIM,1802,76,na,1878,371
SIM,1878,40,na,1918,2600
STAT,1873,25,25-29,1898,44.0470427811356
SIM,1875,75,na,1950,1066
STAT,1837,61,na,1898,1245.8689533162226
SIM,1860,30,35-39,1890,16
SIM,1933,23,na,1956,4808
STAT,1856,38,30-34,1894,4.2467755372927956
SIM,1909,24,40-44,1933,4
STAT,1861,23,40-44,1884,1.7916507198721272
STAT,1899,37,40-44,1936,1.3199205669710796
SIM,1885,30,40-44,1915,11
SIM,1858,47,45-49,1905,2
STAT,1819,56,na,1875,1359.7033897244457
STAT,1877,30,40-44,1907,4.625502828188315
SIM,1931,21,15-19,1952,10
SIM,1880,90,na,1970,85
STAT,1887,34,45-49,1921,1.9763544925156047
SIM,1809,55,na,1864,932
STAT,1830,51,na,1881,1441.8242242464805
STAT,1846,33,15-19,1879,0.11910490066564548
SIM,1804,63,na,1867,1049
STAT,1867,40,25-29,1907,0.6212198683380676
SIM,1878,12,na,1890,2831
SIM,1873,88,na,1961,144
STAT,1937,18,15-19,1955,44.9165713260689
SIM,1815,48,35-39,1863,1
STAT,1879,25,20-24,1904,12.594762973793612
SIM,1842,31,30-34,1873,24
STAT,1914,47,35-39,1961,0.1304616003316886
SIM,1943,23,35-39,1966,21
STAT,1848,28,30-34,1876,23.20073573221383
STAT,1858,53,30-34,1911,0.004738337637597
SIM,1920,21,40-44,1941,5
STAT,1869,18,20-24,1887,17.598502006205177
SIM,1803,61,na,1864,817
SIM,1929,18,30-34,1947,16
STAT,1785,99,na,1884,0.3706465238121417
STAT,1832,24,25-29,1856,55.15212440887534
SIM,1895,75,na,1970,1822
SIM,1861,43,35-39,1904,4
STAT,1863,36,20-24,1899,0.6928056541979479
STAT,1876,30,25-29,1906,10.876590800392751
SIM,1889,2,na,1891,3423
STAT,1818,51,35-39,1869,0.01911472638312613
STAT,1945,16,na,1961,4103.396752073771
STAT,1837,28,20-24,1865,9.967219667558801
STAT,1820,37,45-49,1857,4.84955573005327
STAT,1922,25,15-19,1947,0.820621682098741
STAT,1846,37,30-34,1883,3.980064758567565
STAT,1869,53,40-44,1922,0.010202289021474756
STAT,1888,48,25-29,1936,0.03869267809879513
STAT,1954,18,15-19,1972,57.20804191851586
SIM,1860,70,na,1930,1445
SIM,1861,41,40-44,1902,3
STAT,1856,40,15-19,1896,0.011170548777970298
SIM,1921,46,na,1967,4854
STAT,1843,24,35-39,1867,5.828443633516678
SIM,1809,63,na,1872,685
SIM,1929,7,na,1936,5453
STAT,1820,51,50-100,1871,0.02701560811504012
STAT,1860,21,30-34,1881,15.308336121292019
STAT,1841,66,na,1907,1210.1675108944653
SIM,1837,33,45-49,1870,2
SIM,1884,30,25-29,1914,11
STAT,1912,21,40-44,1933,3.297117791915697
SIM,1951,8,na,1959,5317
STAT,1849,33,50-100,1882,0.7418285003927624
SIM,1828,29,30-34,1857,9
STAT,1877,48,15-19,1925,4.179160791114537E-4
STAT,1848,13,na,1861,2289.9447324968
STAT,1896,24,45-49,1920,0.9336569495820577
SIM,1868,73,na,1941,1146
STAT,1885,42,35-39,1927,1.840738821666819
STAT,1869,83,na,1952,390.99583876005306
SIM,1796,74,na,1870,430
STAT,1891,30,20-24,1921,3.44139949770411
STAT,1854,33,na,1887,1850.997047934367
STAT,1936,20,50-100,1956,0.6420637305244589
SIM,1870,91,na,1961,72
STAT,1871,24,40-44,1895,2.0925578566414935
STAT,1864,17,25-29,1881,5.317411672502517
SIM,1876,17,na,1893,2987
STAT,1872,58,na,1930,2021.9543042351777
SIM,1917,16,na,1933,4167
STAT,1953,11,na,1964,4847.9258881151345
SIM,1872,17,25-29,1889,12
STAT,1833,51,30-34,1884,0.004138987955777814
SIM,1833,26,40-44,1859,7
STAT,1784,104,na,1888,0.028867086710944852
SIM,1887,57,na,1944,2364
STAT,1893,16,45-49,1909,0.08474451282920442
SIM,1839,29,40-44,1868,7
SIM,1889,34,20-24,1923,2
STAT,1883,10,na,1893,2592.826799967816
STAT,1908,48,20-24,1956,0.010163053612139565
SIM,1930,39,40-44,1969,1
SIM,1836,19,50-100,1855,2
STAT,1821,34,20-24,1855,7.319278010986666
STAT,1844,51,40-44,1895,0.008197028367362589
SIM,1858,43,na,1901,1886
STAT,1838,27,50-100,1865,0.5978816013738196
STAT,1875,17,35-39,1892,0.5745043193470725
SIM,1902,62,na,1964,2792
SIM,1837,19,na,1856,1874
STAT,1851,30,20-24,1881,2.369811053262831
SIM,1889,35,na,1924,3098
STAT,1869,94,na,1963,52.05290998896801
STAT,1855,7,na,1862,2282.119006372673
STAT,1893,19,45-49,1912,0.08408353476834672
STAT,1922,39,40-44,1961,1.7343581391953413
SIM,1837,81,na,1918,465
STAT,1872,27,30-34,1899,25.74672098508184
SIM,1887,24,15-19,1911,6
STAT,1838,91,na,1929,42.577283139813524
SIM,1857,42,30-34,1899,3
STAT,1869,51,45-49,1920,0.014361787436543663
SIM,1880,38,20-24,1918,2
STAT,1837,53,50-100,1890,0.009907985808830523
STAT,1894,50,na,1944,2866.106958072426
SIM,1932,20,20-24,1952,159
STAT,1837,46,20-24,1883,0.008412460096880656
STAT,1825,45,45-49,1870,0.3119684665063807
STAT,1895,44,15-19,1939,0.001259187506093904
STAT,1876,49,45-49,1925,0.2434185614283355
SIM,1820,40,40-44,1860,1
SIM,1905,31,50-100,1936,4
SIM,1925,25,50-100,1950,1
STAT,1813,41,40-44,1854,8.534234646523359
STAT,1821,54,45-49,1875,0.021102599036916858
STAT,1879,39,15-19,1918,0.059278025210879326
STAT,1913,20,45-49,1933,1.1189185408015119
STAT,1849,42,30-34,1891,0.8914581647273889
SIM,1956,11,na,1967,5511
STAT,1867,22,25-29,1889,55.05179723272417
STAT,1899,36,35-39,1935,9.928213113259323
STAT,1841,48,35-39,1889,0.10251613013167415
STAT,1826,28,45-49,1854,3.1904032517765213
SIM,1834,30,na,1864,1891
SIM,1851,24,35-39,1875,6
SIM,1834,28,45-49,1862,2
STAT,1831,101,na,1932,0.38449826709099355
STAT,1923,38,45-49,1961,0.8051234582370748
STAT,1935,35,50-100,1970,0.5997528340614887
STAT,1956,8,na,1964,5303.902310753289
SIM,1894,5,na,1899,3561
SIM,1898,25,30-34,1923,56
SIM,1770,89,na,1859,26
SIM,1874,27,40-44,1901,4
SIM,1923,24,na,1947,4089
STAT,1857,19,40-44,1876,0.1692622869438772
STAT,1872,38,20-24,1910,0.7842295912452921
SIM,1875,22,25-29,1897,64
SIM,1931,38,45-49,1969,2
STAT,1866,28,50-100,1894,0.5998126654116108
SIM,1881,19,25-29,1900,7
STAT,1872,5,na,1877,2834.5136808228626
SIM,1877,47,na,1924,2251
STAT,1821,36,15-19,1857,0.13022104602685622
STAT,1799,70,na,1869,657.5080814374152
STAT,1838,27,25-29,1865,39.53656741668637
STAT,1890,18,15-19,1908,7.382989684209365
STAT,1845,34,40-44,1879,3.9461102015831653
SIM,1833,45,45-49,1878,1
SIM,1856,65,na,1921,1687
SIM,1877,18,20-24,1895,22
STAT,1840,49,30-34,1889,0.06846658839152998
STAT,1894,61,na,1955,2452.0576259299737
SIM,1870,37,45-49,1907,3
SIM,1847,29,na,1876,1812
STAT,1909,30,30-34,1939,15.456646210681907
STAT,1837,25,20-24,1862,10.18503387843056
SIM,1823,78,na,1901,491
STAT,1880,30,45-49,1910,1.8844557656046215
STAT,1948,4,na,1952,4633.995657453128
STAT,1934,38,20-24,1972,0.37060140214398074
STAT,1855,41,45-49,1896,1.165442486794589
STAT,1892,36,45-49,1928,2.5610636180369646
STAT,1912,48,40-44,1960,0.15414066142414506
SIM,1821,41,40-44,1862,2
SIM,1921,20,45-49,1941,1
STAT,1847,47,25-29,1894,0.04470782277016987
SIM,1790,86,na,1876,44
SIM,1929,36,30-34,1965,2
SIM,1881,32,na,1913,2188
STAT,1821,66,na,1887,864.8316458206871
STAT,1775,89,na,1864,33.188534490350044
STAT,1897,41,15-19,1938,0.0013140065487750804
STAT,1775,111,na,1886,0.0011622965191023394
STAT,1924,20,20-24,1944,134.6640706303033
STAT,1846,46,50-100,1892,0.1761325625053688
SIM,1833,22,20-24,1855,60
SIM,1845,25,20-24,1870,13
SIM,1850,60,na,1910,1428
STAT,1914,24,na,1938,3782.7327467658874
STAT,1857,37,40-44,1894,3.4876391883662254
STAT,1874,52,30-34,1926,0.006166942974817482
SIM,1885,42,na,1927,2342
SIM,1845,28,20-24,1873,13
SIM,1843,48,45-49,1891,2
STAT,1826,46,45-49,1872,0.18686877149872053
STAT,1884,20,na,1904,2401.2446541238664
STAT,1830,82,na,1912,295.15638030288216
STAT,1836,47,15-19,1883,2.605753401236492E-4
STAT,1855,23,45-49,1878,0.626976863835403
STAT,1887,49,20-24,1936,0.007576308642810347
SIM,1878,38,30-34,1916,9
STAT,1793,85,na,1878,96.19860122689845
STAT,1939,31,20-24,1970,2.5402923844121843
SIM,1855,35,25-29,1890,3
STAT,1932,15,30-34,1947,16.536178921909414
SIM,1834,43,40-44,1877,10
SIM,1862,17,na,1879,2397
SIM,1862,40,45-49,1902,3
SIM,1881,25,25-29,1906,36
SIM,1883,87,na,1970,405
SIM,1896,18,25-29,1914,15
STAT,1898,38,40-44,1936,1.2969987511770367
SIM,1780,79,na,1859,256
SIM,1846,27,25-29,1873,47
SIM,1857,24,30-34,1881,26
STAT,1893,34,40-44,1927,5.56429565327442
STAT,1907,42,na,1949,3469.655025553532
SIM,1895,38,30-34,1933,16
STAT,1812,42,35-39,1854,5.224957627392678
STAT,1851,35,45-49,1886,1.6971557257112146
STAT,1926,46,15-19,1972,4.6484018210368586E-4
SIM,1803,78,na,1881,282
SIM,1925,39,na,1964,4754
SIM,1861,32,na,1893,2498
STAT,1836,45,20-24,1881,0.00802016068067102
STAT,1858,39,45-49,1897,1.5965144632205988
STAT,1888,18,25-29,1906,6.816283410057972
STAT,1878,43,na,1921,2436.487185857705
STAT,1826,43,40-44,1869,1.8115811492268155
SIM,1904,20,45-49,1924,1
STAT,1827,51,na,1878,1541.3025504318343
SIM,1864,80,na,1944,549
STAT,1873,37,20-24,1910,0.797250140008749
SIM,1875,26,40-44,1901,4
SIM,1893,32,50-100,1925,3
STAT,1851,16,40-44,1867,0.18455160058617848
STAT,1835,48,45-49,1883,0.18306031440284318
SIM,1884,80,na,1964,710
STAT,1840,16,30-34,1856,1.4937800708127529
SIM,1940,15,30-34,1955,16
STAT,1904,14,na,1918,3763.5746496799416
SIM,1863,10,na,1873,2436
SIM,1890,27,25-29,1917,63
STAT,1884,38,50-100,1922,1.2329932935286956
SIM,1886,26,20-24,1912,14
STAT,1841,46,40-44,1887,0.12861631031503654
SIM,1886,29,20-24,1915,14
SIM,1849,39,45-49,1888,3
SIM,1874,73,na,1947,1162
STAT,1764,97,na,1861,1.4822170031339188
STAT,1821,36,45-49,1857,4.622846584183881
STAT,1936,22,35-39,1958,9.181592327618443
SIM,1829,39,25-29,1868,3
SIM,1892,24,na,1916,3414
STAT,1825,73,na,1898,712.2511129759084
STAT,1859,52,35-39,1911,0.00697659059259262
STAT,1911,39,30-34,1950,1.7775630321774947
STAT,1880,51,45-49,1931,0.015632175464973884
SIM,1944,22,35-39,1966,21
STAT,1878,29,20-24,1907,12.368139540906007
SIM,1872,24,na,1896,2614
SIM,1829,27,25-29,1856,37
STAT,1860,51,25-29,1911,0.0029458019889679727
STAT,1890,36,15-19,1926,0.07038077869776861
STAT,1857,33,20-24,1890,2.144489867231205
STAT,1858,51,35-39,1909,0.006998118810381915
STAT,1887,38,30-34,1925,6.062199912335669
STAT,1849,24,30-34,1873,16.480150296246684
STAT,1945,7,na,1952,4404.557230442477
STAT,1823,45,15-19,1868,6.186259280784262E-4
STAT,1836,96,na,1932,5.344632591468093
STAT,1872,23,45-49,1895,0.7107591994391401
SIM,1859,43,45-49,1902,3
SIM,1865,33,20-24,1898,5
STAT,1878,26,20-24,1904,12.499923027148144
STAT,1928,9,na,1937,5116.422966347887
SIM,1889,27,na,1916,3069
STAT,1888,36,25-29,1924,3.4890826667400106
SIM,1947,15,15-19,1962,54
STAT,1826,47,50-100,1873,0.19191315598541353
STAT,1907,65,na,1972,2909.3579041619437
SIM,1943,20,30-34,1963,48
STAT,1846,19,30-34,1865,1.415015162725859
STAT,1882,27,25-29,1909,42.042401943498234
SIM,1792,81,na,1873,188
SIM,1841,19,25-29,1860,11
STAT,1840,41,na,1881,1757.292220077057
STAT,1870,31,35-39,1901,10.140617481057978
STAT,1832,39,25-29,1871,2.3926805293866455
STAT,1831,37,20-24,1868,0.6780868803538913
STAT,1873,4,na,1877,3029.3425918841144
STAT,1910,17,na,1927,3903.2378010664393
STAT,1892,17,40-44,1909,0.23385287927676515
STAT,1813,42,15-19,1855,0.050263751826724636
STAT,1879,28,25-29,1907,44.949550381750285
STAT,1842,26,40-44,1868,2.9260658577541467
SIM,1862,42,40-44,1904,1
SIM,1905,39,na,1944,3368
SIM,1899,34,na,1933,3298
STAT,1829,66,na,1895,1090.0791649229068
SIM,1866,95,na,1961,24
STAT,1863,18,25-29,1881,5.232227070746119
STAT,1915,43,35-39,1958,0.20654863576617824
STAT,1836,29,15-19,1865,0.3602135190373613
STAT,1852,36,45-49,1888,1.631523797614922
SIM,1840,39,25-29,1879,5
SIM,1844,29,15-19,1873,1
STAT,1832,36,25-29,1868,2.47176076950409
STAT,1879,93,na,1972,141.51063716332
SIM,1840,36,25-29,1876,5
SIM,1899,23,25-29,1922,98
SIM,1909,20,25-29,1929,134
SIM,1936,31,50-100,1967,4
SIM,1819,35,20-24,1854,1
SIM,1819,38,20-24,1857,1
SIM,1919,28,na,1947,4085
STAT,1865,0,na,1865,3528.135664198188
SIM,1860,36,45-49,1896,1
SIM,1837,37,30-34,1874,6
STAT,1842,29,40-44,1871,2.863489853258448
STAT,1884,35,50-100,1919,1.2509076823478333
STAT,1864,46,15-19,1910,3.638627686179482E-4
SIM,1887,28,25-29,1915,3
SIM,1830,29,20-24,1859,16
STAT,1914,44,30-34,1958,0.12882060569559473
SIM,1820,42,35-39,1862,3
STAT,1922,42,na,1964,4349.625372722576
SIM,1845,14,na,1859,2331
SIM,1850,29,40-44,1879,5
STAT,1813,48,na,1861,1308.0980411342482
SIM,1850,26,40-44,1876,3
STAT,1762,93,na,1855,6.1217999999999995
STAT,1797,92,na,1889,12.02163841861601
STAT,1939,15,15-19,1954,46.45628434954758
SIM,1831,96,na,1927,1
STAT,1896,28,30-34,1924,33.80948962248944
SIM,1875,44,40-44,1919,3
SIM,1904,35,15-19,1939,1
SIM,1849,32,25-29,1881,1
STAT,1839,50,20-24,1889,5.219432302521528E-4
STAT,1909,20,na,1929,3638.8277380252052
SIM,1840,24,25-29,1864,3
STAT,1919,47,50-100,1966,0.2503447433525732
STAT,1939,26,50-100,1965,1.0212289693668248
STAT,1876,65,na,1941,1780.2561712208694
STAT,1878,47,20-24,1925,0.01268292981289787
STAT,1935,20,30-34,1955,39.940940773994924
SIM,1844,43,50-100,1887,4
SIM,1914,25,30-34,1939,56
STAT,1884,25,35-39,1909,9.804564868307486
SIM,1874,43,40-44,1917,7
STAT,1863,47,50-100,1910,0.2186531956473974
SIM,1858,40,25-29,1898,1
SIM,1954,16,na,1970,4395
STAT,1852,15,45-49,1867,0.06440306706185014
SIM,1938,23,20-24,1961,116
SIM,1817,81,na,1898,220
STAT,1877,48,45-49,1925,0.24657069421013156
STAT,1880,33,15-19,1913,0.15202099613068304
SIM,1925,28,na,1953,4536
SIM,1825,34,35-39,1859,1
STAT,1847,51,na,1898,1687.1018900456825
SIM,1845,25,na,1870,2111
SIM,1854,37,30-34,1891,14
SIM,1848,33,20-24,1881,7
STAT,1785,103,na,1888,0.05584133368938608
STAT,1861,38,45-49,1899,1.672110969900048
STAT,1906,25,30-34,1931,37.644911051566204
STAT,1867,44,40-44,1911,2.125125101802501
SIM,1834,22,na,1856,1843
SIM,1872,28,15-19,1900,1
SIM,1889,38,40-44,1927,2
STAT,1853,99,na,1952,1.5880050139929225
SIM,1859,22,40-44,1881,2
STAT,1866,43,40-44,1909,2.1012123651012913
SIM,1892,25,35-39,1917,19
STAT,1877,46,20-24,1923,0.012733081282133749
SIM,1839,32,50-100,1871,2
SIM,1879,37,50-100,1916,2
SIM,1904,17,15-19,1921,5
STAT,1852,18,45-49,1870,0.0632717545399004
SIM,1881,40,50-100,1921,1
STAT,1857,54,25-29,1911,0.002744385756838425
SIM,1861,55,na,1916,2187
STAT,1843,21,30-34,1864,18.179588499498784
SIM,1865,14,na,1879,2610
STAT,1875,53,30-34,1928,0.00613231515386291
STAT,1894,44,35-39,1938,0.16277972484727318
SIM,1946,18,30-34,1964,15
STAT,1874,61,na,1935,1946.299529677161
STAT,1830,74,na,1904,702.0435340155414
STAT,1902,49,30-34,1951,0.07691457352283902
STAT,1868,13,na,1881,2590.5601400412716
STAT,1949,3,na,1952,4720.457360881892
STAT,1850,38,35-39,1888,5.348706524309143
SIM,1895,35,na,1930,3295
STAT,1837,28,25-29,1865,35.939931343468785
STAT,1913,17,15-19,1930,9.466069109839541
SIM,1902,11,na,1913,3787
SIM,1854,81,na,1935,540
STAT,1833,54,35-39,1887,0.0056408261328274815
STAT,1829,37,30-34,1866,4.659982142787444
STAT,1854,28,20-24,1882,9.345043462080364
STAT,1870,41,40-44,1911,2.2532684735018167
STAT,1873,19,25-29,1892,5.829381200702698
STAT,1843,40,35-39,1883,1.544174522626661
SIM,1810,94,na,1904,40
STAT,1834,33,na,1867,1846.2246181528794
SIM,1871,62,na,1933,1637
STAT,1868,36,35-39,1904,6.924793509956751
STAT,1793,77,na,1870,368.22449228876917
STAT,1878,20,na,1898,2526.337584777422
SIM,1910,49,30-34,1959,1
STAT,1894,46,20-24,1940,0.008907623346986922
STAT,1883,44,25-29,1927,0.6341007130541698
SIM,1865,36,25-29,1901,6
STAT,1877,33,45-49,1910,1.8373274051735364
SIM,1875,47,45-49,1922,1
SIM,1862,28,20-24,1890,11
STAT,1840,81,na,1921,389.1330283914702
STAT,1865,28,30-34,1893,23.23391993514854
STAT,1854,40,45-49,1894,1.1570185806461561
STAT,1910,44,50-100,1954,0.11184834704816575
SIM,1879,9,na,1888,3223
SIM,1918,32,35-39,1950,14
STAT,1815,74,na,1889,585.2320953706025
SIM,1844,47,45-49,1891,1
STAT,1898,20,na,1918,3282.1757126903544
STAT,1822,35,20-24,1857,1.596297869645048
STAT,1938,18,30-34,1956,12.261201000159174
SIM,1881,83,na,1964,591
SIM,1858,44,40-44,1902,5
STAT,1893,20,na,1913,3078.9812846562672
STAT,1832,36,20-24,1868,0.661765735913782
SIM,1845,28,25-29,1873,56
STAT,1867,68,na,1935,1463.6032484905083
SIM,1891,8,na,1899,3358
SIM,1868,45,40-44,1913,1
STAT,1925,16,na,1941,4547.508083008894
STAT,1776,110,na,1886,0.0019073388065895193
STAT,1776,85,na,1861,79.56090719277017
STAT,1846,52,50-100,1898,0.010742809315266097
STAT,1839,40,15-19,1879,0.01132498905046188
SIM,1851,21,30-34,1872,18
STAT,1872,54,20-24,1926,7.337232153196929E-4
STAT,1867,47,45-49,1914,0.22497094472223048
STAT,1888,13,na,1901,3109.7306102004663
SIM,1840,21,20-24,1861,66
STAT,1949,18,40-44,1967,1.6591366078985406
STAT,1887,71,na,1958,1620.1024396965283
SIM,1921,17,15-19,1938,58
SIM,1883,4,na,1887,2779
SIM,1918,9,na,1927,4592
STAT,1842,47,40-44,1889,0.1342782615775646
STAT,1896,39,15-19,1935,0.07489855769543785
SIM,1940,7,na,1947,4155
SIM,1928,19,25-29,1947,66
SIM,1843,46,50-100,1889,1
STAT,1911,35,15-19,1946,0.019099212352280102
SIM,1812,75,na,1887,370
SIM,1833,42,40-44,1875,6
STAT,1889,20,50-100,1909,0.5169405537735401
STAT,1911,22,35-39,1933,9.108933761524897
SIM,1790,89,na,1879,4
STAT,1852,33,40-44,1885,3.5799074529072255
STAT,1827,53,35-39,1880,0.009144736350231738
STAT,1835,46,50-100,1881,0.19545135335152194
STAT,1872,83,na,1955,405.8912751448741
SIM,1860,33,40-44,1893,7
SIM,1915,46,na,1961,4126
STAT,1899,33,30-34,1932,24.28776741284742
STAT,1828,38,20-24,1866,0.6614613725961841
STAT,1895,41,50-100,1936,0.09808769758199512
SIM,1825,93,na,1918,10
STAT,1901,28,15-19,1929,0.6449642996090731
STAT,1836,47,45-49,1883,0.1537395800729517
STAT,1956,16,25-29,1972,58.49960044011965
STAT,1892,33,40-44,1925,5.521361539591929
SIM,1891,26,25-29,1917,57
STAT,1847,29,25-29,1876,39.08161425994934
STAT,1833,50,50-100,1883,0.010711456847959008
STAT,1845,42,50-100,1887,0.8405765842883611
SIM,1862,48,50-100,1910,1
SIM,1823,36,25-29,1859,2
STAT,1871,45,45-49,1916,0.24086139407046228
SIM,1911,31,40-44,1942,4
STAT,1838,45,25-29,1883,0.04467047073605418
STAT,1877,15,45-49,1892,0.06943795246038822
STAT,1868,54,35-39,1922,0.008157711100288685
STAT,1817,50,35-39,1867,0.01919178632281018
STAT,1845,52,40-44,1897,0.00818195688312671
STAT,1862,37,15-19,1899,0.04876462326318532
STAT,1865,3,na,1868,2962.3262844458086
STAT,1830,26,15-19,1856,0.5583582385098846
STAT,1878,29,25-29,1907,44.59719969786461
SIM,1866,35,35-39,1901,4
SIM,1878,43,na,1921,2584
STAT,1857,58,na,1915,1575.5892732287207
STAT,1948,21,15-19,1969,6.237916927238938
STAT,1816,53,25-29,1869,0.006830722296356601
STAT,1895,29,20-24,1924,15.50308897176859
STAT,1927,21,50-100,1948,0.829458386598361
STAT,1867,26,45-49,1893,1.0670217213582955
SIM,1841,63,na,1904,1314
STAT,1861,32,na,1893,2011.5844295996292
STAT,1898,12,na,1910,3562.706720521434
SIM,1853,42,50-100,1895,1
STAT,1882,47,40-44,1929,0.16935845658445717
SIM,1841,55,na,1896,1555
SIM,1870,35,20-24,1905,1
SIM,1834,46,45-49,1880,1
SIM,1898,28,35-39,1926,24
SIM,1844,32,45-49,1876,1
STAT,1856,106,na,1962,0.038316837982874705
SIM,1855,29,25-29,1884,32
STAT,1920,40,50-100,1960,0.13277602715489667
SIM,1882,17,na,1899,2487
STAT,1830,71,na,1901,844.3843832480214
STAT,1883,26,25-29,1909,42.48756769733065
STAT,1919,32,50-100,1951,0.9102742736524599
SIM,1822,40,45-49,1862,2
STAT,1892,31,20-24,1923,3.4701514031112652
SIM,1935,21,50-100,1956,1
STAT,1893,16,40-44,1909,0.23728469362347537
SIM,1908,25,35-39,1933,22
SIM,1860,3,na,1863,2707
STAT,1879,15,45-49,1894,0.06998061633638189
STAT,1905,8,na,1913,3830.027311936517
SIM,1881,22,20-24,1903,67
STAT,1860,24,35-39,1884,4.9079094506642855
SIM,1824,35,25-29,1859,2
SIM,1905,36,na,1941,3446
STAT,1881,31,45-49,1912,1.7269209917349337
STAT,1903,31,40-44,1934,6.314653627921254
SIM,1834,25,40-44,1859,4
SIM,1912,32,na,1944,3839
STAT,1816,39,40-44,1855,12.05042802674706
SIM,1824,39,40-44,1863,8
STAT,1893,37,45-49,1930,2.579863770934275
STAT,1913,49,40-44,1962,0.15606822451902252
STAT,1840,27,15-19,1867,0.4070771596342897
STAT,1804,54,45-49,1858,0.04086269310274259
SIM,1864,91,na,1955,84
SIM,1921,49,40-44,1970,1
STAT,1853,45,20-24,1898,0.010162298289419598
SIM,1876,36,35-39,1912,11
STAT,1862,19,15-19,1881,5.308080124518262
STAT,1836,32,45-49,1868,1.3720791541641726
STAT,1922,50,na,1972,4267.60075046637
SIM,1878,32,na,1910,2643
STAT,1814,40,45-49,1854,5.666390520320199
SIM,1870,19,15-19,1889,8
SIM,1917,30,30-34,1947,5
STAT,1831,53,20-24,1884,5.204722210647795E-4
STAT,1806,49,25-29,1855,0.1942223945102356
STAT,1892,35,na,1927,3040.870436689452
STAT,1906,45,50-100,1951,0.2077596550274827
STAT,1926,24,50-100,1950,0.8103947333613271
SIM,1835,20,35-39,1855,8
STAT,1882,28,na,1910,2363.5610209652573
STAT,1926,33,35-39,1959,11.265632678894288
SIM,1853,34,40-44,1887,7
SIM,1896,15,20-24,1911,22
STAT,1855,38,15-19,1893,0.04331500622285365
STAT,1938,16,50-100,1954,0.37792766499652725
STAT,1825,40,20-24,1865,0.22607183532343453
STAT,1863,98,na,1961,6.948709479346091
SIM,1847,40,na,1887,1656
STAT,1824,109,na,1933,3.9174064008961994E-4
SIM,1776,82,na,1858,146
STAT,1832,54,20-24,1886,4.953817431161901E-4
STAT,1847,47,20-24,1894,0.009314130178263672
STAT,1883,48,40-44,1931,0.16921207190992216
SIM,1906,30,20-24,1936,4
STAT,1862,73,na,1935,1031.4444469342811
SIM,1892,41,35-39,1933,7
STAT,1876,50,40-44,1926,0.011249505234682114
STAT,1886,86,na,1972,577.7505842110187
SIM,1827,37,na,1864,1648
STAT,1829,33,15-19,1862,0.1300885287091555
STAT,1849,27,35-39,1876,8.879933728326648
SIM,1886,29,25-29,1915,55
SIM,1891,48,40-44,1939,1
STAT,1840,30,45-49,1870,1.5604724906194787
STAT,1851,32,40-44,1883,3.7239177510616677
SIM,1846,55,na,1901,1670
SIM,1857,27,35-39,1884,15
SIM,1906,21,na,1927,3529
STAT,1884,41,35-39,1925,1.8358924250989272
SIM,1855,32,20-24,1887,3
STAT,1938,34,na,1972,3874.273994846387
STAT,1956,5,na,1961,5306.183643935959
SIM,1892,22,30-34,1914,37
SIM,1914,21,15-19,1935,6
SIM,1850,25,25-29,1875,44
STAT,1864,35,25-29,1899,2.6364721677655005
SIM,1775,89,na,1864,12
SIM,1863,23,15-19,1886,3
STAT,1888,15,20-24,1903,21.480306113046073
STAT,1881,32,na,1913,2353.5646667746123
SIM,1825,31,30-34,1856,24
STAT,1822,103,na,1925,0.08344594852740497
SIM,1864,37,25-29,1901,1
STAT,1928,28,15-19,1956,0.8867113322067907
STAT,1842,43,25-29,1885,0.5143782673886875
STAT,1823,110,na,1933,1.5379675351988274E-4
STAT,1928,31,45-49,1959,2.0081378225768236
SIM,1903,21,35-39,1924,10
SIM,1934,33,35-39,1967,19
SIM,1939,3,na,1942,4070
SIM,1870,22,45-49,1892,1
STAT,1863,50,35-39,1913,0.007811045631427168
STAT,1928,27,na,1955,4707.607079997908
SIM,1819,38,25-29,1857,6
SIM,1901,19,20-24,1920,42
STAT,1853,25,35-39,1878,9.508669103831211
STAT,1824,48,35-39,1872,0.1609717061218977
STAT,1839,38,30-34,1877,4.350066546999406
STAT,1833,31,15-19,1864,0.12297343232246068
STAT,1904,54,na,1958,3120.4276929273537
SIM,1910,30,50-100,1940,1
SIM,1861,25,35-39,1886,14
STAT,1862,37,45-49,1899,1.7311439199677305
STAT,1940,16,na,1956,3813.6631170308406
STAT,1850,40,na,1890,1756.0680656013744
STAT,1854,41,50-100,1895,0.8122188740961026
STAT,1886,20,40-44,1906,2.2635475088333923
STAT,1830,41,40-44,1871,1.9681883861729192
STAT,1891,39,35-39,1930,8.843177705202402
SIM,1830,71,na,1901,889
STAT,1897,27,na,1924,3255.305017344981
SIM,1847,38,30-34,1885,2
SIM,1940,13,na,1953,4119
SIM,1906,32,na,1938,3592
STAT,1829,48,15-19,1877,3.1957190352425226E-4
STAT,1862,22,45-49,1884,0.6198989602308669
STAT,1823,78,na,1901,434.8529542851955
STAT,1855,23,15-19,1878,2.966223647814599
STAT,1809,63,na,1872,1141.8887059390577
STAT,1849,45,35-39,1894,0.10977407296970339
SIM,1835,35,35-39,1870,1
STAT,1844,41,35-39,1885,1.4556622022598196
SIM,1874,46,45-49,1920,1
STAT,1888,4,na,1892,3172.662563700124
SIM,1871,15,20-24,1886,25
STAT,1842,25,25-29,1867,41.61883759588499
STAT,1918,24,40-44,1942,3.677483446967534
SIM,1934,15,35-39,1949,12
STAT,1854,84,na,1938,254.60531023956213
STAT,1894,26,35-39,1920,12.704950543471554
SIM,1878,34,45-49,1912,1
STAT,1829,33,45-49,1862,1.592970780067697
SIM,1855,0,na,1855,3033
STAT,1888,33,20-24,1921,3.246186490294709
SIM,1833,37,na,1870,1820
STAT,1906,21,15-19,1927,4.913330909898731
STAT,1852,15,40-44,1867,0.1803286316245936
STAT,1874,32,15-19,1906,0.14832640073692765
STAT,1922,3,na,1925,4789.705733051953
STAT,1819,44,40-44,1863,4.580371043962393
SIM,1944,20,50-100,1964,1
STAT,1880,18,20-24,1898,18.955716217799193
STAT,1902,30,50-100,1932,1.3287480405108971
STAT,1891,20,15-19,1911,4.191521216813532
SIM,1894,35,40-44,1929,10
SIM,1936,31,45-49,1967,2
SIM,1782,82,na,1864,100
STAT,1853,43,35-39,1896,1.5073966465375532
STAT,1886,35,40-44,1921,4.771772265843784
SIM,1824,63,na,1887,917
STAT,1896,42,45-49,1938,0.13985772625317608
STAT,1896,24,15-19,1920,4.417125228282407
STAT,1828,92,na,1920,22.934946874819506
STAT,1865,49,35-39,1914,0.12691989607781679
SIM,1851,40,35-39,1891,4
SIM,1852,41,35-39,1893,4
STAT,1866,46,45-49,1912,0.22269945829624144
STAT,1827,35,35-39,1862,9.667027399768726
SIM,1938,26,25-29,1964,73
STAT,1863,15,20-24,1878,18.309742035393874
SIM,1850,29,45-49,1879,4
STAT,1834,52,30-34,1886,0.004107368465232621
STAT,1866,41,20-24,1907,0.15011450073125784
STAT,1905,39,na,1944,3463.3447895251766
STAT,1888,48,20-24,1936,0.008060974979937728
SIM,1926,24,40-44,1950,7
SIM,1872,58,na,1930,2074
SIM,1898,49,na,1947,3374
STAT,1939,19,30-34,1958,12.437953398320083
SIM,1849,36,40-44,1885,8
STAT,1884,22,30-34,1906,17.977627669888435
STAT,1826,66,na,1892,955.9373951576341
SIM,1937,16,na,1953,4178
STAT,1905,10,na,1915,3816.442731306831
STAT,1829,51,45-49,1880,0.011579787829677547
STAT,1810,82,na,1892,198.91964290926143
STAT,1842,29,45-49,1871,1.0613499928279995
STAT,1895,41,45-49,1936,0.13895757197269382
STAT,1947,15,50-100,1962,0.4308202508671482
SIM,1793,74,na,1867,376
SIM,1827,44,40-44,1871,4
STAT,1926,15,35-39,1941,5.272768342083246
SIM,1962,3,na,1965,5406
STAT,1836,99,na,1935,1.1788083311102568
STAT,1916,39,15-19,1955,0.019866117490376044
STAT,1918,42,40-44,1960,0.2713826460411884
STAT,1844,40,na,1884,1881.8971055767572
STAT,1865,40,20-24,1905,0.1485291771190405
SIM,1884,83,na,1967,603
STAT,1828,50,45-49,1878,0.011405244493856815
STAT,1799,62,na,1861,886.0290460537395
STAT,1827,32,50-100,1859,1.4149681041965039
SIM,1926,42,40-44,1968,3
STAT,1786,75,na,1861,336.87010928927634
STAT,1898,34,25-29,1932,14.00923240574964
STAT,1871,56,na,1927,2061.100410030384
STAT,1904,38,40-44,1942,1.3745744803387825
STAT,1877,42,40-44,1919,2.3769971153325877
STAT,1910,49,20-24,1959,0.010454417930079762
STAT,1822,36,30-34,1858,10.581734347200895
STAT,1842,29,50-100,1871,0.6114884291593429
STAT,1875,46,na,1921,2362.295269329722
STAT,1958,6,na,1964,5265.546442644175
STAT,1894,49,25-29,1943,0.041745342309235364
STAT,1900,72,na,1972,2235.243548001998
SIM,1806,75,na,1881,510
SIM,1931,25,30-34,1956,59
STAT,1837,92,na,1929,27.768770109633852
STAT,1894,41,30-34,1935,1.5154417193330025
STAT,1853,35,50-100,1888,1.0510635088951588
STAT,1896,46,25-29,1942,0.04390141712751451
STAT,1856,99,na,1955,1.5166153431757636
STAT,1861,41,35-39,1902,1.5333653703062022
STAT,1819,46,50-100,1865,0.4936951454241402
STAT,1858,16,25-29,1874,5.386948718361286
STAT,1844,45,50-100,1889,0.19331954259143477
STAT,1861,35,40-44,1896,3.7251411332312068
STAT,1957,15,30-34,1972,16.39812547617563
SIM,1894,35,45-49,1929,4
STAT,1914,41,25-29,1955,0.07229816808538997
STAT,1847,37,na,1884,1906.199208557634
STAT,1835,52,45-49,1887,0.011023987440532148
SIM,1920,28,20-24,1948,23
STAT,1921,37,30-34,1958,2.076639060013744
SIM,1821,66,na,1887,841
SIM,1889,19,30-34,1908,4
STAT,1884,47,45-49,1931,0.23708023951822027
STAT,1935,2,na,1937,5701.780413931352
SIM,1898,63,na,1961,2929
STAT,1846,17,45-49,1863,0.05868164692261049
SIM,1846,27,50-100,1873,3
STAT,1811,48,20-24,1859,0.032755849706016915
SIM,1948,18,35-39,1966,13
STAT,1846,52,20-24,1898,5.248929840685031E-4
STAT,1905,41,15-19,1946,0.0014193053322150233
SIM,1827,44,45-49,1871,6
STAT,1837,40,45-49,1877,1.2080509745385561
SIM,1814,41,50-100,1855,4
STAT,1856,19,25-29,1875,5.302789852740245
SIM,1830,94,na,1924,11
SIM,1864,19,25-29,1883,10
SIM,1926,24,na,1950,4656
STAT,1941,23,25-29,1964,97.35337257835096
SIM,1885,26,35-39,1911,12
STAT,1886,35,45-49,1921,2.17303448636771
SIM,1789,78,na,1867,303
STAT,1894,39,na,1933,3060.441006735356
STAT,1903,16,45-49,1919,0.09496104241681859
STAT,1771,114,na,1885,2.760626604722803E-4
STAT,1889,41,20-24,1930,0.20103275866617157
SIM,1830,36,30-34,1866,9
STAT,1873,40,15-19,1913,0.014426929217492446
STAT,1906,17,40-44,1923,0.27158282745974544
SIM,1834,84,na,1918,142
SIM,1905,35,30-34,1940,1
STAT,1831,29,35-39,1860,9.071206240390287
STAT,1826,69,na,1895,855.9310056564125
STAT,1914,16,20-24,1930,28.68408147445671
SIM,1872,35,25-29,1907,5
STAT,1858,54,na,1912,1694.027273656455
STAT,1879,18,50-100,1897,0.052105858921508506
STAT,1878,48,30-34,1926,0.10149663020182063
SIM,1847,57,na,1904,1360
STAT,1849,23,20-24,1872,64.21981174278888
STAT,1868,51,30-34,1919,0.005827720527696729
SIM,1844,29,na,1873,2043
SIM,1875,23,40-44,1898,2
STAT,1905,16,na,1921,3730.2271138622514
STAT,1842,17,50-100,1859,0.04933588837915423
STAT,1863,30,45-49,1893,1.5723023745761864
SIM,1890,24,20-24,1914,130
STAT,1767,100,na,1867,0.1410660456152824
STAT,1812,100,na,1912,0.48422289490415915
STAT,1867,37,na,1904,2256.3940411534545
STAT,1854,64,na,1918,1330.4606381218123
STAT,1880,36,20-24,1916,0.8303502116434308
STAT,1805,81,na,1886,256.84580586390274
STAT,1882,24,20-24,1906,68.06176814608754
STAT,1912,28,20-24,1940,18.285918979557945
STAT,1850,53,25-29,1903,0.0026215407024036165
STAT,1901,46,45-49,1947,0.19045062575602167
STAT,1925,30,na,1955,4587.286216124003
SIM,1865,33,25-29,1898,15
SIM,1922,16,20-24,1938,145
STAT,1813,45,20-24,1858,0.03119017303301232
SIM,1841,66,na,1907,1168
SIM,1867,71,na,1938,1009
STAT,1920,31,40-44,1951,4.392173725187628
SIM,1838,29,25-29,1867,56
STAT,1834,53,40-44,1887,0.0071218191231730696
SIM,1916,14,na,1930,4301
STAT,1827,50,30-34,1877,0.0067108721774111
STAT,1852,83,na,1935,319.81337370009794
STAT,1877,9,na,1886,2797.0765214418666
SIM,1829,32,na,1861,1567
STAT,1807,62,na,1869,1100.4394000125565
STAT,1940,22,50-100,1962,0.6838157485345595
STAT,1881,32,20-24,1913,2.6659657583669025
STAT,1843,51,25-29,1894,0.0028730524146351835
STAT,1857,33,25-29,1890,8.126039156419958
SIM,1880,20,45-49,1900,1
STAT,1895,40,35-39,1935,2.4345328817170753
SIM,1904,43,30-34,1947,1
SIM,1938,23,na,1961,3596
SIM,1939,25,30-34,1964,51
STAT,1889,25,15-19,1914,0.575609171719016
STAT,1903,1,na,1904,3947.154568310598
STAT,1870,32,45-49,1902,1.7390488236032173
STAT,1893,34,50-100,1927,1.1756039733554142
SIM,1843,45,40-44,1888,1
SIM,1823,67,na,1890,900
STAT,1960,3,na,1963,5224.736841415341
SIM,1912,38,40-44,1950,3
STAT,1862,38,25-29,1900,2.4878934593751074
STAT,1932,30,20-24,1962,3.3105268184983734
STAT,1829,97,na,1926,3.572991540222531
STAT,1902,42,45-49,1944,0.14933400672416056
SIM,1906,31,30-34,1937,23
STAT,1867,23,40-44,1890,1.9895629953278469
SIM,1870,38,25-29,1908,5
SIM,1840,39,na,1879,1673
STAT,1782,101,na,1883,0.13183940589957172
STAT,1835,45,40-44,1880,0.15164793360471177
STAT,1837,24,40-44,1861,1.7927535275055242
SIM,1823,33,20-24,1856,2
SIM,1881,18,15-19,1899,7
STAT,1862,28,na,1890,2065.1618105185685
STAT,1873,18,15-19,1891,6.12172560840024
STAT,1887,18,45-49,1905,0.07447669485412427
STAT,1930,42,20-24,1972,0.02369927771643598
STAT,1876,53,45-49,1929,0.015042341304601203
SIM,1850,49,na,1899,1606
STAT,1859,53,45-49,1912,0.011633642201662039
STAT,1848,24,15-19,1872,3.0777912993434406
SIM,1854,39,na,1893,2026
STAT,1884,29,na,1913,2391.461151170937
STAT,1814,41,20-24,1855,0.5726404189166244
STAT,1843,46,45-49,1889,0.1920733266845169
SIM,1917,22,45-49,1939,1
SIM,1941,28,50-100,1969,1
STAT,1788,84,na,1872,119.02194163339517
SIM,1924,43,na,1967,4537
STAT,1886,6,na,1892,2820.855023676514
STAT,1852,49,20-24,1901,0.009465375850396135
SIM,1872,44,50-100,1916,1
STAT,1915,33,25-29,1948,9.56518421849289
STAT,1859,45,50-100,1904,0.2020888458685839
STAT,1904,45,15-19,1949,3.3317934388115095E-4
STAT,1947,25,15-19,1972,0.8155680381464799
STAT,1810,51,30-34,1861,0.018187774370930263
SIM,1883,39,50-100,1922,1
SIM,1917,41,na,1958,3820
STAT,1913,42,20-24,1955,0.017569341460337243
SIM,1851,46,45-49,1897,1
SIM,1910,29,na,1939,3606
SIM,1800,64,na,1864,771
SIM,1857,21,50-100,1878,2
STAT,1904,30,45-49,1934,2.5700767494819576
STAT,1819,87,na,1906,103.86861930190388
STAT,1899,15,30-34,1914,2.2369323668965824
SIM,1923,33,25-29,1956,15
SIM,1865,76,na,1941,870
STAT,1890,25,25-29,1915,53.12209061229635
STAT,1862,31,40-44,1893,3.7813950263824254
SIM,1793,77,na,1870,271
SIM,1882,88,na,1970,278
SIM,1856,24,15-19,1880,3
SIM,1834,39,na,1873,1720
STAT,1838,20,40-44,1858,2.0152584539857608
STAT,1834,30,na,1864,1904.641841609208
STAT,1899,2,na,1901,3723.846161122942
STAT,1909,22,45-49,1931,1.066524848772742
SIM,1823,47,na,1870,1494
STAT,1879,41,50-100,1920,1.13165013830313
STAT,1918,27,45-49,1945,1.876209715304748
SIM,1877,16,na,1893,2633
STAT,1913,43,30-34,1956,0.1269857972705002
STAT,1892,58,na,1950,2528.4807663893494
STAT,1930,35,15-19,1965,0.025591246467438326
STAT,1823,34,25-29,1857,21.422836290059976
STAT,1946,20,50-100,1966,0.7475794500767781
SIM,1831,34,25-29,1865,13
SIM,1908,4,na,1912,4245
STAT,1820,40,35-39,1860,3.805738664575255
STAT,1831,43,15-19,1874,0.011548500040156347
SIM,1819,93,na,1912,7
SIM,1846,20,40-44,1866,1
STAT,1890,23,na,1913,2940.896764632486
STAT,1819,44,45-49,1863,3.0477219437355667
SIM,1857,23,20-24,1880,56
SIM,1858,6,na,1864,2464
STAT,1777,92,na,1869,12.984505783335862
SIM,1926,27,45-49,1953,5
STAT,1895,47,20-24,1942,0.008967609295196948
SIM,1898,24,20-24,1922,118
STAT,1907,24,35-39,1931,8.68617001090706
STAT,1805,53,na,1858,1365.4578873058986
STAT,1869,31,25-29,1900,10.129253427597531
STAT,1910,42,35-39,1952,0.1940978409447733
SIM,1799,68,na,1867,937
SIM,1924,29,na,1953,4608
SIM,1929,28,40-44,1957,1
SIM,1953,6,na,1959,4774
SIM,1877,87,na,1964,305
SIM,1892,35,50-100,1927,3
STAT,1853,23,50-100,1876,0.4011059576316742
SIM,1909,12,na,1921,3795
SIM,1843,67,na,1910,1180
STAT,1924,24,35-39,1948,11.264696838071112
SIM,1883,7,na,1890,2686
SIM,1826,52,45-49,1878,2
SIM,1868,45,45-49,1913,1
SIM,1858,22,25-29,1880,47
STAT,1828,106,na,1934,0.006686024761191577
STAT,1899,30,25-29,1929,14.423622503534133
SIM,1901,29,50-100,1930,1
STAT,1881,66,na,1947,1616.518669427971
STAT,1840,34,25-29,1874,8.79277450127485
STAT,1879,21,40-44,1900,2.2287886302990274
STAT,1885,43,45-49,1928,1.5122450281196032
STAT,1876,46,40-44,1922,0.18085914935348696
STAT,1923,25,30-34,1948,46.21076076027852
SIM,1829,52,na,1881,1180
STAT,1848,40,20-24,1888,0.12649880034940555
STAT,1883,75,na,1958,1131.856597015181
STAT,1930,37,na,1967,5005.009380336655
STAT,1837,47,30-34,1884,0.06699664465793205
STAT,1874,17,20-24,1891,18.465362029203405
STAT,1913,35,15-19,1948,0.01951669721235717
SIM,1915,24,35-39,1939,14
SIM,1877,31,25-29,1908,18
STAT,1812,63,na,1875,987.5667803391436
SIM,1874,59,na,1933,1964
SIM,1930,33,30-34,1963,33
STAT,1887,57,na,1944,2297.276292707622
STAT,1860,42,30-34,1902,0.9504252145684381
STAT,1872,44,15-19,1916,0.013928991461862167
STAT,1865,9,na,1874,2554.459161388105
SIM,1887,21,40-44,1908,3
SIM,1814,84,na,1898,185
STAT,1825,81,na,1906,324.276370180003
STAT,1868,35,50-100,1903,1.2076336076290126
STAT,1818,52,45-49,1870,0.03158440281065676
SIM,1863,67,na,1930,1285
STAT,1801,91,na,1892,20.67567584046044
STAT,1778,113,na,1891,1.9985562650329675E-4
SIM,1906,18,30-34,1924,4
STAT,1846,89,na,1935,75.1260599436007
STAT,1861,66,na,1927,1381.6334989574436
STAT,1879,46,25-29,1925,0.061596436151419305
STAT,1898,29,na,1927,3268.8029912885672
STAT,1875,54,40-44,1929,0.010719448032413766
SIM,1916,29,50-100,1945,1
STAT,1909,32,50-100,1941,0.8046610340765045
SIM,1932,24,35-39,1956,16
STAT,1816,45,na,1861,1355.5353846452979
STAT,1780,107,na,1887,0.007564373572893505
STAT,1853,40,30-34,1893,0.9737223638962647
STAT,1922,33,30-34,1955,18.08714749401287
STAT,1923,49,50-100,1972,0.2683811271359187
STAT,1952,18,na,1970,4498.16215053202
STAT,1862,15,35-39,1877,0.5522206679894822
STAT,1813,62,na,1875,972.5251907348392
SIM,1861,40,30-34,1901,1
SIM,1864,18,15-19,1882,5
STAT,1840,19,na,1859,2113.5066767027265
STAT,1931,26,35-39,1957,19.776977407461377
SIM,1938,29,30-34,1967,52
SIM,1880,42,20-24,1922,2
STAT,1797,67,na,1864,767.9426355166794
STAT,1882,30,15-19,1912,0.14267337099191338
STAT,1919,30,na,1949,4197.394521141977
STAT,1921,38,40-44,1959,1.7039458464589876
SIM,1836,30,25-29,1866,3
STAT,1919,41,45-49,1960,0.1843142438393951
STAT,1927,17,na,1944,4668.462977583302
SIM,1917,1,na,1918,4424
STAT,1822,39,35-39,1861,12.053248095741495
STAT,1835,51,35-39,1886,0.0066704613220598475
STAT,1854,24,40-44,1878,1.847083347353446
SIM,1869,58,na,1927,1991
SIM,1885,49,25-29,1934,1
STAT,1820,34,40-44,1854,13.004505531055788
STAT,1827,51,40-44,1878,0.011635558012379608
STAT,1877,49,25-29,1926,0.059673250211437275
STAT,1944,17,45-49,1961,0.5484734994119177
STAT,1815,52,50-100,1867,0.038815309756827836
STAT,1894,42,40-44,1936,0.20470870197545224
SIM,1932,38,na,1970,5289
SIM,1778,86,na,1864,99
STAT,1900,20,30-34,1920,25.335945160540067
STAT,1941,20,20-24,1961,117.31399494660268
STAT,1832,33,20-24,1865,2.344762133448266
STAT,1850,50,20-24,1900,5.630430662965623E-4
STAT,1836,45,na,1881,1503.533015882727
STAT,1908,26,50-100,1934,0.9709507493374143
STAT,1856,18,15-19,1874,5.586315019390856
SIM,1844,60,na,1904,1492
STAT,1887,15,40-44,1902,0.21005402091315767
STAT,1907,11,na,1918,3874.07911860142
SIM,1867,31,35-39,1898,12
STAT,1831,34,50-100,1865,0.8176155591739012
STAT,1874,30,20-24,1904,2.8380334836686982
STAT,1929,27,20-24,1956,23.30085792655334
STAT,1940,25,30-34,1965,40.79691456583181
SIM,1901,46,na,1947,3400
STAT,1926,36,50-100,1962,0.523937806149221
STAT,1900,22,25-29,1922,80.94241764465276
SIM,1922,19,25-29,1941,63
STAT,1885,4,na,1889,2827.2528199159997
SIM,1867,57,na,1924,1768
STAT,1878,74,na,1952,1178.441459106295
SIM,1871,30,45-49,1901,2
STAT,1859,31,35-39,1890,8.284389676290555
STAT,1864,28,15-19,1892,0.41009690846134994
STAT,1937,22,20-24,1959,110.45010984128378
STAT,1927,39,20-24,1966,0.3336140515125814
STAT,1895,21,25-29,1916,76.42457365967901
SIM,1934,36,50-100,1970,1
STAT,1914,19,25-29,1933,9.09703699955979
SIM,1948,19,45-49,1967,1
STAT,1805,51,20-24,1856,0.002653142977358356
STAT,1884,44,40-44,1928,2.239512167953899
STAT,1872,42,20-24,1914,0.1621752424617047
STAT,1828,30,25-29,1858,10.847213522391769
SIM,1849,52,na,1901,1713
SIM,1845,27,45-49,1872,2
SIM,1906,15,25-29,1921,9
STAT,1875,27,50-100,1902,0.6697647467572132
STAT,1895,48,30-34,1943,0.07176434292835136
SIM,1827,51,na,1878,1338
STAT,1849,63,na,1912,1385.2634066233225
STAT,1836,44,45-49,1880,1.0802518382076884
SIM,1823,92,na,1915,17
SIM,1867,36,50-100,1903,3
SIM,1840,33,20-24,1873,5
STAT,1860,43,40-44,1903,1.8483087565075849
STAT,1913,28,40-44,1941,4.721261645189073
STAT,1857,52,50-100,1909,0.01196858989253227
STAT,1809,97,na,1906,2.7408704104822483
STAT,1936,22,na,1958,3560.9191292697724
SIM,1862,24,40-44,1886,4
STAT,1852,45,40-44,1897,0.13929399364705447
SIM,1844,44,45-49,1888,2
SIM,1895,21,na,1916,3500
SIM,1931,31,25-29,1962,15
SIM,1859,36,35-39,1895,5
STAT,1837,27,45-49,1864,0.9501525357303731
STAT,1933,30,50-100,1963,1.1375794896371312
SIM,1881,29,50-100,1910,1
SIM,1848,19,40-44,1867,3
SIM,1824,32,25-29,1856,11
SIM,1863,30,50-100,1893,2
STAT,1837,21,na,1858,1879.6315919830688
SIM,1830,39,35-39,1869,15
STAT,1864,18,50-100,1882,0.04570107536774178
STAT,1915,40,na,1955,3826.122142296777
STAT,1883,23,25-29,1906,57.12381893284952
SIM,1830,49,na,1879,1642
SIM,1857,81,na,1938,378
STAT,1931,41,25-29,1972,0.09743211542452639
SIM,1874,23,20-24,1897,77
STAT,1947,18,40-44,1965,1.607029243099481
STAT,1802,103,na,1905,0.04553810550967693
STAT,1878,40,35-39,1918,1.9422350250864733
STAT,1955,17,20-24,1972,183.5668244622319
STAT,1853,41,40-44,1894,1.8945486078857967
STAT,1855,18,na,1873,2103.9802006588
STAT,1918,34,na,1952,4066.138172312986
STAT,1885,18,40-44,1903,0.18566712847058672
STAT,1923,35,40-44,1958,1.7728258884031864
SIM,1931,35,40-44,1966,4
SIM,1824,94,na,1918,4
SIM,1862,20,25-29,1882,68
SIM,1865,90,na,1955,11
STAT,1848,27,20-24,1875,10.886655778111642
STAT,1923,31,25-29,1954,10.855101861486553
SIM,1903,28,20-24,1931,19
SIM,1891,23,25-29,1914,94
SIM,1795,78,na,1873,323
STAT,1876,52,35-39,1928,0.009020756785975016
SIM,1856,27,20-24,1883,5
STAT,1839,87,na,1926,121.59025820428342
STAT,1836,48,25-29,1884,0.037045213968466974
STAT,1901,43,40-44,1944,0.22121394843133718
STAT,1864,41,50-100,1905,0.9626248504935497
SIM,1851,43,40-44,1894,8
STAT,1866,23,20-24,1889,64.90467913692419
SIM,1834,22,40-44,1856,1
STAT,1853,37,na,1890,1975.4837616139769
STAT,1831,26,30-34,1857,25.813838182402154
STAT,1913,45,25-29,1958,0.053067119911266995
SIM,1953,0,na,1953,4958
STAT,1842,28,na,1870,2082.846972300056
SIM,1836,34,40-44,1870,11
STAT,1769,100,na,1869,0.10265948083869048
STAT,1838,23,45-49,1861,0.6599598708039497
SIM,1881,86,na,1967,390
SIM,1907,39,45-49,1946,5
SIM,1923,30,20-24,1953,6
STAT,1899,18,35-39,1917,0.7645217375758118
SIM,1905,45,40-44,1950,1
SIM,1853,31,40-44,1884,1
SIM,1892,78,na,1970,1663
STAT,1895,25,40-44,1920,4.014178329290467
STAT,1932,33,25-29,1965,12.522521470392933
SIM,1933,34,na,1967,5067
SIM,1886,41,45-49,1927,2
STAT,1838,38,15-19,1876,0.04927183793351702
STAT,1831,36,na,1867,1833.3232747148668
STAT,1847,44,20-24,1891,0.12217280117403966
STAT,1907,49,15-19,1956,3.3269505524598307E-4
SIM,1831,42,na,1873,1604
STAT,1951,17,50-100,1968,0.4551320545747042
STAT,1783,111,na,1894,1.9875519611458893E-4
SIM,1914,24,15-19,1938,4
STAT,1824,88,na,1912,75.59044695044435
STAT,1886,45,50-100,1931,0.2678458002417223
STAT,1831,41,20-24,1872,0.13640587868483076
STAT,1911,48,25-29,1959,0.05108186350192351
STAT,1859,50,40-44,1909,0.008700289150199252
STAT,1867,51,na,1918,2072.023611506915
SIM,1927,23,15-19,1950,10
STAT,1854,20,25-29,1874,52.2262385274212
SIM,1852,20,35-39,1872,6
STAT,1925,20,35-39,1945,11.56758687431386
STAT,1816,90,na,1906,34.98261686415172
SIM,1865,48,na,1913,2121
STAT,1877,27,na,1904,2525.1467425582982
STAT,1878,41,45-49,1919,1.5964150422191736
STAT,1915,18,50-100,1933,0.07980701703787017
STAT,1850,31,15-19,1881,0.11322762594012117
STAT,1900,29,40-44,1929,4.2053043364229055
STAT,1924,40,50-100,1964,0.1429640059394464
STAT,1876,93,na,1969,120.80106055003218
SIM,1856,85,na,1941,151
SIM,1897,28,20-24,1925,20
STAT,1888,19,na,1907,3029.5973057576284
STAT,1899,17,25-29,1916,7.916247930586607
STAT,1915,30,20-24,1945,2.5553594118398153
STAT,1915,40,30-34,1955,0.13170784084718745
SIM,1777,81,na,1858,128
SIM,1919,32,20-24,1951,6
STAT,1828,34,40-44,1862,4.008189230612439
SIM,1923,31,30-34,1954,28
STAT,1932,32,na,1964,5127.352454748206
STAT,1844,20,35-39,1864,5.7279446647711385
SIM,1850,22,25-29,1872,79
STAT,1773,88,na,1861,43.43103208871295
STAT,1911,47,15-19,1958,3.5572377982625306E-4
STAT,1849,18,na,1867,2180.691824944372
STAT,1919,23,15-19,1942,5.929908822479446
STAT,1773,114,na,1887,3.029390545979991E-4
STAT,1841,49,45-49,1890,0.1706129965596006
STAT,1804,88,na,1892,46.3222053239477
STAT,1858,32,50-100,1890,0.7412496798293113
STAT,1880,23,50-100,1903,0.43581255926070367
STAT,1854,46,20-24,1900,0.0092103315657565
STAT,1877,26,35-39,1903,10.24443170898833
SIM,1947,16,25-29,1963,89
STAT,1862,34,45-49,1896,1.5013701144533675
STAT,1882,16,50-100,1898,0.048811481078588896
STAT,1930,20,45-49,1950,1.4788963343788522
STAT,1857,27,na,1884,1958.4594105730116
STAT,1868,52,40-44,1920,0.010203190419658188
STAT,1913,9,na,1922,4138.641174839973
STAT,1915,31,30-34,1946,16.440988986325774
STAT,1923,40,20-24,1963,0.02111894383790582
STAT,1871,33,50-100,1904,0.9219814485401101
SIM,1859,90,na,1949,101
SIM,1945,22,20-24,1967,129
STAT,1810,54,35-39,1864,0.024764817022315498
STAT,1827,82,na,1909,301.56124400869135
STAT,1854,47,30-34,1901,0.07374093277509491
SIM,1838,28,15-19,1866,3
STAT,1824,41,15-19,1865,0.017359498663111508
STAT,1882,51,50-100,1933,0.015082091203086392
STAT,1842,22,25-29,1864,56.62238134171936
SIM,1827,41,40-44,1868,5
STAT,1813,46,30-34,1859,0.2474067876587434
STAT,1885,21,35-39,1906,5.957158917960604
STAT,1869,35,40-44,1904,4.352385692768816
STAT,1822,44,50-100,1866,1.5502112585735057
STAT,1889,28,20-24,1917,14.731276346109489
SIM,1907,31,na,1938,3648
STAT,1814,64,na,1878,975.1073404515678
SIM,1838,43,na,1881,1599
STAT,1787,100,na,1887,0.26525351125425134
SIM,1933,20,35-39,1953,22
STAT,1941,21,30-34,1962,30.312033537563526
STAT,1901,26,na,1927,3416.2479146652036
SIM,1852,58,na,1910,1651
STAT,1844,17,40-44,1861,0.1801677911728068
STAT,1933,39,15-19,1972,0.026617922546118267
STAT,1803,72,na,1875,641.7613973666994
SIM,1841,86,na,1927,98
SIM,1894,32,40-44,1926,11
STAT,1836,25,35-39,1861,7.884711626610415
STAT,1870,47,15-19,1917,3.970450288841127E-4
STAT,1886,32,40-44,1918,4.682838954647121
STAT,1821,37,25-29,1858,6.3041773469842814
SIM,1845,40,45-49,1885,5
STAT,1846,35,na,1881,1796.3361080392326
STAT,1819,41,40-44,1860,4.999060712085355
SIM,1937,27,20-24,1964,22
STAT,1845,50,na,1895,1706.5473730700292
SIM,1888,17,20-24,1905,29
SIM,1921,46,35-39,1967,1
STAT,1890,40,15-19,1930,0.01739932110668386
SIM,1894,25,na,1919,3254
STAT,1880,37,30-34,1917,5.713465206634002
STAT,1885,76,na,1961,1156.8515455530928
STAT,1906,24,15-19,1930,4.867876060926408
STAT,1798,94,na,1892,6.879772730258126
STAT,1885,56,na,1941,2075.896249721835
STAT,1904,23,50-100,1927,0.5943741138061636
STAT,1876,42,25-29,1918,0.6756342467333278
SIM,1878,31,45-49,1909,3
SIM,1880,27,30-34,1907,32
SIM,1912,23,50-100,1935,5
SIM,1857,33,50-100,1890,2
STAT,1941,30,30-34,1971,16.895025610342486
SIM,1889,25,50-100,1914,2
STAT,1858,17,35-39,1875,0.518545750027323
STAT,1888,45,20-24,1933,0.014616525023017017
SIM,1841,16,20-24,1857,18
STAT,1863,17,45-49,1880,0.06667164642390616
SIM,1877,35,40-44,1912,6
SIM,1844,25,35-39,1869,19
STAT,1931,31,15-19,1962,0.17182664241210424
STAT,1829,63,na,1892,1186.711924828899
STAT,1874,84,na,1958,434.4128008522533
STAT,1891,32,15-19,1923,0.17986059851995376
STAT,1879,24,45-49,1903,0.7389373293500555
STAT,1913,46,35-39,1959,0.12869753290766361
SIM,1810,74,na,1884,739
STAT,1809,51,25-29,1860,0.015349994110573754
STAT,1833,39,50-100,1872,0.9952097223177586
SIM,1849,33,40-44,1882,7
STAT,1843,78,na,1921,630.7488055026325
SIM,1913,36,35-39,1949,4
SIM,1835,51,40-44,1886,2
SIM,1836,34,na,1870,1972
STAT,1844,53,35-39,1897,0.006564143781976522
STAT,1915,41,50-100,1956,0.12086785811966658
SIM,1796,71,na,1867,553
STAT,1905,36,35-39,1941,2.2600747624302957
SIM,1934,19,na,1953,5181
STAT,1777,103,na,1880,0.06303405325276544
SIM,1848,18,30-34,1866,1
STAT,1870,57,na,1927,2004.1300316201134
STAT,1882,49,35-39,1931,0.13623756136830922
STAT,1931,40,15-19,1971,0.0020981049297024578
STAT,1912,18,na,1930,3973.68711205056
STAT,1897,19,15-19,1916,8.05153286362461
SIM,1887,24,45-49,1911,1
STAT,1910,18,45-49,1928,0.10068919615278858
SIM,1923,41,50-100,1964,1
STAT,1885,40,40-44,1925,2.312364765748419
STAT,1882,28,50-100,1910,0.6335375118159229
SIM,1864,60,na,1924,1774
STAT,1879,43,20-24,1922,0.16812771648071004
SIM,1882,33,25-29,1915,1
STAT,1816,54,35-39,1870,0.01627342279236643
STAT,1904,47,50-100,1951,0.20160861112722897
STAT,1845,15,35-39,1860,0.5483202794197228
STAT,1865,70,na,1935,1299.1103766922145
STAT,1883,45,35-39,1928,0.14153224878001858
STAT,1875,15,na,1890,2656.6225017002835
STAT,1872,45,25-29,1917,0.05947907487997586
SIM,1913,17,25-29,1930,12
STAT,1916,17,35-39,1933,0.9085083083621197
STAT,1827,54,45-49,1881,0.013752350490135375
STAT,1929,42,15-19,1971,0.002028421420132215
SIM,1847,16,20-24,1863,19
SIM,1886,21,25-29,1907,63
STAT,1931,23,30-34,1954,37.899546463468994
STAT,1865,27,20-24,1892,10.862183948586274
SIM,1925,37,50-100,1962,1
STAT,1859,28,40-44,1887,2.4648312283780367
SIM,1870,46,50-100,1916,2
SIM,1842,15,25-29,1857,6
SIM,1946,17,20-24,1963,1
STAT,1827,31,na,1858,1884.6842202402577
STAT,1905,17,25-29,1922,8.34904354136282
STAT,1894,33,45-49,1927,2.2786187148296118
SIM,1915,15,na,1930,4557
STAT,1851,107,na,1958,0.00768696736326467
STAT,1926,32,na,1958,4665.344613111824
SIM,1858,16,30-34,1874,1
STAT,1830,27,25-29,1857,47.851038881195
STAT,1942,23,40-44,1965,3.59558210628954
STAT,1870,40,30-34,1910,1.1580900565858552
STAT,1805,54,25-29,1859,0.011991081486651572
SIM,1909,6,na,1915,3819
STAT,1820,49,50-100,1869,0.4350521722776941
SIM,1833,29,40-44,1862,4
SIM,1893,21,35-39,1914,14
SIM,1891,45,35-39,1936,1
STAT,1874,33,25-29,1907,10.623285696628228
STAT,1859,53,na,1912,1726.0520860261324
SIM,1805,73,na,1878,430
SIM,1823,98,na,1921,2
STAT,1869,60,na,1929,1878.3973410096223
SIM,1895,52,na,1947,2945
STAT,1843,22,40-44,1865,2.111508586512165
STAT,1880,17,45-49,1897,0.07002765966991212
STAT,1865,42,15-19,1907,0.012770817957237824
STAT,1920,35,20-24,1955,0.29504807751074685
SIM,1861,35,50-100,1896,1
SIM,1938,18,40-44,1956,1
STAT,1858,40,15-19,1898,0.011284990185042405
SIM,1826,30,35-39,1856,3
SIM,1879,15,20-24,1894,25
SIM,1827,46,50-100,1873,2
STAT,1900,23,35-39,1923,8.225579699631341
SIM,1885,45,na,1930,2302
STAT,1894,45,45-49,1939,0.17642884012040563
STAT,1916,25,na,1941,3979.5399965859406
STAT,1854,27,45-49,1881,0.8908418835100206
STAT,1907,21,30-34,1928,26.761338250571864
STAT,1895,15,na,1910,3377.2279325001527
SIM,1881,52,na,1933,1960
SIM,1815,80,na,1895,213
SIM,1815,42,25-29,1857,1
STAT,1896,62,na,1958,2534.781995054912
STAT,1918,37,na,1955,4046.6465827702827
STAT,1825,29,40-44,1854,10.150681632060207
STAT,1874,18,30-34,1892,1.6557641151756142
STAT,1811,44,40-44,1855,6.633425556571982
STAT,1853,44,45-49,1897,1.2379916135626785
SIM,1915,21,30-34,1936,39
SIM,1894,39,25-29,1933,3
SIM,1904,21,20-24,1925,96
SIM,1905,31,15-19,1936,1
STAT,1860,46,45-49,1906,0.19589517255605732
STAT,1939,16,25-29,1955,44.26303891014612
STAT,1826,100,na,1926,0.6191945768135353
STAT,1928,44,na,1972,4813.285026725268
STAT,1827,42,45-49,1869,1.773604721713743
SIM,1845,20,25-29,1865,2
SIM,1859,100,na,1959,5
STAT,1949,21,35-39,1970,11.21322527079591
SIM,1867,28,40-44,1895,6
SIM,1889,15,15-19,1904,10
SIM,1900,61,na,1961,2691
STAT,1890,22,20-24,1912,85.95709377482747
STAT,1938,17,20-24,1955,136.42439121357833
STAT,1893,46,40-44,1939,0.12533192550347244
STAT,1839,37,20-24,1876,0.635743516914133
STAT,1901,71,na,1972,2339.936094691264
STAT,1924,46,45-49,1970,0.26464152859774265
STAT,1904,35,50-100,1939,0.3911233745956107
SIM,1841,32,25-29,1873,11
STAT,1874,30,na,1904,2505.469287939238
STAT,1903,38,25-29,1941,0.89673400639958
SIM,1893,40,na,1933,3099
STAT,1886,39,25-29,1925,3.077701332214067
SIM,1927,22,35-39,1949,17
STAT,1866,26,25-29,1892,39.9409738774961
SIM,1963,2,na,1965,5158
SIM,1911,38,25-29,1949,1
STAT,1823,31,20-24,1854,7.8707373817391915
STAT,1917,43,35-39,1960,0.21411085806690028
SIM,1902,42,na,1944,3390
STAT,1859,16,40-44,1875,0.17399871931026778
STAT,1936,29,20-24,1965,17.800078517444607
SIM,1878,18,na,1896,2828
STAT,1804,103,na,1907,0.048424813479292096
STAT,1839,16,20-24,1855,16.100320943413834
STAT,1805,110,na,1915,1.1106770596294145E-4
STAT,1833,53,25-29,1886,0.0023672195173788857
SIM,1887,23,na,1910,2790
SIM,1870,34,50-100,1904,2
SIM,1839,93,na,1932,18
STAT,1922,44,20-24,1966,0.020614407176694736
SIM,1829,86,na,1915,60
STAT,1925,29,45-49,1954,2.0669440785074977
SIM,1831,31,20-24,1862,3
STAT,1898,40,na,1938,3231.7719635971866
SIM,1935,17,45-49,1952,1
STAT,1828,37,45-49,1865,1.74767332585362
SIM,1855,38,na,1893,1792
STAT,1835,49,20-24,1884,0.00918965915894481
STAT,1837,20,25-29,1857,52.78651855590662
SIM,1858,41,35-39,1899,4
SIM,1872,27,na,1899,2451
STAT,1871,46,20-24,1917,0.012160724832434697
SIM,1908,33,na,1941,3903
SIM,1870,34,45-49,1904,4
STAT,1843,43,40-44,1886,1.845751081362862
STAT,1943,22,45-49,1965,1.2213487348366467
STAT,1823,43,20-24,1866,0.2505515922954083
SIM,1854,53,na,1907,1831
SIM,1885,34,50-100,1919,2
SIM,1821,45,50-100,1866,1
SIM,1807,51,na,1858,1201
STAT,1869,63,na,1932,1757.3762981454458
STAT,1912,12,na,1924,4073.8895854671227
STAT,1927,17,45-49,1944,0.6335890931006036
SIM,1870,15,na,1885,2816
STAT,1913,0,na,1913,4683.684627586464
SIM,1929,39,30-34,1968,1
STAT,1867,82,na,1949,446.860788595738
SIM,1815,49,45-49,1864,2
STAT,1933,28,50-100,1961,1.3471683207098697
STAT,1902,28,50-100,1930,0.9170511543404712
STAT,1822,32,15-19,1854,0.4486271723473316
SIM,1934,22,45-49,1956,1
STAT,1895,28,45-49,1923,1.4726236629724432
STAT,1910,31,na,1941,3734.5323361152314
STAT,1921,18,20-24,1939,157.28324441070782
STAT,1904,18,20-24,1922,25.852368843220304
SIM,1819,37,45-49,1856,2
STAT,1911,41,40-44,1952,0.24491583333731018
STAT,1858,36,45-49,1894,1.6205082693205695
STAT,1861,97,na,1958,7.052706299876508
SIM,1825,32,40-44,1857,9
STAT,1851,19,40-44,1870,0.18130974354094648
STAT,1873,34,20-24,1907,2.771702246516141
SIM,1767,91,na,1858,12
STAT,1769,109,na,1878,0.0015302035500470179
STAT,1857,30,20-24,1887,2.21234463557419
STAT,1878,28,45-49,1906,1.1748378009086207
SIM,1892,23,40-44,1915,4
STAT,1884,23,40-44,1907,2.0966532902784403
SIM,1805,70,na,1875,609
STAT,1880,44,50-100,1924,1.1172604399841617
STAT,1915,18,30-34,1933,2.59638881550449
STAT,1899,41,15-19,1940,0.0013457317408101246
SIM,1903,22,15-19,1925,4
STAT,1936,4,na,1940,3941.292581624072
STAT,1921,33,15-19,1954,0.1453125669983868
STAT,1863,51,45-49,1914,0.013042761232171502
SIM,1909,27,45-49,1936,1
SIM,1869,38,na,1907,2291
SIM,1828,26,50-100,1854,4
SIM,1908,33,50-100,1941,1
STAT,1915,34,35-39,1949,9.416053542136686
SIM,1876,35,50-100,1911,4
SIM,1881,34,20-24,1915,7
STAT,1926,22,45-49,1948,1.3945047835558677
SIM,1853,38,25-29,1891,4
STAT,1939,29,50-100,1968,1.0197591044927952
STAT,1849,21,50-100,1870,0.385537861082994
STAT,1919,22,35-39,1941,10.521633613841953
SIM,1836,37,45-49,1873,4
SIM,1938,25,15-19,1963,4
SIM,1836,31,na,1867,2040
STAT,1831,44,25-29,1875,0.5298788872320894
SIM,1839,24,15-19,1863,3
SIM,1887,41,50-100,1928,4
SIM,1912,18,20-24,1930,23
STAT,1806,53,30-34,1859,0.018944628220059177
STAT,1813,49,35-39,1862,0.34024926836256675
SIM,1849,38,na,1887,1846
SIM,1924,33,40-44,1957,7
STAT,1848,106,na,1954,0.009438137576136318
STAT,1821,33,45-49,1854,5.495430601238233
SIM,1913,33,30-34,1946,16
SIM,1940,18,30-34,1958,19
STAT,1852,51,35-39,1903,0.0069686557872624755
SIM,1807,54,na,1861,1162
SIM,1923,34,35-39,1957,20
STAT,1932,18,30-34,1950,16.416580306831538
SIM,1928,28,25-29,1956,12
STAT,1814,98,na,1912,1.513778615003592
SIM,1854,50,na,1904,1876
STAT,1821,46,na,1867,1386.3686285798794
STAT,1901,3,na,1904,3771.36402689298
STAT,1863,75,na,1938,920.8041279034873
STAT,1905,45,30-34,1950,0.08125146454231699
SIM,1847,71,na,1918,844
STAT,1898,15,15-19,1913,8.225062008521029
STAT,1860,49,15-19,1909,3.241726126637731E-4
STAT,1898,43,na,1941,3176.3755879131195
SIM,1904,20,na,1924,3684
STAT,1895,44,50-100,1939,0.09632783717716857
SIM,1872,32,20-24,1904,2
STAT,1914,44,na,1958,3742.2477558330006
STAT,1916,33,40-44,1949,4.105578418187984
SIM,1930,29,na,1959,5260
SIM,1931,22,na,1953,4684
STAT,1913,34,50-100,1947,0.8319987042525193
SIM,1886,28,45-49,1914,2
SIM,1865,30,20-24,1895,3
STAT,1859,70,na,1929,1143.1055490981498
SIM,1816,68,na,1884,917
STAT,1872,20,45-49,1892,0.7172161916338391
SIM,1931,4,na,1935,5244
STAT,1770,91,na,1861,10.836197923719883
STAT,1899,28,na,1927,3322.16532031421
STAT,1841,45,30-34,1886,0.07365999821160724
STAT,1941,24,35-39,1965,9.920495438835935
STAT,1906,43,25-29,1949,0.06573497347420362
STAT,1817,53,40-44,1870,0.022103524359579813
STAT,1848,16,na,1864,2225.038453835569
SIM,1922,35,30-34,1957,5
STAT,1905,33,30-34,1938,14.708491961517895
STAT,1858,103,na,1961,0.33191381808196035
STAT,1868,43,45-49,1911,1.4477430544934529
SIM,1788,76,na,1864,462
STAT,1912,43,15-19,1955,0.0015018605841526358
STAT,1830,45,20-24,1875,0.010220811117658067
STAT,1930,24,25-29,1954,119.93224917588863
STAT,1873,44,30-34,1917,1.1729940300090305
STAT,1874,54,25-29,1928,0.003587774239755971
SIM,1876,43,45-49,1919,6
STAT,1917,32,45-49,1949,1.6815471005305498
SIM,1896,37,na,1933,3188
SIM,1925,32,45-49,1957,5
STAT,1951,19,45-49,1970,0.6064362227639056
SIM,1787,91,na,1878,9
STAT,1812,83,na,1895,181.06823367583775
STAT,1842,44,35-39,1886,1.432026644552296
SIM,1923,18,30-34,1941,20
STAT,1860,27,50-100,1887,0.535155746862659
STAT,1869,38,45-49,1907,1.9536633920235051
SIM,1890,15,na,1905,3302
SIM,1830,40,na,1870,1770
STAT,1931,35,30-34,1966,2.465955766336601
STAT,1902,2,na,1904,3834.9396793266524
STAT,1853,68,na,1921,1281.3916355498084
STAT,1832,43,30-34,1875,0.9324681986068086
SIM,1812,46,50-100,1858,1
STAT,1841,97,na,1938,3.9666094149995788
STAT,1882,46,30-34,1928,0.09648042726270276
STAT,1899,37,45-49,1936,0.6010833609610652
STAT,1914,35,30-34,1949,1.874282824343159
STAT,1926,37,15-19,1963,0.023942087226493113
STAT,1956,15,15-19,1971,61.27974302266062
SIM,1877,38,45-49,1915,4
STAT,1906,28,30-34,1934,37.25961947188282
STAT,1921,45,15-19,1966,4.2575108441953406E-4
SIM,1831,25,na,1856,1835
STAT,1877,45,45-49,1922,0.2521977719820848
SIM,1838,46,na,1884,1558
SIM,1834,53,na,1887,1463
STAT,1870,43,35-39,1913,1.7928119271090115
SIM,1818,46,na,1864,1422
STAT,1902,32,35-39,1934,14.569257958201929
STAT,1854,30,na,1884,1909.5652779877446
SIM,1939,28,na,1967,3770
STAT,1858,23,na,1881,1983.370877841487
SIM,1889,58,na,1947,2652
SIM,1849,47,50-100,1896,1
STAT,1844,23,na,1867,2053.843895220171
SIM,1885,45,45-49,1930,2
STAT,1898,31,20-24,1929,3.7442503389289827
STAT,1900,41,30-34,1941,0.11339390029431508
SIM,1841,32,na,1873,1924
STAT,1803,52,35-39,1855,0.03477405307221119
SIM,1798,83,na,1881,93
SIM,1794,90,na,1884,16
SIM,1910,32,35-39,1942,13
STAT,1924,29,50-100,1953,1.173940107598606
SIM,1859,8,na,1867,2689
STAT,1811,50,35-39,1861,0.02371840426311327
STAT,1911,26,15-19,1937,0.7046591091505476
SIM,1894,59,na,1953,2618
SIM,1836,19,15-19,1855,7
STAT,1946,18,25-29,1964,49.02341897926787
STAT,1855,45,25-29,1900,0.045096575923810285
SIM,1811,52,35-39,1863,2
STAT,1850,57,na,1907,1511.6541459951968
STAT,1863,78,na,1941,698.8643839562571
SIM,1852,42,45-49,1894,4
SIM,1847,19,25-29,1866,4
STAT,1936,27,30-34,1963,38.24623813509887
STAT,1887,19,20-24,1906,20.157393355108837
STAT,1896,43,20-24,1939,0.014751683457388432
STAT,1898,19,30-34,1917,2.187034598933398
SIM,1806,58,na,1864,1230
SIM,1944,27,30-34,1971,51
SIM,1878,66,na,1944,1825
STAT,1816,76,na,1892,420.375706435274
STAT,1849,60,na,1909,1480.6590383318262
SIM,1907,17,35-39,1924,2
STAT,1901,22,40-44,1923,2.9727182865083073
STAT,1908,29,45-49,1937,1.6534599885367633
STAT,1847,54,30-34,1901,0.0045142270432918016
STAT,1866,45,35-39,1911,0.1330491755050773
STAT,1936,25,na,1961,3659.8121985761395
SIM,1828,28,20-24,1856,13
STAT,1838,23,na,1861,2023.5693081156203
STAT,1876,31,35-39,1907,10.711745715651624
SIM,1865,45,na,1910,2208
STAT,1785,90,na,1875,30.693590738115212
STAT,1791,76,na,1867,335.4204985618521
STAT,1839,19,25-29,1858,5.055888658594887
STAT,1894,48,15-19,1942,2.923596371443721E-4
STAT,1824,30,50-100,1854,2.590331151447315
STAT,1868,40,40-44,1908,2.2137351863079715
SIM,1946,21,na,1967,4033
STAT,1806,69,na,1875,737.9643489690529
STAT,1837,43,15-19,1880,0.010726647306115125
STAT,1913,46,50-100,1959,0.2257722427581892
SIM,1883,16,25-29,1899,9
STAT,1843,25,45-49,1868,1.119091501932525
STAT,1844,50,30-34,1894,0.004678984790799658
STAT,1920,38,25-29,1958,1.0990170565330548
SIM,1854,30,45-49,1884,2
STAT,1882,42,15-19,1924,0.013708371570883992
STAT,1858,54,40-44,1912,0.00828273870338444
STAT,1891,17,20-24,1908,22.39109861737042
SIM,1948,15,30-34,1963,23
STAT,1894,30,40-44,1924,5.736461166436316
SIM,1867,26,na,1893,2184
STAT,1851,52,30-34,1903,0.004884813247078486
STAT,1881,48,50-100,1929,0.23918610485254704
STAT,1893,42,25-29,1935,0.8300221014817678
STAT,1848,43,25-29,1891,0.49556403344777394
STAT,1875,16,25-29,1891,5.9476969203457815
STAT,1931,38,35-39,1969,3.2636291138057314
STAT,1934,19,45-49,1953,0.6853627877631677
SIM,1942,19,45-49,1961,1
STAT,1884,30,15-19,1914,0.14488490812209762
SIM,1832,26,20-24,1858,15
STAT,1870,71,na,1941,1331.1468612514057
SIM,1839,28,30-34,1867,36
STAT,1864,44,20-24,1908,0.1421119999338519
SIM,1888,73,na,1961,1547
SIM,1881,44,30-34,1925,2
STAT,1826,51,25-29,1877,0.0027259810277571635
STAT,1865,56,na,1921,1888.5029067522744
STAT,1844,24,50-100,1868,0.3889030059853327
SIM,1846,72,na,1918,921
SIM,1856,39,50-100,1895,1
STAT,1868,18,40-44,1886,0.18037280565077213
STAT,1917,40,30-34,1957,0.13652996890211228
STAT,1851,51,50-100,1902,0.012519647346346856
STAT,1828,45,50-100,1873,0.1972016291653445
STAT,1846,30,45-49,1876,1.5046213570708573
STAT,1878,44,15-19,1922,0.014466184513484234
SIM,1836,65,na,1901,1337
STAT,1924,4,na,1928,4903.770253865489
SIM,1887,26,na,1913,2797
SIM,1881,6,na,1887,2431
STAT,1923,47,40-44,1970,0.18818302187712907
SIM,1878,42,50-100,1920,2
STAT,1890,77,na,1967,1464.3842600991659
SIM,1854,18,20-24,1872,13
SIM,1870,31,40-44,1901,12
SIM,1921,21,20-24,1942,174
SIM,1910,20,na,1930,3637
SIM,1884,31,35-39,1915,12
SIM,1916,29,45-49,1945,3
STAT,1933,33,40-44,1966,5.374903458331981
STAT,1861,39,20-24,1900,0.6432611713271176
STAT,1845,38,25-29,1883,2.3392717701343972
SIM,1916,20,35-39,1936,8
STAT,1881,35,25-29,1916,2.8666559677730166
SIM,1852,27,na,1879,2148
SIM,1878,63,na,1941,2004
SIM,1905,16,20-24,1921,27
STAT,1852,41,25-29,1893,0.5196635214435747
SIM,1906,34,35-39,1940,14
STAT,1878,21,25-29,1899,60.970416482704856
SIM,1873,27,20-24,1900,14
STAT,1833,50,20-24,1883,5.233611044977332E-4
STAT,1923,43,25-29,1966,0.0850230623804726
STAT,1847,82,na,1929,363.84705118243653
SIM,1850,40,50-100,1890,1
STAT,1855,42,20-24,1897,0.12296001828197194
STAT,1913,21,20-24,1934,110.25263701916826
SIM,1840,17,15-19,1857,4
SIM,1920,6,na,1926,4425
SIM,1855,54,30-34,1909,1
STAT,1842,40,50-100,1882,0.879393537271569
STAT,1835,49,na,1884,1722.1440264261566
STAT,1901,47,20-24,1948,0.009611494690625022
STAT,1921,30,45-49,1951,1.8012979237388949
SIM,1817,40,35-39,1857,3
STAT,1814,44,25-29,1858,2.0056405437683957
SIM,1900,35,45-49,1935,1
SIM,1880,49,40-44,1929,1
STAT,1911,44,45-49,1955,0.1600400994929669
STAT,1852,38,na,1890,1888.5650914503806
STAT,1885,22,na,1907,2407.0963191893916
SIM,1908,7,na,1915,4205
STAT,1822,50,45-49,1872,0.020699865604882507
SIM,1794,79,na,1873,238
STAT,1849,26,25-29,1875,39.211646330978404
SIM,1822,44,25-29,1866,1
SIM,1918,37,30-34,1955,3
STAT,1903,35,20-24,1938,0.24357125111529834
STAT,1844,42,45-49,1886,1.1877913405342737
STAT,1939,32,30-34,1971,16.3988528273369
STAT,1832,83,na,1915,265.2778054940051
STAT,1905,48,35-39,1953,0.11489049187149371
SIM,1852,72,na,1924,999
STAT,1784,94,na,1878,3.5560881348280295
STAT,1890,34,20-24,1924,3.34275830096805
SIM,1882,37,40-44,1919,7
SIM,1922,45,40-44,1967,1
STAT,1821,91,na,1912,30.534979140441155
STAT,1876,11,na,1887,2748.954772330188
SIM,1870,5,na,1875,3016
SIM,1894,16,35-39,1910,1
STAT,1825,50,na,1875,1488.46985699697
SIM,1863,64,na,1927,1402
STAT,1789,100,na,1889,0.1811333168865574
SIM,1868,23,30-34,1891,25
SIM,1877,15,50-100,1892,2
STAT,1888,29,15-19,1917,0.5432636705489369
STAT,1867,52,25-29,1919,0.0033742391134484284
STAT,1928,32,20-24,1960,3.110962928331974
SIM,1939,28,35-39,1967,23
SIM,1886,25,40-44,1911,5
SIM,1871,37,30-34,1908,4
STAT,1861,20,35-39,1881,5.126966868316227
SIM,1914,19,na,1933,3991
SIM,1869,41,45-49,1910,2
STAT,1819,48,25-29,1867,0.11246820391840642
STAT,1800,54,40-44,1854,0.042863797586519516
SIM,1944,23,15-19,1967,6
SIM,1857,26,25-29,1883,54
SIM,1928,33,na,1961,4962
SIM,1890,12,na,1902,3398
STAT,1833,32,25-29,1865,8.749795133206145
SIM,1930,36,35-39,1966,4
SIM,1825,35,45-49,1860,1
STAT,1878,25,40-44,1903,3.2024532536164365
STAT,1936,23,15-19,1959,5.188998600697357
STAT,1824,49,45-49,1873,0.26771354954359833
STAT,1825,41,30-34,1866,1.6029158761296056
SIM,1845,79,na,1924,525
SIM,1876,85,na,1961,503
STAT,1883,20,20-24,1903,69.3905927056607
STAT,1850,16,20-24,1866,16.392303123023275
STAT,1900,44,35-39,1944,0.17539944783810027
STAT,1836,42,na,1878,1556.761057577026
STAT,1940,31,25-29,1971,9.764343795520253
SIM,1940,30,20-24,1970,6
STAT,1874,37,40-44,1911,4.559439942582554
STAT,1897,28,50-100,1925,0.8694923985721388
STAT,1921,16,30-34,1937,14.21238995119215
SIM,1918,26,na,1944,4208
STAT,1869,50,35-39,1919,0.008600983719535812
SIM,1913,48,35-39,1961,1
SIM,1896,29,15-19,1925,4
STAT,1940,21,15-19,1961,5.533894954110382
STAT,1834,64,na,1898,1168.2073458448249
SIM,1954,8,na,1962,4719
STAT,1836,41,40-44,1877,1.6871065493123456
STAT,1775,80,na,1855,222.84465
STAT,1914,45,40-44,1959,0.16028676589862914
SIM,1913,34,na,1947,3919
STAT,1803,58,na,1861,1171.755955213821
SIM,1929,18,na,1947,4983
STAT,1888,29,50-100,1917,0.7659680176978683
SIM,1891,20,20-24,1911,91
STAT,1907,46,45-49,1953,0.19997033070473763
STAT,1840,21,50-100,1861,0.3758736833153784
STAT,1863,33,15-19,1896,0.12683925914547553
STAT,1858,50,25-29,1908,0.002906694256512528
STAT,1932,40,30-34,1972,0.17719726038731334
SIM,1870,12,na,1882,2874
STAT,1905,30,na,1935,3544.1193800809
STAT,1908,20,35-39,1928,8.879700617799028
STAT,1851,31,30-34,1882,15.149065813358868
SIM,1815,46,40-44,1861,2
SIM,1829,83,na,1912,118
SIM,1847,37,20-24,1884,3
SIM,1903,27,na,1930,3380
STAT,1858,33,40-44,1891,3.493631306072513
STAT,1812,46,15-19,1858,9.630365326004682E-4
SIM,1896,29,50-100,1925,2
STAT,1780,104,na,1884,0.030736630398670486
STAT,1858,20,50-100,1878,0.38401476795892525
STAT,1846,18,20-24,1864,15.832396846142508
SIM,1841,35,na,1876,1850
SIM,1866,33,40-44,1899,10
STAT,1890,47,50-100,1937,0.17199899409720085
STAT,1768,87,na,1855,72.83699999999999
STAT,1878,77,na,1955,917.8645071353976
STAT,1848,39,50-100,1887,0.9632780118724789
SIM,1876,40,40-44,1916,5
SIM,1862,27,45-49,1889,2
SIM,1898,18,na,1916,3880
SIM,1844,41,40-44,1885,6
STAT,1836,90,na,1926,49.07309540187538
STAT,1871,45,50-100,1916,0.25065914528200145
STAT,1840,31,20-24,1871,2.3938658336811507
STAT,1861,12,na,1873,2312.981173414749
SIM,1895,31,45-49,1926,3
STAT,1841,41,15-19,1882,0.010732084501170936
SIM,1833,41,30-34,1874,4
SIM,1894,33,50-100,1927,1
SIM,1790,80,na,1870,148
STAT,1889,69,na,1958,1937.8757265090862
STAT,1857,18,30-34,1875,1.4837390935428185
STAT,1855,49,na,1904,1707.657786721742
STAT,1906,40,20-24,1946,0.016540561350320143
STAT,1922,36,35-39,1958,2.8108140423919847
SIM,1898,27,25-29,1925,80
STAT,1892,32,30-34,1924,22.323329214653533
STAT,1924,21,30-34,1945,34.70555630332271
STAT,1838,54,20-24,1892,5.272780491228999E-4
STAT,1890,47,35-39,1937,0.09804502950620864
SIM,1843,30,35-39,1873,23
SIM,1872,78,na,1950,604
SIM,1871,93,na,1964,84
STAT,1799,93,na,1892,9.483315631994499
STAT,1884,40,25-29,1924,0.6546576730648943
SIM,1922,48,na,1970,4260
SIM,1801,66,na,1867,975
SIM,1941,0,na,1941,4225
STAT,1806,109,na,1915,2.528058129335484E-4
STAT,1810,51,na,1861,1180.5183023503535
STAT,1853,47,15-19,1900,3.3383554404919235E-4
STAT,1889,44,25-29,1933,0.7982872780017596
SIM,1885,11,na,1896,2632
STAT,1847,28,15-19,1875,0.42220000282087633
STAT,1886,33,50-100,1919,0.985197881427469
SIM,1800,81,na,1881,185
SIM,1932,21,30-34,1953,2
STAT,1932,18,na,1950,4957.457588125975
STAT,1931,33,na,1964,5051.010116574222
SIM,1865,18,30-34,1883,3
STAT,1930,28,40-44,1958,6.041841836939349
SIM,1885,42,40-44,1927,10
STAT,1862,34,50-100,1896,0.7888554789957469
STAT,1921,26,na,1947,4275.045317594297
STAT,1887,31,45-49,1918,2.001567751263797
STAT,1818,57,na,1875,1198.6038110139698
STAT,1914,31,15-19,1945,0.13251671180258665
STAT,1886,16,35-39,1902,0.5939579697409457
SIM,1903,36,50-100,1939,3
STAT,1919,49,40-44,1968,0.17348455135532542
STAT,1850,39,45-49,1889,1.4919479867426837
STAT,1899,34,40-44,1933,6.006393123862731
SIM,1843,13,na,1856,2404
SIM,1936,32,20-24,1968,3
STAT,1863,37,30-34,1900,4.767050028667983
SIM,1888,38,20-24,1926,4
SIM,1903,26,30-34,1929,62
STAT,1874,51,20-24,1925,7.722660881340835E-4
STAT,1829,52,20-24,1881,5.253014887588994E-4
SIM,1887,77,na,1964,1330
STAT,1901,0,na,1901,4188.91649187635
STAT,1826,35,na,1861,1695.5338994561043
STAT,1860,50,50-100,1910,0.012680402259590343
STAT,1835,30,35-39,1865,9.811883171003192
SIM,1911,56,na,1967,3418
SIM,1818,91,na,1909,24
STAT,1912,47,30-34,1959,0.08739726377123148
SIM,1918,0,na,1918,4688
SIM,1861,86,na,1947,96
STAT,1823,72,na,1895,702.8677756156002
SIM,1883,19,na,1902,2585
STAT,1947,17,na,1964,4230.29706287092
SIM,1816,65,na,1881,1030
STAT,1869,15,50-100,1884,0.04950210958760984
STAT,1820,38,20-24,1858,1.7720440474770591
STAT,1851,16,50-100,1867,0.04943345242174416
SIM,1828,40,45-49,1868,5
STAT,1838,17,50-100,1855,0.04754785536170988
STAT,1887,66,na,1953,1873.6072197444923
SIM,1865,32,20-24,1897,5
STAT,1906,18,30-34,1924,2.360449635552663
STAT,1846,68,na,1914,1092.8473269526603
STAT,1860,52,50-100,1912,0.01243421309930735
STAT,1898,20,15-19,1918,4.57833150400796
SIM,1859,21,40-44,1880,3
SIM,1862,31,40-44,1893,1
STAT,1842,38,45-49,1880,1.8149266756077107
SIM,1876,30,30-34,1906,33
STAT,1827,48,20-24,1875,0.013296321760835879
STAT,1824,47,40-44,1871,0.19952146117353808
STAT,1850,73,na,1923,893.4332874032593
STAT,1891,71,na,1962,1891.276448579193
SIM,1954,15,20-24,1969,162
STAT,1845,48,50-100,1893,0.18948759377757227
STAT,1849,23,50-100,1872,0.38002141279987206
STAT,1838,27,15-19,1865,0.4240481923673947
STAT,1951,19,20-24,1970,164.58682395042752
STAT,1902,30,30-34,1932,25.320248709370684
STAT,1822,35,50-100,1857,2.5424479299914613
STAT,1824,41,na,1865,1533.3263294654314
STAT,1857,5,na,1862,2354.673252651927
STAT,1948,23,30-34,1971,33.65790002605624
STAT,1900,22,20-24,1922,97.43880279889063
STAT,1887,40,50-100,1927,1.2198512053158959
SIM,1827,58,na,1885,1158
STAT,1821,47,50-100,1868,0.386974732354608
SIM,1874,36,na,1910,2416
STAT,1803,95,na,1898,5.159133717493845
STAT,1930,34,25-29,1964,12.149797585173468
STAT,1911,49,na,1960,3526.870402358982
STAT,1857,32,20-24,1889,2.1668736722657087
STAT,1828,55,na,1883,1197.2738802830295
STAT,1920,21,35-39,1941,10.71468173202932
SIM,1914,18,30-34,1932,4
STAT,1878,28,50-100,1906,0.6768735348840317
STAT,1915,43,50-100,1958,0.12050311218669597
STAT,1847,25,15-19,1872,0.43142636318130867
STAT,1926,45,15-19,1971,4.6586975426060183E-4
STAT,1836,23,50-100,1859,0.332602257277719
STAT,1846,32,45-49,1878,1.4736964363237037
STAT,1854,31,40-44,1885,3.4344634158542564
SIM,1832,47,40-44,1879,1
STAT,1923,44,35-39,1967,0.2393363200967551
SIM,1939,26,35-39,1965,22
STAT,1889,35,20-24,1924,0.980605631134262
STAT,1898,28,25-29,1926,58.15161092191174
SIM,1840,24,na,1864,1946
STAT,1844,24,35-39,1868,5.565201364280463
SIM,1907,20,30-34,1927,35
STAT,1861,21,30-34,1882,15.537245497141525
STAT,1830,45,15-19,1875,3.40693404236409E-4
STAT,1940,19,45-49,1959,0.517086803635492
SIM,1921,31,45-49,1952,3
STAT,1873,54,25-29,1927,0.0035625863195841655
STAT,1914,24,15-19,1938,5.514046736689924
STAT,1941,26,25-29,1967,69.49625347312434
SIM,1922,24,15-19,1946,7
STAT,1862,46,50-100,1908,0.21388458644580355
STAT,1891,38,40-44,1929,5.501354293595193
SIM,1962,0,na,1962,5413
STAT,1837,34,45-49,1871,1.4277888464744561
STAT,1918,39,30-34,1957,1.956196087281095
SIM,1886,21,na,1907,2663
SIM,1926,39,30-34,1965,6
STAT,1876,34,50-100,1910,0.9569363316672354
SIM,1852,24,35-39,1876,5
STAT,1832,60,na,1892,1274.430761332483
SIM,1830,39,30-34,1869,13
STAT,1967,0,na,1967,5046.30765946719
STAT,1832,53,50-100,1885,0.010341622293648368
STAT,1822,39,30-34,1861,9.082346459874035
STAT,1919,13,na,1932,4461.340400658177
STAT,1831,37,30-34,1868,4.688229861836284
STAT,1900,44,40-44,1944,0.21786985757422142
STAT,1829,72,na,1901,839.9309960247826
SIM,1915,34,25-29,1949,12
SIM,1824,77,na,1901,424
STAT,1922,28,40-44,1950,5.3626876871484495
SIM,1912,19,35-39,1931,2
STAT,1879,16,20-24,1895,18.951338912488477
SIM,1932,31,20-24,1963,5
STAT,1850,37,40-44,1887,3.344921742046202
SIM,1854,32,45-49,1886,1
SIM,1903,66,na,1969,2648
SIM,1912,33,45-49,1945,3
STAT,1837,91,na,1928,38.6353481225949
STAT,1833,45,40-44,1878,0.13609691047394024
STAT,1807,107,na,1914,0.0019929776318404124
STAT,1843,49,50-100,1892,0.1941266031374217
STAT,1909,42,35-39,1951,0.19208753966043432
SIM,1849,69,na,1918,1280
STAT,1883,39,45-49,1922,1.9753283641987112
STAT,1782,84,na,1866,101.28793567920727
STAT,1907,28,na,1935,3562.1589474970624
STAT,1903,14,na,1917,3732.9392591043797
SIM,1795,63,na,1858,885
STAT,1917,19,45-49,1936,0.5438473626441032
STAT,1863,24,45-49,1887,0.6270482310173162
STAT,1879,28,15-19,1907,0.48210496845165557
STAT,1816,48,45-49,1864,0.47751392184618374
STAT,1853,22,na,1875,2118.2891614093746
SIM,1920,30,na,1950,4107
STAT,1808,94,na,1902,6.653558157856628
STAT,1882,19,na,1901,2496.680032881823
STAT,1918,48,50-100,1966,0.24493629638107273
STAT,1858,53,na,1911,1713.9606358514077
SIM,1879,83,na,1962,788
STAT,1851,50,30-34,1901,0.004981529304768092
STAT,1929,23,20-24,1952,142.9756465876624
STAT,1935,15,45-49,1950,0.6996608432689376
STAT,1833,23,20-24,1856,65.0704133209649
STAT,1875,40,15-19,1915,0.01460493565798857
STAT,1889,34,50-100,1923,1.1447157637428997
STAT,1900,31,35-39,1931,14.377679502062609
SIM,1865,27,25-29,1892,42
SIM,1925,19,45-49,1944,1
SIM,1866,33,na,1899,2322
SIM,1924,44,na,1968,4522
SIM,1824,48,45-49,1872,1
STAT,1894,39,20-24,1933,1.0013414289079205
SIM,1930,28,40-44,1958,14
STAT,1946,15,20-24,1961,153.50168923711988
SIM,1836,19,na,1855,2282
SIM,1882,87,na,1969,353
STAT,1778,79,na,1857,173.07574881042336
SIM,1881,15,15-19,1896,5
SIM,1910,30,30-34,1940,16
STAT,1849,17,na,1866,2193.612200807126
SIM,1936,19,20-24,1955,136
STAT,1847,52,50-100,1899,0.011714623881678973
STAT,1928,19,20-24,1947,173.31407012481807
SIM,1848,35,25-29,1883,6
STAT,1873,15,15-19,1888,6.210753878447786
SIM,1907,15,35-39,1922,2
STAT,1835,31,30-34,1866,16.741576175760382
STAT,1908,61,na,1969,3120.99179412449
SIM,1841,23,20-24,1864,82
SIM,1926,20,40-44,1946,11
STAT,1811,98,na,1909,1.4071329395956362
SIM,1899,30,25-29,1929,19
SIM,1873,48,40-44,1921,1
STAT,1915,36,25-29,1951,1.0198760243819065
STAT,1913,42,25-29,1955,0.07104124934499068
STAT,1859,35,35-39,1894,5.817141306452851
STAT,1879,31,na,1910,2555.053793598908
STAT,1910,41,45-49,1951,0.16134665939178913
SIM,1929,29,30-34,1958,65
SIM,1874,68,na,1942,1472
STAT,1779,80,na,1859,196.72869965803972
STAT,1858,25,50-100,1883,0.5374692054347192
SIM,1843,31,30-34,1874,4
SIM,1893,22,30-34,1915,33
STAT,1847,19,50-100,1866,0.04712293327491369
STAT,1914,29,45-49,1943,1.7642428425381615
STAT,1776,104,na,1880,0.03149157758072789
STAT,1869,42,40-44,1911,2.2126033053886007
STAT,1856,103,na,1959,0.2379037752560245
SIM,1856,39,na,1895,2286
STAT,1861,57,na,1918,1694.055108732161
STAT,1872,38,30-34,1910,5.422090730162796
SIM,1852,25,na,1877,2158
STAT,1839,39,na,1878,1730.1093143363623
STAT,1885,22,30-34,1907,18.128964051257885
SIM,1837,20,na,1857,1712
SIM,1856,48,40-44,1904,1
SIM,1895,33,45-49,1928,2
SIM,1778,83,na,1861,153
SIM,1920,18,30-34,1938,21
STAT,1938,29,30-34,1967,39.55915038389073
SIM,1923,36,25-29,1959,2
SIM,1917,25,45-49,1942,4
STAT,1887,33,45-49,1920,1.9850091323325756
STAT,1912,18,30-34,1930,2.5077300828446476
SIM,1922,29,45-49,1951,4
STAT,1781,112,na,1893,1.787705091001218E-4
STAT,1830,49,50-100,1879,0.19860542950408394
SIM,1920,14,na,1934,4359
STAT,1918,23,45-49,1941,1.2345514925754981
STAT,1900,65,na,1965,2631.1203352932107
STAT,1904,33,45-49,1937,1.4577925973402526
SIM,1804,89,na,1893,61
SIM,1924,28,na,1952,4446
STAT,1866,88,na,1954,129.17976512674682
SIM,1845,55,na,1900,1610
STAT,1920,4,na,1924,4621.185262789413
SIM,1827,42,na,1869,1546
STAT,1904,19,35-39,1923,0.7979465922769361
SIM,1799,93,na,1892,12
STAT,1865,48,40-44,1913,0.15652282330374168
STAT,1860,43,35-39,1903,1.4880091212953308
STAT,1917,41,30-34,1958,0.13634838404347252
SIM,1906,36,25-29,1942,1
STAT,1857,49,45-49,1906,0.18409982610956666
STAT,1858,69,na,1927,1187.2538550409515
SIM,1863,38,30-34,1901,9
STAT,1839,28,50-100,1867,0.5521728921646768
STAT,1862,74,na,1936,963.7404334375149
STAT,1894,20,30-34,1914,23.513062514227943
STAT,1907,34,25-29,1941,8.7341045309229
STAT,1909,25,45-49,1934,1.70968414887935
STAT,1820,36,50-100,1856,3.1580298351302387
SIM,1826,31,30-34,1857,4
SIM,1894,72,na,1966,1969
STAT,1835,25,na,1860,2130.9881650133943
STAT,1917,47,15-19,1964,3.926500938766206E-4
STAT,1839,19,30-34,1858,1.4220597516143019
STAT,1887,50,na,1937,2496.797050331052
SIM,1847,19,30-34,1866,3
SIM,1889,36,25-29,1925,5
STAT,1878,14,na,1892,2733.388553917876
SIM,1828,42,45-49,1870,4
SIM,1886,32,40-44,1918,9
STAT,1851,3,na,1854,2834.0
STAT,1881,17,15-19,1898,5.853113326625731
STAT,1844,61,na,1905,1448.0269801926806
STAT,1878,32,40-44,1910,4.6049911127430985
SIM,1865,49,45-49,1914,1
STAT,1848,75,na,1923,800.234960176498
SIM,1872,17,15-19,1889,10
STAT,1919,45,na,1964,4085.4382659530224
SIM,1861,61,na,1922,1902
STAT,1895,32,40-44,1927,5.772217130874178
SIM,1931,19,45-49,1950,2
STAT,1810,52,35-39,1862,0.02578100374691171
SIM,1932,34,25-29,1966,17
SIM,1817,41,30-34,1858,2
SIM,1869,89,na,1958,98
SIM,1936,13,na,1949,3450
SIM,1927,16,15-19,1943,49
STAT,1878,73,na,1951,1261.2284976949943
STAT,1871,46,15-19,1917,4.053571378485399E-4
STAT,1913,31,45-49,1944,1.6036826117361864
STAT,1876,32,30-34,1908,18.392579346958183
SIM,1884,32,30-34,1916,26
STAT,1859,23,40-44,1882,1.7487848478631645
STAT,1938,16,25-29,1954,43.71364207391252
STAT,1923,19,45-49,1942,0.59528167303296
SIM,1946,16,25-29,1962,61
SIM,1836,41,40-44,1877,3
STAT,1924,34,25-29,1958,10.98735670009514
SIM,1857,56,na,1913,1690
STAT,1848,34,20-24,1882,2.183984917938359
STAT,1853,38,20-24,1891,0.6431498548716345
SIM,1819,43,50-100,1862,2
STAT,1901,32,50-100,1933,1.307096822228348
STAT,1919,16,15-19,1935,10.293198598778055
STAT,1924,45,50-100,1969,0.2760166039696055
STAT,1904,37,50-100,1941,0.38744377412484854
SIM,1902,31,35-39,1933,22
SIM,1869,43,45-49,1912,1
STAT,1895,31,50-100,1926,1.2245166431333896
STAT,1874,38,40-44,1912,4.5368251204673475
SIM,1900,20,20-24,1920,88
STAT,1833,107,na,1940,0.00309694657254164
STAT,1831,42,50-100,1873,0.8953465156882096
STAT,1898,36,50-100,1934,1.7018875458214402
STAT,1865,52,25-29,1917,0.003262100975411255
SIM,1856,34,20-24,1890,4
STAT,1828,41,40-44,1869,1.8692655678739711
STAT,1933,24,25-29,1957,124.86686279811742
SIM,1802,82,na,1884,215
SIM,1886,53,na,1939,2434
SIM,1901,18,20-24,1919,39
STAT,1899,51,na,1950,3022.384555954797
STAT,1858,19,40-44,1877,0.17081843340118869
STAT,1892,15,25-29,1907,7.278925562351042
SIM,1867,23,40-44,1890,6
STAT,1904,44,25-29,1948,0.06431742220338278
SIM,1833,24,25-29,1857,60
STAT,1864,17,15-19,1881,5.568724503766452
STAT,1833,41,50-100,1874,0.8580135509876201
STAT,1952,15,na,1967,4501.987761553917
STAT,1767,95,na,1862,1.640691042855166
SIM,1817,44,50-100,1861,2
SIM,1941,24,25-29,1965,102
STAT,1836,46,50-100,1882,0.1620563708376486
STAT,1922,46,50-100,1968,0.26578674761338267
STAT,1930,31,45-49,1961,2.072398319907312
STAT,1770,99,na,1869,0.21375192035403756
SIM,1873,52,25-29,1925,1
SIM,1882,38,40-44,1920,8
STAT,1841,37,na,1878,1863.209346666751
STAT,1815,80,na,1895,319.8609494768539
STAT,1894,36,na,1930,3106.4359725109102
SIM,1877,17,na,1894,2620
SIM,1854,48,30-34,1902,1
SIM,1865,75,na,1940,973
STAT,1803,79,na,1882,330.54187362632086
STAT,1807,47,40-44,1854,0.7503701147417482
STAT,1824,51,25-29,1875,0.004062310514916825
SIM,1850,35,40-44,1885,6
STAT,1883,36,na,1919,2369.602110130545
STAT,1921,27,na,1948,4260.4246626081185
STAT,1841,47,40-44,1888,0.1269790246847262
STAT,1887,25,45-49,1912,1.2778354058267662
STAT,1915,42,35-39,1957,0.20687549905468475
STAT,1855,27,15-19,1882,0.3665984219206431
SIM,1891,22,20-24,1913,91
STAT,1839,44,20-24,1883,0.11259543948013098
SIM,1903,29,35-39,1932,16
SIM,1863,68,na,1931,1202
STAT,1868,33,35-39,1901,9.82584169617241
STAT,1825,38,45-49,1863,2.9545469011930816
STAT,1844,48,20-24,1892,0.009182095514526522
STAT,1939,16,50-100,1955,0.3826774925932113
STAT,1888,18,15-19,1906,7.138436289688758
SIM,1876,33,35-39,1909,2
STAT,1865,23,na,1888,2200.5102065805704
SIM,1915,22,30-34,1937,40
STAT,1784,110,na,1894,2.580134683864148E-4
STAT,1926,16,50-100,1942,0.46975649395613744
STAT,1854,34,45-49,1888,1.3386630605785352
STAT,1890,54,na,1944,2611.941330373472
STAT,1791,77,na,1868,305.08842287690385
SIM,1890,31,50-100,1921,2
SIM,1804,57,na,1861,1262
STAT,1892,29,45-49,1921,1.4094451700115236
STAT,1847,85,na,1932,213.7735961851184
STAT,1877,39,20-24,1916,0.8074154913652257
STAT,1849,16,35-39,1865,0.5274742056278684
SIM,1904,31,45-49,1935,5
SIM,1939,23,30-34,1962,61
SIM,1824,31,20-24,1855,3
STAT,1853,105,na,1958,0.04530264874297182
STAT,1904,41,45-49,1945,0.15263970468376212
SIM,1844,54,na,1898,1670
STAT,1937,26,na,1963,3726.517179943728
STAT,1842,35,40-44,1877,4.111506270764742
STAT,1883,22,20-24,1905,68.97902456144332
STAT,1902,33,35-39,1935,14.507775689618322
STAT,1880,49,20-24,1929,0.012595757904993515
STAT,1875,19,40-44,1894,0.19047446784684446
SIM,1918,32,na,1950,4233
SIM,1879,67,na,1946,1888
SIM,1902,23,35-39,1925,12
SIM,1844,38,20-24,1882,2
STAT,1912,40,40-44,1952,0.24888165006865337
STAT,1931,18,40-44,1949,1.8622438884233892
STAT,1894,15,35-39,1909,0.723371476235796
STAT,1919,29,20-24,1948,19.983099963560463
SIM,1875,53,na,1928,2087
STAT,1895,21,na,1916,3157.409385127507
STAT,1899,35,na,1934,3322.4859133447535
SIM,1921,34,25-29,1955,20
STAT,1933,12,na,1945,5409.19734816148
STAT,1779,102,na,1881,0.06883864367736048
STAT,1840,95,na,1935,9.567442113565445
SIM,1874,21,50-100,1895,1
STAT,1778,95,na,1873,1.6314111872324912
SIM,1833,38,45-49,1871,5
STAT,1920,24,15-19,1944,6.001387394191353
STAT,1882,31,50-100,1913,0.9143566544519889
SIM,1865,16,na,1881,2588
SIM,1908,32,40-44,1940,1
STAT,1894,38,50-100,1932,1.6030755225550246
SIM,1856,37,25-29,1893,2
SIM,1927,29,20-24,1956,28
SIM,1910,52,na,1962,3397
STAT,1910,18,20-24,1928,27.327053330323313
STAT,1913,34,25-29,1947,9.30081843331708
STAT,1930,31,20-24,1961,3.2123770555217246
SIM,1837,36,na,1873,1631
STAT,1883,36,40-44,1919,4.402818515320126
SIM,1854,24,45-49,1878,1
SIM,1846,15,20-24,1861,18
STAT,1836,38,20-24,1874,0.5828901647294806
STAT,1812,50,50-100,1862,0.03548909878073155
STAT,1917,16,40-44,1933,0.30791434127316414
STAT,1842,54,na,1896,1642.0907247880837
STAT,1856,54,50-100,1910,0.011761748434135992
SIM,1913,36,40-44,1949,3
STAT,1848,37,25-29,1885,2.306401228006206
SIM,1835,77,na,1912,493
SIM,1910,33,35-39,1943,14
SIM,1819,41,40-44,1860,7
SIM,1906,15,na,1921,3774
STAT,1922,32,25-29,1954,10.655648037134235
SIM,1822,37,30-34,1859,9
STAT,1908,45,na,1953,3437.7872555305576
STAT,1905,28,40-44,1933,4.397962270429426
SIM,1854,91,na,1945,70
STAT,1923,41,30-34,1964,0.15267945240252573
STAT,1799,57,na,1856,1013.0667392899844
SIM,1835,24,35-39,1859,5
SIM,1948,21,30-34,1969,2
STAT,1852,80,na,1932,498.3421851935405
SIM,1885,20,30-34,1905,28
STAT,1840,44,50-100,1884,0.7729591287194628
STAT,1854,46,15-19,1900,3.070107821347388E-4
STAT,1856,19,30-34,1875,1.4915051596382205
SIM,1885,39,20-24,1924,1
SIM,1930,32,25-29,1962,19
STAT,1905,36,40-44,1941,1.398783186219875
SIM,1841,37,40-44,1878,5
SIM,1925,16,40-44,1941,5
STAT,1825,50,50-100,1875,0.01948738337323159
STAT,1869,53,na,1922,2086.623334989671
STAT,1833,37,40-44,1870,3.624828090504681
STAT,1928,42,45-49,1970,0.2164146505801724
SIM,1926,23,45-49,1949,2
STAT,1881,28,30-34,1909,24.748914770166753
SIM,1870,22,na,1892,2588
SIM,1896,18,15-19,1914,11
STAT,1881,20,50-100,1901,0.4045941867696594
SIM,1891,36,40-44,1927,10
STAT,1792,78,na,1870,273.94815211071574
STAT,1864,22,na,1886,2179.7918565614027
STAT,1846,24,45-49,1870,0.6064858469716451
SIM,1851,9,na,1860,2353
SIM,1807,48,45-49,1855,1
STAT,1891,42,25-29,1933,0.8100444829257163
STAT,1913,39,50-100,1952,0.41843736135877163
SIM,1874,39,45-49,1913,6
STAT,1907,22,30-34,1929,26.680786622437648
SIM,1840,56,na,1896,1405
STAT,1803,63,na,1866,1007.058828081025
STAT,1874,24,20-24,1898,71.32729072821076
STAT,1896,28,15-19,1924,0.6091459131166613
STAT,1816,45,40-44,1861,0.3636661662770344
STAT,1924,17,50-100,1941,0.45518797538675504
SIM,1935,12,na,1947,5538
STAT,1856,9,na,1865,2306.9477408750067
STAT,1911,39,20-24,1950,0.25709963176795547
STAT,1853,21,50-100,1874,0.40692847235531837
STAT,1921,33,45-49,1954,1.7793934292437616
STAT,1921,19,35-39,1940,4.854627816154554
STAT,1827,44,50-100,1871,1.205371714218143
STAT,1829,37,15-19,1866,0.04909943446555439
SIM,1816,42,na,1858,1642
STAT,1866,39,45-49,1905,1.8569323420906163
STAT,1850,89,na,1939,79.02176659928811
STAT,1888,26,15-19,1914,0.5490521871012329
STAT,1917,44,35-39,1961,0.21373616406528315
SIM,1905,26,40-44,1931,8
SIM,1841,26,25-29,1867,56
SIM,1878,30,40-44,1908,8
STAT,1863,1,na,1864,3240.0757250175457
STAT,1850,49,35-39,1899,0.10310991164496158
STAT,1835,41,na,1876,1901.0702860722636
STAT,1918,20,40-44,1938,3.7227303465256436
STAT,1829,48,30-34,1877,0.07733646581842847
STAT,1887,34,na,1921,2704.5168869835225
SIM,1934,22,40-44,1956,10
STAT,1868,16,45-49,1884,0.06518445499008683
STAT,1898,66,na,1964,2483.9006867923144
SIM,1811,43,na,1854,1320
SIM,1899,28,na,1927,3225
SIM,1906,33,20-24,1939,4
STAT,1896,42,50-100,1938,0.09872310060169115
STAT,1822,47,30-34,1869,0.13802281074494857
STAT,1904,16,30-34,1920,2.3360654120438733
SIM,1815,57,na,1872,1177
SIM,1961,4,na,1965,5330
STAT,1903,37,20-24,1940,0.24127978773447992
SIM,1881,22,na,1903,2149
STAT,1889,49,40-44,1938,0.11915253724787404
STAT,1932,33,20-24,1965,3.3047367713243894
SIM,1923,27,na,1950,4373
STAT,1900,39,45-49,1939,0.6022663056447508
SIM,1915,51,na,1966,4055
SIM,1885,36,na,1921,2420
STAT,1883,20,na,1903,2381.456761508844
STAT,1857,46,40-44,1903,0.13678553414713093
SIM,1852,41,na,1893,1962
STAT,1925,18,40-44,1943,1.7193358480579792
SIM,1860,49,45-49,1909,1
SIM,1918,18,15-19,1936,58
STAT,1952,20,40-44,1972,4.126796735111244
SIM,1801,65,na,1866,975
STAT,1839,55,na,1894,1427.021841206346
STAT,1935,35,15-19,1970,0.027431526022930832
STAT,1885,49,20-24,1934,0.011958340650494288
SIM,1770,87,na,1857,26
SIM,1848,49,45-49,1897,1
STAT,1772,107,na,1879,0.004388933004241584
SIM,1960,11,na,1971,5241
STAT,1880,44,15-19,1924,0.01460471270099772
SIM,1866,92,na,1958,57
STAT,1896,39,30-34,1935,7.108553187636681
STAT,1926,22,40-44,1948,4.167204208801613
SIM,1912,16,30-34,1928,3
STAT,1833,26,25-29,1859,37.69082259540032
STAT,1851,28,45-49,1879,1.0648306325619346
STAT,1869,45,45-49,1914,0.23475570092188563
SIM,1933,29,20-24,1962,3
STAT,1893,19,na,1912,3250.9759241322467
STAT,1906,41,50-100,1947,0.10942441952989786
SIM,1869,35,45-49,1904,1
STAT,1852,49,45-49,1901,0.18615238465992182
STAT,1945,19,20-24,1964,150.99917302693157
SIM,1892,49,na,1941,3214
SIM,1796,80,na,1876,198
SIM,1839,42,20-24,1881,1
SIM,1806,96,na,1902,4
SIM,1924,15,35-39,1939,7
STAT,1871,48,50-100,1919,0.2450663975996254
STAT,1837,104,na,1941,0.044470688408758924
STAT,1849,33,na,1882,1932.0514494331942
SIM,1895,14,na,1909,3587
STAT,1840,16,15-19,1856,5.561881938681113
STAT,1853,22,35-39,1875,5.781335571302967
SIM,1925,44,35-39,1969,1
SIM,1848,27,25-29,1875,47
SIM,1917,34,35-39,1951,18
STAT,1904,30,40-44,1934,6.391531369010579
STAT,1898,33,20-24,1931,3.7132748126165325
STAT,1913,38,40-44,1951,1.4996267217201262
STAT,1823,46,50-100,1869,0.3744906885496476
STAT,1857,68,na,1925,1217.5438553916606
SIM,1876,25,35-39,1901,16
STAT,1891,28,50-100,1919,0.8050862538954494
SIM,1841,48,45-49,1889,1
SIM,1861,22,35-39,1883,8
STAT,1868,30,30-34,1898,17.148924883366146
STAT,1924,31,20-24,1955,2.905030500861187
STAT,1928,20,50-100,1948,0.8429861731867975
STAT,1853,54,na,1907,1755.7801945127446
SIM,1947,13,na,1960,4672
SIM,1921,38,40-44,1959,2
SIM,1913,28,40-44,1941,10
STAT,1850,41,25-29,1891,0.4852192356058096
STAT,1852,37,na,1889,1908.277599048551
STAT,1817,49,50-100,1866,0.5319642187983208
STAT,1916,15,35-39,1931,0.9127293704597811
STAT,1873,42,na,1915,2387.455785890167
STAT,1946,23,20-24,1969,126.20462154212004
STAT,1828,44,45-49,1872,1.1848236839535558
SIM,1902,17,na,1919,3679
STAT,1904,41,20-24,1945,0.016197062351048026
SIM,1930,26,15-19,1956,2
STAT,1925,29,20-24,1954,21.8393097328695
STAT,1833,48,45-49,1881,0.16428320661605367
STAT,1902,43,50-100,1945,0.10477976630008055
STAT,1879,15,na,1894,2705.70569484619
STAT,1806,53,50-100,1859,0.04806612271515687
STAT,1914,38,35-39,1952,2.451752412105372
STAT,1906,43,20-24,1949,0.01625703665832183
SIM,1874,25,25-29,1899,60
STAT,1878,40,40-44,1918,2.4125188163752966
SIM,1925,45,na,1970,4710
STAT,1911,47,20-24,1958,0.0106717227819903
STAT,1880,32,50-100,1912,0.9822423653155233
STAT,1889,30,15-19,1919,0.1808966007385225
SIM,1807,81,na,1888,60
SIM,1835,32,35-39,1867,3
STAT,1921,35,50-100,1956,0.4792115225794089
STAT,1902,36,15-19,1938,0.017520983454847466
SIM,1933,18,40-44,1951,6
SIM,1849,85,na,1934,258
STAT,1929,35,15-19,1964,0.025189081653805012
SIM,1845,71,na,1916,1094
STAT,1832,53,25-29,1885,0.0024253967423122007
SIM,1846,56,na,1902,1637
SIM,1912,30,40-44,1942,2
SIM,1931,14,na,1945,5132
SIM,1860,76,na,1936,970
STAT,1841,69,na,1910,1083.5645721776687
STAT,1820,75,na,1895,566.980888970734
SIM,1935,28,na,1963,5113
STAT,1893,27,50-100,1920,0.8278556426236183
STAT,1933,28,40-44,1961,6.308545890700271
SIM,1887,16,20-24,1903,18
SIM,1836,44,45-49,1880,5
SIM,1895,25,45-49,1920,3
STAT,1849,92,na,1941,32.33496135620093
STAT,1909,45,15-19,1954,3.485371044600666E-4
STAT,1840,27,30-34,1867,22.59404636532813
STAT,1869,69,na,1938,1445.3958548787045
STAT,1935,32,35-39,1967,12.893215358801061
STAT,1821,92,na,1913,21.946710907400686
STAT,1914,16,15-19,1930,9.60187474327116
SIM,1889,20,15-19,1909,10
STAT,1931,26,40-44,1957,6.139873451862727
STAT,1922,26,15-19,1948,0.817889011897352
SIM,1923,42,35-39,1965,1
STAT,1894,23,35-39,1917,7.633761774730382
STAT,1889,38,25-29,1927,3.6102060989486984
STAT,1871,35,na,1906,2403.3834472244084
STAT,1860,51,35-39,1911,0.00715993546210385
SIM,1840,40,na,1880,1684
STAT,1872,22,45-49,1894,0.7129622528002934
STAT,1950,21,20-24,1971,134.6202508314931
SIM,1860,41,35-39,1901,1
STAT,1864,17,50-100,1881,0.04597184956165995
STAT,1827,32,35-39,1859,15.639339635946662
STAT,1875,49,na,1924,2306.4239802509906
STAT,1895,35,45-49,1930,2.6785518378214808
SIM,1889,28,25-29,1917,73
SIM,1922,16,15-19,1938,50
STAT,1796,76,na,1872,375.24508223986004
SIM,1931,16,40-44,1947,6
STAT,1866,25,25-29,1891,40.07442170176295
SIM,1922,38,35-39,1960,3
STAT,1923,16,40-44,1939,1.6798916671908268
SIM,1828,34,45-49,1862,2
SIM,1928,25,20-24,1953,3
STAT,1848,48,40-44,1896,0.13140728107340674
STAT,1792,62,na,1854,788.0000000000002
STAT,1842,21,20-24,1863,68.65519109026175
STAT,1923,34,na,1957,4418.087753372316
SIM,1850,21,20-24,1871,70
SIM,1894,56,na,1950,2697
STAT,1831,49,25-29,1880,0.045911240276941205
SIM,1886,40,40-44,1926,1
SIM,1897,21,na,1918,3220
SIM,1890,42,na,1932,3032
STAT,1867,32,50-100,1899,0.8775174196569452
STAT,1943,27,na,1970,4070.4840009960453
STAT,1804,104,na,1908,0.022505916312635803
STAT,1814,49,25-29,1863,0.16627757346412075
SIM,1884,34,50-100,1918,4
STAT,1891,39,na,1930,2945.646274344787
STAT,1902,29,na,1931,3408.822049510846
SIM,1824,34,25-29,1858,10
SIM,1805,74,na,1879,374
SIM,1922,18,40-44,1940,3
SIM,1925,19,20-24,1944,174
SIM,1809,88,na,1897,18
STAT,1870,38,20-24,1908,0.7649258961672833
STAT,1875,29,45-49,1904,1.154190599721331
SIM,1934,30,40-44,1964,7
SIM,1895,22,40-44,1917,4
STAT,1890,18,30-34,1908,1.9828833072827303
SIM,1818,38,na,1856,1525
SIM,1847,15,15-19,1862,9
STAT,1914,15,25-29,1929,9.188579629065067
STAT,1883,25,25-29,1908,42.62952401229158
STAT,1944,22,35-39,1966,10.372414162254735
SIM,1828,31,40-44,1859,3
STAT,1783,85,na,1868,89.64900543157799
STAT,1913,31,20-24,1944,2.4858315975236276
STAT,1839,47,25-29,1886,0.040502495784833725
STAT,1847,69,na,1916,1144.4094305608342
STAT,1880,87,na,1967,429.5153492825953
STAT,1917,19,20-24,1936,147.60020389853412
STAT,1931,22,25-29,1953,122.1801546676595
SIM,1816,38,45-49,1854,6
SIM,1918,26,15-19,1944,1
STAT,1872,57,na,1929,2054.706323024183
STAT,1869,50,40-44,1919,0.010517774352777173
STAT,1926,31,30-34,1957,19.44600826001503
STAT,1937,32,45-49,1969,1.5879945077721405
SIM,1884,35,35-39,1919,8
SIM,1883,29,45-49,1912,4
STAT,1863,48,30-34,1911,0.08549500934837556
SIM,1882,27,25-29,1909,45
SIM,1846,22,45-49,1868,4
SIM,1937,30,na,1967,4463
STAT,1867,52,35-39,1919,0.008201275705724263
SIM,1891,28,40-44,1919,6
STAT,1921,41,45-49,1962,0.1915603756288543
STAT,1838,92,na,1930,30.601996483909563
SIM,1831,24,15-19,1855,3
SIM,1932,32,35-39,1964,26
STAT,1878,46,na,1924,2395.8015581023565
SIM,1817,44,35-39,1861,3
STAT,1768,109,na,1877,0.004254241922162105
STAT,1902,31,45-49,1933,2.5189942588830183
SIM,1904,51,na,1955,3272
STAT,1865,44,25-29,1909,0.5865493681738594
STAT,1882,41,20-24,1923,0.15855478345977866
SIM,1891,25,25-29,1916,10
STAT,1920,29,20-24,1949,20.288491803601367
SIM,1940,1,na,1941,4267
STAT,1839,15,15-19,1854,5.421446541205019
STAT,1866,16,35-39,1882,0.5330994142810794
STAT,1874,42,25-29,1916,0.6680228108762112
STAT,1781,99,na,1880,0.3343454290505449
STAT,1838,22,45-49,1860,0.6647326512398517
STAT,1876,35,35-39,1911,7.52158467932393
SIM,1853,10,na,1863,2408
STAT,1838,17,na,1855,2227.7847145043015
STAT,1919,27,30-34,1946,43.20308296042694
SIM,1930,36,40-44,1966,6
STAT,1808,47,50-100,1855,0.6512296433557784
STAT,1913,36,15-19,1949,0.01942613973729183
SIM,1831,27,30-34,1858,4
SIM,1873,28,50-100,1901,1
STAT,1919,41,40-44,1960,0.27700283721979796
SIM,1918,29,30-34,1947,7
STAT,1807,51,25-29,1858,0.0149351245919224
SIM,1857,24,na,1881,2063
SIM,1927,27,30-34,1954,64
STAT,1907,38,40-44,1945,1.408252041341863
STAT,1883,28,40-44,1911,2.9879013633494353
SIM,1873,44,25-29,1917,3
SIM,1885,68,na,1953,1634
SIM,1863,15,20-24,1878,19
SIM,1832,33,20-24,1865,2
SIM,1838,17,15-19,1855,4
SIM,1915,38,40-44,1953,2
SIM,1898,5,na,1903,4038
STAT,1822,48,20-24,1870,0.01686125997403296
STAT,1846,37,15-19,1883,0.04193555314035128
STAT,1846,109,na,1955,5.087803621354723E-4
STAT,1906,41,30-34,1947,0.11907951563207929
SIM,1904,24,20-24,1928,104
STAT,1891,24,20-24,1915,86.4914751348699
STAT,1851,17,50-100,1868,0.0491422893869801
STAT,1924,32,35-39,1956,10.877444834475515
STAT,1822,93,na,1915,16.992929979972487
STAT,1929,27,15-19,1956,0.9011381590809943
SIM,1876,16,na,1892,2969
SIM,1827,74,na,1901,601
SIM,1934,31,30-34,1965,40
STAT,1819,38,20-24,1857,1.983558295503306
STAT,1918,48,20-24,1966,0.011967571958244706
STAT,1901,50,na,1951,3115.890679219203
STAT,1836,105,na,1941,0.01825019961603028
STAT,1930,20,40-44,1950,4.419391816849891
SIM,1874,17,25-29,1891,10
STAT,1866,17,25-29,1883,5.473093310223198
SIM,1857,6,na,1863,2508
STAT,1879,23,45-49,1902,0.7412946463253705
SIM,1887,23,45-49,1910,1
STAT,1914,14,na,1928,4154.669355907964
STAT,1833,41,25-29,1874,0.5215376519178646
SIM,1848,26,35-39,1874,14
STAT,1886,29,20-24,1915,12.577224194503478
STAT,1937,28,25-29,1965,65.41441282828394
STAT,1830,26,na,1856,1793.1305785852455
SIM,1848,48,50-100,1896,1
STAT,1872,6,na,1878,2812.2060581547867
STAT,1874,27,25-29,1901,44.05954632121278
STAT,1879,36,15-19,1915,0.06016890686316945
STAT,1905,64,na,1969,2875.77233210602
STAT,1918,28,na,1946,4054.049560112458
STAT,1824,33,20-24,1857,4.784283762671478
SIM,1872,28,30-34,1900,27
STAT,1896,20,40-44,1916,2.824378922617208
STAT,1768,96,na,1864,2.03214874437095
STAT,1874,49,45-49,1923,0.240676301432337
SIM,1830,41,na,1871,1759
SIM,1865,35,25-29,1900,2
STAT,1879,90,na,1969,259.8669826245967
STAT,1890,15,15-19,1905,7.436776485410484
SIM,1906,26,50-100,1932,2
STAT,1797,98,na,1895,0.8180329657540981
SIM,1835,21,30-34,1856,29
SIM,1914,41,30-34,1955,1
STAT,1851,74,na,1925,915.5948621413124
STAT,1856,51,20-24,1907,5.937557949702858E-4
SIM,1780,86,na,1866,91
STAT,1940,28,35-39,1968,15.61102733796355
STAT,1793,84,na,1877,118.86642929309093
STAT,1910,40,30-34,1950,0.12462773118963164
SIM,1841,49,35-39,1890,1
STAT,1855,88,na,1943,106.42200278817683
STAT,1829,40,na,1869,1780.1039426539874
SIM,1856,55,na,1911,2003
SIM,1869,32,40-44,1901,6
STAT,1848,91,na,1939,45.04475676743028
STAT,1907,25,35-39,1932,14.551058013917798
STAT,1951,19,50-100,1970,0.45482716707292925
SIM,1894,29,20-24,1923,19
SIM,1913,28,na,1941,3875
STAT,1855,15,20-24,1870,16.54035024227854
STAT,1913,23,45-49,1936,1.1555274949292298
SIM,1834,55,na,1889,1382
SIM,1902,20,30-34,1922,37
STAT,1905,32,25-29,1937,8.66518689864349
SIM,1827,38,20-24,1865,2
SIM,1841,41,25-29,1882,2
SIM,1859,30,30-34,1889,6
STAT,1811,48,45-49,1859,0.6441983531041563
SIM,1830,47,30-34,1877,1
STAT,1899,40,25-29,1939,0.06292322875879387
SIM,1915,25,35-39,1940,24
STAT,1851,95,na,1946,10.969050219687553
STAT,1855,38,30-34,1893,4.1109873812259545
STAT,1914,18,40-44,1932,0.29443164265927013
SIM,1913,32,25-29,1945,14
SIM,1835,93,na,1928,22
STAT,1926,30,40-44,1956,4.832737607950622
SIM,1921,23,45-49,1944,3
STAT,1891,46,40-44,1937,0.12231533908229897
STAT,1905,21,45-49,1926,1.030496742231875
SIM,1855,16,25-29,1871,13
SIM,1777,82,na,1859,93
STAT,1826,51,35-39,1877,0.006625648398213841
SIM,1903,18,30-34,1921,5
STAT,1872,36,na,1908,2420.4147029637497
STAT,1862,28,20-24,1890,10.151732356888306
STAT,1938,27,40-44,1965,4.710501120996122
SIM,1934,25,45-49,1959,4
SIM,1843,34,35-39,1877,16
STAT,1950,22,35-39,1972,11.395822539144426
SIM,1870,28,20-24,1898,14
STAT,1955,17,15-19,1972,61.448216742655156
SIM,1853,28,20-24,1881,13
STAT,1845,28,20-24,1873,11.076955786059154
STAT,1817,55,na,1872,1234.8255789423263
SIM,1937,26,25-29,1963,94
STAT,1805,59,na,1864,1212.6525041166021
STAT,1926,25,45-49,1951,2.1270836975614116
STAT,1946,26,25-29,1972,74.83932863234661
STAT,1813,41,na,1854,1400.8809854975073
STAT,1836,51,40-44,1887,0.00676330574727207
STAT,1841,40,20-24,1881,0.1250103468124224
STAT,1835,34,35-39,1869,9.412695098993277
SIM,1845,43,50-100,1888,3
SIM,1909,20,40-44,1929,7
STAT,1930,31,na,1961,4980.9647505429175
STAT,1922,49,na,1971,4281.173237167624
STAT,1892,40,15-19,1932,0.01783488448654069
STAT,1811,53,40-44,1864,0.027306448566550498
SIM,1815,89,na,1904,26
STAT,1850,23,20-24,1873,61.76994485037879
STAT,1928,42,20-24,1970,0.02296441542775219
STAT,1866,22,20-24,1888,65.37406492307181
SIM,1851,40,na,1891,1836
STAT,1937,3,na,1940,4024.8972108559565
STAT,1842,24,25-29,1866,55.81220296530413
STAT,1900,40,25-29,1940,0.06368805493958622
SIM,1913,21,45-49,1934,2
SIM,1919,19,20-24,1938,144
STAT,1846,21,40-44,1867,1.851969770288354
SIM,1854,21,40-44,1875,3
SIM,1895,7,na,1902,3621
SIM,1916,39,50-100,1955,1
STAT,1929,26,25-29,1955,84.05636434026458
SIM,1874,22,20-24,1896,92
SIM,1794,78,na,1872,277
SIM,1820,63,na,1883,1135
STAT,1823,56,na,1879,1239.8050058189579
STAT,1841,48,30-34,1889,0.0708825813732067
STAT,1936,16,15-19,1952,44.425101121948224
SIM,1848,23,30-34,1871,1
STAT,1861,4,na,1865,2582.503507932703
SIM,1890,49,30-34,1939,1
SIM,1906,47,na,1953,3308
STAT,1862,23,50-100,1885,0.359911174939616
STAT,1841,96,na,1937,6.33998148325674
STAT,1911,20,30-34,1931,27.97010469844168
STAT,1865,28,50-100,1893,0.5902081214129813
SIM,1944,16,15-19,1960,50
STAT,1871,94,na,1965,64.15211716529947
STAT,1777,78,na,1855,347.45574
STAT,1815,50,20-24,1865,0.0019740929551098968
STAT,1858,54,35-39,1912,0.006773267646892255
SIM,1790,64,na,1854,661
SIM,1855,17,15-19,1872,7
SIM,1953,17,30-34,1970,18
SIM,1862,41,50-100,1903,3
SIM,1907,23,35-39,1930,9
SIM,1899,46,35-39,1945,1
STAT,1850,45,40-44,1895,0.13006132301561407
STAT,1906,46,25-29,1952,0.04838138980245119
STAT,1949,11,na,1960,4661.705145002564
SIM,1938,19,30-34,1957,18
SIM,1865,38,40-44,1903,7
STAT,1955,12,na,1967,5318.6438606985585
SIM,1917,31,30-34,1948,3
SIM,1824,37,40-44,1861,2
STAT,1901,27,45-49,1928,1.5839353085220795
STAT,1866,21,50-100,1887,0.3896494008570117
SIM,1836,62,na,1898,1436
STAT,1847,17,15-19,1864,5.776000037990613
STAT,1945,17,30-34,1962,13.584560082705906
SIM,1834,37,50-100,1871,1
STAT,1922,39,45-49,1961,0.7898155733795428
SIM,1855,92,na,1947,17
SIM,1850,24,25-29,1874,58
SIM,1910,31,45-49,1941,1
STAT,1929,29,40-44,1958,5.943861759739752
STAT,1882,49,30-34,1931,0.09419854238911389
STAT,1819,53,50-100,1872,0.028207429146449813
STAT,1837,31,40-44,1868,3.6631238309227907
STAT,1832,92,na,1924,27.831302380909392
STAT,1833,77,na,1910,567.6426084577934
SIM,1930,39,45-49,1969,1
STAT,1950,22,50-100,1972,0.7963538695282554
SIM,1889,24,30-34,1913,32
STAT,1906,19,45-49,1925,0.09647368526520625
STAT,1848,52,25-29,1900,0.002738666545350093
STAT,1861,24,35-39,1885,4.98129864725469
SIM,1955,8,na,1963,5092
SIM,1911,21,na,1932,3742
STAT,1884,21,na,1905,2394.209007287283
STAT,1863,49,20-24,1912,0.010509315434768988
STAT,1949,19,40-44,1968,1.6585559100857763
STAT,1888,35,na,1923,2868.340763397187
STAT,1905,34,15-19,1939,0.11944464010837903
STAT,1808,78,na,1886,286.6575798878651
SIM,1950,12,na,1962,4737
SIM,1917,7,na,1924,4277
STAT,1893,42,35-39,1935,2.340573069277715
SIM,1865,42,25-29,1907,1
SIM,1937,29,40-44,1966,9
STAT,1955,16,25-29,1971,58.691533239794644
SIM,1888,17,na,1905,2983
SIM,1876,91,na,1967,226
STAT,1878,8,na,1886,2820.8504937048897
SIM,1858,34,50-100,1892,1
STAT,1872,27,15-19,1899,0.4638789298311447
STAT,1932,34,35-39,1966,12.372969852154087
SIM,1857,40,na,1897,1987
STAT,1857,84,na,1941,265.0390497954545
STAT,1892,72,na,1964,1880.4625122552004
STAT,1804,64,na,1868,859.8504335183607
STAT,1902,41,35-39,1943,0.18172336612980208
STAT,1922,21,45-49,1943,1.320559473466168
SIM,1868,40,na,1908,2333
STAT,1847,16,25-29,1863,5.548010783307988
STAT,1887,22,40-44,1909,2.3820714567171635
STAT,1883,16,35-39,1899,0.5505878273413602
STAT,1882,48,40-44,1930,0.16801375043917657
STAT,1822,43,15-19,1865,0.02087467511505556
SIM,1875,0,na,1875,3564
STAT,1903,21,35-39,1924,8.487955689569043
STAT,1864,28,30-34,1892,22.761651801780364
SIM,1930,17,25-29,1947,66
SIM,1890,44,25-29,1934,1
STAT,1922,28,na,1950,4310.072390873932
SIM,1928,9,na,1937,5246
STAT,1911,38,30-34,1949,1.786728951699714
STAT,1820,47,20-24,1867,0.02188757345898359
SIM,1888,4,na,1892,3115
STAT,1919,44,45-49,1963,0.18343645761496186
SIM,1845,31,40-44,1876,10
STAT,1894,20,na,1914,3121.97685818352
STAT,1838,50,50-100,1888,0.011483677633913789
STAT,1869,32,na,1901,2350.2978754503342
SIM,1914,44,35-39,1958,2
STAT,1927,26,15-19,1953,0.8784703441925148
STAT,1898,34,na,1932,3263.856050828528
STAT,1920,15,50-100,1935,0.08646120709465228
SIM,1934,27,na,1961,5272
STAT,1857,102,na,1959,0.4694960730333287
STAT,1844,21,30-34,1865,17.35850547437203
SIM,1864,69,na,1933,1362
SIM,1913,37,30-34,1950,8
SIM,1900,34,50-100,1934,5
STAT,1900,47,45-49,1947,0.18735261708368753
SIM,1841,41,na,1882,1797
SIM,1849,21,na,1870,1923
STAT,1780,113,na,1893,1.0908395880855645E-4
STAT,1861,39,45-49,1900,1.6635330406244606
STAT,1849,39,45-49,1888,1.551120355874179
STAT,1909,46,50-100,1955,0.21249110805776586
STAT,1821,40,40-44,1861,4.16305256267511
SIM,1853,1,na,1854,3124
STAT,1884,25,50-100,1909,0.6500105744584005
STAT,1906,44,35-39,1950,0.18419404603319986
STAT,1922,17,25-29,1939,51.17343057332854
STAT,1898,39,40-44,1937,1.2903451475834988
SIM,1932,3,na,1935,5636
STAT,1864,25,15-19,1889,0.41594434508807476
STAT,1947,19,30-34,1966,13.999209978314674
STAT,1917,40,40-44,1957,0.2671149395009442
STAT,1854,39,na,1893,1785.01002150919
SIM,1862,41,45-49,1903,2
SIM,1949,17,40-44,1966,1
STAT,1865,37,25-29,1902,2.66585681379862
SIM,1878,26,20-24,1904,10
SIM,1911,21,35-39,1932,14
STAT,1814,63,na,1877,1012.1521075893372
STAT,1906,16,40-44,1922,0.27224983956668375
STAT,1779,96,na,1875,1.2480671358857678
SIM,1930,13,na,1943,5732
STAT,1802,78,na,1880,286.119627542531
STAT,1900,25,25-29,1925,60.217867823634805
SIM,1917,46,50-100,1963,2
SIM,1939,20,15-19,1959,6
SIM,1860,44,na,1904,2006
SIM,1882,24,20-24,1906,67
STAT,1859,91,na,1950,47.210953404331455
SIM,1876,54,na,1930,2385
STAT,1937,22,50-100,1959,0.6535896890183397
STAT,1909,46,na,1955,3451.4508709672714
STAT,1950,20,30-34,1970,34.80874714874683
STAT,1886,49,na,1935,2378.681164500855
STAT,1882,35,na,1917,2363.7891075044686
STAT,1847,41,15-19,1888,0.010968778966564618
STAT,1811,93,na,1904,12.659225100046688
SIM,1871,87,na,1958,337
STAT,1923,28,35-39,1951,17.525315830521198
STAT,1952,15,45-49,1967,0.6109956010553084
SIM,1931,28,35-39,1959,24
SIM,1839,48,40-44,1887,2
SIM,1887,20,40-44,1907,3
STAT,1857,35,25-29,1892,2.315696332421496
STAT,1937,25,20-24,1962,18.165889327019627
SIM,1917,10,na,1927,4256
STAT,1927,29,30-34,1956,48.395345213436926
STAT,1885,16,45-49,1901,0.06664714583599672
STAT,1888,17,25-29,1905,6.834188985199191
SIM,1872,25,15-19,1897,1
STAT,1838,38,30-34,1876,4.676344797282454
STAT,1852,41,35-39,1893,1.4653952481572217
STAT,1912,50,na,1962,3569.2723537862735
SIM,1946,12,na,1958,4329
STAT,1852,54,40-44,1906,0.008247867257425556
SIM,1898,16,20-24,1914,35
STAT,1797,77,na,1874,353.67275062597827
STAT,1913,20,40-44,1933,3.3436687399842215
STAT,1916,38,45-49,1954,0.7088836602141216
SIM,1877,31,50-100,1908,5
STAT,1831,29,30-34,1860,23.67415277658649
STAT,1792,99,na,1891,0.31414506120034175
STAT,1865,34,20-24,1899,2.48134202439678
STAT,1793,63,na,1856,928.1395600000001
STAT,1856,54,25-29,1910,0.0027584556393603506
SIM,1797,59,na,1856,965
STAT,1830,96,na,1926,5.431852102443048
STAT,1877,72,na,1949,1336.2513730757028
STAT,1891,27,25-29,1918,53.42660735027219
STAT,1908,29,20-24,1937,17.4704411193533
STAT,1843,92,na,1935,33.62244771309734
STAT,1861,48,20-24,1909,0.009988516169627721
STAT,1865,41,20-24,1906,0.14771078135311455
SIM,1904,27,25-29,1931,2
STAT,1875,54,35-39,1929,0.008765903785039521
STAT,1869,31,50-100,1900,0.9061058214638118
SIM,1871,21,40-44,1892,2
STAT,1855,15,50-100,1870,0.045708401575058434
STAT,1820,49,25-29,1869,0.10203177909777605
SIM,1829,26,25-29,1855,53
STAT,1860,18,45-49,1878,0.06199086949866048
SIM,1850,18,na,1868,2151
STAT,1896,23,45-49,1919,0.9366354503140566
SIM,1859,33,35-39,1892,12
STAT,1891,49,45-49,1940,0.1646243719848517
SIM,1916,29,20-24,1945,23
SIM,1852,21,30-34,1873,38
STAT,1827,92,na,1919,26.918821260742565
STAT,1941,23,20-24,1964,117.19437531645721
SIM,1849,16,25-29,1865,6
STAT,1829,32,45-49,1861,1.6269277995335258
STAT,1953,16,15-19,1969,56.01712502417048
SIM,1892,25,50-100,1917,1
SIM,1935,29,30-34,1964,6
SIM,1879,25,50-100,1904,2
STAT,1880,48,30-34,1928,0.10246856196499418
STAT,1842,27,40-44,1869,2.9050567048954727
STAT,1863,21,40-44,1884,1.9147592217616087
STAT,1898,36,25-29,1934,3.9911209119616493
SIM,1883,72,na,1955,1391
SIM,1893,25,35-39,1918,16
STAT,1867,31,15-19,1898,0.1369457139707094
STAT,1910,29,50-100,1939,0.9732950511499613
STAT,1877,52,40-44,1929,0.011079858710540917
SIM,1857,39,45-49,1896,3
STAT,1931,24,15-19,1955,6.997076866725284
STAT,1941,31,na,1972,4053.4531134320123
SIM,1915,31,20-24,1946,3
SIM,1830,78,na,1908,511
STAT,1931,28,30-34,1959,51.56622442236755
STAT,1897,49,na,1946,3005.348242070093
SIM,1837,32,45-49,1869,3
STAT,1905,37,30-34,1942,1.6948509289344702
SIM,1832,36,25-29,1868,6
STAT,1849,17,25-29,1866,5.415341808301146
SIM,1934,34,35-39,1968,21
STAT,1813,78,na,1891,335.99443204443514
SIM,1857,17,25-29,1874,10
STAT,1824,36,25-29,1860,4.134025349217285
STAT,1926,34,35-39,1960,11.25808470499943
SIM,1904,49,45-49,1953,1
STAT,1789,95,na,1884,2.1066998035013005
STAT,1893,35,na,1928,3077.9360498802107
STAT,1868,68,na,1936,1489.025793831231
SIM,1859,24,45-49,1883,1
SIM,1937,23,20-24,1960,135
STAT,1885,25,35-39,1910,9.887100083482569
STAT,1911,34,15-19,1945,0.12654742009899272
STAT,1932,31,30-34,1963,21.37174130863119
STAT,1862,41,40-44,1903,1.9621093019675355
STAT,1934,26,50-100,1960,1.3661168898973282
SIM,1850,27,40-44,1877,4
SIM,1867,32,30-34,1899,22
SIM,1923,33,20-24,1956,3
STAT,1926,39,50-100,1965,0.5223466429062861
SIM,1949,20,50-100,1969,1
STAT,1930,38,40-44,1968,1.9894925459772412
STAT,1917,42,45-49,1959,0.17724297419581744
SIM,1932,30,30-34,1962,9
STAT,1899,15,35-39,1914,0.7700914566830823
STAT,1953,19,30-34,1972,15.030487445136991
STAT,1932,36,25-29,1968,1.350371317957979
STAT,1879,39,50-100,1918,1.2960330237579245
STAT,1932,27,na,1959,5003.934201143329
SIM,1904,32,50-100,1936,1
SIM,1869,20,35-39,1889,7
STAT,1942,28,45-49,1970,1.8490410115619196
SIM,1858,41,40-44,1899,7
SIM,1886,35,45-49,1921,4
STAT,1769,108,na,1877,0.0024418011873027557
STAT,1861,73,na,1934,1001.2377691329864
STAT,1907,31,20-24,1938,2.3343658598116677
STAT,1863,30,50-100,1893,0.8261249713725881
STAT,1865,87,na,1952,163.12628619321194
STAT,1833,49,35-39,1882,0.09621466436859397
SIM,1826,34,35-39,1860,18
SIM,1892,41,30-34,1933,2
STAT,1890,41,50-100,1931,1.3237138930965846
STAT,1862,58,na,1920,1717.3457168522943
SIM,1941,21,20-24,1962,122
SIM,1963,1,na,1964,5159
STAT,1888,42,15-19,1930,0.01663442853329392
SIM,1816,74,na,1890,582
SIM,1929,27,40-44,1956,15
STAT,1850,26,25-29,1876,37.715794637611474
SIM,1833,21,20-24,1854,62
STAT,1901,9,na,1910,3701.4495316648276
STAT,1918,32,35-39,1950,9.909633680742902
SIM,1903,15,15-19,1918,10
SIM,1940,31,30-34,1971,22
STAT,1887,38,15-19,1925,0.06387376135625504
SIM,1898,18,25-29,1916,12
SIM,1921,20,40-44,1941,6
STAT,1930,23,45-49,1953,1.465582047558166
STAT,1781,78,na,1859,277.6613925553345
STAT,1931,27,30-34,1958,51.59098809665395
SIM,1943,23,50-100,1966,1
SIM,1819,44,45-49,1863,7
STAT,1851,36,na,1887,1985.0426075342466
STAT,1801,106,na,1907,0.004332132906597461
STAT,1844,18,na,1862,2247.7966001543155
STAT,1863,44,15-19,1907,0.01218549401843565
SIM,1945,25,20-24,1970,25
STAT,1874,46,40-44,1920,0.1788216596597176
SIM,1846,38,30-34,1884,9
STAT,1844,15,45-49,1859,0.06511036534579134
STAT,1869,52,45-49,1921,0.01421730785493203
STAT,1922,36,40-44,1958,1.7396413107417663
SIM,1846,40,na,1886,1926
STAT,1859,32,30-34,1891,14.224693015224934
SIM,1824,93,na,1917,8
STAT,1842,59,na,1901,1524.0735372890624
STAT,1829,25,20-24,1854,36.717321495907825
SIM,1926,32,35-39,1958,21
SIM,1849,15,25-29,1864,5
SIM,1865,91,na,1956,10
SIM,1905,16,15-19,1921,9
STAT,1877,23,35-39,1900,6.15536053574769
STAT,1885,86,na,1971,533.8610540374589
STAT,1841,43,25-29,1884,0.4864171604895712
STAT,1851,50,50-100,1901,0.012639086715811265
STAT,1896,16,20-24,1912,23.945263795365218
STAT,1915,33,20-24,1948,2.5242852316988933
STAT,1834,53,35-39,1887,0.00582391752069832
STAT,1840,74,na,1914,798.6015805901252
SIM,1925,42,45-49,1967,1
SIM,1866,17,na,1883,2593
STAT,1881,72,na,1953,1245.5647074048209
STAT,1844,88,na,1932,106.38261717716459
STAT,1840,39,25-29,1879,2.400142643136231
STAT,1871,20,25-29,1891,58.19325524596354
SIM,1887,39,50-100,1926,3
STAT,1859,26,45-49,1885,0.9268492991622902
STAT,1897,71,na,1968,2169.2689239296965
SIM,1913,38,30-34,1951,4
SIM,1885,23,35-39,1908,6
SIM,1846,18,na,1864,2306
SIM,1910,4,na,1914,4043
STAT,1880,31,45-49,1911,1.8770686990034515
STAT,1895,40,40-44,1935,3.024019395369169
STAT,1850,48,45-49,1898,0.17528979085533905
STAT,1849,15,20-24,1864,17.143415391342273
SIM,1925,13,na,1938,5019
SIM,1842,28,45-49,1870,3
STAT,1859,54,na,1913,1705.9781002656491
STAT,1952,16,50-100,1968,0.45813213911628337
STAT,1815,53,25-29,1868,0.008922599981573905
STAT,1863,21,na,1884,2173.1833293821414
STAT,1877,20,30-34,1897,18.959378265345297
STAT,1855,22,45-49,1877,0.6315111136312753
STAT,1878,35,45-49,1913,2.136909809267966
STAT,1911,23,35-39,1934,9.080787156201787
STAT,1842,22,na,1864,2114.850081749159
SIM,1889,27,35-39,1916,16
STAT,1933,21,20-24,1954,150.871613842417
STAT,1905,48,50-100,1953,0.20155074798542638
STAT,1868,15,30-34,1883,1.5999245809048028
STAT,1904,48,40-44,1952,0.13941914503193029
STAT,1924,38,40-44,1962,1.7991463727352535
STAT,1845,110,na,1955,2.159159195062206E-4
SIM,1922,15,25-29,1937,54
STAT,1857,38,40-44,1895,3.4703404979919297
STAT,1924,30,30-34,1954,18.8381479041068
SIM,1897,53,na,1950,2848
SIM,1941,15,35-39,1956,7
SIM,1932,38,40-44,1970,3
SIM,1905,38,35-39,1943,3
SIM,1927,44,45-49,1971,1
STAT,1832,30,15-19,1862,0.12768439579078328
STAT,1834,52,50-100,1886,0.01042117450883499
STAT,1836,22,35-39,1858,4.793958365637332
STAT,1905,38,30-34,1943,1.6864444683269555
STAT,1858,51,30-34,1909,0.004838699289556999
STAT,1831,26,15-19,1857,0.46508818104741617
SIM,1889,33,20-24,1922,2
STAT,1842,81,na,1923,424.0700158113223
STAT,1909,22,40-44,1931,3.1871004610427827
SIM,1844,22,35-39,1866,9
STAT,1882,44,25-29,1926,0.6296101557878281
SIM,1870,41,40-44,1911,3
STAT,1935,23,50-100,1958,0.913466556311003
STAT,1854,18,50-100,1872,0.04459016172328419
SIM,1907,32,na,1939,3664
STAT,1860,52,25-29,1912,0.002916167220958956
STAT,1879,16,45-49,1895,0.06982805859276857
STAT,1944,12,na,1956,4312.928861772168
STAT,1787,99,na,1886,0.43329333080834304
STAT,1879,39,30-34,1918,5.626022823871687
SIM,1900,23,25-29,1923,84
STAT,1912,27,20-24,1939,18.35051278455961
SIM,1867,35,35-39,1902,11
STAT,1933,15,35-39,1948,5.755090466666101
SIM,1831,63,na,1894,1118
STAT,1838,35,15-19,1873,0.050830870316882173
STAT,1934,19,20-24,1953,186.00749799813
SIM,1935,36,50-100,1971,1
STAT,1812,56,na,1868,1195.5040608845572
SIM,1783,78,na,1861,249
SIM,1942,19,20-24,1961,228
STAT,1861,20,40-44,1881,1.8308037636218253
SIM,1921,31,20-24,1952,3
SIM,1913,48,50-100,1961,2
SIM,1912,48,40-44,1960,1
STAT,1807,93,na,1900,12.35074787111002
SIM,1857,15,20-24,1872,29
SIM,1887,39,30-34,1926,10
SIM,1910,36,na,1946,3626
SIM,1821,40,45-49,1861,2
SIM,1825,78,na,1903,435
STAT,1834,28,45-49,1862,0.9727338171140733
STAT,1925,42,40-44,1967,0.3089549330059272
STAT,1908,18,40-44,1926,0.27594327082311887
SIM,1920,27,20-24,1947,27
STAT,1809,73,na,1882,661.8790800444076
SIM,1914,28,35-39,1942,20
STAT,1843,40,30-34,1883,0.9803815357775825
STAT,1889,30,na,1919,3031.266123394707
SIM,1868,15,35-39,1883,1
STAT,1843,22,50-100,1865,0.41321110374411474
SIM,1842,26,na,1868,2013
STAT,1822,77,na,1899,502.5956323509434
STAT,1852,46,40-44,1898,0.13831057805190633
SIM,1850,45,na,1895,1694
SIM,1947,22,15-19,1969,6
SIM,1853,30,25-29,1883,15
STAT,1910,17,45-49,1927,0.10095369483325169
STAT,1938,19,40-44,1957,1.4065306635900756
STAT,1828,51,45-49,1879,0.011181343031685897
STAT,1928,43,20-24,1971,0.022928131651376332
STAT,1889,45,25-29,1934,0.073307906472106
SIM,1899,42,40-44,1941,2
SIM,1835,40,na,1875,1744
SIM,1837,41,na,1878,1557
STAT,1829,44,15-19,1873,0.01127816319447253
STAT,1868,29,15-19,1897,0.43891336338136183
STAT,1921,49,50-100,1970,0.2586617373234826
STAT,1827,48,50-100,1875,0.2721313745973809
STAT,1941,25,35-39,1966,15.858713925469726
STAT,1861,31,35-39,1892,8.57168176637611
SIM,1857,36,40-44,1893,7
STAT,1909,38,15-19,1947,0.01844581444877178
STAT,1887,37,15-19,1924,0.06419215444228876
STAT,1835,30,40-44,1865,4.201745658090972
STAT,1894,5,na,1899,3438.849584405997
SIM,1791,70,na,1861,618
STAT,1839,93,na,1932,20.16975454986804
SIM,1857,18,25-29,1875,9
SIM,1871,17,na,1888,2464
SIM,1900,22,35-39,1922,1
STAT,1895,42,45-49,1937,0.13816134508529038
STAT,1834,62,na,1896,1228.2673855516593
SIM,1834,43,35-39,1877,5
SIM,1858,35,na,1893,1947
SIM,1851,40,30-34,1891,2
STAT,1842,28,40-44,1870,2.884198397754323
STAT,1870,34,40-44,1904,4.287817993297983
STAT,1901,19,45-49,1920,0.09268797833456972
STAT,1841,41,20-24,1882,0.12341896509750021
STAT,1780,98,na,1878,0.5317926888714322
STAT,1873,31,15-19,1904,0.14788697725873676
SIM,1810,80,na,1890,474
SIM,1898,65,na,1963,2880
SIM,1943,28,15-19,1971,1
STAT,1893,34,35-39,1927,12.993699124485994
STAT,1843,23,na,1866,2150.9937541821246
STAT,1913,49,45-49,1962,0.2151407769864546
STAT,1849,18,25-29,1867,5.383445445050252
STAT,1903,17,50-100,1920,0.07104629089717304
STAT,1894,34,50-100,1928,1.1920203664420588
STAT,1827,86,na,1913,143.40286654510675
SIM,1851,62,na,1913,1465
STAT,1921,48,40-44,1969,0.1808637936423897
SIM,1850,28,40-44,1878,4
STAT,1880,47,30-34,1927,0.10328867403684672
STAT,1900,21,30-34,1921,25.261710841219696
SIM,1884,67,na,1951,1525
STAT,1947,17,40-44,1964,1.6075436570697426
SIM,1913,2,na,1915,4325
STAT,1944,26,15-19,1970,0.7788050608181236
STAT,1834,51,30-34,1885,0.0041895250514923845
STAT,1835,41,35-39,1876,1.6381216749055056
STAT,1942,26,na,1968,4013.1890473999883
SIM,1946,19,40-44,1965,2
SIM,1905,52,na,1957,3132
STAT,1935,28,15-19,1963,0.9808904427375448
STAT,1826,43,35-39,1869,1.4584410015508775
STAT,1877,35,na,1912,2516.501048031387
SIM,1808,76,na,1884,460
SIM,1899,20,20-24,1919,141
SIM,1874,32,25-29,1906,15
STAT,1844,47,45-49,1891,0.18202649530530465
STAT,1855,29,50-100,1884,0.5094852302751368
STAT,1921,17,20-24,1938,157.69640900229376
STAT,1917,43,45-49,1960,0.17696293029658808
STAT,1856,73,na,1929,951.1564858536284
STAT,1831,38,na,1869,1795.7094140502331
SIM,1922,27,30-34,1949,73
STAT,1854,60,na,1914,1459.6687690585059
STAT,1855,34,15-19,1889,0.11009378072456819
STAT,1857,42,25-29,1899,0.5109887537228481
STAT,1913,27,25-29,1940,66.90612065700903
STAT,1934,35,45-49,1969,0.9610404481417909
STAT,1923,48,50-100,1971,0.269212995291369
SIM,1939,16,30-34,1955,19
STAT,1833,33,25-29,1866,8.65577366940567
SIM,1843,30,40-44,1873,8
SIM,1904,32,20-24,1936,1
STAT,1817,50,30-34,1867,0.013269749394329507
STAT,1845,21,50-100,1866,0.398413969654708
STAT,1822,55,na,1877,1322.0256947594937
STAT,1850,30,20-24,1880,2.3863970308953633
SIM,1811,43,40-44,1854,3
SIM,1921,27,25-29,1948,116
SIM,1921,49,45-49,1970,1
STAT,1879,20,40-44,1899,2.2353381711404694
STAT,1864,60,na,1924,1729.9689472850055
SIM,1884,57,na,1941,2040
STAT,1831,25,15-19,1856,0.4868622806799872
SIM,1925,43,45-49,1968,1
SIM,1816,47,50-100,1863,1
STAT,1806,108,na,1914,6.508735947415061E-4
STAT,1914,27,30-34,1941,40.30142692072593
STAT,1826,30,15-19,1856,0.18379878122691032
SIM,1867,1,na,1868,3270
STAT,1938,19,50-100,1957,0.3767491932741952
STAT,1881,34,50-100,1915,0.8959354032743608
STAT,1917,49,na,1966,3892.9812205788553
STAT,1930,24,20-24,1954,144.3749163507822
STAT,1864,29,30-34,1893,22.67879938922188
STAT,1914,23,50-100,1937,0.6837624203042605
SIM,1896,52,na,1948,2875
SIM,1866,38,na,1904,2311
STAT,1932,18,35-39,1950,5.651609511905808
STAT,1878,20,35-39,1898,6.233441708151179
STAT,1862,52,35-39,1914,0.007436308121885579
STAT,1881,40,na,1921,2302.5247650186825
STAT,1845,30,25-29,1875,9.715316443840122
STAT,1954,11,na,1965,4953.964105383687
SIM,1821,58,na,1879,1175
SIM,1907,6,na,1913,3976
SIM,1918,38,20-24,1956,2
STAT,1800,107,na,1907,0.0022729377453827196
STAT,1943,9,na,1952,4269.821404179432
SIM,1920,15,15-19,1935,68
STAT,1839,51,20-24,1890,5.117079235069081E-4
SIM,1839,49,40-44,1888,1
STAT,1820,35,40-44,1855,11.904206779873467
STAT,1884,41,30-34,1925,1.1655904231467997
SIM,1910,48,30-34,1958,1
STAT,1815,51,20-24,1866,0.0019349143906241093
STAT,1879,36,na,1915,2524.3999129523368
SIM,1818,46,50-100,1864,1
STAT,1900,35,50-100,1935,1.7524532454377826
SIM,1940,18,35-39,1958,5
STAT,1902,48,30-34,1950,0.07756769350212693
SIM,1906,48,40-44,1954,1
SIM,1907,38,45-49,1945,1
SIM,1923,35,35-39,1958,6
STAT,1890,49,na,1939,2748.226603804754
STAT,1833,46,30-34,1879,0.0759716454889442
STAT,1935,30,45-49,1965,2.2226479940214188
SIM,1876,38,na,1914,2715
SIM,1900,26,40-44,1926,6
STAT,1939,22,15-19,1961,5.4535980582231005
STAT,1932,32,30-34,1964,21.359345698672172
STAT,1919,19,30-34,1938,13.671636226098295
STAT,1849,36,40-44,1885,3.5138835940863027
STAT,1815,41,50-100,1856,3.5300925501831153
STAT,1816,43,na,1859,1373.4279909394359
STAT,1831,47,35-39,1878,0.11449927625927424
STAT,1912,15,15-19,1927,9.405207075655929
STAT,1915,35,35-39,1950,2.5170661347675582
STAT,1845,52,45-49,1897,0.011278865807120128
STAT,1838,54,50-100,1892,0.010791623644780063
STAT,1927,38,20-24,1965,0.3339881182049709
SIM,1875,44,35-39,1919,1
STAT,1829,28,25-29,1857,49.07237256958616
SIM,1831,23,15-19,1854,5
SIM,1833,43,na,1876,1690
SIM,1858,44,35-39,1902,2
SIM,1932,33,35-39,1965,18
STAT,1874,31,20-24,1905,2.8269083924127174
STAT,1841,51,50-100,1892,0.011204509406533059
STAT,1882,42,20-24,1924,0.15764626455055417
SIM,1910,24,45-49,1934,2
STAT,1809,51,35-39,1860,0.037309013839686565
STAT,1918,50,na,1968,3953.5844031700417
STAT,1809,89,na,1898,53.59737596122869
SIM,1817,40,40-44,1857,6
STAT,1857,39,40-44,1896,3.4525376512372317
STAT,1784,70,na,1854,542.0
SIM,1915,33,35-39,1948,15
STAT,1839,61,na,1900,1289.6291914875005
SIM,1929,17,15-19,1946,59
STAT,1835,54,40-44,1889,0.007686492580908093
STAT,1807,88,na,1895,58.01649855972635
STAT,1834,25,40-44,1859,2.681757412892942
STAT,1908,39,50-100,1947,0.39681384737063385
SIM,1814,88,na,1902,78
STAT,1844,33,50-100,1877,0.8402815768066072
SIM,1930,22,20-24,1952,196
STAT,1867,44,35-39,1911,1.7108643370552645
STAT,1876,42,35-39,1918,1.9052159210732762
SIM,1838,18,15-19,1856,6
STAT,1872,48,35-39,1920,0.14134159049017428
SIM,1898,37,40-44,1935,2
SIM,1889,82,na,1971,1052
STAT,1907,37,40-44,1944,1.4152717894173734
STAT,1848,44,25-29,1892,0.49243206875638407
STAT,1896,19,25-29,1915,7.594140704998213
STAT,1840,23,15-19,1863,2.9973083665452234
STAT,1854,104,na,1958,0.09139856802965218
STAT,1884,15,na,1899,2560.8936154243875
STAT,1920,17,15-19,1937,51.96103603983431
SIM,1868,41,25-29,1909,2
SIM,1830,25,na,1855,1935
SIM,1837,28,25-29,1865,51
SIM,1882,31,20-24,1913,2
STAT,1807,102,na,1909,0.123896718428619
SIM,1929,39,35-39,1968,1
SIM,1846,93,na,1939,2
STAT,1896,48,20-24,1944,0.009005638885349094
STAT,1891,43,15-19,1934,0.017315790748484113
STAT,1907,33,35-39,1940,8.673398364251868
STAT,1850,47,45-49,1897,0.17669273114059533
SIM,1843,41,35-39,1884,2
STAT,1928,38,25-29,1966,1.267965902625641
STAT,1892,18,na,1910,3220.6833818252
SIM,1867,42,35-39,1909,4
SIM,1906,35,35-39,1941,3
STAT,1885,32,50-100,1917,0.9325352943734853
STAT,1898,4,na,1902,3629.1716517030786
SIM,1826,54,40-44,1880,1
SIM,1826,95,na,1921,1
STAT,1772,85,na,1857,45.05547233034501
STAT,1904,34,20-24,1938,2.2498385836518398
SIM,1884,31,40-44,1915,5
SIM,1852,47,45-49,1899,1
SIM,1912,34,20-24,1946,1
STAT,1897,65,na,1962,2478.7724191188768
SIM,1900,37,na,1937,3391
STAT,1879,68,na,1947,1629.6010969887338
STAT,1876,31,40-44,1907,4.5870940640961635
STAT,1846,32,50-100,1878,0.7743150719326296
STAT,1938,17,15-19,1955,45.66748694833752
STAT,1859,42,35-39,1901,1.4734807496953082
STAT,1885,45,40-44,1930,0.17598086467211466
STAT,1935,6,na,1941,5587.767391106592
SIM,1919,17,30-34,1936,17
STAT,1820,46,20-24,1866,0.022210139547851733
STAT,1897,39,50-100,1936,0.3578282740156302
SIM,1920,19,20-24,1939,1
STAT,1830,45,50-100,1875,0.20918592592585022
SIM,1922,36,50-100,1958,5
STAT,1818,54,40-44,1872,0.022014342018001058
STAT,1899,20,50-100,1919,0.5730698253256878
STAT,1874,26,50-100,1900,0.6685656845541799
STAT,1913,32,20-24,1945,2.475714262921708
STAT,1912,19,20-24,1931,27.816651582433245
STAT,1860,15,40-44,1875,0.1766780256245728
STAT,1925,19,50-100,1944,0.4592698011230667
SIM,1834,92,na,1926,13
STAT,1886,31,25-29,1917,11.105286615526133
SIM,1905,30,na,1935,3481
SIM,1902,27,15-19,1929,1
SIM,1957,12,na,1969,5607
STAT,1854,41,45-49,1895,1.1506434082667958
STAT,1951,8,na,1959,4774.302884782795
SIM,1901,31,40-44,1932,9
STAT,1936,28,20-24,1964,17.80916118965132
STAT,1784,80,na,1864,210.0683208607956
STAT,1846,45,50-100,1891,0.1773848998986533
STAT,1906,65,na,1971,2868.6083288408104
SIM,1884,42,35-39,1926,5
STAT,1839,71,na,1910,921.2057518161939
STAT,1875,52,30-34,1927,0.006199204571186007
STAT,1818,41,35-39,1859,4.831817514029592
STAT,1909,40,45-49,1949,0.16056025414804606
STAT,1929,17,50-100,1946,0.4876729958831913
STAT,1929,28,na,1957,4779.608295294505
SIM,1867,7,na,1874,2551
SIM,1842,25,40-44,1867,1
STAT,1827,76,na,1903,612.325295753037
SIM,1837,21,40-44,1858,2
SIM,1854,101,na,1955,4
SIM,1905,62,na,1967,2987
STAT,1856,52,20-24,1908,5.877826116728849E-4
SIM,1873,73,na,1946,1109
SIM,1841,30,20-24,1871,4
STAT,1857,28,50-100,1885,0.5211834398080003
STAT,1885,32,35-39,1917,10.30711303524129
STAT,1877,29,na,1906,2507.0990460817598
SIM,1842,20,na,1862,2167
SIM,1884,5,na,1889,2868
STAT,1882,7,na,1889,2604.1232152614534
STAT,1918,36,15-19,1954,0.020754650938983186
STAT,1896,35,15-19,1931,0.07637859495864777
STAT,1830,41,45-49,1871,1.3096080811731605
STAT,1879,35,15-19,1914,0.06044939204224546
STAT,1823,32,50-100,1855,2.334409087026823
STAT,1854,17,na,1871,2101.5846701173477
STAT,1919,48,25-29,1967,0.05854955176140493
SIM,1855,60,na,1915,1420
STAT,1868,18,35-39,1886,0.5411183856222054
STAT,1928,17,30-34,1945,15.665674737116072
SIM,1894,31,25-29,1925,2
STAT,1840,36,20-24,1876,0.6629239022781459
SIM,1915,37,40-44,1952,3
STAT,1819,40,25-29,1859,1.4683795139773643
STAT,1900,24,35-39,1924,8.199422356186513
STAT,1826,37,50-100,1863,1.0970136841734461
SIM,1893,32,35-39,1925,21
STAT,1922,22,20-24,1944,130.11088577106503
STAT,1834,40,na,1874,1747.4689833987095
STAT,1861,47,20-24,1908,0.010068459739963032
SIM,1860,23,na,1883,2084
STAT,1842,75,na,1917,807.3089024561989
SIM,1935,26,15-19,1961,1
SIM,1826,41,35-39,1867,3
STAT,1819,73,na,1892,700.2479275741223
STAT,1891,48,45-49,1939,0.16602227957890603
STAT,1908,45,45-49,1953,0.2033769377067954
STAT,1911,41,50-100,1952,0.11503337642461119
STAT,1913,44,15-19,1957,0.001522685658981002
STAT,1824,40,20-24,1864,0.2036918634464762
SIM,1869,68,na,1937,1376
SIM,1846,39,30-34,1885,8
STAT,1838,39,30-34,1877,4.628038155526525
SIM,1878,29,25-29,1907,42
STAT,1929,40,50-100,1969,0.1556049550117586
SIM,1900,15,na,1915,3665
SIM,1775,86,na,1861,20
STAT,1860,88,na,1948,113.63158479978264
STAT,1891,31,20-24,1922,3.42790921167311
SIM,1825,56,na,1881,1229
STAT,1924,33,35-39,1957,10.870700818678136
SIM,1827,40,25-29,1867,3
SIM,1898,15,20-24,1913,32
STAT,1847,90,na,1937,61.480900188975525
SIM,1786,81,na,1867,131
STAT,1908,42,40-44,1950,0.23597632281257194
STAT,1943,28,50-100,1971,1.0810059301263222
STAT,1811,61,na,1872,994.0412092053688
STAT,1831,44,30-34,1875,0.9486541329373268
STAT,1881,37,20-24,1918,0.7602708387901012
STAT,1913,46,40-44,1959,0.15737869702129534
STAT,1903,40,50-100,1943,0.10746073552073285
SIM,1826,73,na,1899,712
SIM,1934,33,45-49,1967,4
SIM,1788,82,na,1870,259
SIM,1850,23,25-29,1873,55
STAT,1860,41,30-34,1901,0.9559025361002925
STAT,1861,40,25-29,1901,0.5467800790282452
STAT,1930,36,15-19,1966,0.02557026164533503
STAT,1875,26,40-44,1901,3.1471505763897794
SIM,1867,20,25-29,1887,3
STAT,1823,40,15-19,1863,0.023466597905252802
STAT,1903,29,20-24,1932,16.89094424140784
SIM,1829,39,30-34,1868,9
STAT,1846,41,na,1887,1694.3966784654801
SIM,1932,25,35-39,1957,27
SIM,1806,59,na,1865,1194
SIM,1929,19,40-44,1948,1
STAT,1893,31,30-34,1924,22.687770756752563
STAT,1843,43,35-39,1886,1.4859500259568168
STAT,1922,6,na,1928,4733.025380648892
STAT,1925,45,45-49,1970,0.26995918612683967
SIM,1882,47,30-34,1929,1
STAT,1900,37,40-44,1937,1.335964082634516
SIM,1886,16,na,1902,2837
STAT,1826,40,30-34,1866,0.9762625622360331
STAT,1926,33,45-49,1959,1.9398767872225615
STAT,1872,73,na,1945,1214.3935368359
STAT,1811,45,40-44,1856,0.492581497405826
STAT,1941,22,30-34,1963,30.302030566496136
STAT,1951,18,45-49,1969,0.6066485497563202
STAT,1852,59,na,1911,1565.657902657131
STAT,1837,46,15-19,1883,2.804150899000211E-4
STAT,1891,45,40-44,1936,0.1231850253613501
STAT,1882,45,15-19,1927,4.0151380301117046E-4
SIM,1831,32,50-100,1863,1
STAT,1877,15,35-39,1892,0.583278908734957
STAT,1963,0,na,1963,5131.762017261488
STAT,1820,43,40-44,1863,4.344687273613041
STAT,1839,54,25-29,1893,0.002377279715431904
STAT,1874,47,30-34,1921,0.10035314463034552
STAT,1931,15,25-29,1946,58.11663482555831
SIM,1896,36,na,1932,3242
STAT,1879,52,na,1931,2283.818131673069
SIM,1845,41,45-49,1886,2
STAT,1814,46,20-24,1860,0.036363862028018404
STAT,1824,54,40-44,1878,0.011376111040897354
SIM,1908,8,na,1916,4193
STAT,1836,40,25-29,1876,0.48787110422746166
SIM,1916,42,40-44,1958,1
STAT,1761,103,na,1864,0.02378986227516212
STAT,1853,51,40-44,1904,0.008869656127350198
STAT,1901,16,40-44,1917,0.26156653145339864
STAT,1859,20,25-29,1879,53.94705777209826
STAT,1924,25,35-39,1949,17.955827273178983
STAT,1892,56,na,1948,2607.7983149747047
STAT,1911,49,25-29,1960,0.050924020543702576
STAT,1929,38,30-34,1967,2.3841280767620234
STAT,1938,27,na,1965,3785.9002823231262
STAT,1852,30,40-44,1882,3.6931809146373005
SIM,1864,90,na,1954,122
SIM,1920,5,na,1925,4442
STAT,1858,39,50-100,1897,0.9832566595072941
SIM,1843,75,na,1918,736
SIM,1900,29,45-49,1929,1
STAT,1880,49,na,1929,2361.5373870023336
SIM,1855,17,na,1872,2131
SIM,1923,32,30-34,1955,3
STAT,1848,70,na,1918,1090.6560386027252
SIM,1852,44,40-44,1896,4
STAT,1850,33,25-29,1883,7.976460454653384
SIM,1920,51,na,1971,3904
STAT,1883,32,25-29,1915,10.252492915094505
STAT,1878,47,15-19,1925,4.22763955219016E-4
SIM,1941,27,40-44,1968,10
SIM,1876,22,30-34,1898,24
SIM,1901,34,45-49,1935,1
STAT,1932,35,35-39,1967,3.3199909565589514
STAT,1855,18,25-29,1873,5.194068459444728
STAT,1877,31,50-100,1908,0.9734284128384552
STAT,1904,46,15-19,1950,3.308270977133498E-4
STAT,1851,18,40-44,1869,0.18238398521385601
SIM,1860,30,40-44,1890,8
STAT,1933,27,40-44,1960,6.311575446914789
STAT,1871,42,45-49,1913,1.5105297609836794
SIM,1921,24,20-24,1945,141
SIM,1938,17,40-44,1955,3
SIM,1774,96,na,1870,2
STAT,1834,56,na,1890,1370.6698355525739
STAT,1811,49,20-24,1860,0.032186539738365355
SIM,1884,34,35-39,1918,15
SIM,1893,48,45-49,1941,1
SIM,1857,18,na,1875,2271
SIM,1863,18,25-29,1881,8
STAT,1809,100,na,1909,0.5416418917906838
STAT,1923,46,25-29,1969,0.06347132228896855
STAT,1848,16,50-100,1864,0.047489241616758514
STAT,1858,41,15-19,1899,0.011222809889122819
STAT,1915,32,30-34,1947,16.374074161151434
STAT,1844,44,40-44,1888,1.7399523464160274
STAT,1855,47,20-24,1902,0.009259011516477303
SIM,1824,41,25-29,1865,1
SIM,1841,62,na,1903,1355
STAT,1897,55,na,1952,2820.436957865691
SIM,1813,42,50-100,1855,2
SIM,1859,25,35-39,1884,1
SIM,1928,36,25-29,1964,4
STAT,1876,34,35-39,1910,10.576812478341498
STAT,1864,41,15-19,1905,0.012583332298509086
STAT,1878,42,45-49,1920,1.5872675840272572
STAT,1899,33,50-100,1932,1.2745658120752135
STAT,1817,53,35-39,1870,0.018075312017975652
STAT,1926,26,na,1952,4597.0058001624
STAT,1804,51,45-49,1855,0.04344596469649675
SIM,1921,46,40-44,1967,1
SIM,1891,32,25-29,1923,17
STAT,1826,40,40-44,1866,1.9100151955332345
SIM,1843,39,50-100,1882,4
STAT,1862,30,25-29,1892,8.966174615541908
STAT,1829,93,na,1922,19.437337127113473
STAT,1868,22,30-34,1890,17.355707112494677
STAT,1926,38,15-19,1964,0.02391790571839436
SIM,1945,7,na,1952,4716
STAT,1885,48,45-49,1933,0.2371777269958524
STAT,1918,34,50-100,1952,0.88889727562799
STAT,1816,41,25-29,1857,1.5966254073665807
STAT,1914,20,na,1934,3839.9580371070247
SIM,1818,44,na,1862,1433
SIM,1883,22,25-29,1905,83
STAT,1835,39,50-100,1874,1.1081226686674022
STAT,1861,44,40-44,1905,1.870474739027715
STAT,1843,101,na,1944,0.46064902529740537
STAT,1870,72,na,1942,1259.4379798357925
SIM,1883,26,40-44,1909,2
SIM,1817,43,35-39,1860,3
SIM,1904,46,50-100,1950,1
SIM,1835,44,50-100,1879,4
STAT,1905,44,50-100,1949,0.10662879631132649
STAT,1842,23,25-29,1865,56.2158326436858
SIM,1893,34,na,1927,3201
SIM,1926,34,50-100,1960,6
STAT,1913,24,20-24,1937,113.8313516458487
SIM,1856,61,na,1917,1841
SIM,1886,42,45-49,1928,4
SIM,1911,29,20-24,1940,18
STAT,1931,21,50-100,1952,0.8729807667827401
SIM,1879,19,15-19,1898,6
SIM,1830,30,45-49,1860,1
STAT,1818,56,na,1874,1222.5785769071188
STAT,1860,72,na,1932,1045.3161167459546
STAT,1859,38,na,1897,1909.9293808711307
STAT,1928,35,20-24,1963,0.3404050007185871
STAT,1936,19,30-34,1955,11.83839136904743
SIM,1835,56,na,1891,1388
SIM,1866,15,25-29,1881,9
SIM,1874,29,40-44,1903,3
STAT,1861,23,35-39,1884,5.017323026585574
SIM,1915,30,30-34,1945,20
STAT,1910,43,35-39,1953,0.19293325389910473
STAT,1812,50,40-44,1862,0.024738329461312766
STAT,1843,35,50-100,1878,1.1813292352642144
STAT,1925,28,45-49,1953,2.0744952411854136
STAT,1832,51,20-24,1883,5.257081676614235E-4
SIM,1933,28,45-49,1961,4
STAT,1877,67,na,1944,1677.2967378847513
STAT,1850,44,40-44,1894,1.6690784612943634
STAT,1902,13,na,1915,3709.5563959256574
STAT,1884,44,35-39,1928,1.802953387216508
SIM,1913,25,25-29,1938,65
SIM,1800,80,na,1880,243
STAT,1824,62,na,1886,1047.6189811851177
SIM,1944,19,30-34,1963,16
STAT,1824,43,25-29,1867,0.7756904332077791
STAT,1898,13,na,1911,3557.1845251046257
SIM,1878,40,45-49,1918,3
STAT,1843,30,15-19,1873,0.14110644661604435
SIM,1943,26,na,1969,3713
SIM,1891,24,25-29,1915,112
SIM,1868,20,30-34,1888,22
SIM,1847,41,na,1888,1627
STAT,1824,53,50-100,1877,0.016647100911533413
STAT,1891,34,25-29,1925,12.825631959714292
STAT,1842,31,25-29,1873,9.804494767385773
SIM,1825,49,50-100,1874,1
STAT,1863,36,15-19,1899,0.05046929241723251
STAT,1867,41,30-34,1908,1.1060558196979862
STAT,1895,48,na,1943,2957.485687313649
SIM,1901,32,na,1933,3560
SIM,1867,18,na,1885,2420
SIM,1869,40,50-100,1909,1
STAT,1842,91,na,1933,45.44294483122805
STAT,1947,4,na,1951,4570.9892663482915
STAT,1889,52,na,1941,2698.930222234918
STAT,1939,22,na,1961,3741.263893407483
STAT,1901,66,na,1967,2627.479729751805
STAT,1907,30,30-34,1937,15.137579215224534
STAT,1901,46,50-100,1947,0.1981977695290647
STAT,1850,30,50-100,1880,0.8089079352103202
SIM,1832,42,na,1874,1654
STAT,1919,45,50-100,1964,0.2515230077114393
STAT,1915,48,40-44,1963,0.16166814630338167
STAT,1922,38,30-34,1960,2.113936007740203
SIM,1850,31,25-29,1881,14
SIM,1930,38,30-34,1968,3
SIM,1875,41,30-34,1916,1
SIM,1881,19,30-34,1900,1
STAT,1830,49,30-34,1879,0.07827771020219192
STAT,1959,10,na,1969,5241.40346454068
SIM,1811,46,45-49,1857,1
STAT,1821,51,35-39,1872,0.013290233316583397
STAT,1835,33,35-39,1868,9.510943141646491
SIM,1939,24,30-34,1963,37
STAT,1883,24,25-29,1907,56.942165188643074
STAT,1859,16,na,1875,2183.69241223762
SIM,1903,27,20-24,1930,15
SIM,1874,90,na,1964,161
STAT,1934,32,40-44,1966,5.448814529434566
STAT,1902,35,na,1937,3448.604632607414
SIM,1877,2,na,1879,3260
SIM,1921,35,25-29,1956,4
SIM,1844,18,15-19,1862,3
STAT,1836,18,15-19,1854,6.896104599308486
STAT,1841,44,15-19,1885,0.010327421550744842
STAT,1892,19,40-44,1911,0.23259877422504413
STAT,1913,35,25-29,1948,1.0006741705887336
STAT,1913,51,na,1964,3611.4780720568424
SIM,1820,57,na,1877,1338
STAT,1855,52,50-100,1907,0.011645299706546047
SIM,1871,31,45-49,1902,1
STAT,1870,37,45-49,1907,1.9880299298546313
STAT,1931,32,na,1963,5054.143685659332
SIM,1824,33,25-29,1857,11
SIM,1851,43,35-39,1894,5
SIM,1900,21,na,1921,3317
STAT,1897,40,15-19,1937,0.0013212868392593992
SIM,1817,53,na,1870,1244
SIM,1955,11,na,1966,5089
STAT,1944,5,na,1949,4370.741460337179
STAT,1860,94,na,1954,16.54276145395479
STAT,1938,11,na,1949,3993.032414699099
STAT,1899,42,15-19,1941,0.0013380206979352824
STAT,1910,46,15-19,1956,3.514064078406653E-4
STAT,1892,34,na,1926,3024.924518688982
STAT,1906,28,35-39,1934,14.276738680261435
STAT,1888,3,na,1891,3188.28516098897
STAT,1890,31,15-19,1921,0.1783562507329506
STAT,1875,37,50-100,1912,1.2854597549762672
STAT,1857,0,na,1857,3151.020952666177
SIM,1796,58,na,1854,907
STAT,1905,25,25-29,1930,62.74739873014262
STAT,1893,47,40-44,1940,0.1243944427007065
STAT,1950,15,35-39,1965,5.06443556469752
SIM,1843,33,35-39,1876,16
STAT,1881,5,na,1886,2641.1964701155684
STAT,1872,45,30-34,1917,0.09995789069222805
STAT,1926,1,na,1927,5223.292126339695
STAT,1940,17,30-34,1957,12.625378163182202
STAT,1876,51,25-29,1927,0.003749113118175309
STAT,1857,90,na,1947,62.81376918437553
SIM,1776,81,na,1857,146
STAT,1857,51,50-100,1908,0.012090217480384939
STAT,1911,22,45-49,1933,1.0884890259822464
SIM,1910,15,na,1925,3881
STAT,1942,17,50-100,1959,0.39945542916437243
SIM,1883,3,na,1886,2965
STAT,1882,51,na,1933,2150.222481042906
STAT,1812,77,na,1889,391.80128933587895
STAT,1833,45,na,1878,1615.4877034748752
STAT,1898,43,25-29,1941,0.061073577768312924
STAT,1907,15,50-100,1922,0.073725250382025
SIM,1850,23,na,1873,1967
STAT,1858,15,25-29,1873,5.418865838147977
STAT,1805,54,30-34,1859,0.020151678803730637
SIM,1833,28,40-44,1861,7
SIM,1941,20,30-34,1961,40
SIM,1879,29,50-100,1908,2
SIM,1820,79,na,1899,407
STAT,1896,30,45-49,1926,2.3684308170922264
SIM,1833,35,40-44,1868,2
SIM,1823,41,50-100,1864,1
SIM,1835,31,35-39,1866,15
STAT,1825,42,na,1867,1637.493145335545
SIM,1932,22,30-34,1954,48
STAT,1953,10,na,1963,4848.507709040219
SIM,1861,39,na,1900,2463
SIM,1826,57,na,1883,1359
STAT,1907,15,30-34,1922,2.3985286334073255
SIM,1953,18,20-24,1971,197
STAT,1869,45,50-100,1914,0.2443050849649351
STAT,1933,20,30-34,1953,39.111413272453696
STAT,1894,22,35-39,1916,7.657423212456873
SIM,1895,51,na,1946,2977
STAT,1912,43,45-49,1955,0.16276412938021406
SIM,1850,20,20-24,1870,70
STAT,1915,44,25-29,1959,0.07311880798807689
SIM,1817,40,30-34,1857,2
STAT,1890,17,50-100,1907,0.0611093761600754
SIM,1882,7,na,1889,2562
SIM,1877,17,15-19,1894,10
STAT,1840,40,15-19,1880,0.01168718542557894
STAT,1869,17,15-19,1886,5.925927698413973
STAT,1919,9,na,1928,4489.24314861157
SIM,1927,15,15-19,1942,60
SIM,1929,17,25-29,1946,89
SIM,1938,29,35-39,1967,23
STAT,1890,70,na,1960,1895.4146397234947
STAT,1913,48,30-34,1961,0.08851770288787258
STAT,1882,88,na,1970,370.3368601028495
SIM,1852,89,na,1941,57
SIM,1917,33,45-49,1950,2
STAT,1831,46,20-24,1877,0.00994134408390511
SIM,1868,99,na,1967,2
STAT,1909,51,na,1960,3399.031554466173
STAT,1830,41,35-39,1871,1.584520043386389
STAT,1802,94,na,1896,6.341692402691912
SIM,1845,39,na,1884,1882
STAT,1835,50,25-29,1885,0.002799312870195138
SIM,1950,17,40-44,1967,3
SIM,1857,23,50-100,1880,2
STAT,1872,34,15-19,1906,0.14435524367822455
STAT,1896,18,50-100,1914,0.06583643208118703
STAT,1862,52,45-49,1914,0.012535490816560066
STAT,1910,48,na,1958,3486.197114800498
SIM,1915,29,na,1944,4151
STAT,1899,29,na,1928,3310.0726385482635
STAT,1857,89,na,1946,83.69812544554888
STAT,1828,87,na,1915,97.01689756514561
SIM,1868,19,15-19,1887,6
STAT,1827,31,35-39,1858,16.45840313186291
SIM,1900,30,50-100,1930,1
SIM,1883,66,na,1949,1680
SIM,1921,20,na,1941,4782
STAT,1825,35,40-44,1860,7.152699803897412
STAT,1834,21,25-29,1855,51.89476186819485
SIM,1889,25,20-24,1914,20
SIM,1928,33,20-24,1961,4
STAT,1941,25,na,1966,3957.0316770110894
SIM,1895,32,45-49,1927,2
STAT,1942,17,40-44,1959,1.4913006315273398
STAT,1892,26,40-44,1918,3.843157430204791
STAT,1916,27,40-44,1943,4.918066173574789
SIM,1854,54,na,1908,1812
SIM,1842,21,25-29,1863,60
SIM,1906,53,na,1959,3212
STAT,1870,56,na,1926,2034.0509206630668
STAT,1873,52,20-24,1925,7.591299498732738E-4
STAT,1833,61,na,1894,1227.124950943143
SIM,1898,23,20-24,1921,114
STAT,1844,24,na,1868,2039.0972960524923
SIM,1870,16,na,1886,2816
SIM,1843,30,30-34,1873,31
SIM,1894,19,na,1913,3398
STAT,1922,34,15-19,1956,0.14742637530700478
STAT,1887,32,45-49,1919,1.9934213705161528
STAT,1804,51,35-39,1855,0.02577302994063144
SIM,1843,91,na,1934,58
SIM,1874,4,na,1878,2832
SIM,1927,14,na,1941,4854
STAT,1941,7,na,1948,4176.32195215279
SIM,1895,73,na,1968,1980
SIM,1858,30,25-29,1888,13
STAT,1824,94,na,1918,11.004640428999965
SIM,1835,72,na,1907,717
STAT,1866,36,40-44,1902,4.138925074753229
STAT,1872,47,20-24,1919,0.012211956850860205
STAT,1938,28,30-34,1966,39.579335845171784
STAT,1896,15,45-49,1911,0.0884214211183073
STAT,1899,16,25-29,1915,7.935690371998001
SIM,1885,15,35-39,1900,1
STAT,1902,19,na,1921,3613.966439983003
STAT,1900,30,50-100,1930,1.305938776308352
STAT,1946,19,50-100,1965,0.42368516621133445
SIM,1861,21,35-39,1882,8
STAT,1882,51,25-29,1933,0.0035371679445001616
STAT,1884,31,15-19,1915,0.144316959282259
STAT,1831,33,15-19,1864,0.1287399745451771
SIM,1887,22,na,1909,2778
STAT,1843,76,na,1919,764.8134010194559
STAT,1869,30,35-39,1899,10.05440700283837
STAT,1902,21,40-44,1923,3.006913018911971
STAT,1901,39,15-19,1940,0.017116784077354497
SIM,1914,9,na,1923,4160
STAT,1870,30,25-29,1900,10.29667336516563
STAT,1880,43,15-19,1923,0.014697601542747882
SIM,1927,28,20-24,1955,27
SIM,1828,41,45-49,1869,5
SIM,1954,10,na,1964,4718
STAT,1868,25,35-39,1893,9.465384384660341
STAT,1919,28,20-24,1947,20.05610418278581
SIM,1899,66,na,1965,2534
STAT,1820,110,na,1930,1.5219444959304611E-4
STAT,1902,44,15-19,1946,0.001361013931834007
STAT,1941,20,50-100,1961,0.6942068014674773
STAT,1851,106,na,1957,0.015561292690523237
STAT,1895,47,15-19,1942,2.9892004689964014E-4
STAT,1853,40,25-29,1893,0.5438809622394158
STAT,1896,70,na,1966,2182.6406853221542
STAT,1842,20,20-24,1862,69.1517002984043
STAT,1917,48,15-19,1965,3.9155852661564353E-4
SIM,1857,22,20-24,1879,81
STAT,1891,47,30-34,1938,0.06864229387420666
STAT,1853,21,35-39,1874,5.82314575784429
STAT,1920,25,15-19,1945,0.7956476944141335
STAT,1898,32,20-24,1930,3.7290112400495414
STAT,1817,40,15-19,1857,0.03749373165768094
STAT,1873,19,50-100,1892,0.05039809819166228
STAT,1924,22,30-34,1946,34.601092578849716
STAT,1863,16,na,1879,2356.732482696945
STAT,1873,19,30-34,1892,1.6396184611866458
STAT,1821,76,na,1897,499.2241717054226
SIM,1851,24,na,1875,2021
STAT,1867,53,25-29,1920,0.0033378310734143214
STAT,1939,26,30-34,1965,40.20133110489794
SIM,1901,16,na,1917,3734
STAT,1843,40,40-44,1883,1.9180737879229104
SIM,1884,31,30-34,1915,21
STAT,1810,50,30-34,1860,0.0185571815146532
STAT,1838,18,25-29,1856,5.467309795887326
STAT,1846,17,50-100,1863,0.044011235191957876
STAT,1919,15,15-19,1934,10.315686795993317
STAT,1909,33,45-49,1942,1.5249889289701442
STAT,1833,42,15-19,1875,0.011072060847326782
STAT,1943,25,45-49,1968,1.8788187430736267
STAT,1876,31,30-34,1907,18.467743061217337
STAT,1813,57,na,1870,1111.9645887944816
SIM,1853,21,50-100,1874,1
SIM,1775,80,na,1855,169
STAT,1922,33,na,1955,4341.854914993255
SIM,1906,31,na,1937,3605
STAT,1808,72,na,1880,506.22858370422813
SIM,1864,74,na,1938,953
STAT,1920,39,25-29,1959,1.097786157429738
STAT,1888,30,45-49,1918,2.1199896866122043
STAT,1822,35,15-19,1857,0.11628661440615565
SIM,1834,40,40-44,1874,4
STAT,1852,42,25-29,1894,0.5166858494657031
SIM,1812,44,na,1856,1365
STAT,1863,40,35-39,1903,1.6360287163852243
STAT,1873,53,25-29,1926,0.0036045067328876494
STAT,1921,37,25-29,1958,1.1218624745387715
SIM,1868,23,35-39,1891,9
SIM,1911,0,na,1911,4288
STAT,1832,29,50-100,1861,0.5687521142422826
STAT,1882,56,na,1938,2027.1449835977453
STAT,1915,15,30-34,1930,2.61530411337617
STAT,1850,46,30-34,1896,0.07302015854226447
STAT,1876,20,50-100,1896,0.4321415087362981
STAT,1930,42,25-29,1972,0.0958275130203538
STAT,1909,46,15-19,1955,3.460764325025786E-4
STAT,1866,32,25-29,1898,9.637985271788825
SIM,1916,25,40-44,1941,6
SIM,1865,24,20-24,1889,72
SIM,1838,16,25-29,1854,8
STAT,1809,95,na,1904,6.783265854360135
STAT,1887,45,15-19,1932,4.618115862015449E-4
STAT,1900,30,20-24,1930,3.852710899050673
STAT,1893,31,40-44,1924,5.6352819194471815
STAT,1883,14,na,1897,2576.633737621454
STAT,1857,24,20-24,1881,56.853579834842726
STAT,1846,31,45-49,1877,1.4890786184523157
SIM,1848,39,40-44,1887,7
SIM,1864,19,30-34,1883,4
STAT,1829,35,na,1864,1861.441459739717
STAT,1820,39,20-24,1859,1.6723835591057445
SIM,1848,24,20-24,1872,84
SIM,1879,30,45-49,1909,4
SIM,1948,17,35-39,1965,6
STAT,1874,37,na,1911,2453.8959467357386
STAT,1877,41,25-29,1918,0.6825317275104146
STAT,1876,66,na,1942,1726.5814476585606
STAT,1849,22,20-24,1871,64.68424461915438
STAT,1947,25,na,1972,4327.824435929878
SIM,1899,33,50-100,1932,3
SIM,1958,7,na,1965,5142
SIM,1910,21,40-44,1931,4
SIM,1848,46,40-44,1894,1
STAT,1847,29,30-34,1876,23.26515922792517
SIM,1825,94,na,1919,6
SIM,1896,30,45-49,1926,2
STAT,1920,28,50-100,1948,1.1103321658969096
SIM,1923,15,30-34,1938,18
STAT,1935,23,45-49,1958,1.562027751774086
STAT,1845,89,na,1934,82.08324814640825
STAT,1861,20,30-34,1881,15.649609694749836
STAT,1921,44,25-29,1965,0.08180056060342446
SIM,1887,19,25-29,1906,11
STAT,1821,51,45-49,1872,0.022403536131007994
STAT,1810,101,na,1911,0.24327585815549724
STAT,1835,30,30-34,1865,16.916321779745154
STAT,1898,21,15-19,1919,4.5649169927012165
STAT,1769,114,na,1883,1.4789167518140128E-4
STAT,1817,50,40-44,1867,0.023468812934914676
STAT,1845,52,35-39,1897,0.00669085260677181
STAT,1905,22,20-24,1927,101.53184813710789
STAT,1884,85,na,1969,581.2506302754826
SIM,1838,39,50-100,1877,2
STAT,1863,31,45-49,1894,1.5661389492678475
STAT,1914,36,50-100,1950,0.42976385581796783
SIM,1907,16,na,1923,3864
SIM,1924,27,40-44,1951,1
STAT,1867,89,na,1956,112.99332561882802
SIM,1913,22,20-24,1935,108
STAT,1926,40,45-49,1966,0.20989032927317716
SIM,1824,30,20-24,1854,3
STAT,1917,35,45-49,1952,0.729451509566919
SIM,1855,29,30-34,1884,17
STAT,1935,36,15-19,1971,0.027409032171592025
SIM,1939,27,35-39,1966,17
SIM,1889,47,40-44,1936,1
SIM,1943,23,45-49,1966,2
SIM,1854,7,na,1861,2561
SIM,1907,27,40-44,1934,7
STAT,1867,41,40-44,1908,2.1639500524248914
STAT,1826,52,25-29,1878,0.0026724535679124957
STAT,1900,48,20-24,1948,0.009450764967339343
STAT,1939,33,30-34,1972,16.388685538583957
STAT,1883,21,20-24,1904,69.1872782690331
SIM,1886,20,35-39,1906,11
STAT,1930,27,25-29,1957,85.35996541390648
STAT,1912,37,50-100,1949,0.418031635135907
SIM,1829,87,na,1916,43
STAT,1908,29,na,1937,3585.360062846579
SIM,1954,16,20-24,1970,172
SIM,1857,29,40-44,1886,4
SIM,1925,29,na,1954,4531
STAT,1911,31,35-39,1942,9.113999361013402
SIM,1930,34,15-19,1964,3
STAT,1843,52,25-29,1895,0.002844149507343953
STAT,1874,43,15-19,1917,0.014279886416320931
SIM,1844,40,25-29,1884,1
STAT,1832,39,na,1871,1758.6670159159064
SIM,1865,28,50-100,1893,1
SIM,1937,16,20-24,1953,211
STAT,1857,20,15-19,1877,3.078377440647016
STAT,1868,32,35-39,1900,9.867482472205113
SIM,1860,30,30-34,1890,24
STAT,1826,91,na,1917,33.797524191750604
SIM,1848,42,na,1890,1826
SIM,1844,76,na,1920,674
SIM,1912,37,50-100,1949,1
STAT,1907,44,na,1951,3427.040444957282
STAT,1857,74,na,1931,884.1895223543662
SIM,1889,0,na,1889,3701
STAT,1877,19,15-19,1896,6.245590466900371
STAT,1837,41,45-49,1878,1.1926724856326805
STAT,1849,29,40-44,1878,2.7173792939449877
STAT,1870,51,50-100,1921,0.015133471826329788
STAT,1807,52,15-19,1859,1.0163144628075788E-4
STAT,1841,50,25-29,1891,0.0026528369692264734
SIM,1894,29,na,1923,3166
STAT,1860,78,na,1938,646.7202186510624
STAT,1842,15,50-100,1857,0.049922240464467235
SIM,1860,46,40-44,1906,1
SIM,1915,45,na,1960,4139
STAT,1876,20,25-29,1896,60.664018659517915
SIM,1862,89,na,1951,69
SIM,1876,32,35-39,1908,3
STAT,1946,16,20-24,1962,153.46331381481065
STAT,1857,52,na,1909,1706.337052784785
STAT,1898,47,40-44,1945,0.13260373509269047
SIM,1875,37,na,1912,2350
STAT,1859,7,na,1866,2340.7605496083033
SIM,1886,28,50-100,1914,1
SIM,1871,40,35-39,1911,6
SIM,1875,41,40-44,1916,5
SIM,1883,88,na,1971,348
STAT,1851,25,40-44,1876,2.935661732025061
STAT,1929,16,20-24,1945,176.90605676477063
STAT,1870,54,45-49,1924,0.014074699767351071
STAT,1893,43,25-29,1936,0.05729260691576349
STAT,1880,36,15-19,1916,0.060489095875897
STAT,1928,43,na,1971,4821.7230420488595
SIM,1924,23,35-39,1947,15
STAT,1894,41,25-29,1935,0.8464629457934439
SIM,1824,38,50-100,1862,1
SIM,1854,31,45-49,1885,4
STAT,1916,23,35-39,1939,10.037571646357039
STAT,1897,20,45-49,1917,0.9568473735685444
STAT,1813,45,15-19,1858,0.0010396715199032511
STAT,1852,30,30-34,1882,14.86882877418218
SIM,1865,20,15-19,1885,3
SIM,1888,27,50-100,1915,2
STAT,1945,18,20-24,1963,151.05204124136594
STAT,1888,27,50-100,1915,0.7714819435699825
SIM,1844,86,na,1930,156
STAT,1844,46,50-100,1890,0.19085858481424572
SIM,1891,21,20-24,1912,104
STAT,1934,15,40-44,1949,1.9383271530294726
STAT,1866,29,40-44,1895,2.7985902764879995
SIM,1838,29,30-34,1867,37
STAT,1898,25,20-24,1923,16.293950659918206
STAT,1827,50,25-29,1877,0.003993246215840933
STAT,1911,27,15-19,1938,0.7022491749972527
STAT,1809,57,na,1866,1355.2119833114848
SIM,1938,26,30-34,1964,52
SIM,1805,58,na,1863,996
SIM,1908,19,20-24,1927,23
STAT,1806,102,na,1908,0.10417502888119973
STAT,1867,67,na,1934,1518.2133839097423
STAT,1916,20,30-34,1936,30.917135820651254
STAT,1785,109,na,1894,5.321205485700371E-4
STAT,1891,55,na,1946,2611.517971272954
SIM,1885,15,na,1900,2555
STAT,1879,30,45-49,1909,1.8744807110533748
STAT,1912,37,25-29,1949,0.9803319878265845
STAT,1816,38,50-100,1854,3.7592793118146406
STAT,1924,29,na,1953,4418.302074832319
STAT,1932,11,na,1943,5358.618850818077
SIM,1864,15,15-19,1879,8
STAT,1859,48,na,1907,1809.947499449979
STAT,1872,22,50-100,1894,0.416937005828185
SIM,1874,52,na,1926,2226
SIM,1913,47,35-39,1960,1
SIM,1848,42,25-29,1890,2
SIM,1848,20,na,1868,2098
STAT,1850,42,15-19,1892,0.010375031432403075
SIM,1852,31,35-39,1883,6
SIM,1907,26,na,1933,3562
STAT,1791,100,na,1891,0.1873145875206908
STAT,1812,62,na,1874,1025.084887211069
SIM,1854,45,50-100,1899,1
STAT,1851,90,na,1941,65.04483810643356
STAT,1794,79,na,1873,294.95626911190163
SIM,1924,20,30-34,1944,43
STAT,1907,28,50-100,1935,0.954814069225289
STAT,1903,25,15-19,1928,0.6624070912835546
STAT,1878,51,35-39,1929,0.009185365379499481
STAT,1833,30,20-24,1863,2.359503852677983
STAT,1933,23,35-39,1956,12.733084476377321
SIM,1892,41,40-44,1933,5
STAT,1893,40,20-24,1933,0.20760116847215448
SIM,1836,35,na,1871,2001
SIM,1825,72,na,1897,677
STAT,1905,47,35-39,1952,0.11581002345774817
SIM,1917,30,40-44,1947,1
STAT,1818,50,25-29,1868,0.008023094871212473
SIM,1795,79,na,1874,323
SIM,1890,1,na,1891,3531
STAT,1889,14,na,1903,3243.796908705911
SIM,1857,25,25-29,1882,47
SIM,1930,6,na,1936,5809
STAT,1853,38,na,1891,1965.6853621563705
STAT,1880,92,na,1972,184.72624345321196
STAT,1884,41,40-44,1925,2.2804269118742946
SIM,1911,25,15-19,1936,1
STAT,1875,41,15-19,1916,0.014524462462513049
STAT,1846,44,15-19,1890,0.0097424061818442
STAT,1885,41,25-29,1926,0.6565310782453114
STAT,1948,16,30-34,1964,14.235564405038431
STAT,1851,42,40-44,1893,1.853407001445261
SIM,1905,27,30-34,1932,48
STAT,1838,49,na,1887,1657.6528868751811
STAT,1863,43,50-100,1906,0.9381191372392491
SIM,1806,80,na,1886,313
STAT,1777,94,na,1871,4.866129901125919
STAT,1920,36,20-24,1956,0.29480613808718803
STAT,1868,15,na,1883,2535.2009496103947
SIM,1904,35,25-29,1939,4
STAT,1799,78,na,1877,308.027944013759
SIM,1871,60,na,1931,1737
STAT,1932,33,na,1965,5124.173496226259
SIM,1884,20,25-29,1904,70
STAT,1901,34,na,1935,3375.1157142810407
STAT,1881,24,15-19,1905,3.2333837932648857
SIM,1874,74,na,1948,1068
STAT,1895,20,35-39,1915,7.813430717060124
STAT,1787,94,na,1881,5.039486884922739
STAT,1865,51,25-29,1916,0.0032952512025084904
SIM,1943,20,40-44,1963,6
STAT,1891,33,na,1924,3001.187255476606
STAT,1914,30,na,1944,3915.484196028474
STAT,1918,21,50-100,1939,0.7263841519881629
STAT,1886,43,50-100,1929,1.1325288677174832
STAT,1909,30,40-44,1939,3.839185429904928
SIM,1820,73,na,1893,826
STAT,1856,15,15-19,1871,5.6861995283467035
SIM,1880,38,30-34,1918,8
STAT,1934,4,na,1938,5567.451181590616
STAT,1790,98,na,1888,0.6380394346865412
SIM,1856,71,na,1927,1268
SIM,1868,67,na,1935,1619
SIM,1898,26,25-29,1924,88
STAT,1902,24,45-49,1926,0.9969183463954671
STAT,1831,109,na,1940,4.7939666385045523E-4
STAT,1915,41,20-24,1956,0.018169678364351485
SIM,1922,15,na,1937,4360
STAT,1871,19,na,1890,2538.500344634712
SIM,1785,80,na,1865,187
SIM,1874,89,na,1963,195
STAT,1889,42,20-24,1931,0.19988084095901443
STAT,1867,50,20-24,1917,7.168847848259724E-4
SIM,1937,14,na,1951,4588
STAT,1844,31,35-39,1875,9.482345852977142
STAT,1844,40,25-29,1884,0.5228680655838619
STAT,1772,95,na,1867,1.3449029123367113
STAT,1938,17,25-29,1955,43.60654365083142
STAT,1834,40,15-19,1874,0.011494401035105717
STAT,1828,49,na,1877,1338.215431225264
STAT,1800,77,na,1877,418.95169744626344
STAT,1874,22,na,1896,2463.3444096839785
STAT,1889,36,na,1925,2983.1589517259254
SIM,1927,19,30-34,1946,21
SIM,1872,23,na,1895,2463
STAT,1916,0,na,1916,4861.748959904576
SIM,1957,5,na,1962,5610
SIM,1851,40,40-44,1891,7
STAT,1879,19,25-29,1898,6.010338223018532
SIM,1836,57,na,1893,1583
SIM,1873,2,na,1875,3246
SIM,1852,40,25-29,1892,2
STAT,1918,7,na,1925,4439.947662777254
STAT,1937,33,20-24,1970,2.4599876891787344
SIM,1919,11,na,1930,4532
SIM,1946,17,25-29,1963,1
STAT,1853,16,na,1869,2329.037359012574
STAT,1861,89,na,1950,88.55678249103272
SIM,1800,59,na,1859,922
SIM,1892,8,na,1900,3814
STAT,1878,2,na,1880,3440.2238883045584
STAT,1861,47,45-49,1908,0.19801303403795564
STAT,1818,72,na,1890,643.5924605656885
SIM,1833,31,25-29,1864,13
SIM,1930,25,25-29,1955,99
STAT,1857,27,25-29,1884,34.71393632436113
SIM,1870,38,na,1908,2591
STAT,1919,51,na,1970,4014.49849891777
STAT,1825,52,40-44,1877,0.013055018621602419
STAT,1848,41,20-24,1889,0.1248884706209576
SIM,1893,66,na,1959,2281
STAT,1931,37,35-39,1968,3.2669287118046535
STAT,1904,37,25-29,1941,0.9085999559228625
SIM,1891,37,na,1928,2993
STAT,1899,14,na,1913,3596.007537606453
STAT,1892,22,25-29,1914,73.19205719518013
STAT,1939,29,35-39,1968,15.381740979179463
STAT,1873,50,20-24,1923,7.741602186496214E-4
SIM,1857,36,50-100,1893,2
SIM,1916,28,45-49,1944,4
STAT,1883,17,25-29,1900,5.672199315494804
SIM,1931,17,30-34,1948,21
SIM,1880,21,45-49,1901,1
STAT,1846,48,30-34,1894,0.06835398764566229
STAT,1783,110,na,1893,5.117149303946575E-4
SIM,1891,39,45-49,1930,5
SIM,1939,31,30-34,1970,3
SIM,1801,81,na,1882,208
SIM,1889,66,na,1955,2255
SIM,1853,68,na,1921,1183
SIM,1865,23,50-100,1888,2
STAT,1921,30,40-44,1951,4.4796530636026395
SIM,1912,37,25-29,1949,2
STAT,1852,106,na,1958,0.018621129804787025
STAT,1849,23,na,1872,1992.529302567263
STAT,1857,23,50-100,1880,0.372378799897984
SIM,1890,52,na,1942,2786
STAT,1943,22,40-44,1965,3.6497612975179123
SIM,1879,26,15-19,1905,3
SIM,1874,36,40-44,1910,8
STAT,1825,31,25-29,1856,22.170612147361123
SIM,1907,16,35-39,1923,2
STAT,1855,23,na,1878,1922.4367945438364
STAT,1875,15,25-29,1890,5.960691227221125
SIM,1896,3,na,1899,3619
SIM,1902,22,45-49,1924,1
STAT,1923,17,30-34,1940,14.603189687701546
STAT,1868,49,20-24,1917,0.011448280072408059
STAT,1849,25,25-29,1874,39.49522202511877
STAT,1926,42,35-39,1968,0.25324739623360315
STAT,1904,52,na,1956,3150.1261892639473
STAT,1834,24,na,1858,1893.950582976229
STAT,1887,29,na,1916,2708.6160518378283
STAT,1931,34,50-100,1965,1.103460029180871
STAT,1915,18,35-39,1933,0.8938387564311884
SIM,1867,22,50-100,1889,3
STAT,1935,20,40-44,1955,4.67257817402041
STAT,1819,57,na,1876,1333.039606251949
STAT,1870,28,50-100,1898,0.6356958035121378
SIM,1841,33,25-29,1874,13
STAT,1957,5,na,1962,5286.821546694605
STAT,1852,53,na,1905,1706.7446306351208
STAT,1948,18,50-100,1966,0.43730598717424674
SIM,1870,30,25-29,1900,15
STAT,1795,97,na,1892,0.9610963244041966
STAT,1871,42,35-39,1913,1.8276190539891908
STAT,1899,30,20-24,1929,3.8064439159340906
STAT,1881,41,15-19,1922,0.013681951612849512
STAT,1888,51,na,1939,2609.2597683220633
STAT,1870,21,35-39,1891,5.837076194553383
STAT,1873,2,na,1875,3403.742106249681
STAT,1946,19,25-29,1965,49.006260782625155
SIM,1845,49,na,1894,1724
SIM,1900,31,na,1931,3404
SIM,1893,36,50-100,1929,4
SIM,1850,61,na,1911,1397
SIM,1923,18,35-39,1941,6
STAT,1921,46,15-19,1967,4.248101745229668E-4
STAT,1908,28,45-49,1936,1.6595005706137975
SIM,1879,17,25-29,1896,17
STAT,1885,36,50-100,1921,1.255584801005524
SIM,1889,43,25-29,1932,1
STAT,1852,33,35-39,1885,8.35977152098453
STAT,1859,22,50-100,1881,0.3447029466272133
STAT,1917,44,na,1961,3942.066544487188
STAT,1923,43,20-24,1966,0.02102720924447551
SIM,1859,22,30-34,1881,26
STAT,1939,28,na,1967,3839.9768169244685
STAT,1802,84,na,1886,101.54488874122293
STAT,1884,51,35-39,1935,0.008730547194721319
SIM,1822,34,50-100,1856,1
STAT,1921,41,20-24,1962,0.020327052875782993
SIM,1855,9,na,1864,2250
SIM,1938,28,50-100,1966,1
STAT,1792,83,na,1875,120.13491680461732
STAT,1843,38,na,1881,1999.6190141630343
SIM,1906,32,30-34,1938,20
STAT,1882,41,na,1923,2307.481417300915
STAT,1870,51,40-44,1921,0.010549065059282525
SIM,1804,95,na,1899,13
STAT,1771,84,na,1855,92.2602
SIM,1915,30,na,1945,4305
SIM,1860,38,na,1898,2021
STAT,1813,47,50-100,1860,0.6172625783286144
STAT,1822,54,30-34,1876,0.007840100312480608
STAT,1867,52,na,1919,2051.179053975157
STAT,1913,49,35-39,1962,0.12762588483090376
STAT,1915,15,na,1930,4144.146262195437
SIM,1857,34,na,1891,1955
SIM,1899,31,25-29,1930,20
STAT,1822,39,na,1861,1636.0689722824366
SIM,1850,16,25-29,1866,1
STAT,1804,58,na,1862,1038.4811098923592
SIM,1819,87,na,1906,67
STAT,1919,45,20-24,1964,0.012289398257486647
SIM,1915,28,50-100,1943,1
STAT,1859,51,25-29,1910,0.002899538024514021
STAT,1851,51,30-34,1902,0.004934453852838035
SIM,1882,23,na,1905,2445
STAT,1934,18,45-49,1952,0.6872527327783079
STAT,1932,18,50-100,1950,0.5046078986425991
STAT,1941,31,20-24,1972,2.614196331303653
STAT,1956,16,30-34,1972,16.454066315323544
SIM,1839,37,25-29,1876,3
SIM,1884,52,na,1936,2243
STAT,1851,21,25-29,1872,56.808071370135806
SIM,1878,25,45-49,1903,1
SIM,1858,19,na,1877,2248
STAT,1922,25,25-29,1947,76.51150280056265
STAT,1860,30,15-19,1890,0.11882034063274735
SIM,1875,15,na,1890,2577
STAT,1873,74,na,1947,1147.798369238068
SIM,1838,42,na,1880,1637
STAT,1842,16,25-29,1858,5.7403294480411455
STAT,1900,33,25-29,1933,14.421411453617129
STAT,1819,35,na,1854,1754.440351960951
SIM,1912,17,20-24,1929,29
STAT,1841,54,40-44,1895,0.007559362457730335
SIM,1815,43,25-29,1858,3
SIM,1860,42,25-29,1902,1
STAT,1858,37,na,1895,1906.003599595354
STAT,1892,43,40-44,1935,2.8550639469015238
STAT,1904,17,20-24,1921,25.920279976759414
STAT,1900,71,na,1971,2302.59443523255
SIM,1860,33,35-39,1893,20
STAT,1813,49,30-34,1862,0.23525806544693287
STAT,1920,48,na,1968,4132.7662554302315
SIM,1835,48,50-100,1883,1
SIM,1882,34,25-29,1916,12
STAT,1837,38,na,1875,1720.640526878894
STAT,1874,34,25-29,1908,10.57696817099093
SIM,1850,38,45-49,1888,3
STAT,1918,16,45-49,1934,0.11159350118958769
SIM,1900,53,na,1953,2899
STAT,1897,16,15-19,1913,8.114825713928694
STAT,1917,32,40-44,1949,4.181844391875133
SIM,1929,15,25-29,1944,79
SIM,1925,32,40-44,1957,5
SIM,1820,47,na,1867,1620
STAT,1837,50,35-39,1887,0.005993609334038003
SIM,1926,16,45-49,1942,1
STAT,1820,46,45-49,1866,0.43679939453109046
STAT,1887,49,30-34,1936,0.06111555412348886
STAT,1852,75,na,1927,829.3363358727962
SIM,1817,43,na,1860,1407
SIM,1887,30,45-49,1917,2
STAT,1902,45,na,1947,3269.59984488191
SIM,1865,85,na,1950,119
STAT,1865,40,45-49,1905,1.399726026917812
STAT,1868,41,25-29,1909,0.6285279772224672
STAT,1893,28,35-39,1921,12.443171937511824
SIM,1825,57,na,1882,1198
SIM,1837,47,30-34,1884,1
STAT,1921,45,25-29,1966,0.061308207225298374
STAT,1923,44,na,1967,4414.22584923869
SIM,1933,21,25-29,1954,123
SIM,1867,43,25-29,1910,1
SIM,1881,42,50-100,1923,1
STAT,1889,67,na,1956,2025.939278147301
SIM,1898,18,35-39,1916,2
SIM,1827,34,40-44,1861,2
STAT,1896,29,15-19,1925,0.606928621992917
SIM,1806,74,na,1880,585
SIM,1892,44,45-49,1936,1
SIM,1802,60,na,1862,960
STAT,1840,89,na,1929,75.59629873837974
STAT,1941,15,30-34,1956,12.815178292429918
STAT,1866,21,20-24,1887,65.84684527212566
STAT,1829,38,15-19,1867,0.04844486022422472
SIM,1848,24,30-34,1872,26
SIM,1870,36,50-100,1906,2
STAT,1869,54,20-24,1923,7.06796971403857E-4
STAT,1882,49,40-44,1931,0.16659907466047869
SIM,1887,40,45-49,1927,3
STAT,1871,100,na,1971,8.693771325568864
STAT,1848,69,na,1917,1140.7700676757192
SIM,1874,21,20-24,1895,60
SIM,1791,71,na,1862,562
SIM,1915,30,20-24,1945,6
SIM,1860,40,35-39,1900,4
STAT,1849,24,25-29,1873,52.964366021688896
SIM,1823,51,50-100,1874,1
SIM,1834,93,na,1927,13
STAT,1871,57,na,1928,2030.7816229988368
SIM,1873,40,45-49,1913,1
STAT,1845,48,25-29,1893,0.04444008682650967
STAT,1897,50,na,1947,2979.2870770979084
SIM,1881,25,30-34,1906,30
STAT,1925,21,25-29,1946,113.14465145387076
SIM,1842,25,na,1867,2037
STAT,1882,17,20-24,1899,17.619976538210768
STAT,1813,42,20-24,1855,0.5780331147872624
STAT,1850,48,35-39,1898,0.1039854692964376
STAT,1826,37,35-39,1863,6.3198023795884914
STAT,1843,34,30-34,1877,16.596338930144253
STAT,1777,104,na,1881,0.03950155015191052
STAT,1923,31,15-19,1954,0.15092351087756128
SIM,1812,45,50-100,1857,2
SIM,1855,8,na,1863,2273
STAT,1847,38,35-39,1885,5.663520138656535
STAT,1858,75,na,1933,832.842715924209
SIM,1843,35,35-39,1878,11
STAT,1852,74,na,1926,894.0474934486064
STAT,1873,19,20-24,1892,18.237395465819752
SIM,1855,38,35-39,1893,8
SIM,1910,14,na,1924,3962
STAT,1894,14,na,1908,3377.844616323184
SIM,1919,23,15-19,1942,10
STAT,1871,35,20-24,1906,0.7863596814841133
SIM,1877,70,na,1947,1332
STAT,1852,32,30-34,1884,14.563225408070354
STAT,1840,26,30-34,1866,22.757444819129486
SIM,1853,43,50-100,1896,1
STAT,1898,28,na,1926,3280.744902734519
SIM,1851,34,30-34,1885,23
SIM,1897,24,50-100,1921,1
SIM,1860,32,30-34,1892,19
SIM,1834,37,35-39,1871,3
STAT,1835,35,35-39,1870,6.6545343285853615
STAT,1893,20,25-29,1913,74.52623441685351
STAT,1845,42,40-44,1887,1.7896589757124448
STAT,1855,21,45-49,1876,0.6360781547826146
STAT,1781,106,na,1887,0.012396753192859065
SIM,1856,33,na,1889,2382
SIM,1839,26,30-34,1865,33
SIM,1874,58,na,1932,2018
STAT,1880,33,20-24,1913,2.8855304752162656
SIM,1870,44,na,1914,2527
SIM,1866,22,25-29,1888,73
STAT,1864,35,30-34,1899,4.880278294781071
STAT,1887,56,na,1943,2331.5737424591966
SIM,1835,40,25-29,1875,1
SIM,1914,31,50-100,1945,4
STAT,1879,21,na,1900,2529.5954922343462
STAT,1867,38,35-39,1905,6.740362321216224
STAT,1898,17,30-34,1915,2.1988264544491853
SIM,1925,20,35-39,1945,18
STAT,1817,53,45-49,1870,0.030469811644966923
STAT,1886,43,40-44,1929,2.4112501956975
STAT,1861,32,25-29,1893,8.6341901539729
STAT,1932,17,na,1949,4970.480246371465
SIM,1912,27,50-100,1939,1
SIM,1825,44,30-34,1869,1
SIM,1907,31,25-29,1938,11
STAT,1894,31,25-29,1925,13.495458436026158
STAT,1847,29,20-24,1876,10.83850246036995
STAT,1883,42,na,1925,2310.6228551733325
STAT,1891,61,na,1952,2360.082875116153
STAT,1871,17,45-49,1888,0.06643631706449875
STAT,1912,47,25-29,1959,0.05200498289984685
SIM,1837,42,na,1879,1556
STAT,1880,28,25-29,1908,45.1887495447334
STAT,1884,44,45-49,1928,1.4901435521327056
SIM,1808,47,35-39,1855,1
STAT,1803,73,na,1876,583.7269142028289
STAT,1861,25,35-39,1886,8.311762014733802
STAT,1879,40,45-49,1919,1.612053448357309
STAT,1851,45,45-49,1896,0.1966452181727154
STAT,1819,52,40-44,1871,0.02005796843257253
STAT,1858,22,25-29,1880,53.13664788062396
SIM,1889,25,30-34,1914,42
SIM,1936,33,50-100,1969,1
STAT,1876,40,20-24,1916,0.1689864147367211
SIM,1949,20,20-24,1969,192
STAT,1933,16,35-39,1949,5.742544369448766
STAT,1922,20,45-49,1942,1.3244400829090917
STAT,1824,63,na,1887,1009.2761264737426
SIM,1855,29,20-24,1884,6
SIM,1858,43,30-34,1901,2
SIM,1888,28,20-24,1916,9
STAT,1807,87,na,1894,74.45458093956309
STAT,1798,93,na,1891,10.060206373026825
STAT,1829,47,30-34,1876,0.0783394394106879
SIM,1846,19,na,1865,2281
STAT,1843,50,35-39,1893,0.007049733560406508
SIM,1919,41,45-49,1960,3
STAT,1866,98,na,1964,10.596344123278957
SIM,1875,38,35-39,1913,12
STAT,1827,40,25-29,1867,0.7901023024942552
STAT,1859,43,25-29,1902,0.5193956449306885
STAT,1817,44,30-34,1861,2.671311809133186
SIM,1916,25,50-100,1941,1
SIM,1941,16,35-39,1957,5
SIM,1924,34,na,1958,4516
SIM,1903,37,25-29,1940,1
SIM,1890,18,35-39,1908,1
STAT,1853,26,40-44,1879,2.930824102162436
STAT,1862,39,15-19,1901,0.04827382902054582
STAT,1866,94,na,1960,35.72671255173042
SIM,1816,80,na,1896,266
STAT,1780,83,na,1863,118.56117187554337
STAT,1830,34,20-24,1864,2.4969624225362046
STAT,1886,25,40-44,1911,3.256591050734581
SIM,1892,35,30-34,1927,9
STAT,1840,19,40-44,1859,0.16840625215304267
STAT,1896,38,30-34,1934,7.145208105216445
STAT,1836,29,45-49,1865,0.8815163234100106
STAT,1859,49,50-100,1908,0.1959161846471816
STAT,1858,40,25-29,1898,0.5247520085575265
SIM,1920,29,25-29,1949,87
STAT,1911,59,na,1970,3336.029351339466
SIM,1861,26,40-44,1887,3
STAT,1884,35,30-34,1919,5.4301356851535365
STAT,1917,20,35-39,1937,10.273375690664656
SIM,1916,49,50-100,1965,1
STAT,1855,28,15-19,1883,0.36396624525125293
SIM,1821,37,25-29,1858,2
STAT,1912,29,25-29,1941,65.6956007702171
SIM,1894,25,40-44,1919,5
STAT,1886,49,25-29,1935,0.060898546884273784
STAT,1896,22,45-49,1918,0.9395386246642693
STAT,1830,31,40-44,1861,4.219559177324493
SIM,1840,24,30-34,1864,2
SIM,1861,30,25-29,1891,5
STAT,1928,41,45-49,1969,0.21672673708156992
STAT,1833,71,na,1904,876.5578279924853
SIM,1911,29,30-34,1940,38
STAT,1831,40,15-19,1871,0.012020994066142826
STAT,1818,42,25-29,1860,1.6442202623610083
STAT,1912,15,50-100,1927,0.07764341088984987
STAT,1844,50,25-29,1894,0.002784189270171141
STAT,1807,101,na,1908,0.24114741412398105
STAT,1876,36,35-39,1912,7.486684526411867
STAT,1843,43,45-49,1886,1.228139820846669
STAT,1869,49,25-29,1918,0.055546230918598775
STAT,1892,19,na,1911,3211.8265025251794
STAT,1838,55,na,1893,1519.256994461818
SIM,1827,29,45-49,1856,1
SIM,1906,28,35-39,1934,27
SIM,1936,23,na,1959,3150
STAT,1907,23,30-34,1930,26.598342991774313
STAT,1878,83,na,1961,610.0846776682406
SIM,1875,30,25-29,1905,3
STAT,1873,36,na,1909,2448.396221573917
STAT,1778,89,na,1867,23.4454304442363
STAT,1911,27,na,1938,3726.496132158201
STAT,1947,18,30-34,1965,14.004111417310735
STAT,1881,31,15-19,1912,0.1410274524948951
STAT,1879,46,30-34,1925,0.10351623397436531
STAT,1899,20,20-24,1919,96.84305951798984
SIM,1851,43,45-49,1894,4
SIM,1887,46,30-34,1933,1
SIM,1817,58,na,1875,1099
SIM,1822,36,30-34,1858,5
SIM,1854,102,na,1956,2
SIM,1876,69,na,1945,1646
SIM,1887,40,50-100,1927,1
STAT,1770,109,na,1879,0.0019504701295585557
STAT,1835,42,25-29,1877,0.573521297845522
SIM,1837,31,45-49,1868,2
STAT,1839,32,15-19,1871,0.12094724404927042
STAT,1814,40,15-19,1854,0.05228503730699501
SIM,1884,36,35-39,1920,14
STAT,1829,31,45-49,1860,1.6633311018818169
SIM,1905,31,na,1936,3485
STAT,1853,30,25-29,1883,9.029877495085351
STAT,1874,54,30-34,1928,0.0060294539888120155
STAT,1933,20,20-24,1953,151.3149666948328
STAT,1857,16,30-34,1873,1.5013731838600577
STAT,1903,36,na,1939,3460.087767868842
STAT,1903,29,30-34,1932,36.25690068560872
SIM,1959,7,na,1966,5722
STAT,1862,33,50-100,1895,0.7923099503794008
STAT,1828,27,45-49,1855,1.6296048942355053
STAT,1848,26,30-34,1874,23.537521119790238
STAT,1895,44,20-24,1939,0.014480655537967109
STAT,1905,15,na,1920,3738.3767752322574
SIM,1932,23,30-34,1955,46
STAT,1849,17,35-39,1866,0.5243673825567203
STAT,1854,17,45-49,1871,0.059805805156752205
SIM,1867,36,35-39,1903,13
STAT,1885,21,na,1906,2414.3635534853825
STAT,1781,102,na,1883,0.08038080225944845
STAT,1828,53,20-24,1881,4.972604339552256E-4
STAT,1913,46,30-34,1959,0.08898515128440153
STAT,1819,72,na,1891,744.5485673302738
SIM,1865,53,na,1918,1997
SIM,1872,40,50-100,1912,2
SIM,1836,27,45-49,1863,1
STAT,1933,29,50-100,1962,1.3464812648663085
STAT,1841,90,na,1931,58.212142902141146
STAT,1860,21,25-29,1881,49.19835698924472
SIM,1887,22,45-49,1909,1
SIM,1852,32,25-29,1884,17
SIM,1857,17,35-39,1874,1
SIM,1898,25,25-29,1923,87
STAT,1782,94,na,1876,3.9969757235325902
STAT,1847,91,na,1938,45.188461638897
STAT,1924,23,30-34,1947,34.49417520278108
STAT,1834,45,45-49,1879,0.1898918562242841
STAT,1879,22,45-49,1901,0.743592346676601
SIM,1941,20,20-24,1961,108
SIM,1893,26,35-39,1919,24
STAT,1840,17,15-19,1857,5.529122454062282
SIM,1793,78,na,1871,224
SIM,1859,85,na,1944,296
SIM,1896,36,30-34,1932,2
STAT,1891,49,35-39,1940,0.09765852588987052
SIM,1932,18,35-39,1950,4
STAT,1833,53,30-34,1886,0.0039782439494923695
STAT,1890,17,30-34,1907,1.9880921086072811
STAT,1869,44,50-100,1913,1.02646346225225
STAT,1963,1,na,1964,5101.433303739473
SIM,1866,39,na,1905,2312
STAT,1865,8,na,1873,2574.7222253012255
SIM,1863,90,na,1953,14
SIM,1912,49,na,1961,3652
SIM,1859,53,na,1912,1983
SIM,1848,35,50-100,1883,5
STAT,1891,30,45-49,1921,2.2201473905165714
STAT,1913,39,40-44,1952,1.4919336366377014
SIM,1836,48,25-29,1884,1
STAT,1879,37,na,1916,2512.308037369293
SIM,1826,94,na,1920,6
SIM,1846,21,45-49,1867,1
STAT,1862,37,na,1899,2045.9306498734368
STAT,1903,36,20-24,1939,0.24244108051012347
SIM,1853,27,45-49,1880,4
SIM,1846,45,30-34,1891,2
SIM,1868,35,40-44,1903,8
STAT,1882,6,na,1888,2624.780235716543
STAT,1895,18,45-49,1913,0.0867171732840093
SIM,1831,26,30-34,1857,29
STAT,1839,92,na,1931,28.744127903474475
STAT,1895,39,25-29,1934,3.7936731383620734
SIM,1831,57,na,1888,1300
SIM,1903,25,50-100,1928,5
STAT,1907,47,45-49,1954,0.19847455263106611
SIM,1907,23,50-100,1930,1
STAT,1875,46,45-49,1921,0.2477960617917577
SIM,1927,31,50-100,1958,1
STAT,1939,19,35-39,1958,4.281918305807874
STAT,1819,88,na,1907,80.93650553242958
STAT,1851,27,50-100,1878,0.6179305133817655
STAT,1885,26,35-39,1911,9.854176040204567
SIM,1921,39,40-44,1960,6
SIM,1818,39,45-49,1857,2
SIM,1906,15,30-34,1921,3
STAT,1845,27,45-49,1872,1.055941173098987
STAT,1924,18,35-39,1942,5.0847492304648885
SIM,1915,23,30-34,1938,44
SIM,1840,93,na,1933,12
STAT,1838,21,45-49,1859,0.6695399480669726
STAT,1860,34,30-34,1894,14.327927677755506
STAT,1809,45,35-39,1854,0.6439051814883685
STAT,1872,41,15-19,1913,0.014183467024391543
SIM,1898,30,20-24,1928,3
SIM,1893,33,25-29,1926,13
STAT,1892,46,45-49,1938,0.1706900788649756
STAT,1907,30,20-24,1937,2.343552585948585
SIM,1913,50,na,1963,3723
STAT,1871,41,na,1912,2346.1325824340515
STAT,1823,102,na,1925,0.16316737965349415
STAT,1899,46,30-34,1945,0.07649567226540463
SIM,1857,24,25-29,1881,71
STAT,1867,36,na,1903,2267.2541887174098
STAT,1924,30,20-24,1954,2.9164630359621593
STAT,1849,42,25-29,1891,0.49793158954267286
STAT,1881,27,30-34,1908,24.836338682328552
SIM,1888,33,15-19,1921,1
STAT,1862,50,45-49,1912,0.012783685208373731
SIM,1826,35,35-39,1861,8
STAT,1934,12,na,1946,5465.488448726233
STAT,1937,31,45-49,1968,1.5889160790980168
STAT,1811,92,na,1903,18.04079392909603
STAT,1838,45,30-34,1883,0.0750712084882832
SIM,1882,16,30-34,1898,3
STAT,1791,67,na,1858,662.4496999416482
STAT,1885,33,25-29,1918,10.380713227725895
STAT,1899,15,25-29,1914,7.953027972979098
STAT,1874,16,30-34,1890,1.6641908804984795
STAT,1823,52,30-34,1875,0.008615407832849788
STAT,1839,50,45-49,1889,0.010264883138737121
SIM,1898,15,30-34,1913,5
SIM,1950,21,25-29,1971,139
STAT,1821,44,20-24,1865,0.2583045366789089
STAT,1841,16,20-24,1857,16.982571608831318
SIM,1857,21,20-24,1878,69
STAT,1879,29,15-19,1908,0.4803501063664916
STAT,1866,24,25-29,1890,53.52920055413166
STAT,1901,44,45-49,1945,0.14626275104824046
SIM,1864,19,20-24,1883,25
SIM,1830,32,20-24,1862,2
STAT,1888,14,na,1902,3104.4751654692277
SIM,1877,25,40-44,1902,6
SIM,1929,20,20-24,1949,194
STAT,1846,38,15-19,1884,0.04150235887641147
SIM,1848,27,35-39,1875,13
SIM,1865,24,30-34,1889,22
SIM,1836,25,na,1861,2193
SIM,1860,54,na,1914,1876
STAT,1869,31,na,1900,2359.9026793553085
STAT,1893,41,35-39,1934,2.354061843641783
STAT,1926,26,50-100,1952,1.2214215760426186
SIM,1864,68,na,1932,1362
SIM,1842,31,25-29,1873,11
STAT,1856,19,20-24,1875,16.589938500659763
STAT,1870,22,25-29,1892,57.08891307590417
STAT,1835,32,30-34,1867,16.568635693864785
STAT,1922,27,na,1949,4325.297437855176
SIM,1844,34,40-44,1878,4
SIM,1881,28,35-39,1909,10
STAT,1942,21,25-29,1963,98.84170226999943
STAT,1918,47,20-24,1965,0.012000934556311252
STAT,1845,19,45-49,1864,0.06375183823841843
STAT,1836,34,40-44,1870,3.342095144630709
STAT,1822,32,20-24,1854,8.515451225602416
STAT,1941,18,35-39,1959,4.4080336530189035
SIM,1883,37,50-100,1920,1
STAT,1924,3,na,1927,4927.917047397738
SIM,1880,26,25-29,1906,48
SIM,1879,38,20-24,1917,1
STAT,1890,43,30-34,1933,1.4236644978689614
STAT,1867,44,45-49,1911,1.4140318205190232
STAT,1871,32,40-44,1903,4.382358837830552
STAT,1867,30,25-29,1897,9.888518447925726
STAT,1896,40,45-49,1936,0.14144308079796536
STAT,1868,51,25-29,1919,0.003467734495455867
STAT,1903,39,25-29,1942,0.89213376094675
SIM,1852,19,na,1871,2394
SIM,1875,44,45-49,1919,1
STAT,1880,5,na,1885,2888.805467207009
STAT,1863,22,na,1885,2157.5798730771767
SIM,1929,28,30-34,1957,8
STAT,1844,32,25-29,1876,9.491458485177366
STAT,1924,32,50-100,1956,0.984136021994398
STAT,1933,37,45-49,1970,0.9469520747381878
STAT,1862,16,40-44,1878,0.18298937334654117
SIM,1884,43,25-29,1927,4
STAT,1876,43,25-29,1919,0.6715804412529278
SIM,1890,20,na,1910,3296
SIM,1957,6,na,1963,5610
STAT,1865,22,15-19,1887,3.0917066352800124
STAT,1809,52,25-29,1861,0.015045157262234383
STAT,1875,22,25-29,1897,59.936765321812544
SIM,1841,31,na,1872,1931
SIM,1874,24,25-29,1898,79
SIM,1816,64,na,1880,1067
STAT,1853,49,15-19,1902,3.2839631305707793E-4
STAT,1887,44,15-19,1931,0.015573389495179078
SIM,1911,39,25-29,1950,1
STAT,1853,31,50-100,1884,0.7994176776720133
STAT,1903,20,na,1923,3450.1734992814077
STAT,1861,22,30-34,1883,15.42568807447205
STAT,1880,25,20-24,1905,12.661786041559946
STAT,1854,43,20-24,1897,0.12067024954291337
SIM,1848,10,na,1858,2381
STAT,1897,28,20-24,1925,15.945801302456296
SIM,1924,31,25-29,1955,20
STAT,1864,29,20-24,1893,10.565335941620342
SIM,1812,50,na,1862,1324
SIM,1877,44,50-100,1921,4
SIM,1839,34,30-34,1873,6
STAT,1874,49,35-39,1923,0.14277407731991804
STAT,1803,57,na,1860,1195.1937037442449
STAT,1887,28,na,1915,2718.5114334556065
STAT,1877,35,40-44,1912,4.6757628045345925
STAT,1891,65,na,1956,2161.1169763012463
SIM,1833,40,50-100,1873,6
STAT,1812,48,15-19,1860,9.305949875463575E-4
STAT,1890,25,30-34,1915,31.623409626707303
SIM,1781,81,na,1862,141
STAT,1840,29,35-39,1869,8.533469593341506
STAT,1928,28,na,1956,4705.34742859951
SIM,1928,17,30-34,1945,16
SIM,1952,19,15-19,1971,72
SIM,1934,28,na,1962,5143
STAT,1787,93,na,1880,8.232034507698287
STAT,1873,28,35-39,1901,9.94427272592945
SIM,1854,32,50-100,1886,1
STAT,1823,34,30-34,1857,36.51773079659804
STAT,1858,18,40-44,1876,0.1718305151353358
STAT,1872,21,45-49,1893,0.7151147481923521
SIM,1811,65,na,1876,761
SIM,1831,34,30-34,1865,28
STAT,1916,16,35-39,1932,0.9107396204321786
STAT,1895,47,25-29,1942,0.04304452260903792
SIM,1821,34,20-24,1855,4
SIM,1930,34,na,1964,5414
STAT,1908,25,40-44,1933,4.561978352572844
STAT,1826,50,35-39,1876,0.006758355783165231
SIM,1860,35,35-39,1895,10
STAT,1808,107,na,1915,0.001569986520692773
SIM,1800,65,na,1865,738
STAT,1780,112,na,1892,2.80847451941393E-4
STAT,1944,19,15-19,1963,49.79544777112854
SIM,1836,24,40-44,1860,2
SIM,1849,22,25-29,1871,88
STAT,1825,40,50-100,1865,1.503869136744667
STAT,1832,54,na,1886,1430.3918204761517
STAT,1857,54,30-34,1911,0.004612092774693038
SIM,1804,79,na,1883,358
SIM,1895,36,na,1931,3264
STAT,1836,26,40-44,1862,2.430277320782914
STAT,1809,58,na,1867,1328.6362763187467
STAT,1849,53,40-44,1902,0.00804202131333978
STAT,1916,31,25-29,1947,9.777582784318685
STAT,1866,17,35-39,1883,0.5299594587309637
STAT,1939,27,na,1966,3841.8208909521254
STAT,1836,52,40-44,1888,0.006630677321568065
STAT,1911,55,na,1966,3436.3253310130335
SIM,1839,37,na,1876,1874
STAT,1814,73,na,1887,586.6791591438968
STAT,1852,35,35-39,1887,5.8490926348718775
STAT,1950,20,20-24,1970,134.66873157485995
SIM,1913,44,50-100,1957,1
STAT,1834,31,25-29,1865,8.921361331461688
SIM,1852,25,35-39,1877,15
SIM,1853,96,na,1949,13
STAT,1890,76,na,1966,1535.49293806076
STAT,1908,21,25-29,1929,86.85395167824802
STAT,1834,89,na,1923,70.59780938188494
SIM,1916,21,25-29,1937,90
STAT,1768,115,na,1883,2.5766510712138866E-4
STAT,1898,44,na,1942,3156.300894197509
STAT,1843,36,50-100,1879,1.1691261042639352
STAT,1844,25,35-39,1869,9.286058270618051
SIM,1871,33,20-24,1904,5
STAT,1901,26,45-49,1927,1.5893709571956882
STAT,1881,71,na,1952,1316.4836834312632
SIM,1834,43,45-49,1877,2
SIM,1878,32,45-49,1910,2
STAT,1856,40,na,1896,1869.524623435345
STAT,1838,39,20-24,1877,0.6693809918719694
SIM,1844,26,40-44,1870,2
STAT,1870,15,35-39,1885,0.5589853134204443
SIM,1848,19,35-39,1867,1
SIM,1884,33,30-34,1917,25
SIM,1888,22,50-100,1910,4
SIM,1895,37,25-29,1932,7
STAT,1781,77,na,1858,305.2666562830068
STAT,1906,18,50-100,1924,0.07255478962036069
STAT,1934,28,na,1962,5136.808045767832
SIM,1864,27,20-24,1891,15
STAT,1900,3,na,1903,3737.97633417232
STAT,1931,34,30-34,1965,21.02722376844773
STAT,1808,52,40-44,1860,0.025123889611012182
SIM,1818,75,na,1893,430
SIM,1906,25,30-34,1931,61
STAT,1873,25,30-34,1898,26.22106285083833
STAT,1899,19,40-44,1918,0.25413978231354956
STAT,1853,29,45-49,1882,0.9673990745635139
SIM,1854,85,na,1939,205
SIM,1840,27,35-39,1867,9
SIM,1897,18,20-24,1915,31
STAT,1874,19,35-39,1893,0.5684495969786548
STAT,1889,18,20-24,1907,22.281963808926854
SIM,1890,15,30-34,1905,3
STAT,1858,101,na,1959,0.9032962924389463
STAT,1869,46,20-24,1915,0.011852457687433444
SIM,1898,22,20-24,1920,96
STAT,1856,27,20-24,1883,9.734943316629554
SIM,1924,16,35-39,1940,8
STAT,1849,32,25-29,1881,8.379374972563273
STAT,1855,37,30-34,1892,4.131479519643385
SIM,1940,25,30-34,1965,49
SIM,1914,17,30-34,1931,5
STAT,1924,26,35-39,1950,17.8960343683593
SIM,1857,32,25-29,1889,16
SIM,1861,29,45-49,1890,2
STAT,1858,45,30-34,1903,0.07909267897809487
STAT,1871,29,15-19,1900,0.4552007662190344
STAT,1876,33,30-34,1909,18.314962662114013
STAT,1882,29,na,1911,2354.957658848946
SIM,1903,29,25-29,1932,61
STAT,1831,25,25-29,1856,45.39310325857685
STAT,1872,33,15-19,1905,0.14498738869292574
STAT,1895,15,40-44,1910,0.2445770581818523
STAT,1906,17,30-34,1923,2.36665025923185
STAT,1880,9,na,1889,2798.9337915966894
SIM,1897,48,50-100,1945,1
STAT,1864,18,15-19,1882,5.535924716439266
SIM,1903,49,50-100,1952,1
SIM,1946,15,25-29,1961,53
SIM,1816,52,40-44,1868,1
STAT,1793,62,na,1855,963.4000000000001
STAT,1852,27,35-39,1879,9.053757481776623
SIM,1847,56,na,1903,1382
STAT,1792,84,na,1876,97.2251881699768
STAT,1858,7,na,1865,2339.0652919377953
STAT,1803,104,na,1907,0.025881947878458083
STAT,1875,71,na,1946,1397.5504652823395
STAT,1918,29,15-19,1947,0.761194953548342
SIM,1775,81,na,1856,115
SIM,1838,29,20-24,1867,14
SIM,1883,43,40-44,1926,1
SIM,1926,29,15-19,1955,1
STAT,1875,43,40-44,1918,2.3380036621716025
SIM,1873,22,15-19,1895,7
STAT,1869,47,na,1916,2205.5565692865093
STAT,1916,23,25-29,1939,98.46780750861538
SIM,1853,7,na,1860,2438
STAT,1938,15,25-29,1953,43.809146012219145
STAT,1888,20,45-49,1908,0.8460016927220132
STAT,1832,27,35-39,1859,8.788512253780498
STAT,1923,12,na,1935,4747.128332307915
SIM,1945,21,15-19,1966,6
SIM,1937,19,25-29,1956,62
SIM,1904,30,45-49,1934,6
SIM,1936,3,na,1939,3541
SIM,1818,36,40-44,1854,5
STAT,1846,74,na,1920,793.6339637751147
STAT,1905,44,30-34,1949,0.11603721976989918
SIM,1875,16,na,1891,2537
STAT,1910,33,na,1943,3703.637205135521
STAT,1780,99,na,1879,0.3255528482733133
SIM,1924,23,25-29,1947,123
STAT,1799,94,na,1893,6.4852602280957585
STAT,1898,25,30-34,1923,34.97543668426811
STAT,1851,37,na,1888,1964.537117398419
SIM,1896,39,35-39,1935,5
STAT,1877,27,40-44,1904,3.16956411736372
STAT,1867,51,35-39,1918,0.008284618972588505
STAT,1813,45,25-29,1858,0.1497128235747718
STAT,1848,29,35-39,1877,8.825978591828857
STAT,1880,36,25-29,1916,3.101440535079399
SIM,1906,18,35-39,1924,1
SIM,1947,16,30-34,1963,26
STAT,1834,42,40-44,1876,1.8247888755464126
STAT,1875,32,25-29,1907,10.724115865514614
SIM,1819,88,na,1907,50
SIM,1862,38,25-29,1900,2
SIM,1856,17,20-24,1873,20
STAT,1857,24,30-34,1881,14.695333221223956
SIM,1860,27,35-39,1887,20
STAT,1823,77,na,1900,481.079924201741
SIM,1946,13,na,1959,4328
SIM,1925,27,50-100,1952,5
STAT,1929,19,25-29,1948,56.10501926890879
STAT,1836,91,na,1927,36.0687251203784
STAT,1881,54,20-24,1935,7.077793822881651E-4
SIM,1843,32,30-34,1875,23
STAT,1866,47,35-39,1913,0.13112166666053285
SIM,1861,40,25-29,1901,3
SIM,1872,35,30-34,1907,9
STAT,1921,6,na,1927,4662.037316551807
STAT,1939,16,30-34,1955,12.449776956866353
STAT,1899,13,na,1912,3602.0950782887608
SIM,1842,42,40-44,1884,4
SIM,1865,31,20-24,1896,3
SIM,1883,32,25-29,1915,19
STAT,1848,17,20-24,1865,17.083558684948137
SIM,1866,45,30-34,1911,1
STAT,1859,36,35-39,1895,5.79014977079091
STAT,1864,53,30-34,1917,0.005312758357798023
STAT,1880,22,na,1902,2535.4021412040433
STAT,1932,25,30-34,1957,52.383842475375175
SIM,1932,15,30-34,1947,20
SIM,1866,70,na,1936,1540
STAT,1882,41,50-100,1923,1.0547339742133623
SIM,1884,20,na,1904,2587
STAT,1828,45,20-24,1873,0.009635259135492175
STAT,1909,45,na,1954,3475.991370039751
SIM,1822,39,35-39,1861,7
STAT,1841,48,40-44,1889,0.12536258170048956
STAT,1905,31,na,1936,3560.2554556681207
STAT,1834,93,na,1927,19.639977194787683
STAT,1849,21,20-24,1870,65.15203623935297
STAT,1850,53,30-34,1903,0.004405644834000381
SIM,1816,41,25-29,1857,3
SIM,1881,16,na,1897,2320
STAT,1861,50,25-29,1911,0.0030287116378185986
SIM,1898,33,25-29,1931,25
SIM,1870,24,40-44,1894,3
STAT,1917,12,na,1929,4336.9607038377835
STAT,1815,42,na,1857,1649.5463081743228
STAT,1862,24,40-44,1886,1.8259409020710107
STAT,1818,46,40-44,1864,0.39493033578785125
STAT,1857,31,20-24,1888,2.189491115488708
STAT,1924,15,30-34,1939,14.87758891885204
SIM,1876,53,na,1929,2416
STAT,1895,36,20-24,1931,1.03094654078631
STAT,1896,19,50-100,1915,0.06565538189296377
STAT,1831,32,15-19,1863,0.13042124735850275
SIM,1918,30,50-100,1948,4
STAT,1830,28,15-19,1858,0.4817398434565306
STAT,1918,22,45-49,1940,1.23837808084531
STAT,1901,8,na,1909,3708.4585182643473
SIM,1885,27,40-44,1912,6
STAT,1888,39,35-39,1927,8.444234653964132
STAT,1921,27,25-29,1948,74.85610017217101
STAT,1937,21,15-19,1958,5.289285439635304
STAT,1852,43,na,1895,1848.4883101344135
SIM,1940,28,na,1968,3929
STAT,1867,83,na,1950,380.2070333687978
STAT,1908,22,50-100,1930,0.6168437835093131
SIM,1865,27,35-39,1892,14
STAT,1900,17,35-39,1917,0.7758471500016785
SIM,1861,34,40-44,1895,6
STAT,1924,33,25-29,1957,10.994723164615433
STAT,1863,44,50-100,1907,0.9321902242918971
STAT,1814,44,30-34,1858,3.5907435394744898
SIM,1923,21,15-19,1944,3
STAT,1840,52,30-34,1892,0.004260639439239642
STAT,1843,35,45-49,1878,1.918125030416493
SIM,1921,21,na,1942,4713
STAT,1825,46,35-39,1871,0.18254700418452846
STAT,1916,37,45-49,1953,0.7124172497729958
SIM,1880,23,20-24,1903,63
SIM,1887,32,na,1919,2877
STAT,1860,32,40-44,1892,3.5895620705944102
STAT,1907,50,na,1957,3307.4782560077565
SIM,1891,39,35-39,1930,13
SIM,1884,41,35-39,1925,2
SIM,1833,23,25-29,1856,3
STAT,1874,50,50-100,1924,0.01595650091163637
STAT,1863,33,20-24,1896,2.4075526212411913
STAT,1903,18,15-19,1921,8.583527860293561
STAT,1951,15,40-44,1966,1.700060996929568
STAT,1907,29,50-100,1936,0.9433311312323349
STAT,1851,31,25-29,1882,8.887078955551226
STAT,1860,37,35-39,1897,5.854357931311029
STAT,1872,28,15-19,1900,0.462246075998139
STAT,1879,42,15-19,1921,0.014708050525888732
STAT,1919,38,25-29,1957,1.0783356945415616
SIM,1861,54,45-49,1915,1
STAT,1834,37,50-100,1871,1.027705374896992
SIM,1847,36,30-34,1883,1
STAT,1946,21,45-49,1967,1.277900601030152
SIM,1868,98,na,1966,6
STAT,1858,38,50-100,1896,0.9883267758674943
SIM,1851,35,45-49,1886,3
STAT,1852,37,50-100,1889,0.9944383349740544
STAT,1883,39,35-39,1922,7.008495393941291
STAT,1892,37,35-39,1929,9.04316781657498
SIM,1794,84,na,1878,118
SIM,1952,13,na,1965,4885
SIM,1911,18,15-19,1929,12
SIM,1835,71,na,1906,764
STAT,1853,34,40-44,1887,3.6677026330928384
STAT,1825,41,na,1866,1658.5111506523028
STAT,1922,32,50-100,1954,0.9531941111879939
STAT,1915,21,15-19,1936,5.631971068451093
STAT,1916,27,na,1943,3952.7234229981896
SIM,1932,33,25-29,1965,21
STAT,1951,20,35-39,1971,11.484182251755945
SIM,1838,52,na,1890,1390
SIM,1875,47,na,1922,2247
SIM,1835,19,na,1854,2071
SIM,1820,42,na,1862,1674
SIM,1856,40,45-49,1896,2
STAT,1881,35,30-34,1916,5.306363203516897
SIM,1929,23,25-29,1952,7
STAT,1918,35,50-100,1953,0.45588740117276144
SIM,1900,52,na,1952,2936
STAT,1809,50,35-39,1859,0.03806494811563462
STAT,1913,42,15-19,1955,0.0015277689051541425
STAT,1912,13,na,1925,4067.5750566096485
SIM,1837,73,na,1910,700
STAT,1857,27,35-39,1884,7.9182278205249785
STAT,1937,17,30-34,1954,12.095138259510717
STAT,1825,41,25-29,1866,0.8953223849247889
SIM,1891,28,50-100,1919,1
STAT,1898,49,50-100,1947,0.1871311371395426
STAT,1913,1,na,1914,4341.5883023875485
STAT,1851,96,na,1947,7.084141703380813
STAT,1892,71,na,1963,1937.1233708526404
SIM,1856,29,35-39,1885,15
STAT,1922,48,25-29,1970,0.062006901864840695
STAT,1911,26,50-100,1937,0.9935255572002591
STAT,1876,41,35-39,1917,1.9161957225635664
STAT,1840,58,na,1898,1423.075089841444
SIM,1856,22,15-19,1878,3
SIM,1896,28,30-34,1924,36
STAT,1837,43,20-24,1880,0.12335643735773558
SIM,1893,72,na,1965,1885
STAT,1813,56,na,1869,1134.2063758243983
STAT,1849,50,25-29,1899,0.0027893959512206665
STAT,1849,55,na,1904,1605.2912179076525
STAT,1840,25,na,1865,1969.1341809723924
SIM,1878,17,na,1895,2828
STAT,1861,95,na,1956,12.924489946490976
SIM,1945,17,30-34,1962,18
STAT,1851,36,35-39,1887,5.959332145109083
STAT,1840,53,20-24,1893,5.224794168188934E-4
STAT,1844,22,30-34,1866,17.233871405066044
SIM,1805,64,na,1869,813
STAT,1881,47,50-100,1928,0.24110044236492453
SIM,1826,67,na,1893,941
STAT,1923,43,50-100,1966,0.13987665013378564
STAT,1840,34,30-34,1874,14.988312838003194
SIM,1835,44,40-44,1879,5
SIM,1889,35,25-29,1924,3
STAT,1899,47,45-49,1946,0.18510271030412745
SIM,1870,42,40-44,1912,4
STAT,1942,27,45-49,1969,1.8499289774711054
SIM,1818,41,50-100,1859,2
SIM,1932,26,35-39,1958,41
STAT,1869,20,30-34,1889,17.723689197241473
SIM,1862,73,na,1935,1013
SIM,1956,12,na,1968,5507
STAT,1859,47,40-44,1906,0.13882894234727455
STAT,1909,20,25-29,1929,88.07722552847235
STAT,1848,22,15-19,1870,3.122468983171778
STAT,1920,32,na,1952,4227.559502964132
SIM,1889,67,na,1956,2210
SIM,1900,22,25-29,1922,3
STAT,1922,47,35-39,1969,0.1511313665301623
SIM,1879,36,30-34,1915,11
SIM,1912,24,20-24,1936,194
STAT,1862,42,40-44,1904,1.950866415667262
STAT,1852,105,na,1957,0.035857445080562725
STAT,1890,21,15-19,1911,4.127417801106097
STAT,1836,30,25-29,1866,8.228232425562341
SIM,1909,4,na,1913,3856
SIM,1872,94,na,1966,47
STAT,1880,86,na,1966,487.7142962546644
SIM,1939,31,20-24,1970,2
SIM,1851,30,na,1881,2007
STAT,1888,28,30-34,1916,30.262977829894073
STAT,1928,33,50-100,1961,1.0538574877114986
SIM,1893,65,na,1958,2362
STAT,1897,29,50-100,1926,0.8663274462413364
SIM,1843,11,na,1854,2421
STAT,1841,19,25-29,1860,5.332936622359032
SIM,1847,25,na,1872,1804
STAT,1858,43,40-44,1901,1.8065364338505723
STAT,1827,44,40-44,1871,2.566338805698117
STAT,1838,70,na,1908,1030.9117929861286
STAT,1837,105,na,1942,0.01954886991760634
STAT,1845,16,40-44,1861,0.18169690151134743
STAT,1908,49,50-100,1957,0.20736109054861598
STAT,1904,42,20-24,1946,0.016104253183776524
STAT,1925,30,35-39,1955,11.084013390697423
STAT,1826,43,45-49,1869,1.2054035728467927
SIM,1865,49,35-39,1914,1
STAT,1912,19,30-34,1931,2.5008338251168247
STAT,1910,34,45-49,1944,1.534230236502378
SIM,1889,21,15-19,1910,4
STAT,1947,19,na,1966,4227.46323763207
SIM,1820,41,na,1861,1700
SIM,1877,20,30-34,1897,31
SIM,1929,30,45-49,1959,4
STAT,1857,49,35-39,1906,0.10921176140368906
SIM,1885,46,na,1931,2287
STAT,1839,36,30-34,1875,4.441350925447381
SIM,1801,75,na,1876,452
SIM,1892,30,25-29,1922,13
SIM,1843,40,35-39,1883,1
STAT,1894,35,40-44,1929,5.798792638980099
STAT,1889,41,45-49,1930,1.8945152058750296
STAT,1918,38,na,1956,4042.5594697216857
SIM,1829,37,30-34,1866,6
STAT,1821,47,25-29,1868,0.09075628838102631
STAT,1904,49,40-44,1953,0.13824523583076148
STAT,1931,41,15-19,1972,0.002095314450145954
STAT,1842,16,35-39,1858,0.5558359258262375
STAT,1893,34,45-49,1927,2.23743983406873
STAT,1815,54,25-29,1869,0.008745521634723962
SIM,1830,39,40-44,1869,10
SIM,1920,15,50-100,1935,4
STAT,1837,69,na,1906,978.4501428222919
SIM,1844,30,25-29,1874,13
STAT,1921,34,20-24,1955,2.7461711631087278
SIM,1940,28,35-39,1968,21
STAT,1908,39,na,1947,3555.73666625369
SIM,1879,20,45-49,1899,1
STAT,1834,25,na,1859,1933.8019963394324
STAT,1835,40,35-39,1875,1.6592438491046064
STAT,1896,46,30-34,1942,0.07377877116147546
SIM,1871,54,na,1925,1944
SIM,1892,36,45-49,1928,4
STAT,1855,55,na,1910,1602.8879956386565
SIM,1831,26,na,1857,1809
SIM,1903,26,20-24,1929,22
STAT,1932,28,35-39,1960,20.044790289988047
SIM,1784,85,na,1869,114
SIM,1855,39,na,1894,1824
STAT,1877,53,40-44,1930,0.010960307035054184
STAT,1842,38,35-39,1880,6.4393877376927255
STAT,1882,45,25-29,1927,0.057818035795229664
STAT,1863,20,50-100,1883,0.3774181521696837
STAT,1912,26,20-24,1938,18.413486909791086
STAT,1892,25,50-100,1917,0.8234351164192673
SIM,1920,26,20-24,1946,20
SIM,1923,28,35-39,1951,22
SIM,1864,25,30-34,1889,27
STAT,1915,28,35-39,1943,15.571594109870588
STAT,1898,26,50-100,1924,0.885517655155345
STAT,1883,20,45-49,1903,0.7021594270743428
STAT,1921,49,40-44,1970,0.18030492452003463
SIM,1850,55,na,1905,1529
STAT,1856,25,30-34,1881,21.199671981465347
STAT,1916,20,20-24,1936,119.61279293112011
SIM,1848,20,15-19,1868,3
STAT,1797,99,na,1896,0.47690503870498163
SIM,1862,18,na,1880,2401
SIM,1919,27,30-34,1946,65
SIM,1868,27,40-44,1895,6
STAT,1868,45,40-44,1913,0.16847473115491438
SIM,1848,34,25-29,1882,5
STAT,1896,64,na,1960,2466.0537274532126
SIM,1840,54,25-29,1894,1
STAT,1892,50,na,1942,2792.5958429346465
STAT,1925,25,40-44,1950,5.654801053905455
STAT,1869,25,40-44,1894,2.9703723285104866
SIM,1850,38,35-39,1888,9
STAT,1848,17,na,1865,2211.9329773424765
SIM,1938,32,15-19,1970,1
SIM,1895,34,20-24,1929,6
STAT,1888,45,na,1933,2740.4043941036375
SIM,1897,23,15-19,1920,3
STAT,1904,24,20-24,1928,100.1238612454486
STAT,1879,40,50-100,1919,1.1379200779325387
STAT,1878,49,15-19,1927,4.158758007113065E-4
SIM,1867,24,na,1891,2136
STAT,1890,47,25-29,1937,0.04033852601835419
STAT,1910,16,45-49,1926,0.10120163884843031
SIM,1841,18,35-39,1859,1
STAT,1865,26,30-34,1891,23.396006570260646
SIM,1866,48,35-39,1914,1
SIM,1831,30,15-19,1861,1
SIM,1790,85,na,1875,57
SIM,1883,35,na,1918,2459
STAT,1833,40,na,1873,1716.1164725620044
STAT,1887,34,20-24,1921,3.0635017237508477
STAT,1888,19,15-19,1907,7.118805589892116
SIM,1810,79,na,1889,474
SIM,1935,34,na,1969,5316
STAT,1858,48,35-39,1906,0.11183794461323003
STAT,1852,40,35-39,1892,1.4735143120164318
SIM,1885,35,40-44,1920,8
SIM,1931,20,na,1951,4719
STAT,1773,86,na,1859,66.3103116752018
STAT,1904,24,50-100,1928,0.59248400412426
SIM,1903,29,na,1932,3355
STAT,1812,53,45-49,1865,0.03210791503462414
STAT,1889,23,15-19,1912,4.144398228335011
STAT,1898,35,25-29,1933,4.009726040790918
SIM,1928,31,45-49,1959,1
STAT,1832,82,na,1914,311.78342049504613
SIM,1862,40,na,1902,2130
STAT,1831,27,15-19,1858,0.44895546372886713
STAT,1858,46,45-49,1904,0.1914678839192688
STAT,1859,40,20-24,1899,0.13069291848785125
SIM,1933,25,40-44,1958,8
STAT,1880,40,35-39,1920,1.9608338683059576
SIM,1889,28,35-39,1917,17
STAT,1950,16,35-39,1966,5.063169455806345
STAT,1832,54,25-29,1886,0.0023778322560384407
STAT,1865,72,na,1937,1169.317966247752
SIM,1818,44,40-44,1862,2
SIM,1873,26,30-34,1899,3
SIM,1852,74,na,1926,837
STAT,1898,28,35-39,1926,13.264347180561359
SIM,1869,39,25-29,1908,2
STAT,1849,37,50-100,1886,0.9753460404976821
STAT,1929,22,20-24,1951,143.41881071276484
STAT,1905,40,15-19,1945,0.0014271690335901045
STAT,1903,51,na,1954,3137.4733915447005
STAT,1817,45,45-49,1862,0.5439296558368252
SIM,1941,29,50-100,1970,1
SIM,1924,20,20-24,1944,140
STAT,1861,30,35-39,1891,8.605414993149257
STAT,1922,40,15-19,1962,0.0018035337469050046
STAT,1886,71,na,1957,1504.1097589754415
STAT,1874,30,45-49,1904,1.8308983415523998
STAT,1841,44,25-29,1885,0.4802250700365389
SIM,1871,5,na,1876,2661
SIM,1869,21,35-39,1890,11
STAT,1916,31,na,1947,4000.953855740674
STAT,1821,41,40-44,1862,4.031190161565529
STAT,1857,34,25-29,1891,8.090609625697967
STAT,1930,39,40-44,1969,1.9872643143257467
SIM,1915,14,na,1929,4557
STAT,1844,55,na,1899,1602.294784447
STAT,1940,31,15-19,1971,0.13575819608510212
STAT,1929,15,30-34,1944,15.939345395516042
SIM,1869,44,20-24,1913,3
STAT,1816,48,35-39,1864,0.28327097098162507
STAT,1853,54,45-49,1907,0.011834010533687088
SIM,1895,20,na,1915,3292
STAT,1822,46,30-34,1868,0.1400618500381891
SIM,1870,20,25-29,1890,77
STAT,1928,12,na,1940,5092.51540106434
STAT,1852,33,45-49,1885,1.4395043032446722
STAT,1930,32,20-24,1962,3.210513876829522
STAT,1854,50,35-39,1904,0.006683669660562396
SIM,1860,33,45-49,1893,4
STAT,1820,97,na,1917,2.9587867045981913
STAT,1869,16,na,1885,2536.878565240552
SIM,1855,91,na,1946,38
STAT,1837,48,15-19,1885,2.7332116378968844E-4
SIM,1839,37,35-39,1876,14
SIM,1882,30,45-49,1912,1
STAT,1884,36,45-49,1920,2.021675297045619
STAT,1878,44,20-24,1922,0.16636111291976044
SIM,1859,45,40-44,1904,1
SIM,1838,35,30-34,1873,9
STAT,1872,51,na,1923,2211.99565498056
SIM,1841,19,na,1860,2110
STAT,1853,91,na,1944,48.58916825396621
STAT,1856,36,na,1892,1895.755431289441
STAT,1859,33,30-34,1892,14.164664810700685
STAT,1846,10,na,1856,2171.4141928013996
SIM,1859,37,40-44,1896,7
SIM,1835,78,na,1913,449
STAT,1875,16,na,1891,2650.8310646465766
SIM,1876,45,40-44,1921,1
SIM,1921,14,na,1935,5219
SIM,1865,34,25-29,1899,18
STAT,1853,37,45-49,1890,1.6715359844306426
STAT,1822,39,40-44,1861,7.4598774588899985
SIM,1860,24,30-34,1884,18
STAT,1837,17,45-49,1854,0.07959674234572614
STAT,1862,20,25-29,1882,51.6284363806174
SIM,1937,15,30-34,1952,15
STAT,1897,26,30-34,1923,34.466909437105606
STAT,1852,24,30-34,1876,16.802747476535906
SIM,1849,91,na,1940,37
STAT,1849,54,na,1903,1625.6655848159837
STAT,1833,48,35-39,1881,0.09745613965386081
SIM,1924,37,45-49,1961,3
STAT,1887,39,15-19,1926,0.06354608896049745
SIM,1904,20,15-19,1924,5
SIM,1825,45,45-49,1870,1
STAT,1808,46,35-39,1854,0.3862124710913166
STAT,1860,35,45-49,1895,1.6657079702940452
STAT,1863,36,25-29,1899,2.587697948085079
SIM,1844,55,na,1899,1649
SIM,1859,41,50-100,1900,2
SIM,1895,29,25-29,1924,70
STAT,1839,39,35-39,1878,5.713369836489637
STAT,1835,46,40-44,1881,0.13624296302205907
STAT,1919,35,20-24,1954,0.29060687625420273
STAT,1889,27,30-34,1916,31.732810534570216
STAT,1904,45,25-29,1949,0.047977865483781586
STAT,1907,33,25-29,1940,8.772351985580029
SIM,1892,15,50-100,1907,2
STAT,1807,56,na,1863,1283.3861740481339
SIM,1910,32,45-49,1942,1
SIM,1894,6,na,1900,3551
STAT,1843,70,na,1913,1132.6639382733276
STAT,1895,20,na,1915,3166.687780323856
STAT,1831,44,na,1875,1683.0349629564246
SIM,1851,37,35-39,1888,10
SIM,1899,45,45-49,1944,1
SIM,1891,36,30-34,1927,10
STAT,1801,78,na,1879,304.21115394853416
SIM,1861,37,45-49,1898,3
STAT,1908,35,na,1943,3626.0000054439656
STAT,1792,77,na,1869,301.1842432256074
STAT,1878,21,35-39,1899,6.2151777239462955
STAT,1879,38,30-34,1917,5.655033143899895
STAT,1779,112,na,1891,3.9854085587490195E-4
SIM,1887,38,30-34,1925,4
STAT,1920,18,15-19,1938,51.82489812540993
SIM,1888,26,30-34,1914,49
SIM,1850,92,na,1942,11
SIM,1811,64,na,1875,805
STAT,1847,84,na,1931,259.4150865047671
STAT,1845,45,20-24,1890,0.009469640004467659
SIM,1828,38,25-29,1866,7
STAT,1871,38,25-29,1909,2.8950685453208487
SIM,1838,38,35-39,1876,7
STAT,1771,108,na,1879,0.00455799916583773
STAT,1888,82,na,1970,998.4572155334364
SIM,1828,92,na,1920,52
STAT,1800,54,30-34,1854,0.02423607251205215
STAT,1930,42,15-19,1972,0.0020608068692569183
SIM,1834,34,30-34,1868,18
STAT,1778,85,na,1863,54.653760454766775
SIM,1859,84,na,1943,296
SIM,1856,40,na,1896,2255
SIM,1920,44,20-24,1964,1
STAT,1906,43,30-34,1949,0.11768680686746245
STAT,1934,20,35-39,1954,12.946627834802882
STAT,1826,34,30-34,1860,16.84438977623801
STAT,1836,49,15-19,1885,2.5398331895363667E-4
SIM,1907,37,45-49,1944,2
SIM,1859,41,25-29,1900,2
SIM,1897,27,30-34,1924,37
STAT,1902,32,45-49,1934,2.5087419522493644
STAT,1893,25,30-34,1918,32.81016142955694
STAT,1853,34,50-100,1887,0.7748987575835787
STAT,1819,41,na,1860,1699.3487706314181
STAT,1875,37,35-39,1912,7.405424139704546
STAT,1809,49,50-100,1858,1.0564091412319454
STAT,1897,29,35-39,1926,13.067423789137058
STAT,1901,46,15-19,1947,3.2279739907959017E-4
STAT,1887,29,25-29,1916,48.01055597222213
SIM,1896,46,na,1942,3077
STAT,1838,104,na,1942,0.04900799873199076
STAT,1896,42,15-19,1938,0.0012904981413821776
SIM,1885,31,25-29,1916,13
STAT,1905,20,45-49,1925,1.0335249703951326
STAT,1913,20,15-19,1933,5.293596665434466
SIM,1909,22,45-49,1931,2
STAT,1843,32,40-44,1875,4.208771097898032
SIM,1935,13,na,1948,5524
STAT,1851,40,50-100,1891,0.8803858384400293
SIM,1939,27,na,1966,3781
SIM,1851,32,40-44,1883,7
SIM,1959,3,na,1962,5723
STAT,1883,36,30-34,1919,5.36039946720997
STAT,1835,33,45-49,1868,1.6377293979803802
STAT,1922,44,30-34,1966,0.14923037987055507
SIM,1817,49,50-100,1866,1
SIM,1937,4,na,1941,4696
STAT,1882,15,30-34,1897,1.5914699116876774
STAT,1912,44,20-24,1956,0.01724117084228862
SIM,1921,32,20-24,1953,6
SIM,1942,20,35-39,1962,17
STAT,1921,17,na,1938,4281.324043150019
SIM,1843,33,45-49,1876,4
STAT,1830,37,25-29,1867,2.601308348435738
STAT,1869,16,50-100,1885,0.04921054216213881
SIM,1917,36,50-100,1953,1
SIM,1826,63,na,1889,1075
STAT,1835,26,50-100,1861,0.6259231323561196
SIM,1857,37,50-100,1894,2
SIM,1907,35,40-44,1942,2
STAT,1816,45,30-34,1861,0.20562432804232317
STAT,1867,35,30-34,1902,5.152781849475913
SIM,1869,19,20-24,1888,21
SIM,1863,58,na,1921,1645
STAT,1850,53,50-100,1903,0.011177958351604844
SIM,1866,38,50-100,1904,3
STAT,1883,51,50-100,1934,0.01518966093273744
STAT,1933,23,25-29,1956,124.91058150164291
SIM,1846,37,30-34,1883,7
SIM,1941,23,25-29,1964,6
STAT,1837,46,25-29,1883,0.040379806581421325
SIM,1930,35,na,1965,5472
STAT,1899,6,na,1905,3649.383988513375
STAT,1817,47,35-39,1864,0.3128020686155654
SIM,1889,32,20-24,1921,4
SIM,1900,15,35-39,1915,2
SIM,1861,34,50-100,1895,1
STAT,1827,47,45-49,1874,0.26504721756732563
SIM,1856,26,30-34,1882,29
STAT,1850,18,35-39,1868,0.5013930355462884
STAT,1945,25,20-24,1970,20.449926623612363
SIM,1827,52,na,1879,1295
STAT,1909,36,50-100,1945,0.40725357523158295
SIM,1923,28,na,1951,4176
SIM,1845,77,na,1922,659
STAT,1857,46,30-34,1903,0.07734135356294829
STAT,1894,38,45-49,1932,2.6029147452471744
STAT,1884,38,35-39,1922,7.10316932493915
SIM,1847,39,35-39,1886,1
SIM,1867,40,20-24,1907,1
SIM,1890,42,20-24,1932,3
STAT,1910,31,40-44,1941,3.8641574983979865
STAT,1859,17,na,1876,2170.8304639295397
STAT,1813,63,na,1876,936.9307687539441
STAT,1882,57,na,1939,1997.3256808890233
SIM,1864,28,35-39,1892,9
SIM,1854,28,25-29,1882,44
SIM,1892,38,35-39,1930,16
STAT,1817,77,na,1894,421.8514880942216
STAT,1883,35,na,1918,2380.648318327584
STAT,1936,2,na,1938,3993.6878735165574
SIM,1906,21,15-19,1927,5
SIM,1942,26,50-100,1968,1
STAT,1861,36,40-44,1897,3.7078564783730137
SIM,1842,36,35-39,1878,1
STAT,1840,96,na,1936,6.17894114020397
SIM,1855,18,15-19,1873,6
STAT,1847,18,15-19,1865,5.741979397766847
SIM,1916,46,na,1962,3830
SIM,1881,19,20-24,1900,13
SIM,1844,29,45-49,1873,2
STAT,1901,65,na,1966,2673.7897685429693
STAT,1863,47,30-34,1910,0.08617927277420273
STAT,1899,44,40-44,1943,0.2152534710126233
SIM,1832,26,na,1858,1894
SIM,1861,88,na,1949,57
STAT,1840,30,15-19,1870,0.12743458507579933
STAT,1914,41,15-19,1955,0.0015547994175056682
STAT,1856,28,35-39,1884,7.949343947901457
SIM,1798,81,na,1879,133
STAT,1864,32,na,1896,2164.5805456760245
STAT,1834,36,35-39,1870,5.982320484851641
STAT,1846,28,25-29,1874,36.333070595414576
STAT,1863,43,15-19,1906,0.012262996154129749
SIM,1865,39,40-44,1904,5
STAT,1782,105,na,1887,0.020332971680909587
STAT,1936,33,15-19,1969,0.1272284021256153
SIM,1937,18,35-39,1955,6
SIM,1898,16,na,1914,3888
STAT,1812,78,na,1890,356.37069874123534
STAT,1896,49,na,1945,2968.5906877762354
SIM,1867,33,30-34,1900,17
STAT,1870,40,25-29,1910,0.6468611153342235
SIM,1839,92,na,1931,24
STAT,1885,30,20-24,1915,2.7732297300447595
STAT,1955,15,25-29,1970,58.70620979224272
SIM,1876,32,na,1908,2849
STAT,1884,30,25-29,1914,10.420778225424376
STAT,1923,21,50-100,1944,0.7835103215306466
STAT,1821,38,15-19,1859,0.11554018589493205
STAT,1842,35,30-34,1877,5.005728931717121
STAT,1882,18,35-39,1900,0.5439204869081933
STAT,1842,44,na,1886,1827.7732122392497
SIM,1938,18,30-34,1956,18
SIM,1824,38,40-44,1862,3
SIM,1847,27,20-24,1874,15
STAT,1803,105,na,1908,0.011377445467891385
STAT,1893,21,15-19,1914,4.282310033613487
STAT,1935,29,15-19,1964,0.9803901886117483
STAT,1911,28,na,1939,3713.378865773002
STAT,1855,41,15-19,1896,0.010753795327500438
STAT,1866,42,25-29,1908,0.6035066901896716
STAT,1881,19,50-100,1900,0.04806045488456167
SIM,1891,29,40-44,1920,6
SIM,1813,60,na,1873,1083
SIM,1897,31,na,1928,3240
SIM,1798,77,na,1875,267
STAT,1883,29,40-44,1912,2.977025402386844
STAT,1921,40,45-49,1961,0.19181549023086142
SIM,1825,41,na,1866,1547
STAT,1876,34,45-49,1910,1.8212659328028438
SIM,1871,36,25-29,1907,3
SIM,1884,34,45-49,1918,2
STAT,1816,38,40-44,1854,13.403667484662376
STAT,1839,27,20-24,1866,10.199646571363763
SIM,1876,34,50-100,1910,4
SIM,1936,2,na,1938,3572
STAT,1930,17,25-29,1947,57.14127794007647
STAT,1929,18,35-39,1947,5.447628286816379
SIM,1828,37,na,1865,1818
SIM,1898,71,na,1969,2447
STAT,1868,34,50-100,1902,0.8851162988895177
SIM,1849,36,na,1885,1891
SIM,1944,27,na,1971,4057
STAT,1860,73,na,1933,983.1198077995704
SIM,1893,30,20-24,1923,4
STAT,1855,45,30-34,1900,0.07578730193571936
SIM,1881,87,na,1968,315
STAT,1798,62,na,1860,1103.5380748640061
STAT,1890,44,20-24,1934,0.1954194602307758
SIM,1831,41,na,1872,1627
SIM,1875,43,na,1918,2318
STAT,1908,30,35-39,1938,8.866699803101334
STAT,1864,54,50-100,1918,0.013322711455466145
SIM,1831,29,35-39,1860,9
STAT,1964,2,na,1966,5054.600523079533
STAT,1864,54,20-24,1918,6.509468395576786E-4
STAT,1876,47,40-44,1923,0.17950632291632287
SIM,1817,43,45-49,1860,7
STAT,1928,31,15-19,1959,0.16399277253103436
SIM,1796,70,na,1866,553
SIM,1908,32,na,1940,3939
STAT,1886,17,40-44,1903,0.1975009356734288
STAT,1940,0,na,1940,4647.3853466758665
SIM,1843,26,50-100,1869,1
SIM,1876,48,45-49,1924,1
SIM,1923,25,30-34,1948,54
STAT,1869,28,45-49,1897,1.0896976217736383
SIM,1848,31,20-24,1879,2
STAT,1838,37,30-34,1875,4.725155655200679
SIM,1848,14,na,1862,2361
STAT,1886,46,20-24,1932,0.012994535150905337
STAT,1877,31,25-29,1908,10.881844982891483
SIM,1917,20,25-29,1937,119
STAT,1907,26,35-39,1933,14.502602990731454
STAT,1868,48,45-49,1916,0.22706135616511494
STAT,1899,49,35-39,1948,0.1080175963181798
STAT,1899,23,25-29,1922,79.7232763275926
SIM,1875,35,30-34,1910,13
SIM,1916,30,35-39,1946,14
STAT,1878,15,50-100,1893,0.05226428102047268
SIM,1954,6,na,1960,4724
STAT,1865,17,na,1882,2409.746456417798
STAT,1892,32,25-29,1924,13.095803511952807
STAT,1878,47,25-29,1925,0.06087806026211733
STAT,1915,25,30-34,1940,41.0591864378396
STAT,1872,18,25-29,1890,5.778651355565413
SIM,1866,91,na,1957,57
STAT,1823,53,20-24,1876,0.0010469911745858479
STAT,1889,20,na,1909,2998.0831068098387
STAT,1865,29,35-39,1894,8.870117391433418
SIM,1879,39,35-39,1918,12
SIM,1873,17,20-24,1890,22
STAT,1829,62,na,1891,1215.5944489356093
STAT,1947,20,45-49,1967,1.2983299213771076
SIM,1912,27,25-29,1939,105
STAT,1909,39,15-19,1948,0.018351187420649596
STAT,1929,25,25-29,1954,84.33720724037504
STAT,1959,6,na,1965,5244.024986758363
SIM,1845,92,na,1937,17
SIM,1867,17,na,1884,2396
STAT,1930,35,25-29,1965,1.312132839613942
STAT,1904,27,25-29,1931,61.847461993362394
SIM,1860,20,15-19,1880,3
SIM,1874,42,25-29,1916,4
STAT,1839,24,50-100,1863,0.356435808486144
STAT,1822,42,15-19,1864,0.021502760575544476
SIM,1825,42,40-44,1867,5
SIM,1880,18,25-29,1898,10
STAT,1848,40,45-49,1888,1.192113675288413
SIM,1904,14,na,1918,4019
STAT,1913,50,na,1963,3625.108479941422
STAT,1927,36,50-100,1963,0.5329707768332603
SIM,1915,26,35-39,1941,21
STAT,1902,14,na,1916,3703.2872456165433
STAT,1862,19,45-49,1881,0.0584268470049217
SIM,1807,60,na,1867,1057
SIM,1883,37,35-39,1920,5
SIM,1844,92,na,1936,12
STAT,1899,41,25-29,1940,0.06257652176833295
SIM,1928,31,na,1959,4965
SIM,1841,15,30-34,1856,1
SIM,1953,1,na,1954,4837
STAT,1841,17,35-39,1858,0.5225253115788454
SIM,1820,78,na,1898,475
STAT,1865,51,50-100,1916,0.014050585087595036
STAT,1948,24,30-34,1972,33.64611976104711
SIM,1872,27,30-34,1899,37
STAT,1881,53,30-34,1934,0.005776602020656074
SIM,1823,93,na,1916,10
STAT,1865,17,20-24,1882,16.915252627739516
STAT,1914,22,50-100,1936,0.6858817950509678
STAT,1830,59,na,1889,1230.5989245942644
SIM,1922,22,50-100,1944,4
STAT,1909,24,na,1933,3594.6006095883185
SIM,1892,33,40-44,1925,10
SIM,1826,32,30-34,1858,18
SIM,1814,78,na,1892,459
SIM,1820,36,45-49,1856,3
STAT,1873,43,na,1916,2373.131051174827
STAT,1843,37,35-39,1880,6.665660901722758
STAT,1817,42,40-44,1859,5.655322798577953
SIM,1915,33,25-29,1948,13
STAT,1864,27,30-34,1891,22.84205583833129
STAT,1867,37,50-100,1904,1.175848175574024
STAT,1852,20,15-19,1872,3.203052967313963
STAT,1885,23,30-34,1908,18.0729455523395
STAT,1927,37,20-24,1964,0.3343257872500933
SIM,1890,21,na,1911,3070
SIM,1893,23,30-34,1916,27
SIM,1938,15,15-19,1953,41
SIM,1937,25,25-29,1962,79
STAT,1884,33,40-44,1917,4.358501738120301
STAT,1937,32,50-100,1969,0.8343699904585491
STAT,1821,82,na,1903,245.86059616164243
STAT,1822,35,25-29,1857,5.962331133967389
SIM,1850,35,30-34,1885,5
SIM,1858,44,45-49,1902,4
STAT,1923,13,na,1936,4739.770283392838
STAT,1880,45,50-100,1925,0.26591536548157635
STAT,1959,11,na,1970,5240.7744961249355
STAT,1864,37,20-24,1901,0.6992233909362315
SIM,1961,9,na,1970,5326
STAT,1788,88,na,1876,51.0581638058235
STAT,1872,26,na,1898,2448.4257410029854
SIM,1834,32,40-44,1866,5
STAT,1873,21,15-19,1894,3.42231539394383
SIM,1920,45,na,1965,3962
SIM,1905,22,25-29,1927,83
SIM,1859,26,35-39,1885,19
STAT,1815,46,25-29,1861,0.15755835904056822
STAT,1832,43,20-24,1875,0.12880942300135895
STAT,1901,28,na,1929,3392.5802802963235
SIM,1902,21,45-49,1923,2
STAT,1893,23,40-44,1916,2.688420869607605
SIM,1843,69,na,1912,1048
STAT,1914,45,30-34,1959,0.09062943322276315
SIM,1909,24,35-39,1933,7
STAT,1875,34,30-34,1909,18.123999718109204
STAT,1866,50,25-29,1916,0.003380824100145557
STAT,1927,33,na,1960,4742.835291188941
STAT,1882,37,25-29,1919,2.8615673546276557
SIM,1869,74,na,1943,925
STAT,1900,32,25-29,1932,14.48252772059805
STAT,1857,6,na,1863,2336.1419741535565
SIM,1837,33,20-24,1870,6
SIM,1926,35,50-100,1961,3
STAT,1838,33,15-19,1871,0.1286758384539901
STAT,1807,60,na,1867,1185.6400130305365
STAT,1932,36,35-39,1968,3.317268563974572
SIM,1926,21,30-34,1947,1
STAT,1826,32,40-44,1858,4.727643970042559
STAT,1850,34,25-29,1884,7.894063618156813
STAT,1870,20,35-39,1890,5.854229085774704
STAT,1937,32,20-24,1969,2.46151382775194
STAT,1876,26,45-49,1902,1.1736397822850124
SIM,1919,35,30-34,1954,3
STAT,1803,94,na,1897,7.755296911631659
STAT,1820,76,na,1896,521.786842310877
SIM,1812,81,na,1893,231
SIM,1857,55,na,1912,1717
SIM,1941,8,na,1949,3993
STAT,1811,99,na,1910,0.8203444324548593
SIM,1823,46,25-29,1869,1
STAT,1857,52,25-29,1909,0.0028069656878928297
STAT,1828,41,50-100,1869,0.8779666335849509
STAT,1851,17,40-44,1868,0.18346459165872592
STAT,1846,49,20-24,1895,0.008402287137783867
SIM,1931,36,25-29,1967,2
STAT,1946,25,25-29,1971,74.87077435757682
SIM,1846,26,25-29,1872,7
SIM,1890,37,25-29,1927,4
STAT,1824,44,25-29,1868,0.7606168270205113
STAT,1952,10,na,1962,4803.322986661973
SIM,1912,16,na,1928,4108
STAT,1835,49,45-49,1884,0.18072995660049504
SIM,1918,22,35-39,1940,11
SIM,1928,35,25-29,1963,2
STAT,1914,38,25-29,1952,0.9980428392190812
STAT,1883,28,50-100,1911,0.6380560800935026
STAT,1923,36,25-29,1959,1.165077436634361
SIM,1799,60,na,1859,1160
SIM,1894,51,na,1945,2908
SIM,1858,8,na,1866,2426
SIM,1922,38,25-29,1960,1
STAT,1837,20,35-39,1857,5.380930837932072
SIM,1888,49,50-100,1937,1
SIM,1866,29,45-49,1895,1
SIM,1908,20,50-100,1928,1
STAT,1820,42,na,1862,1498.234655269444
SIM,1895,29,na,1924,3243
SIM,1842,33,30-34,1875,23
STAT,1884,15,50-100,1899,0.049676387731489295
SIM,1867,25,30-34,1892,2
STAT,1786,77,na,1863,278.69856524220313
SIM,1894,20,30-34,1914,2
SIM,1920,35,na,1955,4019
STAT,1866,48,50-100,1914,0.22819846852175055
SIM,1882,56,na,1938,1982
STAT,1841,36,25-29,1877,2.530827900865685
STAT,1931,35,20-24,1966,0.35666601296527184
SIM,1826,33,45-49,1859,1
STAT,1833,108,na,1941,0.0012028850182408985
STAT,1943,27,50-100,1970,1.0815250621561567
SIM,1843,25,45-49,1868,4
SIM,1817,90,na,1907,46
SIM,1866,32,na,1898,2354
STAT,1929,33,25-29,1962,11.966882098430862
STAT,1861,58,na,1919,1667.05187029897
SIM,1893,24,45-49,1917,1
STAT,1821,43,45-49,1864,2.5140897595268137
SIM,1862,42,45-49,1904,1
STAT,1837,43,50-100,1880,0.8205884589545119
STAT,1918,21,30-34,1939,31.728456317803815
SIM,1936,25,20-24,1961,19
STAT,1845,34,na,1879,1972.0490217532426
STAT,1907,29,na,1936,3550.3701316616407
SIM,1919,28,25-29,1947,104
SIM,1869,36,20-24,1905,1
STAT,1904,16,20-24,1920,25.983940631306112
STAT,1942,16,na,1958,3925.499359785627
STAT,1834,33,30-34,1867,14.894939874556528
SIM,1787,75,na,1862,291
SIM,1889,39,40-44,1928,10
STAT,1885,24,45-49,1909,0.7052761446521908
SIM,1912,16,20-24,1928,31
STAT,1827,29,15-19,1856,0.8766501674392387
STAT,1890,17,na,1907,3150.2816206522234
STAT,1929,17,20-24,1946,176.472636925697
SIM,1874,37,na,1911,2416
SIM,1870,37,na,1907,2606
STAT,1852,22,40-44,1874,1.9942405921028525
STAT,1884,39,50-100,1923,1.2266680379328934
STAT,1886,20,30-34,1906,19.348679384779267
SIM,1836,20,25-29,1856,69
SIM,1889,31,45-49,1920,1
STAT,1883,73,na,1956,1222.764976487638
SIM,1916,7,na,1923,4346
SIM,1941,13,na,1954,3949
STAT,1801,93,na,1894,10.42756741743184
STAT,1877,16,35-39,1893,0.5820073607139147
STAT,1917,25,45-49,1942,1.8614471209515724
SIM,1887,27,25-29,1914,2
STAT,1776,105,na,1881,0.01973482692251475
STAT,1905,17,35-39,1922,0.8084376321224179
STAT,1820,53,40-44,1873,0.018096191016984908
STAT,1916,35,40-44,1951,1.5792562388948197
SIM,1937,17,20-24,1954,162
STAT,1835,25,45-49,1860,1.094260852850388
SIM,1878,9,na,1887,2861
SIM,1857,89,na,1946,42
STAT,1807,51,15-19,1858,1.0371605660535388E-4
SIM,1936,27,30-34,1963,54
STAT,1892,40,25-29,1932,0.8293220732356829
STAT,1928,25,20-24,1953,23.094456614081075
STAT,1845,24,na,1869,2044.2911963041329
STAT,1940,15,na,1955,3814.6167712236474
STAT,1915,48,na,1963,3767.1246884045618
STAT,1829,33,20-24,1862,2.4692274331871085
STAT,1881,29,20-24,1910,11.487769034270567
STAT,1943,5,na,1948,4312.616860491869
STAT,1832,61,na,1893,1248.6745156459533
STAT,1874,42,15-19,1916,0.014366082913803752
SIM,1897,3,na,1900,3569
STAT,1879,27,25-29,1906,45.10833170936724
SIM,1909,17,45-49,1926,1
SIM,1925,25,45-49,1950,2
STAT,1896,24,20-24,1920,92.26823228052831
STAT,1910,36,15-19,1946,0.01882192660291037
SIM,1922,45,30-34,1967,1
STAT,1903,29,na,1932,3436.1162966717675
SIM,1864,47,25-29,1911,1
STAT,1924,37,40-44,1961,1.800965347736468
SIM,1861,19,15-19,1880,6
SIM,1872,16,25-29,1888,11
STAT,1892,18,40-44,1910,0.23324018473306007
SIM,1880,6,na,1886,2709
STAT,1895,19,20-24,1914,23.47032418601096
STAT,1942,10,na,1952,4206.647429664962
STAT,1786,108,na,1894,7.914424658983633E-4
STAT,1954,18,25-29,1972,54.62628105462611
SIM,1880,21,na,1901,2286
SIM,1902,28,15-19,1930,1
SIM,1799,94,na,1893,12
STAT,1918,17,45-49,1935,0.11132009711167325
SIM,1833,27,40-44,1860,3
SIM,1942,17,45-49,1959,1
SIM,1821,41,45-49,1862,2
SIM,1863,48,35-39,1911,1
SIM,1836,28,20-24,1864,11
SIM,1884,21,15-19,1905,4
STAT,1870,52,40-44,1922,0.010442941464786137
STAT,1863,25,20-24,1888,10.645537938911712
SIM,1802,81,na,1883,215
STAT,1865,42,20-24,1907,0.1468643985759612
STAT,1934,17,45-49,1951,0.6890580649083679
STAT,1937,18,25-29,1955,42.88951635091472
STAT,1818,46,50-100,1864,0.5665589392445085
SIM,1876,2,na,1878,3430
SIM,1797,65,na,1862,795
SIM,1899,29,na,1928,3193
STAT,1852,81,na,1933,435.6407714524892
SIM,1822,38,20-24,1860,3
SIM,1863,89,na,1952,31
SIM,1900,38,20-24,1938,1
STAT,1856,102,na,1958,0.40037659921915936
STAT,1864,16,25-29,1880,5.8779305740330186
SIM,1886,19,20-24,1905,21
SIM,1817,59,na,1876,1072
SIM,1878,34,20-24,1912,5
SIM,1834,27,50-100,1861,1
STAT,1881,16,25-29,1897,5.602692814422074
SIM,1849,43,40-44,1892,5
SIM,1868,31,25-29,1899,14
STAT,1862,44,45-49,1906,1.2821391072355928
SIM,1853,69,na,1922,1120
SIM,1914,35,na,1949,3878
SIM,1913,17,35-39,1930,1
STAT,1853,19,15-19,1872,5.915633390993084
STAT,1885,15,30-34,1900,1.6297435299147627
SIM,1852,30,35-39,1882,13
STAT,1890,21,na,1911,2958.9186477774774
SIM,1821,64,na,1885,928
STAT,1868,90,na,1958,108.65048953674345
STAT,1887,35,na,1922,2718.7737731452344
STAT,1918,30,45-49,1948,1.7200977406187603
STAT,1802,57,na,1859,941.012930010107
STAT,1810,76,na,1886,385.3116057239761
STAT,1879,48,20-24,1927,0.01263547504612295
STAT,1885,6,na,1891,2658.8018625281784
STAT,1874,21,na,1895,2470.7814618842513
STAT,1905,24,25-29,1929,83.81451180686928
STAT,1907,13,na,1920,3862.3108652665956
STAT,1927,43,na,1970,4743.8162777974785
STAT,1880,32,45-49,1912,1.8694290293985083
STAT,1853,48,50-100,1901,0.20334769317561915
STAT,1859,28,35-39,1887,7.939400037968002
STAT,1828,28,20-24,1856,14.817819558312634
STAT,1909,19,45-49,1928,0.09937231517158267
STAT,1933,35,40-44,1968,2.0830166691211147
SIM,1859,30,20-24,1889,2
STAT,1820,38,45-49,1858,4.582670233830914
SIM,1926,30,45-49,1956,2
SIM,1906,27,50-100,1933,1
STAT,1884,16,40-44,1900,0.18505425963717714
SIM,1926,20,na,1946,4687
STAT,1918,8,na,1926,4430.046579489261
STAT,1813,41,45-49,1854,5.6785736254888315
SIM,1932,37,40-44,1969,3
SIM,1912,10,na,1922,4225
SIM,1925,40,40-44,1965,1
SIM,1937,33,25-29,1970,16
SIM,1945,18,25-29,1963,53
STAT,1925,27,45-49,1952,2.081823259057294
STAT,1844,30,35-39,1874,9.581320897851954
SIM,1853,48,50-100,1901,1
STAT,1932,40,20-24,1972,0.02447770004597851
STAT,1923,38,35-39,1961,2.8565904033365968
STAT,1914,3,na,1917,4266.8309296186135
STAT,1790,82,na,1872,175.76730835968394
STAT,1843,15,40-44,1858,0.19093255627086378
SIM,1812,43,45-49,1855,1
STAT,1908,27,45-49,1935,1.6794989869966896
SIM,1845,18,20-24,1863,26
STAT,1833,41,15-19,1874,0.01121586423118561
SIM,1863,26,25-29,1889,35
SIM,1916,1,na,1917,4445
STAT,1891,35,25-29,1926,3.6709556219054496
STAT,1858,29,45-49,1887,0.9063710658873126
STAT,1863,43,na,1906,2052.358726766526
SIM,1862,18,20-24,1880,18
STAT,1838,26,25-29,1864,39.82249291582197
STAT,1902,51,na,1953,3112.5513671380845
STAT,1862,36,na,1898,2055.777825658339
STAT,1845,22,35-39,1867,5.660367881207272
SIM,1856,18,na,1874,2689
STAT,1925,14,na,1939,4867.509742023948
SIM,1931,38,35-39,1969,8
STAT,1868,23,30-34,1891,17.30207797751706
SIM,1926,30,na,1956,4907
STAT,1861,54,40-44,1915,0.008630431992544473
SIM,1894,41,na,1935,3136
SIM,1873,37,25-29,1910,2
STAT,1854,18,20-24,1872,16.1356964332223
STAT,1798,78,na,1876,383.6449446609276
STAT,1833,39,na,1872,1721.942308765052
STAT,1886,16,na,1902,2733.87806307077
STAT,1861,23,45-49,1884,0.5995543712607005
STAT,1860,33,40-44,1893,3.574414118656503
STAT,1837,18,20-24,1855,18.12853891200237
SIM,1826,49,45-49,1875,1
STAT,1905,21,50-100,1926,0.6026296967817257
SIM,1874,28,40-44,1902,1
SIM,1932,30,na,1962,5324
STAT,1856,47,25-29,1903,0.04591123810659731
SIM,1925,22,25-29,1947,149
SIM,1870,44,45-49,1914,6
SIM,1906,16,na,1922,3771
SIM,1916,27,45-49,1943,5
STAT,1844,23,45-49,1867,0.6698335195660807
SIM,1872,23,15-19,1895,3
STAT,1937,25,30-34,1962,38.99360721237057
SIM,1876,23,30-34,1899,27
STAT,1899,20,na,1919,3323.6141946876096
STAT,1960,1,na,1961,5229.808583217979
STAT,1874,90,na,1964,193.9934704639458
STAT,1802,105,na,1907,0.009303610204472238
STAT,1913,13,na,1926,4112.917582299255
STAT,1942,25,40-44,1967,4.995396911580774
STAT,1943,15,45-49,1958,0.540740852978913
SIM,1878,41,50-100,1919,3
STAT,1823,36,20-24,1859,1.4923290112379384
STAT,1890,27,20-24,1917,14.633071621638146
STAT,1868,30,20-24,1898,2.654942820463031
STAT,1913,16,30-34,1929,2.548589520390129
SIM,1921,16,30-34,1937,25
SIM,1865,54,na,1919,1965
STAT,1871,50,35-39,1921,0.008824684218229404
STAT,1850,41,15-19,1891,0.010434822968009771
STAT,1877,54,50-100,1931,0.015540567605101974
STAT,1902,41,na,1943,3351.6349706411083
SIM,1886,22,na,1908,2633
STAT,1829,52,50-100,1881,0.010751170044265186
STAT,1855,26,25-29,1881,34.42736774417825
SIM,1911,17,15-19,1928,14
SIM,1816,43,30-34,1859,4
STAT,1917,22,25-29,1939,100.18327660350674
STAT,1919,14,na,1933,4453.800735381064
SIM,1945,25,30-34,1970,72
STAT,1869,53,45-49,1922,0.014063903103177315
STAT,1948,20,15-19,1968,6.24016338605792
STAT,1864,23,15-19,1887,3.018776434458083
STAT,1903,17,15-19,1920,8.606075778834107
STAT,1833,49,na,1882,1534.8497992540592
SIM,1883,34,30-34,1917,18
STAT,1848,76,na,1924,736.4482315008295
STAT,1914,46,50-100,1960,0.22943592211664546
STAT,1855,48,35-39,1903,0.10716410400791418
SIM,1922,22,25-29,1944,113
STAT,1838,47,20-24,1885,0.00907091699197502
SIM,1867,41,35-39,1908,5
SIM,1842,43,40-44,1885,3
STAT,1871,72,na,1943,1276.1864072710591
SIM,1807,59,na,1866,1057
STAT,1827,39,na,1866,1776.5308845248182
STAT,1892,34,30-34,1926,22.132205781390688
SIM,1908,25,45-49,1933,5
STAT,1879,24,20-24,1903,73.02515252068174
STAT,1899,27,40-44,1926,4.184711999075872
SIM,1844,22,25-29,1866,66
SIM,1911,35,45-49,1946,4
STAT,1904,46,na,1950,3299.367906347707
STAT,1914,48,35-39,1962,0.1300989170827665
STAT,1840,54,20-24,1894,5.164029812012898E-4
STAT,1835,20,15-19,1855,4.43852980832011
STAT,1856,21,15-19,1877,3.0904744889673177
STAT,1806,52,50-100,1858,0.04909760113110075
STAT,1845,20,25-29,1865,56.333824074678056
STAT,1944,21,50-100,1965,0.7250761288105948
SIM,1846,87,na,1933,77
SIM,1912,22,15-19,1934,5
SIM,1932,32,50-100,1964,3
STAT,1825,43,30-34,1868,1.537338373312875
STAT,1814,47,35-39,1861,0.4174323494530836
STAT,1846,33,20-24,1879,2.2607457480602546
SIM,1909,21,30-34,1930,29
STAT,1905,48,25-29,1953,0.04726923046441924
STAT,1873,73,na,1946,1228.4326910805987
STAT,1906,36,25-29,1942,0.9271977970654623
STAT,1899,43,50-100,1942,0.10174442445687257
SIM,1885,16,35-39,1901,1
SIM,1854,33,20-24,1887,2
SIM,1850,17,na,1867,2156
STAT,1881,38,35-39,1919,6.941262340324249
STAT,1876,87,na,1963,350.4954120247614
SIM,1853,22,35-39,1875,5
SIM,1904,31,20-24,1935,3
STAT,1840,34,50-100,1874,0.7865519625283353
SIM,1833,43,30-34,1876,6
STAT,1911,21,45-49,1932,1.0917752695435725
STAT,1839,24,na,1863,1868.8651980432128
STAT,1871,18,20-24,1889,17.92461854638249
STAT,1909,31,30-34,1940,15.396056157536036
STAT,1904,22,15-19,1926,4.823390303160676
STAT,1824,41,20-24,1865,0.19963422384336443
STAT,1944,20,45-49,1964,1.240326650617357
STAT,1851,58,na,1909,1631.5522938701079
STAT,1917,43,na,1960,3948.977254682883
STAT,1877,20,20-24,1897,73.35039700025351
SIM,1887,24,20-24,1911,113
STAT,1785,108,na,1893,0.0013699970355295615
STAT,1836,22,25-29,1858,47.028363650407
SIM,1917,24,40-44,1941,6
STAT,1831,75,na,1906,693.6733603922802
STAT,1932,33,30-34,1965,21.346102904339006
STAT,1861,88,na,1949,115.72570663856975
STAT,1883,50,25-29,1933,0.0035963818325580217
SIM,1892,22,na,1914,3416
SIM,1822,47,35-39,1869,1
SIM,1861,31,50-100,1892,1
STAT,1838,48,na,1886,1679.0268993033126
STAT,1818,93,na,1911,14.893751614941774
STAT,1937,19,20-24,1956,134.13418620835054
SIM,1933,27,45-49,1960,5
STAT,1897,15,50-100,1912,0.06713720174024071
STAT,1839,65,na,1904,1166.318903668463
STAT,1929,30,20-24,1959,3.1636347531389255
STAT,1931,31,50-100,1962,1.105526076820739
SIM,1864,21,15-19,1885,2
SIM,1913,24,25-29,1937,117
SIM,1904,16,30-34,1920,3
STAT,1877,73,na,1950,1256.7444163776984
SIM,1867,28,35-39,1895,8
STAT,1786,102,na,1888,0.07338506778138595
STAT,1952,16,na,1968,4500.86226461353
STAT,1872,39,20-24,1911,0.7802064934422036
SIM,1930,21,20-24,1951,164
SIM,1881,27,20-24,1908,11
SIM,1852,20,40-44,1872,2
STAT,1858,90,na,1948,63.78262343135152
STAT,1812,51,40-44,1863,0.024246451303713397
STAT,1872,15,20-24,1887,18.401936380963225
SIM,1812,77,na,1889,290
SIM,1873,3,na,1876,3047
STAT,1888,72,na,1960,1684.964746313664
STAT,1903,35,45-49,1938,0.6298978424899919
STAT,1834,43,40-44,1877,1.801559313160707
SIM,1843,20,15-19,1863,3
SIM,1945,19,20-24,1964,164
STAT,1914,22,25-29,1936,96.28407633154688
SIM,1853,20,25-29,1873,78
STAT,1928,28,25-29,1956,82.67343900044214
STAT,1840,37,35-39,1877,6.019822280539482
SIM,1908,11,na,1919,4174
STAT,1875,44,40-44,1919,2.3232274790266785
STAT,1943,16,40-44,1959,1.5136962378369383
STAT,1828,52,45-49,1880,0.010961837111813456
STAT,1918,28,15-19,1946,0.7639758255533563
STAT,1900,19,40-44,1919,0.25722882848820416
STAT,1898,31,45-49,1929,2.4155253189755372
STAT,1895,54,na,1949,2787.156070045435
STAT,1864,31,15-19,1895,0.12970337479404945
SIM,1851,36,50-100,1887,3
STAT,1775,115,na,1890,1.7925552718077307E-4
STAT,1906,38,35-39,1944,2.2555636657107234
SIM,1877,21,25-29,1898,72
SIM,1900,30,25-29,1930,18
STAT,1891,32,20-24,1923,3.413957621181601
SIM,1893,21,40-44,1914,5
SIM,1894,23,35-39,1917,10
STAT,1779,95,na,1874,2.03872576021067
STAT,1872,20,na,1892,2432.523559708884
STAT,1813,108,na,1921,7.876912446742206E-4
STAT,1834,50,30-34,1884,0.004273324953837131
SIM,1868,30,30-34,1898,4
SIM,1880,15,20-24,1895,21
STAT,1897,59,na,1956,2673.966012360294
SIM,1826,30,40-44,1856,1
STAT,1848,26,50-100,1874,0.5979204611880294
SIM,1914,38,35-39,1952,3
STAT,1816,92,na,1908,18.4804034430312
STAT,1926,19,45-49,1945,0.6214567397706577
STAT,1865,88,na,1953,127.11126472747462
SIM,1832,36,na,1868,1759
SIM,1866,26,40-44,1892,3
SIM,1846,23,20-24,1869,91
STAT,1909,24,40-44,1933,3.1671486582385957
STAT,1861,53,45-49,1914,0.01203708210659413
STAT,1886,23,35-39,1909,6.281751217633403
SIM,1893,31,35-39,1924,26
SIM,1839,40,45-49,1879,2
SIM,1922,48,35-39,1970,1
SIM,1824,62,na,1886,957
STAT,1875,40,25-29,1915,0.6791294627390184
STAT,1891,42,15-19,1933,0.017420312624229488
STAT,1889,48,50-100,1937,0.17238526386747755
STAT,1848,49,40-44,1897,0.13030083176676868
STAT,1895,43,45-49,1938,0.1373323770147786
STAT,1842,41,25-29,1883,0.5277287206467601
STAT,1808,53,40-44,1861,0.024601465165367778
SIM,1839,22,15-19,1861,4
STAT,1847,54,20-24,1901,5.596149434331178E-4
SIM,1936,28,25-29,1964,113
SIM,1877,29,20-24,1906,18
SIM,1883,44,40-44,1927,2
SIM,1951,16,40-44,1967,5
SIM,1812,43,na,1855,1369
STAT,1921,16,20-24,1937,158.08371410184333
STAT,1832,23,na,1855,1889.199434812296
STAT,1907,49,20-24,1956,0.00998086043687668
STAT,1865,45,25-29,1910,0.05386369970844929
STAT,1903,16,50-100,1919,0.07122078181261393
STAT,1885,31,35-39,1916,10.349234419327956
STAT,1869,21,25-29,1890,56.55190681502371
STAT,1853,1,na,1854,3202.0000000000005
STAT,1935,21,30-34,1956,39.926562035316266
SIM,1847,35,na,1882,1728
SIM,1943,21,30-34,1964,43
SIM,1946,23,25-29,1969,105
SIM,1827,32,35-39,1859,14
SIM,1880,37,na,1917,2315
STAT,1874,86,na,1960,348.0354506056353
SIM,1914,36,25-29,1950,1
SIM,1908,42,45-49,1950,2
SIM,1931,28,25-29,1959,94
STAT,1851,33,30-34,1884,14.837702653803847
STAT,1886,21,25-29,1907,62.001127558353495
STAT,1931,38,25-29,1969,1.3285361322857487
STAT,1885,21,40-44,1906,2.127259498183068
STAT,1924,41,25-29,1965,0.08678411384273062
SIM,1830,31,na,1861,1894
STAT,1938,23,25-29,1961,93.22417820029118
STAT,1868,21,na,1889,2321.0915806699672
STAT,1879,54,50-100,1933,0.01566201854587586
SIM,1852,56,na,1908,1686
STAT,1814,42,na,1856,1499.3936098682454
STAT,1866,28,40-44,1894,2.8088143607611706
SIM,1875,84,na,1959,467
STAT,1896,49,35-39,1945,0.10418112926077007
STAT,1818,40,35-39,1858,5.037778784698618
STAT,1855,24,na,1879,1908.633698359011
SIM,1859,20,na,1879,2315
STAT,1880,55,na,1935,2216.6501733023865
SIM,1884,51,na,1935,2270
STAT,1816,51,25-29,1867,0.007109732441366581
SIM,1895,67,na,1962,2254
SIM,1909,32,35-39,1941,14
STAT,1897,48,25-29,1945,0.04376230890986004
SIM,1838,21,na,1859,2009
SIM,1894,21,25-29,1915,76
STAT,1839,52,20-24,1891,5.065601417964285E-4
STAT,1944,18,15-19,1962,49.812882279926505
STAT,1928,27,30-34,1955,49.23886689989742
STAT,1900,22,30-34,1922,25.185673091587613
STAT,1853,52,40-44,1905,0.00878042738670905
STAT,1879,8,na,1887,2824.1353708981387
STAT,1838,41,15-19,1879,0.012019443367785305
STAT,1879,34,15-19,1913,0.15055699510059592
STAT,1883,69,na,1952,1468.9602063709
SIM,1899,37,45-49,1936,2
STAT,1824,43,50-100,1867,1.276135865965335
STAT,1917,26,40-44,1943,5.005403775154106
SIM,1936,30,50-100,1966,4
STAT,1913,29,na,1942,3780.7365195533966
SIM,1917,25,na,1942,3875
SIM,1827,30,25-29,1857,13
STAT,1909,33,50-100,1942,0.8012653645127015
STAT,1771,85,na,1856,74.66617986
STAT,1831,38,20-24,1869,0.6699863298259155
STAT,1951,17,45-49,1968,0.6068427394329386
STAT,1891,34,na,1925,2988.102079042729
SIM,1854,25,20-24,1879,2
STAT,1863,28,25-29,1891,37.7033940037943
SIM,1886,21,35-39,1907,5
STAT,1922,2,na,1924,4829.598214302088
STAT,1846,25,20-24,1871,10.296445794100132
STAT,1936,27,20-24,1963,17.817713692223588
STAT,1946,18,35-39,1964,4.74693616841233
SIM,1952,18,15-19,1970,55
SIM,1876,30,20-24,1906,6
STAT,1828,93,na,1921,16.093452222060847
STAT,1882,20,na,1902,2364.591825474687
SIM,1882,22,na,1904,2241
SIM,1917,33,50-100,1950,1
SIM,1871,28,25-29,1899,45
STAT,1859,25,30-34,1884,21.173153110199486
SIM,1859,33,25-29,1892,15
STAT,1861,15,45-49,1876,0.06404281881807912
SIM,1875,33,40-44,1908,10
STAT,1832,108,na,1940,0.0012240089050225176
STAT,1954,15,20-24,1969,171.04532064915588
STAT,1838,23,20-24,1861,65.22024034890394
STAT,1843,18,45-49,1861,0.06699234461666174
SIM,1806,81,na,1887,313
SIM,1868,33,35-39,1901,2
SIM,1911,1,na,1912,4208
STAT,1822,92,na,1914,24.216802023617625
STAT,1858,26,40-44,1884,2.498800064324207
STAT,1847,59,na,1906,1515.5386348843647
STAT,1911,28,15-19,1939,0.6997772579012628
STAT,1844,32,50-100,1876,0.8490522869306001
STAT,1895,45,50-100,1940,0.1862350862780435
STAT,1807,48,40-44,1855,0.734734463354405
STAT,1914,28,30-34,1942,40.15956589796497
STAT,1844,17,35-39,1861,0.5405033422239196
SIM,1864,37,na,1901,2175
SIM,1867,55,na,1922,1800
STAT,1854,42,45-49,1896,1.144050221537427
STAT,1829,41,na,1870,1757.4493853725517
STAT,1933,39,20-24,1972,0.36539143625198056
STAT,1807,94,na,1901,8.446182439137301
SIM,1844,21,na,1865,2139
SIM,1869,84,na,1953,182
STAT,1922,21,20-24,1943,130.50370191382564
STAT,1867,33,40-44,1900,4.135883511805932
STAT,1916,1,na,1917,4506.646815873146
STAT,1875,51,30-34,1926,0.0062622023265915166
STAT,1908,60,na,1968,3154.9389370875515
SIM,1859,44,50-100,1903,3
STAT,1871,88,na,1959,206.54473091452383
SIM,1836,56,na,1892,1612
SIM,1922,28,30-34,1950,56
STAT,1910,28,15-19,1938,0.6928325105171637
STAT,1922,34,na,1956,4338.945872200209
SIM,1800,58,na,1858,964
SIM,1849,54,na,1903,1657
STAT,1947,15,15-19,1962,52.186703615325904
STAT,1878,3,na,1881,3245.5072162265205
STAT,1878,18,50-100,1896,0.051886277392330524
STAT,1933,38,45-49,1971,0.9459956531427021
STAT,1926,39,15-19,1965,0.023891117663989745
STAT,1867,73,na,1940,1137.548383659684
STAT,1926,32,45-49,1958,1.9410802569818904
STAT,1909,16,40-44,1925,0.2804298062053042
SIM,1929,10,na,1939,5433
SIM,1899,50,na,1949,3090
STAT,1813,94,na,1907,8.594560025912967
STAT,1843,60,na,1903,1539.6146774021047
STAT,1847,108,na,1955,0.0014284019015711649
STAT,1872,45,50-100,1917,0.253612168291253
STAT,1844,20,40-44,1864,2.0454087025384973
SIM,1893,18,35-39,1911,1
SIM,1894,46,50-100,1940,1
STAT,1788,78,na,1866,335.36413335702616
STAT,1928,17,20-24,1945,174.24852926632482
STAT,1820,52,45-49,1872,0.025447604074878078
SIM,1879,36,na,1915,2909
STAT,1860,19,50-100,1879,0.04621930745798504
SIM,1835,22,30-34,1857,24
SIM,1858,72,na,1930,1009
STAT,1871,31,40-44,1902,4.400267928298728
STAT,1918,46,45-49,1964,0.2366051514260274
STAT,1954,17,30-34,1971,15.369543726133141
STAT,1925,47,15-19,1972,4.554141203060303E-4
SIM,1937,30,20-24,1967,3
STAT,1878,19,20-24,1897,18.7242842462878
STAT,1885,18,35-39,1903,0.5570013531620445
STAT,1914,35,20-24,1949,0.27108879699041394
SIM,1954,11,na,1965,4715
STAT,1884,19,45-49,1903,0.06557530549747109
SIM,1916,24,40-44,1940,6
STAT,1913,19,35-39,1932,0.8705399739336669
STAT,1833,45,30-34,1878,0.0769519915787872
SIM,1930,32,50-100,1962,1
SIM,1855,54,na,1909,1633
SIM,1848,38,40-44,1886,8
SIM,1870,33,50-100,1903,1
SIM,1910,5,na,1915,4024
STAT,1915,14,na,1929,4204.2635906249825
SIM,1944,27,20-24,1971,19
STAT,1909,14,na,1923,3937.055027296867
STAT,1838,76,na,1914,696.1068750425076
STAT,1857,30,45-49,1887,1.4272481799541668
STAT,1883,40,15-19,1923,0.013962642817059273
SIM,1826,46,40-44,1872,3
SIM,1859,48,45-49,1907,1
SIM,1860,17,na,1877,2260
STAT,1908,24,40-44,1932,3.1323389889598108
SIM,1828,35,20-24,1863,2
SIM,1904,24,30-34,1928,33
STAT,1859,41,35-39,1900,1.4819724518443766
STAT,1843,39,na,1882,1978.9629497467306
STAT,1883,42,25-29,1925,0.6419856319445637
STAT,1894,20,20-24,1914,90.96777573465363
SIM,1831,39,25-29,1870,1
STAT,1823,39,25-29,1862,4.9813976675713025
STAT,1897,22,15-19,1919,4.499989480105028
STAT,1849,54,40-44,1903,0.00794849260546564
SIM,1895,26,20-24,1921,17
STAT,1873,44,20-24,1917,0.16203521408585075
STAT,1885,37,40-44,1922,4.4553295350054345
SIM,1918,8,na,1926,4606
SIM,1928,28,35-39,1956,2
STAT,1887,26,20-24,1913,13.456635353992864
SIM,1893,37,40-44,1930,8
STAT,1906,46,35-39,1952,0.11759365695648799
SIM,1830,72,na,1902,826
STAT,1904,40,45-49,1944,0.15348540928894422
STAT,1927,22,35-39,1949,11.83382078312108
SIM,1926,22,45-49,1948,3
SIM,1935,22,35-39,1957,16
SIM,1891,42,25-29,1933,1
SIM,1921,17,25-29,1938,73
STAT,1833,38,40-44,1871,3.5864112848891394
STAT,1872,23,20-24,1895,70.2404613800919
SIM,1865,30,45-49,1895,4
STAT,1806,53,20-24,1859,0.0023485077175026264
STAT,1822,49,35-39,1871,0.19385276583048056
SIM,1880,45,50-100,1925,1
STAT,1850,31,20-24,1881,2.149188425299785
SIM,1841,38,40-44,1879,9
STAT,1836,54,45-49,1890,0.008785447388301577
STAT,1913,17,25-29,1930,9.038871709909843
STAT,1825,75,na,1900,617.3301359249477
SIM,1858,36,45-49,1894,4
STAT,1901,24,40-44,1925,2.954108553376327
SIM,1844,82,na,1926,245
SIM,1873,34,20-24,1907,2
SIM,1925,26,40-44,1951,16
SIM,1861,22,25-29,1883,70
SIM,1906,36,35-39,1942,5
SIM,1889,33,na,1922,3088
STAT,1907,48,45-49,1955,0.19689866468317546
SIM,1830,62,na,1892,1226
SIM,1943,24,35-39,1967,15
STAT,1846,36,25-29,1882,2.172592798851432
SIM,1892,18,na,1910,3687
SIM,1946,20,20-24,1966,124
SIM,1849,21,30-34,1870,32
SIM,1880,37,30-34,1917,8
STAT,1871,20,35-39,1891,5.932080581920081
SIM,1821,33,45-49,1854,1
SIM,1822,43,na,1865,1390
STAT,1842,43,30-34,1885,0.9209030233312321
STAT,1945,23,15-19,1968,5.950389751681559
SIM,1792,83,na,1875,117
STAT,1940,18,30-34,1958,12.621338042169983
SIM,1911,4,na,1915,4149
STAT,1797,83,na,1880,141.07127921922972
STAT,1864,38,na,1902,2126.4653739505716
STAT,1924,45,40-44,1969,0.19240245372193254
SIM,1904,52,na,1956,3257
SIM,1950,11,na,1961,4737
STAT,1889,24,50-100,1913,0.510657542344594
STAT,1842,23,na,1865,2099.6654581621997
STAT,1845,43,50-100,1888,0.8298760443703703
STAT,1909,52,na,1961,3384.9595638306832
STAT,1888,38,20-24,1926,0.9250482203487753
SIM,1825,88,na,1913,64
STAT,1881,23,15-19,1904,3.243698755306761
STAT,1851,43,40-44,1894,1.8422865594365896
SIM,1897,52,na,1949,2885
SIM,1944,17,na,1961,3934
STAT,1841,65,na,1906,1247.7883290142447
STAT,1884,52,na,1936,2161.645136945829
STAT,1929,41,50-100,1970,0.15539800042159294
STAT,1897,18,na,1915,3435.993218700913
STAT,1873,15,na,1888,2643.1517168534333
SIM,1877,48,na,1925,2257
STAT,1815,58,na,1873,1291.574492219259
SIM,1904,18,20-24,1922,33
STAT,1894,16,35-39,1910,0.7217945264176019
SIM,1882,39,40-44,1921,7
STAT,1823,40,na,1863,1572.5113492556295
STAT,1864,38,35-39,1902,6.383899977938595
SIM,1825,35,50-100,1860,2
SIM,1862,35,20-24,1897,1
STAT,1934,37,15-19,1971,0.02702475153206934
STAT,1872,37,30-34,1909,5.449118357214577
STAT,1836,32,35-39,1868,7.9682069804612405
STAT,1884,4,na,1888,2816.96151820407
SIM,1854,36,25-29,1890,4
SIM,1886,43,45-49,1929,2
SIM,1858,33,40-44,1891,1
STAT,1777,79,na,1856,316.03531743179997
STAT,1935,24,35-39,1959,13.067129794142902
SIM,1866,60,na,1926,1959
SIM,1810,48,na,1858,1605
STAT,1836,37,45-49,1873,1.5231420768288366
SIM,1858,68,na,1926,1171
SIM,1943,22,50-100,1965,1
STAT,1930,19,35-39,1949,5.5033159231537265
SIM,1810,58,na,1868,1401
STAT,1933,31,25-29,1964,12.709876831987659
STAT,1901,41,40-44,1942,0.22383180010933193
STAT,1837,38,25-29,1875,2.3130919276552695
STAT,1930,30,45-49,1960,2.0735387662287392
SIM,1845,38,25-29,1883,3
STAT,1868,24,45-49,1892,0.6751939143022094
STAT,1870,38,50-100,1908,1.2183091253136948
STAT,1890,19,20-24,1909,21.994860796477344
SIM,1908,22,25-29,1930,105
STAT,1774,112,na,1886,5.523830380346616E-4
STAT,1850,42,na,1892,1736.3853036518024
SIM,1841,31,20-24,1872,4
SIM,1850,43,30-34,1893,1
STAT,1941,30,20-24,1971,2.615634930515436
SIM,1835,25,35-39,1860,8
SIM,1835,39,45-49,1874,1
SIM,1844,37,45-49,1881,3
STAT,1808,73,na,1881,460.4503328798547
STAT,1815,51,50-100,1866,0.03960124629352314
STAT,1876,21,15-19,1897,3.4857810517019976
STAT,1848,38,na,1886,1867.7766246727558
SIM,1939,25,50-100,1964,2
STAT,1905,39,45-49,1944,0.6275652956146137
SIM,1877,31,35-39,1908,20
STAT,1854,35,20-24,1889,0.5989999962648878
SIM,1914,35,30-34,1949,2
STAT,1871,25,50-100,1896,0.6508104734708497
STAT,1823,37,35-39,1860,13.252081062391904
SIM,1849,26,40-44,1875,6
STAT,1874,39,40-44,1913,4.513551207599347
SIM,1867,31,40-44,1898,6
STAT,1879,38,50-100,1917,1.3027159566153617
STAT,1797,93,na,1890,7.35940660710835
SIM,1877,45,45-49,1922,1
STAT,1892,44,40-44,1936,0.19700848505272708
STAT,1904,27,50-100,1931,0.9352723828495957
STAT,1898,72,na,1970,2147.3668737538087
SIM,1852,36,40-44,1888,4
STAT,1827,39,45-49,1866,2.4569362826525154
STAT,1848,45,25-29,1893,0.04522076830614242
STAT,1921,19,25-29,1940,50.135591669300226
SIM,1844,32,35-39,1876,16
STAT,1837,60,na,1897,1271.567329036041
SIM,1935,20,45-49,1955,3
STAT,1919,33,15-19,1952,0.1408825425569271
STAT,1868,31,35-39,1899,9.907807247703268
STAT,1922,24,25-29,1946,107.40649925858605
SIM,1861,30,na,1891,2571
STAT,1859,31,40-44,1890,3.5476266630607025
STAT,1825,53,40-44,1878,0.012798285200587555
STAT,1890,28,35-39,1918,11.993099274452412
STAT,1902,38,15-19,1940,0.01735057013669601
STAT,1909,34,35-39,1943,8.81760149816269
SIM,1855,37,20-24,1892,1
SIM,1896,38,20-24,1934,1
STAT,1829,34,na,1863,1859.7181752840593
STAT,1860,40,30-34,1900,0.9611987411641068
STAT,1844,36,40-44,1880,3.980234780717332
STAT,1830,25,na,1855,1792.6358585351372
STAT,1841,68,na,1909,1128.3487334065758
SIM,1930,24,25-29,1954,161
SIM,1928,27,20-24,1955,26
STAT,1930,37,50-100,1967,0.5585500881396833
SIM,1831,28,20-24,1859,11
SIM,1892,39,50-100,1931,5
STAT,1910,49,na,1959,3475.4247657157644
STAT,1861,17,35-39,1878,0.5316412745155973
STAT,1875,23,50-100,1898,0.42564159394883616
STAT,1802,54,50-100,1856,0.03844073637467741
STAT,1900,49,na,1949,3115.320659819895
STAT,1912,25,45-49,1937,1.7485355662161923
STAT,1855,8,na,1863,2264.1587297925203
STAT,1887,37,25-29,1924,3.2913064237206067
SIM,1826,36,na,1862,1708
STAT,1938,20,20-24,1958,112.33818080096135
SIM,1917,27,45-49,1944,2
SIM,1835,20,40-44,1855,2
STAT,1905,46,35-39,1951,0.11668281088315417
SIM,1858,38,35-39,1896,8
STAT,1861,50,40-44,1911,0.00900200410470736
STAT,1810,80,na,1890,263.72821862420295
STAT,1898,65,na,1963,2527.680106232258
STAT,1836,19,15-19,1855,5.656740151039713
SIM,1885,38,45-49,1923,5
STAT,1870,49,15-19,1919,3.9057591657756585E-4
SIM,1938,0,na,1938,4249
STAT,1906,35,30-34,1941,1.7243030809231694
STAT,1943,19,45-49,1962,0.5400922543297954
STAT,1874,32,20-24,1906,2.815402875255597
SIM,1882,32,20-24,1914,5
SIM,1855,23,na,1878,1905
STAT,1875,18,40-44,1893,0.19099971706878358
STAT,1940,25,20-24,1965,19.00599323500547
STAT,1876,25,30-34,1901,26.707323411127895
STAT,1830,30,40-44,1860,4.292597910470294
SIM,1899,34,40-44,1933,3
SIM,1867,49,50-100,1916,1
STAT,1877,38,45-49,1915,2.0988182725123186
STAT,1897,28,na,1925,3243.846343683927
STAT,1900,36,40-44,1936,1.3423941506159671
SIM,1845,42,45-49,1887,1
STAT,1909,27,45-49,1936,1.68386981483616
STAT,1908,25,50-100,1933,0.974194818081626
SIM,1844,19,15-19,1863,3
STAT,1874,46,30-34,1920,0.10110944326597499
STAT,1927,20,45-49,1947,1.4225418346145153
SIM,1910,26,15-19,1936,1
STAT,1928,30,50-100,1958,1.0557038933379477
SIM,1885,67,na,1952,1634
STAT,1853,22,25-29,1875,56.71445826086632
SIM,1831,37,35-39,1868,10
STAT,1872,67,na,1939,1620.7737160385495
STAT,1880,24,45-49,1904,0.7428695864955973
SIM,1884,25,30-34,1909,50
SIM,1951,19,45-49,1970,1
STAT,1912,44,na,1956,3625.7708210242995
SIM,1909,30,45-49,1939,4
STAT,1935,17,45-49,1952,0.6964251504531664
SIM,1928,15,20-24,1943,178
STAT,1923,28,25-29,1951,76.83192648588071
SIM,1890,17,20-24,1907,34
SIM,1815,88,na,1903,37
STAT,1931,29,45-49,1960,2.2724631957982777
STAT,1910,15,na,1925,3921.372813139077
SIM,1899,20,30-34,1919,45
STAT,1940,23,50-100,1963,0.6835900893375431
STAT,1831,36,30-34,1867,4.744799078002959
SIM,1885,30,30-34,1915,28
STAT,1863,15,na,1878,2370.695881438619
SIM,1871,32,45-49,1903,5
SIM,1896,15,na,1911,3463
STAT,1905,47,50-100,1952,0.203163869106129
SIM,1917,6,na,1923,4286
SIM,1830,27,25-29,1857,48
STAT,1819,51,40-44,1870,0.020461383567978636
STAT,1843,51,35-39,1894,0.006983113578260668
STAT,1907,41,25-29,1948,0.06709705731899863
SIM,1840,26,20-24,1866,9
STAT,1864,40,50-100,1904,0.9679583007305754
SIM,1848,16,30-34,1864,4
SIM,1934,5,na,1939,5710
STAT,1941,23,30-34,1964,30.292030896409184
STAT,1909,15,45-49,1924,0.10037228945235938
STAT,1947,16,50-100,1963,0.43071254580443147
STAT,1823,46,na,1869,1468.1951552669675
SIM,1848,41,na,1889,1826
SIM,1876,60,na,1936,2174
SIM,1875,36,45-49,1911,3
STAT,1835,24,30-34,1859,17.396058732070706
STAT,1846,43,15-19,1889,0.009868026154794745
STAT,1873,47,25-29,1920,0.05929504410361404
SIM,1872,29,20-24,1901,10
SIM,1876,33,25-29,1909,3
SIM,1927,15,na,1942,4474
STAT,1838,28,15-19,1866,0.4210035263461968
STAT,1892,40,na,1932,2984.8807221959346
STAT,1889,46,25-29,1935,0.07279035265241292
STAT,1846,108,na,1954,0.0013099054147304974
STAT,1870,26,40-44,1896,2.997615982905104
STAT,1917,29,45-49,1946,1.8356890923597862
STAT,1904,26,30-34,1930,36.94394342339044
STAT,1939,30,15-19,1969,0.13390615580795087
STAT,1915,26,25-29,1941,68.74295400687892
SIM,1894,42,40-44,1936,2
STAT,1866,44,30-34,1910,1.0672012113458929
STAT,1941,16,25-29,1957,45.550769919750884
STAT,1862,27,45-49,1889,0.9677417136042673
SIM,1827,73,na,1900,662
SIM,1843,24,30-34,1867,23
STAT,1912,49,30-34,1961,0.08688499259286961
SIM,1874,44,30-34,1918,5
STAT,1802,88,na,1890,43.56083837854951
SIM,1949,21,35-39,1970,13
STAT,1876,23,40-44,1899,2.1883624615499375
STAT,1873,27,20-24,1900,12.133248603520173
STAT,1917,17,45-49,1934,0.10969995587265247
STAT,1868,33,25-29,1901,9.937943386605648
STAT,1897,45,20-24,1942,0.009325213804341034
STAT,1878,9,na,1887,2798.6504003194323
SIM,1954,15,30-34,1969,23
SIM,1864,75,na,1939,875
STAT,1841,75,na,1916,760.1060694307673
STAT,1877,30,30-34,1907,18.622377602528534
SIM,1912,26,30-34,1938,43
STAT,1946,15,30-34,1961,13.800446668397354
STAT,1822,36,50-100,1858,2.437650466758689
STAT,1886,42,40-44,1928,2.4258050258526156
STAT,1926,15,45-49,1941,0.6277104006148571
STAT,1912,34,na,1946,3763.906060542352
SIM,1872,38,35-39,1910,13
SIM,1876,26,35-39,1902,11
SIM,1928,25,30-34,1953,9
STAT,1877,23,25-29,1900,60.38361445719854
SIM,1923,26,25-29,1949,105
STAT,1847,35,30-34,1882,4.402599714176177
SIM,1925,29,45-49,1954,1
SIM,1835,32,25-29,1867,1
STAT,1854,42,50-100,1896,0.8075648599475322
STAT,1854,38,na,1892,1794.214341078926
SIM,1913,16,20-24,1929,30
STAT,1946,22,20-24,1968,126.24628281544918
SIM,1840,62,na,1902,1211
STAT,1901,20,25-29,1921,82.15265949531398
SIM,1817,80,na,1897,268
SIM,1940,26,25-29,1966,6
STAT,1915,47,40-44,1962,0.16211883666932236
STAT,1904,15,na,1919,3709.7587914667592
STAT,1894,23,25-29,1917,74.88661715043264
STAT,1905,16,20-24,1921,26.184387084283284
SIM,1886,39,25-29,1925,3
STAT,1929,39,30-34,1968,2.38145785331605
STAT,1845,41,40-44,1886,1.8127350934520894
STAT,1857,53,na,1910,1687.9256759852371
STAT,1832,26,20-24,1858,10.839805753953197
STAT,1878,43,45-49,1921,1.577743978523094
STAT,1791,98,na,1889,0.5458365475391733
STAT,1872,26,25-29,1898,43.398650392880164
SIM,1809,61,na,1870,747
STAT,1846,19,na,1865,2037.8618035210377
STAT,1829,29,50-100,1858,0.657243430336293
SIM,1819,48,25-29,1867,1
SIM,1944,11,na,1955,4265
STAT,1840,80,na,1920,445.1406213725664
STAT,1868,48,50-100,1916,0.23629774992612446
STAT,1827,32,25-29,1859,15.817766733050426
STAT,1903,30,na,1933,3488.3602874285666
STAT,1898,23,50-100,1921,0.5608299109034476
STAT,1848,48,na,1896,1726.9010472273787
STAT,1853,60,na,1913,1599.1676508447347
SIM,1870,27,45-49,1897,6
STAT,1915,40,20-24,1955,0.018193876219723716
SIM,1830,31,45-49,1861,3
STAT,1915,33,50-100,1948,0.8556473747745745
STAT,1919,31,50-100,1950,0.9139942301692484
SIM,1911,31,na,1942,3823
STAT,1860,42,50-100,1902,0.8733637087680011
SIM,1905,38,25-29,1943,3
STAT,1833,34,25-29,1867,8.562758932769375
SIM,1843,38,na,1881,1846
STAT,1901,28,20-24,1929,16.676933899032974
SIM,1855,35,30-34,1890,7
SIM,1904,34,25-29,1938,8
STAT,1785,98,na,1883,0.6054535002975296
STAT,1867,36,45-49,1903,1.918414636420995
STAT,1862,22,35-39,1884,5.187575099790874
SIM,1905,24,15-19,1929,5
SIM,1809,49,45-49,1858,1
STAT,1915,33,30-34,1948,16.304975568191374
STAT,1931,36,35-39,1967,3.2699043247401676
SIM,1923,33,30-34,1956,25
STAT,1811,53,50-100,1864,0.039173269643966065
STAT,1861,3,na,1864,2737.4427686375907
SIM,1853,41,40-44,1894,3
STAT,1883,44,30-34,1927,1.13524482033923
SIM,1870,22,35-39,1892,9
STAT,1853,20,35-39,1873,5.865258312528242
SIM,1940,6,na,1946,4164
STAT,1878,50,35-39,1928,0.009272995183988168
SIM,1885,23,25-29,1908,55
STAT,1878,52,na,1930,2274.193795982284
STAT,1867,19,45-49,1886,0.06320536521961909
STAT,1932,26,25-29,1958,87.95922099977523
SIM,1922,46,50-100,1968,1
STAT,1945,6,na,1951,4416.393164122324
STAT,1816,53,30-34,1869,0.011479408414236182
STAT,1828,86,na,1914,122.17983447534233
STAT,1878,39,25-29,1917,3.026537410273034
STAT,1783,79,na,1862,283.89755098410245
SIM,1908,29,45-49,1937,3
SIM,1923,47,40-44,1970,1
SIM,1841,34,25-29,1875,15
STAT,1949,21,na,1970,4348.852240746935
STAT,1854,20,35-39,1874,5.323817238368549
SIM,1817,37,35-39,1854,13
STAT,1916,49,15-19,1965,3.8330875546285195E-4
STAT,1832,46,25-29,1878,0.046318798657752784
STAT,1927,36,45-49,1963,0.8653849892200055
STAT,1882,34,20-24,1916,2.6635066429400114
SIM,1827,37,45-49,1864,1
SIM,1863,37,30-34,1900,5
SIM,1840,20,15-19,1860,3
SIM,1923,36,35-39,1959,2
SIM,1926,24,35-39,1950,20
STAT,1893,26,45-49,1919,1.4418259038596444
STAT,1933,15,50-100,1948,0.5138472678915037
SIM,1866,21,30-34,1887,25
STAT,1876,28,35-39,1904,10.128685831335968
SIM,1868,34,na,1902,2344
STAT,1924,48,45-49,1972,0.2632513387018732
STAT,1866,67,na,1933,1491.6427139459659
STAT,1886,28,45-49,1914,1.1946985531117928
STAT,1863,53,na,1916,1894.982087709925
SIM,1961,0,na,1961,5337
SIM,1940,21,15-19,1961,4
STAT,1775,105,na,1880,0.01919037712474886
SIM,1849,20,na,1869,2025
STAT,1961,3,na,1964,5182.725990552853
STAT,1815,43,20-24,1858,0.4748125181477764
STAT,1935,22,45-49,1957,1.5625433910931465
STAT,1944,4,na,1948,4387.501716895721
SIM,1896,37,50-100,1933,3
SIM,1898,29,40-44,1927,7
STAT,1896,33,na,1929,3201.636258069044
STAT,1896,27,25-29,1923,56.994965217885245
SIM,1861,20,35-39,1881,9
STAT,1890,55,na,1945,2579.135347263981
SIM,1884,28,35-39,1912,1
SIM,1886,15,na,1901,2856
STAT,1868,37,40-44,1905,4.265295815059885
SIM,1894,28,45-49,1922,1
SIM,1906,33,30-34,1939,19
STAT,1907,45,40-44,1952,0.14609465105606617
SIM,1804,58,na,1862,1230
SIM,1859,23,30-34,1882,22
SIM,1876,22,na,1898,2744
STAT,1818,49,45-49,1867,0.5194502293679967
STAT,1829,36,25-29,1865,2.5523721755164126
STAT,1828,48,25-29,1876,0.04445956364214965
STAT,1874,52,25-29,1926,0.0036695858670037934
SIM,1858,35,30-34,1893,13
SIM,1889,29,na,1918,3159
SIM,1941,15,50-100,1956,1
STAT,1838,48,35-39,1886,0.10448017873171976
STAT,1830,33,45-49,1863,1.63903649433858
SIM,1943,22,45-49,1965,2
SIM,1927,37,30-34,1964,2
STAT,1878,36,20-24,1914,0.8224741984567739
STAT,1932,21,15-19,1953,7.14442871538432
SIM,1862,20,35-39,1882,10
STAT,1805,49,35-39,1854,0.4996713885000083
STAT,1840,28,20-24,1868,10.450276567450787
STAT,1819,37,45-49,1856,5.651117890618919
STAT,1880,21,40-44,1901,2.2406491354721854
SIM,1819,54,na,1873,1268
STAT,1846,47,30-34,1893,0.0689010620785661
STAT,1913,30,45-49,1943,1.6099937873827261
SIM,1856,49,na,1905,2143
STAT,1888,36,30-34,1924,6.458514758993142
SIM,1919,38,35-39,1957,2
STAT,1940,16,40-44,1956,1.449219726858415
STAT,1891,46,30-34,1937,0.06915960774010262
STAT,1930,16,30-34,1946,16.111486788789826
STAT,1915,36,35-39,1951,2.505386947902237
SIM,1900,19,15-19,1919,1
SIM,1905,45,30-34,1950,1
STAT,1855,33,15-19,1888,0.11124292008908841
STAT,1910,42,45-49,1952,0.16042214303347416
STAT,1913,26,50-100,1939,1.0152427814805176
SIM,1876,37,40-44,1913,10
SIM,1922,36,35-39,1958,3
STAT,1866,40,15-19,1906,0.013125758480450972
STAT,1843,102,na,1945,0.23667225621730092
SIM,1861,23,na,1884,2592
SIM,1845,61,na,1906,1439
STAT,1888,37,50-100,1925,1.4806825754141621
STAT,1921,42,20-24,1963,0.02029778191964187
SIM,1908,20,35-39,1928,17
STAT,1833,46,na,1879,1594.922552417167
SIM,1914,45,na,1959,3753
SIM,1873,89,na,1962,125
STAT,1881,34,na,1915,2333.4143856407027
SIM,1775,87,na,1862,12
STAT,1826,35,45-49,1861,1.8682341134674243
STAT,1914,36,35-39,1950,2.4758329616516384
SIM,1786,80,na,1866,171
STAT,1866,20,45-49,1886,0.6711190851086148
STAT,1831,29,40-44,1860,2.816206805734182
SIM,1816,43,na,1859,1623
STAT,1856,33,15-19,1889,0.11424433788715556
STAT,1868,26,35-39,1894,9.433864654659418
SIM,1880,22,45-49,1902,1
SIM,1919,25,20-24,1944,18
STAT,1844,39,45-49,1883,1.5988518058726955
STAT,1856,26,50-100,1882,0.5346657335507401
STAT,1919,37,30-34,1956,1.9980862786329405
SIM,1875,74,na,1949,1065
STAT,1929,37,40-44,1966,1.9602076065983134
SIM,1807,69,na,1876,697
STAT,1859,34,45-49,1893,1.4085544123256588
STAT,1874,35,25-29,1909,3.0273425038214716
STAT,1945,17,20-24,1962,151.10039336724353
STAT,1808,79,na,1887,260.7351349386054
STAT,1933,33,na,1966,5194.599541286861
STAT,1848,42,20-24,1890,0.12329864038995282
STAT,1887,48,30-34,1935,0.10926492421742272
SIM,1936,29,na,1965,3203
SIM,1867,21,15-19,1888,4
SIM,1878,88,na,1966,284
SIM,1931,35,30-34,1966,5
STAT,1871,34,45-49,1905,1.7470882351732422
SIM,1893,15,30-34,1908,6
STAT,1850,79,na,1929,525.8703472314568
SIM,1923,23,20-24,1946,127
SIM,1961,3,na,1964,5332
STAT,1842,25,50-100,1867,0.6293701981483283
STAT,1966,0,na,1966,5045.6490482809095
SIM,1885,74,na,1959,1311
STAT,1894,21,35-39,1915,7.680541642801707
STAT,1852,25,45-49,1877,1.0569399119127525
STAT,1893,66,na,1959,2225.9022488731416
SIM,1839,29,35-39,1868,13
STAT,1805,58,na,1863,1236.9082753971404
STAT,1840,15,25-29,1855,5.342344315846575
STAT,1795,64,na,1859,740.6704769606242
SIM,1774,95,na,1869,7
STAT,1851,53,35-39,1904,0.006988583223207876
SIM,1928,32,20-24,1960,6
STAT,1827,30,35-39,1857,17.34666063759115
STAT,1861,39,50-100,1900,1.0245318650009678
STAT,1877,1,na,1878,3644.571981471284
SIM,1876,24,45-49,1900,2
STAT,1922,17,35-39,1939,4.955121725659339
STAT,1832,24,30-34,1856,17.160883206708455
SIM,1852,39,45-49,1891,5
STAT,1839,34,na,1873,1802.822314283206
STAT,1906,31,15-19,1937,0.12191275055571456
STAT,1851,68,na,1919,1260.7895369082967
STAT,1918,24,35-39,1942,10.298392523557482
STAT,1868,21,40-44,1889,2.0450789625303356
STAT,1858,21,30-34,1879,16.65332762518353
SIM,1858,41,na,1899,1896
STAT,1854,38,25-29,1892,2.192676964195305
STAT,1870,93,na,1963,73.87566248281799
STAT,1837,42,45-49,1879,1.177489764890576
SIM,1835,30,35-39,1865,16
STAT,1772,91,na,1863,9.575784986011888
SIM,1870,75,na,1945,984
STAT,1829,43,15-19,1872,0.011431988865480431
SIM,1930,17,35-39,1947,6
STAT,1941,26,35-39,1967,15.852053265621027
STAT,1859,21,15-19,1880,3.0866085850422462
SIM,1837,36,25-29,1873,7
SIM,1843,42,na,1885,1809
STAT,1903,67,na,1970,2654.3834756516458
SIM,1827,80,na,1907,308
STAT,1824,35,na,1859,1611.9564609674092
STAT,1865,49,40-44,1914,0.15520490113152424
SIM,1936,23,15-19,1959,5
SIM,1912,19,25-29,1931,15
STAT,1904,19,25-29,1923,8.240698574498586
SIM,1834,24,na,1858,1822
STAT,1841,33,20-24,1874,2.3964997890133777
STAT,1913,18,20-24,1931,28.204294268218096
SIM,1926,29,na,1955,4691
STAT,1923,18,30-34,1941,14.564929330719773
SIM,1921,18,20-24,1939,241
SIM,1948,16,35-39,1964,8
STAT,1842,46,35-39,1888,0.11122285682847555
SIM,1871,25,20-24,1896,15
STAT,1887,17,50-100,1904,0.05600425228157091
STAT,1928,23,15-19,1951,6.758360080599849
SIM,1931,18,30-34,1949,26
SIM,1837,35,na,1872,1648
SIM,1848,30,45-49,1878,5
STAT,1877,33,35-39,1910,10.670087808611061
SIM,1891,47,35-39,1938,1
SIM,1862,42,50-100,1904,1
SIM,1904,17,25-29,1921,12
SIM,1821,37,50-100,1858,4
STAT,1945,27,30-34,1972,43.8581778397242
STAT,1900,25,35-39,1925,13.735659126596518
SIM,1830,24,20-24,1854,4
STAT,1896,34,15-19,1930,0.19023072620719067
STAT,1869,29,20-24,1898,11.471823798201108
SIM,1865,19,35-39,1884,4
STAT,1879,49,35-39,1928,0.14617264536255523
STAT,1849,28,40-44,1877,2.737031177801605
SIM,1895,30,40-44,1925,12
STAT,1940,28,25-29,1968,68.43958285251733
STAT,1904,29,35-39,1933,14.006540564255664
STAT,1927,18,15-19,1945,57.41076941453207
STAT,1822,61,na,1883,1153.5618957112965
STAT,1917,24,50-100,1941,0.7091902142728008
SIM,1936,29,20-24,1965,22
STAT,1833,51,25-29,1884,0.0024628688425111815
STAT,1853,15,35-39,1868,0.5600384290216677
SIM,1931,25,20-24,1956,24
STAT,1877,66,na,1943,1734.213629194928
STAT,1915,23,20-24,1938,116.92830607915539
SIM,1905,28,30-34,1933,36
STAT,1859,85,na,1944,223.3414221803178
SIM,1877,1,na,1878,3570
STAT,1819,54,45-49,1873,0.02657046295949126
STAT,1801,62,na,1863,875.0502146645733
SIM,1885,33,35-39,1918,1
STAT,1868,52,na,1920,2086.8076934684104
SIM,1861,15,35-39,1876,1
STAT,1855,39,20-24,1894,0.5915465470632488
STAT,1916,39,20-24,1955,0.2727075785115196
SIM,1839,36,50-100,1875,1
STAT,1845,24,40-44,1869,1.9923561656932982
STAT,1897,34,15-19,1931,0.19258619281823713
SIM,1896,7,na,1903,3573
SIM,1860,75,na,1935,970
STAT,1921,48,na,1969,4214.413771963331
STAT,1923,25,20-24,1948,21.528133089012734
SIM,1857,28,40-44,1885,9
SIM,1899,23,35-39,1922,10
STAT,1892,30,15-19,1922,0.18354058514558744
STAT,1816,98,na,1914,1.4414212879936585
STAT,1928,29,20-24,1957,22.9161282171657
SIM,1912,29,35-39,1941,27
STAT,1883,47,35-39,1930,0.13948184403097652
STAT,1870,29,45-49,1899,1.099350064467645
STAT,1855,23,20-24,1878,61.960709372728545
SIM,1841,26,50-100,1867,1
SIM,1934,16,40-44,1950,4
SIM,1868,38,45-49,1906,4
SIM,1925,44,na,1969,4715
STAT,1823,87,na,1910,98.05391966137257
SIM,1871,23,na,1894,2216
STAT,1867,16,40-44,1883,0.18013941772705158
STAT,1850,38,40-44,1888,3.310368700450864
SIM,1953,17,20-24,1970,158
SIM,1902,16,na,1918,3697
SIM,1908,26,40-44,1934,7
STAT,1914,26,40-44,1940,4.81059010541767
STAT,1937,15,20-24,1952,135.15869057010156
STAT,1833,26,50-100,1859,0.5699697986660257
STAT,1831,39,35-39,1870,6.07410268743712
STAT,1905,26,15-19,1931,0.6707541489584765
SIM,1954,17,20-24,1971,167
STAT,1956,15,50-100,1971,0.5058866039269022
STAT,1835,22,40-44,1857,2.0646579682606068
SIM,1853,24,40-44,1877,3
STAT,1866,54,40-44,1920,0.00963379019340275
SIM,1853,44,45-49,1897,3
STAT,1931,16,15-19,1947,60.73067553665207
STAT,1827,36,40-44,1863,5.836773958067748
STAT,1869,31,35-39,1900,10.014993727387242
SIM,1904,45,na,1949,3492
STAT,1856,44,20-24,1900,0.1254613671009234
STAT,1902,49,20-24,1951,0.009534864839181648
STAT,1847,53,na,1900,1652.1089461619295
SIM,1900,34,40-44,1934,9
STAT,1847,37,20-24,1884,0.6236866631572034
SIM,1795,94,na,1889,6
SIM,1876,31,35-39,1907,20
STAT,1801,99,na,1900,0.675728317281155
STAT,1842,102,na,1944,0.2299091768412767
STAT,1835,72,na,1907,940.9399084860604
STAT,1890,48,na,1938,2771.563165659607
SIM,1843,22,40-44,1865,1
SIM,1818,42,35-39,1860,4
SIM,1850,24,na,1874,1951
SIM,1887,49,35-39,1936,1
STAT,1946,17,20-24,1963,153.42034408694246
STAT,1887,30,40-44,1917,4.99729407493203
STAT,1804,80,na,1884,266.4551041516798
STAT,1888,32,15-19,1920,0.17174653156765454
SIM,1840,29,25-29,1869,5
SIM,1922,26,40-44,1948,5
STAT,1856,67,na,1923,1269.4479881108502
SIM,1878,37,25-29,1915,4
STAT,1926,16,40-44,1942,1.7537580039063319
SIM,1935,18,15-19,1953,57
STAT,1832,29,25-29,1861,37.61029985945905
STAT,1923,35,30-34,1958,2.1584026038287716
STAT,1905,19,25-29,1924,8.304269332404413
STAT,1909,32,45-49,1941,1.5314516549540504
STAT,1847,31,15-19,1878,0.1317494145035658
SIM,1863,23,20-24,1886,57
SIM,1913,21,20-24,1934,99
SIM,1921,30,45-49,1951,7
STAT,1837,35,20-24,1872,0.6388803312979903
STAT,1900,15,25-29,1915,8.049696312005768
STAT,1845,44,45-49,1889,1.1606916099539533
STAT,1894,27,40-44,1921,3.9308335005187733
SIM,1886,36,20-24,1922,1
STAT,1828,30,35-39,1858,10.72485511028918
STAT,1840,22,15-19,1862,3.0189846765226545
SIM,1885,20,20-24,1905,77
SIM,1916,30,na,1946,3981
SIM,1858,22,35-39,1880,5
SIM,1796,79,na,1875,252
STAT,1937,28,35-39,1965,14.920987890293855
SIM,1843,27,35-39,1870,12
SIM,1874,20,45-49,1894,1
SIM,1854,75,na,1929,827
SIM,1917,15,na,1932,4233
SIM,1869,40,40-44,1909,4
STAT,1836,20,na,1856,1775.4558021927046
STAT,1824,48,40-44,1872,0.19684540017511545
SIM,1907,63,na,1970,3060
STAT,1833,31,20-24,1864,2.3341748550533636
SIM,1919,44,na,1963,4161
SIM,1833,76,na,1909,610
STAT,1869,37,na,1906,2320.421778831784
STAT,1881,18,15-19,1899,5.837778169709972
STAT,1891,39,40-44,1930,5.473132346069049
STAT,1863,32,45-49,1895,1.5597647637443277
STAT,1886,45,45-49,1931,0.2573762579839619
STAT,1905,21,20-24,1926,101.8383816659223
SIM,1835,36,40-44,1871,9
SIM,1904,38,40-44,1942,2
SIM,1927,27,20-24,1954,26
SIM,1913,19,25-29,1932,20
STAT,1835,27,35-39,1862,9.37344902188467
SIM,1836,30,35-39,1866,4
SIM,1859,43,35-39,1902,1
SIM,1914,34,35-39,1948,16
STAT,1817,87,na,1904,85.98195401992133
STAT,1808,101,na,1909,0.1899661007860646
SIM,1935,36,45-49,1971,1
STAT,1908,47,15-19,1955,3.3971255665346973E-4
STAT,1901,38,15-19,1939,0.017205045963145413
STAT,1762,102,na,1864,0.07746595968962261
STAT,1838,86,na,1924,163.02400373659046
STAT,1889,43,20-24,1932,0.19868155591326023
STAT,1938,3,na,1941,4081.4639507835936
STAT,1938,25,15-19,1963,0.7140648447468426
STAT,1895,21,35-39,1916,7.790537365059141
SIM,1933,3,na,1936,5382
SIM,1851,61,na,1912,1504
STAT,1889,51,na,1940,2726.3573774520846
SIM,1901,31,na,1932,3571
STAT,1939,21,na,1960,3742.4989180504413
STAT,1920,37,20-24,1957,0.2945378645015286
STAT,1829,49,20-24,1878,0.009464425260886627
STAT,1850,45,30-34,1895,0.07353934632733547
SIM,1853,90,na,1943,55
SIM,1884,23,40-44,1907,4
STAT,1917,49,15-19,1966,3.903486107684012E-4
STAT,1857,19,35-39,1876,0.507786831431378
STAT,1859,32,50-100,1891,0.7464789618695238
STAT,1915,43,25-29,1958,0.07324699022096358
STAT,1853,53,na,1906,1776.4401939685997
STAT,1937,35,25-29,1972,1.0060174951639498
STAT,1942,29,20-24,1971,19.526984340064683
STAT,1919,27,20-24,1946,20.12695105048351
SIM,1871,16,na,1887,2492
STAT,1859,50,30-34,1909,0.004919322379087678
STAT,1906,50,na,1956,3261.1524553479653
STAT,1880,31,50-100,1911,0.9862564289814777
SIM,1910,29,25-29,1939,70
STAT,1847,38,na,1885,1886.5081707332333
STAT,1904,26,25-29,1930,62.059706188527166
SIM,1881,36,25-29,1917,5
SIM,1848,91,na,1939,82
STAT,1906,34,35-39,1940,8.560397433218125
STAT,1851,43,na,1894,1893.038582278218
SIM,1916,39,45-49,1955,4
STAT,1862,46,20-24,1908,0.010450387373650847
STAT,1923,20,20-24,1943,132.79448303793444
STAT,1930,18,20-24,1948,178.29984422912347
SIM,1816,42,25-29,1858,1
SIM,1826,88,na,1914,46
STAT,1921,23,20-24,1944,127.76341099922831
SIM,1871,91,na,1962,159
SIM,1793,84,na,1877,60
SIM,1931,39,40-44,1970,1
STAT,1877,30,25-29,1907,10.924669688068716
SIM,1834,26,40-44,1860,3
SIM,1838,20,40-44,1858,2
SIM,1912,26,25-29,1938,66
SIM,1935,33,40-44,1968,2
STAT,1932,26,30-34,1958,52.3618412615355
STAT,1869,27,45-49,1896,1.093546906885877
STAT,1927,33,40-44,1960,4.907458526166806
STAT,1875,21,30-34,1896,18.7059551515348
STAT,1893,17,40-44,1910,0.23670334612409794
SIM,1914,14,na,1928,4125
STAT,1858,49,50-100,1907,0.19454374009335706
SIM,1831,42,20-24,1873,2
SIM,1903,39,35-39,1942,5
SIM,1918,28,na,1946,4139
STAT,1852,27,50-100,1879,0.600234501049568
STAT,1914,42,15-19,1956,0.0015525605063444602
SIM,1884,42,na,1926,2450
SIM,1839,55,na,1894,1521
SIM,1876,43,35-39,1919,4
SIM,1893,40,30-34,1933,1
SIM,1899,25,30-34,1924,3
STAT,1859,23,na,1882,1984.8083429288072
SIM,1834,83,na,1917,188
STAT,1943,16,35-39,1959,4.541088450587193
STAT,1811,109,na,1920,3.081747810644263E-4
STAT,1924,16,50-100,1940,0.4563059249027665
STAT,1836,48,15-19,1884,2.572582160438753E-4
STAT,1843,48,na,1891,1793.4146714731355
STAT,1838,61,na,1899,1372.9840096723615
STAT,1902,29,25-29,1931,60.421794257750456
SIM,1883,33,25-29,1916,15
STAT,1875,33,25-29,1908,10.67886009656214
STAT,1934,21,35-39,1955,12.908694215246909
SIM,1841,16,30-34,1857,1
SIM,1928,0,na,1928,5558
SIM,1941,28,na,1969,3724
SIM,1785,89,na,1874,22
STAT,1892,30,20-24,1922,3.4838079301976403
SIM,1928,18,30-34,1946,14
STAT,1912,45,15-19,1957,3.628451689133049E-4
STAT,1810,47,40-44,1857,0.5382249384262944
STAT,1910,23,45-49,1933,1.0743565636731613
STAT,1864,93,na,1957,34.41599100844206
SIM,1800,71,na,1871,606
STAT,1892,38,50-100,1930,1.561959168198047
SIM,1942,21,35-39,1963,16
SIM,1951,16,35-39,1967,4
STAT,1911,16,15-19,1927,9.286330387730269
SIM,1832,29,40-44,1861,1
STAT,1930,29,30-34,1959,50.76421884584826
STAT,1904,39,30-34,1943,1.6649491842782964
STAT,1796,80,na,1876,256.838142470861
STAT,1892,25,na,1917,3072.018796304609
SIM,1931,35,50-100,1966,3
STAT,1913,20,50-100,1933,0.6543383528862639
SIM,1858,34,na,1892,1926
SIM,1854,20,na,1874,2190
SIM,1942,23,30-34,1965,35
STAT,1911,16,50-100,1927,0.07666204052218122
SIM,1857,31,30-34,1888,23
STAT,1939,27,25-29,1966,67.50118878539209
STAT,1932,24,35-39,1956,12.556058882645871
STAT,1916,41,40-44,1957,0.26194872182579576
SIM,1891,43,30-34,1934,4
SIM,1935,31,45-49,1966,5
STAT,1876,17,35-39,1893,0.5780263347669389
STAT,1937,19,15-19,1956,44.90085052610477
STAT,1896,15,na,1911,3418.694421269603
STAT,1866,46,35-39,1912,0.13210984832601147
SIM,1858,10,na,1868,2372
SIM,1874,40,20-24,1914,2
STAT,1894,37,50-100,1931,1.6110664119583373
STAT,1914,44,40-44,1958,0.2520319060610391
SIM,1888,22,20-24,1910,88
STAT,1778,112,na,1890,5.145480973798222E-4
STAT,1849,31,30-34,1880,15.86012647013823
STAT,1866,40,20-24,1906,0.15094621437245007
STAT,1881,65,na,1946,1666.7718404165294
STAT,1856,98,na,1954,2.6014431519850483
SIM,1911,27,50-100,1938,2
STAT,1870,40,40-44,1910,2.2657527712715213
STAT,1818,43,50-100,1861,2.597867611190959
STAT,1843,25,50-100,1868,0.6447557443128825
SIM,1877,24,40-44,1901,1
SIM,1829,37,na,1866,1503
SIM,1940,24,35-39,1964,14
STAT,1883,43,30-34,1926,1.1424652004057947
SIM,1907,46,40-44,1953,1
SIM,1825,47,na,1872,1452
SIM,1925,26,35-39,1951,33
SIM,1821,33,na,1854,1625
SIM,1953,7,na,1960,4773
STAT,1914,33,30-34,1947,16.11263920108364
STAT,1852,84,na,1936,267.9940127594711
SIM,1945,19,15-19,1964,57
SIM,1905,47,45-49,1952,1
STAT,1863,33,50-100,1896,0.8160789652959464
STAT,1940,32,15-19,1972,0.13567945633137277
STAT,1794,97,na,1891,1.0648671606049127
STAT,1870,22,na,1892,2358.574752870203
SIM,1922,33,30-34,1955,23
STAT,1809,64,na,1873,1100.095579301688
STAT,1866,50,50-100,1916,0.014415458417593787
STAT,1864,49,35-39,1913,0.12434003772523303
STAT,1840,20,50-100,1860,0.37859197368644704
STAT,1865,27,30-34,1892,23.31599222779037
STAT,1868,99,na,1967,9.462693148524794
STAT,1934,23,30-34,1957,39.37663783383975
STAT,1863,19,20-24,1882,16.272766227839234
STAT,1915,29,35-39,1944,15.514913507310657
SIM,1885,30,25-29,1915,15
SIM,1838,73,na,1911,731
SIM,1940,26,30-34,1966,4
STAT,1917,26,35-39,1943,16.122768352238964
STAT,1958,7,na,1965,5264.809266142204
SIM,1929,34,25-29,1963,25
STAT,1864,43,20-24,1907,0.1430158601701271
STAT,1881,46,30-34,1927,0.09574271446680921
SIM,1879,21,40-44,1900,4
SIM,1888,32,na,1920,2798
STAT,1930,16,25-29,1946,57.281617903941104
SIM,1906,23,20-24,1929,102
STAT,1866,17,na,1883,2439.3048201261677
SIM,1871,19,20-24,1890,22
STAT,1835,19,45-49,1854,0.13402420179376354
SIM,1923,29,35-39,1952,22
STAT,1818,104,na,1922,0.033991461469751835
STAT,1844,89,na,1933,81.40717014248166
SIM,1934,34,na,1968,5367
SIM,1804,61,na,1865,1143
SIM,1892,77,na,1969,1773
STAT,1876,94,na,1970,94.79984027724325
SIM,1916,33,30-34,1949,18
STAT,1830,27,15-19,1857,0.5132247907770768
STAT,1890,9,na,1899,3236.381497919441
STAT,1938,34,25-29,1972,9.468000901682707
SIM,1847,24,25-29,1871,74
STAT,1849,40,15-19,1889,0.010908787439440666
SIM,1873,16,20-24,1889,17
SIM,1859,75,na,1934,854
STAT,1896,41,45-49,1937,0.14066372942276859
SIM,1856,16,20-24,1872,24
STAT,1831,82,na,1913,314.39312790372725
STAT,1869,7,na,1876,2715.9675146008226
STAT,1777,110,na,1887,0.002392475871748296
STAT,1869,21,30-34,1890,17.59643310880529
STAT,1852,16,40-44,1868,0.17926649598432473
SIM,1863,80,na,1943,393
STAT,1910,25,40-44,1935,4.66094977365611
STAT,1894,33,35-39,1927,13.232841191567633
STAT,1865,16,20-24,1881,17.01547376823442
SIM,1905,30,20-24,1935,3
STAT,1909,39,na,1948,3595.2515520406328
STAT,1908,33,30-34,1941,15.100871368928038
STAT,1861,29,50-100,1890,0.535386315786238
STAT,1899,38,40-44,1937,1.3133737609589036
STAT,1894,44,45-49,1938,0.13453767530484217
SIM,1852,42,35-39,1894,2
SIM,1926,39,na,1965,4904
STAT,1877,49,15-19,1926,4.143972257253353E-4
STAT,1830,38,25-29,1868,2.564425472020617
STAT,1879,54,20-24,1933,7.652452361226142E-4
STAT,1839,37,30-34,1876,4.395471770387506
SIM,1912,39,30-34,1951,2
SIM,1905,21,na,1926,3653
STAT,1934,29,45-49,1963,2.3677328734952594
STAT,1851,32,25-29,1883,8.795275429940377
SIM,1846,25,na,1871,2100
STAT,1945,24,15-19,1969,5.948307115268472
STAT,1867,58,na,1925,1894.0078161230144
STAT,1944,24,50-100,1968,0.7243440483462359
STAT,1805,74,na,1879,560.4619990195816
SIM,1881,5,na,1886,2457
STAT,1907,16,25-29,1923,8.508965610569131
STAT,1928,24,15-19,1952,6.7368684955435425
STAT,1792,90,na,1882,27.3171907157916
STAT,1848,27,30-34,1875,23.368521718150145
STAT,1904,28,20-24,1932,17.09177848491313
SIM,1877,21,30-34,1898,21
STAT,1871,63,na,1934,1803.0833901603391
STAT,1886,5,na,1891,2829.7971827740803
SIM,1851,55,na,1906,1686
STAT,1844,42,35-39,1886,1.4371316224250523
STAT,1788,85,na,1873,96.32445736390672
SIM,1842,19,na,1861,2169
STAT,1912,36,30-34,1948,1.8233911373584661
STAT,1784,79,na,1863,230.9534404837402
SIM,1897,15,25-29,1912,11
SIM,1856,27,30-34,1883,4
STAT,1862,27,na,1889,2080.0969063058433
SIM,1896,67,na,1963,2331
SIM,1915,16,25-29,1931,16
STAT,1889,15,25-29,1904,7.174069376610012
SIM,1858,27,35-39,1885,10
STAT,1848,16,20-24,1864,17.18477702160539
STAT,1780,106,na,1886,0.012070744686826406
STAT,1844,53,45-49,1897,0.011065270931334421
SIM,1913,31,50-100,1944,5
SIM,1912,28,20-24,1940,23
STAT,1798,87,na,1885,72.17196304300741
STAT,1936,34,20-24,1970,2.413320986082405
STAT,1899,31,15-19,1930,0.19975219667055522
STAT,1927,31,45-49,1958,1.975691429749315
SIM,1861,32,35-39,1893,17
STAT,1823,42,20-24,1865,0.2569049832933957
STAT,1930,16,na,1946,4865.325844009053
SIM,1847,37,30-34,1884,4
SIM,1898,34,na,1932,3707
STAT,1899,22,30-34,1921,24.88321979513203
SIM,1821,73,na,1894,606
STAT,1885,40,30-34,1925,1.181914759795215
STAT,1889,17,20-24,1906,22.340495908206353
SIM,1916,20,25-29,1936,89
STAT,1823,48,35-39,1871,0.2075074206280514
STAT,1852,68,na,1920,1231.1184475226119
STAT,1840,48,35-39,1888,0.10029872821469829
STAT,1840,42,20-24,1882,0.11921229897862103
STAT,1914,47,45-49,1961,0.219920983109685
SIM,1814,63,na,1877,966
SIM,1772,82,na,1854,140
STAT,1834,20,30-34,1854,28.914412191486306
STAT,1821,48,25-29,1869,0.08941015430758625
SIM,1830,36,50-100,1866,3
SIM,1854,42,50-100,1896,2
SIM,1916,31,35-39,1947,17
STAT,1829,39,50-100,1868,1.04539850912407
STAT,1889,45,na,1934,2863.3874740157207
STAT,1839,26,20-24,1865,10.27340965266993
SIM,1876,47,na,1923,2593
STAT,1890,33,20-24,1923,3.3573965499257272
STAT,1890,39,35-39,1929,8.733522974956553
STAT,1923,39,40-44,1962,1.7659926351777673
STAT,1858,30,15-19,1888,0.11762651234946374
STAT,1856,74,na,1930,888.7225741221962
SIM,1936,24,15-19,1960,7
STAT,1881,30,45-49,1911,1.7337171630139487
SIM,1850,30,na,1880,1949
SIM,1898,23,50-100,1921,1
STAT,1853,32,35-39,1885,8.744518769975262
SIM,1894,20,na,1914,3427
STAT,1821,37,15-19,1858,0.12295382859907973
STAT,1927,12,na,1939,5025.518234142977
STAT,1810,45,45-49,1855,0.7685686282712799
STAT,1924,16,25-29,1940,52.77939596612604
STAT,1825,42,25-29,1867,0.8768246921130363
STAT,1839,24,25-29,1863,50.03645356854273
SIM,1897,17,20-24,1914,23
STAT,1908,20,25-29,1928,87.10918158027822
STAT,1834,32,25-29,1866,8.829203668907692
SIM,1866,30,15-19,1896,1
SIM,1893,19,na,1912,3307
STAT,1858,37,40-44,1895,3.54143334979682
STAT,1822,46,na,1868,1535.002592935059
SIM,1875,22,na,1897,2366
SIM,1868,12,na,1880,2678
SIM,1880,52,na,1932,2041
SIM,1797,74,na,1871,352
STAT,1766,117,na,1883,1.0299664540356925E-4
SIM,1878,51,45-49,1929,1
SIM,1959,10,na,1969,5721
STAT,1889,28,30-34,1917,31.62111104148853
SIM,1899,28,35-39,1927,24
STAT,1901,19,na,1920,3583.6550741157957
STAT,1947,24,25-29,1971,106.4385818048949
STAT,1871,39,25-29,1910,2.8802168436833533
SIM,1897,28,30-34,1925,49
STAT,1845,21,45-49,1866,0.6812878621505327
STAT,1908,31,35-39,1939,8.831942339873175
STAT,1913,44,na,1957,3682.4907843405226
SIM,1817,68,na,1885,729
SIM,1847,26,20-24,1873,13
STAT,1919,34,15-19,1953,0.14026829467137886
STAT,1911,3,na,1914,4126.6109775897685
SIM,1842,32,25-29,1874,16
SIM,1932,16,25-29,1948,69
STAT,1835,96,na,1931,6.397625580494607
SIM,1931,20,20-24,1951,147
STAT,1906,34,na,1940,3542.8496669719307
SIM,1819,94,na,1913,3
SIM,1898,32,30-34,1930,34
STAT,1908,39,45-49,1947,0.6443068962796367
STAT,1923,37,45-49,1960,0.8059374550666918
SIM,1836,23,40-44,1859,2
SIM,1853,21,45-49,1874,1
STAT,1900,18,35-39,1918,0.7738144304686742
STAT,1849,47,50-100,1896,0.18978521531308595
STAT,1893,50,na,1943,2826.6352008972362
STAT,1815,39,40-44,1854,16.657190289739834
STAT,1895,17,45-49,1912,0.08694496910305935
STAT,1906,20,20-24,1926,102.93494897431195
STAT,1921,26,25-29,1947,75.11298658629615
SIM,1932,4,na,1936,5605
STAT,1851,46,45-49,1897,0.19525690293241596
STAT,1905,7,na,1912,3838.5873617532266
SIM,1837,19,15-19,1856,7
STAT,1846,96,na,1942,6.140505689219316
SIM,1819,39,20-24,1858,2
SIM,1905,37,na,1942,3429
SIM,1867,27,na,1894,2168
STAT,1920,14,na,1934,4521.865970716613
STAT,1851,100,na,1951,0.8758756091388705
STAT,1887,15,15-19,1902,6.815502507497192
STAT,1918,24,50-100,1942,0.7196641319996884
STAT,1853,43,45-49,1896,1.24586548341788
STAT,1874,17,30-34,1891,1.660113612841258
STAT,1865,2,na,1867,3140.053301299352
STAT,1875,24,35-39,1899,6.071561337526227
STAT,1850,16,30-34,1866,1.4737369089927976
STAT,1932,6,na,1938,5412.476177046856
SIM,1895,15,15-19,1910,10
STAT,1875,47,50-100,1922,0.2559469894291867
STAT,1845,38,15-19,1883,0.04562410040849496
STAT,1875,30,20-24,1905,2.8528803034146177
SIM,1836,26,45-49,1862,2
SIM,1910,26,20-24,1936,29
STAT,1917,23,30-34,1940,31.076247667430668
STAT,1910,20,40-44,1930,3.2396702823884036
SIM,1836,66,na,1902,1279
SIM,1914,20,20-24,1934,117
STAT,1916,44,45-49,1960,0.1734673409513249
SIM,1859,7,na,1866,2712
SIM,1862,39,25-29,1901,6
STAT,1902,26,20-24,1928,16.93531841686971
STAT,1923,23,25-29,1946,109.31925652396822
STAT,1847,46,25-29,1893,0.04504475755669396
STAT,1939,15,30-34,1954,12.476976766216705
SIM,1879,12,na,1891,3166
SIM,1851,26,40-44,1877,4
STAT,1828,26,45-49,1854,2.2766744953203912
SIM,1797,58,na,1855,1001
SIM,1879,32,20-24,1911,7
SIM,1910,15,35-39,1925,1
STAT,1826,29,45-49,1855,1.8707398998140812
STAT,1764,99,na,1863,0.5554820952957517
SIM,1831,35,na,1866,1745
SIM,1841,19,35-39,1860,3
STAT,1838,21,na,1859,2052.9437461329107
STAT,1862,49,25-29,1911,0.048975465304640725
SIM,1843,16,35-39,1859,1
STAT,1864,53,na,1917,1921.7412074658162
SIM,1839,15,na,1854,2283
SIM,1888,27,20-24,1915,22
STAT,1806,99,na,1905,0.6729552639445374
SIM,1923,24,35-39,1947,14
SIM,1870,49,25-29,1919,1
STAT,1862,38,15-19,1900,0.048522750731799937
SIM,1917,49,50-100,1966,1
STAT,1931,33,30-34,1964,21.041321453821784
SIM,1912,31,na,1943,3882
STAT,1894,30,25-29,1924,13.548568825823391
STAT,1823,71,na,1894,742.8871039028464
SIM,1947,15,30-34,1962,20
SIM,1894,20,25-29,1914,5
SIM,1925,23,30-34,1948,46
SIM,1834,29,45-49,1863,4
SIM,1888,38,30-34,1926,9
STAT,1886,46,50-100,1932,0.2659548088920158
SIM,1884,82,na,1966,603
STAT,1902,18,45-49,1920,0.09372971094266784
STAT,1886,39,15-19,1925,0.0600260971816139
STAT,1930,32,na,1962,4978.075790987602
SIM,1939,2,na,1941,4070
STAT,1921,35,15-19,1956,0.021918201308203645
SIM,1904,18,15-19,1922,13
SIM,1906,26,25-29,1932,8
SIM,1883,49,40-44,1932,1
SIM,1902,16,15-19,1918,9
STAT,1885,71,na,1956,1389.848220424081
SIM,1878,19,30-34,1897,2
STAT,1888,47,25-29,1935,0.06914290540025461
SIM,1838,31,20-24,1869,1
STAT,1883,40,20-24,1923,0.16057038372363572
STAT,1901,59,na,1960,2884.340212169241
SIM,1860,2,na,1862,2906
STAT,1841,29,40-44,1870,2.7078333044350247
STAT,1878,17,45-49,1895,0.06936343539049712
STAT,1928,44,50-100,1972,0.15225500298504607
STAT,1842,42,30-34,1884,0.9327772780812058
STAT,1937,4,na,1941,4005.1752145227624
SIM,1847,10,na,1857,2152
STAT,1897,22,20-24,1919,93.99916306464259
SIM,1821,34,50-100,1855,1
SIM,1913,43,30-34,1956,1
STAT,1913,16,25-29,1929,9.061071334679808
SIM,1921,16,25-29,1937,81
STAT,1814,94,na,1908,9.3132564192735
STAT,1891,17,30-34,1908,2.0130538227400945
STAT,1881,49,35-39,1930,0.1351958558622891
STAT,1896,6,na,1902,3519.7686116767222
SIM,1916,34,45-49,1950,4
STAT,1843,26,40-44,1869,2.997596288440973
STAT,1847,81,na,1928,421.6951985146803
STAT,1825,45,35-39,1870,0.1850660397109368
STAT,1908,36,50-100,1944,0.4027775105449642
SIM,1850,14,na,1864,2252
SIM,1947,24,20-24,1971,143
STAT,1833,42,50-100,1875,0.847012592926299
STAT,1841,41,na,1882,1796.1423950179044
STAT,1872,88,na,1960,226.6121293047927
STAT,1949,2,na,1951,4759.773086577018
SIM,1802,78,na,1880,281
SIM,1901,22,30-34,1923,39
STAT,1827,53,45-49,1880,0.01541541268318586
STAT,1893,10,na,1903,3352.261237948348
STAT,1928,24,45-49,1952,1.4239859103407124
STAT,1827,42,35-39,1869,2.1459185163874817
SIM,1843,60,na,1903,1432
STAT,1819,48,15-19,1867,7.810285432913465E-4
STAT,1943,27,15-19,1970,0.7670728561533466
SIM,1909,11,na,1920,3799
STAT,1918,41,45-49,1959,0.1808350409654034
SIM,1857,34,35-39,1891,18
STAT,1868,40,25-29,1908,0.6320103542745199
SIM,1832,22,15-19,1854,3
STAT,1927,44,20-24,1971,0.022518195512923594
STAT,1939,24,20-24,1963,113.84140424190728
STAT,1905,43,30-34,1948,0.11677523928216245
SIM,1877,29,50-100,1906,1
STAT,1776,84,na,1860,98.30830000342293
SIM,1918,31,45-49,1949,1
STAT,1875,53,na,1928,2218.1928735847537
SIM,1853,19,na,1872,2211
STAT,1859,17,35-39,1876,0.5189215705156492
SIM,1832,26,30-34,1858,38
STAT,1854,16,45-49,1870,0.06016014843101084
STAT,1900,43,50-100,1943,0.10298111877643082
STAT,1849,34,35-39,1883,8.114573178663917
STAT,1832,35,25-29,1867,2.498548985255704
STAT,1873,16,50-100,1889,0.050970043660349976
STAT,1917,34,na,1951,4006.9600157406617
SIM,1882,16,na,1898,2439
SIM,1938,24,na,1962,3877
STAT,1840,43,na,1883,1712.8363344543059
STAT,1920,42,15-19,1962,0.0017308300853317732
STAT,1834,71,na,1905,897.0094262994222
SIM,1863,40,45-49,1903,1
STAT,1822,102,na,1924,0.1704648401033767
SIM,1855,45,na,1900,1760
STAT,1921,29,35-39,1950,16.952595462300817
SIM,1905,33,25-29,1938,14
STAT,1902,26,15-19,1928,0.654957071097246
SIM,1931,34,40-44,1965,9
STAT,1848,19,25-29,1867,5.396433993420391
STAT,1908,34,45-49,1942,1.5016521238537959
SIM,1796,89,na,1885,5
STAT,1862,49,30-34,1911,0.08230599109688562
STAT,1816,52,30-34,1868,0.011711507733854614
STAT,1846,50,45-49,1896,0.010527281425131523
SIM,1833,45,35-39,1878,1
STAT,1843,91,na,1934,46.77970853590637
STAT,1852,19,45-49,1871,0.06289908390566039
SIM,1870,49,30-34,1919,2
STAT,1914,45,25-29,1959,0.05392825726569307
STAT,1869,24,35-39,1893,5.711433715964127
SIM,1864,21,20-24,1885,71
SIM,1861,43,45-49,1904,6
SIM,1864,22,na,1886,2193
STAT,1909,27,15-19,1936,0.6880787746012088
STAT,1904,23,15-19,1927,4.808486027123909
SIM,1860,91,na,1951,35
SIM,1856,19,25-29,1875,11
STAT,1882,16,20-24,1898,17.66325150439654
SIM,1864,81,na,1945,483
SIM,1858,24,30-34,1882,21
STAT,1923,34,40-44,1957,4.571439040887497
SIM,1840,35,25-29,1875,5
STAT,1837,29,20-24,1866,9.89565503034573
SIM,1849,21,25-29,1870,96
SIM,1867,70,na,1937,1101
STAT,1875,49,40-44,1924,0.17550565779892166
STAT,1938,31,20-24,1969,2.5033165075391914
STAT,1905,49,na,1954,3246.1838102020442
STAT,1933,18,50-100,1951,0.5101308457427357
SIM,1877,27,45-49,1904,1
SIM,1837,19,20-24,1856,22
STAT,1845,74,na,1919,867.1299098458755
STAT,1892,36,35-39,1928,9.086693076410986
STAT,1872,35,50-100,1907,1.2672021583082635
STAT,1912,22,40-44,1934,3.2871934673620307
SIM,1887,47,na,1934,2681
SIM,1806,68,na,1874,900
SIM,1920,22,40-44,1942,5
STAT,1925,47,20-24,1972,0.013662435627114227
STAT,1782,102,na,1884,0.08261980049508462
STAT,1915,24,35-39,1939,9.869951626933865
STAT,1948,17,25-29,1965,50.5979273954106
STAT,1826,36,na,1862,1678.2733440704426
STAT,1871,28,15-19,1899,0.45686375027001713
STAT,1864,51,50-100,1915,0.013764983535615385
STAT,1906,36,30-34,1942,1.7163023146276857
SIM,1855,49,35-39,1904,1
STAT,1910,55,na,1965,3386.200454224551
STAT,1938,32,50-100,1970,0.8480475329922351
STAT,1892,47,45-49,1939,0.16941331707506552
SIM,1847,50,na,1897,1465
SIM,1873,27,30-34,1900,35
STAT,1912,33,20-24,1945,2.4380886157768282
STAT,1858,34,30-34,1892,14.004112289306857
SIM,1872,57,na,1929,2114
STAT,1920,42,45-49,1962,0.18757869732832438
STAT,1934,24,45-49,1958,1.5409910373948914
SIM,1931,8,na,1939,5203
SIM,1845,29,20-24,1874,1
STAT,1868,54,45-49,1922,0.013751570121315688
STAT,1878,45,na,1923,2412.8361815440576
STAT,1949,21,25-29,1970,110.00087933780304
STAT,1834,48,40-44,1882,0.12062784264745369
STAT,1922,22,50-100,1944,0.7699325377875305
STAT,1886,20,25-29,1906,62.183324699723684
STAT,1901,31,25-29,1932,14.671599409145786
STAT,1840,45,30-34,1885,0.0720667482417823
STAT,1863,68,na,1931,1366.898927952951
SIM,1922,45,25-29,1967,1
STAT,1845,49,25-29,1894,0.04406590129543045
STAT,1942,30,50-100,1972,0.899572266204796
SIM,1966,1,na,1967,5194
STAT,1941,19,35-39,1960,4.406490841240347
SIM,1898,10,na,1908,4010
STAT,1889,61,na,1950,2354.7492115307514
SIM,1911,30,45-49,1941,4
STAT,1919,39,20-24,1958,0.28838000221000765
SIM,1818,53,na,1871,1229
SIM,1936,27,25-29,1963,75
STAT,1868,43,35-39,1911,1.7516522083945443
SIM,1825,36,40-44,1861,7
STAT,1858,23,20-24,1881,57.79121544132903
SIM,1922,49,na,1971,4242
SIM,1917,27,15-19,1944,1
STAT,1902,15,35-39,1917,0.793065598352712
STAT,1874,31,na,1905,2495.647848330514
STAT,1892,65,na,1957,2213.5051727020127
SIM,1898,35,35-39,1933,4
SIM,1931,23,25-29,1954,150
SIM,1822,47,50-100,1869,1
STAT,1917,37,15-19,1954,0.020354621979230325
SIM,1869,53,na,1922,2094
STAT,1926,30,na,1956,4670.620924828806
STAT,1925,36,40-44,1961,1.8347631345909956
STAT,1873,36,25-29,1909,2.9921408336529405
SIM,1929,28,na,1957,5163
STAT,1855,33,na,1888,1864.0864104515415
STAT,1784,95,na,1879,2.1769660343790234
STAT,1839,27,50-100,1866,0.5561661652310356
SIM,1835,25,na,1860,1947
STAT,1860,63,na,1923,1476.8940625232754
STAT,1834,23,35-39,1857,5.2143352258890445
SIM,1820,42,45-49,1862,2
STAT,1781,90,na,1871,27.687462596137216
STAT,1844,38,50-100,1882,0.9949742593648734
SIM,1866,23,20-24,1889,1
STAT,1939,18,40-44,1957,1.427805916646109
STAT,1856,21,20-24,1877,64.55615434656005
STAT,1928,27,25-29,1955,82.71314130827012
STAT,1839,33,15-19,1872,0.11969785901824143
STAT,1857,36,50-100,1893,0.9828738192984265
SIM,1851,71,na,1922,990
SIM,1920,33,20-24,1953,3
SIM,1938,21,15-19,1959,8
STAT,1903,30,45-49,1933,2.549156397859268
SIM,1855,85,na,1940,220
SIM,1912,23,20-24,1935,107
STAT,1859,35,50-100,1894,1.0097599944833873
STAT,1851,35,35-39,1886,6.021534597501272
STAT,1869,24,40-44,1893,2.039512758992684
STAT,1857,53,30-34,1910,0.004666362571398402
STAT,1904,23,20-24,1927,100.44327084674126
SIM,1926,23,na,1949,4731
STAT,1876,19,na,1895,2646.279738489015
SIM,1947,18,40-44,1965,2
STAT,1812,42,45-49,1854,4.318434948917968
STAT,1821,45,20-24,1866,0.019481461863831498
SIM,1842,48,40-44,1890,1
STAT,1875,30,15-19,1905,0.15030085777700566
STAT,1884,27,40-44,1911,3.023370562350545
SIM,1933,36,40-44,1969,1
STAT,1875,93,na,1968,113.25080307727531
SIM,1927,24,na,1951,4289
STAT,1853,40,40-44,1893,1.9050454080843415
SIM,1851,29,45-49,1880,1
STAT,1938,31,15-19,1969,0.1318844740594772
STAT,1939,18,35-39,1957,4.283417501933547
STAT,1897,37,25-29,1934,3.9273302944906914
STAT,1830,32,50-100,1862,0.8762371201777561
STAT,1854,32,na,1886,1870.3174269548097
SIM,1788,78,na,1866,372
SIM,1911,32,40-44,1943,6
STAT,1826,102,na,1928,0.17099158065255443
STAT,1928,34,na,1962,4817.496058506586
SIM,1874,80,na,1954,563
SIM,1919,24,45-49,1943,2
STAT,1865,94,na,1959,31.195359273774024
SIM,1870,23,40-44,1893,2
STAT,1847,23,45-49,1870,0.6618354523851838
SIM,1796,73,na,1869,472
STAT,1850,19,35-39,1869,0.4984398305669208
STAT,1889,19,40-44,1908,0.22924808461235918
STAT,1910,22,30-34,1932,27.528273710719805
STAT,1955,11,na,1966,5319.441776965103
SIM,1842,46,45-49,1888,1
SIM,1900,62,na,1962,2639
SIM,1894,32,50-100,1926,2
STAT,1831,52,20-24,1883,5.308846150459335E-4
STAT,1825,30,30-34,1855,42.39996983444645
SIM,1872,17,na,1889,2630
STAT,1842,39,50-100,1881,1.006664893471879
STAT,1862,20,50-100,1882,0.3677763340479838
SIM,1921,47,50-100,1968,1
STAT,1839,21,15-19,1860,2.9465800743305586
STAT,1888,32,20-24,1920,3.2599434516607184
SIM,1842,23,35-39,1865,6
SIM,1947,18,35-39,1965,6
SIM,1873,23,15-19,1896,4
SIM,1847,21,15-19,1868,3
SIM,1896,32,20-24,1928,4
STAT,1828,31,50-100,1859,0.9360320243221448
STAT,1834,35,35-39,1869,6.044762885458426
STAT,1838,40,45-49,1878,1.3194030847999267
STAT,1845,55,na,1900,1615.6016744626459
STAT,1862,23,40-44,1885,1.8391459701365904
STAT,1946,21,50-100,1967,0.7473103214747505
STAT,1834,46,45-49,1880,0.1874745328945489
STAT,1936,34,15-19,1970,0.1271431590961911
SIM,1847,29,25-29,1876,37
STAT,1928,28,30-34,1956,49.215232243785465
STAT,1940,23,25-29,1963,95.96236671710172
SIM,1915,39,na,1954,4204
STAT,1811,46,na,1857,1321.2177824477128
SIM,1855,23,45-49,1878,1
SIM,1827,89,na,1916,44
STAT,1932,27,45-49,1959,2.3076636214584894
SIM,1837,18,30-34,1855,2
STAT,1899,35,30-34,1934,7.515967192789452
SIM,1872,20,40-44,1892,2
STAT,1876,53,35-39,1929,0.008923422820254342
STAT,1868,42,50-100,1910,1.0281049002329925
SIM,1842,35,35-39,1877,4
STAT,1880,40,na,1920,2502.718529557508
SIM,1808,94,na,1902,1
STAT,1846,19,15-19,1865,5.268611779137467
STAT,1816,52,25-29,1868,0.006968830981079481
STAT,1874,68,na,1942,1591.7122690432875
STAT,1820,82,na,1902,256.9723811281144
STAT,1895,17,na,1912,3361.6094049470657
SIM,1889,42,30-34,1931,1
STAT,1814,44,15-19,1858,0.043132057585384576
STAT,1899,24,20-24,1923,95.66600725284258
SIM,1889,57,na,1946,2652
STAT,1948,15,50-100,1963,0.4376779085386817
SIM,1885,43,na,1928,2317
STAT,1864,20,40-44,1884,1.9484613530658013
STAT,1832,39,40-44,1871,3.6378077293390825
STAT,1917,37,20-24,1954,0.2794134120148198
STAT,1947,16,na,1963,4231.481877796701
STAT,1931,40,25-29,1971,0.09756187271523761
SIM,1840,39,40-44,1879,10
STAT,1903,27,50-100,1930,0.9276592922614845
SIM,1921,20,50-100,1941,2
SIM,1855,31,20-24,1886,4
STAT,1883,43,25-29,1926,0.6381337181528963
SIM,1902,19,25-29,1921,10
SIM,1871,32,na,1903,2203
STAT,1891,30,50-100,1921,1.1665181132400289
STAT,1910,39,25-29,1949,0.9507625062025892
STAT,1827,50,40-44,1877,0.01186881523392496
SIM,1846,40,45-49,1886,8
STAT,1841,25,25-29,1866,39.356477693039096
STAT,1904,35,15-19,1939,0.01788922105751324
SIM,1818,41,45-49,1859,6
STAT,1890,36,30-34,1926,6.679774940323707
SIM,1862,29,20-24,1891,12
SIM,1910,15,40-44,1925,1
SIM,1883,24,35-39,1907,6
STAT,1855,73,na,1928,920.7438152966594
SIM,1873,58,na,1931,1992
STAT,1866,38,50-100,1904,1.149539197383962
SIM,1826,43,50-100,1869,5
SIM,1906,62,na,1968,2886
SIM,1836,63,na,1899,1436
STAT,1919,34,20-24,1953,2.662450906669114
STAT,1823,45,30-34,1868,0.1497076007421913
STAT,1886,56,na,1942,2202.4214918711405
STAT,1892,21,30-34,1913,22.8428633408975
STAT,1931,17,na,1948,4913.421162188968
STAT,1854,29,20-24,1883,9.27794605002263
SIM,1863,37,na,1900,2058
STAT,1886,47,20-24,1933,0.012897336027976566
SIM,1904,17,30-34,1921,4
STAT,1876,35,na,1911,2505.4260613563315
STAT,1899,22,25-29,1921,79.97038481667617
STAT,1894,41,40-44,1935,2.9648957399753626
STAT,1954,18,30-34,1972,15.364625472140775
STAT,1825,51,na,1876,1459.2809673277063
STAT,1830,81,na,1911,342.0833781123319
SIM,1873,19,25-29,1892,8
STAT,1843,29,45-49,1872,1.0872956911776315
STAT,1905,65,na,1970,2830.6802219385977
STAT,1928,2,na,1930,5256.482605845484
STAT,1843,23,30-34,1866,17.919466810064147
STAT,1922,43,30-34,1965,0.14949199085455056
STAT,1875,47,45-49,1922,0.24594254724955533
STAT,1829,65,na,1894,1123.9667628219895
SIM,1895,42,na,1937,3209
STAT,1764,100,na,1864,0.34005502909815327
STAT,1845,20,30-34,1865,17.52857547908417
STAT,1865,23,15-19,1888,3.0695081816387035
SIM,1940,0,na,1940,4367
SIM,1923,2,na,1925,4692
STAT,1872,53,20-24,1925,7.42356825196731E-4
STAT,1901,2,na,1903,3802.7749479631557
SIM,1895,8,na,1903,3614
SIM,1833,30,30-34,1863,24
SIM,1848,51,na,1899,1753
STAT,1877,32,45-49,1909,1.8451137853477035
STAT,1943,26,na,1969,4072.316543440592
SIM,1885,32,45-49,1917,2
STAT,1797,62,na,1859,925.3277147188284
STAT,1950,0,na,1950,5314.2349087762905
SIM,1841,34,na,1875,1850
STAT,1902,15,40-44,1917,0.2643552147567557
SIM,1851,23,30-34,1874,22
STAT,1835,52,35-39,1887,0.0065396535755342525
STAT,1910,39,na,1949,3632.8778281924615
SIM,1923,31,na,1954,4229
STAT,1875,36,35-39,1911,7.441066849915643
STAT,1910,20,35-39,1930,9.072344361590988
STAT,1894,21,50-100,1915,0.5367255444974006
SIM,1883,36,35-39,1919,12
SIM,1866,36,35-39,1902,2
STAT,1882,23,20-24,1905,68.27889503229022
STAT,1865,19,25-29,1884,5.343268693077005
STAT,1879,41,45-49,1920,1.6031710338568599
STAT,1912,48,25-29,1960,0.05186040904738526
SIM,1933,33,30-34,1966,31
STAT,1901,33,45-49,1934,2.477202323184412
STAT,1930,25,15-19,1955,0.9163226130260034
SIM,1922,30,20-24,1952,5
SIM,1937,23,na,1960,4214
SIM,1914,39,35-39,1953,4
SIM,1896,24,45-49,1920,1
STAT,1898,41,na,1939,3213.9649000777663
STAT,1894,30,30-34,1924,23.09512066290517
SIM,1837,88,na,1925,96
SIM,1848,41,30-34,1889,3
STAT,1837,33,50-100,1870,0.7580245284206784
SIM,1816,45,35-39,1861,1
SIM,1928,18,25-29,1946,66
SIM,1942,13,na,1955,4656
STAT,1906,37,45-49,1943,0.6388943657685816
STAT,1878,42,na,1920,2451.1943519695214
SIM,1866,47,45-49,1913,1
SIM,1869,29,30-34,1898,29
STAT,1877,34,40-44,1911,4.549332934830315
SIM,1907,30,25-29,1937,4
STAT,1817,56,na,1873,1210.6106493392672
STAT,1890,46,50-100,1936,0.17329524251118453
STAT,1910,28,45-49,1938,1.6955031811192833
STAT,1844,33,na,1877,1987.5702669784057
SIM,1823,32,20-24,1855,2
SIM,1861,33,na,1894,2515
STAT,1888,24,45-49,1912,0.8357191984091202
SIM,1836,23,35-39,1859,7
STAT,1906,39,35-39,1945,2.2439926241056276
SIM,1915,36,na,1951,4261
STAT,1871,22,50-100,1893,0.4120822522888947
STAT,1770,90,na,1860,17.70099958136477
SIM,1885,34,40-44,1919,9
STAT,1906,20,15-19,1926,4.9277692738711725
STAT,1844,92,na,1936,32.27460498031363
SIM,1891,43,25-29,1934,2
STAT,1790,67,na,1857,774.3509187220639
STAT,1822,86,na,1908,129.00857712542773
STAT,1862,21,45-49,1883,0.6243820231571351
STAT,1864,46,30-34,1910,0.08805486420268224
STAT,1918,35,na,1953,4085.078075712978
SIM,1907,49,45-49,1956,1
STAT,1787,84,na,1871,127.7063606994162
STAT,1810,50,50-100,1860,0.04708309677918688
STAT,1857,43,na,1900,1828.106457422029
STAT,1866,36,na,1902,2227.5743496309847
SIM,1914,37,45-49,1951,4
SIM,1841,93,na,1934,12
STAT,1879,83,na,1962,640.4063596251866
STAT,1862,43,na,1905,1992.5819805628992
STAT,1915,17,40-44,1932,0.2987289392152069
SIM,1829,33,45-49,1862,2
SIM,1923,17,40-44,1940,4
SIM,1852,96,na,1948,3
STAT,1873,24,25-29,1897,58.83560851844057
STAT,1925,33,30-34,1958,19.07613438874633
STAT,1880,19,20-24,1899,18.903587998200248
STAT,1884,24,30-34,1908,17.865084596163243
SIM,1890,7,na,1897,3429
SIM,1938,24,25-29,1962,3
SIM,1883,57,na,1940,2120
SIM,1881,21,20-24,1902,2
SIM,1914,20,15-19,1934,5
STAT,1917,38,50-100,1955,0.4428186680805406
SIM,1919,24,15-19,1943,11
SIM,1940,27,45-49,1967,2
STAT,1881,25,na,1906,2369.7427185266065
SIM,1828,52,na,1880,1471
SIM,1844,33,40-44,1877,8
STAT,1845,46,20-24,1891,0.009402784346036122
SIM,1933,31,35-39,1964,3
SIM,1908,23,30-34,1931,34
STAT,1866,57,na,1923,1891.0028498789102
SIM,1825,33,30-34,1858,26
STAT,1916,43,30-34,1959,0.13348532827030452
SIM,1807,53,na,1860,1163
STAT,1941,16,30-34,1957,12.81197449785681
STAT,1868,40,30-34,1908,1.131502403829685
SIM,1825,39,45-49,1864,6
SIM,1903,38,20-24,1941,1
STAT,1845,58,na,1903,1545.1897471155355
SIM,1803,79,na,1882,258
SIM,1925,38,na,1963,4767
SIM,1855,34,25-29,1889,11
SIM,1890,14,na,1904,3375
STAT,1806,49,40-44,1855,0.5772721215105491
STAT,1862,47,50-100,1909,0.21228472973918888
STAT,1847,34,25-29,1881,8.358691596570935
STAT,1836,31,45-49,1867,1.3864006731174765
STAT,1914,30,20-24,1944,2.5252159415922026
SIM,1860,27,50-100,1887,1
SIM,1918,47,30-34,1965,1
SIM,1786,71,na,1857,546
STAT,1867,98,na,1965,12.112181401354496
STAT,1817,39,45-49,1856,5.826369971085866
STAT,1833,30,na,1863,1870.1101869927897
STAT,1919,46,15-19,1965,4.0874093003547105E-4
STAT,1867,27,40-44,1894,2.868946534892929
STAT,1916,49,na,1965,3822.772120958525
SIM,1834,22,25-29,1856,70
SIM,1823,39,40-44,1862,6
SIM,1869,18,20-24,1887,19
SIM,1890,23,20-24,1913,91
STAT,1868,51,40-44,1919,0.010306877608398678
SIM,1840,20,20-24,1860,65
STAT,1921,26,30-34,1947,44.71451924661238
STAT,1890,20,45-49,1910,0.8749845928039537
STAT,1914,49,40-44,1963,0.1586007941816877
SIM,1803,60,na,1863,853
STAT,1842,42,25-29,1884,0.5210107340329267
STAT,1850,51,25-29,1901,0.002677066959858548
STAT,1935,15,50-100,1950,0.5247456324517032
SIM,1874,83,na,1957,424
STAT,1925,20,25-29,1945,113.4771394725253
STAT,1851,20,30-34,1871,17.803972625579398
STAT,1829,25,na,1854,1761.4412640548742
SIM,1859,35,na,1894,2236
STAT,1846,42,50-100,1888,0.7646377846772431
SIM,1850,42,25-29,1892,1
SIM,1877,24,35-39,1901,7
STAT,1836,33,40-44,1869,3.3769793412255695
STAT,1901,45,45-49,1946,0.1918047674139642
STAT,1917,50,na,1967,3880.6394084359063
SIM,1888,72,na,1960,1547
STAT,1856,36,25-29,1892,2.316768497924766
SIM,1868,31,30-34,1899,21
SIM,1933,20,25-29,1953,204
SIM,1876,40,30-34,1916,2
STAT,1945,24,20-24,1969,124.25271058047996
SIM,1874,21,na,1895,2425
SIM,1934,16,35-39,1950,5
SIM,1833,42,25-29,1875,2
STAT,1892,17,50-100,1909,0.06263914885971256
STAT,1928,29,15-19,1957,0.8862591094273651
STAT,1869,68,na,1937,1505.1346491015445
STAT,1768,89,na,1857,47.70579423212999
SIM,1904,36,na,1940,3728
SIM,1864,36,25-29,1900,5
SIM,1901,47,na,1948,3399
STAT,1865,54,na,1919,1938.8007119843678
SIM,1948,23,na,1971,4511
STAT,1868,43,na,1911,2235.728640834205
STAT,1849,44,30-34,1893,0.8805092042315541
SIM,1916,36,40-44,1952,2
STAT,1914,49,50-100,1963,0.2275254382159763
STAT,1915,26,30-34,1941,40.92245934700161
STAT,1892,33,25-29,1925,13.040539221132363
STAT,1928,24,20-24,1952,140.72477348166396
SIM,1894,22,45-49,1916,2
SIM,1922,3,na,1925,4785
STAT,1814,52,20-24,1866,0.002105051716320803
SIM,1889,45,35-39,1934,1
STAT,1915,8,na,1923,4245.74469701012
STAT,1789,105,na,1894,0.005832589698967033
SIM,1827,31,45-49,1858,1
STAT,1925,39,45-49,1964,0.833001888501223
STAT,1847,20,40-44,1867,2.0209857440907157
STAT,1877,20,na,1897,2517.355625373722
SIM,1853,81,na,1934,357
SIM,1862,55,na,1917,1869
STAT,1920,25,50-100,1945,1.1218138084964668
STAT,1874,53,30-34,1927,0.006100401660119202
SIM,1922,49,50-100,1971,1
STAT,1925,31,35-39,1956,11.077917183332543
STAT,1841,81,na,1922,399.2749143494998
SIM,1903,11,na,1914,3706
SIM,1945,18,30-34,1963,22
STAT,1864,23,45-49,1887,0.6380850556872946
SIM,1889,48,50-100,1937,1
STAT,1926,16,35-39,1942,5.261273707097507
SIM,1813,78,na,1891,352
STAT,1855,40,45-49,1895,1.1718996538875102
STAT,1881,43,20-24,1924,0.15550221771935333
STAT,1932,29,35-39,1961,20.034567446940155
SIM,1913,32,na,1945,3914
SIM,1840,71,na,1911,832
STAT,1875,3,na,1878,3227.4555787483478
SIM,1917,46,na,1963,3760
SIM,1901,20,35-39,1921,11
STAT,1854,91,na,1945,44.35062913971468
SIM,1872,23,45-49,1895,2
SIM,1866,34,30-34,1900,32
SIM,1885,83,na,1968,702
SIM,1859,44,40-44,1903,5
STAT,1783,104,na,1887,0.035484620640929325
SIM,1840,55,na,1895,1435
SIM,1940,29,35-39,1969,30
STAT,1855,17,na,1872,2116.4460679993163
STAT,1940,20,20-24,1960,115.63778743313455
SIM,1856,23,15-19,1879,5
STAT,1929,30,50-100,1959,1.072365253053078
SIM,1870,47,50-100,1917,1
STAT,1821,103,na,1924,0.0756236974204415
STAT,1875,23,20-24,1898,71.92916533808554
SIM,1774,86,na,1860,109
SIM,1842,20,30-34,1862,1
SIM,1853,59,na,1912,1581
STAT,1886,22,45-49,1908,0.7529762725112188
STAT,1841,22,20-24,1863,64.45701277044988
SIM,1894,57,na,1951,2697
SIM,1936,24,20-24,1960,114
STAT,1906,10,na,1916,3846.2345391112835
SIM,1897,49,na,1946,2953
STAT,1922,46,35-39,1968,0.15150710414845034
STAT,1873,53,50-100,1926,0.015369216316708597
STAT,1848,23,15-19,1871,3.100049655872605
STAT,1825,33,35-39,1858,18.57734599033157
SIM,1913,19,30-34,1932,7
SIM,1833,33,35-39,1866,13
STAT,1952,17,15-19,1969,55.47954572442393
STAT,1866,43,25-29,1909,0.5998856500485338
STAT,1818,52,35-39,1870,0.01873651016803544
SIM,1783,82,na,1865,119
STAT,1929,41,20-24,1970,0.023360484168820386
SIM,1872,30,45-49,1902,3
SIM,1872,73,na,1945,1110
SIM,1883,21,30-34,1904,31
SIM,1849,37,40-44,1886,7
STAT,1831,66,na,1897,1104.3997642965621
STAT,1905,31,50-100,1936,0.7783064030219289
SIM,1835,22,na,1857,1867
STAT,1918,43,40-44,1961,0.2709538614604433
SIM,1903,36,30-34,1939,3
SIM,1852,40,na,1892,1982
STAT,1818,41,na,1859,1522.2246128451777
STAT,1844,50,40-44,1894,0.008275229284097307
STAT,1899,46,50-100,1945,0.19408406053565067
SIM,1849,33,25-29,1882,12
STAT,1885,43,35-39,1928,1.8296943887368184
SIM,1850,70,na,1920,951
SIM,1876,87,na,1963,350
STAT,1816,74,na,1890,492.4280726575795
STAT,1853,69,na,1922,1230.5332015348365
STAT,1905,19,30-34,1924,2.335725325774727
SIM,1936,29,15-19,1965,2
SIM,1812,53,na,1865,1244
SIM,1923,26,30-34,1949,71
SIM,1916,21,na,1937,3965
SIM,1818,43,40-44,1861,5
STAT,1951,21,35-39,1972,11.48004794614531
STAT,1866,31,30-34,1897,16.496213067996866
STAT,1888,35,25-29,1923,3.5053474790427694
STAT,1921,23,15-19,1944,6.1163736643429925
SIM,1861,40,40-44,1901,3
STAT,1849,46,35-39,1895,0.10899906801453732
STAT,1825,53,50-100,1878,0.018360156793041732
STAT,1864,9,na,1873,2512.2399625164544
STAT,1937,18,30-34,1955,12.063448997270802
STAT,1829,50,45-49,1879,0.011811464778871864
SIM,1863,40,na,1903,2032
STAT,1921,28,20-24,1949,20.68676451952911
STAT,1783,101,na,1884,0.14418611917656454
STAT,1821,45,na,1866,1404.2413304538584
SIM,1861,44,35-39,1905,9
SIM,1930,28,na,1958,5254
SIM,1874,43,na,1917,2338
SIM,1883,17,na,1900,2598
STAT,1833,52,30-34,1885,0.004057820078750655
STAT,1835,36,50-100,1871,1.1431852763891708
STAT,1907,35,na,1942,3590.6134644988024
SIM,1845,40,na,1885,1869
STAT,1921,39,30-34,1960,2.0722181679100204
STAT,1897,34,20-24,1931,3.65550379636499
STAT,1789,70,na,1859,524.5057917605087
SIM,1843,36,50-100,1879,5
SIM,1896,35,25-29,1931,8
SIM,1816,67,na,1883,940
STAT,1828,62,na,1890,1006.4707453192593
SIM,1828,42,50-100,1870,3
SIM,1837,29,na,1866,1701
SIM,1922,33,25-29,1955,11
SIM,1914,34,40-44,1948,7
SIM,1836,20,30-34,1856,17
STAT,1772,108,na,1880,0.0027504126457680734
STAT,1845,23,35-39,1868,5.619726439820206
SIM,1859,91,na,1950,101
SIM,1838,92,na,1930,23
STAT,1858,21,25-29,1879,53.52092814470294
STAT,1908,47,20-24,1955,0.010191385664286278
SIM,1898,45,30-34,1943,2
STAT,1780,89,na,1869,33.31192466246206
SIM,1818,93,na,1911,7
STAT,1879,17,50-100,1896,0.05224273488691223
SIM,1786,74,na,1860,372
STAT,1882,26,25-29,1908,42.1866803904335
SIM,1832,29,35-39,1861,15
STAT,1912,45,20-24,1957,0.010885364642528353
STAT,1902,40,50-100,1942,0.10660713813864252
SIM,1898,31,na,1929,3671
SIM,1866,21,25-29,1887,67
SIM,1929,41,50-100,1970,1
STAT,1855,53,20-24,1908,5.628492204628039E-4
STAT,1927,26,50-100,1953,1.2385885981803226
STAT,1841,44,na,1885,1728.417221881778
STAT,1872,45,15-19,1917,4.1304878704675167E-4
STAT,1856,33,20-24,1889,2.168486768175806
STAT,1919,37,25-29,1956,1.0794259147154242
SIM,1864,33,20-24,1897,2
SIM,1866,44,40-44,1910,2
STAT,1847,31,20-24,1878,2.5007529243863984
STAT,1860,23,30-34,1883,15.08929759605733
STAT,1801,53,30-34,1854,0.016433817984145123
SIM,1905,8,na,1913,3767
SIM,1824,78,na,1902,347
STAT,1900,15,30-34,1915,2.2641220784325644
STAT,1830,35,20-24,1865,0.7158291741073265
SIM,1820,43,35-39,1863,5
STAT,1906,34,40-44,1940,3.665821547167874
SIM,1942,26,40-44,1968,6
SIM,1829,30,40-44,1859,2
SIM,1857,47,50-100,1904,1
SIM,1932,7,na,1939,5560
SIM,1814,60,na,1874,1003
STAT,1848,18,40-44,1866,0.17521084845448323
SIM,1896,21,40-44,1917,5
SIM,1935,26,50-100,1961,1
STAT,1832,23,25-29,1855,60.21247053627414
STAT,1870,43,45-49,1913,1.4817616208550877
STAT,1926,27,15-19,1953,0.8633318870194732
SIM,1908,47,50-100,1955,1
SIM,1888,22,15-19,1910,2
STAT,1876,31,50-100,1907,0.9691444063963601
STAT,1881,47,15-19,1928,3.9267140037579185E-4
STAT,1883,41,50-100,1924,1.0622566344951605
STAT,1891,24,na,1915,2968.352052366993
STAT,1870,32,35-39,1902,10.09934516791007
STAT,1903,43,20-24,1946,0.015877326030896744
STAT,1843,51,50-100,1894,0.012250376354379923
STAT,1890,61,na,1951,2330.8180271558485
STAT,1893,24,50-100,1917,0.5244367683391559
STAT,1934,26,40-44,1960,6.397278617297643
SIM,1868,32,45-49,1900,3
STAT,1860,16,50-100,1876,0.04704571857402402
STAT,1819,103,na,1922,0.08461028909708172
SIM,1848,44,35-39,1892,2
SIM,1879,47,25-29,1926,1
STAT,1851,48,40-44,1899,0.1394682525461168
STAT,1860,36,45-49,1896,1.6579790853118817
STAT,1888,21,40-44,1909,2.520702870939247
SIM,1877,32,na,1909,2445
SIM,1840,23,25-29,1863,67
STAT,1858,44,40-44,1902,1.795119123588637
SIM,1886,46,na,1932,2531
SIM,1882,32,na,1914,2287
STAT,1860,25,35-39,1885,8.189305286135903
STAT,1919,42,50-100,1961,0.12991682174177702
STAT,1839,29,25-29,1868,36.25178295795532
STAT,1917,24,45-49,1941,1.2127152201985678
STAT,1912,20,45-49,1932,1.106583114266534
SIM,1873,98,na,1971,1
STAT,1934,37,20-24,1971,0.3709760879928534
SIM,1857,33,20-24,1890,7
STAT,1803,52,45-49,1855,0.05861911795429276
SIM,1870,3,na,1873,3206
SIM,1875,27,40-44,1902,7
SIM,1878,15,15-19,1893,10
SIM,1949,3,na,1952,4819
STAT,1812,43,35-39,1855,4.835443423881975
STAT,1892,24,35-39,1916,7.414315108502176
SIM,1908,26,35-39,1934,24
SIM,1919,28,30-34,1947,66
STAT,1947,21,15-19,1968,6.140179531688647
STAT,1877,18,50-100,1895,0.05170180464412965
STAT,1884,20,15-19,1904,3.3495141671725435
SIM,1802,75,na,1877,415
STAT,1919,20,na,1939,4104.977943942801
SIM,1933,24,40-44,1957,4
STAT,1916,46,35-39,1962,0.13528467590090623
SIM,1938,28,40-44,1966,4
STAT,1831,44,15-19,1875,0.011395245647773042
STAT,1777,113,na,1890,5.887952265197218E-4
SIM,1881,24,25-29,1905,63
STAT,1889,24,15-19,1913,4.131219041968905
STAT,1941,16,na,1957,3868.9434100258936
STAT,1819,66,na,1885,1004.3371405474762
STAT,1888,20,na,1908,2869.3148218138963
SIM,1825,63,na,1888,1091
STAT,1830,41,na,1871,1642.9474939671525
SIM,1891,41,50-100,1932,4
STAT,1920,17,na,1937,4214.237514717246
SIM,1828,74,na,1902,667
STAT,1871,36,20-24,1907,0.7827109725620269
STAT,1913,18,15-19,1931,9.441268008771763
STAT,1925,24,40-44,1949,4.080498311166501
STAT,1908,36,40-44,1944,1.436098617274276
STAT,1912,39,35-39,1951,2.384006726681813
STAT,1812,54,45-49,1866,0.03146950909017449
STAT,1856,58,na,1914,1583.6669845788451
SIM,1865,47,na,1912,2156
SIM,1921,18,15-19,1939,84
SIM,1920,39,35-39,1959,2
STAT,1808,63,na,1871,794.3792916466087
STAT,1923,35,25-29,1958,1.1660335841733833
SIM,1897,24,15-19,1921,3
SIM,1925,24,45-49,1949,2
SIM,1892,20,15-19,1912,3
STAT,1892,49,40-44,1941,0.12089407052854065
SIM,1920,20,45-49,1940,5
STAT,1777,85,na,1862,99.79745084380966
STAT,1903,32,40-44,1935,6.288952987655614
STAT,1952,19,na,1971,4496.587793779333
STAT,1867,23,25-29,1890,54.656525328593204
STAT,1873,21,20-24,1894,71.48789662647265
STAT,1849,33,20-24,1882,2.188502861343005
STAT,1945,27,25-29,1972,73.67447485246471
STAT,1854,31,50-100,1885,0.7256208313888004
STAT,1851,23,35-39,1874,5.708019788441544
SIM,1862,31,50-100,1893,1
STAT,1932,24,40-44,1956,4.483680204891749
SIM,1865,0,na,1865,3342
SIM,1931,35,25-29,1966,2
STAT,1901,30,40-44,1931,6.2363987602971145
SIM,1862,95,na,1957,15
STAT,1840,46,15-19,1886,2.940052834071351E-4
SIM,1855,20,40-44,1875,4
STAT,1923,1,na,1924,5003.292870964514
SIM,1858,44,50-100,1902,2
STAT,1804,89,na,1893,35.447141180044504
STAT,1879,86,na,1965,466.2163225338423
SIM,1830,93,na,1923,22
SIM,1890,26,25-29,1916,65
SIM,1906,24,35-39,1930,14
STAT,1828,39,20-24,1867,0.6478046279919348
SIM,1841,96,na,1937,5
SIM,1823,35,25-29,1858,5
SIM,1875,23,25-29,1898,73
STAT,1798,84,na,1882,136.15697586470415
STAT,1859,53,35-39,1912,0.006901313180098546
STAT,1849,20,50-100,1869,0.3883260420650209
SIM,1940,24,40-44,1964,6
STAT,1914,33,25-29,1947,9.45235161867654
SIM,1849,14,na,1863,2268
STAT,1895,7,na,1902,3467.7575961159378
SIM,1873,38,50-100,1911,6
STAT,1868,83,na,1951,386.81116639094637
STAT,1831,45,50-100,1876,0.2061016082522659
SIM,1905,37,40-44,1942,2
STAT,1890,45,20-24,1935,0.015117267855958943
STAT,1825,51,20-24,1876,9.334277601696146E-4
STAT,1867,37,45-49,1904,1.9092254303125389
STAT,1870,25,na,1895,2396.1372415329056
SIM,1869,50,na,1919,2166
STAT,1861,52,45-49,1913,0.012168378915087928
SIM,1886,68,na,1954,1675
SIM,1950,1,na,1951,4877
STAT,1838,44,25-29,1882,0.48942543075343903
STAT,1929,22,na,1951,4710.086086156487
SIM,1878,41,40-44,1919,7
STAT,1842,51,50-100,1893,0.01190031306857266
SIM,1825,43,40-44,1868,3
STAT,1874,4,na,1878,3040.2400230259964
STAT,1932,25,25-29,1957,87.99617939512117
SIM,1836,31,50-100,1867,1
STAT,1792,93,na,1885,6.267198435922288
STAT,1905,45,20-24,1950,0.010072495977196139
STAT,1914,9,na,1923,4187.731344285316
SIM,1890,26,30-34,1916,41
STAT,1934,22,25-29,1956,126.59151057377608
SIM,1827,40,40-44,1867,6
SIM,1892,34,40-44,1926,13
STAT,1874,15,na,1889,2652.6599064880843
STAT,1920,35,45-49,1955,0.7630216891519112
STAT,1936,30,35-39,1966,9.06347119249021
STAT,1884,34,40-44,1918,4.3394986705420955
STAT,1903,48,20-24,1951,0.009692823541952719
SIM,1872,31,20-24,1903,1
SIM,1919,17,15-19,1936,42
STAT,1803,70,na,1873,775.7134733746423
STAT,1898,45,35-39,1943,0.11003168413365232
STAT,1849,47,35-39,1896,0.10818375498578853
STAT,1925,32,na,1957,4582.104046044082
STAT,1921,22,15-19,1943,6.135331839727753
STAT,1930,27,50-100,1957,1.2908341859071182
SIM,1823,35,30-34,1858,9
STAT,1885,52,na,1937,2179.841951277355
STAT,1840,41,45-49,1881,1.1379321979713373
STAT,1820,39,50-100,1859,2.663630766446877
SIM,1827,33,35-39,1860,16
SIM,1848,29,na,1877,2002
SIM,1865,60,na,1925,1804
STAT,1880,19,15-19,1899,6.327895990630136
STAT,1852,52,35-39,1904,0.006898551110042615
SIM,1922,46,na,1968,4267
SIM,1873,29,35-39,1902,12
SIM,1892,27,35-39,1919,1
STAT,1886,24,35-39,1910,6.261775248761329
SIM,1819,51,50-100,1870,1
STAT,1796,83,na,1879,136.1407508408598
SIM,1818,40,30-34,1858,1
SIM,1854,23,na,1877,2138
STAT,1912,48,30-34,1960,0.08715429937794746
STAT,1915,24,na,1939,3827.8871789586883
SIM,1844,30,30-34,1874,26
STAT,1854,88,na,1942,105.07062973099667
STAT,1860,17,na,1877,2191.274756426827
STAT,1896,18,na,1914,3393.968568937624
STAT,1923,30,25-29,1953,10.897821321065129
SIM,1823,43,na,1866,1571
SIM,1830,25,20-24,1855,17
STAT,1847,39,25-29,1886,2.281652107512996
STAT,1844,41,45-49,1885,1.2031068912600138
STAT,1892,42,20-24,1934,0.2028022989886793
SIM,1907,34,40-44,1941,6
SIM,1815,48,na,1863,1420
STAT,1784,98,na,1882,0.4994466037032533
STAT,1823,54,20-24,1877,0.0010263708284164778
STAT,1882,26,30-34,1908,25.113595105175563
SIM,1899,20,50-100,1919,3
STAT,1855,41,20-24,1896,0.12366863958680435
STAT,1873,48,25-29,1921,0.05882424145343136
SIM,1842,22,20-24,1864,77
STAT,1914,30,15-19,1944,0.1330382216313816
SIM,1825,36,35-39,1861,12
SIM,1931,30,25-29,1961,9
SIM,1940,25,25-29,1965,81
STAT,1856,39,35-39,1895,5.607014422982285
SIM,1865,36,50-100,1901,4
SIM,1853,30,40-44,1883,7
STAT,1814,51,45-49,1865,0.04223645893269487
SIM,1857,65,na,1922,1345
STAT,1866,1,na,1867,3369.2704411030545
SIM,1840,25,20-24,1865,11
STAT,1824,56,na,1880,1221.7844218482467
STAT,1908,15,50-100,1923,0.07445183418647244
SIM,1873,15,30-34,1888,2
SIM,1891,15,na,1906,3282
STAT,1829,51,20-24,1880,5.888027933457847E-4
STAT,1919,21,50-100,1940,0.7374843173359841
STAT,1867,18,45-49,1885,0.06357985053929552
SIM,1910,22,35-39,1932,16
STAT,1863,29,25-29,1892,37.56615364962049
STAT,1834,22,20-24,1856,62.02257714008433
SIM,1840,15,na,1855,2093
STAT,1882,19,25-29,1901,5.6018266651178825
STAT,1914,49,35-39,1963,0.1296969114289807
STAT,1858,78,na,1936,632.1041510989342
STAT,1907,40,25-29,1947,0.06746881046465897
STAT,1847,46,30-34,1893,0.07570021829014285
STAT,1853,36,45-49,1889,1.6889831806871403
STAT,1848,18,35-39,1866,0.5256325149299521
SIM,1887,34,45-49,1921,5
STAT,1896,42,20-24,1938,0.014840727824334437
STAT,1940,20,15-19,1960,5.535887873744926
STAT,1958,4,na,1962,5267.495238894726
STAT,1884,15,40-44,1899,0.18545855929644328
STAT,1879,34,45-49,1913,1.843612932745588
STAT,1866,73,na,1939,1117.639836553999
STAT,1924,19,40-44,1943,1.6902554878908131
SIM,1932,19,40-44,1951,1
SIM,1897,21,50-100,1918,4
SIM,1837,40,40-44,1877,1
SIM,1947,15,25-29,1962,55
STAT,1899,60,na,1959,2756.0139791165143
STAT,1903,39,na,1942,3408.856511254562
SIM,1846,44,25-29,1890,2
STAT,1884,27,35-39,1911,9.73849571571387
STAT,1880,50,45-49,1930,0.01578130883344999
STAT,1892,48,35-39,1940,0.09970146008496138
SIM,1861,70,na,1931,1310
SIM,1919,24,20-24,1943,174
SIM,1875,37,45-49,1912,2
STAT,1833,92,na,1925,27.350991103706285
STAT,1860,48,15-19,1908,3.2692532389093473E-4
SIM,1808,54,na,1862,1376
SIM,1858,13,na,1871,2346
SIM,1870,47,na,1917,2479
STAT,1829,100,na,1929,0.7060829617470803
STAT,1846,59,na,1905,1389.8135124887954
SIM,1910,19,20-24,1929,36
STAT,1832,25,20-24,1857,11.022277306439648
STAT,1902,22,35-39,1924,8.395187149800613
STAT,1929,40,45-49,1969,0.22044035356502484
SIM,1853,23,35-39,1876,7
STAT,1817,43,40-44,1860,5.434786037445969
STAT,1833,40,30-34,1873,0.9458473298313411
STAT,1886,2,na,1888,3191.7270756657012
SIM,1912,27,30-34,1939,71
STAT,1849,48,na,1897,1724.7404053553826
STAT,1879,46,na,1925,2405.94053503758
STAT,1865,15,30-34,1880,1.6910178713986996
STAT,1904,27,30-34,1931,36.81759513688243
SIM,1884,44,50-100,1928,3
STAT,1902,19,20-24,1921,25.36829348070056
STAT,1918,45,50-100,1963,0.24677514041113868
STAT,1816,43,35-39,1859,4.091501479058483
STAT,1818,51,45-49,1869,0.03222196728663507
STAT,1913,25,15-19,1938,0.7224678927673076
STAT,1911,34,na,1945,3724.451645322527
STAT,1844,51,30-34,1895,0.0046347683845266024
STAT,1844,101,na,1945,0.44218271831080413
SIM,1853,75,na,1928,830
SIM,1811,58,na,1869,983
SIM,1870,20,30-34,1890,26
STAT,1874,53,25-29,1927,0.0036299910354988226
STAT,1819,40,40-44,1859,5.143275541231967
SIM,1899,24,25-29,1923,95
SIM,1795,70,na,1865,629
SIM,1808,46,45-49,1854,1
STAT,1878,37,20-24,1915,0.8185345470461658
STAT,1882,10,na,1892,2574.464989316506
SIM,1820,88,na,1908,86
STAT,1886,31,40-44,1917,4.701975996954727
SIM,1896,37,20-24,1933,1
STAT,1884,28,50-100,1912,0.6433577867628493
STAT,1889,16,30-34,1905,2.0134373481251746
SIM,1851,26,35-39,1877,12
STAT,1933,30,25-29,1963,12.716871111098765
SIM,1832,73,na,1905,656
SIM,1859,41,30-34,1900,2
SIM,1859,4,na,1863,2747
SIM,1845,33,50-100,1878,3
STAT,1842,54,30-34,1896,0.004539649349500502
SIM,1838,76,na,1914,512
SIM,1858,90,na,1948,41
SIM,1835,31,50-100,1866,1
STAT,1831,54,25-29,1885,0.002449267318783239
STAT,1871,23,45-49,1894,0.7024832232345183
STAT,1832,45,50-100,1877,0.20004832979266113
SIM,1863,33,45-49,1896,4
SIM,1867,35,50-100,1902,4
STAT,1837,36,20-24,1873,0.6322806974756824
STAT,1856,95,na,1951,10.647113641635737
SIM,1910,21,na,1931,3604
SIM,1847,25,30-34,1872,36
SIM,1877,20,25-29,1897,92
SIM,1944,5,na,1949,4326
SIM,1873,95,na,1968,21
STAT,1859,17,40-44,1876,0.17297386685353036
STAT,1862,20,30-34,1882,16.064468528979738
SIM,1863,18,na,1881,2288
SIM,1868,41,40-44,1909,6
STAT,1942,30,35-39,1972,9.942779739366651
SIM,1778,82,na,1860,186
STAT,1841,28,na,1869,1969.6254181651184
SIM,1795,88,na,1883,59
STAT,1840,30,20-24,1870,2.4188525808412398
STAT,1866,34,35-39,1900,9.447681378531618
SIM,1923,30,50-100,1953,1
STAT,1821,39,50-100,1860,2.3664478566098595
STAT,1860,26,35-39,1886,8.130506074181453
SIM,1829,46,20-24,1875,1
STAT,1915,22,15-19,1937,5.615018835535057
SIM,1874,34,35-39,1908,18
SIM,1864,36,30-34,1900,7
STAT,1908,32,25-29,1940,8.896348659433343
SIM,1856,30,na,1886,2398
SIM,1923,22,15-19,1945,7
STAT,1829,43,45-49,1872,1.2389417063129449
STAT,1923,27,40-44,1950,5.460051881259094
STAT,1939,19,50-100,1958,0.38231406361342385
STAT,1820,51,45-49,1871,0.02595962347565338
STAT,1841,28,35-39,1869,8.785205110470141
SIM,1896,30,na,1926,3253
STAT,1843,26,35-39,1869,9.65547491132763
STAT,1849,52,20-24,1901,5.698416965226239E-4
STAT,1867,21,na,1888,2290.8616140605973
SIM,1783,85,na,1868,56
STAT,1849,43,30-34,1892,0.8861094157390247
STAT,1866,52,20-24,1918,6.906637044584686E-4
STAT,1888,37,20-24,1925,0.9296593306286935
STAT,1894,35,na,1929,3120.917027518595
STAT,1899,26,40-44,1925,4.1990728281481395
SIM,1885,44,50-100,1929,4
STAT,1899,45,40-44,1944,0.1362518041377401
STAT,1855,33,45-49,1888,1.3622009792078777
STAT,1948,11,na,1959,4587.171229392958
SIM,1914,32,20-24,1946,4
STAT,1887,27,50-100,1914,0.7312537273810432
STAT,1908,20,na,1928,3598.833912729502
STAT,1840,49,40-44,1889,0.12108966850114407
STAT,1839,25,30-34,1864,22.21165081366417
STAT,1862,36,50-100,1898,1.071303398962262
STAT,1771,91,na,1862,15.86904424892034
SIM,1845,36,20-24,1881,1
STAT,1879,42,20-24,1921,0.16914257191218318
SIM,1916,32,25-29,1948,11
SIM,1789,76,na,1865,405
STAT,1881,42,45-49,1923,1.4742850645064827
SIM,1916,24,na,1940,3838
STAT,1870,48,15-19,1918,3.938924913547731E-4
SIM,1860,69,na,1929,1527
SIM,1878,33,na,1911,2689
STAT,1854,29,15-19,1883,0.3588155959717868
STAT,1828,40,na,1868,1495.3415652296562
STAT,1873,67,na,1940,1639.5108811378507
STAT,1830,39,15-19,1869,0.04929734836690137
SIM,1852,41,45-49,1893,2
STAT,1878,18,20-24,1896,18.77591802084513
STAT,1948,15,35-39,1963,4.901993483855929
STAT,1828,46,na,1874,1390.6504108366137
SIM,1835,62,na,1897,1219
STAT,1848,51,30-34,1899,0.004649252805180402
SIM,1890,67,na,1957,1978
STAT,1891,19,35-39,1910,0.6893020004061425
SIM,1871,26,20-24,1897,14
STAT,1845,33,45-49,1878,1.6033191205907302
STAT,1896,34,45-49,1930,2.329428976759471
STAT,1927,3,na,1930,5144.4809536371195
STAT,1939,25,35-39,1964,15.410384342232017
SIM,1832,28,35-39,1860,14
SIM,1868,34,35-39,1902,15
STAT,1924,40,25-29,1964,0.08689969043100386
STAT,1809,67,na,1876,983.6720814253389
STAT,1906,32,20-24,1938,2.3046237646647216
STAT,1860,22,30-34,1882,15.198422267941147
STAT,1864,34,25-29,1898,9.211340364348684
SIM,1831,30,20-24,1861,5
STAT,1840,110,na,1950,1.9885232032059195E-4
STAT,1816,77,na,1893,383.54238703741527
STAT,1847,16,50-100,1863,0.04796550141408695
STAT,1869,29,50-100,1898,0.6255354247238941
STAT,1928,36,15-19,1964,0.024777384274987893
STAT,1851,44,25-29,1895,0.5226395338684225
STAT,1878,15,40-44,1893,0.1951200299247427
SIM,1851,33,40-44,1884,6
STAT,1923,49,45-49,1972,0.25789066004926264
STAT,1833,52,25-29,1885,0.002414570602101005
STAT,1838,46,20-24,1884,0.009187878687669047
STAT,1893,35,50-100,1928,1.603968731868771
STAT,1860,110,na,1970,0.0031757429850555376
SIM,1798,59,na,1857,1038
STAT,1881,20,40-44,1901,2.0674761439762257
STAT,1898,33,50-100,1931,1.2586746558325865
SIM,1942,22,25-29,1964,163
SIM,1897,16,30-34,1913,4
STAT,1765,97,na,1862,0.3129282314703339
SIM,1941,30,25-29,1971,3
STAT,1920,46,25-29,1966,0.05998759269452515
SIM,1830,47,na,1877,1692
SIM,1910,38,20-24,1948,2
STAT,1853,47,na,1900,1877.6936278110977
STAT,1899,38,35-39,1937,2.1220750435262854
SIM,1872,54,na,1926,2165
STAT,1843,45,na,1888,1854.6881550222706
STAT,1843,33,40-44,1876,4.165294492456746
SIM,1810,70,na,1880,963
SIM,1853,33,45-49,1886,1
SIM,1870,20,50-100,1890,1
STAT,1914,37,40-44,1951,1.5249783195608977
SIM,1866,25,40-44,1891,4
STAT,1892,28,na,1920,3040.57701727573
SIM,1867,73,na,1940,934
STAT,1823,49,40-44,1872,0.25018294358027193
STAT,1869,28,20-24,1897,11.513733789193772
STAT,1902,38,20-24,1940,0.23817597827380466
SIM,1906,29,40-44,1935,8
STAT,1869,20,25-29,1889,56.96088597633376
SIM,1831,49,40-44,1880,1
SIM,1883,23,20-24,1906,4
SIM,1925,33,35-39,1958,5
STAT,1940,30,25-29,1970,9.769717139947225
SIM,1931,29,na,1960,4715
STAT,1944,27,na,1971,4130.881393394641
STAT,1957,8,na,1965,5284.548538024974
SIM,1952,8,na,1960,4887
STAT,1890,21,20-24,1911,86.21660575815955
STAT,1895,34,50-100,1929,1.2090917068826448
SIM,1846,33,45-49,1879,2
STAT,1854,36,20-24,1890,0.5928123263034717
STAT,1890,32,45-49,1922,2.1751336981333194
STAT,1875,26,50-100,1901,0.6720632029111693
SIM,1902,45,45-49,1947,1
SIM,1911,52,na,1963,3506
STAT,1810,46,35-39,1856,0.4479600045424672
STAT,1838,33,45-49,1871,1.5756719888514783
STAT,1858,25,40-44,1883,2.5168711995368813
STAT,1839,89,na,1928,72.50214564245493
SIM,1840,35,30-34,1875,7
STAT,1916,34,40-44,1950,4.0876780962846855
SIM,1949,22,35-39,1971,21
SIM,1922,37,40-44,1959,2
SIM,1847,87,na,1934,62
STAT,1790,64,na,1854,866.0
STAT,1845,71,na,1916,1042.9423798452267
SIM,1858,20,15-19,1878,3
SIM,1914,30,25-29,1944,16
STAT,1917,33,35-39,1950,9.724199862067131
STAT,1863,19,15-19,1882,5.447239549413005
STAT,1895,21,50-100,1916,0.5444121786785118
STAT,1834,32,30-34,1866,15.0504106162221
STAT,1867,34,40-44,1901,4.1178510596944555
STAT,1819,43,45-49,1862,3.137530046671478
STAT,1826,39,na,1865,1627.7621352485062
STAT,1827,40,30-34,1867,1.4145379873876238
STAT,1873,45,20-24,1918,0.01253472776222361
SIM,1875,34,40-44,1909,9
STAT,1919,30,35-39,1949,10.14193902156116
STAT,1924,42,50-100,1966,0.1425682694476583
SIM,1909,14,na,1923,3785
STAT,1796,67,na,1863,741.1025658842841
STAT,1921,27,30-34,1948,44.561595590789
SIM,1831,41,45-49,1872,2
STAT,1856,48,25-29,1904,0.04554670287603093
SIM,1843,97,na,1940,7
STAT,1806,54,20-24,1860,0.0022991918813460304
STAT,1932,22,20-24,1954,148.7889907562265
SIM,1842,32,30-34,1874,25
STAT,1858,28,45-49,1886,0.9129258736601932
STAT,1837,23,na,1860,1852.7369818418754
SIM,1871,19,15-19,1890,7
STAT,1849,61,na,1910,1450.73491916714
SIM,1940,22,20-24,1962,129
STAT,1887,81,na,1968,1007.1011699803041
SIM,1865,44,na,1909,2202
STAT,1825,32,20-24,1857,5.358879508613096
STAT,1864,30,50-100,1894,0.8377907159649318
SIM,1924,34,40-44,1958,9
SIM,1946,22,na,1968,3877
STAT,1922,45,20-24,1967,0.013015087029790663
STAT,1931,30,15-19,1961,0.17192119907159364
SIM,1848,17,30-34,1865,5
SIM,1861,30,30-34,1891,7
STAT,1863,26,20-24,1889,10.569102976510328
STAT,1814,40,20-24,1854,0.6012778965549009
STAT,1832,35,30-34,1867,4.624973678946586
SIM,1869,37,20-24,1906,1
SIM,1892,37,45-49,1929,7
STAT,1837,76,na,1913,631.65917279138
SIM,1844,33,35-39,1877,17
STAT,1906,30,25-29,1936,8.803024555886406
STAT,1856,18,na,1874,2160.7471716802456
STAT,1892,45,25-29,1937,0.0419561615903041
SIM,1901,21,25-29,1922,127
STAT,1869,47,20-24,1916,0.011763801303931442
SIM,1865,44,35-39,1909,4
STAT,1892,23,20-24,1915,87.83663174280082
STAT,1840,40,na,1880,1779.29766862152
SIM,1864,29,25-29,1893,56
SIM,1927,1,na,1928,5079
SIM,1863,43,na,1906,1995
SIM,1882,41,30-34,1923,4
STAT,1834,34,na,1868,1827.15311784736
STAT,1857,44,35-39,1901,1.423235677523078
STAT,1825,54,25-29,1879,0.004221286166221283
STAT,1898,59,na,1957,2726.724987761038
STAT,1920,48,20-24,1968,0.012431765483117927
STAT,1842,28,50-100,1870,0.615910667753815
SIM,1892,24,30-34,1916,30
SIM,1949,11,na,1960,4778
STAT,1911,18,na,1929,3932.0337076481314
STAT,1817,46,45-49,1863,0.5355479948231194
STAT,1881,31,20-24,1912,2.6768605809312924
STAT,1862,45,45-49,1907,0.20698559551979875
SIM,1849,25,40-44,1874,5
STAT,1816,105,na,1921,0.013009974928899166
SIM,1811,74,na,1885,329
SIM,1884,27,45-49,1911,2
SIM,1881,37,na,1918,2168
SIM,1872,34,25-29,1906,17
STAT,1920,32,40-44,1952,4.3742975781261135
STAT,1874,41,30-34,1915,1.2028687557749929
STAT,1884,37,45-49,1921,2.0119914723727703
STAT,1846,51,20-24,1897,5.302270683763692E-4
STAT,1851,22,20-24,1873,67.89477130047432
STAT,1853,30,30-34,1883,15.392482630546338
STAT,1863,50,45-49,1913,0.013167191188906666
STAT,1873,36,30-34,1909,5.538643701208
STAT,1775,81,na,1856,180.348175245
STAT,1945,20,35-39,1965,10.536092630525593
STAT,1837,29,15-19,1866,0.38270489374488803
STAT,1949,5,na,1954,4679.383330215883
STAT,1865,18,35-39,1883,0.5204540191750567
STAT,1912,32,15-19,1944,0.12899236216593304
STAT,1851,53,50-100,1904,0.012259971674343888
STAT,1861,42,35-39,1903,1.5245791867343472
SIM,1886,62,na,1948,2042
SIM,1931,24,30-34,1955,52
STAT,1858,47,45-49,1905,0.19003570414755272
STAT,1912,2,na,1914,4205.059397496841
STAT,1943,23,35-39,1966,10.217386807693261
SIM,1878,67,na,1945,1746
SIM,1938,21,20-24,1959,155
STAT,1838,24,na,1862,2009.040080483351
STAT,1875,33,30-34,1908,18.20336639559399
STAT,1936,26,na,1962,3658.2750774527367
SIM,1839,18,35-39,1857,1
SIM,1894,34,45-49,1928,2
STAT,1882,29,50-100,1911,0.6312314352729129
STAT,1895,37,20-24,1932,1.0260083068559434
SIM,1931,20,15-19,1951,5
STAT,1856,29,25-29,1885,34.6001255782009
STAT,1811,83,na,1894,171.9582561167871
SIM,1830,28,25-29,1858,42
STAT,1913,17,30-34,1930,2.5423454760651727
STAT,1914,40,25-29,1954,0.07269873813250002
SIM,1820,40,30-34,1860,4
SIM,1890,29,50-100,1919,1
STAT,1836,33,35-39,1869,7.885895402353081
STAT,1828,46,20-24,1874,0.00950933058172374
STAT,1864,42,45-49,1906,1.3559044348608325
STAT,1960,11,na,1971,5218.105048912898
SIM,1921,17,30-34,1938,21
STAT,1883,45,na,1928,2274.464455413438
STAT,1803,88,na,1891,53.270832751498695
STAT,1886,34,45-49,1920,1.866878808337165
SIM,1881,36,30-34,1917,7
SIM,1891,34,35-39,1925,27
STAT,1844,54,35-39,1898,0.0064878027897921344
STAT,1879,31,40-44,1910,4.643377876877948
SIM,1866,48,na,1914,2281
STAT,1845,109,na,1954,5.558969117845077E-4
STAT,1901,32,30-34,1933,24.9076691870978
STAT,1850,58,na,1908,1487.5583789080329
STAT,1875,48,35-39,1923,0.1447396903687937
SIM,1872,42,45-49,1914,6
STAT,1842,52,35-39,1894,0.006715323427045285
STAT,1923,20,15-19,1943,6.357224439070198
STAT,1940,27,40-44,1967,4.848858361863649
STAT,1833,86,na,1919,145.7051365336417
STAT,1928,17,15-19,1945,58.328956906093836
STAT,1859,46,50-100,1905,0.20066209861675174
SIM,1899,35,na,1934,3244
SIM,1846,71,na,1917,999
STAT,1838,41,20-24,1879,0.13822359126395478
STAT,1862,26,45-49,1888,0.9747403493123296
STAT,1891,40,na,1931,2948.545736127599
STAT,1806,53,na,1859,1185.535880493763
STAT,1941,19,40-44,1960,1.468830365456975
STAT,1887,41,40-44,1928,2.582856483167757
SIM,1870,26,45-49,1896,1
STAT,1776,111,na,1887,0.0011952720099254542
SIM,1921,25,15-19,1946,1
SIM,1931,39,35-39,1970,4
SIM,1934,26,50-100,1960,2
STAT,1892,45,30-34,1937,0.0705096611299341
SIM,1887,31,40-44,1918,6
STAT,1885,42,45-49,1927,1.5213732677259586
SIM,1791,64,na,1855,866
SIM,1827,43,45-49,1870,1
SIM,1892,28,50-100,1920,2
STAT,1858,22,50-100,1880,0.3785201127739587
SIM,1931,23,na,1954,4612
STAT,1923,24,30-34,1947,33.907112116100215
SIM,1824,43,35-39,1867,4
SIM,1844,45,na,1889,1822
SIM,1819,78,na,1897,451
SIM,1876,41,30-34,1917,2
SIM,1918,25,na,1943,4168
STAT,1850,52,25-29,1902,0.0026501356662423725
STAT,1862,23,35-39,1885,5.150328310574377
STAT,1839,28,35-39,1867,8.328810564751818
SIM,1868,44,45-49,1912,5
STAT,1837,39,25-29,1876,2.2891976880425906
STAT,1883,34,35-39,1917,10.050055448931792
STAT,1803,53,35-39,1856,0.0340792766524534
STAT,1858,44,na,1902,1844.5717596604516
SIM,1905,34,30-34,1939,17
STAT,1939,15,25-29,1954,44.35974315021357
STAT,1826,48,50-100,1874,0.1893902377554276
STAT,1854,17,20-24,1871,16.231298783054495
STAT,1844,22,50-100,1866,0.394548380817931
STAT,1825,54,30-34,1879,0.007094105986604961
SIM,1862,17,20-24,1879,23
SIM,1843,26,45-49,1869,1
STAT,1775,99,na,1874,0.32434697312839106
STAT,1846,40,40-44,1886,1.670232265971154
STAT,1862,48,25-29,1910,0.049391340390730676
STAT,1854,94,na,1948,15.296436871133146
STAT,1857,53,25-29,1910,0.0027766785281204656
SIM,1888,37,30-34,1925,9
SIM,1871,94,na,1965,84
SIM,1883,33,30-34,1916,21
STAT,1880,26,20-24,1906,12.619622294041552
STAT,1938,33,na,1971,3876.8714987505487
STAT,1899,48,45-49,1947,0.1836329947843128
STAT,1901,42,40-44,1943,0.22254924389470535
SIM,1876,84,na,1960,551
SIM,1853,20,30-34,1873,23
SIM,1933,30,35-39,1963,19
STAT,1836,41,na,1877,1576.8341563878414
SIM,1853,41,na,1894,1922
SIM,1861,17,na,1878,2845
STAT,1886,34,na,1920,2554.706294958707
SIM,1914,51,na,1965,3683
SIM,1870,23,35-39,1893,8
STAT,1768,86,na,1854,90.0
STAT,1879,45,25-29,1924,0.06203439900841873
STAT,1868,41,30-34,1909,1.1252678255845832
SIM,1847,28,35-39,1875,14
STAT,1867,17,30-34,1884,1.56054025064016
STAT,1908,14,na,1922,3893.783429332534
STAT,1841,37,25-29,1878,2.5046844486497433
STAT,1914,46,30-34,1960,0.09042914217534084
SIM,1861,41,30-34,1902,5
SIM,1908,24,45-49,1932,4
STAT,1871,20,40-44,1891,2.1183042009893023
STAT,1847,35,na,1882,1946.2000241937149
SIM,1939,22,50-100,1961,1
STAT,1899,29,45-49,1928,1.5399741029720584
STAT,1831,51,20-24,1882,5.415053160855731E-4
SIM,1846,30,40-44,1876,3
STAT,1763,96,na,1859,0.51587791460041
STAT,1870,44,35-39,1914,1.7814813557296827
STAT,1824,101,na,1925,0.31419408732172893
STAT,1841,18,25-29,1859,5.364533726005206
STAT,1845,30,40-44,1875,4.113462921154112
SIM,1816,42,30-34,1858,2
STAT,1818,39,20-24,1857,2.310708966364285
SIM,1831,72,na,1903,830
STAT,1877,37,45-49,1914,2.1092803028142773
SIM,1874,31,30-34,1905,28
STAT,1942,24,40-44,1966,3.5943236525523385
STAT,1807,50,30-34,1857,0.02561414574511847
SIM,1870,45,45-49,1915,1
SIM,1874,38,50-100,1912,1
STAT,1882,18,50-100,1900,0.04856432019041749
STAT,1863,90,na,1953,70.51908099949922
STAT,1938,30,45-49,1968,1.6158513564279642
SIM,1854,40,40-44,1894,5
STAT,1922,19,30-34,1941,14.316259964957347
STAT,1853,13,na,1866,2396.9773748697844
SIM,1885,37,45-49,1922,4
SIM,1848,35,na,1883,1947
SIM,1880,35,50-100,1915,1
STAT,1927,43,15-19,1970,0.001961536752721689
STAT,1869,62,na,1931,1800.1478101137484
SIM,1930,19,30-34,1949,19
SIM,1826,39,20-24,1865,2
STAT,1801,54,45-49,1855,0.039269856309438696
STAT,1850,15,30-34,1865,1.4824686493373944
STAT,1814,41,50-100,1855,3.809303583656003
SIM,1936,28,30-34,1964,74
SIM,1841,56,na,1897,1518
STAT,1836,36,45-49,1872,1.539040363786754
STAT,1851,41,20-24,1892,0.1316163618999067
STAT,1872,52,20-24,1924,7.504542262984917E-4
SIM,1893,56,na,1949,2706
STAT,1828,27,20-24,1855,17.218388439956122
SIM,1922,46,30-34,1968,1
STAT,1876,27,45-49,1903,1.1696259342295985
STAT,1906,35,25-29,1941,0.9315200500979169
SIM,1912,22,45-49,1934,1
SIM,1831,33,25-29,1864,12
SIM,1851,36,45-49,1887,5
SIM,1851,58,na,1909,1583
STAT,1895,30,na,1925,3201.736926524942
SIM,1827,27,na,1854,1770
STAT,1881,46,25-29,1927,0.05697087086918959
SIM,1815,50,30-34,1865,1
SIM,1829,56,na,1885,1113
SIM,1852,29,20-24,1881,2
SIM,1782,81,na,1863,128
STAT,1842,33,35-39,1875,9.494656884347773
SIM,1832,25,30-34,1857,23
SIM,1866,28,45-49,1894,1
SIM,1890,11,na,1901,3405
SIM,1850,33,35-39,1883,16
SIM,1902,42,40-44,1944,3
STAT,1886,21,30-34,1907,19.291987754181864
STAT,1859,52,45-49,1911,0.011760538411118005
STAT,1890,24,25-29,1914,70.95755650331122
SIM,1909,17,15-19,1926,14
STAT,1843,36,45-49,1879,1.8983107988522907
STAT,1835,26,45-49,1861,1.0864040599269225
STAT,1870,31,45-49,1901,1.74615567720946
SIM,1906,22,na,1928,3769
STAT,1895,18,20-24,1913,23.535045561304553
STAT,1881,62,na,1943,1802.6499215737151
SIM,1890,41,50-100,1931,5
STAT,1838,30,40-44,1868,4.042531657486666
SIM,1927,30,35-39,1957,13
STAT,1814,47,50-100,1861,0.732295605102705
STAT,1790,100,na,1890,0.23911443554596368
STAT,1815,73,na,1888,643.4162245573209
STAT,1838,49,25-29,1887,0.04243891680640739
SIM,1928,17,25-29,1945,72
SIM,1903,57,na,1960,2899
STAT,1820,41,35-39,1861,3.7047889897891984
STAT,1878,18,45-49,1896,0.06918170318977403
STAT,1904,22,45-49,1926,1.0195300437166483
STAT,1927,40,35-39,1967,0.2583285935415974
STAT,1917,27,50-100,1944,1.0652312021655497
STAT,1935,36,50-100,1971,0.599261036737558
STAT,1823,33,25-29,1856,23.243557117360037
SIM,1845,39,25-29,1884,5
SIM,1881,26,20-24,1907,13
SIM,1900,47,50-100,1947,1
SIM,1914,35,25-29,1949,3
STAT,1888,47,30-34,1935,0.11619849491755445
SIM,1859,42,45-49,1901,3
STAT,1821,44,45-49,1865,2.434239452970527
STAT,1866,33,20-24,1899,2.53276412149758
SIM,1890,38,25-29,1928,4
STAT,1937,35,50-100,1972,0.42898440905827884
SIM,1894,21,30-34,1915,30
STAT,1864,31,20-24,1895,2.461916776185942
STAT,1887,19,na,1906,2871.6217414592925
SIM,1785,86,na,1871,54
SIM,1918,46,50-100,1964,1
SIM,1836,27,20-24,1863,13
STAT,1894,31,30-34,1925,23.004587789906584
STAT,1920,43,20-24,1963,0.019873095725301753
STAT,1891,16,30-34,1907,2.0179979176383083
SIM,1892,40,na,1932,3423
SIM,1839,23,15-19,1862,3
STAT,1815,47,25-29,1862,0.15495201883964746
STAT,1890,48,25-29,1938,0.04001823812176846
STAT,1784,103,na,1887,0.04606425504802343
SIM,1838,39,25-29,1877,6
SIM,1834,86,na,1920,78
SIM,1866,37,35-39,1903,4
SIM,1827,30,30-34,1857,22
SIM,1812,59,na,1871,1047
STAT,1818,78,na,1896,398.18027307845796
SIM,1849,22,30-34,1871,38
SIM,1888,29,35-39,1917,20
STAT,1882,38,25-29,1920,2.8473739805486997
SIM,1835,40,30-34,1875,1
SIM,1870,13,na,1883,2848
STAT,1780,103,na,1883,0.049047553574721126
SIM,1868,74,na,1942,1055
STAT,1881,34,25-29,1915,10.015559484941729
STAT,1851,32,30-34,1883,14.992575963506873
STAT,1869,84,na,1953,327.6427830057616
STAT,1920,46,30-34,1966,0.10081248313880424
STAT,1856,45,20-24,1901,0.009705446375707269
SIM,1923,22,20-24,1945,176
STAT,1933,34,40-44,1967,5.3713022730149005
SIM,1870,90,na,1960,90
STAT,1836,21,40-44,1857,1.7242690240154117
STAT,1832,38,35-39,1870,5.941898867521846
STAT,1795,82,na,1877,150.3298569478663
SIM,1917,16,35-39,1933,1
STAT,1897,26,50-100,1923,0.8755582323846636
STAT,1864,3,na,1867,2913.3660018090045
SIM,1933,30,na,1963,5076
STAT,1871,26,na,1897,2419.9166296368335
STAT,1846,37,na,1883,1759.4154890972607
SIM,1882,44,35-39,1926,2
SIM,1929,38,40-44,1967,7
SIM,1812,44,45-49,1856,2
STAT,1845,26,45-49,1871,1.063577660702833
STAT,1799,72,na,1871,543.9679979870349
SIM,1921,45,na,1966,4878
SIM,1850,76,na,1926,502
SIM,1904,29,30-34,1933,64
STAT,1853,45,50-100,1898,0.2079883634219842
SIM,1906,25,25-29,1931,98
STAT,1814,43,25-29,1857,2.0992070503187628
STAT,1899,23,30-34,1922,24.80633064596507
STAT,1844,29,20-24,1873,10.969482253770181
SIM,1858,27,40-44,1885,3
SIM,1919,29,na,1948,4297
STAT,1873,42,50-100,1915,1.0912897111241335
STAT,1926,33,na,1959,4662.452099451692
SIM,1822,43,25-29,1865,1
SIM,1870,30,40-44,1900,9
STAT,1887,44,45-49,1931,1.687765968045527
STAT,1888,66,na,1954,1976.6793456931414
STAT,1900,18,40-44,1918,0.25793815842386986
STAT,1813,47,na,1860,1324.9552833507473
STAT,1910,21,25-29,1931,88.73823484663383
STAT,1857,99,na,1956,1.778437973927027
SIM,1838,36,20-24,1874,1
STAT,1861,51,30-34,1912,0.005041818491006027
STAT,1947,21,20-24,1968,128.26068585207244
SIM,1844,43,45-49,1887,6
STAT,1827,43,35-39,1870,2.10568227942633
SIM,1908,33,35-39,1941,11
SIM,1864,26,20-24,1890,15
STAT,1819,49,15-19,1868,7.697743532669174E-4
STAT,1763,101,na,1864,0.04540486495552029
STAT,1840,45,25-29,1885,0.04288269275536665
STAT,1867,20,15-19,1887,3.21864994378071
STAT,1903,49,35-39,1952,0.11213077885776977
SIM,1849,44,40-44,1893,1
STAT,1906,32,15-19,1938,0.1214165656609528
STAT,1881,19,na,1900,2477.589810545912
STAT,1814,107,na,1921,0.0021975740942084213
STAT,1914,23,na,1937,3794.8002114382616
STAT,1954,17,25-29,1971,54.64376706008536
SIM,1881,31,na,1912,2187
STAT,1842,32,20-24,1874,2.5607118577106096
STAT,1851,44,30-34,1895,0.9356933551941142
STAT,1942,20,25-29,1962,98.87729809731442
STAT,1858,22,na,1880,1984.657682198458
STAT,1828,49,25-29,1877,0.04387859187724088
STAT,1901,35,40-44,1936,1.3606980859281081
SIM,1807,50,na,1857,1232
STAT,1894,34,35-39,1928,13.175146003972394
STAT,1836,43,45-49,1879,1.0941807592732355
STAT,1914,48,na,1962,3707.105466048185
SIM,1850,32,20-24,1882,5
SIM,1868,9,na,1877,2741
STAT,1939,19,40-44,1958,1.427306184575283
SIM,1856,89,na,1945,51
SIM,1875,20,15-19,1895,2
STAT,1834,47,35-39,1881,0.09991619726589664
STAT,1923,35,50-100,1958,0.4972182198155581
STAT,1870,19,20-24,1889,17.63878764055808
STAT,1825,42,30-34,1867,1.569799039134384
STAT,1906,31,50-100,1937,0.7843819965534643
STAT,1932,17,40-44,1949,1.8888186512420124
STAT,1907,44,40-44,1951,0.230803407963724
STAT,1807,53,35-39,1860,0.034856107339878116
STAT,1888,44,20-24,1932,0.18894640603471827
SIM,1882,4,na,1886,2589
STAT,1874,44,35-39,1918,1.860616091668327
STAT,1940,24,30-34,1964,29.848761139797123
SIM,1912,23,15-19,1935,5
STAT,1852,8,na,1860,2392.647108990183
STAT,1873,39,35-39,1912,7.241542184691382
SIM,1899,28,40-44,1927,10
STAT,1868,37,na,1905,2295.5872308904427
SIM,1921,48,na,1969,4818
SIM,1843,47,50-100,1890,1
STAT,1889,21,50-100,1910,0.5154259179509835
STAT,1847,43,20-24,1890,0.1229498441893161
STAT,1876,24,40-44,1900,2.181403468922209
STAT,1831,32,45-49,1863,1.5970450139117804
STAT,1806,48,35-39,1854,0.49163705310927897
STAT,1870,41,na,1911,2315.3423851035245
STAT,1900,22,50-100,1922,0.5765951424689507
SIM,1884,24,40-44,1908,4
STAT,1784,109,na,1893,6.642812192951128E-4
SIM,1906,56,na,1962,3137
SIM,1927,33,45-49,1960,3
STAT,1868,21,50-100,1889,0.4002111763830898
SIM,1940,17,40-44,1957,1
SIM,1833,42,30-34,1875,3
STAT,1872,52,45-49,1924,0.014758932557098012
STAT,1909,16,35-39,1925,0.841289369906259
SIM,1831,94,na,1925,11
STAT,1910,29,20-24,1939,17.8494596615081
STAT,1894,51,na,1945,2839.0222473186413
SIM,1767,92,na,1859,3
SIM,1872,30,50-100,1902,3
SIM,1865,17,30-34,1882,2
STAT,1851,89,na,1940,86.67098138049457
STAT,1892,33,30-34,1925,22.229124765367686
SIM,1868,34,40-44,1902,4
STAT,1890,46,35-39,1936,0.09878393332749834
SIM,1943,17,15-19,1960,44
SIM,1826,42,na,1868,1633
SIM,1814,48,35-39,1862,1
SIM,1801,96,na,1897,2
STAT,1845,39,15-19,1884,0.04515280345127521
STAT,1853,33,35-39,1886,8.65418789108142
STAT,1949,22,25-29,1971,109.9645790476215
STAT,1898,44,20-24,1942,0.015008759690761191
STAT,1932,22,15-19,1954,7.122923984951009
STAT,1894,49,15-19,1943,2.898979689996165E-4
STAT,1923,39,35-39,1962,2.8533910220848595
STAT,1857,17,30-34,1874,1.4925300958071221
SIM,1940,22,15-19,1962,6
SIM,1881,53,na,1934,1928
STAT,1855,44,50-100,1899,0.8079052657120716
STAT,1914,45,na,1959,3734.936330055625
SIM,1861,33,35-39,1894,16
STAT,1935,17,15-19,1952,63.27023772177362
STAT,1927,9,na,1936,5049.111271336604
SIM,1907,29,50-100,1936,1
STAT,1820,50,30-34,1870,0.010862086056112327
STAT,1932,29,40-44,1961,6.219843722965098
STAT,1867,27,35-39,1894,9.241084730594633
SIM,1874,33,20-24,1907,4
STAT,1919,33,45-49,1952,1.7251465286118972
STAT,1857,50,20-24,1907,5.963628911652388E-4
STAT,1914,29,na,1943,3825.581430849732
SIM,1891,33,20-24,1924,5
STAT,1827,31,50-100,1858,1.4890728137949418
SIM,1835,87,na,1922,138
STAT,1883,50,30-34,1933,0.006043919526854878
STAT,1915,29,40-44,1944,4.816691832572155
STAT,1937,26,15-19,1963,0.7022531414014832
STAT,1941,22,na,1963,3850.1073359111815
STAT,1815,54,50-100,1869,0.03728993278890269
STAT,1868,44,35-39,1912,1.7405817664374907
SIM,1933,32,25-29,1965,4
SIM,1899,32,na,1931,3261
STAT,1839,38,50-100,1877,1.0020986542276447
STAT,1832,32,20-24,1864,2.3708263241966434
STAT,1853,48,15-19,1901,3.311848898294418E-4
STAT,1893,17,35-39,1910,0.7101099972577696
STAT,1901,46,20-24,1947,0.009683930490695424
SIM,1859,44,35-39,1903,3
SIM,1944,21,45-49,1965,1
STAT,1872,40,45-49,1912,1.5456496604787813
SIM,1813,84,na,1897,98
SIM,1834,23,30-34,1857,18
STAT,1831,32,50-100,1863,0.8391253411127341
STAT,1915,30,50-100,1945,0.8661804715605337
SIM,1918,41,na,1959,4164
SIM,1919,26,na,1945,4167
SIM,1940,29,40-44,1969,7
SIM,1890,22,15-19,1912,5
SIM,1860,23,40-44,1883,3
STAT,1882,22,15-19,1904,3.278823533253739
SIM,1881,39,35-39,1920,7
SIM,1918,21,35-39,1939,15
STAT,1883,29,na,1912,2371.753881288588
SIM,1929,31,20-24,1960,2
STAT,1857,41,30-34,1898,0.920106913114851
SIM,1913,37,50-100,1950,4
STAT,1916,30,25-29,1946,9.816061746364435
STAT,1922,40,na,1962,4361.698925219655
SIM,1782,84,na,1866,50
SIM,1893,41,na,1934,3060
SIM,1923,29,40-44,1952,4
STAT,1858,25,35-39,1883,8.107024556936087
STAT,1874,50,20-24,1924,7.796336258988272E-4
SIM,1839,27,30-34,1866,21
STAT,1871,16,45-49,1887,0.06682994544315896
STAT,1815,44,20-24,1859,0.450525854827192
SIM,1924,30,25-29,1954,12
STAT,1916,42,25-29,1958,0.07467736308611264
STAT,1893,24,40-44,1917,2.6798716912422544
STAT,1800,99,na,1899,0.9127828781612067
STAT,1841,15,20-24,1856,17.083191607398906
STAT,1901,23,40-44,1924,2.9635325870029967
SIM,1788,75,na,1863,516
SIM,1929,24,15-19,1953,5
SIM,1900,68,na,1968,2433
STAT,1898,18,30-34,1916,2.1930655291385284
STAT,1877,41,40-44,1918,2.39069580227965
STAT,1901,41,na,1942,3323.523853524895
STAT,1841,34,20-24,1875,2.3717439461928684
STAT,1876,17,40-44,1893,0.19267545607799208
STAT,1867,15,40-44,1882,0.18120672533930005
SIM,1818,47,na,1865,1394
STAT,1826,33,40-44,1859,4.433953058985594
STAT,1909,22,50-100,1931,0.6236987657370713
SIM,1848,29,30-34,1877,33
STAT,1834,49,na,1883,1562.8533253694354
STAT,1821,61,na,1882,1042.0735266317924
SIM,1885,22,40-44,1907,5
STAT,1877,44,50-100,1921,1.1027284840557434
SIM,1876,44,35-39,1920,6
SIM,1868,89,na,1957,101
STAT,1912,38,20-24,1950,0.26116294373478083
SIM,1827,33,40-44,1860,7
SIM,1845,24,na,1869,2214
SIM,1899,21,15-19,1920,4
STAT,1856,26,20-24,1882,9.805345698746551
STAT,1926,23,35-39,1949,11.633742578478344
SIM,1885,41,40-44,1926,5
SIM,1859,35,45-49,1894,2
STAT,1880,29,25-29,1909,45.02426249639058
STAT,1773,116,na,1889,1.189687983455461E-4
SIM,1834,33,40-44,1867,8
STAT,1919,21,45-49,1940,1.2610981345930827
SIM,1889,51,na,1940,2854
STAT,1886,24,40-44,1910,2.2360358447471715
STAT,1897,5,na,1902,3574.6468212040127
SIM,1885,34,35-39,1919,16
STAT,1916,49,45-49,1965,0.22615235607168743
STAT,1911,45,45-49,1956,0.21086500792581334
STAT,1831,51,45-49,1882,0.010649604145527455
SIM,1934,23,35-39,1957,18
STAT,1848,107,na,1955,0.003665867015947109
STAT,1831,69,na,1900,988.8618289121155
SIM,1854,43,45-49,1897,4
STAT,1945,23,45-49,1968,1.2577462619368922
SIM,1818,43,35-39,1861,3
STAT,1882,66,na,1948,1628.9742020904719
STAT,1895,14,na,1909,3426.2199100883154
SIM,1823,77,na,1900,491
SIM,1904,16,25-29,1920,14
STAT,1806,62,na,1868,958.0515718068804
SIM,1835,43,35-39,1878,3
SIM,1868,71,na,1939,1358
STAT,1887,1,na,1888,3395.5313217751846
STAT,1852,23,40-44,1875,1.9799219446515535
STAT,1812,84,na,1896,151.72974777334161
STAT,1812,54,20-24,1866,0.00160014459073481
SIM,1950,20,25-29,1970,125
STAT,1847,24,20-24,1871,64.93598169952428
STAT,1917,21,35-39,1938,10.243274699891007
STAT,1762,92,na,1854,10.0
STAT,1902,1,na,1903,3915.800969343598
STAT,1910,36,20-24,1946,0.2583736872233749
SIM,1869,37,na,1906,2311
STAT,1862,33,45-49,1895,1.5079447535789714
STAT,1882,35,20-24,1917,0.773404864637594
STAT,1853,31,45-49,1884,1.5214723636709975
SIM,1833,32,20-24,1865,4
SIM,1849,37,35-39,1886,14
STAT,1846,43,45-49,1889,1.069447259442233
STAT,1781,84,na,1865,98.54303060901806
STAT,1925,32,25-29,1957,11.19780513646132
STAT,1841,21,15-19,1862,3.10804407498127
STAT,1849,64,na,1913,1349.5928739027715
STAT,1883,33,20-24,1916,2.6942504557739335
SIM,1925,21,35-39,1946,19
SIM,1844,21,40-44,1865,5
STAT,1842,54,25-29,1896,0.002701278925734357
STAT,1862,45,20-24,1907,0.010524691697031893
STAT,1948,6,na,1954,4601.706305652485
STAT,1812,47,15-19,1859,9.466898679881246E-4
STAT,1897,27,20-24,1924,16.002128795817573
STAT,1910,48,20-24,1958,0.010486822210710857
STAT,1857,15,50-100,1872,0.0464221831737141
STAT,1906,27,40-44,1933,4.4479503047613616
STAT,1852,16,35-39,1868,0.5377994568150252
SIM,1943,6,na,1949,3939
SIM,1843,23,40-44,1866,2
SIM,1914,39,40-44,1953,4
STAT,1940,20,50-100,1960,0.6842878258409962
STAT,1936,21,45-49,1957,1.0975336829451385
STAT,1908,11,na,1919,3912.2592960865827
STAT,1816,42,20-24,1858,0.3767729527839457
SIM,1819,40,50-100,1859,3
STAT,1841,103,na,1944,0.10596469818017737
SIM,1840,32,20-24,1872,3
SIM,1840,38,35-39,1878,12
SIM,1837,39,50-100,1876,1
SIM,1847,72,na,1919,777
STAT,1880,18,na,1898,2700.4308472339544
SIM,1914,27,40-44,1941,2
STAT,1863,74,na,1937,992.6523014849694
SIM,1939,15,35-39,1954,8
STAT,1877,34,35-39,1911,10.623566225765517
STAT,1876,50,30-34,1926,0.006360701569713731
STAT,1850,24,na,1874,1902.7574003066795
STAT,1915,22,20-24,1937,117.29073444860153
SIM,1871,29,25-29,1900,58
STAT,1906,39,40-44,1945,1.3888297877478617
STAT,1821,49,15-19,1870,6.116965112330688E-4
STAT,1827,61,na,1888,1242.5182334569422
STAT,1832,44,20-24,1876,0.12714865253409832
STAT,1898,42,30-34,1940,0.11000141339238349
SIM,1845,46,na,1891,1760
STAT,1835,23,40-44,1858,2.049833724048497
STAT,1848,54,35-39,1902,0.006508078250598326
STAT,1855,44,25-29,1899,0.491079674402056
SIM,1861,31,45-49,1892,5
STAT,1848,60,na,1908,1482.513911045677
STAT,1801,53,25-29,1854,0.00977880068970745
SIM,1900,33,40-44,1933,8
SIM,1844,61,na,1905,1447
SIM,1853,23,40-44,1876,3
STAT,1913,36,50-100,1949,0.4247260014836927
STAT,1847,36,20-24,1883,0.6301965939729438
STAT,1902,20,na,1922,3422.767590951512
STAT,1842,19,45-49,1861,0.06500856423949472
SIM,1874,19,30-34,1893,2
STAT,1840,22,45-49,1862,0.6381290722457427
STAT,1903,46,30-34,1949,0.07940853715261655
STAT,1913,29,30-34,1942,39.54433305635053
SIM,1906,22,20-24,1928,1
STAT,1842,51,20-24,1893,5.814485442868336E-4
STAT,1920,49,35-39,1969,0.14458909353841637
STAT,1894,69,na,1963,2139.3593153190805
SIM,1900,46,na,1946,3149
SIM,1923,25,25-29,1948,85
SIM,1888,35,50-100,1923,4
STAT,1845,45,45-49,1890,0.18623624635347918
STAT,1901,56,na,1957,2953.022081529878
STAT,1882,29,35-39,1911,9.521305955991329
STAT,1866,19,30-34,1885,1.521325276222938
SIM,1828,39,30-34,1867,4
SIM,1869,8,na,1877,2739
SIM,1869,34,na,1903,2340
STAT,1856,36,30-34,1892,4.28848639204009
STAT,1836,40,40-44,1876,1.7088603414591204
STAT,1915,25,25-29,1940,68.97263287435057
SIM,1861,19,20-24,1880,19
SIM,1890,29,35-39,1919,16
STAT,1845,23,40-44,1868,2.0067647365013785
STAT,1897,33,15-19,1930,0.1934295456372154
SIM,1875,27,35-39,1902,17
STAT,1827,41,45-49,1868,1.8072952771421908
STAT,1922,15,15-19,1937,53.84099821708726
STAT,1923,32,15-19,1955,0.1503092521882896
SIM,1877,88,na,1965,246
SIM,1870,33,45-49,1903,3
SIM,1814,42,20-24,1856,2
STAT,1916,46,40-44,1962,0.16543383186302735
STAT,1898,47,25-29,1945,0.04461434043153019
SIM,1890,16,20-24,1906,34
STAT,1836,24,45-49,1860,0.5646662144350957
STAT,1873,33,20-24,1906,2.783839787991786
SIM,1823,38,35-39,1861,8
SIM,1899,18,30-34,1917,6
SIM,1881,33,20-24,1914,2
SIM,1859,30,50-100,1889,2
SIM,1878,11,na,1889,2847
STAT,1836,75,na,1911,640.7727975832445
SIM,1839,17,20-24,1856,23
SIM,1881,29,25-29,1910,53
STAT,1861,42,na,1903,1945.9030375246475
STAT,1912,19,na,1931,3962.7594724924215
STAT,1873,29,25-29,1902,43.43753581498544
SIM,1919,27,25-29,1946,93
STAT,1852,21,50-100,1873,0.3930847234989538
STAT,1842,30,30-34,1872,16.887354771431706
SIM,1837,43,45-49,1880,3
SIM,1930,15,15-19,1945,94
STAT,1853,19,20-24,1872,17.672018714800924
STAT,1840,31,50-100,1871,0.8114396069152913
STAT,1918,17,15-19,1935,10.113432869107934
SIM,1829,34,20-24,1863,2
STAT,1873,26,20-24,1899,12.174886716089194
STAT,1832,28,25-29,1860,38.04382404421519
SIM,1810,73,na,1883,799
STAT,1858,37,35-39,1895,5.722047716583462
STAT,1810,44,45-49,1854,4.995911185846886
STAT,1834,31,na,1865,1884.9668913853845
STAT,1944,21,na,1965,4024.0863861674516
SIM,1840,28,25-29,1868,35
SIM,1850,30,30-34,1880,24
STAT,1894,32,45-49,1926,2.2882752363269114
SIM,1868,37,45-49,1905,2
SIM,1895,27,50-100,1922,4
STAT,1846,19,20-24,1865,15.739144028718728
SIM,1888,26,na,1914,2747
STAT,1864,46,25-29,1910,0.0523962823263603
STAT,1923,36,30-34,1959,2.156632713693631
STAT,1901,38,45-49,1939,0.6107790590550952
SIM,1829,53,na,1882,1180
SIM,1832,76,na,1908,473
SIM,1850,35,25-29,1885,4
SIM,1808,69,na,1877,851
STAT,1834,44,30-34,1878,0.909105569384521
STAT,1938,24,15-19,1962,5.370562967229297
SIM,1832,57,na,1889,1271
STAT,1871,35,50-100,1906,1.2524470416430409
STAT,1904,30,na,1934,3516.988473545713
STAT,1815,76,na,1891,489.87916219886574
STAT,1848,15,30-34,1863,1.5541375113178761
STAT,1816,40,30-34,1856,2.9376239261570936
SIM,1844,40,40-44,1884,4
STAT,1842,35,25-29,1877,2.704244350565823
STAT,1848,29,50-100,1877,0.5851335058403839
SIM,1864,39,35-39,1903,15
STAT,1847,49,35-39,1896,0.10689435595902068
STAT,1838,53,20-24,1891,5.334824500165929E-4
SIM,1901,30,50-100,1931,3
STAT,1855,52,45-49,1907,0.011190108856915631
STAT,1829,54,25-29,1883,0.0024235049034257053
STAT,1861,64,na,1925,1465.3809337170776
SIM,1891,46,35-39,1937,1
STAT,1941,15,25-29,1956,45.56216045986586
SIM,1868,6,na,1874,2741
SIM,1928,19,15-19,1947,58
STAT,1787,101,na,1888,0.1662264178977017
STAT,1870,41,30-34,1911,1.1517089803740672
STAT,1886,46,45-49,1932,0.2555591816025952
STAT,1861,54,35-39,1915,0.007057596271861063
SIM,1889,73,na,1962,1824
SIM,1834,26,35-39,1860,8
STAT,1896,45,25-29,1941,0.044213564895678
SIM,1938,33,20-24,1971,3
STAT,1836,97,na,1933,3.343869380852012
SIM,1833,21,na,1854,1914
STAT,1883,46,35-39,1929,0.14053303110363163
STAT,1883,52,20-24,1935,7.34699684320967E-4
SIM,1921,29,30-34,1950,56
SIM,1824,40,30-34,1864,3
STAT,1903,42,15-19,1945,0.0013889709464128173
SIM,1856,86,na,1942,102
SIM,1859,32,40-44,1891,9
STAT,1887,4,na,1891,3007.2269931455094
STAT,1884,49,50-100,1933,0.24270426815316673
SIM,1877,85,na,1962,392
SIM,1901,29,20-24,1930,19
STAT,1883,31,30-34,1914,17.54799398797349
STAT,1783,94,na,1877,4.37129107255009
SIM,1913,19,na,1932,4111
STAT,1833,43,35-39,1876,1.4332094353148292
STAT,1856,32,15-19,1888,0.11543680003148077
STAT,1868,42,45-49,1910,1.4564819461704752
SIM,1883,63,na,1946,1840
SIM,1939,17,25-29,1956,58
SIM,1875,24,30-34,1899,20
STAT,1820,53,35-39,1873,0.01479828708072635
SIM,1904,25,15-19,1929,1
STAT,1829,40,40-44,1869,1.9396366492564014
SIM,1909,29,15-19,1938,1
STAT,1762,95,na,1857,2.2942324125223195
STAT,1867,24,30-34,1891,16.95259363373696
STAT,1873,52,na,1925,2215.057786866566
STAT,1815,98,na,1913,1.679740865440963
SIM,1833,39,na,1872,1778
SIM,1931,36,30-34,1967,3
STAT,1876,41,na,1917,2445.744445072171
STAT,1818,87,na,1905,89.7846872659679
STAT,1877,25,45-49,1902,1.1827663521465388
SIM,1841,43,35-39,1884,3
SIM,1885,25,45-49,1910,2
STAT,1877,44,45-49,1921,1.5621986902223177
SIM,1871,78,na,1949,884
STAT,1846,34,na,1880,1793.891506679223
STAT,1828,39,15-19,1867,0.04719107155268701
STAT,1856,12,na,1868,2260.469930745607
SIM,1892,49,50-100,1941,1
STAT,1854,39,25-29,1893,2.181428531368983
STAT,1912,44,15-19,1956,0.0014992323281303689
STAT,1883,36,25-29,1919,2.8958479721366146
SIM,1891,31,30-34,1922,25
STAT,1896,31,40-44,1927,5.866968485806338
SIM,1883,45,30-34,1928,1
SIM,1880,19,30-34,1899,1
SIM,1866,22,30-34,1888,26
STAT,1866,43,30-34,1909,1.0739888206926713
SIM,1926,17,15-19,1943,51
SIM,1891,6,na,1897,3374
STAT,1929,41,15-19,1970,0.0020313465591774295
SIM,1876,42,45-49,1918,6
SIM,1908,63,na,1971,3220
STAT,1842,45,35-39,1887,0.11265698018624642
STAT,1852,26,45-49,1878,1.0493510833452189
SIM,1822,32,45-49,1854,4
SIM,1870,93,na,1963,56
STAT,1897,37,30-34,1934,7.269739095665594
SIM,1921,30,na,1951,4929
SIM,1897,19,35-39,1916,1
SIM,1915,44,40-44,1959,2
STAT,1811,51,35-39,1862,0.02324627958845819
STAT,1837,17,20-24,1854,21.6025602161034
SIM,1922,34,30-34,1956,29
SIM,1845,17,20-24,1862,25
SIM,1854,29,30-34,1883,32
STAT,1846,29,30-34,1875,21.473664094582507
STAT,1881,23,45-49,1904,0.6856273546087476
SIM,1934,18,na,1952,5183
STAT,1889,19,35-39,1908,0.6877442140175055
STAT,1914,34,30-34,1948,16.04238809416692
STAT,1923,46,40-44,1969,0.18865087604973235
STAT,1875,45,30-34,1920,0.1023610538026073
SIM,1882,19,na,1901,2431
STAT,1837,54,50-100,1891,0.009792755933873827
STAT,1830,34,45-49,1864,1.6108634322490194
STAT,1858,22,30-34,1880,16.533756732834714
STAT,1897,40,na,1937,3195.424203508484
STAT,1906,44,50-100,1950,0.10746115901916137
SIM,1791,80,na,1871,193
SIM,1854,38,na,1892,2043
STAT,1824,72,na,1896,695.3692726239321
STAT,1836,30,30-34,1866,14.025984821997785
STAT,1839,86,na,1925,153.12670260598625
STAT,1840,33,25-29,1873,8.88455192263568
STAT,1947,10,na,1957,4515.840071593419
STAT,1825,35,na,1860,1743.4397829886718
STAT,1916,40,35-39,1956,0.2111666606535573
SIM,1860,26,45-49,1886,2
STAT,1808,54,30-34,1862,0.013621021280151573
SIM,1881,56,na,1937,1830
STAT,1847,53,30-34,1900,0.0045673452687675685
SIM,1944,8,na,1952,4295
STAT,1893,27,45-49,1920,1.4368948592684445
SIM,1874,43,30-34,1917,4
STAT,1864,56,na,1920,1850.1159386848215
STAT,1930,17,30-34,1947,16.072013646157306
SIM,1792,65,na,1857,769
SIM,1819,91,na,1910,13
SIM,1905,46,30-34,1951,1
STAT,1855,30,40-44,1885,3.4948521146974865
SIM,1856,64,na,1920,1687
SIM,1920,29,50-100,1949,1
STAT,1912,29,50-100,1941,0.9934648746247815
SIM,1930,35,50-100,1965,3
STAT,1948,3,na,1951,4656.814046279899
STAT,1851,47,35-39,1898,0.11496395516784415
STAT,1870,78,na,1948,779.1939611840949
STAT,1832,47,25-29,1879,0.04572835007002328
STAT,1911,42,40-44,1953,0.24351246561228743
SIM,1881,43,30-34,1924,2
STAT,1834,23,50-100,1857,0.3643840556388647
STAT,1872,19,30-34,1891,1.6208800666077723
STAT,1824,40,50-100,1864,1.354993674488079
STAT,1937,17,25-29,1954,43.00218206793269
SIM,1879,47,30-34,1926,1
STAT,1837,20,na,1857,1887.5011396983564
SIM,1834,36,45-49,1870,3
SIM,1885,31,30-34,1916,19
STAT,1885,55,na,1940,2104.4750205002283
SIM,1821,36,na,1857,1584
STAT,1927,20,50-100,1947,0.8318958414137028
SIM,1865,41,30-34,1906,1
SIM,1842,35,na,1877,1939
SIM,1863,30,40-44,1893,8
STAT,1826,36,45-49,1862,1.8275511088086493
STAT,1812,87,na,1899,80.35714951386264
STAT,1816,45,25-29,1861,0.1223549708790023
SIM,1945,17,25-29,1962,60
SIM,1886,18,20-24,1904,28
SIM,1835,29,20-24,1864,16
STAT,1841,25,30-34,1866,23.42878454529904
SIM,1933,33,na,1966,5062
STAT,1877,31,30-34,1908,18.54937788232661
SIM,1827,36,45-49,1863,2
SIM,1860,5,na,1865,2479
SIM,1863,34,na,1897,2052
STAT,1904,8,na,1912,3800.707725917099
SIM,1849,34,30-34,1883,19
SIM,1849,28,45-49,1877,3
SIM,1891,36,25-29,1927,4
STAT,1805,80,na,1885,317.3678560038339
STAT,1890,36,25-29,1926,3.6086140284118664
STAT,1916,55,na,1971,3724.630387652989
STAT,1810,58,na,1868,1027.8533566048422
STAT,1877,22,40-44,1899,2.2048488831711923
STAT,1883,11,na,1894,2588.859774963865
SIM,1914,23,25-29,1937,98
STAT,1886,27,45-49,1913,1.198918747101591
SIM,1912,34,na,1946,3836
STAT,1901,49,25-29,1950,0.04538348530078633
SIM,1894,27,45-49,1921,1
STAT,1919,38,30-34,1957,1.9960682114915211
STAT,1773,113,na,1886,4.834108136626918E-4
STAT,1906,23,25-29,1929,84.73824992405665
SIM,1832,40,50-100,1872,4
STAT,1825,57,na,1882,1295.8489131584927
STAT,1827,83,na,1910,256.5803688523549
STAT,1871,35,45-49,1906,2.033599057852232
STAT,1823,45,25-29,1868,0.0890822078475358
STAT,1862,30,40-44,1892,3.796276429987977
STAT,1819,36,45-49,1855,6.126597735594303
SIM,1789,79,na,1868,267
STAT,1827,29,20-24,1856,22.667668433464854
SIM,1828,29,20-24,1857,3
SIM,1927,38,30-34,1965,1
SIM,1857,49,na,1906,1821
STAT,1774,80,na,1854,169.00000000000003
STAT,1852,50,50-100,1902,0.012341641773003561
SIM,1892,17,30-34,1909,4
SIM,1824,87,na,1911,74
SIM,1857,19,30-34,1876,3
STAT,1848,53,20-24,1901,5.643992624371913E-4
STAT,1837,46,50-100,1883,0.1721750098326316
SIM,1864,1,na,1865,3269
STAT,1886,30,35-39,1916,11.023228149417141
STAT,1895,42,50-100,1937,0.09752565507485025
SIM,1892,33,35-39,1925,22
STAT,1895,36,45-49,1931,2.666123357293991
STAT,1851,27,45-49,1878,1.0725314080718908
STAT,1898,46,40-44,1944,0.13360308617729663
STAT,1866,70,na,1936,1320.250991874101
STAT,1890,44,15-19,1934,0.016992997459613104
SIM,1939,15,40-44,1954,1
STAT,1826,42,na,1868,1582.5575216634165
STAT,1849,39,na,1888,1833.1720668173728
SIM,1949,19,15-19,1968,52
STAT,1787,107,na,1894,0.0021451123140126204
STAT,1904,61,na,1965,2951.5431069199753
STAT,1917,15,40-44,1932,0.30858706106628864
SIM,1869,99,na,1968,29
SIM,1899,36,25-29,1935,2
STAT,1836,37,20-24,1873,0.5889742689275017
SIM,1871,43,45-49,1914,3
STAT,1941,26,40-44,1967,4.921358759624226
STAT,1853,44,na,1897,1911.8125270668684
SIM,1890,36,35-39,1926,19
STAT,1855,103,na,1958,0.19414626147678493
SIM,1928,29,25-29,1957,106
STAT,1873,43,30-34,1916,1.1804545024646074
STAT,1850,40,25-29,1890,0.4879076065177223
STAT,1881,87,na,1968,409.21590973616543
STAT,1815,47,30-34,1862,0.2604054786152693
STAT,1852,53,40-44,1905,0.008344918661458317
STAT,1892,41,15-19,1933,0.01773661427301985
STAT,1924,29,45-49,1953,2.037587737339845
SIM,1886,31,na,1917,2649
SIM,1943,17,na,1960,3639
STAT,1853,24,45-49,1877,0.6809664628767812
SIM,1945,26,20-24,1971,4
STAT,1870,21,40-44,1891,2.0843788032992134
STAT,1908,51,na,1959,3344.823139218362
STAT,1857,34,na,1891,1884.941616850335
SIM,1919,18,20-24,1937,204
STAT,1850,24,20-24,1874,61.32643664635308
STAT,1806,52,30-34,1858,0.019351171831302253
STAT,1880,40,40-44,1920,2.435621097330106
STAT,1884,17,30-34,1901,1.6086647185516947
SIM,1904,6,na,1910,4063
SIM,1795,85,na,1880,105
STAT,1863,43,45-49,1906,1.329002114897363
SIM,1828,77,na,1905,504
SIM,1820,97,na,1917,2
STAT,1852,21,20-24,1873,66.4273803838601
STAT,1840,37,40-44,1877,3.7257290466779884
SIM,1894,30,35-39,1924,3
SIM,1921,4,na,1925,5302
STAT,1833,27,25-29,1860,37.28495113444434
STAT,1884,33,35-39,1917,10.177938727133883
SIM,1901,29,15-19,1930,1
STAT,1909,39,20-24,1948,0.25191172289808506
STAT,1831,29,na,1860,1899.4819430824346
STAT,1854,17,15-19,1871,5.433358497962877
SIM,1879,39,50-100,1918,2
STAT,1784,73,na,1857,407.85676458804113
STAT,1828,45,45-49,1873,0.18949342247335052
SIM,1862,17,15-19,1879,9
STAT,1864,24,20-24,1888,62.60571166069141
SIM,1851,89,na,1940,19
STAT,1872,30,35-39,1902,10.437441206917924
SIM,1825,42,35-39,1867,3
STAT,1814,57,na,1871,1201.238490235363
SIM,1951,12,na,1963,5314
SIM,1924,10,na,1934,4927
STAT,1864,36,15-19,1900,0.0511819713647258
STAT,1893,72,na,1965,1924.3236168258054
STAT,1845,100,na,1945,0.8295131060614982
SIM,1830,30,50-100,1860,2
SIM,1872,24,20-24,1896,4
SIM,1925,15,40-44,1940,2
SIM,1836,72,na,1908,929
STAT,1835,24,25-29,1859,55.90793806231429
STAT,1910,16,50-100,1926,0.07590122913632272
STAT,1862,27,20-24,1889,10.225148926178269
SIM,1859,69,na,1928,1242
STAT,1921,22,50-100,1943,0.7583847399315636
SIM,1848,48,45-49,1896,2
STAT,1857,46,25-29,1903,0.0460213008501085
SIM,1947,21,25-29,1968,146
STAT,1815,45,35-39,1860,0.3894062392722074
STAT,1950,19,45-49,1969,0.6021857171900302
SIM,1905,23,15-19,1928,8
STAT,1917,28,na,1945,3995.0473399582393
SIM,1890,38,30-34,1928,4
SIM,1935,19,15-19,1954,62
STAT,1903,0,na,1903,4258.17140794705
SIM,1901,53,na,1954,3257
STAT,1941,30,50-100,1971,0.8866118351284535
STAT,1892,23,15-19,1915,4.204972745753521
STAT,1841,53,35-39,1894,0.00625446103205297
STAT,1776,78,na,1854,277.0
STAT,1929,16,15-19,1945,59.21855297663905
STAT,1901,23,35-39,1924,8.299050771384767
SIM,1955,16,35-39,1971,9
STAT,1810,67,na,1877,760.983776156466
STAT,1909,6,na,1915,3995.4937324955326
SIM,1867,64,na,1931,1498
SIM,1887,17,20-24,1904,28
STAT,1903,20,35-39,1923,8.512898482121658
STAT,1939,21,25-29,1960,94.66363746486292
STAT,1817,42,35-39,1859,4.5529037713666725
STAT,1889,39,25-29,1928,3.5916857416610917
SIM,1841,27,25-29,1868,48
STAT,1831,48,25-29,1879,0.04650590344573261
STAT,1952,16,45-49,1968,0.6108428521550445
STAT,1877,22,35-39,1899,6.174439553969456
SIM,1861,24,45-49,1885,1
STAT,1839,45,20-24,1884,0.008657025317304412
SIM,1912,25,na,1937,3832
SIM,1840,42,30-34,1882,2
STAT,1849,37,30-34,1886,4.233934617732221
STAT,1869,46,45-49,1915,0.23309832567337713
STAT,1876,39,15-19,1915,0.05855949801763562
STAT,1882,38,30-34,1920,5.270671014203618
SIM,1851,32,35-39,1883,16
SIM,1916,15,na,1931,4280
STAT,1836,60,na,1896,1187.094582855136
STAT,1842,54,50-100,1896,0.011517953278483054
STAT,1835,23,50-100,1858,0.4011416581568842
SIM,1938,30,na,1968,3867
STAT,1866,53,40-44,1919,0.009747149542582993
SIM,1882,41,na,1923,2211
SIM,1870,27,20-24,1897,18
STAT,1896,49,40-44,1945,0.1273986377736601
STAT,1849,19,30-34,1868,1.5052724127627544
STAT,1947,16,35-39,1963,4.823981406778546
SIM,1922,37,35-39,1959,7
STAT,1870,16,na,1886,2557.7510176878477
STAT,1828,27,15-19,1855,0.6659045306414038
STAT,1927,19,15-19,1946,57.252889798642094
STAT,1860,29,50-100,1889,0.527498498900836
STAT,1897,33,45-49,1930,2.3685994242486172
STAT,1849,109,na,1958,9.679683730021139E-4
STAT,1879,28,50-100,1907,0.6797380480717119
STAT,1862,80,na,1942,537.1890387009165
STAT,1939,27,50-100,1966,1.0207694163306091
STAT,1919,30,40-44,1949,4.3430855734609235
SIM,1903,26,15-19,1929,1
STAT,1821,98,na,1919,1.7117838580141518
SIM,1869,21,40-44,1890,3
STAT,1882,36,35-39,1918,7.063446655964873
STAT,1920,18,20-24,1938,154.81868280737854
STAT,1832,42,30-34,1874,0.9446474453465147
STAT,1868,32,40-44,1900,4.2255549634349725
STAT,1925,23,na,1948,4445.895789984846
STAT,1854,85,na,1939,209.81005195601358
STAT,1871,4,na,1875,2978.967432713932
SIM,1878,36,na,1914,2645
STAT,1845,49,na,1894,1721.2024715036728
STAT,1854,50,40-44,1904,0.008173173166068028
SIM,1848,38,na,1886,1894
SIM,1832,82,na,1914,213
STAT,1958,10,na,1968,5262.914161710638
SIM,1911,20,35-39,1931,12
STAT,1825,32,15-19,1857,0.28232666680902424
SIM,1920,20,na,1940,3852
STAT,1895,18,15-19,1913,7.878256787063681
SIM,1838,42,45-49,1880,3
STAT,1864,38,40-44,1902,3.951060425119606
STAT,1915,33,na,1948,3914.04107989004
STAT,1879,35,20-24,1914,0.8298051863591507
SIM,1882,41,25-29,1923,1
STAT,1906,9,na,1915,3852.629904753174
STAT,1881,38,40-44,1919,4.296017642507624
STAT,1867,32,20-24,1899,2.588805071227069
STAT,1843,16,30-34,1859,1.65404075897352
SIM,1911,18,20-24,1929,32
STAT,1837,85,na,1922,182.77270366118776
SIM,1898,56,na,1954,3147
STAT,1914,37,35-39,1951,2.4639737217653273
STAT,1848,38,25-29,1886,2.282576103320902
STAT,1820,45,45-49,1865,0.44323803440634624
SIM,1822,47,40-44,1869,1
SIM,1879,43,45-49,1922,5
STAT,1881,31,50-100,1912,0.9073652612426393
SIM,1929,23,30-34,1952,2
STAT,1870,49,20-24,1919,0.011717287804243495
STAT,1933,31,30-34,1964,21.66547203760312
STAT,1929,34,15-19,1963,0.16626963131226527
STAT,1878,21,40-44,1899,2.2193961967841553
SIM,1946,23,30-34,1969,34
STAT,1869,28,15-19,1897,0.4452825258042957
STAT,1809,48,15-19,1857,0.0017496110980666985
SIM,1925,33,40-44,1958,5
SIM,1856,38,25-29,1894,6
STAT,1859,27,45-49,1886,0.920194521194305
STAT,1925,16,50-100,1941,0.4628801067957906
STAT,1823,35,15-19,1858,0.11176501476172293
STAT,1843,32,35-39,1875,9.828288922379183
SIM,1897,15,na,1912,3435
SIM,1813,44,na,1857,1425
STAT,1820,57,na,1877,1190.6268439987837
STAT,1897,15,15-19,1912,8.132554683137931
STAT,1861,46,15-19,1907,3.3814434917887713E-4
SIM,1867,27,45-49,1894,1
STAT,1919,23,na,1942,4068.0214295017763
STAT,1876,25,25-29,1901,44.863879986541576
STAT,1935,28,50-100,1963,1.3829945728623536
STAT,1860,16,30-34,1876,1.5305543554522965
STAT,1910,47,45-49,1957,0.20681577684337374
STAT,1917,33,40-44,1950,4.164197008541419
SIM,1868,40,35-39,1908,1
SIM,1884,25,25-29,1909,71
STAT,1854,35,15-19,1889,0.04363576680737681
SIM,1872,38,40-44,1910,7
SIM,1844,36,50-100,1880,3
SIM,1835,31,40-44,1866,7
SIM,1890,76,na,1966,1457
SIM,1893,25,50-100,1918,1
STAT,1866,38,45-49,1904,1.8665075256974446
SIM,1888,15,15-19,1903,7
SIM,1909,45,na,1954,3329
STAT,1841,21,45-49,1862,0.6569537425910787
STAT,1872,11,na,1883,2703.273888963254
STAT,1918,31,35-39,1949,9.950130712743768
SIM,1855,42,50-100,1897,4
SIM,1844,36,na,1880,2038
SIM,1866,23,na,1889,2531
STAT,1905,18,25-29,1923,8.32716904728445
SIM,1946,24,15-19,1970,8
STAT,1890,26,15-19,1916,0.5678619895111139
STAT,1905,37,50-100,1942,0.39043260985817246
SIM,1884,36,na,1920,2526
STAT,1860,32,35-39,1892,8.382316907715625
STAT,1892,28,45-49,1920,1.4145942932389135
STAT,1906,56,na,1962,3168.1861595811174
SIM,1838,24,15-19,1862,2
STAT,1814,48,25-29,1862,0.16898755198630516
STAT,1851,54,35-39,1905,0.0069073060003219675
SIM,1880,30,35-39,1910,15
SIM,1906,39,45-49,1945,1
STAT,1818,41,40-44,1859,6.00177142278088
STAT,1903,18,20-24,1921,25.64193129633044
STAT,1856,48,30-34,1904,0.07654376529326973
STAT,1857,111,na,1968,7.61596244791735E-4
SIM,1880,74,na,1954,902
SIM,1904,39,40-44,1943,4
SIM,1937,16,15-19,1953,68
STAT,1824,50,25-29,1874,0.004143747808075655
STAT,1861,67,na,1928,1336.2882875216605
SIM,1841,59,na,1900,1453
SIM,1888,1,na,1889,3430
STAT,1874,43,20-24,1917,0.16421868491809682
SIM,1857,37,30-34,1894,6
STAT,1885,32,40-44,1917,4.413818090625515
STAT,1881,39,25-29,1920,2.811106927424681
STAT,1891,41,25-29,1932,0.8147127871963518
STAT,1823,93,na,1916,16.265476539243775
STAT,1807,52,20-24,1859,0.003048946070377226
SIM,1801,59,na,1860,1219
SIM,1896,61,na,1957,2580
STAT,1850,42,20-24,1892,0.11931285502844441
SIM,1885,41,50-100,1926,1
SIM,1913,18,25-29,1931,16
STAT,1885,15,25-29,1900,5.7942725824008035
STAT,1839,48,25-29,1887,0.03998689901349278
STAT,1921,33,na,1954,4276.733803184731
STAT,1820,45,15-19,1865,7.512502734583151E-4
SIM,1866,40,30-34,1906,3
STAT,1869,43,40-44,1912,2.19932768555627
STAT,1827,31,40-44,1858,7.04798688418804
SIM,1862,35,45-49,1897,3
SIM,1874,38,45-49,1912,4
STAT,1825,37,45-49,1862,3.054169534649148
STAT,1899,28,30-34,1927,35.054523095296666
STAT,1891,43,20-24,1934,0.19913158285229746
STAT,1859,29,40-44,1888,2.447133740158283
SIM,1843,24,25-29,1867,71
STAT,1864,28,50-100,1892,0.578211157982942
SIM,1830,87,na,1917,106
STAT,1844,31,40-44,1875,4.060627794061888
STAT,1930,24,50-100,1954,0.8543400890714751
STAT,1850,95,na,1945,10.000968172619455
SIM,1829,90,na,1919,11
SIM,1823,31,45-49,1854,4
STAT,1776,114,na,1890,2.9415989609226967E-4
STAT,1843,14,na,1857,2440.456867786533
STAT,1805,109,na,1914,2.859548053936342E-4
STAT,1879,47,15-19,1926,4.2455308252653935E-4
SIM,1855,79,na,1934,495
STAT,1899,44,35-39,1943,0.1732930859790303
STAT,1841,15,50-100,1856,0.04720851558383268
STAT,1844,110,na,1954,2.1413752979611362E-4
SIM,1932,29,45-49,1961,3
SIM,1789,85,na,1874,37
STAT,1833,42,20-24,1875,0.12732869286712473
SIM,1831,37,40-44,1868,8
SIM,1926,31,35-39,1957,12
STAT,1794,63,na,1857,898.64050036452
STAT,1825,29,na,1854,1571.9855831964787
STAT,1910,61,na,1971,3220.418519388361
STAT,1924,41,30-34,1965,0.15537155801821895
STAT,1899,69,na,1968,2378.680678921794
STAT,1938,23,30-34,1961,29.007209627615442
SIM,1846,34,20-24,1880,6
STAT,1868,77,na,1945,842.2354851357012
SIM,1841,40,25-29,1881,1
STAT,1948,15,40-44,1963,1.6339979225585066
STAT,1855,49,25-29,1904,0.043719132828292054
SIM,1901,47,45-49,1948,1
STAT,1946,25,na,1971,4261.259841855544
STAT,1856,46,35-39,1902,0.11243079834006409
STAT,1875,87,na,1962,328.5888940541604
STAT,1924,47,45-49,1971,0.2639852176068202
SIM,1933,27,na,1960,4941
STAT,1868,17,45-49,1885,0.06480051855019527
SIM,1851,16,30-34,1867,1
SIM,1902,28,20-24,1930,18
STAT,1824,52,20-24,1876,8.296820694482001E-4
STAT,1854,35,45-49,1889,1.5490695374396248
SIM,1833,37,45-49,1870,3
SIM,1887,5,na,1892,3074
STAT,1937,26,20-24,1963,18.15825965350228
STAT,1880,37,50-100,1917,1.31617659929679
STAT,1954,8,na,1962,4955.698397638215
STAT,1838,34,20-24,1872,2.417182848063273
STAT,1894,22,40-44,1916,2.734411904170408
STAT,1909,23,35-39,1932,8.897549646645247
SIM,1893,15,25-29,1908,13
STAT,1891,25,20-24,1916,14.917320826806007
STAT,1838,16,20-24,1854,17.307931100558697
SIM,1915,29,45-49,1944,3
STAT,1814,47,40-44,1861,0.5104601290111623
STAT,1880,22,40-44,1902,2.2339047815744153
STAT,1824,34,20-24,1858,4.303601305752221
SIM,1832,34,20-24,1866,4
STAT,1943,23,40-44,1966,3.6485568762897325
STAT,1872,49,25-29,1921,0.05766232850083496
SIM,1883,28,45-49,1911,2
STAT,1882,22,45-49,1904,0.6930517520024966
SIM,1822,80,na,1902,265
STAT,1821,36,50-100,1857,2.8471052373744024
STAT,1907,41,30-34,1948,0.12012537632155364
SIM,1890,22,45-49,1912,1
STAT,1922,47,40-44,1969,0.184812070644972
STAT,1875,28,45-49,1903,1.1584072019363796
SIM,1917,23,35-39,1940,8
SIM,1918,10,na,1928,4578
STAT,1777,91,na,1868,21.21027440186851
STAT,1808,57,na,1865,942.7821903612287
STAT,1861,46,45-49,1907,0.19950533393579536
STAT,1872,82,na,1954,477.0477118434419
STAT,1907,29,45-49,1936,1.6373236869654182
SIM,1877,30,35-39,1907,19
STAT,1831,48,50-100,1879,0.19829600636889894
STAT,1875,40,30-34,1915,1.215860807348393
STAT,1885,49,na,1934,2242.030114079636
SIM,1936,18,20-24,1954,128
STAT,1897,30,40-44,1927,5.962989124778441
STAT,1865,53,20-24,1918,6.722714700859636E-4
SIM,1875,33,35-39,1908,13
SIM,1902,35,na,1937,3479
SIM,1928,26,20-24,1954,25
STAT,1833,24,20-24,1857,62.53720293665371
STAT,1895,4,na,1899,3501.474183027717
SIM,1806,90,na,1896,42
SIM,1871,40,40-44,1911,5
STAT,1930,37,20-24,1967,0.3506904921315043
SIM,1899,33,20-24,1932,8
STAT,1833,40,25-29,1873,0.5283111233286378
STAT,1899,26,35-39,1925,13.525517928936512
STAT,1902,37,15-19,1939,0.01743705794409874
STAT,1866,42,na,1908,2172.130157147631
STAT,1812,50,35-39,1862,0.020229942363146656
STAT,1937,29,25-29,1966,65.38105147774151
SIM,1846,62,na,1908,1424
SIM,1849,45,25-29,1894,1
STAT,1878,51,50-100,1929,0.016113755216822283
SIM,1938,31,25-29,1969,15
STAT,1873,44,15-19,1917,0.014090019377175085
SIM,1867,42,40-44,1909,4
STAT,1894,8,na,1902,3411.1719110709764
SIM,1842,42,35-39,1884,2
STAT,1810,53,35-39,1863,0.025267801178613044
STAT,1867,33,35-39,1900,9.658082408813803
STAT,1862,52,na,1914,1859.856930290825
SIM,1926,29,20-24,1955,34
STAT,1867,49,15-19,1916,3.750936850593816E-4
STAT,1871,97,na,1968,26.855176276921295
STAT,1922,29,40-44,1951,5.343167503967227
STAT,1859,42,40-44,1901,1.8302625523131224
STAT,1910,29,15-19,1939,0.690310600178881
STAT,1882,40,45-49,1922,1.5024851609878136
STAT,1848,85,na,1933,213.09376983014647
STAT,1909,26,45-49,1935,1.7039909006635818
STAT,1926,23,40-44,1949,4.154327547796416
SIM,1930,29,40-44,1959,7
STAT,1923,28,na,1951,4372.8785459469245
STAT,1895,33,40-44,1928,5.74785837458189
STAT,1804,98,na,1902,1.0961222059844964
STAT,1867,45,50-100,1912,0.23756393900762923
SIM,1841,24,20-24,1865,108
SIM,1861,21,40-44,1882,4
SIM,1831,23,20-24,1854,92
STAT,1943,26,45-49,1969,1.8780296392015352
STAT,1926,39,20-24,1965,0.3279598466704281
STAT,1928,18,20-24,1946,173.79199811964705
SIM,1833,36,na,1869,1824
STAT,1873,46,35-39,1919,0.14520604150774727
SIM,1851,49,na,1900,1782
STAT,1880,46,na,1926,2418.743754586616
SIM,1890,33,30-34,1923,37
SIM,1914,20,na,1934,3788
STAT,1863,40,40-44,1903,2.0321691306302907
SIM,1934,23,40-44,1957,4
STAT,1855,16,20-24,1871,16.44292757935151
SIM,1838,67,na,1905,984
STAT,1882,51,30-34,1933,0.005944407297354112
SIM,1810,95,na,1905,28
SIM,1890,40,45-49,1930,5
STAT,1935,16,45-49,1951,0.6981355826306116
SIM,1863,16,20-24,1879,17
SIM,1899,35,40-44,1934,7
STAT,1865,54,35-39,1919,0.007751950833654955
STAT,1919,15,45-49,1934,0.11354633691308344
STAT,1793,78,na,1871,334.9259514510957
STAT,1846,40,35-39,1886,1.344645929797415
STAT,1854,57,na,1911,1538.0803647145474
STAT,1941,29,45-49,1970,1.821471849908017
STAT,1899,43,20-24,1942,0.015294913772006627
STAT,1865,36,35-39,1901,6.580357916879159
STAT,1889,39,na,1928,2938.9892681715723
STAT,1838,46,15-19,1884,3.062623535235003E-4
STAT,1841,19,na,1860,2160.232032446322
STAT,1928,36,20-24,1964,0.3401258686179979
SIM,1873,36,35-39,1909,16
SIM,1918,19,15-19,1937,1
SIM,1847,32,45-49,1879,2
STAT,1827,34,50-100,1861,1.2829958078969097
SIM,1873,64,na,1937,1770
SIM,1881,46,35-39,1927,1
SIM,1834,24,50-100,1858,1
SIM,1835,34,50-100,1869,5
SIM,1823,42,30-34,1865,1
STAT,1851,9,na,1860,2443.8014479989065
STAT,1847,42,45-49,1889,1.1736086598218565
STAT,1853,21,40-44,1874,2.079404342451121
STAT,1931,23,na,1954,4815.430488940382
STAT,1824,53,35-39,1877,0.009489389799231895
STAT,1818,110,na,1928,1.4082653161639574E-4
STAT,1832,45,35-39,1877,0.11403406456031366
STAT,1843,54,na,1897,1690.3949728696737
STAT,1889,36,20-24,1925,0.9760556210057991
STAT,1882,33,30-34,1915,17.279579674212897
SIM,1944,27,15-19,1971,1
STAT,1933,19,45-49,1952,0.6783039812225907
SIM,1873,35,20-24,1908,3
SIM,1893,32,40-44,1925,11
STAT,1866,33,15-19,1899,0.13343588917918428
STAT,1868,35,45-49,1903,1.9608354565501787
STAT,1854,53,45-49,1907,0.01092880599998026
SIM,1896,21,na,1917,3209
STAT,1857,43,20-24,1900,0.12561532297712683
STAT,1894,54,na,1948,2747.80381093891
STAT,1865,35,20-24,1900,0.7205095574230891
SIM,1866,25,35-39,1891,11
SIM,1892,31,na,1923,3486
SIM,1937,17,na,1954,4252
SIM,1826,41,40-44,1867,2
SIM,1888,33,45-49,1921,5
STAT,1871,50,40-44,1921,0.01079132810483449
STAT,1828,45,15-19,1873,3.211750219999132E-4
STAT,1850,17,50-100,1867,0.04503246826038359
STAT,1935,31,35-39,1966,12.900697763503892
STAT,1950,16,40-44,1966,1.6877232496526111
SIM,1906,20,25-29,1926,129
SIM,1839,23,20-24,1862,66
STAT,1807,50,25-29,1857,0.015241475007224933
SIM,1856,92,na,1948,17
SIM,1905,15,na,1920,3715
STAT,1852,24,25-29,1876,54.0011378245707
SIM,1834,77,na,1911,581
SIM,1868,18,na,1886,2550
SIM,1860,24,25-29,1884,60
SIM,1927,30,na,1957,4622
STAT,1942,24,35-39,1966,10.065512561644335
SIM,1929,26,50-100,1955,4
SIM,1815,79,na,1894,234
STAT,1914,51,na,1965,3670.082697251107
STAT,1895,36,15-19,1931,0.07510207533412
SIM,1876,35,45-49,1911,4
SIM,1840,45,35-39,1885,1
STAT,1844,18,40-44,1862,0.1791066028827989
STAT,1900,49,50-100,1949,0.1917970047114882
STAT,1952,7,na,1959,4805.052598507914
SIM,1834,32,35-39,1866,16
SIM,1897,36,20-24,1933,1
STAT,1857,45,40-44,1902,0.13775810637816077
STAT,1828,42,40-44,1870,1.8391191924753436
STAT,1830,75,na,1905,651.2296230234963
STAT,1874,41,25-29,1915,0.6718726411097702
SIM,1885,4,na,1889,2680
SIM,1944,22,50-100,1966,1
STAT,1845,80,na,1925,483.33832071093633
SIM,1858,32,20-24,1890,5
STAT,1871,47,15-19,1918,4.02325066457433E-4
SIM,1906,36,40-44,1942,2
STAT,1790,73,na,1863,521.0340756775888
STAT,1835,59,na,1894,1448.008833413494
STAT,1891,44,35-39,1935,2.256183135306179
STAT,1893,23,35-39,1916,7.528630320980285
SIM,1809,70,na,1879,465
STAT,1897,46,20-24,1943,0.009259377794882392
STAT,1893,39,15-19,1932,0.07194081389645712
STAT,1830,38,50-100,1868,1.0935183045792665
SIM,1861,4,na,1865,3121
SIM,1910,30,na,1940,3701
STAT,1894,48,50-100,1942,0.17950896800148664
SIM,1840,18,na,1858,2086
STAT,1856,50,45-49,1906,0.011788599119609682
SIM,1836,42,40-44,1878,6
STAT,1834,42,35-39,1876,1.4690740828290663
STAT,1847,24,15-19,1871,3.108657832700066
STAT,1935,13,na,1948,5515.360806503335
STAT,1826,48,15-19,1874,3.0845289684025524E-4
STAT,1936,27,15-19,1963,0.6890828555005752
SIM,1858,34,40-44,1892,9
STAT,1936,22,50-100,1958,0.6416207828275681
SIM,1862,100,na,1962,8
STAT,1826,32,35-39,1858,11.039956742462826
STAT,1841,50,30-34,1891,0.004458239949584585
STAT,1887,72,na,1959,1572.7144433354051
SIM,1925,9,na,1934,5045
SIM,1927,30,40-44,1957,5
STAT,1886,40,50-100,1926,1.1522803085948985
STAT,1931,4,na,1935,5387.885562996971
SIM,1906,7,na,1913,3887
STAT,1849,53,35-39,1902,0.006576419313457853
STAT,1850,43,35-39,1893,1.3522633461129043
SIM,1814,57,na,1871,1114
STAT,1855,79,na,1934,541.9451868292948
STAT,1910,44,40-44,1954,0.2381346351478685
SIM,1873,22,45-49,1895,2
STAT,1905,15,20-24,1920,26.241593758677187
STAT,1830,46,15-19,1876,3.3630118322119484E-4
STAT,1897,49,30-34,1946,0.07292574323798005
SIM,1908,33,40-44,1941,5
STAT,1860,26,na,1886,2010.9633739542978
STAT,1774,106,na,1880,0.00912025343187515
STAT,1841,19,30-34,1860,1.4999844815954368
SIM,1862,9,na,1871,2538
STAT,1891,26,35-39,1917,12.22839785238439
SIM,1822,41,50-100,1863,1
STAT,1833,95,na,1928,8.731122903681433
STAT,1842,52,40-44,1894,0.008211881200420696
STAT,1816,44,40-44,1860,4.849536559847763
SIM,1885,38,20-24,1923,5
SIM,1889,35,50-100,1924,5
STAT,1877,82,na,1959,631.3558653905452
STAT,1878,67,na,1945,1683.2813556542012
STAT,1901,41,35-39,1942,0.18019920049936328
STAT,1854,32,40-44,1886,3.3989854087684828
SIM,1895,26,15-19,1921,4
SIM,1839,21,na,1860,2051
SIM,1880,46,na,1926,2172
STAT,1920,48,15-19,1968,4.1439181825743507E-4
SIM,1832,35,35-39,1867,12
SIM,1862,0,na,1862,3321
STAT,1849,21,15-19,1870,3.119000937092275
STAT,1824,35,35-39,1859,10.563942969101527
STAT,1900,21,25-29,1921,81.1867898821982
STAT,1855,70,na,1925,1087.6607075454988
STAT,1887,26,15-19,1913,0.5204223659293848
STAT,1853,51,35-39,1904,0.007253223485354264
SIM,1857,74,na,1931,740
STAT,1906,46,40-44,1952,0.143800243032314
STAT,1887,41,35-39,1928,2.0793679586371807
STAT,1865,22,45-49,1887,0.6535004639704522
STAT,1845,35,50-100,1880,1.1308475036452355
STAT,1883,35,40-44,1918,4.423342826032916
STAT,1916,43,50-100,1959,0.12266219327651527
STAT,1880,25,15-19,1905,0.4896823370252843
SIM,1869,24,45-49,1893,1
STAT,1855,46,20-24,1901,0.009328790872201374
SIM,1843,82,na,1925,262
SIM,1857,21,15-19,1878,1
STAT,1851,80,na,1931,510.35269121047975
STAT,1916,34,35-39,1950,9.545513504412524
SIM,1883,25,40-44,1908,4
STAT,1851,22,15-19,1873,3.250302945741796
SIM,1840,77,na,1917,495
STAT,1880,25,45-49,1905,1.198353061614487
SIM,1919,39,25-29,1958,2
STAT,1860,19,35-39,1879,0.5176563394388286
STAT,1848,35,20-24,1883,0.6304518033491101
STAT,1938,26,35-39,1964,15.179696391980865
STAT,1796,98,na,1894,0.7066954215367086
SIM,1824,44,40-44,1868,2
SIM,1877,46,45-49,1923,1
SIM,1900,30,30-34,1930,32
STAT,1852,38,15-19,1890,0.045013825467778316
STAT,1820,42,40-44,1862,4.472607793710775
STAT,1929,13,na,1942,5149.522100848927
STAT,1815,42,30-34,1857,3.631979611470946
SIM,1952,19,20-24,1971,248
STAT,1917,36,45-49,1953,0.7260668545625284
STAT,1849,70,na,1919,1089.291445588704
STAT,1864,16,na,1880,2380.9947144852586
STAT,1799,63,na,1862,853.6003829681728
STAT,1817,41,20-24,1858,0.4156982445594333
SIM,1831,40,50-100,1871,3
STAT,1851,40,15-19,1891,0.011508312454548102
SIM,1884,22,20-24,1906,103
SIM,1869,54,45-49,1923,1
SIM,1856,35,20-24,1891,1
SIM,1909,17,20-24,1926,36
SIM,1926,45,na,1971,4884
SIM,1898,34,50-100,1932,1
STAT,1833,45,25-29,1878,0.04578961438242742
STAT,1877,38,20-24,1915,0.811578891076448
STAT,1884,15,35-39,1899,0.5563756456758419
SIM,1924,34,35-39,1958,14
STAT,1839,32,45-49,1871,1.4810331672745318
STAT,1944,19,20-24,1963,148.75602099736415
STAT,1859,25,25-29,1884,35.56739046627445
STAT,1918,47,15-19,1965,4.0003079999632E-4
STAT,1921,16,15-19,1937,52.9178535177668
STAT,1930,8,na,1938,5259.073255179651
STAT,1841,37,30-34,1878,4.636330813376618
SIM,1863,74,na,1937,807
STAT,1883,82,na,1965,749.0743633845522
SIM,1934,12,na,1946,5639
STAT,1842,60,na,1902,1495.6190843478755
STAT,1885,19,40-44,1904,0.18515654386729252
SIM,1908,51,na,1959,3548
SIM,1843,21,20-24,1864,71
STAT,1834,107,na,1941,0.0031692036504628136
STAT,1842,34,40-44,1876,4.023899006274504
STAT,1814,45,20-24,1859,0.036957753542185945
STAT,1836,19,20-24,1855,16.898616125560455
STAT,1847,44,na,1891,1778.0067069386773
STAT,1940,27,35-39,1967,15.618524229593753
SIM,1826,28,40-44,1854,4
STAT,1895,39,na,1934,3104.2706524319788
STAT,1858,16,na,1874,2182.11090860518
STAT,1881,36,20-24,1917,0.7639300637956824
SIM,1827,36,na,1863,1663
STAT,1787,78,na,1865,359.8339297140384
STAT,1913,25,20-24,1938,18.680955363199033
SIM,1891,35,40-44,1926,7
STAT,1823,40,50-100,1863,1.7951946085706338
STAT,1904,47,20-24,1951,0.009850583995575314
STAT,1918,29,20-24,1947,19.68232649822249
SIM,1854,40,35-39,1894,4
STAT,1875,43,35-39,1918,1.882245465041682
SIM,1883,43,35-39,1926,3
SIM,1925,18,45-49,1943,2
STAT,1867,0,na,1867,3620.443537124202
STAT,1924,44,40-44,1968,0.30253001157330256
SIM,1844,19,20-24,1863,12
STAT,1874,46,25-29,1920,0.06016429623956833
SIM,1850,34,40-44,1884,5
STAT,1861,43,40-44,1904,1.8823713258068144
STAT,1837,20,40-44,1857,1.9214925087101518
SIM,1819,69,na,1888,809
SIM,1862,32,40-44,1894,7
STAT,1875,25,40-44,1900,3.1576656028472607
STAT,1830,107,na,1937,0.0029832753049466405
STAT,1818,47,na,1865,1428.6101760894528
SIM,1867,25,25-29,1892,2
STAT,1827,34,45-49,1861,2.441830746231984
SIM,1803,54,na,1857,994
SIM,1797,80,na,1877,165
STAT,1835,21,20-24,1856,68.77295586266042
STAT,1945,20,40-44,1965,3.7623644812375
STAT,1913,38,na,1951,3768.832973064685
SIM,1895,76,na,1971,1709
STAT,1879,50,40-44,1929,0.011387537077428147
STAT,1894,25,45-49,1919,1.4668444707693802
SIM,1919,20,35-39,1939,16
STAT,1808,52,35-39,1860,0.02054523687881486
SIM,1821,34,45-49,1855,2
STAT,1863,29,30-34,1892,22.363010402433044
STAT,1917,18,45-49,1935,0.10941254198826612
STAT,1849,50,30-34,1899,0.004687734907647777
STAT,1835,19,na,1854,2253.747189183737
STAT,1843,31,20-24,1874,2.6506925201300784
SIM,1879,40,40-44,1919,5
STAT,1872,33,45-49,1905,1.775411529040482
STAT,1884,36,na,1920,2389.29150061349
STAT,1880,43,45-49,1923,1.5928524553644747
SIM,1932,26,40-44,1958,12
SIM,1882,28,25-29,1910,45
STAT,1821,106,na,1927,0.006397932960319931
SIM,1892,71,na,1963,2217
STAT,1874,28,25-29,1902,43.90445671816212
STAT,1902,66,na,1968,2667.665458896906
STAT,1932,36,40-44,1968,2.0530911492829387
SIM,1813,42,45-49,1855,4
SIM,1948,20,30-34,1968,39
STAT,1869,46,15-19,1915,3.950815753872331E-4
SIM,1803,85,na,1888,16
SIM,1880,33,45-49,1913,4
STAT,1813,52,45-49,1865,0.03483025626244429
SIM,1845,21,na,1866,2095
SIM,1851,31,20-24,1882,2
SIM,1879,89,na,1968,452
SIM,1940,12,na,1952,4125
STAT,1924,26,40-44,1950,5.555924145944438
SIM,1844,37,20-24,1881,1
SIM,1835,34,45-49,1869,1
STAT,1850,25,35-39,1875,8.66516577129662
SIM,1913,29,40-44,1942,6
SIM,1904,28,25-29,1932,65
STAT,1816,40,25-29,1856,1.6408349924949075
STAT,1873,32,45-49,1905,1.8035473745867772
SIM,1845,39,30-34,1884,9
SIM,1849,27,30-34,1876,30
SIM,1807,75,na,1882,340
STAT,1923,15,35-39,1938,5.050685203524994
STAT,1857,16,25-29,1873,5.3378739142146605
SIM,1863,30,35-39,1893,13
STAT,1827,55,na,1882,1423.9730325214905
SIM,1953,17,15-19,1970,52
STAT,1888,37,15-19,1925,0.06772353591748032
STAT,1860,44,35-39,1904,1.4786049036487443
SIM,1886,33,40-44,1919,7
SIM,1790,70,na,1860,480
SIM,1819,42,40-44,1861,4
STAT,1773,107,na,1880,0.00798147087933586
SIM,1925,35,na,1960,4774
STAT,1831,60,na,1891,1285.0980745411825
STAT,1856,44,15-19,1900,0.010909684684973983
STAT,1884,49,15-19,1933,3.952834922991846E-4
STAT,1840,35,20-24,1875,0.669843384439405
SIM,1842,24,40-44,1866,4
STAT,1885,49,50-100,1934,0.24474736228992786
STAT,1945,15,na,1960,4104.422857788217
SIM,1926,45,50-100,1971,1
STAT,1900,28,45-49,1928,1.564386717205521
STAT,1878,33,40-44,1911,4.585558050247323
SIM,1880,16,20-24,1896,23
SIM,1921,25,20-24,1946,24
SIM,1794,60,na,1854,1045
STAT,1831,100,na,1931,0.7153589221957497
STAT,1911,46,20-24,1957,0.010698254453033827
STAT,1868,19,50-100,1887,0.04802956238080766
STAT,1858,42,20-24,1900,0.12832277973644385
STAT,1956,9,na,1965,5303.265842475999
SIM,1864,84,na,1948,400
STAT,1823,38,25-29,1861,5.193682491358878
SIM,1886,30,50-100,1916,1
SIM,1836,41,na,1877,1893
STAT,1922,43,na,1965,4342.752964633678
STAT,1947,15,20-24,1962,155.899519459401
SIM,1873,36,na,1909,2357
SIM,1831,38,25-29,1869,8
STAT,1836,33,50-100,1869,0.713475806977961
SIM,1873,38,25-29,1911,6
STAT,1919,27,15-19,1946,0.7783903783592934
STAT,1910,1,na,1911,4206.551454518916
SIM,1815,70,na,1885,705
SIM,1931,15,35-39,1946,12
SIM,1881,32,45-49,1913,2
STAT,1837,50,40-44,1887,0.007329327968721345
STAT,1805,100,na,1905,0.4267036815402136
SIM,1923,32,25-29,1955,4
STAT,1825,52,35-39,1877,0.01067583300957494
STAT,1870,22,50-100,1892,0.4066741632663979
SIM,1824,40,25-29,1864,2
STAT,1945,17,15-19,1962,50.58021648917912
STAT,1883,31,25-29,1914,10.294391086817855
SIM,1892,32,20-24,1924,6
SIM,1858,39,40-44,1897,4
SIM,1866,42,20-24,1908,1
SIM,1840,27,40-44,1867,3
SIM,1899,41,na,1940,3253
SIM,1909,29,20-24,1938,18
STAT,1812,48,20-24,1860,0.02791787418388248
STAT,1874,45,40-44,1919,0.18009311706620498
STAT,1881,24,20-24,1905,67.54135132480019
STAT,1943,17,50-100,1960,0.4053407236340204
STAT,1876,32,na,1908,2513.810181329807
STAT,1933,5,na,1938,5489.061308946772
STAT,1950,3,na,1953,4784.510363070136
STAT,1909,23,40-44,1932,3.177252320618161
STAT,1893,0,na,1893,3800.0494974116746
STAT,1884,18,45-49,1902,0.06575613486835914
STAT,1931,23,15-19,1954,7.019398554127408
SIM,1824,56,na,1880,1202
SIM,1826,44,45-49,1870,7
SIM,1814,41,45-49,1855,2
SIM,1877,28,20-24,1905,12
SIM,1888,19,30-34,1907,4
STAT,1931,37,40-44,1968,2.021935304360199
SIM,1903,1,na,1904,3856
STAT,1884,32,20-24,1916,2.72815019339628
STAT,1915,32,25-29,1947,9.605720358405359
STAT,1924,44,35-39,1968,0.24355639451563077
STAT,1834,24,40-44,1858,1.84863321169494
STAT,1856,43,30-34,1899,0.9140077144044851
SIM,1891,31,25-29,1922,17
SIM,1885,21,na,1906,2339
SIM,1875,17,30-34,1892,2
SIM,1881,68,na,1949,1462
STAT,1802,60,na,1862,886.7316485914471
STAT,1847,42,15-19,1889,0.010829146410320246
SIM,1847,18,30-34,1865,1
SIM,1873,33,na,1906,2368
STAT,1923,27,35-39,1950,17.58722285497069
STAT,1844,39,na,1883,1889.582880146333
STAT,1886,31,na,1917,2587.2978523358684
SIM,1926,2,na,1928,5390
STAT,1878,51,40-44,1929,0.011232389638170468
STAT,1892,43,35-39,1935,2.2985127240852745
SIM,1949,16,40-44,1965,1
STAT,1896,47,20-24,1943,0.00907771594999203
STAT,1911,28,20-24,1939,18.094240380652742
SIM,1898,36,40-44,1934,18
STAT,1870,25,50-100,1895,0.6422693607251446
SIM,1931,27,35-39,1958,2
SIM,1825,41,20-24,1866,2
STAT,1807,54,40-44,1861,0.041767380042109184
SIM,1884,23,35-39,1907,7
STAT,1867,9,na,1876,2621.2923883688172
SIM,1917,23,40-44,1940,4
SIM,1858,37,45-49,1895,3
STAT,1860,50,35-39,1910,0.007228242352333398
SIM,1833,92,na,1925,23
STAT,1872,16,20-24,1888,18.293548975679357
STAT,1891,41,30-34,1932,1.4585986936901356
STAT,1824,50,30-34,1874,0.006963798466798791
STAT,1931,37,50-100,1968,0.5670850584891537
STAT,1783,88,na,1871,47.51974451371071
STAT,1827,52,na,1879,1511.0776102187958
SIM,1826,35,50-100,1861,1
STAT,1832,27,40-44,1859,2.7284428735808386
STAT,1851,42,35-39,1893,1.4921135410483353
STAT,1889,23,45-49,1912,0.8760100761791575
SIM,1819,60,na,1879,1101
SIM,1820,34,50-100,1854,1
STAT,1878,18,15-19,1896,6.2851590066297325
STAT,1914,22,30-34,1936,29.959313558655584
SIM,1950,21,30-34,1971,54
STAT,1839,18,30-34,1857,1.4304853100907358
SIM,1949,22,40-44,1971,10
STAT,1840,17,20-24,1857,16.517378449006877
STAT,1837,39,30-34,1876,4.2374510628291
SIM,1900,33,35-39,1933,23
STAT,1798,103,na,1901,0.04940192563425294
STAT,1882,34,15-19,1916,0.14032391497445015
STAT,1855,30,35-39,1885,8.16115096907723
STAT,1897,49,25-29,1946,0.043393830268839036
STAT,1922,18,25-29,1940,51.03935618522646
STAT,1850,43,50-100,1893,0.78892770750163
STAT,1847,36,15-19,1883,0.045908366926342904
STAT,1905,15,15-19,1920,8.784262328881043
SIM,1929,25,20-24,1954,6
STAT,1884,50,20-24,1934,7.554718530579861E-4
STAT,1848,51,25-29,1899,0.0027664975103037464
SIM,1951,9,na,1960,5316
STAT,1876,44,50-100,1920,1.097875434907731
SIM,1805,89,na,1894,5
SIM,1897,23,45-49,1920,1
SIM,1896,39,40-44,1935,4
STAT,1903,36,15-19,1939,0.017661272987704597
SIM,1930,18,25-29,1948,84
STAT,1890,29,25-29,1919,52.38700643319406
STAT,1815,43,15-19,1858,0.04128804728633155
STAT,1843,17,45-49,1860,0.06738926740165746
STAT,1820,104,na,1924,0.03673534887121947
SIM,1918,50,na,1968,4081
STAT,1763,104,na,1867,0.011174268489925051
SIM,1967,0,na,1967,5245
STAT,1918,13,na,1931,4394.191018690152
SIM,1878,27,20-24,1905,16
STAT,1840,23,20-24,1863,62.610030345076744
STAT,1839,40,na,1879,1724.1556355004861
STAT,1838,52,45-49,1890,0.010606262693285975
STAT,1894,24,50-100,1918,0.5317601190025365
SIM,1886,21,40-44,1907,3
STAT,1942,21,30-34,1963,30.755132767555704
STAT,1859,45,45-49,1904,0.19418960791251472
STAT,1861,16,45-49,1877,0.06366560661524062
SIM,1872,28,50-100,1900,2
STAT,1887,27,20-24,1914,13.410613661082207
STAT,1936,33,45-49,1969,1.5579477221541078
STAT,1941,22,25-29,1963,97.38550979658388
SIM,1831,97,na,1928,1
STAT,1899,38,na,1937,3300.7456219386336
STAT,1842,49,45-49,1891,0.1812081188885178
SIM,1860,24,50-100,1884,3
SIM,1854,69,na,1923,1241
SIM,1900,1,na,1901,3860
STAT,1815,67,na,1882,956.2329372771069
STAT,1916,31,30-34,1947,16.667033772968338
SIM,1932,17,na,1949,5075
STAT,1873,48,30-34,1921,0.09885740672867892
SIM,1935,21,35-39,1956,18
STAT,1838,39,na,1877,1859.876763588248
STAT,1910,4,na,1914,4065.6378372035247
SIM,1875,68,na,1943,1506
STAT,1906,45,35-39,1951,0.1184297711407416
SIM,1898,18,40-44,1916,1
STAT,1872,30,40-44,1902,4.469628562471284
SIM,1890,16,15-19,1906,9
SIM,1897,71,na,1968,2054
STAT,1859,69,na,1928,1195.6295554699448
SIM,1876,29,15-19,1905,1
STAT,1871,17,20-24,1888,18.030820076633866
SIM,1879,21,na,1900,2782
SIM,1918,22,40-44,1940,6
STAT,1915,20,25-29,1935,94.0550411120021
STAT,1945,21,50-100,1966,0.7360098441589042
STAT,1846,44,20-24,1890,0.1120376650399567
STAT,1841,32,30-34,1873,15.641151239157034
STAT,1833,47,45-49,1880,0.18286047820831094
SIM,1923,39,45-49,1962,3
STAT,1853,49,20-24,1902,0.009851898057769927
STAT,1888,43,45-49,1931,1.791939529333641
SIM,1889,29,25-29,1918,7
SIM,1890,36,na,1926,3091
STAT,1828,77,na,1905,475.99200407400576
STAT,1898,42,25-29,1940,0.0614422311552444
SIM,1905,37,35-39,1942,3
SIM,1840,25,15-19,1865,1
SIM,1839,26,25-29,1865,42
STAT,1869,87,na,1956,192.45081089077235
SIM,1895,27,20-24,1922,26
STAT,1836,36,50-100,1872,0.9478596791983822
STAT,1789,73,na,1862,394.6923159319742
STAT,1927,21,35-39,1948,11.869548122971219
SIM,1914,45,35-39,1959,1
SIM,1858,20,20-24,1878,62
SIM,1866,54,na,1920,2209
STAT,1931,19,40-44,1950,1.8571227177302254
STAT,1832,31,45-49,1863,1.5464460079896538
STAT,1861,18,40-44,1879,0.17616997933626521
STAT,1832,31,15-19,1863,0.12628912496371814
SIM,1822,52,na,1874,1282
STAT,1832,43,15-19,1875,0.011200819996388504
STAT,1925,42,50-100,1967,0.14511160271848875
SIM,1860,22,35-39,1882,2
SIM,1887,53,na,1940,2490
STAT,1856,15,50-100,1871,0.04694164868776197
STAT,1877,41,50-100,1918,1.1228747704588609
STAT,1896,29,20-24,1925,15.693439957129453
STAT,1873,50,45-49,1923,0.015225150388977132
SIM,1850,49,45-49,1899,1
STAT,1909,61,na,1970,3171.572650606022
STAT,1850,40,30-34,1890,0.8735120016432426
SIM,1871,25,45-49,1896,2
STAT,1829,44,20-24,1873,0.12969886973128547
STAT,1837,54,na,1891,1396.0967316627925
STAT,1866,50,30-34,1916,0.005681662778614774
STAT,1879,53,45-49,1932,0.015226911385344622
SIM,1866,2,na,1868,3060
STAT,1843,85,na,1928,221.30132692112767
STAT,1811,49,15-19,1860,0.0010728837142004411
STAT,1784,100,na,1884,0.18717478299522913
SIM,1923,20,25-29,1943,8
STAT,1829,38,20-24,1867,0.6650157248630709
STAT,1868,46,na,1914,2198.3953752332513
SIM,1905,25,35-39,1930,21
STAT,1796,58,na,1854,1000.9999999999998
STAT,1861,23,50-100,1884,0.35061660474002254
STAT,1863,25,45-49,1888,1.0075287119648988
SIM,1857,35,40-44,1892,4
STAT,1896,35,20-24,1931,1.0484696716092314
SIM,1902,66,na,1968,2574
STAT,1910,47,15-19,1957,3.505349199492203E-4
STAT,1906,49,45-49,1955,0.19354093180852422
STAT,1951,15,na,1966,4473.759086034297
SIM,1853,44,na,1897,1909
SIM,1863,34,20-24,1897,2
SIM,1845,35,45-49,1880,3
SIM,1820,48,20-24,1868,1
SIM,1933,19,50-100,1952,1
STAT,1852,22,35-39,1874,5.584653935239909
SIM,1854,26,20-24,1880,15
SIM,1840,31,45-49,1871,3
SIM,1867,22,20-24,1889,91
STAT,1891,49,na,1940,2782.732272108232
STAT,1832,25,15-19,1857,0.42627592134649217
STAT,1900,43,40-44,1943,0.2192555526670773
STAT,1916,19,45-49,1935,0.10757571394360808
STAT,1849,35,40-44,1884,3.550560888059962
SIM,1944,15,45-49,1959,1
STAT,1821,67,na,1888,833.1788075836499
SIM,1940,20,25-29,1960,153
SIM,1837,26,20-24,1863,12
STAT,1837,30,50-100,1867,0.7820095234352243
SIM,1901,25,na,1926,3699
STAT,1835,106,na,1941,0.009046358893109006
SIM,1848,28,25-29,1876,46
SIM,1880,30,40-44,1910,10
STAT,1885,25,50-100,1910,0.6554823892048577
STAT,1859,22,20-24,1881,58.25134477683226
STAT,1809,109,na,1918,3.6298046738424513E-4
STAT,1892,40,30-34,1932,1.4847540282664393
SIM,1849,25,35-39,1874,16
SIM,1909,31,35-39,1940,15
STAT,1888,25,15-19,1913,0.5508866396111379
STAT,1896,17,20-24,1913,23.886597899066565
SIM,1841,47,45-49,1888,1
SIM,1835,37,50-100,1872,3
STAT,1905,47,40-44,1952,0.14161911407317068
STAT,1898,17,25-29,1915,7.817548960687594
SIM,1891,9,na,1900,3352
STAT,1801,54,50-100,1855,0.04086727412609475
SIM,1924,19,45-49,1943,1
SIM,1937,33,30-34,1970,27
STAT,1841,33,15-19,1874,0.12625695284867178
STAT,1897,44,30-34,1941,0.10742837585295646
STAT,1841,44,50-100,1885,0.7900476909004073
SIM,1837,26,na,1863,1730
STAT,1842,30,25-29,1872,9.906832345514944
SIM,1848,69,na,1917,1065
STAT,1837,35,45-49,1872,1.6522037820604658
SIM,1928,26,15-19,1954,1
STAT,1864,39,25-29,1903,2.5853835472714812
STAT,1932,39,45-49,1971,0.9321251187004465
STAT,1855,34,20-24,1889,2.0897044980512405
STAT,1905,29,40-44,1934,4.381953687765064
STAT,1808,88,na,1896,45.70303211704872
STAT,1846,26,20-24,1872,10.222517313298491
SIM,1924,31,30-34,1955,29
STAT,1852,22,na,1874,2046.2247443240421
SIM,1842,41,na,1883,1775
STAT,1817,93,na,1910,14.262942886313882
STAT,1929,33,30-34,1962,20.39895058843784
STAT,1907,17,45-49,1924,0.09784572831909137
SIM,1838,36,na,1874,1720
STAT,1945,24,50-100,1969,0.7352667243579971
STAT,1915,39,45-49,1954,0.695682252076718
SIM,1863,28,20-24,1891,1
SIM,1885,40,35-39,1925,5
STAT,1857,43,15-19,1900,0.010923072153193
SIM,1850,30,25-29,1880,13
SIM,1943,28,50-100,1971,2
SIM,1813,75,na,1888,504
STAT,1823,41,45-49,1864,2.4819426820202843
STAT,1885,22,50-100,1907,0.4150404308011528
SIM,1848,16,25-29,1864,5
STAT,1876,22,20-24,1898,72.59444601401121
STAT,1873,28,40-44,1901,3.087255188195831
STAT,1795,73,na,1868,445.62881910491643
STAT,1936,15,45-49,1951,0.49006219504881265
SIM,1829,62,na,1891,964
SIM,1949,20,15-19,1969,9
STAT,1877,40,35-39,1917,1.935329742018648
SIM,1782,75,na,1857,405
SIM,1849,43,35-39,1892,5
SIM,1881,28,40-44,1909,3
STAT,1821,33,50-100,1854,2.887429620114715
STAT,1888,43,15-19,1931,0.01653462196209415
SIM,1915,39,50-100,1954,1
STAT,1806,93,na,1899,10.38477477447135
STAT,1874,46,na,1920,2350.001528155795
STAT,1898,48,30-34,1946,0.07438156197783657
SIM,1830,28,30-34,1858,30
SIM,1915,17,45-49,1932,1
STAT,1873,21,na,1894,2453.435374292032
SIM,1897,46,na,1943,3012
STAT,1928,8,na,1936,5126.111316736519
STAT,1932,20,25-29,1952,124.33648312192449
SIM,1861,48,na,1909,2388
SIM,1865,69,na,1934,1264
SIM,1880,19,25-29,1899,8
SIM,1869,28,na,1897,2438
SIM,1825,29,35-39,1854,11
STAT,1905,46,na,1951,3324.82003477111
STAT,1840,38,25-29,1878,2.4251949065205887
STAT,1904,21,na,1925,3468.2963243363756
SIM,1891,21,na,1912,3035
SIM,1874,18,25-29,1892,6
STAT,1834,27,45-49,1861,0.9797685553414252
STAT,1827,28,15-19,1855,1.0398003756424625
STAT,1844,95,na,1939,10.302864041833637
STAT,1883,33,15-19,1916,0.1419436189048056
STAT,1819,37,20-24,1856,2.185195379264957
STAT,1890,33,50-100,1923,1.1380439531739233
SIM,1906,25,na,1931,3519
STAT,1876,29,40-44,1905,3.1330612636223356
STAT,1874,48,45-49,1922,0.2427200038648792
STAT,1817,46,50-100,1863,0.5573329970870383
STAT,1890,26,20-24,1916,14.683288468199393
STAT,1878,36,45-49,1914,2.126994547752962
STAT,1869,31,40-44,1900,4.288723752257566
SIM,1901,22,na,1923,3472
STAT,1912,23,50-100,1935,0.6412986845332068
STAT,1934,18,50-100,1952,0.515439549583731
STAT,1837,17,15-19,1854,7.231365505418415
STAT,1863,25,15-19,1888,0.4117058904412964
SIM,1944,15,15-19,1959,39
STAT,1775,96,na,1871,1.4137494150899828
STAT,1762,111,na,1873,0.0011546784140777054
SIM,1885,22,35-39,1907,5
SIM,1899,34,35-39,1933,5
STAT,1936,15,15-19,1951,44.52215942950455
STAT,1868,47,45-49,1915,0.22887865266729335
STAT,1855,28,20-24,1883,9.411127123180973
STAT,1834,54,35-39,1888,0.005709710498117423
STAT,1897,34,na,1931,3227.1474408040963
STAT,1829,26,20-24,1855,22.744432822274636
SIM,1900,44,50-100,1944,1
SIM,1871,29,30-34,1900,33
SIM,1817,38,40-44,1855,8
STAT,1940,15,35-39,1955,4.348746115379808
SIM,1855,70,na,1925,1111
SIM,1877,31,40-44,1908,9
SIM,1853,27,20-24,1880,18
STAT,1856,80,na,1936,495.3740744918742
SIM,1846,34,15-19,1880,1
STAT,1823,37,40-44,1860,8.201847337370246
STAT,1850,22,30-34,1872,16.081565315890117
STAT,1866,18,25-29,1884,5.440856790625984
SIM,1842,41,20-24,1883,3
SIM,1939,17,30-34,1956,11
STAT,1838,40,50-100,1878,0.9313433513075348
SIM,1851,18,na,1869,2224
STAT,1816,42,15-19,1858,0.03276286722902437
STAT,1844,16,45-49,1860,0.06472686529390463
STAT,1890,28,40-44,1918,3.7233248703102326
STAT,1832,47,30-34,1879,0.07684903349722683
SIM,1787,81,na,1868,178
STAT,1894,19,15-19,1913,7.745663229628057
STAT,1820,107,na,1927,0.0025973328372104094
SIM,1919,35,na,1954,4206
STAT,1845,40,na,1885,1886.690592316766
STAT,1940,31,na,1971,3995.5365062333763
SIM,1840,47,30-34,1887,1
SIM,1843,28,40-44,1871,6
STAT,1823,35,20-24,1858,1.5342286459716683
STAT,1804,67,na,1871,768.8521630005863
STAT,1862,21,na,1883,2117.665495153562
STAT,1876,72,na,1948,1330.3706021684477
STAT,1904,16,15-19,1920,8.698014036132598
STAT,1913,28,25-29,1941,66.67061111229636
STAT,1842,36,30-34,1878,4.954019751852483
STAT,1900,25,40-44,1925,4.26431234043926
SIM,1833,67,na,1900,1034
STAT,1837,53,45-49,1890,0.009520702991548242
SIM,1825,46,50-100,1871,1
STAT,1845,27,20-24,1872,11.15706350200354
STAT,1854,39,30-34,1893,4.037963473848854
STAT,1883,47,40-44,1930,0.17056636887881993
STAT,1921,22,45-49,1943,1.2968378558697382
SIM,1912,16,15-19,1928,11
SIM,1921,28,25-29,1949,10
SIM,1888,44,30-34,1932,5
SIM,1823,74,na,1897,621
STAT,1838,34,15-19,1872,0.12734661704276046
STAT,1946,16,15-19,1962,51.371194097650154
STAT,1873,32,15-19,1905,0.14728507726129364
STAT,1835,22,35-39,1857,5.781850140364789
SIM,1844,21,35-39,1865,9
SIM,1882,72,na,1954,1051
SIM,1842,44,na,1886,1713
STAT,1938,25,20-24,1963,18.463676551840596
SIM,1830,56,na,1886,1395
SIM,1864,28,na,1892,2179
SIM,1820,35,45-49,1855,3
STAT,1911,15,45-49,1926,0.10243937186023029
SIM,1850,36,30-34,1886,8
SIM,1945,12,na,1957,4698
STAT,1895,21,40-44,1916,2.7819460306500656
SIM,1922,23,15-19,1945,1
STAT,1800,110,na,1910,1.3318605307794014E-4
STAT,1867,15,35-39,1882,0.5436201445429405
STAT,1939,12,na,1951,4037.192797998421
STAT,1878,54,45-49,1932,0.014986400305498438
SIM,1845,17,15-19,1862,7
SIM,1846,40,50-100,1886,5
SIM,1889,9,na,1898,3373
SIM,1874,35,50-100,1909,3
SIM,1843,22,35-39,1865,11
STAT,1828,49,30-34,1877,0.07374041205995145
STAT,1842,32,15-19,1874,0.13490828489123577
STAT,1925,43,40-44,1968,0.3084667842117779
STAT,1866,35,50-100,1901,1.1662410661231175
SIM,1899,21,20-24,1920,105
STAT,1861,36,na,1897,1995.5727233910475
SIM,1836,30,40-44,1866,2
STAT,1897,31,na,1928,3268.3176376243987
SIM,1848,66,na,1914,1237
STAT,1914,23,15-19,1937,5.531637343442069
STAT,1845,18,na,1863,2253.5220902276815
STAT,1849,6,na,1855,2384.08839
STAT,1858,47,na,1905,1811.6528635098705
STAT,1926,29,50-100,1955,1.2085444412704542
SIM,1901,9,na,1910,3843
STAT,1788,109,na,1897,2.356008640694834E-4
STAT,1881,20,35-39,1901,5.789742135023181
STAT,1933,34,35-39,1967,12.543022511960201
STAT,1837,35,15-19,1872,0.04654095714219441
STAT,1836,21,35-39,1857,4.828627914060286
STAT,1850,27,25-29,1877,37.44499523211343
SIM,1954,16,15-19,1970,53
SIM,1906,32,25-29,1938,9
STAT,1901,20,30-34,1921,25.562246419880413
STAT,1870,24,45-49,1894,0.6910593877433497
STAT,1879,49,40-44,1928,0.17874826305971064
SIM,1918,25,45-49,1943,5
STAT,1851,18,na,1869,2288.927908227734
STAT,1914,25,35-39,1939,15.547031015172424
STAT,1879,47,20-24,1926,0.012736603679336886
STAT,1903,48,15-19,1951,3.2309383386074574E-4
SIM,1913,10,na,1923,4268
STAT,1869,90,na,1959,121.80641811253427
STAT,1872,19,25-29,1891,5.762760064337609
STAT,1858,27,30-34,1885,20.855083257591502
STAT,1875,42,20-24,1917,0.16607421989511997
STAT,1782,78,na,1860,285.39561951700443
SIM,1922,25,35-39,1947,29
STAT,1891,23,30-34,1914,22.427361524373623
STAT,1891,43,50-100,1934,1.3246578954616066
STAT,1881,18,20-24,1899,17.43943856038247
SIM,1886,36,45-49,1922,4
SIM,1866,27,30-34,1893,29
STAT,1944,21,35-39,1965,10.375838188857056
SIM,1819,45,45-49,1864,1
STAT,1812,93,na,1905,13.329883544605877
STAT,1808,51,20-24,1859,0.00179842898853751
SIM,1877,54,na,1931,2142
STAT,1923,45,35-39,1968,0.15461226968065317
STAT,1824,32,30-34,1856,34.987911638246246
SIM,1862,20,40-44,1882,3
STAT,1927,19,20-24,1946,171.03394905075194
SIM,1832,32,30-34,1864,28
SIM,1939,12,na,1951,3991
STAT,1866,53,35-39,1919,0.007970799877970475
SIM,1867,24,40-44,1891,2
STAT,1882,44,50-100,1926,1.0358102497851098
STAT,1922,15,20-24,1937,160.8414628202983
SIM,1890,44,50-100,1934,1
SIM,1868,38,20-24,1906,1
STAT,1846,47,25-29,1893,0.04099897869293014
STAT,1882,72,na,1954,1255.161980971621
SIM,1858,28,na,1886,1987
SIM,1886,18,15-19,1904,9
SIM,1883,34,50-100,1917,2
STAT,1841,35,35-39,1876,6.282024650835164
STAT,1864,24,15-19,1888,2.9971016196586744
SIM,1856,22,45-49,1878,1
STAT,1827,46,45-49,1873,0.26864853601852107
STAT,1822,42,45-49,1864,2.3303615137648417
STAT,1816,46,30-34,1862,0.20230879620316702
STAT,1956,15,na,1971,4970.02006927559
STAT,1927,0,na,1927,5714.0602061127465
STAT,1917,49,20-24,1966,0.011710468623970176
SIM,1857,38,45-49,1895,2
STAT,1850,45,25-29,1895,0.04375894945898608
STAT,1870,47,na,1917,2233.2221178339064
SIM,1817,74,na,1891,407
STAT,1898,44,15-19,1942,0.0013051096088171604
SIM,1852,34,45-49,1886,3
SIM,1903,32,45-49,1935,3
SIM,1794,63,na,1857,909
SIM,1946,25,20-24,1971,30
STAT,1912,28,na,1940,3752.715983177319
STAT,1864,87,na,1951,159.8104726370497
STAT,1842,46,40-44,1888,0.13600966460802474
STAT,1839,20,45-49,1859,0.6273289829359912
STAT,1883,37,30-34,1920,5.334723153762036
STAT,1901,35,35-39,1936,2.198539011327466
STAT,1843,48,15-19,1891,3.188515707192196E-4
SIM,1930,15,20-24,1945,291
STAT,1859,24,40-44,1883,1.7362285726555067
STAT,1924,13,na,1937,4806.500583551305
STAT,1919,19,50-100,1938,0.4202346346264727
SIM,1891,37,30-34,1928,11
STAT,1864,47,na,1911,2031.2764999418548
SIM,1923,36,40-44,1959,3
STAT,1824,37,25-29,1861,3.9820590159971374
SIM,1769,93,na,1862,10
STAT,1920,36,15-19,1956,0.02147594653617852
STAT,1818,44,45-49,1862,3.537382388493586
STAT,1828,30,40-44,1858,4.592707904073524
SIM,1905,22,30-34,1927,31
STAT,1844,34,45-49,1878,1.582725384575715
STAT,1873,26,15-19,1899,0.47085197622073705
STAT,1945,12,na,1957,4377.965255356772
SIM,1847,20,45-49,1867,2
SIM,1878,41,35-39,1919,3
SIM,1918,25,15-19,1943,1
STAT,1870,87,na,1957,214.3448132211833
SIM,1861,1,na,1862,3311
STAT,1933,27,na,1960,5072.7076913051205
SIM,1907,10,na,1917,3955
STAT,1906,42,30-34,1948,0.11839719000750751
SIM,1876,29,45-49,1905,1
SIM,1899,44,50-100,1943,1
STAT,1901,39,20-24,1940,0.2349667336811628
STAT,1860,31,20-24,1891,2.246503526388042
SIM,1888,35,na,1923,2762
SIM,1923,5,na,1928,4641
STAT,1936,30,40-44,1966,3.881252973213367
STAT,1870,51,35-39,1921,0.008626571914166955
STAT,1891,28,25-29,1919,53.23854569239922
STAT,1835,28,40-44,1863,2.8891456852422794
STAT,1888,40,40-44,1928,2.740043943232722
STAT,1837,32,40-44,1869,3.625283761749358
SIM,1945,4,na,1949,4732
SIM,1845,32,40-44,1877,8
SIM,1804,64,na,1868,1010
SIM,1828,39,25-29,1867,2
SIM,1881,45,50-100,1926,2
STAT,1860,17,45-49,1877,0.06235815905549736
STAT,1885,46,na,1931,2296.341512894235
SIM,1858,35,25-29,1893,2
STAT,1900,46,45-49,1946,0.1887645761130129
STAT,1838,48,40-44,1886,0.1277643325544352
SIM,1934,26,45-49,1960,1
STAT,1885,35,45-49,1920,2.04819747601286
STAT,1896,31,35-39,1927,13.700498324985219
STAT,1878,36,15-19,1914,0.05991534649872203
STAT,1901,43,50-100,1944,0.10390094855659938
STAT,1865,38,25-29,1903,2.6526341640021798
SIM,1871,69,na,1940,1351
SIM,1926,17,20-24,1943,166
STAT,1875,15,30-34,1890,1.6765517712938256
STAT,1893,13,na,1906,3336.964726330391
SIM,1870,84,na,1954,280
STAT,1764,103,na,1867,0.08368852545238228
STAT,1833,55,na,1888,1373.0386118352133
STAT,1891,46,25-29,1937,0.041152824043766655
STAT,1915,36,40-44,1951,1.5506093851213756
STAT,1897,47,35-39,1944,0.10721803531857822
SIM,1861,18,15-19,1879,7
STAT,1827,28,45-49,1855,2.5446046741005897
STAT,1853,18,15-19,1871,5.9506829133527335
SIM,1854,29,25-29,1883,47
STAT,1817,37,na,1854,1514.8996665049156
SIM,1845,18,na,1863,2205
STAT,1769,96,na,1865,0.7309413239197381
STAT,1894,19,45-49,1913,0.08525769578698628
STAT,1846,29,25-29,1875,36.07219914853951
STAT,1870,49,50-100,1919,0.23981381423199377
SIM,1824,49,50-100,1873,1
SIM,1893,35,45-49,1928,7
STAT,1864,36,20-24,1900,0.7025887912463012
STAT,1929,36,35-39,1965,3.170077359242023
STAT,1834,41,20-24,1875,0.1305028820156074
STAT,1809,106,na,1915,0.006194582586447736
SIM,1827,37,20-24,1864,1
SIM,1822,33,20-24,1855,1
SIM,1840,29,30-34,1869,2
STAT,1906,28,na,1934,3531.145333830006
STAT,1816,52,na,1868,1223.7696855994907
STAT,1863,22,40-44,1885,1.9010112505493606
SIM,1830,42,45-49,1872,4
SIM,1894,28,20-24,1922,1
STAT,1832,29,30-34,1861,22.389290499114107
STAT,1928,39,25-29,1967,1.2665457808147
SIM,1873,33,30-34,1906,26
STAT,1928,20,35-39,1948,12.063130726394196
SIM,1841,44,40-44,1885,9
STAT,1926,26,45-49,1952,2.1200005088485336
STAT,1949,15,25-29,1964,51.447323179131594
SIM,1935,19,20-24,1954,187
SIM,1871,22,40-44,1893,1
STAT,1918,17,20-24,1935,30.212280430676728
SIM,1805,49,na,1854,1241
STAT,1841,59,na,1900,1434.9619364132889
STAT,1854,20,40-44,1874,1.9010976445106047
STAT,1930,13,na,1943,5216.507783809417
STAT,1843,19,35-39,1862,0.5594212851851508
SIM,1859,32,35-39,1891,21
STAT,1894,37,45-49,1931,2.6158895574521366
SIM,1877,94,na,1971,46
SIM,1884,29,40-44,1913,5
SIM,1904,25,20-24,1929,22
STAT,1829,40,35-39,1869,1.5615340326287053
STAT,1848,22,45-49,1870,0.6600027654471474
STAT,1849,38,45-49,1887,1.5673106751484631
STAT,1907,44,35-39,1951,0.18581179960700972
STAT,1822,52,na,1874,1402.8726229616425
SIM,1810,64,na,1874,1178
STAT,1883,18,50-100,1901,0.04891069462372558
STAT,1851,40,na,1891,1926.053404860084
SIM,1936,20,35-39,1956,13
STAT,1865,38,50-100,1903,1.131132117246955
STAT,1886,28,20-24,1914,12.623172542558388
STAT,1865,51,30-34,1916,0.005537852768699794
STAT,1857,47,30-34,1904,0.07676284023829741
SIM,1920,23,50-100,1943,2
STAT,1816,49,50-100,1865,0.48897465395773804
STAT,1927,27,na,1954,4645.67376954137
STAT,1910,32,40-44,1942,3.8484303773795054
STAT,1877,57,na,1934,2126.362353248862
STAT,1948,18,45-49,1966,0.5830746495656622
SIM,1801,90,na,1891,13
SIM,1894,35,na,1929,3149
STAT,1921,47,20-24,1968,0.012712710541227999
STAT,1834,29,50-100,1863,0.5564090099456487
STAT,1811,52,40-44,1863,0.027861031438268184
SIM,1835,28,45-49,1863,3
SIM,1812,90,na,1902,36
STAT,1875,34,50-100,1909,0.9511055514531791
STAT,1885,17,45-49,1902,0.06648386032869856
SIM,1837,40,35-39,1877,4
STAT,1833,44,40-44,1877,1.7574155518962538
SIM,1841,15,25-29,1856,10
SIM,1888,34,20-24,1922,5
STAT,1838,28,20-24,1866,10.885948236810814
STAT,1826,54,45-49,1880,0.010523843588620482
STAT,1825,97,na,1922,3.2215339776942855
SIM,1902,27,45-49,1929,2
SIM,1890,73,na,1963,1698
STAT,1823,43,50-100,1866,1.6667127343670434
STAT,1898,39,50-100,1937,0.3618985493307497
SIM,1876,44,40-44,1920,7
STAT,1817,54,35-39,1871,0.017717779552864108
STAT,1855,15,45-49,1870,0.06094453543341124
STAT,1862,45,15-19,1907,3.5082274797208724E-4
STAT,1878,30,50-100,1908,0.9807461436517917
SIM,1923,17,35-39,1940,6
STAT,1826,38,40-44,1864,3.8086314239429417
STAT,1835,20,50-100,1855,0.5486440444125524
SIM,1907,41,na,1948,3547
STAT,1907,39,50-100,1946,0.3929412965056294
SIM,1864,28,40-44,1892,7
STAT,1953,15,15-19,1968,56.03113280737233
STAT,1849,25,30-34,1874,23.511378599790625
SIM,1860,41,40-44,1901,3
SIM,1844,33,50-100,1877,1
STAT,1906,17,25-29,1923,8.414217610003993
SIM,1896,21,35-39,1917,10
STAT,1767,92,na,1859,7.151372432452741
STAT,1847,28,30-34,1875,23.43341111976508
STAT,1801,103,na,1904,0.051205898865386325
STAT,1921,28,15-19,1949,0.8000406231921073
STAT,1782,111,na,1893,2.932167513836129E-4
STAT,1853,18,45-49,1871,0.06550007384917081
STAT,1893,29,40-44,1922,3.8489909395154633
STAT,1902,40,35-39,1942,0.1827302095846133
STAT,1915,24,40-44,1939,3.5244902199436923
SIM,1853,41,35-39,1894,3
SIM,1844,39,na,1883,1962
SIM,1903,51,na,1954,3032
STAT,1887,41,na,1928,2654.01001276332
STAT,1890,39,na,1929,2909.120484817459
STAT,1863,37,na,1900,2107.3078370610647
SIM,1838,30,45-49,1868,1
STAT,1893,45,45-49,1938,0.17399907862238487
STAT,1915,17,35-39,1932,0.8961867657574731
STAT,1786,99,na,1885,0.3052465425024632
STAT,1856,28,40-44,1884,2.4679183709352763
SIM,1840,49,na,1889,1535
SIM,1897,34,30-34,1931,9
STAT,1808,54,25-29,1862,0.0081050704356937
STAT,1888,21,35-39,1909,7.058954302458291
STAT,1878,48,15-19,1926,4.194072094145772E-4
STAT,1894,29,na,1923,3109.2568424372876
STAT,1897,21,45-49,1918,0.9540438107639885
STAT,1906,6,na,1912,3878.947613953826
SIM,1901,17,15-19,1918,10
STAT,1887,48,25-29,1935,0.06501714436225377
STAT,1839,18,na,1857,2060.1414392734873
SIM,1876,42,50-100,1918,2
SIM,1821,38,30-34,1859,3
STAT,1924,17,45-49,1941,0.6069173005156733
SIM,1883,21,25-29,1904,84
SIM,1938,33,na,1971,3807
STAT,1911,24,40-44,1935,3.2323734061274463
SIM,1882,78,na,1960,738
STAT,1892,40,50-100,1932,1.3643685635211358
STAT,1906,24,30-34,1930,26.282920613050038
STAT,1788,100,na,1888,0.2472154696261811
STAT,1901,40,50-100,1941,0.10571299370707667
SIM,1825,54,35-39,1879,1
SIM,1874,15,20-24,1889,24
STAT,1843,51,40-44,1894,0.008539350298866037
STAT,1833,22,30-34,1855,18.341097450106993
STAT,1883,51,na,1934,2165.55847443141
STAT,1930,35,30-34,1965,2.428841652618172
STAT,1794,94,na,1888,4.541566848647233
STAT,1866,15,20-24,1881,17.326240044332042
SIM,1836,33,45-49,1869,4
SIM,1837,51,na,1888,1402
STAT,1864,42,15-19,1906,0.01251122980443863
SIM,1910,40,35-39,1950,1
STAT,1884,45,35-39,1929,0.14270826212852336
SIM,1848,25,20-24,1873,11
SIM,1852,34,na,1886,2050
STAT,1909,27,20-24,1936,17.791751029176723
STAT,1917,21,40-44,1938,3.657801260286197
SIM,1917,27,20-24,1944,19
SIM,1893,16,na,1909,3348
SIM,1825,32,na,1857,1648
STAT,1852,99,na,1951,1.5257023795431972
SIM,1899,31,30-34,1930,33
STAT,1871,29,20-24,1900,11.770191146432879
SIM,1875,90,na,1965,232
SIM,1914,24,30-34,1938,29
STAT,1866,47,40-44,1913,0.16034306628939635
STAT,1915,46,50-100,1961,0.23315056302777634
SIM,1878,23,40-44,1901,6
SIM,1925,21,40-44,1946,7
SIM,1897,27,25-29,1924,61
STAT,1895,70,na,1965,2136.658022988363
STAT,1927,25,15-19,1952,0.8814054242552851
SIM,1862,39,30-34,1901,9
STAT,1843,44,35-39,1887,1.4670338821263869
SIM,1860,28,40-44,1888,2
STAT,1864,18,20-24,1882,16.537699131524512
STAT,1837,54,20-24,1891,4.784734359085339E-4
SIM,1880,43,na,1923,2225
STAT,1852,28,40-44,1880,2.7906082705131676
STAT,1837,82,na,1919,311.08289541135554
STAT,1845,49,30-34,1894,0.0740551959463317
STAT,1862,83,na,1945,344.74351938504026
STAT,1936,25,50-100,1961,0.9724098202023043
STAT,1851,39,45-49,1890,1.628108397054734
SIM,1891,16,35-39,1907,2
STAT,1868,74,na,1942,1081.3417517494252
SIM,1855,76,na,1931,728
SIM,1824,84,na,1908,126
SIM,1926,14,na,1940,5253
SIM,1841,22,30-34,1863,23
SIM,1855,20,35-39,1875,5
SIM,1808,60,na,1868,1228
STAT,1948,17,30-34,1965,14.231578447005015
STAT,1823,41,15-19,1864,0.0229014335065492
STAT,1875,45,25-29,1920,0.06090905622113031
STAT,1883,15,50-100,1898,0.04926702043763829
STAT,1857,31,15-19,1888,0.11535092879964381
STAT,1913,35,na,1948,3823.591048090903
SIM,1857,25,30-34,1882,27
SIM,1948,4,na,1952,4592
STAT,1890,32,15-19,1922,0.17763034079246745
STAT,1913,38,35-39,1951,2.423012043764284
STAT,1856,26,15-19,1882,0.379212267632938
STAT,1876,50,25-29,1926,0.0037848802364093786
SIM,1921,38,35-39,1959,2
STAT,1927,43,45-49,1970,0.21258153065130997
SIM,1904,9,na,1913,4046
SIM,1908,45,40-44,1953,1
SIM,1847,33,20-24,1880,1
STAT,1831,36,25-29,1867,2.5632822464595506
SIM,1911,24,50-100,1935,1
STAT,1930,28,25-29,1958,85.31899263050776
STAT,1863,54,50-100,1917,0.01313720050845362
SIM,1939,27,40-44,1966,10
STAT,1939,33,25-29,1972,9.614292006749363
STAT,1868,44,40-44,1912,2.1620381718650346
SIM,1863,71,na,1934,1009
STAT,1831,91,na,1922,39.046466787735255
STAT,1829,87,na,1916,117.1749925982562
STAT,1869,34,45-49,1903,1.702800587048381
STAT,1921,30,na,1951,4329.380784178039
STAT,1931,7,na,1938,5336.00424034263
SIM,1907,21,20-24,1928,136
STAT,1920,17,45-49,1937,0.5719430437557966
STAT,1858,23,15-19,1881,2.766618904357931
STAT,1845,41,35-39,1886,1.4593700019284543
STAT,1847,20,35-39,1867,5.659550825258635
STAT,1837,47,15-19,1884,2.7684540580559384E-4
STAT,1925,28,15-19,1953,0.8476998226907377
STAT,1933,22,35-39,1955,12.73728778134518
SIM,1924,13,na,1937,4893
SIM,1851,44,35-39,1895,2
STAT,1823,96,na,1919,4.778928835337334
STAT,1916,17,50-100,1933,0.08111679821760344
SIM,1816,89,na,1905,23
SIM,1855,28,30-34,1883,27
STAT,1844,64,na,1908,1347.0737264730046
STAT,1889,37,50-100,1926,1.547132222002236
STAT,1955,7,na,1962,5321.995875733867
STAT,1860,34,25-29,1894,8.405364800075969
SIM,1898,26,30-34,1924,53
SIM,1837,57,na,1894,1244
STAT,1872,37,25-29,1909,2.9437765676231327
STAT,1844,43,40-44,1887,1.7623875397976518
SIM,1799,78,na,1877,376
STAT,1827,43,40-44,1870,2.6155424316878824
STAT,1788,106,na,1894,0.0040207370397479635
STAT,1924,22,25-29,1946,111.20195502791712
STAT,1825,49,45-49,1874,0.2953317765892834
STAT,1852,24,50-100,1876,0.38467832643865607
STAT,1865,33,30-34,1898,16.097781217549063
STAT,1922,33,15-19,1955,0.14752521720253048
STAT,1858,84,na,1942,269.12707400325314
STAT,1854,54,na,1908,1602.6196589881833
STAT,1840,47,50-100,1887,0.17822138374892735
STAT,1841,18,50-100,1859,0.04637924475467545
STAT,1907,22,25-29,1929,85.74745515149854
SIM,1953,16,na,1969,4323
STAT,1851,20,25-29,1871,57.218903094353266
SIM,1929,28,25-29,1957,9
STAT,1854,23,45-49,1877,0.622574317143034
STAT,1808,49,45-49,1857,0.5813432275036925
STAT,1917,45,40-44,1962,0.16884534071485793
STAT,1910,42,50-100,1952,0.11323915946383334
SIM,1843,51,na,1894,1621
STAT,1830,30,35-39,1860,10.02404063095126
STAT,1839,36,25-29,1875,2.3993504867834283
SIM,1932,22,25-29,1954,142
STAT,1864,20,35-39,1884,5.456454154103685
STAT,1894,34,40-44,1928,5.6419967046189
SIM,1842,20,25-29,1862,5
SIM,1887,29,20-24,1916,15
SIM,1924,4,na,1928,4997
SIM,1820,94,na,1914,15
SIM,1875,20,20-24,1895,71
SIM,1873,26,25-29,1899,5
SIM,1868,49,na,1917,2191
STAT,1904,45,30-34,1949,0.08062946915956148
SIM,1902,16,20-24,1918,20
STAT,1879,29,20-24,1908,12.420481222174521
STAT,1889,27,25-29,1916,53.30586601821126
SIM,1929,35,30-34,1964,3
SIM,1822,89,na,1911,73
SIM,1807,49,35-39,1856,1
STAT,1811,43,45-49,1854,4.6226167985388935
STAT,1834,20,25-29,1854,92.92594321549628
STAT,1938,28,25-29,1966,66.48672897580417
STAT,1895,76,na,1971,1730.926435087631
STAT,1910,35,45-49,1945,0.6712931149941485
SIM,1901,0,na,1901,4039
STAT,1914,19,40-44,1933,0.29362195564195714
SIM,1884,20,30-34,1904,23
STAT,1922,40,20-24,1962,0.020740636969187726
STAT,1896,24,na,1920,3166.607994962514
SIM,1915,22,25-29,1937,115
STAT,1848,54,na,1902,1627.7021122386095
STAT,1865,32,na,1897,2209.4921550237905
STAT,1910,19,50-100,1929,0.07530922564752629
SIM,1835,43,40-44,1878,5
SIM,1879,31,45-49,1910,3
STAT,1868,8,na,1876,2676.950283118081
STAT,1906,0,na,1906,4360.006750614244
STAT,1878,54,50-100,1932,0.015596016563498061
STAT,1850,64,na,1914,1307.6015960151149
SIM,1847,36,25-29,1883,1
STAT,1897,27,15-19,1924,0.6188668644688413
SIM,1831,66,na,1897,1039
STAT,1858,52,30-34,1910,0.004790021974704058
SIM,1934,35,40-44,1969,7
STAT,1848,33,30-34,1881,14.254137873125071
STAT,1840,41,15-19,1881,0.010499951814193016
STAT,1858,30,20-24,1888,2.232684265441901
SIM,1856,33,30-34,1889,3
STAT,1807,78,na,1885,382.5676905371377
STAT,1800,54,25-29,1854,0.01442146449627872
SIM,1881,18,30-34,1899,2
SIM,1846,34,na,1880,2001
SIM,1918,19,na,1937,4460
STAT,1813,72,na,1885,597.0713752017374
SIM,1899,16,35-39,1915,1
STAT,1901,10,na,1911,3695.305125442264
STAT,1828,33,45-49,1861,1.6641808088815522
STAT,1926,35,40-44,1961,1.8696273629844926
SIM,1851,86,na,1937,54
STAT,1848,26,25-29,1874,39.53913712891833
STAT,1923,32,20-24,1955,2.8530396388366825
SIM,1842,39,45-49,1881,5
STAT,1875,56,na,1931,2135.5185466975745
STAT,1922,18,na,1940,4335.1271803459385
STAT,1870,5,na,1875,2781.92869505212
STAT,1884,39,na,1923,2353.914824006918
STAT,1859,32,na,1891,1944.1633200770852
STAT,1788,94,na,1882,4.696786523353467
STAT,1908,21,30-34,1929,27.02507902944276
STAT,1904,38,25-29,1942,0.9040933001414849
STAT,1867,20,20-24,1887,67.23357960080925
STAT,1839,43,30-34,1882,0.8256029850082935
STAT,1865,26,25-29,1891,39.30141612375766
SIM,1832,22,20-24,1854,63
STAT,1829,25,45-49,1854,3.475048029123358
SIM,1768,86,na,1854,50
SIM,1793,81,na,1874,144
SIM,1893,22,50-100,1915,4
STAT,1867,48,50-100,1915,0.23226337370088052
STAT,1826,73,na,1899,692.7456707445604
STAT,1851,12,na,1863,2394.5664620122006
SIM,1916,21,30-34,1937,29
STAT,1853,33,40-44,1886,3.7059854629248514
STAT,1819,63,na,1882,1123.2064722664763
SIM,1907,47,na,1954,3419
SIM,1833,30,25-29,1863,11
STAT,1780,74,na,1854,395.0
STAT,1873,18,30-34,1891,1.6441398457624923
STAT,1895,24,45-49,1919,0.9223323119737667
STAT,1898,19,na,1917,3465.5209740643695
STAT,1864,84,na,1948,301.7528975511382
STAT,1870,37,20-24,1907,0.7687388408177394
SIM,1862,58,na,1920,1764
SIM,1922,19,40-44,1941,2
SIM,1861,33,40-44,1894,6
SIM,1817,37,na,1854,1439
STAT,1886,42,35-39,1928,1.9529312904263862
STAT,1880,29,30-34,1909,26.80279860322698
SIM,1848,60,na,1908,1499
SIM,1823,37,na,1860,1655
SIM,1846,28,20-24,1874,15
STAT,1896,16,45-49,1912,0.08822866242026944
SIM,1856,26,25-29,1882,44
SIM,1880,37,25-29,1917,7
SIM,1901,56,na,1957,3152
STAT,1885,50,35-39,1935,0.008888033200348467
SIM,1931,32,20-24,1963,3
STAT,1852,48,50-100,1900,0.19536969758840142
STAT,1846,99,na,1945,1.3543455307361656
STAT,1889,76,na,1965,1531.004855870698
STAT,1903,46,25-29,1949,0.04725136049491549
SIM,1852,43,40-44,1895,2
STAT,1891,8,na,1899,3283.2215386220937
STAT,1819,51,35-39,1870,0.016732439872214323
SIM,1892,42,30-34,1934,3
STAT,1889,34,30-34,1923,21.813381435627967
STAT,1778,103,na,1881,0.034520401251144264
SIM,1806,65,na,1871,1005
SIM,1912,38,25-29,1950,1
SIM,1833,49,45-49,1882,1
STAT,1947,18,25-29,1965,49.78920752669195
STAT,1841,15,15-19,1856,5.718526011565521
STAT,1820,39,15-19,1859,0.12182928122316392
STAT,1868,29,45-49,1897,1.0741109756719875
STAT,1825,30,25-29,1855,24.873605031105786
STAT,1910,17,15-19,1927,9.171645031537043
SIM,1821,42,na,1863,1520
STAT,1881,56,na,1937,2011.6449403665974
SIM,1947,16,na,1963,4240
STAT,1830,38,30-34,1868,4.746915261499957
SIM,1800,74,na,1874,481
SIM,1876,78,na,1954,905
SIM,1847,43,30-34,1890,1
STAT,1834,44,25-29,1878,0.5077886984905904
SIM,1901,35,45-49,1936,3
STAT,1892,21,25-29,1913,73.4130304167345
SIM,1924,19,na,1943,4479
SIM,1847,28,40-44,1875,4
SIM,1940,17,35-39,1957,4
SIM,1887,16,na,1903,2999
STAT,1843,54,45-49,1897,0.011393312202489491
SIM,1920,29,na,1949,3946
SIM,1839,49,50-100,1888,1
SIM,1846,30,35-39,1876,5
STAT,1893,42,40-44,1935,2.9073085892282093
STAT,1901,17,50-100,1918,0.06989079375019688
STAT,1828,52,50-100,1880,0.011407742331524777
SIM,1869,90,na,1959,98
STAT,1904,28,15-19,1932,0.6610080130037956
SIM,1851,80,na,1931,349
SIM,1906,17,35-39,1923,1
SIM,1849,40,30-34,1889,2
STAT,1866,25,30-34,1891,23.856174303782286
SIM,1853,39,20-24,1892,1
STAT,1830,44,na,1874,1581.0305946827755
STAT,1911,40,na,1951,3656.7347135744517
STAT,1845,39,20-24,1884,0.6198247693928626
SIM,1860,44,45-49,1904,2
STAT,1817,51,30-34,1868,0.013007270660430432
STAT,1852,28,na,1880,2015.2601123554693
SIM,1790,79,na,1869,209
SIM,1892,35,25-29,1927,7
STAT,1845,51,45-49,1896,0.011393484258763291
STAT,1888,19,20-24,1907,21.266305279016564
SIM,1886,24,45-49,1910,2
STAT,1876,45,45-49,1921,0.25108786306058245
SIM,1794,69,na,1863,787
STAT,1884,42,30-34,1926,1.1589115900221687
STAT,1850,15,25-29,1865,5.27066209587816
SIM,1882,16,25-29,1898,12
SIM,1891,21,15-19,1912,5
STAT,1911,27,45-49,1938,1.718547689480483
STAT,1951,2,na,1953,4840.869584700941
SIM,1879,21,35-39,1900,17
STAT,1874,16,25-29,1890,5.91674420775772
STAT,1809,54,45-49,1863,0.05921929933781106
SIM,1928,32,45-49,1960,3
SIM,1900,27,40-44,1927,4
STAT,1850,52,30-34,1902,0.0044537002598036635
SIM,1815,42,na,1857,1519
STAT,1798,56,na,1854,1287.0
STAT,1826,51,40-44,1877,0.008102221451131129
SIM,1857,31,25-29,1888,14
SIM,1862,24,na,1886,2214
SIM,1917,31,na,1948,3997
SIM,1932,14,na,1946,5508
STAT,1859,109,na,1968,0.006441328033318574
STAT,1860,29,45-49,1889,0.915570109470204
STAT,1932,17,35-39,1949,5.666455625644998
STAT,1835,87,na,1922,131.26629131925122
STAT,1883,39,50-100,1922,1.2165594572153036
SIM,1855,48,na,1903,1726
STAT,1910,25,35-39,1935,15.013257047332699
STAT,1817,62,na,1879,1038.0380305996266
STAT,1831,33,20-24,1864,2.443630349648108
STAT,1851,36,40-44,1887,3.6882910885277824
SIM,1930,27,20-24,1957,41
SIM,1902,28,50-100,1930,1
SIM,1926,24,50-100,1950,1
STAT,1772,114,na,1886,1.6658323197560007E-4
STAT,1849,31,25-29,1880,9.304217033690128
STAT,1905,34,50-100,1939,0.7685022678821736
STAT,1836,18,45-49,1854,0.07590647445064724
SIM,1872,88,na,1960,130
SIM,1913,34,50-100,1947,1
SIM,1784,70,na,1854,606
SIM,1939,32,20-24,1971,2
STAT,1834,39,45-49,1873,1.6343888842062895
SIM,1829,28,20-24,1857,15
STAT,1832,45,na,1877,1650.0084651694938
STAT,1857,41,25-29,1898,0.5139335932119528
STAT,1861,26,50-100,1887,0.547086142997238
STAT,1833,21,na,1854,1834.779060839967
STAT,1896,29,50-100,1925,0.8557316431674338
STAT,1947,25,30-34,1972,45.26655851808468
STAT,1836,51,35-39,1887,0.005530740693934955
STAT,1838,30,35-39,1868,9.440087898219536
SIM,1850,39,na,1889,1768
STAT,1867,52,40-44,1919,0.010028988554157672
STAT,1953,0,na,1953,5349.0137787963
STAT,1885,48,20-24,1933,0.01205988488119394
STAT,1927,40,40-44,1967,0.320879082437061
STAT,1860,54,na,1914,1733.1980606602501
SIM,1872,20,35-39,1892,7
STAT,1835,56,na,1891,1519.6617203764442
STAT,1867,27,na,1894,2285.648981660104
STAT,1906,27,35-39,1933,14.327170319787083
STAT,1891,16,25-29,1907,7.174644225232856
SIM,1842,75,na,1917,798
SIM,1866,45,25-29,1911,1
STAT,1908,24,35-39,1932,8.771774744968987
STAT,1822,49,50-100,1871,0.3400731367385788
SIM,1914,27,35-39,1941,24
STAT,1937,11,na,1948,3937.6912849357104
SIM,1887,25,50-100,1912,1
STAT,1878,24,45-49,1902,0.7358233419385857
SIM,1874,31,25-29,1905,18
SIM,1846,43,50-100,1889,1
SIM,1898,32,25-29,1930,21
STAT,1906,25,na,1931,3567.659946245457
SIM,1888,63,na,1951,2012
SIM,1895,23,40-44,1918,5
SIM,1888,29,40-44,1917,8
STAT,1912,38,15-19,1950,0.019025117500166805
STAT,1857,26,35-39,1883,7.975491852022501
STAT,1838,43,50-100,1881,0.8155659223046502
STAT,1848,20,na,1868,2053.077178926923
STAT,1887,23,40-44,1910,2.3747108559159082
STAT,1913,43,15-19,1956,0.0015253550302839988
STAT,1893,41,na,1934,3004.6167046760343
STAT,1946,22,na,1968,4146.11484478793
STAT,1768,100,na,1868,0.2854118767911202
STAT,1911,30,35-39,1941,9.149866839022362
STAT,1859,39,15-19,1898,0.0452895087041885
STAT,1922,12,na,1934,4678.946955885579
SIM,1902,32,na,1934,3507
STAT,1877,51,na,1928,2289.1370088246726
SIM,1865,26,35-39,1891,16
STAT,1883,21,15-19,1904,3.312178685608513
SIM,1814,94,na,1908,12
SIM,1874,25,30-34,1899,50
STAT,1843,41,30-34,1884,0.9679012788271341
STAT,1887,45,20-24,1932,0.01385435977280253
STAT,1904,24,na,1928,3436.2099681545938
STAT,1811,100,na,1911,0.4598604785012204
STAT,1913,35,30-34,1948,1.8523117727471545
STAT,1871,31,35-39,1902,10.27547080353158
SIM,1921,35,30-34,1956,4
STAT,1889,20,40-44,1909,2.6415660375988383
STAT,1879,25,50-100,1904,0.6867670341436194
SIM,1888,37,25-29,1925,7
SIM,1897,20,40-44,1917,3
SIM,1849,76,na,1925,1029
SIM,1867,33,na,1900,2181
STAT,1863,37,15-19,1900,0.05022754450655397
SIM,1846,65,na,1911,1240
SIM,1889,26,20-24,1915,18
SIM,1900,21,35-39,1921,13
SIM,1828,32,40-44,1860,8
SIM,1919,32,50-100,1951,1
STAT,1858,45,25-29,1903,0.047063411830895824
STAT,1921,45,30-34,1966,0.10303184924663254
STAT,1816,49,35-39,1865,0.27873148111541646
STAT,1871,38,50-100,1909,1.234510607487276
STAT,1819,97,na,1916,3.167243196103435
STAT,1925,36,35-39,1961,2.964506505638529
SIM,1881,90,na,1971,215
SIM,1894,40,50-100,1934,5
SIM,1853,35,50-100,1888,2
SIM,1858,50,na,1908,1834
STAT,1875,21,25-29,1896,60.117719657983116
STAT,1866,37,30-34,1903,5.014973783530318
STAT,1856,20,45-49,1876,0.6579642056372631
SIM,1879,58,na,1937,2430
SIM,1909,20,50-100,1929,1
STAT,1899,66,na,1965,2535.1981662539006
STAT,1838,30,na,1868,2020.2351666090633
STAT,1848,7,na,1855,2385.08052
SIM,1864,26,15-19,1890,1
SIM,1858,59,na,1917,1536
SIM,1907,22,35-39,1929,11
STAT,1779,89,na,1868,29.299053101981873
STAT,1839,33,20-24,1872,2.272000768356785
SIM,1880,34,20-24,1914,5
STAT,1867,30,30-34,1897,16.856136590377417
STAT,1912,32,45-49,1944,1.5795479111124713
SIM,1887,2,na,1889,3092
STAT,1905,33,15-19,1938,0.11996769927722774
STAT,1836,69,na,1905,913.4497541854153
STAT,1890,48,30-34,1938,0.06725287304725663
STAT,1919,49,25-29,1968,0.05836863364646219
STAT,1921,25,50-100,1946,1.1396719841918692
STAT,1844,46,45-49,1890,0.18339831469925505
STAT,1931,33,25-29,1964,12.343723856843367
STAT,1823,62,na,1885,1063.0707298587495
SIM,1911,46,na,1957,3585
STAT,1907,8,na,1915,3893.8264096445237
STAT,1923,42,30-34,1965,0.1524595939910661
SIM,1910,61,na,1971,3163
SIM,1933,36,35-39,1969,7
STAT,1830,28,20-24,1858,12.456415852357411
STAT,1850,101,na,1951,0.42922582248514857
STAT,1888,39,40-44,1927,5.226222446623384
STAT,1928,37,na,1965,4849.815087408177
SIM,1874,37,30-34,1911,7
STAT,1939,23,15-19,1962,5.451798370863887
SIM,1839,36,35-39,1875,9
STAT,1861,34,45-49,1895,1.4574012866191763
SIM,1935,25,15-19,1960,1
STAT,1865,18,40-44,1883,0.1734846831029085
STAT,1821,44,15-19,1865,0.02246126527218794
SIM,1901,32,40-44,1933,14
SIM,1924,21,20-24,1945,166
STAT,1843,17,na,1860,2368.0686336478866
STAT,1898,27,35-39,1925,13.311202613761802
SIM,1788,69,na,1857,793
SIM,1808,48,40-44,1856,1
SIM,1905,46,na,1951,3289
SIM,1908,29,na,1937,3792
STAT,1946,22,45-49,1968,1.2774788938318125
SIM,1850,20,15-19,1870,5
SIM,1896,29,30-34,1925,62
STAT,1802,63,na,1865,792.8885297306206
STAT,1856,39,50-100,1895,0.9732854257018653
STAT,1871,7,na,1878,2766.2969079084633
STAT,1905,43,25-29,1948,0.06522580959564649
SIM,1875,39,40-44,1914,7
STAT,1888,29,30-34,1917,30.152820590593265
STAT,1919,39,15-19,1958,0.021007817373644842
STAT,1922,27,20-24,1949,21.07594575919502
SIM,1878,73,na,1951,1262
STAT,1867,39,40-44,1906,4.1502778725462015
SIM,1832,25,25-29,1857,41
SIM,1899,72,na,1971,2220
STAT,1806,90,na,1896,28.01473063703324
STAT,1830,40,45-49,1870,1.3283327279542017
SIM,1838,20,35-39,1858,8
SIM,1827,67,na,1894,916
STAT,1916,21,20-24,1937,119.26232744783195
STAT,1811,77,na,1888,366.03031957376106
STAT,1890,0,na,1890,3662.6007499663606
STAT,1842,20,15-19,1862,3.3104754737039235
STAT,1918,10,na,1928,4414.3338129602125
SIM,1925,0,na,1925,5262
SIM,1916,24,35-39,1940,20
STAT,1870,18,15-19,1888,5.9394930437130125
STAT,1840,104,na,1944,0.047997212647117427
STAT,1871,66,na,1937,1656.260121019458
STAT,1925,46,45-49,1971,0.2693625763254994
STAT,1823,31,na,1854,1603.7476419847883
SIM,1895,45,na,1940,3136
STAT,1880,44,20-24,1924,0.1679541869901222
STAT,1879,31,35-39,1910,10.843179229331838
STAT,1898,32,15-19,1930,0.19645885155739268
SIM,1866,33,25-29,1899,17
STAT,1842,39,35-39,1881,5.799310693198166
SIM,1947,23,15-19,1970,7
STAT,1846,22,40-44,1868,1.8386726273376837
STAT,1884,67,na,1951,1599.9327963951164
STAT,1927,23,50-100,1950,0.824406405149619
STAT,1939,28,45-49,1967,1.7708815606799642
SIM,1910,34,40-44,1944,1
SIM,1837,29,25-29,1866,39
SIM,1902,8,na,1910,3805
STAT,1865,23,20-24,1888,64.11819435795141
STAT,1819,49,20-24,1868,0.023093250911600017
SIM,1839,52,na,1891,1521
STAT,1909,49,50-100,1958,0.21072172148030854
SIM,1943,17,20-24,1960,135
STAT,1847,38,40-44,1885,3.5052100383846234
SIM,1838,39,na,1877,1656
STAT,1907,32,35-39,1939,8.710155219277217
SIM,1850,39,35-39,1889,8
SIM,1915,32,35-39,1947,14
SIM,1923,24,40-44,1947,3
STAT,1829,106,na,1935,0.00807524175237942
STAT,1831,97,na,1928,3.619930681946796
STAT,1858,33,25-29,1891,8.251377082324085
STAT,1842,69,na,1911,1150.8542829559024
STAT,1926,38,45-49,1964,0.8490855520259625
SIM,1855,38,40-44,1893,11
STAT,1826,45,na,1871,1528.8802729130693
STAT,1899,24,15-19,1923,4.579785736447394
STAT,1805,77,na,1882,421.7494789569602
SIM,1829,38,30-34,1867,10
SIM,1870,39,50-100,1909,1
STAT,1844,30,na,1874,2050.459871677425
STAT,1949,22,30-34,1971,34.216076318674205
STAT,1822,36,15-19,1858,0.11149338263376159
STAT,1935,17,20-24,1952,189.009823835852
STAT,1862,39,50-100,1901,1.0554413101870432
SIM,1888,38,50-100,1926,2
SIM,1946,3,na,1949,4393
SIM,1884,73,na,1957,1117
SIM,1887,31,35-39,1918,20
STAT,1839,28,40-44,1867,2.5857259083898465
STAT,1951,18,15-19,1969,55.11403189800909
STAT,1934,37,na,1971,5294.522782752191
STAT,1844,47,20-24,1891,0.009255584858301434
STAT,1921,35,20-24,1956,0.3008770891938932
SIM,1859,20,35-39,1879,9
SIM,1819,38,na,1857,1578
STAT,1911,40,45-49,1951,0.16386685678273283
STAT,1825,46,40-44,1871,0.2232289074594319
SIM,1852,46,45-49,1898,1
SIM,1856,24,na,1880,2393
STAT,1842,15,35-39,1857,0.5591291967953621
STAT,1813,53,20-24,1866,0.0017358623063955065
SIM,1840,17,30-34,1857,3
SIM,1772,85,na,1857,71
STAT,1930,18,15-19,1948,59.685117425055324
SIM,1866,88,na,1954,142
STAT,1839,103,na,1942,0.09904615048507398
SIM,1920,32,45-49,1952,1
STAT,1854,34,50-100,1888,0.703365332572292
STAT,1834,26,50-100,1860,0.5685682472721529
SIM,1914,29,na,1943,3772
STAT,1916,16,40-44,1932,0.3035798910543065
STAT,1858,110,na,1968,0.0022983958532502686
STAT,1886,65,na,1951,1824.8419737083407
SIM,1864,59,na,1923,1819
STAT,1922,38,50-100,1960,0.48697471764909706
SIM,1834,38,40-44,1872,4
SIM,1898,22,15-19,1920,4
STAT,1864,30,45-49,1894,1.5945049208728634
SIM,1951,15,na,1966,4976
SIM,1938,25,50-100,1963,2
STAT,1829,29,25-29,1858,43.462031835326705
SIM,1924,16,40-44,1940,1
STAT,1835,44,45-49,1879,1.3028595089895167
SIM,1873,23,20-24,1896,88
STAT,1902,34,40-44,1936,3.551761321836566
SIM,1902,24,40-44,1926,2
STAT,1892,37,40-44,1929,5.596908253772823
SIM,1914,17,25-29,1931,5
STAT,1882,16,15-19,1898,5.9126986044556205
STAT,1872,34,20-24,1906,2.7400258220431097
SIM,1929,38,35-39,1967,3
STAT,1867,42,30-34,1909,1.0997181198511166
STAT,1844,28,15-19,1872,0.42730215317285086
STAT,1877,19,45-49,1896,0.06874616624181105
SIM,1828,46,na,1874,1690
STAT,1804,95,na,1899,4.48617825199528
STAT,1865,40,50-100,1905,0.9880418985223888
SIM,1925,18,15-19,1943,58
STAT,1913,37,20-24,1950,0.26539054549336305
STAT,1943,27,20-24,1970,19.834312264361845
SIM,1842,29,35-39,1871,3
STAT,1924,44,na,1968,4492.059257799417
STAT,1829,56,na,1885,1396.364747061873
SIM,1929,25,na,1954,5181
SIM,1866,85,na,1951,256
SIM,1863,19,25-29,1882,11
STAT,1860,38,40-44,1898,3.6053498086781137
STAT,1892,15,30-34,1907,2.047328922012425
STAT,1822,83,na,1905,230.8257087284092
SIM,1930,37,30-34,1967,6
STAT,1891,15,na,1906,3204.655776128469
SIM,1881,20,45-49,1901,1
SIM,1833,24,30-34,1857,19
STAT,1886,46,15-19,1932,4.331507906826507E-4
STAT,1857,48,45-49,1905,0.18566310949148498
SIM,1941,28,40-44,1969,9
SIM,1811,80,na,1891,178
SIM,1847,46,35-39,1893,1
STAT,1859,100,na,1959,1.6509412186475898
STAT,1922,37,30-34,1959,2.1160732417143344
STAT,1871,41,45-49,1912,1.5192349774042053
STAT,1907,26,40-44,1933,4.502414360452416
SIM,1841,25,na,1866,2059
STAT,1848,16,15-19,1864,5.75253129856844
SIM,1875,35,25-29,1910,5
SIM,1871,47,25-29,1918,1
STAT,1834,29,35-39,1863,8.392706896912165
STAT,1834,36,40-44,1870,3.702518805081911
SIM,1860,94,na,1954,7
SIM,1869,36,45-49,1905,4
STAT,1855,19,25-29,1874,5.163475396218602
STAT,1804,50,45-49,1854,0.04434287960593287
STAT,1926,41,35-39,1967,0.2536125983752637
SIM,1852,65,na,1917,1387
SIM,1911,15,na,1926,4008
SIM,1865,9,na,1874,2677
SIM,1906,26,30-34,1932,2
STAT,1830,52,45-49,1882,0.010591194568749395
STAT,1854,47,15-19,1901,3.0471434148437093E-4
SIM,1866,49,50-100,1915,1
STAT,1904,41,15-19,1945,0.0014084402805100381
STAT,1853,75,na,1928,863.2025992165217
STAT,1876,23,50-100,1899,0.4282510021059901
STAT,1865,17,50-100,1882,0.04674442490800432
SIM,1839,83,na,1922,198
STAT,1821,48,30-34,1869,0.1502587329928656
STAT,1867,35,25-29,1902,2.783686730987934
SIM,1812,50,45-49,1862,1
STAT,1893,9,na,1902,3357.835244454142
STAT,1810,98,na,1908,1.3849613931227285
STAT,1862,41,35-39,1903,1.5796259840389535
STAT,1939,25,40-44,1964,4.784240167568503
SIM,1880,12,na,1892,2613
SIM,1910,25,45-49,1935,5
SIM,1938,18,25-29,1956,46
STAT,1874,25,20-24,1899,12.301930078547333
SIM,1829,37,50-100,1866,2
STAT,1912,59,na,1971,3386.8742229428135
STAT,1885,47,45-49,1932,0.2390759903593052
SIM,1859,38,na,1897,2221
SIM,1895,26,45-49,1921,2
SIM,1939,30,30-34,1969,3
SIM,1915,26,40-44,1941,5
STAT,1839,46,35-39,1885,0.09971291251338563
STAT,1835,50,na,1885,1700.9000087271743
STAT,1878,36,na,1914,2513.761731284933
SIM,1889,32,50-100,1921,1
SIM,1923,34,na,1957,4199
STAT,1897,25,25-29,1922,58.09214619192126
STAT,1902,25,45-49,1927,1.608169420716674
STAT,1882,53,20-24,1935,7.216254385037109E-4
SIM,1888,30,40-44,1918,6
STAT,1909,25,50-100,1934,0.9850210407701825
STAT,1880,77,na,1957,1007.9108179528481
STAT,1821,40,35-39,1861,3.3515288849236393
STAT,1842,38,na,1880,1949.9603600754488
STAT,1924,16,30-34,1940,14.845155775008942
SIM,1833,36,30-34,1869,10
STAT,1849,33,15-19,1882,0.11529886371804084
STAT,1884,30,na,1914,2427.8218163783513
SIM,1822,58,na,1880,1145
STAT,1900,16,45-49,1916,0.09258958331909271
STAT,1872,42,na,1914,2360.170725606546
SIM,1784,79,na,1863,361
SIM,1864,50,na,1914,2035
STAT,1949,15,50-100,1964,0.44478944780065244
SIM,1828,35,45-49,1863,1
SIM,1889,11,na,1900,3370
STAT,1899,46,25-29,1945,0.04551808553741178
STAT,1868,48,20-24,1916,0.011545493124516486
STAT,1953,9,na,1962,4849.041103561612
SIM,1865,23,30-34,1888,21
SIM,1902,30,35-39,1932,25
STAT,1893,32,30-34,1925,22.59543152977259
SIM,1838,34,25-29,1872,15
SIM,1901,25,35-39,1926,2
STAT,1876,54,40-44,1930,0.010785163919990595
STAT,1903,24,15-19,1927,4.754178570284675
STAT,1892,7,na,1899,3331.1091143951667
SIM,1877,23,na,1900,2451
SIM,1911,24,15-19,1935,4
SIM,1932,16,30-34,1948,21
SIM,1879,35,25-29,1914,2
SIM,1877,26,na,1903,2490
STAT,1857,35,30-34,1892,4.286501745246547
STAT,1892,27,30-34,1919,32.19661723908106
STAT,1907,19,35-39,1926,0.8174965660491711
SIM,1878,70,na,1948,1578
STAT,1932,40,15-19,1972,0.0021284957711339442
STAT,1814,88,na,1902,63.972395994128235
STAT,1858,49,40-44,1907,0.13561029449636156
STAT,1826,76,na,1902,552.5643539076248
STAT,1885,29,15-19,1914,0.4584684758034999
STAT,1917,18,15-19,1935,9.94013145107784
SIM,1882,26,35-39,1908,11
STAT,1830,35,50-100,1865,1.1401120283029351
STAT,1885,40,25-29,1925,0.6601686072713769
STAT,1849,40,20-24,1889,0.12545104877784752
SIM,1856,16,15-19,1872,6
STAT,1825,36,30-34,1861,8.437811261816373
SIM,1933,24,35-39,1957,18
STAT,1859,63,na,1922,1453.6993689672536
SIM,1902,38,30-34,1940,3
SIM,1915,19,35-39,1934,2
STAT,1898,50,na,1948,3013.176290240511
STAT,1850,40,50-100,1890,0.8026867024512935
SIM,1860,60,na,1920,1786
STAT,1857,23,30-34,1880,16.265504215504865
STAT,1956,15,30-34,1971,16.458180860538675
SIM,1816,39,35-39,1855,2
SIM,1884,42,40-44,1926,5
STAT,1876,42,40-44,1918,2.3665360780127154
STAT,1908,43,40-44,1951,0.23456046487569648
STAT,1899,34,25-29,1933,14.186103291301697
SIM,1916,31,40-44,1947,9
STAT,1809,51,40-44,1860,0.045623593961603474
STAT,1874,26,35-39,1900,10.084444592916942
STAT,1925,24,35-39,1949,11.426991829088443
SIM,1839,86,na,1925,156
STAT,1818,38,15-19,1856,0.1878805511679782
STAT,1845,45,15-19,1890,3.1565438915523295E-4
SIM,1939,23,25-29,1962,140
SIM,1876,48,20-24,1924,1
STAT,1860,26,40-44,1886,2.5241611681389524
SIM,1864,24,25-29,1888,87
SIM,1880,15,na,1895,2552
SIM,1897,17,15-19,1914,7
STAT,1919,46,20-24,1965,0.0122622386873376
STAT,1937,17,na,1954,3652.474134280707
STAT,1805,103,na,1908,0.0576825449420099
STAT,1899,30,50-100,1929,1.2902558328179294
STAT,1888,24,50-100,1912,0.48872469605404345
STAT,1914,42,20-24,1956,0.01785444485862721
STAT,1880,71,na,1951,1430.9457854438351
STAT,1870,36,45-49,1906,1.9975984263166886
STAT,1893,25,25-29,1918,55.11563708781755
STAT,1856,41,50-100,1897,0.8498383655458928
STAT,1916,18,na,1934,4170.738727491418
STAT,1936,32,na,1968,3746.8168395726093
SIM,1907,24,25-29,1931,93
STAT,1825,103,na,1928,0.08606062253890893
STAT,1807,52,50-100,1859,0.062401760436404885
STAT,1843,34,25-29,1877,9.736110217120922
STAT,1898,29,25-29,1927,57.93993905815601
STAT,1877,52,35-39,1929,0.00906063214400075
SIM,1811,45,45-49,1856,1
STAT,1921,48,35-39,1969,0.14790263532901596
STAT,1874,77,na,1951,900.3178861427208
STAT,1891,18,na,1909,3181.4779673713037
STAT,1893,20,30-34,1913,23.18924281468996
SIM,1848,35,30-34,1883,10
STAT,1901,17,40-44,1918,0.2609256934513379
STAT,1908,31,40-44,1939,3.7821053035711754
SIM,1854,60,na,1914,1653
STAT,1875,23,15-19,1898,3.443440098626488
SIM,1851,34,25-29,1885,17
STAT,1898,24,30-34,1922,24.41914723932204
STAT,1835,41,40-44,1876,2.0347688684307372
STAT,1948,20,20-24,1968,130.34922376360313
STAT,1859,60,na,1919,1553.8078169012952
STAT,1911,16,20-24,1927,27.741442641401456
STAT,1930,31,15-19,1961,0.16924054835746008
STAT,1943,11,na,1954,4256.211518392502
SIM,1815,73,na,1888,480
SIM,1816,58,na,1874,1265
SIM,1924,24,25-29,1948,166
STAT,1859,50,25-29,1909,0.0029272000651294956
SIM,1850,37,45-49,1887,3
STAT,1909,30,na,1939,3710.3979685782792
STAT,1911,20,25-29,1931,89.89110149381436
STAT,1889,17,15-19,1906,7.478386351823116
SIM,1828,43,na,1871,1726
STAT,1934,33,40-44,1967,5.445436264426317
STAT,1826,41,30-34,1867,0.9589360145763474
STAT,1905,40,20-24,1945,0.016412442999835897
STAT,1930,5,na,1935,5301.744488232841
SIM,1809,79,na,1888,158
SIM,1933,31,40-44,1964,1
STAT,1873,92,na,1965,122.0482823455023
SIM,1933,21,30-34,1954,40
STAT,1868,50,35-39,1918,0.008508930824465574
STAT,1886,62,na,1948,1973.6062015348773
STAT,1896,31,50-100,1927,1.2395515790765206
SIM,1859,29,45-49,1888,1
SIM,1847,19,na,1866,2016
STAT,1887,26,45-49,1913,1.2735802139253627
STAT,1934,15,50-100,1949,0.5191946468777106
STAT,1846,90,na,1936,56.380605466473455
STAT,1822,46,25-29,1868,0.08334258764923229
STAT,1861,31,40-44,1892,3.6706538405232574
SIM,1860,34,35-39,1894,11
SIM,1875,48,50-100,1923,2
STAT,1920,20,35-39,1940,10.746168004281857
STAT,1843,22,25-29,1865,58.00656868430895
STAT,1852,34,35-39,1886,8.273415081172763
SIM,1851,22,25-29,1873,4
STAT,1849,47,40-44,1896,0.13229327722039502
STAT,1856,18,30-34,1874,1.5003421750492598
STAT,1847,42,50-100,1889,0.828429639853221
STAT,1789,79,na,1868,223.49892465080762
STAT,1925,31,40-44,1956,4.743899780963234
SIM,1839,38,25-29,1877,2
SIM,1927,15,45-49,1942,1
SIM,1778,79,na,1857,307
STAT,1940,32,20-24,1972,2.5753495640062516
STAT,1811,43,na,1854,1349.3133459228798
SIM,1910,19,15-19,1929,10
SIM,1834,41,30-34,1875,5
STAT,1914,33,50-100,1947,0.845554007452365
SIM,1891,38,45-49,1929,1
STAT,1785,80,na,1865,254.65505065755013
SIM,1892,23,25-29,1915,106
STAT,1835,53,40-44,1888,0.007840239681053553
STAT,1896,55,na,1951,2785.9410005719915
STAT,1817,44,25-29,1861,1.4920840796747419
STAT,1867,24,50-100,1891,0.38810887070267347
SIM,1865,28,25-29,1893,49
STAT,1832,50,20-24,1882,5.362240646806024E-4
STAT,1898,36,30-34,1934,7.387819600994061
SIM,1843,41,40-44,1884,5
STAT,1902,37,45-49,1939,0.6190154833994256
STAT,1951,21,40-44,1972,4.099444276936468
SIM,1843,20,na,1863,2156
STAT,1847,18,20-24,1865,17.153254887605943
SIM,1891,55,na,1946,2626
STAT,1862,39,20-24,1901,0.6626679331806858
SIM,1889,36,30-34,1925,11
STAT,1894,40,35-39,1934,2.4001593603365112
STAT,1934,21,40-44,1955,4.6096037988400065
STAT,1880,47,25-29,1927,0.06146102858659756
SIM,1916,55,na,1971,3744
STAT,1912,36,25-29,1948,0.985050379142678
STAT,1924,47,na,1971,4462.280861193561
STAT,1846,25,45-49,1871,0.9744894836011105
SIM,1824,47,45-49,1871,1
STAT,1863,47,25-29,1910,0.05128022793339331
STAT,1866,48,na,1914,2090.4324917975773
STAT,1902,19,15-19,1921,8.491928760875295
STAT,1857,28,25-29,1885,34.46469026155219
SIM,1891,39,50-100,1930,5
SIM,1910,37,45-49,1947,3
STAT,1884,35,25-29,1919,2.9335215609338063
SIM,1911,49,na,1960,3542
SIM,1825,32,25-29,1857,14
STAT,1907,5,na,1912,3925.4202601448874
SIM,1855,18,20-24,1873,19
STAT,1920,28,30-34,1948,43.708935387247706
SIM,1942,21,40-44,1963,7
STAT,1836,35,na,1871,1670.6491354334278
STAT,1852,41,40-44,1893,1.8202192648898632
SIM,1874,12,na,1886,2685
STAT,1841,41,50-100,1882,0.821004404345887
SIM,1907,31,30-34,1938,18
STAT,1916,24,25-29,1940,98.15467988073794
STAT,1887,10,na,1897,2961.088140482988
SIM,1780,80,na,1860,192
SIM,1796,64,na,1860,689
STAT,1860,57,na,1917,1663.400227441313
STAT,1884,23,25-29,1907,57.59846958075251
SIM,1875,42,30-34,1917,2
STAT,1885,18,na,1903,2563.7736306065617
STAT,1909,49,30-34,1958,0.08305318685662319
STAT,1851,26,30-34,1877,24.50114785556707
STAT,1866,11,na,1877,2545.252376494777
SIM,1938,25,30-34,1963,52
STAT,1841,52,20-24,1893,5.419442580320722E-4
STAT,1856,24,25-29,1880,52.47995281686391
SIM,1834,34,25-29,1868,13
STAT,1815,106,na,1921,0.006278169640101967
STAT,1839,35,50-100,1874,1.0338065084257275
SIM,1891,15,20-24,1906,24
SIM,1839,33,30-34,1872,6
STAT,1931,26,na,1957,4934.708226949704
SIM,1875,30,30-34,1905,4
STAT,1816,47,45-49,1863,0.48530178299171656
STAT,1837,23,45-49,1860,0.6042620138347999
STAT,1816,51,50-100,1867,0.03031510937357696
STAT,1915,27,45-49,1942,1.7981543323078082
SIM,1838,18,20-24,1856,15
SIM,1853,13,na,1866,2365
SIM,1923,27,45-49,1950,1
STAT,1841,50,na,1891,1612.6431595202496
STAT,1883,38,45-49,1921,1.9855140512817873
STAT,1826,34,25-29,1860,9.881627272851349
STAT,1890,30,50-100,1920,1.1520533774517863
STAT,1853,78,na,1931,655.1464469478618
STAT,1791,80,na,1871,229.58003149048358
STAT,1931,30,20-24,1961,3.2632588384722405
STAT,1909,41,35-39,1950,0.19319454439984537
STAT,1821,50,45-49,1871,0.022854766795215295
SIM,1897,37,35-39,1934,13
STAT,1903,45,na,1948,3295.7793476507095
STAT,1843,38,40-44,1881,3.7153746536198677
SIM,1928,40,na,1968,4998
STAT,1849,43,25-29,1892,0.4949440000054169
STAT,1828,71,na,1899,735.0303007846243
SIM,1849,42,50-100,1891,5
SIM,1849,45,na,1894,1801
STAT,1872,15,45-49,1887,0.067803731322832
STAT,1906,15,35-39,1921,0.818533875259293
SIM,1846,19,25-29,1865,5
STAT,1898,49,45-49,1947,0.17981656529911388
STAT,1902,22,40-44,1924,2.9978622107250454
SIM,1808,91,na,1899,18
SIM,1905,12,na,1917,3750
SIM,1942,18,15-19,1960,50
STAT,1861,28,15-19,1889,0.3824694721972361
STAT,1907,18,50-100,1925,0.07319202938317151
STAT,1926,27,20-24,1953,22.323295756800682
STAT,1897,19,30-34,1916,2.162437006713665
SIM,1846,31,na,1877,2044
SIM,1934,27,20-24,1961,24
SIM,1883,26,na,1909,2554
SIM,1908,26,na,1934,3844
STAT,1821,36,na,1857,1507.3861253047985
STAT,1916,40,50-100,1956,0.12319732688833533
SIM,1798,90,na,1888,18
SIM,1887,84,na,1971,756
SIM,1902,2,na,1904,3870
SIM,1838,28,30-34,1866,24
SIM,1938,15,20-24,1953,143
SIM,1892,30,30-34,1922,32
SIM,1924,28,40-44,1952,7
STAT,1773,95,na,1868,2.445766071155684
STAT,1851,24,40-44,1875,2.023658720968759
SIM,1861,79,na,1940,562
STAT,1890,30,na,1920,3000.4595355283086
STAT,1893,44,na,1937,2960.8991817236074
STAT,1929,1,na,1930,5435.826142529582
STAT,1899,31,20-24,1930,3.791522655783626
SIM,1898,25,na,1923,3654
STAT,1930,38,35-39,1968,3.214509537648651
SIM,1871,33,50-100,1904,1
STAT,1915,30,na,1945,3962.2232805653634
SIM,1858,42,30-34,1900,3
SIM,1873,16,15-19,1889,4
STAT,1838,19,25-29,1857,5.435107341189551
STAT,1833,25,35-39,1858,8.699295270958155
STAT,1939,27,30-34,1966,40.18324050590071
STAT,1882,18,40-44,1900,0.1813068394668475
STAT,1884,30,30-34,1914,17.7634356522468
SIM,1857,71,na,1928,952
STAT,1930,25,20-24,1955,23.69348451826906
SIM,1932,19,35-39,1951,5
STAT,1860,23,na,1883,2003.5007295468033
SIM,1818,84,na,1902,160
SIM,1934,31,25-29,1965,20
SIM,1840,42,50-100,1882,5
SIM,1842,26,30-34,1868,33
STAT,1921,38,25-29,1959,1.1207293934394873
SIM,1855,30,45-49,1885,2
STAT,1874,16,50-100,1890,0.05115339781203144
STAT,1865,16,15-19,1881,5.695857751815897
SIM,1947,5,na,1952,4709
STAT,1912,26,15-19,1938,0.7121238088509116
SIM,1865,38,35-39,1903,12
STAT,1862,89,na,1951,91.22848173999569
SIM,1920,26,15-19,1946,1
STAT,1814,44,50-100,1858,3.2996021641683435
STAT,1895,48,15-19,1943,2.9654662172725704E-4
SIM,1851,38,40-44,1889,10
STAT,1853,37,20-24,1890,0.6463557795381436
STAT,1883,18,25-29,1901,5.657338153288206
SIM,1903,7,na,1910,3740
STAT,1839,49,na,1888,1541.9950158344104
STAT,1819,94,na,1913,11.782932591310967
STAT,1859,54,40-44,1913,0.008341170805176849
SIM,1845,86,na,1931,162
STAT,1924,19,35-39,1943,5.070766170081109
STAT,1834,26,30-34,1860,22.382052458315066
STAT,1934,18,15-19,1952,62.43692340738667
SIM,1863,2,na,1865,2913
STAT,1863,49,15-19,1912,3.5031020634750625E-4
SIM,1862,27,na,1889,2189
SIM,1947,2,na,1949,4765
STAT,1826,44,35-39,1870,1.4336939808438511
STAT,1842,17,25-29,1859,5.706518907592185
STAT,1842,37,45-49,1879,1.8338705584767756
STAT,1885,15,na,1900,2582.451319251995
SIM,1911,28,30-34,1939,5
SIM,1869,18,15-19,1887,7
STAT,1925,21,30-34,1946,35.20557312840613
STAT,1944,25,15-19,1969,0.7791322963826045
STAT,1870,19,na,1889,2512.821235825734
SIM,1942,26,35-39,1968,24
STAT,1893,35,35-39,1928,9.240327221704103
STAT,1913,47,30-34,1960,0.08876446810921618
STAT,1875,27,30-34,1902,26.365717341008214
STAT,1900,34,na,1934,3345.23598759289
SIM,1866,30,20-24,1896,4
STAT,1907,16,30-34,1923,2.393299840986497
SIM,1916,28,15-19,1944,1
SIM,1805,80,na,1885,177
SIM,1864,18,30-34,1882,2
SIM,1913,41,na,1954,3825
SIM,1896,31,45-49,1927,2
SIM,1829,40,45-49,1869,2
STAT,1825,39,35-39,1864,10.141741006352328
SIM,1878,26,45-49,1904,1
SIM,1879,52,na,1931,2635
STAT,1849,106,na,1955,0.009426328888386997
SIM,1834,44,35-39,1878,5
STAT,1903,28,30-34,1931,36.38935794854141
STAT,1832,42,50-100,1874,0.868054407332479
STAT,1871,39,30-34,1910,5.331465250552549
STAT,1829,109,na,1938,4.7318039345090317E-4
STAT,1835,38,15-19,1873,0.05121239575697747
STAT,1856,18,50-100,1874,0.046117065676669795
SIM,1906,29,35-39,1935,15
STAT,1871,35,15-19,1906,0.05728448731540543
STAT,1934,26,35-39,1960,20.60609810209486
SIM,1906,24,40-44,1930,1
STAT,1874,23,30-34,1897,18.4952671141431
STAT,1818,53,40-44,1871,0.022458723073487064
STAT,1885,44,40-44,1929,2.258364470034819
STAT,1894,45,50-100,1939,0.183605606196643
SIM,1915,16,30-34,1931,3
STAT,1908,28,15-19,1936,0.6781207840518553
STAT,1908,46,45-49,1954,0.20194109652658537
SIM,1883,27,30-34,1910,34
SIM,1856,36,35-39,1892,17
STAT,1821,39,na,1860,1468.7483096626338
SIM,1833,39,35-39,1872,9
STAT,1873,51,20-24,1924,7.668444045833825E-4
STAT,1883,15,20-24,1898,17.82809604693534
STAT,1832,76,na,1908,633.0816010296745
STAT,1918,44,na,1962,4016.166194844844
SIM,1820,39,25-29,1859,6
SIM,1888,25,25-29,1913,62
SIM,1864,53,na,1917,1966
SIM,1875,32,20-24,1907,3
STAT,1911,19,25-29,1930,8.798083018789594
STAT,1792,68,na,1860,630.0370209941057
SIM,1850,17,25-29,1867,10
STAT,1865,63,na,1928,1652.0923516697324
STAT,1821,38,20-24,1859,1.5860514431892307
STAT,1847,75,na,1922,802.787924613382
SIM,1879,39,40-44,1918,10
STAT,1923,32,50-100,1955,0.9670840071648462
STAT,1941,17,45-49,1958,0.5249337926606998
STAT,1881,42,15-19,1923,0.013603554030107882
STAT,1860,22,25-29,1882,48.84511278606196
STAT,1889,24,20-24,1913,86.29600893483155
STAT,1825,100,na,1925,0.6366290618750146
STAT,1852,90,na,1942,63.51408999262385
SIM,1842,72,na,1914,981
STAT,1839,26,15-19,1865,0.3973141886480446
STAT,1904,48,35-39,1952,0.11401098334978134
SIM,1895,11,na,1906,3609
STAT,1866,21,15-19,1887,3.152263290034812
STAT,1900,31,na,1931,3387.912694048311
STAT,1913,31,15-19,1944,0.13096330082611463
STAT,1857,38,35-39,1895,5.607179907378776
SIM,1874,21,15-19,1895,1
SIM,1914,15,35-39,1929,1
SIM,1897,24,20-24,1921,100
STAT,1888,31,45-49,1919,2.1116793270406853
SIM,1928,20,45-49,1948,3
SIM,1916,52,na,1968,3783
SIM,1839,35,20-24,1874,4
SIM,1948,22,20-24,1970,123
SIM,1860,31,30-34,1891,23
STAT,1841,17,40-44,1858,0.17417511394414645
STAT,1836,38,na,1874,1619.4086965594806
SIM,1929,26,35-39,1955,22
STAT,1816,83,na,1899,176.14845338225908
SIM,1924,22,35-39,1946,1
SIM,1891,28,35-39,1919,20
STAT,1870,101,na,1971,5.044025328374775
SIM,1802,100,na,1902,2
STAT,1876,47,50-100,1923,0.25751607988348035
STAT,1813,46,15-19,1859,0.0010223412363134512
STAT,1875,37,40-44,1912,4.583292086455913
STAT,1898,26,20-24,1924,16.23969180422068
STAT,1848,36,35-39,1884,5.724952441094658
SIM,1886,3,na,1889,3152
STAT,1873,20,45-49,1893,0.7255076625909216
STAT,1870,33,40-44,1903,4.3065947463922525
STAT,1893,22,20-24,1915,89.18286029428712
SIM,1871,38,na,1909,2174
SIM,1840,46,na,1886,1594
STAT,1894,38,20-24,1932,1.0065047985243503
STAT,1927,37,15-19,1964,0.024354861738073268
SIM,1842,22,15-19,1864,4
SIM,1939,20,20-24,1959,134
STAT,1920,30,45-49,1950,1.7730723507248298
SIM,1892,39,40-44,1931,12
SIM,1931,32,50-100,1963,1
STAT,1929,22,45-49,1951,1.45124671854177
SIM,1885,52,na,1937,2111
STAT,1925,34,45-49,1959,1.903988359192184
STAT,1857,37,na,1894,1877.0515185601992
STAT,1883,28,35-39,1911,9.624246854918066
STAT,1916,22,35-39,1938,10.068683879544835
SIM,1870,53,na,1923,2310
STAT,1852,31,30-34,1883,14.715233772944876
STAT,1808,46,40-44,1854,0.47228267784538663
STAT,1770,84,na,1854,63.0
SIM,1825,48,40-44,1873,1
STAT,1786,68,na,1854,582.9999999999999
STAT,1952,17,20-24,1969,165.73636422829156
SIM,1886,37,na,1923,2627
STAT,1875,22,na,1897,2476.2310900678253
STAT,1822,48,15-19,1870,5.620415047435747E-4
STAT,1862,51,45-49,1913,0.0126628793831546
SIM,1903,33,20-24,1936,7
SIM,1950,18,40-44,1968,3
SIM,1916,36,35-39,1952,1
SIM,1933,34,45-49,1967,2
SIM,1874,35,40-44,1909,7
SIM,1891,52,na,1943,2717
STAT,1834,22,15-19,1856,2.9691854220813263
STAT,1942,18,40-44,1960,1.4908234153252513
SIM,1880,32,50-100,1912,2
STAT,1850,19,40-44,1869,0.1661466198086647
SIM,1938,28,35-39,1966,20
STAT,1869,22,45-49,1891,0.6867978966495615
STAT,1866,35,40-44,1901,4.158219211896429
STAT,1859,103,na,1962,0.38946506608291387
STAT,1884,20,20-24,1904,69.9671698743691
STAT,1918,35,15-19,1953,0.020851401441672537
SIM,1837,22,40-44,1859,1
SIM,1848,97,na,1945,10
STAT,1880,37,15-19,1917,0.06019935310665145
STAT,1948,23,25-29,1971,108.17069653226726
STAT,1908,7,na,1915,3940.98960926014
SIM,1865,38,na,1903,2275
STAT,1839,21,20-24,1860,61.55037964301205
SIM,1892,20,20-24,1912,97
STAT,1933,16,40-44,1949,1.914181567311752
STAT,1791,83,na,1874,121.69219713434373
STAT,1908,36,35-39,1944,2.3203669255089587
STAT,1917,48,45-49,1965,0.23101972514861646
SIM,1838,38,40-44,1876,5
SIM,1847,21,20-24,1868,66
STAT,1926,31,25-29,1957,11.407846061679855
SIM,1883,37,40-44,1920,4
STAT,1808,54,na,1862,1000.359577695733
SIM,1841,25,35-39,1866,1
STAT,1899,41,30-34,1940,0.11203215948170092
STAT,1919,29,na,1948,4101.0188610436635
SIM,1891,18,25-29,1909,11
STAT,1817,48,40-44,1865,0.37661791233713854
STAT,1836,49,20-24,1885,0.007619506270980536
STAT,1871,53,45-49,1924,0.014429687092584617
STAT,1831,45,20-24,1876,0.010070111551092893
SIM,1867,54,40-44,1921,1
SIM,1833,61,na,1894,1229
SIM,1834,46,na,1880,1622
STAT,1898,39,35-39,1937,2.0848667124452054
STAT,1850,107,na,1957,0.00565778024385386
SIM,1831,32,na,1863,1767
SIM,1941,22,na,1963,3930
STAT,1922,43,25-29,1965,0.0835000312694069
SIM,1941,16,40-44,1957,1
STAT,1863,44,20-24,1907,0.14013317364329553
STAT,1892,25,40-44,1917,3.8559979032225233
STAT,1838,110,na,1948,2.0304000429721355E-4
STAT,1858,43,35-39,1901,1.454379676586767
SIM,1901,20,40-44,1921,3
STAT,1801,84,na,1885,107.96563677530673
STAT,1866,31,25-29,1897,9.67737217654737
STAT,1856,32,45-49,1888,1.4135562237450754
STAT,1897,29,40-44,1926,4.056854935622893
SIM,1860,21,20-24,1881,79
SIM,1866,43,35-39,1909,2
SIM,1907,34,35-39,1941,10
SIM,1865,25,20-24,1890,14
SIM,1842,36,40-44,1878,4
SIM,1856,23,20-24,1879,101
SIM,1864,32,45-49,1896,3
STAT,1830,34,15-19,1864,0.1315497160869139
STAT,1847,30,45-49,1877,1.6301482269540426
STAT,1852,44,45-49,1896,1.189421150452061
SIM,1822,44,50-100,1866,2
SIM,1898,31,50-100,1929,1
SIM,1924,1,na,1925,5097
STAT,1858,40,30-34,1898,0.939475366315584
STAT,1849,26,50-100,1875,0.5929680655831223
SIM,1813,47,na,1860,1392
STAT,1872,32,50-100,1904,0.9367966217524132
SIM,1888,66,na,1954,1810
STAT,1827,47,20-24,1874,0.013476977675895375
STAT,1903,42,45-49,1945,0.1505297157491137
STAT,1848,23,20-24,1871,64.75616763087564
STAT,1822,43,20-24,1865,0.2400587508573574
SIM,1762,92,na,1854,8
STAT,1872,46,20-24,1918,0.012303990701305972
SIM,1783,91,na,1874,15
STAT,1904,35,20-24,1939,0.2455701854383513
SIM,1799,75,na,1874,526
SIM,1894,66,na,1960,2311
STAT,1826,31,20-24,1857,3.179104686225142
SIM,1850,27,35-39,1877,13
SIM,1879,29,30-34,1908,49
SIM,1893,46,50-100,1939,1
STAT,1860,104,na,1964,0.26120272736215183
STAT,1888,29,na,1917,2857.624238772354
STAT,1907,41,50-100,1948,0.11038548070190045
STAT,1952,1,na,1953,4951.1435413326535
STAT,1848,23,na,1871,2009.1706597219309
STAT,1889,37,35-39,1926,8.912896930282832
STAT,1867,45,35-39,1912,0.13541918388459467
SIM,1910,22,40-44,1932,4
SIM,1940,31,50-100,1971,1
STAT,1916,28,40-44,1944,4.900754580643807
STAT,1854,23,na,1877,1908.937703525816
STAT,1884,39,40-44,1923,4.373670890280056
STAT,1877,88,na,1965,323.3185635789507
STAT,1935,29,20-24,1964,25.35008895941779
SIM,1904,67,na,1971,2710
STAT,1851,29,35-39,1880,9.187314388287444
STAT,1825,34,40-44,1859,7.405301096034473
STAT,1833,24,na,1857,1854.355127875729
SIM,1833,34,40-44,1867,8
STAT,1856,89,na,1945,84.12722794667869
STAT,1885,46,50-100,1931,0.25067617275445897
STAT,1906,59,na,1965,3094.4999689889355
SIM,1829,30,35-39,1859,7
STAT,1934,36,45-49,1970,0.9602523949743142
STAT,1869,22,na,1891,2329.356313823271
STAT,1785,83,na,1868,134.98357163157476
STAT,1879,17,20-24,1896,18.904908132152883
SIM,1778,76,na,1854,420
SIM,1873,67,na,1940,1650
STAT,1857,25,20-24,1882,9.766964621297625
STAT,1932,31,50-100,1963,1.1215395121944398
